date,Debit,credit,amount,balance,mode of transaction,customer name,bank name,transaction details,balance amount
11.08.2020,,11.08,,,Credit,,LCL,Aoat A0 RELEVE DE COMPTE,11.08
20.08.2020,,20.08,,,Credit,,LCL,DUPLICATA,31.159999999999997
,,294,,,Credit,,LCL,N,325.15999999999997
,,58,,,Credit,,LCL,D'IDENTITE,383.15999999999997
,,12,,,Credit,,LCL,BICETRE,395.15999999999997
,,50,,,Credit,,LCL,MONS,445.15999999999997
,,10.08,,,Credit,,LCL,MONSIEUR AMOKRANE,455.23999999999995
,,"19 185,57",,,Credit,,LCL,BICETRE,1919012.24
,,04.08,,,Credit,,LCL,Cle 30002,1919016.32
,,05 08,,,Credit,,LCL,T 50 References bancaires internationales,1919524.32
,,"20 351,50",,,Credit,,LCL,OOOO,3954674.3200000003
,,"19 537,07",,,Credit,,LCL,7121 T5O,5908381.32
,,20.08,,,Credit,,LCL,SOLDE,5908401.4
,,"19 537,07",,,Credit,,LCL,OOOO1CH,7862108.4
,,1,,,Credit,,LCL,OOOOOOO,7862109.4
,,,,,Credit,,LCL,TOTAUX,7862109.4
,,,,,Credit,,LCL,SOLDE,7862109.4
,,,,,Credit,,LCL,Resolution,7862109.4
,,,,,Credit,,LCL,Dispositions genérales de banque disponibles,7862109.4
,,,,,Credit,,LCL,LCLfr,7862109.4
01.01.2020,,01.01,,,Credit,,COVMISSION,LCL RELEVE DE COMPTE,1.01
10.01.2020,,10.01,,,Credit,,COVMISSION,Jaavf,11.02
,,277,,,Credit,,COVMISSION,G40100p00141,288.02
,,158,,,Credit,,COVMISSION,MONSIEUR AMOKRANE,446.02
,,12,,,Credit,,COVMISSION,MONSIEUR AMOKRANE,458.02
,,50,,,Credit,,COVMISSION,BICETRE,508.02
,,31.12,,,Credit,,COVMISSION,References,539.14
,,"19 365,76",,,Credit,,COVMISSION,Cle,1937115.14
,,31.12,,,Credit,,COVMISSION,T 50 References bancaires internationales,1937146.26
,,03.01,,,Credit,,COVMISSION,FR85,1937149.27
,,20,,,Credit,,COVMISSION,T5o BIC,1937169.27
,,"6,00",,,Credit,,COVMISSION,CREDIT 31.12,1937769.27
,,"19 359,76",,,Credit,,COVMISSION,ExtrAIT,3873745.27
,,02.01,,,Credit,,COVMISSION,DECADAIRE,3873747.28
,,02.01,,,Credit,,COVMISSION,SOLDE INTERMEDIAIRE A FIN,3873749.2899999996
,,02.01,,,Credit,,COVMISSION,ABONNEMENT,3873751.2999999993
,,08.01,,,Credit,,COVMISSION,MULTIPREVOYANCE PRo230000105568,3873759.309999999
,,08.01,,,Credit,,COVMISSION,OOOOOADE2001010000105568 ID CrEANCIER FR39ZZZ000957,3873767.319999999
,,02.01,,,Credit,,COVMISSION,ADESOOOO10556800933750,3873769.3299999987
,,20 02,,,Credit,,COVMISSION,IDF,3875771.3299999987
,,01.20,,,Credit,,COVMISSION,ID CREANCIER,3875772.529999999
,,"39,50",,,Credit,,COVMISSION,Tip1030o6710700813142000037477679,3879722.529999999
,,"6,24",,,Credit,,COVMISSION,CHQ,3880346.529999999
,,"20 184,50",,,Credit,,COVMISSION,VERSEMENT,5898796.529999999
,,08.01,,,Credit,,COVMISSION,TOTAUX,5898804.539999999
,,20 08,,,Credit,,COVMISSION,SOLDE,5900812.539999999
,,01 20,,,Credit,,COVMISSION,Resolution,5900932.539999999
,,"698,70",,,Credit,,COVMISSION,dillusee,5970802.539999999
,,"760,00",,,Credit,,COVMISSION,LCLIr,6046802.539999999
,,"934,94",,,Credit,,COVMISSION,Page 71 Crédit Lyonnais SA,6140296.539999999
,,"20 125,76",,,Credit,,COVMISSION,RCS Lyon 18,8152872.539999999
,,8,,,Credit,,COVMISSION,rue de la République,8152880.539999999
,,8 10,,,Credit,,COVMISSION,,8153690.539999999
,,01,,,Credit,,COVMISSION,,8153691.539999999
,,"19 190,82",,,Credit,,COVMISSION,,10072773.54
,,1,,,Credit,,COVMISSION,,10072774.54
,,71,,,Credit,,COVMISSION,,10072845.54
,,2 037 713 591,,,Credit,,COVMISSION,,2047786436.54
,,954 509 741,,,Credit,,COVMISSION,,3002296177.54
,,18,,,Credit,,COVMISSION,,3002296195.54
,,07 00,,,Credit,,COVMISSION,,3002296895.54
31/03/2019,,91,,,Credit,,DEPARGNE,Semce gatut puapod,91.0
,,71,,,Credit,,DEPARGNE,eparane fr Votre Agence MAISONS ALFORT 147 AvenueDugenERALLECLERC,162.0
,,7,,,Credit,,DEPARGNE,Kuardi,169.0
,,147,,,Credit,,DEPARGNE,Keraed,316.0
,,01,,,Credit,,DEPARGNE,Jeudi,317.0
,,12,,,Credit,,DEPARGNE,Vendred,329.0
,,31,,,Credit,,DEPARGNE,Samed,360.0
,,03,,,Credit,,DEPARGNE,N 10,363.0
,,10,,,Credit,,DEPARGNE,Votre Conseiller AMANDINE AvRIL,373.0
,,1,,,Credit,,DEPARGNE,Kettanenacira,374.0
,,15 36,,,Credit,,DEPARGNE,WoumeKettane,1910.0
,,2,,,Credit,,DEPARGNE,DEPOT JOINT,1912.0
,,28,,,Credit,,DEPARGNE,IZICARTE,1940.0
,,02,,,Credit,,DEPARGNE,Soleau310419,1942.0
,,19,,,Credit,,DEPARGNE,Montant,1961.0
,,54,,,Credit,,DEPARGNE,KETTANE,2015.0
,,00,,,Credit,,DEPARGNE,DEPOT JOINT N 17515,2015.0
,,28,,,Credit,,DEPARGNE,Dale Detandes,2043.0
,,02,,,Credit,,DEPARGNE,Solde Precedent AU 28/02/19,2045.0
,,19,,,Credit,,DEPARGNE,VnEUR AU,2064.0
,,01,,,Credit,,DEPARGNE,MotoPaix,2065.0
,,03,,,Credit,,DEPARGNE,SePAINteRepaRGIE,2068.0
,,28,,,Credit,,DEPARGNE,SALARIAL,2096.0
,,314,,,Credit,,DEPARGNE,GRoUPEM OnopR,2410.0
,,006,,,Credit,,DEPARGNE,Ret,2416.0
,,09,,,Credit,,DEPARGNE,Me,2425.0
,,"2 787,73",,,Credit,,DEPARGNE,Ret,281198.0
,,"550,00",,,Credit,,DEPARGNE,ViR SepaDofip VaL De arne ReMBoURSEMENT(ORC,336198.0
,,"548,98",,,Credit,,DEPARGNE,KETT,391096.0
,,"803,70",,,Credit,,DEPARGNE,~Rel doneur dordre,471466.0
,,"82,75",,,Credit,,DEPARGNE,GFC19 0940006W-006-0086,479741.0
,,"703,50",,,Credit,,DEPARGNE,Cux,550091.0
,,"43,45",,,Credit,,DEPARGNE,Nuv€ Iqtc CS,554436.0
,,"20,98",,,Credit,,DEPARGNE,CeDe,556534.0
,,1,,,Credit,,DEPARGNE,8S ctumnucuCode,556535.0
,,900 942,,,Credit,,DEPARGNE,Honcureet,1457477.0
,,0,,,Credit,,DEPARGNE,Soocte,1457477.0
,,200,,,Credit,,DEPARGNE,Drectoreet,1457677.0
,,3,,,Credit,,DEPARGNE,Conei cOicnuuoncice Sunvralnce Cpiu,1457680.0
,,8,,,Credit,,DEPARGNE,ACSPn Sicx',1457688.0
,,,,,Credit,,DEPARGNE,Pneculoue Is001 A Incrmcaur,1457688.0
30/11/2019,,71,,,Credit,,IleDE FRANCE Direct,Feer CAISSE,71.0
,,7,,,Credit,,IleDE FRANCE Direct,Semce gatut puapod,78.0
,,147,,,Credit,,IleDE FRANCE Direct,eparane fr Votre Agence MAISONS ALFORT 147 AvenueDugenERALLECLERC,225.0
,,01,,,Credit,,IleDE FRANCE Direct,Kuardi,226.0
,,12,,,Credit,,IleDE FRANCE Direct,Keraed,238.0
,,30,,,Credit,,IleDE FRANCE Direct,Jeudi,268.0
,,11,,,Credit,,IleDE FRANCE Direct,Vendred,279.0
,,18,,,Credit,,IleDE FRANCE Direct,Samed,297.0
,,1,,,Credit,,IleDE FRANCE Direct,N 18 Page 1/ 100 2010110,298.0
,,100,,,Credit,,IleDE FRANCE Direct,Votre Conseiller AMANDINE AvRIL,398.0
,,15 36,,,Credit,,IleDE FRANCE Direct,Eml amandineavnlocedfcisseeoagnetr 10 BIS DE LA REVOL DES OEILLETS 94380 BONNEUIL SUR MARNE Identifiants,1934.0
,,10,,,Credit,,IleDE FRANCE Direct,Kettanenacira,1944.0
,,30,,,Credit,,IleDE FRANCE Direct,WoumeKettane,1974.0
,,11,,,Credit,,IleDE FRANCE Direct,DEPOT JOINT,1985.0
,,19,,,Credit,,IleDE FRANCE Direct,IZICARTE,2004.0
,,11,,,Credit,,IleDE FRANCE Direct,Sokeau 30/11/19,2015.0
,,19,,,Credit,,IleDE FRANCE Direct,KETTANE,2034.0
,,"42 000,00",,,Credit,,IleDE FRANCE Direct,DEPOT JOINT N 17515,4202034.0
,,31,,,Credit,,IleDE FRANCE Direct,Dale Detandes,4202065.0
,,10,,,Credit,,IleDE FRANCE Direct,Solde Precedent AU 31/10/19 Operations,4202075.0
,,19,,,Credit,,IleDE FRANCE Direct,depa,4202094.0
,,08,,,Credit,,IleDE FRANCE Direct,GAB,4202102.0
,,11,,,Credit,,IleDE FRANCE Direct,DEPOT ESPECE,4202113.0
,,26,,,Credit,,IleDE FRANCE Direct,AWoneu,4202139.0
,,11,,,Credit,,IleDE FRANCE Direct,"1930,00146491930,0014649 ~Rel doneur",4202150.0
,,27,,,Credit,,IleDE FRANCE Direct,MotOPRIX,4202177.0
,,11,,,Credit,,IleDE FRANCE Direct,Rel,4202188.0
,,02,,,Credit,,IleDE FRANCE Direct,Tauty,4202190.0
,,11,,,Credit,,IleDE FRANCE Direct,Bolt Blance,4202201.0
,,0,,,Credit,,IleDE FRANCE Direct,Ret,4202201.0
,,11,,,Credit,,IleDE FRANCE Direct,GRAS SAVOYE,4202212.0
,,09,,,Credit,,IleDE FRANCE Direct,Ret,4202221.0
,,11,,,Credit,,IleDE FRANCE Direct,Ret,4202232.0
,,09,,,Credit,,IleDE FRANCE Direct,Ret,4202241.0
,,11,,,Credit,,IleDE FRANCE Direct,Dol Gedn,4202252.0
,,3,,,Credit,,IleDE FRANCE Direct,Cux,4202255.0
,,05,,,Credit,,IleDE FRANCE Direct,Inne J6n8r,4202260.0
,,11,,,Credit,,IleDE FRANCE Direct,Nkur,4202271.0
,,05,,,Credit,,IleDE FRANCE Direct,Enque Cocoeru,4202276.0
,,11,,,Credit,,IleDE FRANCE Direct,8S ctumnucuCode,4202287.0
,,06,,,Credit,,IleDE FRANCE Direct,Honcureet,4202293.0
,,11,,,Credit,,IleDE FRANCE Direct,Soocte,4202304.0
,,07,,,Credit,,IleDE FRANCE Direct,Drectoreet,4202311.0
,,11,,,Credit,,IleDE FRANCE Direct,Conei cOicnuuoncice Sunvralnce Cpiu,4202322.0
,,111,,,Credit,,IleDE FRANCE Direct,ACSPn Sicx',4202433.0
,,0,,,Credit,,IleDE FRANCE Direct,Pneculoue Is001 A Incrmcaur,4202433.0
,,11,,,Credit,,IleDE FRANCE Direct,,4202444.0
,,11,,,Credit,,IleDE FRANCE Direct,,4202455.0
,,6,,,Credit,,IleDE FRANCE Direct,,4202461.0
,,18,,,Credit,,IleDE FRANCE Direct,,4202479.0
,,11,,,Credit,,IleDE FRANCE Direct,,4202490.0
,,74,,,Credit,,IleDE FRANCE Direct,,4202564.0
,,"450,00",,,Credit,,IleDE FRANCE Direct,,4247564.0
,,"450,00",,,Credit,,IleDE FRANCE Direct,,4292564.0
,,499,,,Credit,,IleDE FRANCE Direct,,4293063.0
,,8,,,Credit,,IleDE FRANCE Direct,,4293071.0
,,0,,,Credit,,IleDE FRANCE Direct,,4293071.0
,,798 54,,,Credit,,IleDE FRANCE Direct,,4372925.0
,,"39,89",,,Credit,,IleDE FRANCE Direct,,4376914.0
,,"7,50",,,Credit,,IleDE FRANCE Direct,,4377664.0
,,"19,24",,,Credit,,IleDE FRANCE Direct,,4379588.0
,,"210,00",,,Credit,,IleDE FRANCE Direct,,4400588.0
,,128 75,,,Credit,,IleDE FRANCE Direct,,4413463.0
,,"86,80",,,Credit,,IleDE FRANCE Direct,,4422143.0
,,756,,,Credit,,IleDE FRANCE Direct,,4422899.0
,,1,,,Credit,,IleDE FRANCE Direct,,4422900.0
,,900 942,,,Credit,,IleDE FRANCE Direct,,5323842.0
,,0,,,Credit,,IleDE FRANCE Direct,,5323842.0
,,200,,,Credit,,IleDE FRANCE Direct,,5324042.0
,,6,,,Credit,,IleDE FRANCE Direct,,5324048.0
31/12/2019,,71,,,Credit,,IleDE FRANCE Direct,Semce gatut puapod,71.0
,,7,,,Credit,,IleDE FRANCE Direct,eparane fr Votre Agence MAISONS ALFORT 147 AvenueDugenERALLECLERC,78.0
,,147,,,Credit,,IleDE FRANCE Direct,Kuardi,225.0
,,01,,,Credit,,IleDE FRANCE Direct,Keraed,226.0
,,12,,,Credit,,IleDE FRANCE Direct,Jeudi,238.0
,,31,,,Credit,,IleDE FRANCE Direct,Vendred,269.0
,,12,,,Credit,,IleDE FRANCE Direct,Samed,281.0
,,19,,,Credit,,IleDE FRANCE Direct,Votre Conseiller AMANDINE AvRIL,300.0
,,1,,,Credit,,IleDE FRANCE Direct,Eml amandineavnlocedfcisseeoagnetr 10 BIS DE LA REVOL DES OEILLETS 94380 BONNEUIL SUR MARNE Identifiants,301.0
,,15 36,,,Credit,,IleDE FRANCE Direct,Kettanenacira,1837.0
,,10,,,Credit,,IleDE FRANCE Direct,WoumeKettane,1847.0
,,31,,,Credit,,IleDE FRANCE Direct,DEPOT JOINT,1878.0
,,12,,,Credit,,IleDE FRANCE Direct,IZICARTE,1890.0
,,19,,,Credit,,IleDE FRANCE Direct,Sokeau 31/12/19,1909.0
,,30,,,Credit,,IleDE FRANCE Direct,M,1939.0
,,11,,,Credit,,IleDE FRANCE Direct,KETTANE,1950.0
,,19,,,Credit,,IleDE FRANCE Direct,DEPOT JOINT N 17515,1969.0
,,"504,80",,,Credit,,IleDE FRANCE Direct,Dale Detandes,52449.0
,,"000,00",,,Credit,,IleDE FRANCE Direct,Solde Precedent AU 30/11/19,52449.0
,,30,,,Credit,,IleDE FRANCE Direct,ChEqUES,52479.0
,,11,,,Credit,,IleDE FRANCE Direct,DEPOT ESPECE,52490.0
,,19,,,Credit,,IleDE FRANCE Direct,DEPOT ESPECE,52509.0
,,09,,,Credit,,IleDE FRANCE Direct,MotoPaix,52518.0
,,12,,,Credit,,IleDE FRANCE Direct,Payout H 35099825 ~Rel,52530.0
,,12 05,,,Credit,,IleDE FRANCE Direct,GO,53735.0
,,12,,,Credit,,IleDE FRANCE Direct,MotoPaix,53747.0
,,06,,,Credit,,IleDE FRANCE Direct,MonopRIX SA,53753.0
,,12 05,,,Credit,,IleDE FRANCE Direct,CbelecleRc,54958.0
,,12,,,Credit,,IleDE FRANCE Direct,CpaM,54970.0
,,14,,,Credit,,IleDE FRANCE Direct,Rel,54984.0
,,12,,,Credit,,IleDE FRANCE Direct,~Ret,54996.0
,,02,,,Credit,,IleDE FRANCE Direct,Bolt Blince Payout,54998.0
,,12,,,Credit,,IleDE FRANCE Direct,Rel,55010.0
,,02,,,Credit,,IleDE FRANCE Direct,CHEQUE Iroooooso,55012.0
,,12,,,Credit,,IleDE FRANCE Direct,Cux,55024.0
,,02,,,Credit,,IleDE FRANCE Direct,Nuv€ Iqtc CS,55026.0
,,12,,,Credit,,IleDE FRANCE Direct,CeDe,55038.0
,,03,,,Credit,,IleDE FRANCE Direct,8S ctumnucuCode,55041.0
,,12,,,Credit,,IleDE FRANCE Direct,Honcureet,55053.0
,,03,,,Credit,,IleDE FRANCE Direct,Soocte onmme'Drectoreet,55056.0
,,12,,,Credit,,IleDE FRANCE Direct,ACSPn Sicx',55068.0
,,06,,,Credit,,IleDE FRANCE Direct,Pneculoue Is001 A Incrmcaur,55074.0
,,12,,,Credit,,IleDE FRANCE Direct,,55086.0
,,11,,,Credit,,IleDE FRANCE Direct,,55097.0
,,12,,,Credit,,IleDE FRANCE Direct,,55109.0
,,16,,,Credit,,IleDE FRANCE Direct,,55125.0
,,12,,,Credit,,IleDE FRANCE Direct,,55137.0
,,6,,,Credit,,IleDE FRANCE Direct,,55143.0
,,23,,,Credit,,IleDE FRANCE Direct,,55166.0
,,12,,,Credit,,IleDE FRANCE Direct,,55178.0
,,30,,,Credit,,IleDE FRANCE Direct,,55208.0
,,12,,,Credit,,IleDE FRANCE Direct,,55220.0
,,05,,,Credit,,IleDE FRANCE Direct,,55225.0
,,12,,,Credit,,IleDE FRANCE Direct,,55237.0
,,12,,,Credit,,IleDE FRANCE Direct,,55249.0
,,12,,,Credit,,IleDE FRANCE Direct,,55261.0
,,"955,42",,,Credit,,IleDE FRANCE Direct,,150803.0
,,"150,00",,,Credit,,IleDE FRANCE Direct,,165803.0
,,"450,00",,,Credit,,IleDE FRANCE Direct,,210803.0
,,"693,58",,,Credit,,IleDE FRANCE Direct,,280161.0
,,"25,97",,,Credit,,IleDE FRANCE Direct,,282758.0
,,"30,05",,,Credit,,IleDE FRANCE Direct,,285763.0
,,"29,89",,,Credit,,IleDE FRANCE Direct,,288752.0
,,"518,00",,,Credit,,IleDE FRANCE Direct,,340552.0
,,"5,60",,,Credit,,IleDE FRANCE Direct,,341112.0
,,116,,,Credit,,IleDE FRANCE Direct,,341228.0
,,3,,,Credit,,IleDE FRANCE Direct,,341231.0
,,"29,28",,,Credit,,IleDE FRANCE Direct,,344159.0
,,"228,80",,,Credit,,IleDE FRANCE Direct,,367039.0
,,"397,00",,,Credit,,IleDE FRANCE Direct,,406739.0
,,1,,,Credit,,IleDE FRANCE Direct,,406740.0
,,900 942,,,Credit,,IleDE FRANCE Direct,,1307682.0
,,0,,,Credit,,IleDE FRANCE Direct,,1307682.0
,,200,,,Credit,,IleDE FRANCE Direct,,1307882.0
,,8,,,Credit,,IleDE FRANCE Direct,,1307890.0
11.12.2021,,11.12,,,Credit,,LCL,So RELEVE DE COMPTE,11.12
20.12.2021,,20.12,,,Credit,,LCL,D'IDENTITE,31.240000000000002
,,335,,,Credit,,LCL,BiCETRE 58 AVENUE DE FONTAINEBLEAU 94270,366.24
,,58,,,Credit,,LCL,BICETRE,424.24
,,12,,,Credit,,LCL,MONS,436.24
,,9,,,Credit,,LCL,SEINE 9 Titulaire,445.24
,,50,,,Credit,,LCL,MONSIEUR AMOKRANE,495.24
,,10 12,,,Credit,,LCL,BICETRE,1507.24
,,"72 305,67",,,Credit,,LCL,Cle,7232074.24
,,16 12,,,Credit,,LCL,References,7233686.24
,,16.12,,,Credit,,LCL,FR85,7233702.36
,,"21 880,00",,,Credit,,LCL,CREDIT 10 12,9421702.36
,,"880,00",,,Credit,,LCL,PRLV,9509702.36
,,"72 305,67",,,Credit,,LCL,DIRECTION GENERALE DES FINANCES PUBLIQUE S CREANCIER,16740269.36
,,20 12,,,Credit,,LCL,NNFR46ZZZ0050022194030858865R923374,16742281.36
,,"71 425,67",,,Credit,,LCL,TOTAUX,23884848.36
,,1,,,Credit,,LCL,SOLDE,23884849.36
,,,,,Credit,,LCL,Resolution,23884849.36
,,,,,Credit,,LCL,Dispositions generales de banque disponibles,23884849.36
21.01.2021,,21.01,,,Credit,,Banque Indicatit,LCL RELEVE DE COMPTE COURANT,21.01
10.02.2021,,10.02,,,Credit,,Banque Indicatit,N,31.03
,,306,,,Credit,,Banque Indicatit,KREMLIn,337.03
,,58,,,Credit,,Banque Indicatit,58 AVENUE DE FONTAINEBLEAU 194270,395.03
,,12,,,Credit,,Banque Indicatit,MONSIEUR AMOKRANE,407.03
,,50,,,Credit,,Banque Indicatit,MONSIEUR AMOKRANE,457.03
,,20.01,,,Credit,,Banque Indicatit,BICETRE,477.03999999999996
,,"35 806,16",,,Credit,,Banque Indicatit,Clé 30002,3581093.04
,,31.01,,,Credit,,Banque Indicatit,T 50 References,3581124.05
,,02.02,,,Credit,,Banque Indicatit,FR85,3581126.07
,,21,,,Credit,,Banque Indicatit,T5o BIC,3581147.07
,,"5,50",,,Credit,,Banque Indicatit,EXTRAIT,3581697.07
,,"35 800,66",,,Credit,,Banque Indicatit,DECADAIRE,7161763.07
,,01.02,,,Credit,,Banque Indicatit,SOLDE INTERMEDIAIRE A FIN JANVIER 35,7161764.09
,,01.02,,,Credit,,Banque Indicatit,LIBELLE MULTIPREVOYANCE PRO2300O0105568 REF,7161765.109999999
,,01.02,,,Credit,,Banque Indicatit,ADESOOOO10556800933750,7161766.129999999
,,21,,,Credit,,Banque Indicatit,ABONNEMENT,7161787.129999999
,,"6,24",,,Credit,,Banque Indicatit,ZEN PRO,7162411.129999999
,,01.02,,,Credit,,Banque Indicatit,B,7162412.1499999985
,,21 40,,,Credit,,Banque Indicatit,SOLDE,7164552.1499999985
,,30,,,Credit,,Banque Indicatit,FGDR,7164582.1499999985
,,"52,04",,,Credit,,Banque Indicatit,LCLIr,7169786.1499999985
,,"35 806,16",,,Credit,,Banque Indicatit,Page 11 Credit Lyonnais,10750402.149999999
,,10.02,,,Credit,,Banque Indicatit,SiREn 954 509 741 RCS Lyon 18,10750412.169999998
,,"35 754,12",,,Credit,,Banque Indicatit,rue de la République,14325824.169999998
,,8,,,Credit,,Banque Indicatit,,14325832.169999998
,,1,,,Credit,,Banque Indicatit,,14325833.169999998
,,8,,,Credit,,Banque Indicatit,,14325841.169999998
,,1,,,Credit,,Banque Indicatit,,14325842.169999998
,,1,,,Credit,,Banque Indicatit,,14325843.169999998
,,0,,,Credit,,Banque Indicatit,,14325843.169999998
,,11,,,Credit,,Banque Indicatit,,14325854.169999998
,,2 037 713 591,,,Credit,,Banque Indicatit,,2052039445.17
,,954 509 741,,,Credit,,Banque Indicatit,,3006549186.17
,,18,,,Credit,,Banque Indicatit,,3006549204.17
,,07 00,,,Credit,,Banque Indicatit,,3006549904.17
01.01.2022,,01.01,,,Credit,,PRLV,LCL RELEVE DE COMPTE COURANT,1.01
10.01.2022,,10.01,,,Credit,,PRLV,N,11.02
,,337,,,Credit,,PRLV,D'IDENTITE,348.02
,,58,,,Credit,,PRLV,58 AVENUE DE FONTAINEBLEAU 94270,406.02
,,0,,,Credit,,PRLV,ATY,406.02
,,1,,,Credit,,PRLV,MONSIEUR,407.02
,,1 50,,,Credit,,PRLV,MONSIEUR AMOKRANE,557.02
,,10,,,Credit,,PRLV,BICETRE,567.02
,,28,,,Credit,,PRLV,Clé,595.02
,,12,,,Credit,,PRLV,T 50 References bancaires internationales,607.02
,,50,,,Credit,,PRLV,T50 BIC,657.02
,,31.12,,,Credit,,PRLV,CREDIT 31.12,688.14
,,"72 447,86",,,Credit,,PRLV,SOLDE,7245474.14
,,31.12,,,Credit,,PRLV,EXTRAIT,7245505.26
,,04.01,,,Credit,,PRLV,DECADAIRE,7245509.27
,,22,,,Credit,,PRLV,SOLDE INTERMEDIAIRE A FIN,7245531.27
,,"9,00",,,Credit,,PRLV,ABONNEMENT,7246431.27
,,"72 438,86",,,Credit,,PRLV,LIBELLE MULTIPREVOYANCE PRO2300O0105568 REF,14490317.27
,,03.01,,,Credit,,PRLV,CLIENT OOOOOADE2201010000105568,14490320.28
,,03.01,,,Credit,,PRLV,ADESOOOO10556800933750,14490323.29
,,03.01,,,Credit,,PRLV,TOTAUX,14490326.299999999
,,22 03,,,Credit,,PRLV,SOLDE,14492529.299999999
,,01 22,,,Credit,,PRLV,Résolution,14492651.299999999
,,"40,30",,,Credit,,PRLV,dillusee,14496681.299999999
,,"6,24",,,Credit,,PRLV,lormulaire dinlormation,14497305.299999999
,,"55,54",,,Credit,,PRLV,Dispositions genérales de banque disponibles,14502859.299999999
,,"72 447,86",,,Credit,,PRLV,LCLIr,21747645.299999997
,,10.01,,,Credit,,PRLV,volre conseiller,21747655.31
,,"72 392,32",,,Credit,,PRLV,RCS Lyon 18,28986887.31
,,8,,,Credit,,PRLV,rue de la République,28986895.31
,,1,,,Credit,,PRLV,,28986896.31
,,8,,,Credit,,PRLV,,28986904.31
,,1,,,Credit,,PRLV,,28986905.31
,,0,,,Credit,,PRLV,,28986905.31
,,1,,,Credit,,PRLV,,28986906.31
,,1,,,Credit,,PRLV,,28986907.31
,,2 037 713 591,,,Credit,,PRLV,,2066700498.31
,,954 509 741,,,Credit,,PRLV,,3021210239.31
,,18,,,Credit,,PRLV,,3021210257.31
,,07 00,,,Credit,,PRLV,,3021210957.31
08/07/2021,40,,40,,Unknown,,Deliveroo,CCM RENNES,-40.0
07/07/2021,8,,8,,Unknown,,Deliveroo,CHALOTAIS 35000 RENNES,-48.0
07/07/2021,1,,1,,Unknown,,Deliveroo,CARTESICHEQUIERS,-49.0
08/07/2021,11,,11,,Unknown,,Deliveroo,Titulaire(s,-60.0
08/07/2021,07,,07,,Unknown,,Deliveroo,EPI SERVICE PrIMEUR,-67.0
08/07/2021,11,,11,,Unknown,,Deliveroo,NUMÉRO DE,-78.0
08/07/2021,02 99,,02 99,,Unknown,,Deliveroo,Crédit ANCIEN SOLDE CRÉDITEUR,-377.0
08/07/2021,14 94,,14 94,,Unknown,,Deliveroo,TPV,-1871.0
08/07/2021,34,,34,,Unknown,,Deliveroo,TPV,-1905.0
08/07/2021,31,,31,,Unknown,,Deliveroo,TPV,-1936.0
08/07/2021,75 10,,75 10,,Unknown,,Deliveroo,CARTE,-9446.0
08/07/2021,11,,11,,Unknown,,Deliveroo,COM,-9457.0
08/07/2021,02 98,,02 98,,Unknown,,Deliveroo,CARTES,-9755.0
08/07/2021,28 42,,28 42,,Unknown,,Deliveroo,COM,-12597.0
08/07/2021,28,,28,,Unknown,,Deliveroo,CARTES 0386405 64 0707,-12625.0
08/07/2021,95,,95,,Unknown,,Deliveroo,COM,-12720.0
08/07/2021,095,,095,,Unknown,,Deliveroo,CARTES,-12815.0
09/07/2021,07,,07,,Unknown,,Deliveroo,COM,-12822.0
09/07/2021,"17 178,52",,"17 178,52",,Unknown,,Deliveroo,CARTES,-1730674.0
01/07/2021,08,,08,,Unknown,,Deliveroo,COM,-1730682.0
09/07/2021,07 08,,07 08,,Unknown,,Deliveroo,CARTES,-1731390.0
09/07/2021,07 08,,07 08,,Unknown,,Deliveroo,TPV,-1732098.0
09/07/2021,07 08,,07 08,,Unknown,,Deliveroo,TPV,-1732806.0
09/07/2021,07 08,,07 08,,Unknown,,Deliveroo,CARTE,-1733514.0
09/07/2021,07 08,,07 08,,Unknown,,Deliveroo,CARTE,-1734222.0
09/07/2021,07 08,,07 08,,Unknown,,Deliveroo,COMM,-1734930.0
09/07/2021,07 08,,07 08,,Unknown,,Deliveroo,COM,-1735638.0
09/07/2021,07 08,,07 08,,Unknown,,Deliveroo,CARTES,-1736346.0
09/07/2021,07 08,,07 08,,Unknown,,Deliveroo,COM,-1737054.0
09/07/2021,07 08,,07 08,,Unknown,,Deliveroo,CARTES,-1737762.0
09/07/2021,07 08,,07 08,,Unknown,,Deliveroo,COM,-1738470.0
09/07/2021,07 08,,07 08,,Unknown,,Deliveroo,CARTES 0386405,-1739178.0
,07 09,,07 09,,Unknown,,Deliveroo,COM,-1739887.0
,07 09,,07 09,,Unknown,,Deliveroo,CARTES,-1740596.0
,07 09,,07 09,,Unknown,,Deliveroo,COM,-1741305.0
,07 09,,07 09,,Unknown,,Deliveroo,CARTES,-1742014.0
,07 09,,07 09,,Unknown,,Deliveroo,COM,-1742723.0
,07 09,,07 09,,Unknown,,Deliveroo,CARTES,-1743432.0
,07 09,,07 09,,Unknown,,Deliveroo,COM,-1744141.0
,07 09,,07 09,,Unknown,,Deliveroo,CARTES 0386405 64 0707,-1744850.0
,07 09,,07 09,,Unknown,,Deliveroo,COM,-1745559.0
,07 09,,07 09,,Unknown,,Deliveroo,CARTES,-1746268.0
,07 09,,07 09,,Unknown,,Deliveroo,TPV,-1746977.0
,07 09,,07 09,,Unknown,,Deliveroo,TPV,-1747686.0
,07 09,,07 09,,Unknown,,Deliveroo,REMISE,-1748395.0
,07 09,,07 09,,Unknown,,Deliveroo,TPV,-1749104.0
,07 09,,07 09,,Unknown,,Deliveroo,TPV,-1749813.0
,07 10,,07 10,,Unknown,,Deliveroo,,-1750523.0
,07 10,,07 10,,Unknown,,Deliveroo,,-1751233.0
,07 10,,07 10,,Unknown,,Deliveroo,,-1751943.0
,07 10,,07 10,,Unknown,,Deliveroo,,-1752653.0
,07 08,,07 08,,Unknown,,Deliveroo,,-1753361.0
,07,,07,,Unknown,,Deliveroo,,-1753368.0
,07,,07,,Unknown,,Deliveroo,,-1753375.0
,07,,07,,Unknown,,Deliveroo,,-1753382.0
,07,,07,,Unknown,,Deliveroo,,-1753389.0
,07,,07,,Unknown,,Deliveroo,,-1753396.0
,08,,08,,Unknown,,Deliveroo,,-1753404.0
,07,,07,,Unknown,,Deliveroo,,-1753411.0
,08,,08,,Unknown,,Deliveroo,,-1753419.0
,07,,07,,Unknown,,Deliveroo,,-1753426.0
,08,,08,,Unknown,,Deliveroo,,-1753434.0
,07,,07,,Unknown,,Deliveroo,,-1753441.0
,07,,07,,Unknown,,Deliveroo,,-1753448.0
,07,,07,,Unknown,,Deliveroo,,-1753455.0
,35,,35,,Unknown,,Deliveroo,,-1753490.0
,08,,08,,Unknown,,Deliveroo,,-1753498.0
,07,,07,,Unknown,,Deliveroo,,-1753505.0
,07,,07,,Unknown,,Deliveroo,,-1753512.0
,07,,07,,Unknown,,Deliveroo,,-1753519.0
,08,,08,,Unknown,,Deliveroo,,-1753527.0
,07,,07,,Unknown,,Deliveroo,,-1753534.0
,07,,07,,Unknown,,Deliveroo,,-1753541.0
,07,,07,,Unknown,,Deliveroo,,-1753548.0
,08,,08,,Unknown,,Deliveroo,,-1753556.0
,07,,07,,Unknown,,Deliveroo,,-1753563.0
,64,,64,,Unknown,,Deliveroo,,-1753627.0
,08,,08,,Unknown,,Deliveroo,,-1753635.0
,07,,07,,Unknown,,Deliveroo,,-1753642.0
,64,,64,,Unknown,,Deliveroo,,-1753706.0
,08,,08,,Unknown,,Deliveroo,,-1753714.0
,07,,07,,Unknown,,Deliveroo,,-1753721.0
,01,,01,,Unknown,,Deliveroo,,-1753722.0
,08,,08,,Unknown,,Deliveroo,,-1753730.0
,07,,07,,Unknown,,Deliveroo,,-1753737.0
,64,,64,,Unknown,,Deliveroo,,-1753801.0
,08,,08,,Unknown,,Deliveroo,,-1753809.0
,07,,07,,Unknown,,Deliveroo,,-1753816.0
,01,,01,,Unknown,,Deliveroo,,-1753817.0
,08,,08,,Unknown,,Deliveroo,,-1753825.0
,07,,07,,Unknown,,Deliveroo,,-1753832.0
,08,,08,,Unknown,,Deliveroo,,-1753840.0
,07,,07,,Unknown,,Deliveroo,,-1753847.0
,08,,08,,Unknown,,Deliveroo,,-1753855.0
,07,,07,,Unknown,,Deliveroo,,-1753862.0
,08,,08,,Unknown,,Deliveroo,,-1753870.0
,07,,07,,Unknown,,Deliveroo,,-1753877.0
,09,,09,,Unknown,,Deliveroo,,-1753886.0
,07,,07,,Unknown,,Deliveroo,,-1753893.0
,08,,08,,Unknown,,Deliveroo,,-1753901.0
,07,,07,,Unknown,,Deliveroo,,-1753908.0
,09,,09,,Unknown,,Deliveroo,,-1753917.0
,07,,07,,Unknown,,Deliveroo,,-1753924.0
,08,,08,,Unknown,,Deliveroo,,-1753932.0
,07,,07,,Unknown,,Deliveroo,,-1753939.0
,01,,01,,Unknown,,Deliveroo,,-1753940.0
,07,,07,,Unknown,,Deliveroo,,-1753947.0
,02 09,,02 09,,Unknown,,Deliveroo,,-1754156.0
,07,,07,,Unknown,,Deliveroo,,-1754163.0
,64,,64,,Unknown,,Deliveroo,,-1754227.0
,09,,09,,Unknown,,Deliveroo,,-1754236.0
,07,,07,,Unknown,,Deliveroo,,-1754243.0
,01,,01,,Unknown,,Deliveroo,,-1754244.0
,09,,09,,Unknown,,Deliveroo,,-1754253.0
,07,,07,,Unknown,,Deliveroo,,-1754260.0
,64,,64,,Unknown,,Deliveroo,,-1754324.0
,09,,09,,Unknown,,Deliveroo,,-1754333.0
,07,,07,,Unknown,,Deliveroo,,-1754340.0
,01,,01,,Unknown,,Deliveroo,,-1754341.0
,09,,09,,Unknown,,Deliveroo,,-1754350.0
,07,,07,,Unknown,,Deliveroo,,-1754357.0
,64,,64,,Unknown,,Deliveroo,,-1754421.0
,09,,09,,Unknown,,Deliveroo,,-1754430.0
,07,,07,,Unknown,,Deliveroo,,-1754437.0
,01,,01,,Unknown,,Deliveroo,,-1754438.0
,09,,09,,Unknown,,Deliveroo,,-1754447.0
,07,,07,,Unknown,,Deliveroo,,-1754454.0
,64,,64,,Unknown,,Deliveroo,,-1754518.0
,09,,09,,Unknown,,Deliveroo,,-1754527.0
,07,,07,,Unknown,,Deliveroo,,-1754534.0
,01,,01,,Unknown,,Deliveroo,,-1754535.0
,09,,09,,Unknown,,Deliveroo,,-1754544.0
,07,,07,,Unknown,,Deliveroo,,-1754551.0
,09,,09,,Unknown,,Deliveroo,,-1754560.0
,07,,07,,Unknown,,Deliveroo,,-1754567.0
,09,,09,,Unknown,,Deliveroo,,-1754576.0
,07,,07,,Unknown,,Deliveroo,,-1754583.0
,09,,09,,Unknown,,Deliveroo,,-1754592.0
,07,,07,,Unknown,,Deliveroo,,-1754599.0
,"252,40",,"252,40",,Unknown,,Deliveroo,,-1779839.0
,"88,00",,"88,00",,Unknown,,Deliveroo,,-1788639.0
,"75,80",,"75,80",,Unknown,,Deliveroo,,-1796219.0
,"63,04",,"63,04",,Unknown,,Deliveroo,,-1802523.0
,"233,59",,"233,59",,Unknown,,Deliveroo,,-1825882.0
,"186,02",,"186,02",,Unknown,,Deliveroo,,-1844484.0
,"223,76",,"223,76",,Unknown,,Deliveroo,,-1866860.0
,"50,00",,"50,00",,Unknown,,Deliveroo,,-1871860.0
,"0,94",,"0,94",,Unknown,,Deliveroo,,-1871954.0
,"0,77",,"0,77",,Unknown,,Deliveroo,,-1872031.0
,"0,31",,"0,31",,Unknown,,Deliveroo,,-1872062.0
,"0,08",,"0,08",,Unknown,,Deliveroo,,-1872070.0
,"0,46",,"0,46",,Unknown,,Deliveroo,,-1872116.0
,"110,20",,"110,20",,Unknown,,Deliveroo,,-1883136.0
,"473,70",,"473,70",,Unknown,,Deliveroo,,-1930506.0
,"52,10",,"52,10",,Unknown,,Deliveroo,,-1935716.0
,"78,30",,"78,30",,Unknown,,Deliveroo,,-1943546.0
,"100,00",,"100,00",,Unknown,,Deliveroo,,-1953546.0
,"150,00",,"150,00",,Unknown,,Deliveroo,,-1968546.0
,"34,09",,"34,09",,Unknown,,Deliveroo,,-1971955.0
,"0,52",,"0,52",,Unknown,,Deliveroo,,-1972007.0
,"0,03",,"0,03",,Unknown,,Deliveroo,,-1972010.0
,"1,63",,"1,63",,Unknown,,Deliveroo,,-1972173.0
,"0,56",,"0,56",,Unknown,,Deliveroo,,-1972229.0
,"0,95",,"0,95",,Unknown,,Deliveroo,,-1972324.0
,"0,02",,"0,02",,Unknown,,Deliveroo,,-1972326.0
,"0,23",,"0,23",,Unknown,,Deliveroo,,-1972349.0
,"0,15",,"0,15",,Unknown,,Deliveroo,,-1972364.0
,1,,1,,Unknown,,Deliveroo,,-1972365.0
,8,,8,,Unknown,,Deliveroo,,-1972373.0
,"97,20",,"97,20",,Unknown,,Deliveroo,,-1982093.0
,"653,26",,"653,26",,Unknown,,Deliveroo,,-2047419.0
,"19,50",,"19,50",,Unknown,,Deliveroo,,-2049369.0
,"83,15",,"83,15",,Unknown,,Deliveroo,,-2057684.0
19/07/2021,40,,40,,Unknown,,EPI SERVICE PRIMEUR,Titulaire(s,-40.0
19/07/2021,8,,8,,Unknown,,EPI SERVICE PRIMEUR,Page 5/11 Crédit Mutuel,-48.0
19/07/2021,5,,5,,Unknown,,EPI SERVICE PRIMEUR,Date Date de Valeur,-53.0
19/07/2021,11,,11,,Unknown,,EPI SERVICE PRIMEUR,Bretagne UR 537000000543170617,-64.0
19/07/2021,19,,19,,Unknown,,EPI SERVICE PRIMEUR,Bretagne UR,-83.0
19/07/2021,07 19,,07 19,,Unknown,,EPI SERVICE PRIMEUR,AVR 21753759570000160721,-802.0
20/07/2021,07,,07,,Unknown,,EPI SERVICE PRIMEUR,Bretagne UR,-809.0
19/07/2021,19,,19,,Unknown,,EPI SERVICE PRIMEUR,MAI 21753759570000160721,-828.0
19/07/2021,07,,07,,Unknown,,EPI SERVICE PRIMEUR,REMISE,-835.0
20/07/2021,19,,19,,Unknown,,EPI SERVICE PRIMEUR,TPV,-854.0
20/07/2021,07,,07,,Unknown,,EPI SERVICE PRIMEUR,REMISE,-861.0
20/07/2021,19,,19,,Unknown,,EPI SERVICE PRIMEUR,TPV,-880.0
20/07/2021,07,,07,,Unknown,,EPI SERVICE PRIMEUR,REMISE,-887.0
20/07/2021,19,,19,,Unknown,,EPI SERVICE PRIMEUR,TPV,-906.0
20/07/2021,07,,07,,Unknown,,EPI SERVICE PRIMEUR,REMISE,-913.0
20/07/2021,19,,19,,Unknown,,EPI SERVICE PRIMEUR,TPV,-932.0
20/07/2021,07,,07,,Unknown,,EPI SERVICE PRIMEUR,REMISE,-939.0
20/07/2021,20,,20,,Unknown,,EPI SERVICE PRIMEUR,TPV,-959.0
20/07/2021,07,,07,,Unknown,,EPI SERVICE PRIMEUR,CARTE,-966.0
20/07/2021,19,,19,,Unknown,,EPI SERVICE PRIMEUR,PEAGE AUTOROUTE,-985.0
20/07/2021,07,,07,,Unknown,,EPI SERVICE PRIMEUR,CARTE,-992.0
20/07/2021,19,,19,,Unknown,,EPI SERVICE PRIMEUR,Sapn,-1011.0
20/07/2021,07,,07,,Unknown,,EPI SERVICE PRIMEUR,GRAND CO,-1018.0
20/07/2021,20,,20,,Unknown,,EPI SERVICE PRIMEUR,CARTE,-1038.0
20/07/2021,07,,07,,Unknown,,EPI SERVICE PRIMEUR,CARTE,-1045.0
20/07/2021,20,,20,,Unknown,,EPI SERVICE PRIMEUR,CARTE,-1065.0
20/07/2021,07,,07,,Unknown,,EPI SERVICE PRIMEUR,PARIS 20/07/2021 COM,-1072.0
20/07/2021,20,,20,,Unknown,,EPI SERVICE PRIMEUR,CARTES,-1092.0
21/07/2021,07,,07,,Unknown,,EPI SERVICE PRIMEUR,COM,-1099.0
21/07/2021,18,,18,,Unknown,,EPI SERVICE PRIMEUR,CARTES,-1117.0
21/07/2021,07,,07,,Unknown,,EPI SERVICE PRIMEUR,COM,-1124.0
,20,,20,,Unknown,,EPI SERVICE PRIMEUR,CARTES 0386405,-1144.0
,07,,07,,Unknown,,EPI SERVICE PRIMEUR,COM,-1151.0
,18,,18,,Unknown,,EPI SERVICE PRIMEUR,CARTES,-1169.0
,07,,07,,Unknown,,EPI SERVICE PRIMEUR,COM,-1176.0
,20,,20,,Unknown,,EPI SERVICE PRIMEUR,CARTES,-1196.0
,07,,07,,Unknown,,EPI SERVICE PRIMEUR,COM,-1203.0
,18,,18,,Unknown,,EPI SERVICE PRIMEUR,CARTES 0386405,-1221.0
,07,,07,,Unknown,,EPI SERVICE PRIMEUR,GERE ET025137103,-1228.0
,20,,20,,Unknown,,EPI SERVICE PRIMEUR,FR67010451697 973C7349C0574126A157041022321014,-1248.0
,07,,07,,Unknown,,EPI SERVICE PRIMEUR,REMISE,-1255.0
,19,,19,,Unknown,,EPI SERVICE PRIMEUR,REMISE,-1274.0
,07,,07,,Unknown,,EPI SERVICE PRIMEUR,TPV,-1281.0
,20,,20,,Unknown,,EPI SERVICE PRIMEUR,REMISE,-1301.0
,07,,07,,Unknown,,EPI SERVICE PRIMEUR,TPV,-1308.0
,19,,19,,Unknown,,EPI SERVICE PRIMEUR,REMISE,-1327.0
,07,,07,,Unknown,,EPI SERVICE PRIMEUR,TPV,-1334.0
,20,,20,,Unknown,,EPI SERVICE PRIMEUR,CARTE,-1354.0
,07,,07,,Unknown,,EPI SERVICE PRIMEUR,COM,-1361.0
,64,,64,,Unknown,,EPI SERVICE PRIMEUR,CARTES,-1425.0
,20,,20,,Unknown,,EPI SERVICE PRIMEUR,COM,-1445.0
,07,,07,,Unknown,,EPI SERVICE PRIMEUR,CARTES,-1452.0
,01,,01,,Unknown,,EPI SERVICE PRIMEUR,,-1453.0
,20,,20,,Unknown,,EPI SERVICE PRIMEUR,,-1473.0
,07,,07,,Unknown,,EPI SERVICE PRIMEUR,,-1480.0
,64,,64,,Unknown,,EPI SERVICE PRIMEUR,,-1544.0
,20,,20,,Unknown,,EPI SERVICE PRIMEUR,,-1564.0
,07,,07,,Unknown,,EPI SERVICE PRIMEUR,,-1571.0
,01,,01,,Unknown,,EPI SERVICE PRIMEUR,,-1572.0
,20,,20,,Unknown,,EPI SERVICE PRIMEUR,,-1592.0
,07,,07,,Unknown,,EPI SERVICE PRIMEUR,,-1599.0
,64,,64,,Unknown,,EPI SERVICE PRIMEUR,,-1663.0
,20,,20,,Unknown,,EPI SERVICE PRIMEUR,,-1683.0
,07,,07,,Unknown,,EPI SERVICE PRIMEUR,,-1690.0
,64,,64,,Unknown,,EPI SERVICE PRIMEUR,,-1754.0
,20,,20,,Unknown,,EPI SERVICE PRIMEUR,,-1774.0
,07,,07,,Unknown,,EPI SERVICE PRIMEUR,,-1781.0
,20,,20,,Unknown,,EPI SERVICE PRIMEUR,,-1801.0
,07,,07,,Unknown,,EPI SERVICE PRIMEUR,,-1808.0
,20,,20,,Unknown,,EPI SERVICE PRIMEUR,,-1828.0
,07,,07,,Unknown,,EPI SERVICE PRIMEUR,,-1835.0
,20,,20,,Unknown,,EPI SERVICE PRIMEUR,,-1855.0
,07,,07,,Unknown,,EPI SERVICE PRIMEUR,,-1862.0
,20,,20,,Unknown,,EPI SERVICE PRIMEUR,,-1882.0
,07,,07,,Unknown,,EPI SERVICE PRIMEUR,,-1889.0
,20,,20,,Unknown,,EPI SERVICE PRIMEUR,,-1909.0
,07,,07,,Unknown,,EPI SERVICE PRIMEUR,,-1916.0
,21,,21,,Unknown,,EPI SERVICE PRIMEUR,,-1937.0
,07,,07,,Unknown,,EPI SERVICE PRIMEUR,,-1944.0
,20,,20,,Unknown,,EPI SERVICE PRIMEUR,,-1964.0
,07,,07,,Unknown,,EPI SERVICE PRIMEUR,,-1971.0
,8 21,,8 21,,Unknown,,EPI SERVICE PRIMEUR,,-2792.0
,07,,07,,Unknown,,EPI SERVICE PRIMEUR,,-2799.0
,64,,64,,Unknown,,EPI SERVICE PRIMEUR,,-2863.0
,21,,21,,Unknown,,EPI SERVICE PRIMEUR,,-2884.0
,07,,07,,Unknown,,EPI SERVICE PRIMEUR,,-2891.0
,01,,01,,Unknown,,EPI SERVICE PRIMEUR,,-2892.0
,"467,99",,"467,99",,Unknown,,EPI SERVICE PRIMEUR,,-49691.0
,19,,19,,Unknown,,EPI SERVICE PRIMEUR,,-49710.0
,"07 491,00",,"07 491,00",,Unknown,,EPI SERVICE PRIMEUR,,-798810.0
,19,,19,,Unknown,,EPI SERVICE PRIMEUR,,-798829.0
,"07 491,00",,"07 491,00",,Unknown,,EPI SERVICE PRIMEUR,,-1547929.0
,19,,19,,Unknown,,EPI SERVICE PRIMEUR,,-1547948.0
,"07 491,00",,"07 491,00",,Unknown,,EPI SERVICE PRIMEUR,,-2297048.0
,20,,20,,Unknown,,EPI SERVICE PRIMEUR,,-2297068.0
,07 20,,07 20,,Unknown,,EPI SERVICE PRIMEUR,,-2297788.0
,07 20,,07 20,,Unknown,,EPI SERVICE PRIMEUR,,-2298508.0
,07 20,,07 20,,Unknown,,EPI SERVICE PRIMEUR,,-2299228.0
,07 20,,07 20,,Unknown,,EPI SERVICE PRIMEUR,,-2299948.0
,07 20,,07 20,,Unknown,,EPI SERVICE PRIMEUR,,-2300668.0
,07 20,,07 20,,Unknown,,EPI SERVICE PRIMEUR,,-2301388.0
,07 20,,07 20,,Unknown,,EPI SERVICE PRIMEUR,,-2302108.0
,07 20,,07 20,,Unknown,,EPI SERVICE PRIMEUR,,-2302828.0
,07 20,,07 20,,Unknown,,EPI SERVICE PRIMEUR,,-2303548.0
,07 20,,07 20,,Unknown,,EPI SERVICE PRIMEUR,,-2304268.0
,07 20,,07 20,,Unknown,,EPI SERVICE PRIMEUR,,-2304988.0
,07 20,,07 20,,Unknown,,EPI SERVICE PRIMEUR,,-2305708.0
,07 20,,07 20,,Unknown,,EPI SERVICE PRIMEUR,,-2306428.0
,07 20,,07 20,,Unknown,,EPI SERVICE PRIMEUR,,-2307148.0
,07 20,,07 20,,Unknown,,EPI SERVICE PRIMEUR,,-2307868.0
,07 20,,07 20,,Unknown,,EPI SERVICE PRIMEUR,,-2308588.0
,07 20,,07 20,,Unknown,,EPI SERVICE PRIMEUR,,-2309308.0
,07 20,,07 20,,Unknown,,EPI SERVICE PRIMEUR,,-2310028.0
,07 18,,07 18,,Unknown,,EPI SERVICE PRIMEUR,,-2310746.0
,"60 274,70",,"60 274,70",,Unknown,,EPI SERVICE PRIMEUR,,-8338216.0
,"71,50",,"71,50",,Unknown,,EPI SERVICE PRIMEUR,,-8345366.0
,"84,50",,"84,50",,Unknown,,EPI SERVICE PRIMEUR,,-8353816.0
,"147,30",,"147,30",,Unknown,,EPI SERVICE PRIMEUR,,-8368546.0
,"83,50",,"83,50",,Unknown,,EPI SERVICE PRIMEUR,,-8376896.0
,"40,32",,"40,32",,Unknown,,EPI SERVICE PRIMEUR,,-8380928.0
,"7,70",,"7,70",,Unknown,,EPI SERVICE PRIMEUR,,-8381698.0
,"11,50",,"11,50",,Unknown,,EPI SERVICE PRIMEUR,,-8382848.0
,"29,50",,"29,50",,Unknown,,EPI SERVICE PRIMEUR,,-8385798.0
,"000,00",,"000,00",,Unknown,,EPI SERVICE PRIMEUR,,-8385798.0
,"100,00",,"100,00",,Unknown,,EPI SERVICE PRIMEUR,,-8395798.0
,"1,74",,"1,74",,Unknown,,EPI SERVICE PRIMEUR,,-8395972.0
,"2,10",,"2,10",,Unknown,,EPI SERVICE PRIMEUR,,-8396182.0
,"1,08",,"1,08",,Unknown,,EPI SERVICE PRIMEUR,,-8396290.0
,"0,24",,"0,24",,Unknown,,EPI SERVICE PRIMEUR,,-8396314.0
,"0,80",,"0,80",,Unknown,,EPI SERVICE PRIMEUR,,-8396394.0
,"0,06",,"0,06",,Unknown,,EPI SERVICE PRIMEUR,,-8396400.0
,"112,26",,"112,26",,Unknown,,EPI SERVICE PRIMEUR,,-8407626.0
,20,,20,,Unknown,,EPI SERVICE PRIMEUR,,-8407646.0
,"07 613,58",,"07 613,58",,Unknown,,EPI SERVICE PRIMEUR,,-9169004.0
,1 21,,1 21,,Unknown,,EPI SERVICE PRIMEUR,,-9169125.0
,07,,07,,Unknown,,EPI SERVICE PRIMEUR,,-9169132.0
,21,,21,,Unknown,,EPI SERVICE PRIMEUR,,-9169153.0
,07 21,,07 21,,Unknown,,EPI SERVICE PRIMEUR,,-9169874.0
,07,,07,,Unknown,,EPI SERVICE PRIMEUR,,-9169881.0
,21,,21,,Unknown,,EPI SERVICE PRIMEUR,,-9169902.0
,07,,07,,Unknown,,EPI SERVICE PRIMEUR,,-9169909.0
,8 21,,8 21,,Unknown,,EPI SERVICE PRIMEUR,,-9170730.0
,07,,07,,Unknown,,EPI SERVICE PRIMEUR,,-9170737.0
,8 21,,8 21,,Unknown,,EPI SERVICE PRIMEUR,,-9171558.0
,07,,07,,Unknown,,EPI SERVICE PRIMEUR,,-9171565.0
,21,,21,,Unknown,,EPI SERVICE PRIMEUR,,-9171586.0
,07 70,,07 70,,Unknown,,EPI SERVICE PRIMEUR,,-9172356.0
,"90 244,20",,"90 244,20",,Unknown,,EPI SERVICE PRIMEUR,,-18196776.0
,"60,90",,"60,90",,Unknown,,EPI SERVICE PRIMEUR,,-18202866.0
,"329,20",,"329,20",,Unknown,,EPI SERVICE PRIMEUR,,-18235786.0
,"19,99",,"19,99",,Unknown,,EPI SERVICE PRIMEUR,,-18237785.0
,"1,96",,"1,96",,Unknown,,EPI SERVICE PRIMEUR,,-18237981.0
,"1,23",,"1,23",,Unknown,,EPI SERVICE PRIMEUR,,-18238104.0
01/08/2021,01,,01,,Cheque,,Transactions,Relevés bancaires,-1.0
31/08/2021,08,,08,,Cheque,,Transactions,Du,-9.0
01/08/2021,31,,31,,Cheque,,Transactions,EGB 2,-40.0
31/08/2021,08,,08,,Cheque,,Transactions,Coulommiers,-48.0
,2,,2,,Cheque,,Transactions,France Solde,-50.0
,01,,01,,Cheque,,Transactions,Entrées,-51.0
,08,,08,,Cheque,,Transactions,Sorties IBAN,-59.0
,"1 055,55",,"1 055,55",,Cheque,,Transactions,QNTOFRPIXXX Solde,-105614.0
,"1 626,00",,"1 626,00",,Cheque,,Transactions,Date,-268214.0
,"2 555,93",,"2 555,93",,Cheque,,Transactions,SOURDUNE FR,-523807.0
,205,,205,,Cheque,,Transactions,ANAIS,-524012.0
,31,,31,,Cheque,,Transactions,FERTE G FR,-524043.0
,"08 125,62",,"08 125,62",,Cheque,,Transactions,LECLERC,-1336605.0
,01,,01,,Cheque,,Transactions,DELICES 77,-1336606.0
,08,,08,,Cheque,,Transactions,LA POSTE 779240,-1336614.0
,"42,00",,"42,00",,Cheque,,Transactions,TEMPLIERS,-1340814.0
,03,,03,,Cheque,,Transactions,LECLERC,-1340817.0
,08,,08,,Cheque,,Transactions,MC DONALD'S COULOMMIER,-1340825.0
,"88,09",,"88,09",,Cheque,,Transactions,HERVE Depot,-1349634.0
,03,,03,,Cheque,,Transactions,MAGNANI Depot,-1349637.0
,08,,08,,Cheque,,Transactions,Qonto,-1349645.0
,"110,00",,"110,00",,Cheque,,Transactions,Frais,-1360645.0
,03,,03,,Cheque,,Transactions,EGB,-1360648.0
,08,,08,,Cheque,,Transactions,,-1360656.0
,"15,00",,"15,00",,Cheque,,Transactions,,-1362156.0
,03,,03,,Cheque,,Transactions,,-1362159.0
,08,,08,,Cheque,,Transactions,,-1362167.0
,0,,0,,Cheque,,Transactions,,-1362167.0
,"17,00",,"17,00",,Cheque,,Transactions,,-1363867.0
,04,,04,,Cheque,,Transactions,,-1363871.0
,08,,08,,Cheque,,Transactions,,-1363879.0
,"100,00",,"100,00",,Cheque,,Transactions,,-1373879.0
,04,,04,,Cheque,,Transactions,,-1373883.0
,08,,08,,Cheque,,Transactions,,-1373891.0
,77,,77,,Cheque,,Transactions,,-1373968.0
,"28,00",,"28,00",,Cheque,,Transactions,,-1376768.0
,05,,05,,Cheque,,Transactions,,-1376773.0
,08,,08,,Cheque,,Transactions,,-1376781.0
,"1,76",,"1,76",,Cheque,,Transactions,,-1376957.0
,05,,05,,Cheque,,Transactions,,-1376962.0
,08,,08,,Cheque,,Transactions,,-1376970.0
,"79,78",,"79,78",,Cheque,,Transactions,,-1384948.0
,05,,05,,Cheque,,Transactions,,-1384953.0
,08,,08,,Cheque,,Transactions,,-1384961.0
,"103,72",,"103,72",,Cheque,,Transactions,,-1395333.0
,06,,06,,Cheque,,Transactions,,-1395339.0
,08,,08,,Cheque,,Transactions,,-1395347.0
,"294,87",,"294,87",,Cheque,,Transactions,,-1424834.0
,06,,06,,Cheque,,Transactions,,-1424840.0
,08,,08,,Cheque,,Transactions,,-1424848.0
,"35,00",,"35,00",,Cheque,,Transactions,,-1428348.0
,06,,06,,Cheque,,Transactions,,-1428354.0
,08,,08,,Cheque,,Transactions,,-1428362.0
,"22,50",,"22,50",,Cheque,,Transactions,,-1430612.0
,09,,09,,Cheque,,Transactions,,-1430621.0
,08,,08,,Cheque,,Transactions,,-1430629.0
,"336,00",,"336,00",,Cheque,,Transactions,,-1464229.0
,09,,09,,Cheque,,Transactions,,-1464238.0
,08,,08,,Cheque,,Transactions,,-1464246.0
,"240,00",,"240,00",,Cheque,,Transactions,,-1488246.0
,09,,09,,Cheque,,Transactions,,-1488255.0
,08,,08,,Cheque,,Transactions,,-1488263.0
,"144,00",,"144,00",,Cheque,,Transactions,,-1502663.0
,09,,09,,Cheque,,Transactions,,-1502672.0
,08,,08,,Cheque,,Transactions,,-1502680.0
,"2,40",,"2,40",,Cheque,,Transactions,,-1502920.0
,01,,01,,Cheque,,Transactions,,-1502921.0
,08,,08,,Cheque,,Transactions,,-1502929.0
,31,,31,,Cheque,,Transactions,,-1502960.0
,08,,08,,Cheque,,Transactions,,-1502968.0
,205,,205,,Cheque,,Transactions,,-1503173.0
,1,,1,,Cheque,,Transactions,,-1503174.0
,3,,3,,Cheque,,Transactions,,-1503177.0
01/08/2021,,09,,,Cheque,,VIVA,Oonto,9.0
31/08/2021,,08,,,Cheque,,VIVA,Abonnement Frais,17.0
,,"2,40",,,Cheque,,VIVA,Oonto,257.0
,,09,,,Cheque,,VIVA,Abonnement,266.0
,,08,,,Cheque,,VIVA,Frais,274.0
,,"2,40",,,Cheque,,VIVA,P073087196,514.0
,,10,,,Cheque,,VIVA,ALVES,524.0
,,08,,,Cheque,,VIVA,Depôt,532.0
,,"29,99",,,Cheque,,VIVA,MIETTE,3531.0
,,10,,,Cheque,,VIVA,Depôt,3541.0
,,08,,,Cheque,,VIVA,FOUCHER Dépôt,3549.0
,,"255,00",,,Cheque,,VIVA,Oonto,29049.0
,,10,,,Cheque,,VIVA,Abonnement Frais,29059.0
,,08,,,Cheque,,VIVA,Oonto,29067.0
,,"376,00",,,Cheque,,VIVA,Abonnement Frais,66667.0
,,10,,,Cheque,,VIVA,Oonto,66677.0
,,08,,,Cheque,,VIVA,Abonnement,66685.0
,,"275,00",,,Cheque,,VIVA,Frais,94185.0
,,10,,,Cheque,,VIVA,SANEF SENLIS,94195.0
,,08,,,Cheque,,VIVA,NEWCO,94203.0
,,"2,40",,,Cheque,,VIVA,GERMIA LL PRISHTINA,94443.0
,,10,,,Cheque,,VIVA,ARSENAL 2,94453.0
,,08,,,Cheque,,VIVA,BEKA,94461.0
,,"2,40",,,Cheque,,VIVA,VIVA FRESH,94701.0
,,10,,,Cheque,,VIVA,BOUYGTEL VAD,94711.0
,,08,,,Cheque,,VIVA,BEKA,94719.0
,,"2,40",,,Cheque,,VIVA,EGB,94959.0
,,11,,,Cheque,,VIVA,,94970.0
,,08,,,Cheque,,VIVA,,94978.0
,,"22,50",,,Cheque,,VIVA,,97228.0
,,11,,,Cheque,,VIVA,,97239.0
,,08,,,Cheque,,VIVA,,97247.0
,,"7,60",,,Cheque,,VIVA,,98007.0
,,17,,,Cheque,,VIVA,,98024.0
,,08,,,Cheque,,VIVA,,98032.0
,,"86,00",,,Cheque,,VIVA,,106632.0
,,20,,,Cheque,,VIVA,,106652.0
,,08,,,Cheque,,VIVA,,106660.0
,,2,,,Cheque,,VIVA,,106662.0
,,"124,00",,,Cheque,,VIVA,,119062.0
,,23,,,Cheque,,VIVA,,119085.0
,,08,,,Cheque,,VIVA,,119093.0
,,"30,61",,,Cheque,,VIVA,,122154.0
,,23,,,Cheque,,VIVA,,122177.0
,,08,,,Cheque,,VIVA,,122185.0
,,"49,50",,,Cheque,,VIVA,,127135.0
,,23,,,Cheque,,VIVA,,127158.0
,,08,,,Cheque,,VIVA,,127166.0
,,"10,39",,,Cheque,,VIVA,,128205.0
,,24,,,Cheque,,VIVA,,128229.0
,,08,,,Cheque,,VIVA,,128237.0
,,"122,00",,,Cheque,,VIVA,,140437.0
,,24,,,Cheque,,VIVA,,140461.0
,,08,,,Cheque,,VIVA,,140469.0
,,"237,78",,,Cheque,,VIVA,,164247.0
,,24,,,Cheque,,VIVA,,164271.0
,,08,,,Cheque,,VIVA,,164279.0
,,"11,90",,,Cheque,,VIVA,,165469.0
,,24,,,Cheque,,VIVA,,165493.0
,,08,,,Cheque,,VIVA,,165501.0
,,"149,56",,,Cheque,,VIVA,,180457.0
,,26,,,Cheque,,VIVA,,180483.0
,,08,,,Cheque,,VIVA,,180491.0
,,"73,99",,,Cheque,,VIVA,,187890.0
,,26,,,Cheque,,VIVA,,187916.0
,,08,,,Cheque,,VIVA,,187924.0
,,"82,97",,,Cheque,,VIVA,,196221.0
,,26,,,Cheque,,VIVA,,196247.0
,,08,,,Cheque,,VIVA,,196255.0
,,"92,40",,,Cheque,,VIVA,,205495.0
,,26,,,Cheque,,VIVA,,205521.0
,,08,,,Cheque,,VIVA,,205529.0
,,"30,17",,,Cheque,,VIVA,,208546.0
,,01,,,Cheque,,VIVA,,208547.0
,,08,,,Cheque,,VIVA,,208555.0
,,31,,,Cheque,,VIVA,,208586.0
,,08,,,Cheque,,VIVA,,208594.0
,,205,,,Cheque,,VIVA,,208799.0
,,2,,,Cheque,,VIVA,,208801.0
,,3,,,Cheque,,VIVA,,208804.0
01/08/2021,,27,,,Unknown,,JP PUTEVI,Carte,27.0
31/08/2021,,08,,,Unknown,,JP PUTEVI,A3,35.0
,,13,,,Unknown,,JP PUTEVI,A3,48.0
,,117,,,Unknown,,JP PUTEVI,TOTALDALTYSA4,165.0
,,"1,00",,,Unknown,,JP PUTEVI,JP PUTEVI,265.0
,,"8,70",,,Unknown,,JP PUTEVI,SID,1135.0
,,"020,00",,,Unknown,,JP PUTEVI,SID,3135.0
,,28,,,Unknown,,JP PUTEVI,SANEF SENLIS,3163.0
,,08,,,Unknown,,JP PUTEVI,MC DONALD'S COULOMMIER,3171.0
,,1,,,Unknown,,JP PUTEVI,SANEF AUTOROUTE,3172.0
,,"17,15",,,Unknown,,JP PUTEVI,Qonto,4887.0
,,"128,00",,,Unknown,,JP PUTEVI,Apple Pay,17687.0
,,28,,,Unknown,,JP PUTEVI,Oonto,17715.0
,,08,,,Unknown,,JP PUTEVI,La Fayette,17723.0
,,7,,,Unknown,,JP PUTEVI,Paris RCS Paris,17730.0
,,1 00,,,Unknown,,JP PUTEVI,Olinda,17830.0
,,"0,94",,,Unknown,,JP PUTEVI,|'Autonte,17924.0
,,"7,00",,,Unknown,,JP PUTEVI,Contrôle Prudentiel,18624.0
,,29,,,Unknown,,JP PUTEVI,Resolution,18653.0
,,08,,,Unknown,,JP PUTEVI,ACPR)en,18661.0
,,0,,,Unknown,,JP PUTEVI,EGB,18661.0
,,"163,19",,,Unknown,,JP PUTEVI,,34980.0
,,30,,,Unknown,,JP PUTEVI,,35010.0
,,08,,,Unknown,,JP PUTEVI,,35018.0
,,"7,60",,,Unknown,,JP PUTEVI,,35778.0
,,30,,,Unknown,,JP PUTEVI,,35808.0
,,08,,,Unknown,,JP PUTEVI,,35816.0
,,"2,00",,,Unknown,,JP PUTEVI,,36016.0
,,30,,,Unknown,,JP PUTEVI,,36046.0
,,08,,,Unknown,,JP PUTEVI,,36054.0
,,"12,50",,,Unknown,,JP PUTEVI,,37304.0
,,31,,,Unknown,,JP PUTEVI,,37335.0
,,08,,,Unknown,,JP PUTEVI,,37343.0
,,3,,,Unknown,,JP PUTEVI,,37346.0
,,117,,,Unknown,,JP PUTEVI,,37463.0
,,1 00,,,Unknown,,JP PUTEVI,,37563.0
,,"3,58",,,Unknown,,JP PUTEVI,,37921.0
,,"420,00",,,Unknown,,JP PUTEVI,,79921.0
,,31,,,Unknown,,JP PUTEVI,,79952.0
,,08,,,Unknown,,JP PUTEVI,,79960.0
,,74,,,Unknown,,JP PUTEVI,,80034.0
,,"64,99",,,Unknown,,JP PUTEVI,,86533.0
,,31,,,Unknown,,JP PUTEVI,,86564.0
,,08,,,Unknown,,JP PUTEVI,,86572.0
,,"16,00",,,Unknown,,JP PUTEVI,,88172.0
,,31,,,Unknown,,JP PUTEVI,,88203.0
,,08,,,Unknown,,JP PUTEVI,,88211.0
,,"22,50",,,Unknown,,JP PUTEVI,,90461.0
,,31,,,Unknown,,JP PUTEVI,,90492.0
,,08,,,Unknown,,JP PUTEVI,,90500.0
,,"9,10",,,Unknown,,JP PUTEVI,,91410.0
,,31,,,Unknown,,JP PUTEVI,,91441.0
,,08,,,Unknown,,JP PUTEVI,,91449.0
,,"70,05",,,Unknown,,JP PUTEVI,,98454.0
,,31,,,Unknown,,JP PUTEVI,,98485.0
,,08,,,Unknown,,JP PUTEVI,,98493.0
,,"39,55",,,Unknown,,JP PUTEVI,,102448.0
,,31,,,Unknown,,JP PUTEVI,,102479.0
,,08,,,Unknown,,JP PUTEVI,,102487.0
,,"4,60",,,Unknown,,JP PUTEVI,,102947.0
,,250 995 35,,,Unknown,,JP PUTEVI,,25202482.0
,,20,,,Unknown,,JP PUTEVI,,25202502.0
,,819 489 626,,,Unknown,,JP PUTEVI,,844692128.0
,,01,,,Unknown,,JP PUTEVI,,844692129.0
,,08,,,Unknown,,JP PUTEVI,,844692137.0
,,31,,,Unknown,,JP PUTEVI,,844692168.0
,,08,,,Unknown,,JP PUTEVI,,844692176.0
,,205,,,Unknown,,JP PUTEVI,,844692381.0
,,3,,,Unknown,,JP PUTEVI,,844692384.0
,,3,,,Unknown,,JP PUTEVI,,844692387.0
,,1,,,Unknown,,Banque Inconnue,cid:22)(cid:23)(cid:24,1.0
,,2,,,Unknown,,Banque Inconnue,cid:15)(cid:2)(cid:1)(cid:2)(cid:34)(cid:34)(cid:34)(cid:19)(cid:33)(cid:37)(cid:2)(cid:44,3.0
,,3,,,Unknown,,Banque Inconnue,cid:25)(cid:24)(cid:26)(cid:27)(cid:28)(cid:2)(cid:28)(cid:3)(cid:16)(cid:32)(cid:2)(cid:17)(cid:32)(cid:33)(cid:34)(cid:2)(cid:35)(cid:18)(cid:18)(cid:18)(cid:2)(cid:18)(cid:17)(cid:33)(cid:35)(cid:2)(cid:17)(cid:1)(cid:36)(cid:37)(cid:2)(cid:33)(cid:35)(cid:33)(cid:1)(cid:2)(cid:1)(cid:18)(cid:34,6.0
,,2,,,Unknown,,Banque Inconnue,cid:24)(cid:25)(cid:29)(cid:28)(cid:2)(cid:38)(cid:8)(cid:10)(cid:11)(cid:28)(cid:3)(cid:39)(cid:17)(cid:40)(cid:40)(cid:40,8.0
,,4,,,Unknown,,Banque Inconnue,,12.0
,,5,,,Unknown,,Banque Inconnue,,17.0
,,6,,,Unknown,,Banque Inconnue,,23.0
,,7,,,Unknown,,Banque Inconnue,,30.0
,,8,,,Unknown,,Banque Inconnue,,38.0
,,9,,,Unknown,,Banque Inconnue,,47.0
,,10,,,Unknown,,Banque Inconnue,,57.0
,,11,,,Unknown,,Banque Inconnue,,68.0
,,9,,,Unknown,,Banque Inconnue,,77.0
,,12,,,Unknown,,Banque Inconnue,,89.0
,,13,,,Unknown,,Banque Inconnue,,102.0
,,2,,,Unknown,,Banque Inconnue,,104.0
,,6,,,Unknown,,Banque Inconnue,,110.0
,,14,,,Unknown,,Banque Inconnue,,124.0
,,15,,,Unknown,,Banque Inconnue,,139.0
,,7,,,Unknown,,Banque Inconnue,,146.0
,,16,,,Unknown,,Banque Inconnue,,162.0
,,17,,,Unknown,,Banque Inconnue,,179.0
,,18,,,Unknown,,Banque Inconnue,,197.0
,,16,,,Unknown,,Banque Inconnue,,213.0
,,19,,,Unknown,,Banque Inconnue,,232.0
,,18,,,Unknown,,Banque Inconnue,,250.0
,,20,,,Unknown,,Banque Inconnue,,270.0
,,16,,,Unknown,,Banque Inconnue,,286.0
,,20,,,Unknown,,Banque Inconnue,,306.0
,,17,,,Unknown,,Banque Inconnue,,323.0
,,7,,,Unknown,,Banque Inconnue,,330.0
,,9,,,Unknown,,Banque Inconnue,,339.0
,,15,,,Unknown,,Banque Inconnue,,354.0
,,7,,,Unknown,,Banque Inconnue,,361.0
,,21,,,Unknown,,Banque Inconnue,,382.0
,,17,,,Unknown,,Banque Inconnue,,399.0
,,18,,,Unknown,,Banque Inconnue,,417.0
,,16,,,Unknown,,Banque Inconnue,,433.0
,,19,,,Unknown,,Banque Inconnue,,452.0
,,18,,,Unknown,,Banque Inconnue,,470.0
,,20,,,Unknown,,Banque Inconnue,,490.0
,,16,,,Unknown,,Banque Inconnue,,506.0
,,20,,,Unknown,,Banque Inconnue,,526.0
,,17,,,Unknown,,Banque Inconnue,,543.0
,,22,,,Unknown,,Banque Inconnue,,565.0
,,23,,,Unknown,,Banque Inconnue,,588.0
,,24,,,Unknown,,Banque Inconnue,,612.0
,,30,,,Unknown,,Banque Inconnue,,642.0
,,31,,,Unknown,,Banque Inconnue,,673.0
,,3,,,Unknown,,Banque Inconnue,,676.0
,,32,,,Unknown,,Banque Inconnue,,708.0
,,2,,,Unknown,,Banque Inconnue,,710.0
,,7,,,Unknown,,Banque Inconnue,,717.0
,,9,,,Unknown,,Banque Inconnue,,726.0
,,15,,,Unknown,,Banque Inconnue,,741.0
,,7,,,Unknown,,Banque Inconnue,,748.0
,,16,,,Unknown,,Banque Inconnue,,764.0
,,17,,,Unknown,,Banque Inconnue,,781.0
,,18,,,Unknown,,Banque Inconnue,,799.0
,,16,,,Unknown,,Banque Inconnue,,815.0
,,19,,,Unknown,,Banque Inconnue,,834.0
,,33,,,Unknown,,Banque Inconnue,,867.0
,,7,,,Unknown,,Banque Inconnue,,874.0
,,17,,,Unknown,,Banque Inconnue,,891.0
,,7,,,Unknown,,Banque Inconnue,,898.0
,,16,,,Unknown,,Banque Inconnue,,914.0
,,34,,,Unknown,,Banque Inconnue,,948.0
,,34,,,Unknown,,Banque Inconnue,,982.0
,,35,,,Unknown,,Banque Inconnue,,1017.0
,,34,,,Unknown,,Banque Inconnue,,1051.0
,,34,,,Unknown,,Banque Inconnue,,1085.0
,,7,,,Unknown,,Banque Inconnue,,1092.0
,,36,,,Unknown,,Banque Inconnue,,1128.0
,,1,,,Unknown,,Banque Inconnue,,1129.0
,,2,,,Unknown,,Banque Inconnue,,1131.0
,,3,,,Unknown,,Banque Inconnue,,1134.0
,,4,,,Unknown,,Banque Inconnue,,1138.0
,,5,,,Unknown,,Banque Inconnue,,1143.0
,,2,,,Unknown,,Banque Inconnue,,1145.0
,,6,,,Unknown,,Banque Inconnue,,1151.0
,,7,,,Unknown,,Banque Inconnue,,1158.0
,,8,,,Unknown,,Banque Inconnue,,1166.0
,,9,,,Unknown,,Banque Inconnue,,1175.0
,,10,,,Unknown,,Banque Inconnue,,1185.0
,,11,,,Unknown,,Banque Inconnue,,1196.0
,,8,,,Unknown,,Banque Inconnue,,1204.0
,,2,,,Unknown,,Banque Inconnue,,1206.0
,,12,,,Unknown,,Banque Inconnue,,1218.0
,,13,,,Unknown,,Banque Inconnue,,1231.0
,,4,,,Unknown,,Banque Inconnue,,1235.0
,,3,,,Unknown,,Banque Inconnue,,1238.0
,,12,,,Unknown,,Banque Inconnue,,1250.0
,,13,,,Unknown,,Banque Inconnue,,1263.0
,,7,,,Unknown,,Banque Inconnue,,1270.0
,,14,,,Unknown,,Banque Inconnue,,1284.0
,,14,,,Unknown,,Banque Inconnue,,1298.0
,,2,,,Unknown,,Banque Inconnue,,1300.0
,,15,,,Unknown,,Banque Inconnue,,1315.0
,,2,,,Unknown,,Banque Inconnue,,1317.0
,,5,,,Unknown,,Banque Inconnue,,1322.0
,,30,,,Unknown,,Banque Inconnue,,1352.0
,,41,,,Unknown,,Banque Inconnue,,1393.0
,,26,,,Unknown,,Banque Inconnue,,1419.0
,,42,,,Unknown,,Banque Inconnue,,1461.0
,,25,,,Unknown,,Banque Inconnue,,1486.0
,,27,,,Unknown,,Banque Inconnue,,1513.0
,,43,,,Unknown,,Banque Inconnue,,1556.0
,,2,,,Unknown,,Banque Inconnue,,1558.0
,,17,,,Unknown,,Banque Inconnue,,1575.0
,,2,,,Unknown,,Banque Inconnue,,1577.0
,,32,,,Unknown,,Banque Inconnue,,1609.0
,,1,,,Unknown,,Banque Inconnue,,1610.0
,,32,,,Unknown,,Banque Inconnue,,1642.0
,,19,,,Unknown,,Banque Inconnue,,1661.0
,,18,,,Unknown,,Banque Inconnue,,1679.0
,,18,,,Unknown,,Banque Inconnue,,1697.0
,,2,,,Unknown,,Banque Inconnue,,1699.0
,,44,,,Unknown,,Banque Inconnue,,1743.0
,,16,,,Unknown,,Banque Inconnue,,1759.0
,,16,,,Unknown,,Banque Inconnue,,1775.0
,,17,,,Unknown,,Banque Inconnue,,1792.0
,,1,,,Unknown,,Banque Inconnue,,1793.0
,,18,,,Unknown,,Banque Inconnue,,1811.0
,,19,,,Unknown,,Banque Inconnue,,1830.0
,,2,,,Unknown,,Banque Inconnue,,1832.0
,,12,,,Unknown,,Banque Inconnue,,1844.0
,,20,,,Unknown,,Banque Inconnue,,1864.0
,,21,,,Unknown,,Banque Inconnue,,1885.0
,,22,,,Unknown,,Banque Inconnue,,1907.0
,,20,,,Unknown,,Banque Inconnue,,1927.0
,,23,,,Unknown,,Banque Inconnue,,1950.0
,,23,,,Unknown,,Banque Inconnue,,1973.0
,,24,,,Unknown,,Banque Inconnue,,1997.0
,,25,,,Unknown,,Banque Inconnue,,2022.0
,,26,,,Unknown,,Banque Inconnue,,2048.0
,,27,,,Unknown,,Banque Inconnue,,2075.0
,,19,,,Unknown,,Banque Inconnue,,2094.0
,,2,,,Unknown,,Banque Inconnue,,2096.0
,,28,,,Unknown,,Banque Inconnue,,2124.0
,,26,,,Unknown,,Banque Inconnue,,2150.0
,,29,,,Unknown,,Banque Inconnue,,2179.0
,,30,,,Unknown,,Banque Inconnue,,2209.0
,,31,,,Unknown,,Banque Inconnue,,2240.0
,,25,,,Unknown,,Banque Inconnue,,2265.0
,,9,,,Unknown,,Banque Inconnue,,2274.0
,,20,,,Unknown,,Banque Inconnue,,2294.0
,,26,,,Unknown,,Banque Inconnue,,2320.0
,,41,,,Unknown,,Banque Inconnue,,2361.0
,,24,,,Unknown,,Banque Inconnue,,2385.0
,,25,,,Unknown,,Banque Inconnue,,2410.0
,,27,,,Unknown,,Banque Inconnue,,2437.0
,,15,,,Unknown,,Banque Inconnue,,2452.0
,,2,,,Unknown,,Banque Inconnue,,2454.0
,,1,,,Unknown,,Banque Inconnue,,2455.0
,,2,,,Unknown,,Banque Inconnue,,2457.0
,,34,,,Unknown,,Banque Inconnue,,2491.0
,,34,,,Unknown,,Banque Inconnue,,2525.0
,,34,,,Unknown,,Banque Inconnue,,2559.0
,,19,,,Unknown,,Banque Inconnue,,2578.0
,,33,,,Unknown,,Banque Inconnue,,2611.0
,,37,,,Unknown,,Banque Inconnue,,2648.0
,,2,,,Unknown,,Banque Inconnue,,2650.0
,,44,,,Unknown,,Banque Inconnue,,2694.0
,,25,,,Unknown,,Banque Inconnue,,2719.0
,,24,,,Unknown,,Banque Inconnue,,2743.0
,,26,,,Unknown,,Banque Inconnue,,2769.0
,,27,,,Unknown,,Banque Inconnue,,2796.0
,,28,,,Unknown,,Banque Inconnue,,2824.0
,,2,,,Unknown,,Banque Inconnue,,2826.0
,,28,,,Unknown,,Banque Inconnue,,2854.0
,,3,,,Unknown,,Banque Inconnue,,2857.0
,,16,,,Unknown,,Banque Inconnue,,2873.0
,,32,,,Unknown,,Banque Inconnue,,2905.0
,,2,,,Unknown,,Banque Inconnue,,2907.0
,,17,,,Unknown,,Banque Inconnue,,2924.0
,,32,,,Unknown,,Banque Inconnue,,2956.0
,,33,,,Unknown,,Banque Inconnue,,2989.0
,,34,,,Unknown,,Banque Inconnue,,3023.0
,,2,,,Unknown,,Banque Inconnue,,3025.0
,,35,,,Unknown,,Banque Inconnue,,3060.0
,,18,,,Unknown,,Banque Inconnue,,3078.0
,,18,,,Unknown,,Banque Inconnue,,3096.0
,,18,,,Unknown,,Banque Inconnue,,3114.0
,,2,,,Unknown,,Banque Inconnue,,3116.0
,,18,,,Unknown,,Banque Inconnue,,3134.0
,,17,,,Unknown,,Banque Inconnue,,3151.0
,,33,,,Unknown,,Banque Inconnue,,3184.0
,,35,,,Unknown,,Banque Inconnue,,3219.0
,,2,,,Unknown,,Banque Inconnue,,3221.0
,,17,,,Unknown,,Banque Inconnue,,3238.0
,,1,,,Unknown,,Banque Inconnue,,3239.0
,,36,,,Unknown,,Banque Inconnue,,3275.0
,,37,,,Unknown,,Banque Inconnue,,3312.0
,,2,,,Unknown,,Banque Inconnue,,3314.0
,,33,,,Unknown,,Banque Inconnue,,3347.0
,,35,,,Unknown,,Banque Inconnue,,3382.0
,,33,,,Unknown,,Banque Inconnue,,3415.0
,,1,,,Unknown,,Banque Inconnue,,3416.0
,,2,,,Unknown,,Banque Inconnue,,3418.0
,,1,,,Unknown,,Banque Inconnue,,3419.0
,,18,,,Unknown,,Banque Inconnue,,3437.0
,,34,,,Unknown,,Banque Inconnue,,3471.0
,,24,,,Unknown,,Banque Inconnue,,3495.0
,,25,,,Unknown,,Banque Inconnue,,3520.0
,,29,,,Unknown,,Banque Inconnue,,3549.0
,,28,,,Unknown,,Banque Inconnue,,3577.0
,,2,,,Unknown,,Banque Inconnue,,3579.0
,,38,,,Unknown,,Banque Inconnue,,3617.0
,,8,,,Unknown,,Banque Inconnue,,3625.0
,,10,,,Unknown,,Banque Inconnue,,3635.0
,,11,,,Unknown,,Banque Inconnue,,3646.0
,,28,,,Unknown,,Banque Inconnue,,3674.0
,,3,,,Unknown,,Banque Inconnue,,3677.0
,,39,,,Unknown,,Banque Inconnue,,3716.0
,,17,,,Unknown,,Banque Inconnue,,3733.0
,,40,,,Unknown,,Banque Inconnue,,3773.0
,,40,,,Unknown,,Banque Inconnue,,3813.0
,,40,,,Unknown,,Banque Inconnue,,3853.0
,,30,,,Unknown,,Banque Inconnue,,3883.0
,,31,,,Unknown,,Banque Inconnue,,3914.0
,,3,,,Unknown,,Banque Inconnue,,3917.0
,,32,,,Unknown,,Banque Inconnue,,3949.0
,,2,,,Unknown,,Banque Inconnue,,3951.0
,,7,,,Unknown,,Banque Inconnue,,3958.0
,,9,,,Unknown,,Banque Inconnue,,3967.0
,,15,,,Unknown,,Banque Inconnue,,3982.0
,,7,,,Unknown,,Banque Inconnue,,3989.0
,,21,,,Unknown,,Banque Inconnue,,4010.0
,,17,,,Unknown,,Banque Inconnue,,4027.0
,,18,,,Unknown,,Banque Inconnue,,4045.0
,,16,,,Unknown,,Banque Inconnue,,4061.0
,,19,,,Unknown,,Banque Inconnue,,4080.0
,,33,,,Unknown,,Banque Inconnue,,4113.0
,,7,,,Unknown,,Banque Inconnue,,4120.0
,,17,,,Unknown,,Banque Inconnue,,4137.0
,,20,,,Unknown,,Banque Inconnue,,4157.0
,,34,,,Unknown,,Banque Inconnue,,4191.0
,,35,,,Unknown,,Banque Inconnue,,4226.0
,,37,,,Unknown,,Banque Inconnue,,4263.0
,,20,,,Unknown,,Banque Inconnue,,4283.0
,,7,,,Unknown,,Banque Inconnue,,4290.0
,,36,,,Unknown,,Banque Inconnue,,4326.0
,,14,,,Unknown,,cid:10)(cid:11)(cid:10)(cid:46)(cid:14)(cid:2)(cid:9)(cid:11)(cid:4)(cid:3)(cid:49)(cid:4)(cid:8)(cid:5)(cid:2)(cid:28)(cid:3,cid:6)(cid:5)(cid:9)(cid:10)(cid:5)(cid:3)(cid:8)(cid:2)(cid:4)(cid:8)(cid:7)(cid:11)(cid:8)(cid:2)(cid:12)(cid:11)(cid:4)(cid:3)(cid:51)(cid:5)(cid:52)(cid:11)(cid:7)(cid:5)(cid:2)(cid:28)(cid:3,14.0
,,9,,,Unknown,,cid:10)(cid:11)(cid:10)(cid:46)(cid:14)(cid:2)(cid:9)(cid:11)(cid:4)(cid:3)(cid:49)(cid:4)(cid:8)(cid:5)(cid:2)(cid:28)(cid:3,cid:18)(cid:36)(cid:45)(cid:18)(cid:35,23.0
,,38,,,Unknown,,cid:10)(cid:11)(cid:10)(cid:46)(cid:14)(cid:2)(cid:9)(cid:11)(cid:4)(cid:3)(cid:49)(cid:4)(cid:8)(cid:5)(cid:2)(cid:28)(cid:3,cid:18)(cid:36)(cid:45)(cid:18)(cid:35,61.0
,,2,,,Unknown,,cid:10)(cid:11)(cid:10)(cid:46)(cid:14)(cid:2)(cid:9)(cid:11)(cid:4)(cid:3)(cid:49)(cid:4)(cid:8)(cid:5)(cid:2)(cid:28)(cid:3,cid:14)(cid:5)(cid:9)(cid:2)(cid:10)(cid:5)(cid:54)(cid:39)(cid:14)(cid:7)(cid:5)(cid:3)(cid:9)(cid:2)(cid:12)(cid:11)(cid:4)(cid:14)(cid:11)(cid:54)(cid:54)(cid:7)(cid:5)(cid:3)(cid:2)(cid:28)(cid:3,63.0
,,7,,,Unknown,,cid:10)(cid:11)(cid:10)(cid:46)(cid:14)(cid:2)(cid:9)(cid:11)(cid:4)(cid:3)(cid:49)(cid:4)(cid:8)(cid:5)(cid:2)(cid:28)(cid:3,cid:12)(cid:46)(cid:38)(cid:4)(cid:46)(cid:8)(cid:10)(cid:2)(cid:13)(cid:5)(cid:3)(cid:52)(cid:5,70.0
,,32,,,Unknown,,cid:10)(cid:11)(cid:10)(cid:46)(cid:14)(cid:2)(cid:9)(cid:11)(cid:4)(cid:3)(cid:49)(cid:4)(cid:8)(cid:5)(cid:2)(cid:28)(cid:3,,102.0
,,2,,,Unknown,,cid:10)(cid:11)(cid:10)(cid:46)(cid:14)(cid:2)(cid:9)(cid:11)(cid:4)(cid:3)(cid:49)(cid:4)(cid:8)(cid:5)(cid:2)(cid:28)(cid:3,,104.0
,,7,,,Unknown,,cid:10)(cid:11)(cid:10)(cid:46)(cid:14)(cid:2)(cid:9)(cid:11)(cid:4)(cid:3)(cid:49)(cid:4)(cid:8)(cid:5)(cid:2)(cid:28)(cid:3,,111.0
,,4,,,Unknown,,cid:10)(cid:11)(cid:10)(cid:46)(cid:14)(cid:2)(cid:9)(cid:11)(cid:4)(cid:3)(cid:49)(cid:4)(cid:8)(cid:5)(cid:2)(cid:28)(cid:3,,115.0
,,9,,,Unknown,,cid:10)(cid:11)(cid:10)(cid:46)(cid:14)(cid:2)(cid:9)(cid:11)(cid:4)(cid:3)(cid:49)(cid:4)(cid:8)(cid:5)(cid:2)(cid:28)(cid:3,,124.0
,,3,,,Unknown,,cid:10)(cid:11)(cid:10)(cid:46)(cid:14)(cid:2)(cid:9)(cid:11)(cid:4)(cid:3)(cid:49)(cid:4)(cid:8)(cid:5)(cid:2)(cid:28)(cid:3,,127.0
,,2,,,Unknown,,cid:10)(cid:11)(cid:10)(cid:46)(cid:14)(cid:2)(cid:9)(cid:11)(cid:4)(cid:3)(cid:49)(cid:4)(cid:8)(cid:5)(cid:2)(cid:28)(cid:3,,129.0
,,15,,,Unknown,,cid:10)(cid:11)(cid:10)(cid:46)(cid:14)(cid:2)(cid:9)(cid:11)(cid:4)(cid:3)(cid:49)(cid:4)(cid:8)(cid:5)(cid:2)(cid:28)(cid:3,,144.0
,,13,,,Unknown,,cid:10)(cid:11)(cid:10)(cid:46)(cid:14)(cid:2)(cid:9)(cid:11)(cid:4)(cid:3)(cid:49)(cid:4)(cid:8)(cid:5)(cid:2)(cid:28)(cid:3,,157.0
,,39,,,Unknown,,cid:10)(cid:11)(cid:10)(cid:46)(cid:14)(cid:2)(cid:9)(cid:11)(cid:4)(cid:3)(cid:49)(cid:4)(cid:8)(cid:5)(cid:2)(cid:28)(cid:3,,196.0
,,13,,,Unknown,,cid:10)(cid:11)(cid:10)(cid:46)(cid:14)(cid:2)(cid:9)(cid:11)(cid:4)(cid:3)(cid:49)(cid:4)(cid:8)(cid:5)(cid:2)(cid:28)(cid:3,,209.0
,,9,,,Unknown,,cid:10)(cid:11)(cid:10)(cid:46)(cid:14)(cid:2)(cid:9)(cid:11)(cid:4)(cid:3)(cid:49)(cid:4)(cid:8)(cid:5)(cid:2)(cid:28)(cid:3,,218.0
,,10,,,Unknown,,cid:10)(cid:11)(cid:10)(cid:46)(cid:14)(cid:2)(cid:9)(cid:11)(cid:4)(cid:3)(cid:49)(cid:4)(cid:8)(cid:5)(cid:2)(cid:28)(cid:3,,228.0
,,6,,,Unknown,,cid:10)(cid:11)(cid:10)(cid:46)(cid:14)(cid:2)(cid:9)(cid:11)(cid:4)(cid:3)(cid:49)(cid:4)(cid:8)(cid:5)(cid:2)(cid:28)(cid:3,,234.0
,,9,,,Unknown,,cid:10)(cid:11)(cid:10)(cid:46)(cid:14)(cid:2)(cid:9)(cid:11)(cid:4)(cid:3)(cid:49)(cid:4)(cid:8)(cid:5)(cid:2)(cid:28)(cid:3,,243.0
,,11,,,Unknown,,cid:10)(cid:11)(cid:10)(cid:46)(cid:14)(cid:2)(cid:9)(cid:11)(cid:4)(cid:3)(cid:49)(cid:4)(cid:8)(cid:5)(cid:2)(cid:28)(cid:3,,254.0
,,38,,,Unknown,,cid:10)(cid:11)(cid:10)(cid:46)(cid:14)(cid:2)(cid:9)(cid:11)(cid:4)(cid:3)(cid:49)(cid:4)(cid:8)(cid:5)(cid:2)(cid:28)(cid:3,,292.0
,,12,,,Unknown,,cid:10)(cid:11)(cid:10)(cid:46)(cid:14)(cid:2)(cid:9)(cid:11)(cid:4)(cid:3)(cid:49)(cid:4)(cid:8)(cid:5)(cid:2)(cid:28)(cid:3,,304.0
,,31,,,Unknown,,cid:10)(cid:11)(cid:10)(cid:46)(cid:14)(cid:2)(cid:9)(cid:11)(cid:4)(cid:3)(cid:49)(cid:4)(cid:8)(cid:5)(cid:2)(cid:28)(cid:3,,335.0
,,10,,,Unknown,,cid:10)(cid:11)(cid:10)(cid:46)(cid:14)(cid:2)(cid:9)(cid:11)(cid:4)(cid:3)(cid:49)(cid:4)(cid:8)(cid:5)(cid:2)(cid:28)(cid:3,,345.0
,,6,,,Unknown,,cid:10)(cid:11)(cid:10)(cid:46)(cid:14)(cid:2)(cid:9)(cid:11)(cid:4)(cid:3)(cid:49)(cid:4)(cid:8)(cid:5)(cid:2)(cid:28)(cid:3,,351.0
,,14,,,Unknown,,cid:10)(cid:11)(cid:10)(cid:46)(cid:14)(cid:2)(cid:9)(cid:11)(cid:4)(cid:3)(cid:49)(cid:4)(cid:8)(cid:5)(cid:2)(cid:28)(cid:3,,365.0
,,5,,,Unknown,,cid:10)(cid:11)(cid:10)(cid:46)(cid:14)(cid:2)(cid:9)(cid:11)(cid:4)(cid:3)(cid:49)(cid:4)(cid:8)(cid:5)(cid:2)(cid:28)(cid:3,,370.0
,,8,,,Unknown,,cid:10)(cid:11)(cid:10)(cid:46)(cid:14)(cid:2)(cid:9)(cid:11)(cid:4)(cid:3)(cid:49)(cid:4)(cid:8)(cid:5)(cid:2)(cid:28)(cid:3,,378.0
,,12,,,Unknown,,cid:10)(cid:11)(cid:10)(cid:46)(cid:14)(cid:2)(cid:9)(cid:11)(cid:4)(cid:3)(cid:49)(cid:4)(cid:8)(cid:5)(cid:2)(cid:28)(cid:3,,390.0
,,38,,,Unknown,,cid:10)(cid:11)(cid:10)(cid:46)(cid:14)(cid:2)(cid:9)(cid:11)(cid:4)(cid:3)(cid:49)(cid:4)(cid:8)(cid:5)(cid:2)(cid:28)(cid:3,,428.0
,,29,,,Unknown,,cid:10)(cid:11)(cid:10)(cid:46)(cid:14)(cid:2)(cid:9)(cid:11)(cid:4)(cid:3)(cid:49)(cid:4)(cid:8)(cid:5)(cid:2)(cid:28)(cid:3,,457.0
,,13,,,Unknown,,cid:10)(cid:11)(cid:10)(cid:46)(cid:14)(cid:2)(cid:9)(cid:11)(cid:4)(cid:3)(cid:49)(cid:4)(cid:8)(cid:5)(cid:2)(cid:28)(cid:3,,470.0
,,5,,,Unknown,,cid:10)(cid:11)(cid:10)(cid:46)(cid:14)(cid:2)(cid:9)(cid:11)(cid:4)(cid:3)(cid:49)(cid:4)(cid:8)(cid:5)(cid:2)(cid:28)(cid:3,,475.0
,,32,,,Unknown,,cid:10)(cid:11)(cid:10)(cid:46)(cid:14)(cid:2)(cid:9)(cid:11)(cid:4)(cid:3)(cid:49)(cid:4)(cid:8)(cid:5)(cid:2)(cid:28)(cid:3,,507.0
,,12,,,Unknown,,cid:10)(cid:11)(cid:10)(cid:46)(cid:14)(cid:2)(cid:9)(cid:11)(cid:4)(cid:3)(cid:49)(cid:4)(cid:8)(cid:5)(cid:2)(cid:28)(cid:3,,519.0
,,38,,,Unknown,,cid:10)(cid:11)(cid:10)(cid:46)(cid:14)(cid:2)(cid:9)(cid:11)(cid:4)(cid:3)(cid:49)(cid:4)(cid:8)(cid:5)(cid:2)(cid:28)(cid:3,,557.0
,,18,,,Unknown,,cid:10)(cid:11)(cid:10)(cid:46)(cid:14)(cid:2)(cid:9)(cid:11)(cid:4)(cid:3)(cid:49)(cid:4)(cid:8)(cid:5)(cid:2)(cid:28)(cid:3,,575.0
,,17,,,Unknown,,cid:10)(cid:11)(cid:10)(cid:46)(cid:14)(cid:2)(cid:9)(cid:11)(cid:4)(cid:3)(cid:49)(cid:4)(cid:8)(cid:5)(cid:2)(cid:28)(cid:3,,592.0
,,45,,,Unknown,,cid:10)(cid:11)(cid:10)(cid:46)(cid:14)(cid:2)(cid:9)(cid:11)(cid:4)(cid:3)(cid:49)(cid:4)(cid:8)(cid:5)(cid:2)(cid:28)(cid:3,,637.0
,,18,,,Unknown,,cid:10)(cid:11)(cid:10)(cid:46)(cid:14)(cid:2)(cid:9)(cid:11)(cid:4)(cid:3)(cid:49)(cid:4)(cid:8)(cid:5)(cid:2)(cid:28)(cid:3,,655.0
,,35,,,Unknown,,cid:10)(cid:11)(cid:10)(cid:46)(cid:14)(cid:2)(cid:9)(cid:11)(cid:4)(cid:3)(cid:49)(cid:4)(cid:8)(cid:5)(cid:2)(cid:28)(cid:3,,690.0
,,38,,,Unknown,,cid:10)(cid:11)(cid:10)(cid:46)(cid:14)(cid:2)(cid:9)(cid:11)(cid:4)(cid:3)(cid:49)(cid:4)(cid:8)(cid:5)(cid:2)(cid:28)(cid:3,,728.0
,,20,,,Unknown,,cid:10)(cid:11)(cid:10)(cid:46)(cid:14)(cid:2)(cid:9)(cid:11)(cid:4)(cid:3)(cid:49)(cid:4)(cid:8)(cid:5)(cid:2)(cid:28)(cid:3,,748.0
,,30,,,Unknown,,cid:10)(cid:11)(cid:10)(cid:46)(cid:14)(cid:2)(cid:9)(cid:11)(cid:4)(cid:3)(cid:49)(cid:4)(cid:8)(cid:5)(cid:2)(cid:28)(cid:3,,778.0
,,41,,,Unknown,,cid:10)(cid:11)(cid:10)(cid:46)(cid:14)(cid:2)(cid:9)(cid:11)(cid:4)(cid:3)(cid:49)(cid:4)(cid:8)(cid:5)(cid:2)(cid:28)(cid:3,,819.0
,,20,,,Unknown,,cid:10)(cid:11)(cid:10)(cid:46)(cid:14)(cid:2)(cid:9)(cid:11)(cid:4)(cid:3)(cid:49)(cid:4)(cid:8)(cid:5)(cid:2)(cid:28)(cid:3,,839.0
,,15,,,Unknown,,cid:10)(cid:11)(cid:10)(cid:46)(cid:14)(cid:2)(cid:9)(cid:11)(cid:4)(cid:3)(cid:49)(cid:4)(cid:8)(cid:5)(cid:2)(cid:28)(cid:3,,854.0
,,2,,,Unknown,,cid:10)(cid:11)(cid:10)(cid:46)(cid:14)(cid:2)(cid:9)(cid:11)(cid:4)(cid:3)(cid:49)(cid:4)(cid:8)(cid:5)(cid:2)(cid:28)(cid:3,,856.0
,,36,,,Unknown,,cid:10)(cid:11)(cid:10)(cid:46)(cid:14)(cid:2)(cid:9)(cid:11)(cid:4)(cid:3)(cid:49)(cid:4)(cid:8)(cid:5)(cid:2)(cid:28)(cid:3,,892.0
,,1,,,Unknown,,cid:10)(cid:11)(cid:10)(cid:46)(cid:14)(cid:2)(cid:9)(cid:11)(cid:4)(cid:3)(cid:49)(cid:4)(cid:8)(cid:5)(cid:2)(cid:28)(cid:3,,893.0
,,19,,,Unknown,,cid:10)(cid:11)(cid:10)(cid:46)(cid:14)(cid:2)(cid:9)(cid:11)(cid:4)(cid:3)(cid:49)(cid:4)(cid:8)(cid:5)(cid:2)(cid:28)(cid:3,,912.0
,,18,,,Unknown,,cid:10)(cid:11)(cid:10)(cid:46)(cid:14)(cid:2)(cid:9)(cid:11)(cid:4)(cid:3)(cid:49)(cid:4)(cid:8)(cid:5)(cid:2)(cid:28)(cid:3,,930.0
,,18,,,Unknown,,cid:10)(cid:11)(cid:10)(cid:46)(cid:14)(cid:2)(cid:9)(cid:11)(cid:4)(cid:3)(cid:49)(cid:4)(cid:8)(cid:5)(cid:2)(cid:28)(cid:3,,948.0
,,2,,,Unknown,,cid:10)(cid:11)(cid:10)(cid:46)(cid:14)(cid:2)(cid:9)(cid:11)(cid:4)(cid:3)(cid:49)(cid:4)(cid:8)(cid:5)(cid:2)(cid:28)(cid:3,,950.0
,,44,,,Unknown,,cid:10)(cid:11)(cid:10)(cid:46)(cid:14)(cid:2)(cid:9)(cid:11)(cid:4)(cid:3)(cid:49)(cid:4)(cid:8)(cid:5)(cid:2)(cid:28)(cid:3,,994.0
,,46,,,Unknown,,cid:10)(cid:11)(cid:10)(cid:46)(cid:14)(cid:2)(cid:9)(cid:11)(cid:4)(cid:3)(cid:49)(cid:4)(cid:8)(cid:5)(cid:2)(cid:28)(cid:3,,1040.0
,,47,,,Unknown,,cid:10)(cid:11)(cid:10)(cid:46)(cid:14)(cid:2)(cid:9)(cid:11)(cid:4)(cid:3)(cid:49)(cid:4)(cid:8)(cid:5)(cid:2)(cid:28)(cid:3,,1087.0
,,20,,,Unknown,,cid:10)(cid:11)(cid:10)(cid:46)(cid:14)(cid:2)(cid:9)(cid:11)(cid:4)(cid:3)(cid:49)(cid:4)(cid:8)(cid:5)(cid:2)(cid:28)(cid:3,,1107.0
,,30,,,Unknown,,cid:10)(cid:11)(cid:10)(cid:46)(cid:14)(cid:2)(cid:9)(cid:11)(cid:4)(cid:3)(cid:49)(cid:4)(cid:8)(cid:5)(cid:2)(cid:28)(cid:3,,1137.0
,,30,,,Unknown,,cid:10)(cid:11)(cid:10)(cid:46)(cid:14)(cid:2)(cid:9)(cid:11)(cid:4)(cid:3)(cid:49)(cid:4)(cid:8)(cid:5)(cid:2)(cid:28)(cid:3,,1167.0
,,25,,,Unknown,,cid:10)(cid:11)(cid:10)(cid:46)(cid:14)(cid:2)(cid:9)(cid:11)(cid:4)(cid:3)(cid:49)(cid:4)(cid:8)(cid:5)(cid:2)(cid:28)(cid:3,,1192.0
,,23,,,Unknown,,cid:10)(cid:11)(cid:10)(cid:46)(cid:14)(cid:2)(cid:9)(cid:11)(cid:4)(cid:3)(cid:49)(cid:4)(cid:8)(cid:5)(cid:2)(cid:28)(cid:3,,1215.0
,,25,,,Unknown,,cid:10)(cid:11)(cid:10)(cid:46)(cid:14)(cid:2)(cid:9)(cid:11)(cid:4)(cid:3)(cid:49)(cid:4)(cid:8)(cid:5)(cid:2)(cid:28)(cid:3,,1240.0
,,30,,,Unknown,,cid:10)(cid:11)(cid:10)(cid:46)(cid:14)(cid:2)(cid:9)(cid:11)(cid:4)(cid:3)(cid:49)(cid:4)(cid:8)(cid:5)(cid:2)(cid:28)(cid:3,,1270.0
,,41,,,Unknown,,cid:10)(cid:11)(cid:10)(cid:46)(cid:14)(cid:2)(cid:9)(cid:11)(cid:4)(cid:3)(cid:49)(cid:4)(cid:8)(cid:5)(cid:2)(cid:28)(cid:3,,1311.0
,,2,,,Unknown,,cid:10)(cid:11)(cid:10)(cid:46)(cid:14)(cid:2)(cid:9)(cid:11)(cid:4)(cid:3)(cid:49)(cid:4)(cid:8)(cid:5)(cid:2)(cid:28)(cid:3,,1313.0
,,45,,,Unknown,,cid:10)(cid:11)(cid:10)(cid:46)(cid:14)(cid:2)(cid:9)(cid:11)(cid:4)(cid:3)(cid:49)(cid:4)(cid:8)(cid:5)(cid:2)(cid:28)(cid:3,,1358.0
,,2,,,Unknown,,cid:10)(cid:11)(cid:10)(cid:46)(cid:14)(cid:2)(cid:9)(cid:11)(cid:4)(cid:3)(cid:49)(cid:4)(cid:8)(cid:5)(cid:2)(cid:28)(cid:3,,1360.0
,,28,,,Unknown,,cid:10)(cid:11)(cid:10)(cid:46)(cid:14)(cid:2)(cid:9)(cid:11)(cid:4)(cid:3)(cid:49)(cid:4)(cid:8)(cid:5)(cid:2)(cid:28)(cid:3,,1388.0
,,26,,,Unknown,,cid:10)(cid:11)(cid:10)(cid:46)(cid:14)(cid:2)(cid:9)(cid:11)(cid:4)(cid:3)(cid:49)(cid:4)(cid:8)(cid:5)(cid:2)(cid:28)(cid:3,,1414.0
,,29,,,Unknown,,cid:10)(cid:11)(cid:10)(cid:46)(cid:14)(cid:2)(cid:9)(cid:11)(cid:4)(cid:3)(cid:49)(cid:4)(cid:8)(cid:5)(cid:2)(cid:28)(cid:3,,1443.0
,,24,,,Unknown,,cid:10)(cid:11)(cid:10)(cid:46)(cid:14)(cid:2)(cid:9)(cid:11)(cid:4)(cid:3)(cid:49)(cid:4)(cid:8)(cid:5)(cid:2)(cid:28)(cid:3,,1467.0
,,27,,,Unknown,,cid:10)(cid:11)(cid:10)(cid:46)(cid:14)(cid:2)(cid:9)(cid:11)(cid:4)(cid:3)(cid:49)(cid:4)(cid:8)(cid:5)(cid:2)(cid:28)(cid:3,,1494.0
,,2,,,Unknown,,cid:10)(cid:11)(cid:10)(cid:46)(cid:14)(cid:2)(cid:9)(cid:11)(cid:4)(cid:3)(cid:49)(cid:4)(cid:8)(cid:5)(cid:2)(cid:28)(cid:3,,1496.0
,,29,,,Unknown,,cid:10)(cid:11)(cid:10)(cid:46)(cid:14)(cid:2)(cid:9)(cid:11)(cid:4)(cid:3)(cid:49)(cid:4)(cid:8)(cid:5)(cid:2)(cid:28)(cid:3,,1525.0
,,48,,,Unknown,,cid:10)(cid:11)(cid:10)(cid:46)(cid:14)(cid:2)(cid:9)(cid:11)(cid:4)(cid:3)(cid:49)(cid:4)(cid:8)(cid:5)(cid:2)(cid:28)(cid:3,,1573.0
,,48,,,Unknown,,cid:10)(cid:11)(cid:10)(cid:46)(cid:14)(cid:2)(cid:9)(cid:11)(cid:4)(cid:3)(cid:49)(cid:4)(cid:8)(cid:5)(cid:2)(cid:28)(cid:3,,1621.0
,,24,,,Unknown,,cid:10)(cid:11)(cid:10)(cid:46)(cid:14)(cid:2)(cid:9)(cid:11)(cid:4)(cid:3)(cid:49)(cid:4)(cid:8)(cid:5)(cid:2)(cid:28)(cid:3,,1645.0
,,41,,,Unknown,,cid:10)(cid:11)(cid:10)(cid:46)(cid:14)(cid:2)(cid:9)(cid:11)(cid:4)(cid:3)(cid:49)(cid:4)(cid:8)(cid:5)(cid:2)(cid:28)(cid:3,,1686.0
,,24,,,Unknown,,cid:10)(cid:11)(cid:10)(cid:46)(cid:14)(cid:2)(cid:9)(cid:11)(cid:4)(cid:3)(cid:49)(cid:4)(cid:8)(cid:5)(cid:2)(cid:28)(cid:3,,1710.0
,,20,,,Unknown,,cid:10)(cid:11)(cid:10)(cid:46)(cid:14)(cid:2)(cid:9)(cid:11)(cid:4)(cid:3)(cid:49)(cid:4)(cid:8)(cid:5)(cid:2)(cid:28)(cid:3,,1730.0
,,30,,,Unknown,,cid:10)(cid:11)(cid:10)(cid:46)(cid:14)(cid:2)(cid:9)(cid:11)(cid:4)(cid:3)(cid:49)(cid:4)(cid:8)(cid:5)(cid:2)(cid:28)(cid:3,,1760.0
,,30,,,Unknown,,cid:10)(cid:11)(cid:10)(cid:46)(cid:14)(cid:2)(cid:9)(cid:11)(cid:4)(cid:3)(cid:49)(cid:4)(cid:8)(cid:5)(cid:2)(cid:28)(cid:3,,1790.0
,,25,,,Unknown,,cid:10)(cid:11)(cid:10)(cid:46)(cid:14)(cid:2)(cid:9)(cid:11)(cid:4)(cid:3)(cid:49)(cid:4)(cid:8)(cid:5)(cid:2)(cid:28)(cid:3,,1815.0
,,22,,,Unknown,,cid:10)(cid:11)(cid:10)(cid:46)(cid:14)(cid:2)(cid:9)(cid:11)(cid:4)(cid:3)(cid:49)(cid:4)(cid:8)(cid:5)(cid:2)(cid:28)(cid:3,,1837.0
,,27,,,Unknown,,cid:10)(cid:11)(cid:10)(cid:46)(cid:14)(cid:2)(cid:9)(cid:11)(cid:4)(cid:3)(cid:49)(cid:4)(cid:8)(cid:5)(cid:2)(cid:28)(cid:3,,1864.0
,,18,,,Unknown,,cid:10)(cid:11)(cid:10)(cid:46)(cid:14)(cid:2)(cid:9)(cid:11)(cid:4)(cid:3)(cid:49)(cid:4)(cid:8)(cid:5)(cid:2)(cid:28)(cid:3,,1882.0
,,37,,,Unknown,,cid:10)(cid:11)(cid:10)(cid:46)(cid:14)(cid:2)(cid:9)(cid:11)(cid:4)(cid:3)(cid:49)(cid:4)(cid:8)(cid:5)(cid:2)(cid:28)(cid:3,,1919.0
,,45,,,Unknown,,cid:10)(cid:11)(cid:10)(cid:46)(cid:14)(cid:2)(cid:9)(cid:11)(cid:4)(cid:3)(cid:49)(cid:4)(cid:8)(cid:5)(cid:2)(cid:28)(cid:3,,1964.0
,,18,,,Unknown,,cid:10)(cid:11)(cid:10)(cid:46)(cid:14)(cid:2)(cid:9)(cid:11)(cid:4)(cid:3)(cid:49)(cid:4)(cid:8)(cid:5)(cid:2)(cid:28)(cid:3,,1982.0
,,35,,,Unknown,,cid:10)(cid:11)(cid:10)(cid:46)(cid:14)(cid:2)(cid:9)(cid:11)(cid:4)(cid:3)(cid:49)(cid:4)(cid:8)(cid:5)(cid:2)(cid:28)(cid:3,,2017.0
,,10,,,Unknown,,cid:10)(cid:11)(cid:10)(cid:46)(cid:14)(cid:2)(cid:9)(cid:11)(cid:4)(cid:3)(cid:49)(cid:4)(cid:8)(cid:5)(cid:2)(cid:28)(cid:3,,2027.0
,,11,,,Unknown,,cid:10)(cid:11)(cid:10)(cid:46)(cid:14)(cid:2)(cid:9)(cid:11)(cid:4)(cid:3)(cid:49)(cid:4)(cid:8)(cid:5)(cid:2)(cid:28)(cid:3,,2038.0
,,10,,,Unknown,,cid:10)(cid:11)(cid:10)(cid:46)(cid:14)(cid:2)(cid:9)(cid:11)(cid:4)(cid:3)(cid:49)(cid:4)(cid:8)(cid:5)(cid:2)(cid:28)(cid:3,,2048.0
,,46,,,Unknown,,cid:10)(cid:11)(cid:10)(cid:46)(cid:14)(cid:2)(cid:9)(cid:11)(cid:4)(cid:3)(cid:49)(cid:4)(cid:8)(cid:5)(cid:2)(cid:28)(cid:3,,2094.0
,,14,,,Unknown,,cid:10)(cid:11)(cid:10)(cid:46)(cid:14)(cid:2)(cid:9)(cid:11)(cid:4)(cid:3)(cid:49)(cid:4)(cid:8)(cid:5)(cid:2)(cid:28)(cid:3,,2108.0
,,2,,,Unknown,,cid:10)(cid:11)(cid:10)(cid:46)(cid:14)(cid:2)(cid:9)(cid:11)(cid:4)(cid:3)(cid:49)(cid:4)(cid:8)(cid:5)(cid:2)(cid:28)(cid:3,,2110.0
,,9,,,Unknown,,cid:10)(cid:11)(cid:10)(cid:46)(cid:14)(cid:2)(cid:9)(cid:11)(cid:4)(cid:3)(cid:49)(cid:4)(cid:8)(cid:5)(cid:2)(cid:28)(cid:3,,2119.0
,,11,,,Unknown,,cid:10)(cid:11)(cid:10)(cid:46)(cid:14)(cid:2)(cid:9)(cid:11)(cid:4)(cid:3)(cid:49)(cid:4)(cid:8)(cid:5)(cid:2)(cid:28)(cid:3,,2130.0
,,4,,,Unknown,,cid:10)(cid:11)(cid:10)(cid:46)(cid:14)(cid:2)(cid:9)(cid:11)(cid:4)(cid:3)(cid:49)(cid:4)(cid:8)(cid:5)(cid:2)(cid:28)(cid:3,,2134.0
,,3,,,Unknown,,cid:10)(cid:11)(cid:10)(cid:46)(cid:14)(cid:2)(cid:9)(cid:11)(cid:4)(cid:3)(cid:49)(cid:4)(cid:8)(cid:5)(cid:2)(cid:28)(cid:3,,2137.0
,,49,,,Unknown,,cid:10)(cid:11)(cid:10)(cid:46)(cid:14)(cid:2)(cid:9)(cid:11)(cid:4)(cid:3)(cid:49)(cid:4)(cid:8)(cid:5)(cid:2)(cid:28)(cid:3,,2186.0
,,4,,,Unknown,,cid:10)(cid:11)(cid:10)(cid:46)(cid:14)(cid:2)(cid:9)(cid:11)(cid:4)(cid:3)(cid:49)(cid:4)(cid:8)(cid:5)(cid:2)(cid:28)(cid:3,,2190.0
,,8,,,Unknown,,cid:10)(cid:11)(cid:10)(cid:46)(cid:14)(cid:2)(cid:9)(cid:11)(cid:4)(cid:3)(cid:49)(cid:4)(cid:8)(cid:5)(cid:2)(cid:28)(cid:3,,2198.0
,,5,,,Unknown,,cid:10)(cid:11)(cid:10)(cid:46)(cid:14)(cid:2)(cid:9)(cid:11)(cid:4)(cid:3)(cid:49)(cid:4)(cid:8)(cid:5)(cid:2)(cid:28)(cid:3,,2203.0
,,2,,,Unknown,,cid:10)(cid:11)(cid:10)(cid:46)(cid:14)(cid:2)(cid:9)(cid:11)(cid:4)(cid:3)(cid:49)(cid:4)(cid:8)(cid:5)(cid:2)(cid:28)(cid:3,,2205.0
,,28,,,Unknown,,cid:10)(cid:11)(cid:10)(cid:46)(cid:14)(cid:2)(cid:9)(cid:11)(cid:4)(cid:3)(cid:49)(cid:4)(cid:8)(cid:5)(cid:2)(cid:28)(cid:3,,2233.0
,,3,,,Unknown,,cid:10)(cid:11)(cid:10)(cid:46)(cid:14)(cid:2)(cid:9)(cid:11)(cid:4)(cid:3)(cid:49)(cid:4)(cid:8)(cid:5)(cid:2)(cid:28)(cid:3,,2236.0
,,15,,,Unknown,,cid:10)(cid:11)(cid:10)(cid:46)(cid:14)(cid:2)(cid:9)(cid:11)(cid:4)(cid:3)(cid:49)(cid:4)(cid:8)(cid:5)(cid:2)(cid:28)(cid:3,,2251.0
,,2,,,Unknown,,cid:10)(cid:11)(cid:10)(cid:46)(cid:14)(cid:2)(cid:9)(cid:11)(cid:4)(cid:3)(cid:49)(cid:4)(cid:8)(cid:5)(cid:2)(cid:28)(cid:3,,2253.0
,,35,,,Unknown,,cid:10)(cid:11)(cid:10)(cid:46)(cid:14)(cid:2)(cid:9)(cid:11)(cid:4)(cid:3)(cid:49)(cid:4)(cid:8)(cid:5)(cid:2)(cid:28)(cid:3,,2288.0
,,35,,,Unknown,,cid:10)(cid:11)(cid:10)(cid:46)(cid:14)(cid:2)(cid:9)(cid:11)(cid:4)(cid:3)(cid:49)(cid:4)(cid:8)(cid:5)(cid:2)(cid:28)(cid:3,,2323.0
,,19,,,Unknown,,cid:10)(cid:11)(cid:10)(cid:46)(cid:14)(cid:2)(cid:9)(cid:11)(cid:4)(cid:3)(cid:49)(cid:4)(cid:8)(cid:5)(cid:2)(cid:28)(cid:3,,2342.0
,,18,,,Unknown,,cid:10)(cid:11)(cid:10)(cid:46)(cid:14)(cid:2)(cid:9)(cid:11)(cid:4)(cid:3)(cid:49)(cid:4)(cid:8)(cid:5)(cid:2)(cid:28)(cid:3,,2360.0
,,33,,,Unknown,,cid:10)(cid:11)(cid:10)(cid:46)(cid:14)(cid:2)(cid:9)(cid:11)(cid:4)(cid:3)(cid:49)(cid:4)(cid:8)(cid:5)(cid:2)(cid:28)(cid:3,,2393.0
,,2,,,Unknown,,cid:10)(cid:11)(cid:10)(cid:46)(cid:14)(cid:2)(cid:9)(cid:11)(cid:4)(cid:3)(cid:49)(cid:4)(cid:8)(cid:5)(cid:2)(cid:28)(cid:3,,2395.0
,,44,,,Unknown,,cid:10)(cid:11)(cid:10)(cid:46)(cid:14)(cid:2)(cid:9)(cid:11)(cid:4)(cid:3)(cid:49)(cid:4)(cid:8)(cid:5)(cid:2)(cid:28)(cid:3,,2439.0
,,12,,,Unknown,,cid:10)(cid:11)(cid:10)(cid:46)(cid:14)(cid:2)(cid:9)(cid:11)(cid:4)(cid:3)(cid:49)(cid:4)(cid:8)(cid:5)(cid:2)(cid:28)(cid:3,,2451.0
,,29,,,Unknown,,cid:10)(cid:11)(cid:10)(cid:46)(cid:14)(cid:2)(cid:9)(cid:11)(cid:4)(cid:3)(cid:49)(cid:4)(cid:8)(cid:5)(cid:2)(cid:28)(cid:3,,2480.0
,,26,,,Unknown,,cid:10)(cid:11)(cid:10)(cid:46)(cid:14)(cid:2)(cid:9)(cid:11)(cid:4)(cid:3)(cid:49)(cid:4)(cid:8)(cid:5)(cid:2)(cid:28)(cid:3,,2506.0
,,41,,,Unknown,,cid:10)(cid:11)(cid:10)(cid:46)(cid:14)(cid:2)(cid:9)(cid:11)(cid:4)(cid:3)(cid:49)(cid:4)(cid:8)(cid:5)(cid:2)(cid:28)(cid:3,,2547.0
,,25,,,Unknown,,cid:10)(cid:11)(cid:10)(cid:46)(cid:14)(cid:2)(cid:9)(cid:11)(cid:4)(cid:3)(cid:49)(cid:4)(cid:8)(cid:5)(cid:2)(cid:28)(cid:3,,2572.0
,,2,,,Unknown,,cid:10)(cid:11)(cid:10)(cid:46)(cid:14)(cid:2)(cid:9)(cid:11)(cid:4)(cid:3)(cid:49)(cid:4)(cid:8)(cid:5)(cid:2)(cid:28)(cid:3,,2574.0
,,50,,,Unknown,,cid:10)(cid:11)(cid:10)(cid:46)(cid:14)(cid:2)(cid:9)(cid:11)(cid:4)(cid:3)(cid:49)(cid:4)(cid:8)(cid:5)(cid:2)(cid:28)(cid:3,,2624.0
,,50,,,Unknown,,cid:10)(cid:11)(cid:10)(cid:46)(cid:14)(cid:2)(cid:9)(cid:11)(cid:4)(cid:3)(cid:49)(cid:4)(cid:8)(cid:5)(cid:2)(cid:28)(cid:3,,2674.0
,,18,,,Unknown,,cid:10)(cid:11)(cid:10)(cid:46)(cid:14)(cid:2)(cid:9)(cid:11)(cid:4)(cid:3)(cid:49)(cid:4)(cid:8)(cid:5)(cid:2)(cid:28)(cid:3,,2692.0
,,1,,,Unknown,,cid:10)(cid:11)(cid:10)(cid:46)(cid:14)(cid:2)(cid:9)(cid:11)(cid:4)(cid:3)(cid:49)(cid:4)(cid:8)(cid:5)(cid:2)(cid:28)(cid:3,,2693.0
,,1,,,Unknown,,cid:10)(cid:11)(cid:10)(cid:46)(cid:14)(cid:2)(cid:9)(cid:11)(cid:4)(cid:3)(cid:49)(cid:4)(cid:8)(cid:5)(cid:2)(cid:28)(cid:3,,2694.0
,,37,,,Unknown,,cid:10)(cid:11)(cid:10)(cid:46)(cid:14)(cid:2)(cid:9)(cid:11)(cid:4)(cid:3)(cid:49)(cid:4)(cid:8)(cid:5)(cid:2)(cid:28)(cid:3,,2731.0
,,18,,,Unknown,,cid:10)(cid:11)(cid:10)(cid:46)(cid:14)(cid:2)(cid:9)(cid:11)(cid:4)(cid:3)(cid:49)(cid:4)(cid:8)(cid:5)(cid:2)(cid:28)(cid:3,,2749.0
,,37,,,Unknown,,cid:10)(cid:11)(cid:10)(cid:46)(cid:14)(cid:2)(cid:9)(cid:11)(cid:4)(cid:3)(cid:49)(cid:4)(cid:8)(cid:5)(cid:2)(cid:28)(cid:3,,2786.0
,,45,,,Unknown,,cid:10)(cid:11)(cid:10)(cid:46)(cid:14)(cid:2)(cid:9)(cid:11)(cid:4)(cid:3)(cid:49)(cid:4)(cid:8)(cid:5)(cid:2)(cid:28)(cid:3,,2831.0
,,18,,,Unknown,,cid:10)(cid:11)(cid:10)(cid:46)(cid:14)(cid:2)(cid:9)(cid:11)(cid:4)(cid:3)(cid:49)(cid:4)(cid:8)(cid:5)(cid:2)(cid:28)(cid:3,,2849.0
,,35,,,Unknown,,cid:10)(cid:11)(cid:10)(cid:46)(cid:14)(cid:2)(cid:9)(cid:11)(cid:4)(cid:3)(cid:49)(cid:4)(cid:8)(cid:5)(cid:2)(cid:28)(cid:3,,2884.0
,,6,,,Unknown,,cid:10)(cid:11)(cid:10)(cid:46)(cid:14)(cid:2)(cid:9)(cid:11)(cid:4)(cid:3)(cid:49)(cid:4)(cid:8)(cid:5)(cid:2)(cid:28)(cid:3,,2890.0
,,5,,,Unknown,,cid:10)(cid:11)(cid:10)(cid:46)(cid:14)(cid:2)(cid:9)(cid:11)(cid:4)(cid:3)(cid:49)(cid:4)(cid:8)(cid:5)(cid:2)(cid:28)(cid:3,,2895.0
,,9,,,Unknown,,cid:10)(cid:11)(cid:10)(cid:46)(cid:14)(cid:2)(cid:9)(cid:11)(cid:4)(cid:3)(cid:49)(cid:4)(cid:8)(cid:5)(cid:2)(cid:28)(cid:3,,2904.0
,,10,,,Unknown,,cid:10)(cid:11)(cid:10)(cid:46)(cid:14)(cid:2)(cid:9)(cid:11)(cid:4)(cid:3)(cid:49)(cid:4)(cid:8)(cid:5)(cid:2)(cid:28)(cid:3,,2914.0
,,5,,,Unknown,,cid:10)(cid:11)(cid:10)(cid:46)(cid:14)(cid:2)(cid:9)(cid:11)(cid:4)(cid:3)(cid:49)(cid:4)(cid:8)(cid:5)(cid:2)(cid:28)(cid:3,,2919.0
,,3,,,Unknown,,cid:10)(cid:11)(cid:10)(cid:46)(cid:14)(cid:2)(cid:9)(cid:11)(cid:4)(cid:3)(cid:49)(cid:4)(cid:8)(cid:5)(cid:2)(cid:28)(cid:3,,2922.0
,,8,,,Unknown,,cid:10)(cid:11)(cid:10)(cid:46)(cid:14)(cid:2)(cid:9)(cid:11)(cid:4)(cid:3)(cid:49)(cid:4)(cid:8)(cid:5)(cid:2)(cid:28)(cid:3,,2930.0
,,2,,,Unknown,,cid:10)(cid:11)(cid:10)(cid:46)(cid:14)(cid:2)(cid:9)(cid:11)(cid:4)(cid:3)(cid:49)(cid:4)(cid:8)(cid:5)(cid:2)(cid:28)(cid:3,,2932.0
,,4,,,Unknown,,cid:10)(cid:11)(cid:10)(cid:46)(cid:14)(cid:2)(cid:9)(cid:11)(cid:4)(cid:3)(cid:49)(cid:4)(cid:8)(cid:5)(cid:2)(cid:28)(cid:3,,2936.0
,,8,,,Unknown,,cid:10)(cid:11)(cid:10)(cid:46)(cid:14)(cid:2)(cid:9)(cid:11)(cid:4)(cid:3)(cid:49)(cid:4)(cid:8)(cid:5)(cid:2)(cid:28)(cid:3,,2944.0
,,7,,,Unknown,,cid:10)(cid:11)(cid:10)(cid:46)(cid:14)(cid:2)(cid:9)(cid:11)(cid:4)(cid:3)(cid:49)(cid:4)(cid:8)(cid:5)(cid:2)(cid:28)(cid:3,,2951.0
,,11,,,Unknown,,cid:10)(cid:11)(cid:10)(cid:46)(cid:14)(cid:2)(cid:9)(cid:11)(cid:4)(cid:3)(cid:49)(cid:4)(cid:8)(cid:5)(cid:2)(cid:28)(cid:3,,2962.0
,,8,,,Unknown,,cid:10)(cid:11)(cid:10)(cid:46)(cid:14)(cid:2)(cid:9)(cid:11)(cid:4)(cid:3)(cid:49)(cid:4)(cid:8)(cid:5)(cid:2)(cid:28)(cid:3,,2970.0
,,2,,,Unknown,,cid:10)(cid:11)(cid:10)(cid:46)(cid:14)(cid:2)(cid:9)(cid:11)(cid:4)(cid:3)(cid:49)(cid:4)(cid:8)(cid:5)(cid:2)(cid:28)(cid:3,,2972.0
,,12,,,Unknown,,cid:10)(cid:11)(cid:10)(cid:46)(cid:14)(cid:2)(cid:9)(cid:11)(cid:4)(cid:3)(cid:49)(cid:4)(cid:8)(cid:5)(cid:2)(cid:28)(cid:3,,2984.0
,,11,,,Unknown,,cid:10)(cid:11)(cid:10)(cid:46)(cid:14)(cid:2)(cid:9)(cid:11)(cid:4)(cid:3)(cid:49)(cid:4)(cid:8)(cid:5)(cid:2)(cid:28)(cid:3,,2995.0
,,4,,,Unknown,,cid:10)(cid:11)(cid:10)(cid:46)(cid:14)(cid:2)(cid:9)(cid:11)(cid:4)(cid:3)(cid:49)(cid:4)(cid:8)(cid:5)(cid:2)(cid:28)(cid:3,,2999.0
,,3,,,Unknown,,cid:10)(cid:11)(cid:10)(cid:46)(cid:14)(cid:2)(cid:9)(cid:11)(cid:4)(cid:3)(cid:49)(cid:4)(cid:8)(cid:5)(cid:2)(cid:28)(cid:3,,3002.0
,,51,,,Unknown,,cid:10)(cid:11)(cid:10)(cid:46)(cid:14)(cid:2)(cid:9)(cid:11)(cid:4)(cid:3)(cid:49)(cid:4)(cid:8)(cid:5)(cid:2)(cid:28)(cid:3,,3053.0
,,5,,,Unknown,,cid:10)(cid:11)(cid:10)(cid:46)(cid:14)(cid:2)(cid:9)(cid:11)(cid:4)(cid:3)(cid:49)(cid:4)(cid:8)(cid:5)(cid:2)(cid:28)(cid:3,,3058.0
,,52,,,Unknown,,cid:10)(cid:11)(cid:10)(cid:46)(cid:14)(cid:2)(cid:9)(cid:11)(cid:4)(cid:3)(cid:49)(cid:4)(cid:8)(cid:5)(cid:2)(cid:28)(cid:3,,3110.0
,,11,,,Unknown,,cid:10)(cid:11)(cid:10)(cid:46)(cid:14)(cid:2)(cid:9)(cid:11)(cid:4)(cid:3)(cid:49)(cid:4)(cid:8)(cid:5)(cid:2)(cid:28)(cid:3,,3121.0
,,7,,,Unknown,,cid:10)(cid:11)(cid:10)(cid:46)(cid:14)(cid:2)(cid:9)(cid:11)(cid:4)(cid:3)(cid:49)(cid:4)(cid:8)(cid:5)(cid:2)(cid:28)(cid:3,,3128.0
,,5,,,Unknown,,cid:10)(cid:11)(cid:10)(cid:46)(cid:14)(cid:2)(cid:9)(cid:11)(cid:4)(cid:3)(cid:49)(cid:4)(cid:8)(cid:5)(cid:2)(cid:28)(cid:3,,3133.0
,,2,,,Unknown,,cid:10)(cid:11)(cid:10)(cid:46)(cid:14)(cid:2)(cid:9)(cid:11)(cid:4)(cid:3)(cid:49)(cid:4)(cid:8)(cid:5)(cid:2)(cid:28)(cid:3,,3135.0
,,28,,,Unknown,,cid:10)(cid:11)(cid:10)(cid:46)(cid:14)(cid:2)(cid:9)(cid:11)(cid:4)(cid:3)(cid:49)(cid:4)(cid:8)(cid:5)(cid:2)(cid:28)(cid:3,,3163.0
,,3,,,Unknown,,cid:10)(cid:11)(cid:10)(cid:46)(cid:14)(cid:2)(cid:9)(cid:11)(cid:4)(cid:3)(cid:49)(cid:4)(cid:8)(cid:5)(cid:2)(cid:28)(cid:3,,3166.0
,,15,,,Unknown,,cid:10)(cid:11)(cid:10)(cid:46)(cid:14)(cid:2)(cid:9)(cid:11)(cid:4)(cid:3)(cid:49)(cid:4)(cid:8)(cid:5)(cid:2)(cid:28)(cid:3,,3181.0
,,2,,,Unknown,,cid:10)(cid:11)(cid:10)(cid:46)(cid:14)(cid:2)(cid:9)(cid:11)(cid:4)(cid:3)(cid:49)(cid:4)(cid:8)(cid:5)(cid:2)(cid:28)(cid:3,,3183.0
,,17,,,Unknown,,cid:10)(cid:11)(cid:10)(cid:46)(cid:14)(cid:2)(cid:9)(cid:11)(cid:4)(cid:3)(cid:49)(cid:4)(cid:8)(cid:5)(cid:2)(cid:28)(cid:3,,3200.0
,,17,,,Unknown,,cid:10)(cid:11)(cid:10)(cid:46)(cid:14)(cid:2)(cid:9)(cid:11)(cid:4)(cid:3)(cid:49)(cid:4)(cid:8)(cid:5)(cid:2)(cid:28)(cid:3,,3217.0
,,18,,,Unknown,,cid:10)(cid:11)(cid:10)(cid:46)(cid:14)(cid:2)(cid:9)(cid:11)(cid:4)(cid:3)(cid:49)(cid:4)(cid:8)(cid:5)(cid:2)(cid:28)(cid:3,,3235.0
,,19,,,Unknown,,cid:10)(cid:11)(cid:10)(cid:46)(cid:14)(cid:2)(cid:9)(cid:11)(cid:4)(cid:3)(cid:49)(cid:4)(cid:8)(cid:5)(cid:2)(cid:28)(cid:3,,3254.0
,,18,,,Unknown,,cid:10)(cid:11)(cid:10)(cid:46)(cid:14)(cid:2)(cid:9)(cid:11)(cid:4)(cid:3)(cid:49)(cid:4)(cid:8)(cid:5)(cid:2)(cid:28)(cid:3,,3272.0
,,18,,,Unknown,,cid:10)(cid:11)(cid:10)(cid:46)(cid:14)(cid:2)(cid:9)(cid:11)(cid:4)(cid:3)(cid:49)(cid:4)(cid:8)(cid:5)(cid:2)(cid:28)(cid:3,,3290.0
,,2,,,Unknown,,cid:10)(cid:11)(cid:10)(cid:46)(cid:14)(cid:2)(cid:9)(cid:11)(cid:4)(cid:3)(cid:49)(cid:4)(cid:8)(cid:5)(cid:2)(cid:28)(cid:3,,3292.0
,,44,,,Unknown,,cid:10)(cid:11)(cid:10)(cid:46)(cid:14)(cid:2)(cid:9)(cid:11)(cid:4)(cid:3)(cid:49)(cid:4)(cid:8)(cid:5)(cid:2)(cid:28)(cid:3,,3336.0
,,12,,,Unknown,,cid:10)(cid:11)(cid:10)(cid:46)(cid:14)(cid:2)(cid:9)(cid:11)(cid:4)(cid:3)(cid:49)(cid:4)(cid:8)(cid:5)(cid:2)(cid:28)(cid:3,,3348.0
,,29,,,Unknown,,cid:10)(cid:11)(cid:10)(cid:46)(cid:14)(cid:2)(cid:9)(cid:11)(cid:4)(cid:3)(cid:49)(cid:4)(cid:8)(cid:5)(cid:2)(cid:28)(cid:3,,3377.0
,,26,,,Unknown,,cid:10)(cid:11)(cid:10)(cid:46)(cid:14)(cid:2)(cid:9)(cid:11)(cid:4)(cid:3)(cid:49)(cid:4)(cid:8)(cid:5)(cid:2)(cid:28)(cid:3,,3403.0
,,41,,,Unknown,,cid:10)(cid:11)(cid:10)(cid:46)(cid:14)(cid:2)(cid:9)(cid:11)(cid:4)(cid:3)(cid:49)(cid:4)(cid:8)(cid:5)(cid:2)(cid:28)(cid:3,,3444.0
,,25,,,Unknown,,cid:10)(cid:11)(cid:10)(cid:46)(cid:14)(cid:2)(cid:9)(cid:11)(cid:4)(cid:3)(cid:49)(cid:4)(cid:8)(cid:5)(cid:2)(cid:28)(cid:3,,3469.0
,,2,,,Unknown,,cid:10)(cid:11)(cid:10)(cid:46)(cid:14)(cid:2)(cid:9)(cid:11)(cid:4)(cid:3)(cid:49)(cid:4)(cid:8)(cid:5)(cid:2)(cid:28)(cid:3,,3471.0
,,50,,,Unknown,,cid:10)(cid:11)(cid:10)(cid:46)(cid:14)(cid:2)(cid:9)(cid:11)(cid:4)(cid:3)(cid:49)(cid:4)(cid:8)(cid:5)(cid:2)(cid:28)(cid:3,,3521.0
,,50,,,Unknown,,cid:10)(cid:11)(cid:10)(cid:46)(cid:14)(cid:2)(cid:9)(cid:11)(cid:4)(cid:3)(cid:49)(cid:4)(cid:8)(cid:5)(cid:2)(cid:28)(cid:3,,3571.0
,,37,,,Unknown,,cid:10)(cid:11)(cid:10)(cid:46)(cid:14)(cid:2)(cid:9)(cid:11)(cid:4)(cid:3)(cid:49)(cid:4)(cid:8)(cid:5)(cid:2)(cid:28)(cid:3,,3608.0
,,16,,,Unknown,,cid:10)(cid:11)(cid:10)(cid:46)(cid:14)(cid:2)(cid:9)(cid:11)(cid:4)(cid:3)(cid:49)(cid:4)(cid:8)(cid:5)(cid:2)(cid:28)(cid:3,,3624.0
,,34,,,Unknown,,cid:10)(cid:11)(cid:10)(cid:46)(cid:14)(cid:2)(cid:9)(cid:11)(cid:4)(cid:3)(cid:49)(cid:4)(cid:8)(cid:5)(cid:2)(cid:28)(cid:3,,3658.0
,,33,,,Unknown,,cid:10)(cid:11)(cid:10)(cid:46)(cid:14)(cid:2)(cid:9)(cid:11)(cid:4)(cid:3)(cid:49)(cid:4)(cid:8)(cid:5)(cid:2)(cid:28)(cid:3,,3691.0
,,18,,,Unknown,,cid:10)(cid:11)(cid:10)(cid:46)(cid:14)(cid:2)(cid:9)(cid:11)(cid:4)(cid:3)(cid:49)(cid:4)(cid:8)(cid:5)(cid:2)(cid:28)(cid:3,,3709.0
,,37,,,Unknown,,cid:10)(cid:11)(cid:10)(cid:46)(cid:14)(cid:2)(cid:9)(cid:11)(cid:4)(cid:3)(cid:49)(cid:4)(cid:8)(cid:5)(cid:2)(cid:28)(cid:3,,3746.0
,,45,,,Unknown,,cid:10)(cid:11)(cid:10)(cid:46)(cid:14)(cid:2)(cid:9)(cid:11)(cid:4)(cid:3)(cid:49)(cid:4)(cid:8)(cid:5)(cid:2)(cid:28)(cid:3,,3791.0
,,18,,,Unknown,,cid:10)(cid:11)(cid:10)(cid:46)(cid:14)(cid:2)(cid:9)(cid:11)(cid:4)(cid:3)(cid:49)(cid:4)(cid:8)(cid:5)(cid:2)(cid:28)(cid:3,,3809.0
,,35,,,Unknown,,cid:10)(cid:11)(cid:10)(cid:46)(cid:14)(cid:2)(cid:9)(cid:11)(cid:4)(cid:3)(cid:49)(cid:4)(cid:8)(cid:5)(cid:2)(cid:28)(cid:3,,3844.0
,,46,,,Unknown,,cid:10)(cid:11)(cid:10)(cid:46)(cid:14)(cid:2)(cid:9)(cid:11)(cid:4)(cid:3)(cid:49)(cid:4)(cid:8)(cid:5)(cid:2)(cid:28)(cid:3,,3890.0
,,8,,,Unknown,,cid:10)(cid:11)(cid:10)(cid:46)(cid:14)(cid:2)(cid:9)(cid:11)(cid:4)(cid:3)(cid:49)(cid:4)(cid:8)(cid:5)(cid:2)(cid:28)(cid:3,,3898.0
,,46,,,Unknown,,cid:10)(cid:11)(cid:10)(cid:46)(cid:14)(cid:2)(cid:9)(cid:11)(cid:4)(cid:3)(cid:49)(cid:4)(cid:8)(cid:5)(cid:2)(cid:28)(cid:3,,3944.0
,,7,,,Unknown,,cid:10)(cid:11)(cid:10)(cid:46)(cid:14)(cid:2)(cid:9)(cid:11)(cid:4)(cid:3)(cid:49)(cid:4)(cid:8)(cid:5)(cid:2)(cid:28)(cid:3,,3951.0
,,9,,,Unknown,,cid:10)(cid:11)(cid:10)(cid:46)(cid:14)(cid:2)(cid:9)(cid:11)(cid:4)(cid:3)(cid:49)(cid:4)(cid:8)(cid:5)(cid:2)(cid:28)(cid:3,,3960.0
,,2,,,Unknown,,cid:10)(cid:11)(cid:10)(cid:46)(cid:14)(cid:2)(cid:9)(cid:11)(cid:4)(cid:3)(cid:49)(cid:4)(cid:8)(cid:5)(cid:2)(cid:28)(cid:3,,3962.0
,,14,,,Unknown,,cid:10)(cid:11)(cid:10)(cid:46)(cid:14)(cid:2)(cid:9)(cid:11)(cid:4)(cid:3)(cid:49)(cid:4)(cid:8)(cid:5)(cid:2)(cid:28)(cid:3,,3976.0
,,46,,,Unknown,,cid:10)(cid:11)(cid:10)(cid:46)(cid:14)(cid:2)(cid:9)(cid:11)(cid:4)(cid:3)(cid:49)(cid:4)(cid:8)(cid:5)(cid:2)(cid:28)(cid:3,,4022.0
,,2,,,Unknown,,cid:10)(cid:11)(cid:10)(cid:46)(cid:14)(cid:2)(cid:9)(cid:11)(cid:4)(cid:3)(cid:49)(cid:4)(cid:8)(cid:5)(cid:2)(cid:28)(cid:3,,4024.0
,,28,,,Unknown,,cid:10)(cid:11)(cid:10)(cid:46)(cid:14)(cid:2)(cid:9)(cid:11)(cid:4)(cid:3)(cid:49)(cid:4)(cid:8)(cid:5)(cid:2)(cid:28)(cid:3,,4052.0
,,5,,,Unknown,,cid:10)(cid:11)(cid:10)(cid:46)(cid:14)(cid:2)(cid:9)(cid:11)(cid:4)(cid:3)(cid:49)(cid:4)(cid:8)(cid:5)(cid:2)(cid:28)(cid:3,,4057.0
,,3,,,Unknown,,cid:10)(cid:11)(cid:10)(cid:46)(cid:14)(cid:2)(cid:9)(cid:11)(cid:4)(cid:3)(cid:49)(cid:4)(cid:8)(cid:5)(cid:2)(cid:28)(cid:3,,4060.0
,,10,,,Unknown,,cid:10)(cid:11)(cid:10)(cid:46)(cid:14)(cid:2)(cid:9)(cid:11)(cid:4)(cid:3)(cid:49)(cid:4)(cid:8)(cid:5)(cid:2)(cid:28)(cid:3,,4070.0
,,5,,,Unknown,,cid:10)(cid:11)(cid:10)(cid:46)(cid:14)(cid:2)(cid:9)(cid:11)(cid:4)(cid:3)(cid:49)(cid:4)(cid:8)(cid:5)(cid:2)(cid:28)(cid:3,,4075.0
,,2,,,Unknown,,cid:10)(cid:11)(cid:10)(cid:46)(cid:14)(cid:2)(cid:9)(cid:11)(cid:4)(cid:3)(cid:49)(cid:4)(cid:8)(cid:5)(cid:2)(cid:28)(cid:3,,4077.0
,,53,,,Unknown,,cid:10)(cid:11)(cid:10)(cid:46)(cid:14)(cid:2)(cid:9)(cid:11)(cid:4)(cid:3)(cid:49)(cid:4)(cid:8)(cid:5)(cid:2)(cid:28)(cid:3,,4130.0
,,2,,,Unknown,,cid:10)(cid:11)(cid:10)(cid:46)(cid:14)(cid:2)(cid:9)(cid:11)(cid:4)(cid:3)(cid:49)(cid:4)(cid:8)(cid:5)(cid:2)(cid:28)(cid:3,,4132.0
,,28,,,Unknown,,cid:10)(cid:11)(cid:10)(cid:46)(cid:14)(cid:2)(cid:9)(cid:11)(cid:4)(cid:3)(cid:49)(cid:4)(cid:8)(cid:5)(cid:2)(cid:28)(cid:3,,4160.0
,,3,,,Unknown,,cid:10)(cid:11)(cid:10)(cid:46)(cid:14)(cid:2)(cid:9)(cid:11)(cid:4)(cid:3)(cid:49)(cid:4)(cid:8)(cid:5)(cid:2)(cid:28)(cid:3,,4163.0
,,15,,,Unknown,,cid:10)(cid:11)(cid:10)(cid:46)(cid:14)(cid:2)(cid:9)(cid:11)(cid:4)(cid:3)(cid:49)(cid:4)(cid:8)(cid:5)(cid:2)(cid:28)(cid:3,,4178.0
,,2,,,Unknown,,cid:10)(cid:11)(cid:10)(cid:46)(cid:14)(cid:2)(cid:9)(cid:11)(cid:4)(cid:3)(cid:49)(cid:4)(cid:8)(cid:5)(cid:2)(cid:28)(cid:3,,4180.0
,,17,,,Unknown,,cid:10)(cid:11)(cid:10)(cid:46)(cid:14)(cid:2)(cid:9)(cid:11)(cid:4)(cid:3)(cid:49)(cid:4)(cid:8)(cid:5)(cid:2)(cid:28)(cid:3,,4197.0
,,34,,,Unknown,,cid:10)(cid:11)(cid:10)(cid:46)(cid:14)(cid:2)(cid:9)(cid:11)(cid:4)(cid:3)(cid:49)(cid:4)(cid:8)(cid:5)(cid:2)(cid:28)(cid:3,,4231.0
,,19,,,Unknown,,cid:10)(cid:11)(cid:10)(cid:46)(cid:14)(cid:2)(cid:9)(cid:11)(cid:4)(cid:3)(cid:49)(cid:4)(cid:8)(cid:5)(cid:2)(cid:28)(cid:3,,4250.0
,,18,,,Unknown,,cid:10)(cid:11)(cid:10)(cid:46)(cid:14)(cid:2)(cid:9)(cid:11)(cid:4)(cid:3)(cid:49)(cid:4)(cid:8)(cid:5)(cid:2)(cid:28)(cid:3,,4268.0
,,18,,,Unknown,,cid:10)(cid:11)(cid:10)(cid:46)(cid:14)(cid:2)(cid:9)(cid:11)(cid:4)(cid:3)(cid:49)(cid:4)(cid:8)(cid:5)(cid:2)(cid:28)(cid:3,,4286.0
,,2,,,Unknown,,cid:10)(cid:11)(cid:10)(cid:46)(cid:14)(cid:2)(cid:9)(cid:11)(cid:4)(cid:3)(cid:49)(cid:4)(cid:8)(cid:5)(cid:2)(cid:28)(cid:3,,4288.0
,,44,,,Unknown,,cid:10)(cid:11)(cid:10)(cid:46)(cid:14)(cid:2)(cid:9)(cid:11)(cid:4)(cid:3)(cid:49)(cid:4)(cid:8)(cid:5)(cid:2)(cid:28)(cid:3,,4332.0
,,12,,,Unknown,,cid:10)(cid:11)(cid:10)(cid:46)(cid:14)(cid:2)(cid:9)(cid:11)(cid:4)(cid:3)(cid:49)(cid:4)(cid:8)(cid:5)(cid:2)(cid:28)(cid:3,,4344.0
,,29,,,Unknown,,cid:10)(cid:11)(cid:10)(cid:46)(cid:14)(cid:2)(cid:9)(cid:11)(cid:4)(cid:3)(cid:49)(cid:4)(cid:8)(cid:5)(cid:2)(cid:28)(cid:3,,4373.0
,,26,,,Unknown,,cid:10)(cid:11)(cid:10)(cid:46)(cid:14)(cid:2)(cid:9)(cid:11)(cid:4)(cid:3)(cid:49)(cid:4)(cid:8)(cid:5)(cid:2)(cid:28)(cid:3,,4399.0
,,41,,,Unknown,,cid:10)(cid:11)(cid:10)(cid:46)(cid:14)(cid:2)(cid:9)(cid:11)(cid:4)(cid:3)(cid:49)(cid:4)(cid:8)(cid:5)(cid:2)(cid:28)(cid:3,,4440.0
,,25,,,Unknown,,cid:10)(cid:11)(cid:10)(cid:46)(cid:14)(cid:2)(cid:9)(cid:11)(cid:4)(cid:3)(cid:49)(cid:4)(cid:8)(cid:5)(cid:2)(cid:28)(cid:3,,4465.0
,,2,,,Unknown,,cid:10)(cid:11)(cid:10)(cid:46)(cid:14)(cid:2)(cid:9)(cid:11)(cid:4)(cid:3)(cid:49)(cid:4)(cid:8)(cid:5)(cid:2)(cid:28)(cid:3,,4467.0
,,50,,,Unknown,,cid:10)(cid:11)(cid:10)(cid:46)(cid:14)(cid:2)(cid:9)(cid:11)(cid:4)(cid:3)(cid:49)(cid:4)(cid:8)(cid:5)(cid:2)(cid:28)(cid:3,,4517.0
,,50,,,Unknown,,cid:10)(cid:11)(cid:10)(cid:46)(cid:14)(cid:2)(cid:9)(cid:11)(cid:4)(cid:3)(cid:49)(cid:4)(cid:8)(cid:5)(cid:2)(cid:28)(cid:3,,4567.0
,,18,,,Unknown,,cid:10)(cid:11)(cid:10)(cid:46)(cid:14)(cid:2)(cid:9)(cid:11)(cid:4)(cid:3)(cid:49)(cid:4)(cid:8)(cid:5)(cid:2)(cid:28)(cid:3,,4585.0
,,1,,,Unknown,,cid:10)(cid:11)(cid:10)(cid:46)(cid:14)(cid:2)(cid:9)(cid:11)(cid:4)(cid:3)(cid:49)(cid:4)(cid:8)(cid:5)(cid:2)(cid:28)(cid:3,,4586.0
,,1,,,Unknown,,cid:10)(cid:11)(cid:10)(cid:46)(cid:14)(cid:2)(cid:9)(cid:11)(cid:4)(cid:3)(cid:49)(cid:4)(cid:8)(cid:5)(cid:2)(cid:28)(cid:3,,4587.0
,,37,,,Unknown,,cid:10)(cid:11)(cid:10)(cid:46)(cid:14)(cid:2)(cid:9)(cid:11)(cid:4)(cid:3)(cid:49)(cid:4)(cid:8)(cid:5)(cid:2)(cid:28)(cid:3,,4624.0
,,18,,,Unknown,,cid:10)(cid:11)(cid:10)(cid:46)(cid:14)(cid:2)(cid:9)(cid:11)(cid:4)(cid:3)(cid:49)(cid:4)(cid:8)(cid:5)(cid:2)(cid:28)(cid:3,,4642.0
,,37,,,Unknown,,cid:10)(cid:11)(cid:10)(cid:46)(cid:14)(cid:2)(cid:9)(cid:11)(cid:4)(cid:3)(cid:49)(cid:4)(cid:8)(cid:5)(cid:2)(cid:28)(cid:3,,4679.0
,,45,,,Unknown,,cid:10)(cid:11)(cid:10)(cid:46)(cid:14)(cid:2)(cid:9)(cid:11)(cid:4)(cid:3)(cid:49)(cid:4)(cid:8)(cid:5)(cid:2)(cid:28)(cid:3,,4724.0
,,18,,,Unknown,,cid:10)(cid:11)(cid:10)(cid:46)(cid:14)(cid:2)(cid:9)(cid:11)(cid:4)(cid:3)(cid:49)(cid:4)(cid:8)(cid:5)(cid:2)(cid:28)(cid:3,,4742.0
,,35,,,Unknown,,cid:10)(cid:11)(cid:10)(cid:46)(cid:14)(cid:2)(cid:9)(cid:11)(cid:4)(cid:3)(cid:49)(cid:4)(cid:8)(cid:5)(cid:2)(cid:28)(cid:3,,4777.0
,,11,,,Unknown,,cid:10)(cid:11)(cid:10)(cid:46)(cid:14)(cid:2)(cid:9)(cid:11)(cid:4)(cid:3)(cid:49)(cid:4)(cid:8)(cid:5)(cid:2)(cid:28)(cid:3,,4788.0
,,2,,,Unknown,,cid:10)(cid:11)(cid:10)(cid:46)(cid:14)(cid:2)(cid:9)(cid:11)(cid:4)(cid:3)(cid:49)(cid:4)(cid:8)(cid:5)(cid:2)(cid:28)(cid:3,,4790.0
,,10,,,Unknown,,cid:10)(cid:11)(cid:10)(cid:46)(cid:14)(cid:2)(cid:9)(cid:11)(cid:4)(cid:3)(cid:49)(cid:4)(cid:8)(cid:5)(cid:2)(cid:28)(cid:3,,4800.0
,,46,,,Unknown,,cid:10)(cid:11)(cid:10)(cid:46)(cid:14)(cid:2)(cid:9)(cid:11)(cid:4)(cid:3)(cid:49)(cid:4)(cid:8)(cid:5)(cid:2)(cid:28)(cid:3,,4846.0
,,12,,,Unknown,,cid:10)(cid:11)(cid:10)(cid:46)(cid:14)(cid:2)(cid:9)(cid:11)(cid:4)(cid:3)(cid:49)(cid:4)(cid:8)(cid:5)(cid:2)(cid:28)(cid:3,,4858.0
,,11,,,Unknown,,cid:10)(cid:11)(cid:10)(cid:46)(cid:14)(cid:2)(cid:9)(cid:11)(cid:4)(cid:3)(cid:49)(cid:4)(cid:8)(cid:5)(cid:2)(cid:28)(cid:3,,4869.0
,,9,,,Unknown,,cid:10)(cid:11)(cid:10)(cid:46)(cid:14)(cid:2)(cid:9)(cid:11)(cid:4)(cid:3)(cid:49)(cid:4)(cid:8)(cid:5)(cid:2)(cid:28)(cid:3,,4878.0
,,2,,,Unknown,,cid:10)(cid:11)(cid:10)(cid:46)(cid:14)(cid:2)(cid:9)(cid:11)(cid:4)(cid:3)(cid:49)(cid:4)(cid:8)(cid:5)(cid:2)(cid:28)(cid:3,,4880.0
,,39,,,Unknown,,cid:10)(cid:11)(cid:10)(cid:46)(cid:14)(cid:2)(cid:9)(cid:11)(cid:4)(cid:3)(cid:49)(cid:4)(cid:8)(cid:5)(cid:2)(cid:28)(cid:3,,4919.0
,,3,,,Unknown,,cid:10)(cid:11)(cid:10)(cid:46)(cid:14)(cid:2)(cid:9)(cid:11)(cid:4)(cid:3)(cid:49)(cid:4)(cid:8)(cid:5)(cid:2)(cid:28)(cid:3,,4922.0
,,11,,,Unknown,,cid:10)(cid:11)(cid:10)(cid:46)(cid:14)(cid:2)(cid:9)(cid:11)(cid:4)(cid:3)(cid:49)(cid:4)(cid:8)(cid:5)(cid:2)(cid:28)(cid:3,,4933.0
,,52,,,Unknown,,cid:10)(cid:11)(cid:10)(cid:46)(cid:14)(cid:2)(cid:9)(cid:11)(cid:4)(cid:3)(cid:49)(cid:4)(cid:8)(cid:5)(cid:2)(cid:28)(cid:3,,4985.0
,,7,,,Unknown,,cid:10)(cid:11)(cid:10)(cid:46)(cid:14)(cid:2)(cid:9)(cid:11)(cid:4)(cid:3)(cid:49)(cid:4)(cid:8)(cid:5)(cid:2)(cid:28)(cid:3,,4992.0
,,8,,,Unknown,,cid:10)(cid:11)(cid:10)(cid:46)(cid:14)(cid:2)(cid:9)(cid:11)(cid:4)(cid:3)(cid:49)(cid:4)(cid:8)(cid:5)(cid:2)(cid:28)(cid:3,,5000.0
,,9,,,Unknown,,cid:10)(cid:11)(cid:10)(cid:46)(cid:14)(cid:2)(cid:9)(cid:11)(cid:4)(cid:3)(cid:49)(cid:4)(cid:8)(cid:5)(cid:2)(cid:28)(cid:3,,5009.0
,,2,,,Unknown,,cid:10)(cid:11)(cid:10)(cid:46)(cid:14)(cid:2)(cid:9)(cid:11)(cid:4)(cid:3)(cid:49)(cid:4)(cid:8)(cid:5)(cid:2)(cid:28)(cid:3,,5011.0
,,28,,,Unknown,,cid:10)(cid:11)(cid:10)(cid:46)(cid:14)(cid:2)(cid:9)(cid:11)(cid:4)(cid:3)(cid:49)(cid:4)(cid:8)(cid:5)(cid:2)(cid:28)(cid:3,,5039.0
,,3,,,Unknown,,cid:10)(cid:11)(cid:10)(cid:46)(cid:14)(cid:2)(cid:9)(cid:11)(cid:4)(cid:3)(cid:49)(cid:4)(cid:8)(cid:5)(cid:2)(cid:28)(cid:3,,5042.0
,,15,,,Unknown,,cid:10)(cid:11)(cid:10)(cid:46)(cid:14)(cid:2)(cid:9)(cid:11)(cid:4)(cid:3)(cid:49)(cid:4)(cid:8)(cid:5)(cid:2)(cid:28)(cid:3,,5057.0
,,2,,,Unknown,,cid:10)(cid:11)(cid:10)(cid:46)(cid:14)(cid:2)(cid:9)(cid:11)(cid:4)(cid:3)(cid:49)(cid:4)(cid:8)(cid:5)(cid:2)(cid:28)(cid:3,,5059.0
,,17,,,Unknown,,cid:10)(cid:11)(cid:10)(cid:46)(cid:14)(cid:2)(cid:9)(cid:11)(cid:4)(cid:3)(cid:49)(cid:4)(cid:8)(cid:5)(cid:2)(cid:28)(cid:3,,5076.0
,,16,,,Unknown,,cid:10)(cid:11)(cid:10)(cid:46)(cid:14)(cid:2)(cid:9)(cid:11)(cid:4)(cid:3)(cid:49)(cid:4)(cid:8)(cid:5)(cid:2)(cid:28)(cid:3,,5092.0
,,19,,,Unknown,,cid:10)(cid:11)(cid:10)(cid:46)(cid:14)(cid:2)(cid:9)(cid:11)(cid:4)(cid:3)(cid:49)(cid:4)(cid:8)(cid:5)(cid:2)(cid:28)(cid:3,,5111.0
,,18,,,Unknown,,cid:10)(cid:11)(cid:10)(cid:46)(cid:14)(cid:2)(cid:9)(cid:11)(cid:4)(cid:3)(cid:49)(cid:4)(cid:8)(cid:5)(cid:2)(cid:28)(cid:3,,5129.0
,,18,,,Unknown,,cid:10)(cid:11)(cid:10)(cid:46)(cid:14)(cid:2)(cid:9)(cid:11)(cid:4)(cid:3)(cid:49)(cid:4)(cid:8)(cid:5)(cid:2)(cid:28)(cid:3,,5147.0
,,2,,,Unknown,,cid:10)(cid:11)(cid:10)(cid:46)(cid:14)(cid:2)(cid:9)(cid:11)(cid:4)(cid:3)(cid:49)(cid:4)(cid:8)(cid:5)(cid:2)(cid:28)(cid:3,,5149.0
,,44,,,Unknown,,cid:10)(cid:11)(cid:10)(cid:46)(cid:14)(cid:2)(cid:9)(cid:11)(cid:4)(cid:3)(cid:49)(cid:4)(cid:8)(cid:5)(cid:2)(cid:28)(cid:3,,5193.0
,,12,,,Unknown,,cid:10)(cid:11)(cid:10)(cid:46)(cid:14)(cid:2)(cid:9)(cid:11)(cid:4)(cid:3)(cid:49)(cid:4)(cid:8)(cid:5)(cid:2)(cid:28)(cid:3,,5205.0
,,29,,,Unknown,,cid:10)(cid:11)(cid:10)(cid:46)(cid:14)(cid:2)(cid:9)(cid:11)(cid:4)(cid:3)(cid:49)(cid:4)(cid:8)(cid:5)(cid:2)(cid:28)(cid:3,,5234.0
,,26,,,Unknown,,cid:10)(cid:11)(cid:10)(cid:46)(cid:14)(cid:2)(cid:9)(cid:11)(cid:4)(cid:3)(cid:49)(cid:4)(cid:8)(cid:5)(cid:2)(cid:28)(cid:3,,5260.0
,,41,,,Unknown,,cid:10)(cid:11)(cid:10)(cid:46)(cid:14)(cid:2)(cid:9)(cid:11)(cid:4)(cid:3)(cid:49)(cid:4)(cid:8)(cid:5)(cid:2)(cid:28)(cid:3,,5301.0
,,25,,,Unknown,,cid:10)(cid:11)(cid:10)(cid:46)(cid:14)(cid:2)(cid:9)(cid:11)(cid:4)(cid:3)(cid:49)(cid:4)(cid:8)(cid:5)(cid:2)(cid:28)(cid:3,,5326.0
,,2,,,Unknown,,cid:10)(cid:11)(cid:10)(cid:46)(cid:14)(cid:2)(cid:9)(cid:11)(cid:4)(cid:3)(cid:49)(cid:4)(cid:8)(cid:5)(cid:2)(cid:28)(cid:3,,5328.0
,,50,,,Unknown,,cid:10)(cid:11)(cid:10)(cid:46)(cid:14)(cid:2)(cid:9)(cid:11)(cid:4)(cid:3)(cid:49)(cid:4)(cid:8)(cid:5)(cid:2)(cid:28)(cid:3,,5378.0
,,50,,,Unknown,,cid:10)(cid:11)(cid:10)(cid:46)(cid:14)(cid:2)(cid:9)(cid:11)(cid:4)(cid:3)(cid:49)(cid:4)(cid:8)(cid:5)(cid:2)(cid:28)(cid:3,,5428.0
,,18,,,Unknown,,cid:10)(cid:11)(cid:10)(cid:46)(cid:14)(cid:2)(cid:9)(cid:11)(cid:4)(cid:3)(cid:49)(cid:4)(cid:8)(cid:5)(cid:2)(cid:28)(cid:3,,5446.0
,,1,,,Unknown,,cid:10)(cid:11)(cid:10)(cid:46)(cid:14)(cid:2)(cid:9)(cid:11)(cid:4)(cid:3)(cid:49)(cid:4)(cid:8)(cid:5)(cid:2)(cid:28)(cid:3,,5447.0
,,1,,,Unknown,,cid:10)(cid:11)(cid:10)(cid:46)(cid:14)(cid:2)(cid:9)(cid:11)(cid:4)(cid:3)(cid:49)(cid:4)(cid:8)(cid:5)(cid:2)(cid:28)(cid:3,,5448.0
,,37,,,Unknown,,cid:10)(cid:11)(cid:10)(cid:46)(cid:14)(cid:2)(cid:9)(cid:11)(cid:4)(cid:3)(cid:49)(cid:4)(cid:8)(cid:5)(cid:2)(cid:28)(cid:3,,5485.0
,,18,,,Unknown,,cid:10)(cid:11)(cid:10)(cid:46)(cid:14)(cid:2)(cid:9)(cid:11)(cid:4)(cid:3)(cid:49)(cid:4)(cid:8)(cid:5)(cid:2)(cid:28)(cid:3,,5503.0
,,36,,,Unknown,,cid:10)(cid:11)(cid:10)(cid:46)(cid:14)(cid:2)(cid:9)(cid:11)(cid:4)(cid:3)(cid:49)(cid:4)(cid:8)(cid:5)(cid:2)(cid:28)(cid:3,,5539.0
,,45,,,Unknown,,cid:10)(cid:11)(cid:10)(cid:46)(cid:14)(cid:2)(cid:9)(cid:11)(cid:4)(cid:3)(cid:49)(cid:4)(cid:8)(cid:5)(cid:2)(cid:28)(cid:3,,5584.0
,,18,,,Unknown,,cid:10)(cid:11)(cid:10)(cid:46)(cid:14)(cid:2)(cid:9)(cid:11)(cid:4)(cid:3)(cid:49)(cid:4)(cid:8)(cid:5)(cid:2)(cid:28)(cid:3,,5602.0
,,35,,,Unknown,,cid:10)(cid:11)(cid:10)(cid:46)(cid:14)(cid:2)(cid:9)(cid:11)(cid:4)(cid:3)(cid:49)(cid:4)(cid:8)(cid:5)(cid:2)(cid:28)(cid:3,,5637.0
,,14,,,Unknown,,cid:10)(cid:11)(cid:10)(cid:46)(cid:14)(cid:2)(cid:9)(cid:11)(cid:4)(cid:3)(cid:49)(cid:4)(cid:8)(cid:5)(cid:2)(cid:28)(cid:3,,5651.0
,,5,,,Unknown,,cid:10)(cid:11)(cid:10)(cid:46)(cid:14)(cid:2)(cid:9)(cid:11)(cid:4)(cid:3)(cid:49)(cid:4)(cid:8)(cid:5)(cid:2)(cid:28)(cid:3,,5656.0
,,12,,,Unknown,,cid:10)(cid:11)(cid:10)(cid:46)(cid:14)(cid:2)(cid:9)(cid:11)(cid:4)(cid:3)(cid:49)(cid:4)(cid:8)(cid:5)(cid:2)(cid:28)(cid:3,,5668.0
,,14,,,Unknown,,cid:10)(cid:11)(cid:10)(cid:46)(cid:14)(cid:2)(cid:9)(cid:11)(cid:4)(cid:3)(cid:49)(cid:4)(cid:8)(cid:5)(cid:2)(cid:28)(cid:3,,5682.0
,,5,,,Unknown,,cid:10)(cid:11)(cid:10)(cid:46)(cid:14)(cid:2)(cid:9)(cid:11)(cid:4)(cid:3)(cid:49)(cid:4)(cid:8)(cid:5)(cid:2)(cid:28)(cid:3,,5687.0
,,3,,,Unknown,,cid:10)(cid:11)(cid:10)(cid:46)(cid:14)(cid:2)(cid:9)(cid:11)(cid:4)(cid:3)(cid:49)(cid:4)(cid:8)(cid:5)(cid:2)(cid:28)(cid:3,,5690.0
,,12,,,Unknown,,cid:10)(cid:11)(cid:10)(cid:46)(cid:14)(cid:2)(cid:9)(cid:11)(cid:4)(cid:3)(cid:49)(cid:4)(cid:8)(cid:5)(cid:2)(cid:28)(cid:3,,5702.0
,,2,,,Unknown,,cid:10)(cid:11)(cid:10)(cid:46)(cid:14)(cid:2)(cid:9)(cid:11)(cid:4)(cid:3)(cid:49)(cid:4)(cid:8)(cid:5)(cid:2)(cid:28)(cid:3,,5704.0
,,49,,,Unknown,,cid:10)(cid:11)(cid:10)(cid:46)(cid:14)(cid:2)(cid:9)(cid:11)(cid:4)(cid:3)(cid:49)(cid:4)(cid:8)(cid:5)(cid:2)(cid:28)(cid:3,,5753.0
,,7,,,Unknown,,cid:10)(cid:11)(cid:10)(cid:46)(cid:14)(cid:2)(cid:9)(cid:11)(cid:4)(cid:3)(cid:49)(cid:4)(cid:8)(cid:5)(cid:2)(cid:28)(cid:3,,5760.0
,,9,,,Unknown,,cid:10)(cid:11)(cid:10)(cid:46)(cid:14)(cid:2)(cid:9)(cid:11)(cid:4)(cid:3)(cid:49)(cid:4)(cid:8)(cid:5)(cid:2)(cid:28)(cid:3,,5769.0
,,10,,,Unknown,,cid:10)(cid:11)(cid:10)(cid:46)(cid:14)(cid:2)(cid:9)(cid:11)(cid:4)(cid:3)(cid:49)(cid:4)(cid:8)(cid:5)(cid:2)(cid:28)(cid:3,,5779.0
,,3,,,Unknown,,cid:10)(cid:11)(cid:10)(cid:46)(cid:14)(cid:2)(cid:9)(cid:11)(cid:4)(cid:3)(cid:49)(cid:4)(cid:8)(cid:5)(cid:2)(cid:28)(cid:3,,5782.0
,,2,,,Unknown,,cid:10)(cid:11)(cid:10)(cid:46)(cid:14)(cid:2)(cid:9)(cid:11)(cid:4)(cid:3)(cid:49)(cid:4)(cid:8)(cid:5)(cid:2)(cid:28)(cid:3,,5784.0
,,12,,,Unknown,,cid:10)(cid:11)(cid:10)(cid:46)(cid:14)(cid:2)(cid:9)(cid:11)(cid:4)(cid:3)(cid:49)(cid:4)(cid:8)(cid:5)(cid:2)(cid:28)(cid:3,,5796.0
,,11,,,Unknown,,cid:10)(cid:11)(cid:10)(cid:46)(cid:14)(cid:2)(cid:9)(cid:11)(cid:4)(cid:3)(cid:49)(cid:4)(cid:8)(cid:5)(cid:2)(cid:28)(cid:3,,5807.0
,,4,,,Unknown,,cid:10)(cid:11)(cid:10)(cid:46)(cid:14)(cid:2)(cid:9)(cid:11)(cid:4)(cid:3)(cid:49)(cid:4)(cid:8)(cid:5)(cid:2)(cid:28)(cid:3,,5811.0
,,14,,,Unknown,,cid:10)(cid:11)(cid:10)(cid:46)(cid:14)(cid:2)(cid:9)(cid:11)(cid:4)(cid:3)(cid:49)(cid:4)(cid:8)(cid:5)(cid:2)(cid:28)(cid:3,,5825.0
,,11,,,Unknown,,cid:10)(cid:11)(cid:10)(cid:46)(cid:14)(cid:2)(cid:9)(cid:11)(cid:4)(cid:3)(cid:49)(cid:4)(cid:8)(cid:5)(cid:2)(cid:28)(cid:3,,5836.0
,,54,,,Unknown,,cid:10)(cid:11)(cid:10)(cid:46)(cid:14)(cid:2)(cid:9)(cid:11)(cid:4)(cid:3)(cid:49)(cid:4)(cid:8)(cid:5)(cid:2)(cid:28)(cid:3,,5890.0
,,54,,,Unknown,,cid:10)(cid:11)(cid:10)(cid:46)(cid:14)(cid:2)(cid:9)(cid:11)(cid:4)(cid:3)(cid:49)(cid:4)(cid:8)(cid:5)(cid:2)(cid:28)(cid:3,,5944.0
,,7,,,Unknown,,cid:10)(cid:11)(cid:10)(cid:46)(cid:14)(cid:2)(cid:9)(cid:11)(cid:4)(cid:3)(cid:49)(cid:4)(cid:8)(cid:5)(cid:2)(cid:28)(cid:3,,5951.0
,,5,,,Unknown,,cid:10)(cid:11)(cid:10)(cid:46)(cid:14)(cid:2)(cid:9)(cid:11)(cid:4)(cid:3)(cid:49)(cid:4)(cid:8)(cid:5)(cid:2)(cid:28)(cid:3,,5956.0
,,3,,,Unknown,,cid:10)(cid:11)(cid:10)(cid:46)(cid:14)(cid:2)(cid:9)(cid:11)(cid:4)(cid:3)(cid:49)(cid:4)(cid:8)(cid:5)(cid:2)(cid:28)(cid:3,,5959.0
,,2,,,Unknown,,cid:10)(cid:11)(cid:10)(cid:46)(cid:14)(cid:2)(cid:9)(cid:11)(cid:4)(cid:3)(cid:49)(cid:4)(cid:8)(cid:5)(cid:2)(cid:28)(cid:3,,5961.0
,,28,,,Unknown,,cid:10)(cid:11)(cid:10)(cid:46)(cid:14)(cid:2)(cid:9)(cid:11)(cid:4)(cid:3)(cid:49)(cid:4)(cid:8)(cid:5)(cid:2)(cid:28)(cid:3,,5989.0
,,3,,,Unknown,,cid:10)(cid:11)(cid:10)(cid:46)(cid:14)(cid:2)(cid:9)(cid:11)(cid:4)(cid:3)(cid:49)(cid:4)(cid:8)(cid:5)(cid:2)(cid:28)(cid:3,,5992.0
,,15,,,Unknown,,cid:10)(cid:11)(cid:10)(cid:46)(cid:14)(cid:2)(cid:9)(cid:11)(cid:4)(cid:3)(cid:49)(cid:4)(cid:8)(cid:5)(cid:2)(cid:28)(cid:3,,6007.0
,,2,,,Unknown,,cid:10)(cid:11)(cid:10)(cid:46)(cid:14)(cid:2)(cid:9)(cid:11)(cid:4)(cid:3)(cid:49)(cid:4)(cid:8)(cid:5)(cid:2)(cid:28)(cid:3,,6009.0
,,17,,,Unknown,,cid:10)(cid:11)(cid:10)(cid:46)(cid:14)(cid:2)(cid:9)(cid:11)(cid:4)(cid:3)(cid:49)(cid:4)(cid:8)(cid:5)(cid:2)(cid:28)(cid:3,,6026.0
,,18,,,Unknown,,cid:10)(cid:11)(cid:10)(cid:46)(cid:14)(cid:2)(cid:9)(cid:11)(cid:4)(cid:3)(cid:49)(cid:4)(cid:8)(cid:5)(cid:2)(cid:28)(cid:3,,6044.0
,,18,,,Unknown,,cid:10)(cid:11)(cid:10)(cid:46)(cid:14)(cid:2)(cid:9)(cid:11)(cid:4)(cid:3)(cid:49)(cid:4)(cid:8)(cid:5)(cid:2)(cid:28)(cid:3,,6062.0
,,19,,,Unknown,,cid:10)(cid:11)(cid:10)(cid:46)(cid:14)(cid:2)(cid:9)(cid:11)(cid:4)(cid:3)(cid:49)(cid:4)(cid:8)(cid:5)(cid:2)(cid:28)(cid:3,,6081.0
,,18,,,Unknown,,cid:10)(cid:11)(cid:10)(cid:46)(cid:14)(cid:2)(cid:9)(cid:11)(cid:4)(cid:3)(cid:49)(cid:4)(cid:8)(cid:5)(cid:2)(cid:28)(cid:3,,6099.0
,,18,,,Unknown,,cid:10)(cid:11)(cid:10)(cid:46)(cid:14)(cid:2)(cid:9)(cid:11)(cid:4)(cid:3)(cid:49)(cid:4)(cid:8)(cid:5)(cid:2)(cid:28)(cid:3,,6117.0
,,2,,,Unknown,,cid:10)(cid:11)(cid:10)(cid:46)(cid:14)(cid:2)(cid:9)(cid:11)(cid:4)(cid:3)(cid:49)(cid:4)(cid:8)(cid:5)(cid:2)(cid:28)(cid:3,,6119.0
,,44,,,Unknown,,cid:10)(cid:11)(cid:10)(cid:46)(cid:14)(cid:2)(cid:9)(cid:11)(cid:4)(cid:3)(cid:49)(cid:4)(cid:8)(cid:5)(cid:2)(cid:28)(cid:3,,6163.0
,,12,,,Unknown,,cid:10)(cid:11)(cid:10)(cid:46)(cid:14)(cid:2)(cid:9)(cid:11)(cid:4)(cid:3)(cid:49)(cid:4)(cid:8)(cid:5)(cid:2)(cid:28)(cid:3,,6175.0
,,29,,,Unknown,,cid:10)(cid:11)(cid:10)(cid:46)(cid:14)(cid:2)(cid:9)(cid:11)(cid:4)(cid:3)(cid:49)(cid:4)(cid:8)(cid:5)(cid:2)(cid:28)(cid:3,,6204.0
,,26,,,Unknown,,cid:10)(cid:11)(cid:10)(cid:46)(cid:14)(cid:2)(cid:9)(cid:11)(cid:4)(cid:3)(cid:49)(cid:4)(cid:8)(cid:5)(cid:2)(cid:28)(cid:3,,6230.0
,,41,,,Unknown,,cid:10)(cid:11)(cid:10)(cid:46)(cid:14)(cid:2)(cid:9)(cid:11)(cid:4)(cid:3)(cid:49)(cid:4)(cid:8)(cid:5)(cid:2)(cid:28)(cid:3,,6271.0
,,25,,,Unknown,,cid:10)(cid:11)(cid:10)(cid:46)(cid:14)(cid:2)(cid:9)(cid:11)(cid:4)(cid:3)(cid:49)(cid:4)(cid:8)(cid:5)(cid:2)(cid:28)(cid:3,,6296.0
,,2,,,Unknown,,cid:10)(cid:11)(cid:10)(cid:46)(cid:14)(cid:2)(cid:9)(cid:11)(cid:4)(cid:3)(cid:49)(cid:4)(cid:8)(cid:5)(cid:2)(cid:28)(cid:3,,6298.0
,,50,,,Unknown,,cid:10)(cid:11)(cid:10)(cid:46)(cid:14)(cid:2)(cid:9)(cid:11)(cid:4)(cid:3)(cid:49)(cid:4)(cid:8)(cid:5)(cid:2)(cid:28)(cid:3,,6348.0
,,50,,,Unknown,,cid:10)(cid:11)(cid:10)(cid:46)(cid:14)(cid:2)(cid:9)(cid:11)(cid:4)(cid:3)(cid:49)(cid:4)(cid:8)(cid:5)(cid:2)(cid:28)(cid:3,,6398.0
,,37,,,Unknown,,cid:10)(cid:11)(cid:10)(cid:46)(cid:14)(cid:2)(cid:9)(cid:11)(cid:4)(cid:3)(cid:49)(cid:4)(cid:8)(cid:5)(cid:2)(cid:28)(cid:3,,6435.0
,,16,,,Unknown,,cid:10)(cid:11)(cid:10)(cid:46)(cid:14)(cid:2)(cid:9)(cid:11)(cid:4)(cid:3)(cid:49)(cid:4)(cid:8)(cid:5)(cid:2)(cid:28)(cid:3,,6451.0
,,34,,,Unknown,,cid:10)(cid:11)(cid:10)(cid:46)(cid:14)(cid:2)(cid:9)(cid:11)(cid:4)(cid:3)(cid:49)(cid:4)(cid:8)(cid:5)(cid:2)(cid:28)(cid:3,,6485.0
,,33,,,Unknown,,cid:10)(cid:11)(cid:10)(cid:46)(cid:14)(cid:2)(cid:9)(cid:11)(cid:4)(cid:3)(cid:49)(cid:4)(cid:8)(cid:5)(cid:2)(cid:28)(cid:3,,6518.0
,,18,,,Unknown,,cid:10)(cid:11)(cid:10)(cid:46)(cid:14)(cid:2)(cid:9)(cid:11)(cid:4)(cid:3)(cid:49)(cid:4)(cid:8)(cid:5)(cid:2)(cid:28)(cid:3,,6536.0
,,36,,,Unknown,,cid:10)(cid:11)(cid:10)(cid:46)(cid:14)(cid:2)(cid:9)(cid:11)(cid:4)(cid:3)(cid:49)(cid:4)(cid:8)(cid:5)(cid:2)(cid:28)(cid:3,,6572.0
,,45,,,Unknown,,cid:10)(cid:11)(cid:10)(cid:46)(cid:14)(cid:2)(cid:9)(cid:11)(cid:4)(cid:3)(cid:49)(cid:4)(cid:8)(cid:5)(cid:2)(cid:28)(cid:3,,6617.0
,,18,,,Unknown,,cid:10)(cid:11)(cid:10)(cid:46)(cid:14)(cid:2)(cid:9)(cid:11)(cid:4)(cid:3)(cid:49)(cid:4)(cid:8)(cid:5)(cid:2)(cid:28)(cid:3,,6635.0
,,35,,,Unknown,,cid:10)(cid:11)(cid:10)(cid:46)(cid:14)(cid:2)(cid:9)(cid:11)(cid:4)(cid:3)(cid:49)(cid:4)(cid:8)(cid:5)(cid:2)(cid:28)(cid:3,,6670.0
,,49,,,Unknown,,cid:10)(cid:11)(cid:10)(cid:46)(cid:14)(cid:2)(cid:9)(cid:11)(cid:4)(cid:3)(cid:49)(cid:4)(cid:8)(cid:5)(cid:2)(cid:28)(cid:3,,6719.0
,,5,,,Unknown,,cid:10)(cid:11)(cid:10)(cid:46)(cid:14)(cid:2)(cid:9)(cid:11)(cid:4)(cid:3)(cid:49)(cid:4)(cid:8)(cid:5)(cid:2)(cid:28)(cid:3,,6724.0
,,14,,,Unknown,,cid:10)(cid:11)(cid:10)(cid:46)(cid:14)(cid:2)(cid:9)(cid:11)(cid:4)(cid:3)(cid:49)(cid:4)(cid:8)(cid:5)(cid:2)(cid:28)(cid:3,,6738.0
,,7,,,Unknown,,cid:10)(cid:11)(cid:10)(cid:46)(cid:14)(cid:2)(cid:9)(cid:11)(cid:4)(cid:3)(cid:49)(cid:4)(cid:8)(cid:5)(cid:2)(cid:28)(cid:3,,6745.0
,,12,,,Unknown,,cid:10)(cid:11)(cid:10)(cid:46)(cid:14)(cid:2)(cid:9)(cid:11)(cid:4)(cid:3)(cid:49)(cid:4)(cid:8)(cid:5)(cid:2)(cid:28)(cid:3,,6757.0
,,5,,,Unknown,,cid:10)(cid:11)(cid:10)(cid:46)(cid:14)(cid:2)(cid:9)(cid:11)(cid:4)(cid:3)(cid:49)(cid:4)(cid:8)(cid:5)(cid:2)(cid:28)(cid:3,,6762.0
,,9,,,Unknown,,cid:10)(cid:11)(cid:10)(cid:46)(cid:14)(cid:2)(cid:9)(cid:11)(cid:4)(cid:3)(cid:49)(cid:4)(cid:8)(cid:5)(cid:2)(cid:28)(cid:3,,6771.0
,,2,,,Unknown,,cid:10)(cid:11)(cid:10)(cid:46)(cid:14)(cid:2)(cid:9)(cid:11)(cid:4)(cid:3)(cid:49)(cid:4)(cid:8)(cid:5)(cid:2)(cid:28)(cid:3,,6773.0
,,16,,,Unknown,,cid:10)(cid:11)(cid:10)(cid:46)(cid:14)(cid:2)(cid:9)(cid:11)(cid:4)(cid:3)(cid:49)(cid:4)(cid:8)(cid:5)(cid:2)(cid:28)(cid:3,,6789.0
,,16,,,Unknown,,cid:10)(cid:11)(cid:10)(cid:46)(cid:14)(cid:2)(cid:9)(cid:11)(cid:4)(cid:3)(cid:49)(cid:4)(cid:8)(cid:5)(cid:2)(cid:28)(cid:3,,6805.0
,,2,,,Unknown,,cid:10)(cid:11)(cid:10)(cid:46)(cid:14)(cid:2)(cid:9)(cid:11)(cid:4)(cid:3)(cid:49)(cid:4)(cid:8)(cid:5)(cid:2)(cid:28)(cid:3,,6807.0
,,12,,,Unknown,,cid:10)(cid:11)(cid:10)(cid:46)(cid:14)(cid:2)(cid:9)(cid:11)(cid:4)(cid:3)(cid:49)(cid:4)(cid:8)(cid:5)(cid:2)(cid:28)(cid:3,,6819.0
,,11,,,Unknown,,cid:10)(cid:11)(cid:10)(cid:46)(cid:14)(cid:2)(cid:9)(cid:11)(cid:4)(cid:3)(cid:49)(cid:4)(cid:8)(cid:5)(cid:2)(cid:28)(cid:3,,6830.0
,,4,,,Unknown,,cid:10)(cid:11)(cid:10)(cid:46)(cid:14)(cid:2)(cid:9)(cid:11)(cid:4)(cid:3)(cid:49)(cid:4)(cid:8)(cid:5)(cid:2)(cid:28)(cid:3,,6834.0
,,14,,,Unknown,,cid:10)(cid:11)(cid:10)(cid:46)(cid:14)(cid:2)(cid:9)(cid:11)(cid:4)(cid:3)(cid:49)(cid:4)(cid:8)(cid:5)(cid:2)(cid:28)(cid:3,,6848.0
,,11,,,Unknown,,cid:10)(cid:11)(cid:10)(cid:46)(cid:14)(cid:2)(cid:9)(cid:11)(cid:4)(cid:3)(cid:49)(cid:4)(cid:8)(cid:5)(cid:2)(cid:28)(cid:3,,6859.0
,,54,,,Unknown,,cid:10)(cid:11)(cid:10)(cid:46)(cid:14)(cid:2)(cid:9)(cid:11)(cid:4)(cid:3)(cid:49)(cid:4)(cid:8)(cid:5)(cid:2)(cid:28)(cid:3,,6913.0
,,54,,,Unknown,,cid:10)(cid:11)(cid:10)(cid:46)(cid:14)(cid:2)(cid:9)(cid:11)(cid:4)(cid:3)(cid:49)(cid:4)(cid:8)(cid:5)(cid:2)(cid:28)(cid:3,,6967.0
,,7,,,Unknown,,cid:10)(cid:11)(cid:10)(cid:46)(cid:14)(cid:2)(cid:9)(cid:11)(cid:4)(cid:3)(cid:49)(cid:4)(cid:8)(cid:5)(cid:2)(cid:28)(cid:3,,6974.0
,,5,,,Unknown,,cid:10)(cid:11)(cid:10)(cid:46)(cid:14)(cid:2)(cid:9)(cid:11)(cid:4)(cid:3)(cid:49)(cid:4)(cid:8)(cid:5)(cid:2)(cid:28)(cid:3,,6979.0
,,3,,,Unknown,,cid:10)(cid:11)(cid:10)(cid:46)(cid:14)(cid:2)(cid:9)(cid:11)(cid:4)(cid:3)(cid:49)(cid:4)(cid:8)(cid:5)(cid:2)(cid:28)(cid:3,,6982.0
,,9,,,Unknown,,cid:10)(cid:11)(cid:10)(cid:46)(cid:14)(cid:2)(cid:9)(cid:11)(cid:4)(cid:3)(cid:49)(cid:4)(cid:8)(cid:5)(cid:2)(cid:28)(cid:3,,6991.0
,,2,,,Unknown,,cid:10)(cid:11)(cid:10)(cid:46)(cid:14)(cid:2)(cid:9)(cid:11)(cid:4)(cid:3)(cid:49)(cid:4)(cid:8)(cid:5)(cid:2)(cid:28)(cid:3,,6993.0
,,28,,,Unknown,,cid:10)(cid:11)(cid:10)(cid:46)(cid:14)(cid:2)(cid:9)(cid:11)(cid:4)(cid:3)(cid:49)(cid:4)(cid:8)(cid:5)(cid:2)(cid:28)(cid:3,,7021.0
,,3,,,Unknown,,cid:10)(cid:11)(cid:10)(cid:46)(cid:14)(cid:2)(cid:9)(cid:11)(cid:4)(cid:3)(cid:49)(cid:4)(cid:8)(cid:5)(cid:2)(cid:28)(cid:3,,7024.0
,,15,,,Unknown,,cid:10)(cid:11)(cid:10)(cid:46)(cid:14)(cid:2)(cid:9)(cid:11)(cid:4)(cid:3)(cid:49)(cid:4)(cid:8)(cid:5)(cid:2)(cid:28)(cid:3,,7039.0
,,2,,,Unknown,,cid:10)(cid:11)(cid:10)(cid:46)(cid:14)(cid:2)(cid:9)(cid:11)(cid:4)(cid:3)(cid:49)(cid:4)(cid:8)(cid:5)(cid:2)(cid:28)(cid:3,,7041.0
,,1,,,Unknown,,cid:10)(cid:11)(cid:10)(cid:46)(cid:14)(cid:2)(cid:9)(cid:11)(cid:4)(cid:3)(cid:49)(cid:4)(cid:8)(cid:5)(cid:2)(cid:28)(cid:3,,7042.0
,,35,,,Unknown,,cid:10)(cid:11)(cid:10)(cid:46)(cid:14)(cid:2)(cid:9)(cid:11)(cid:4)(cid:3)(cid:49)(cid:4)(cid:8)(cid:5)(cid:2)(cid:28)(cid:3,,7077.0
,,19,,,Unknown,,cid:10)(cid:11)(cid:10)(cid:46)(cid:14)(cid:2)(cid:9)(cid:11)(cid:4)(cid:3)(cid:49)(cid:4)(cid:8)(cid:5)(cid:2)(cid:28)(cid:3,,7096.0
,,18,,,Unknown,,cid:10)(cid:11)(cid:10)(cid:46)(cid:14)(cid:2)(cid:9)(cid:11)(cid:4)(cid:3)(cid:49)(cid:4)(cid:8)(cid:5)(cid:2)(cid:28)(cid:3,,7114.0
,,18,,,Unknown,,cid:10)(cid:11)(cid:10)(cid:46)(cid:14)(cid:2)(cid:9)(cid:11)(cid:4)(cid:3)(cid:49)(cid:4)(cid:8)(cid:5)(cid:2)(cid:28)(cid:3,,7132.0
,,2,,,Unknown,,cid:10)(cid:11)(cid:10)(cid:46)(cid:14)(cid:2)(cid:9)(cid:11)(cid:4)(cid:3)(cid:49)(cid:4)(cid:8)(cid:5)(cid:2)(cid:28)(cid:3,,7134.0
,,44,,,Unknown,,cid:10)(cid:11)(cid:10)(cid:46)(cid:14)(cid:2)(cid:9)(cid:11)(cid:4)(cid:3)(cid:49)(cid:4)(cid:8)(cid:5)(cid:2)(cid:28)(cid:3,,7178.0
,,12,,,Unknown,,cid:10)(cid:11)(cid:10)(cid:46)(cid:14)(cid:2)(cid:9)(cid:11)(cid:4)(cid:3)(cid:49)(cid:4)(cid:8)(cid:5)(cid:2)(cid:28)(cid:3,,7190.0
,,29,,,Unknown,,cid:10)(cid:11)(cid:10)(cid:46)(cid:14)(cid:2)(cid:9)(cid:11)(cid:4)(cid:3)(cid:49)(cid:4)(cid:8)(cid:5)(cid:2)(cid:28)(cid:3,,7219.0
,,26,,,Unknown,,cid:10)(cid:11)(cid:10)(cid:46)(cid:14)(cid:2)(cid:9)(cid:11)(cid:4)(cid:3)(cid:49)(cid:4)(cid:8)(cid:5)(cid:2)(cid:28)(cid:3,,7245.0
,,41,,,Unknown,,cid:10)(cid:11)(cid:10)(cid:46)(cid:14)(cid:2)(cid:9)(cid:11)(cid:4)(cid:3)(cid:49)(cid:4)(cid:8)(cid:5)(cid:2)(cid:28)(cid:3,,7286.0
,,25,,,Unknown,,cid:10)(cid:11)(cid:10)(cid:46)(cid:14)(cid:2)(cid:9)(cid:11)(cid:4)(cid:3)(cid:49)(cid:4)(cid:8)(cid:5)(cid:2)(cid:28)(cid:3,,7311.0
,,2,,,Unknown,,cid:10)(cid:11)(cid:10)(cid:46)(cid:14)(cid:2)(cid:9)(cid:11)(cid:4)(cid:3)(cid:49)(cid:4)(cid:8)(cid:5)(cid:2)(cid:28)(cid:3,,7313.0
,,50,,,Unknown,,cid:10)(cid:11)(cid:10)(cid:46)(cid:14)(cid:2)(cid:9)(cid:11)(cid:4)(cid:3)(cid:49)(cid:4)(cid:8)(cid:5)(cid:2)(cid:28)(cid:3,,7363.0
,,50,,,Unknown,,cid:10)(cid:11)(cid:10)(cid:46)(cid:14)(cid:2)(cid:9)(cid:11)(cid:4)(cid:3)(cid:49)(cid:4)(cid:8)(cid:5)(cid:2)(cid:28)(cid:3,,7413.0
,,37,,,Unknown,,cid:10)(cid:11)(cid:10)(cid:46)(cid:14)(cid:2)(cid:9)(cid:11)(cid:4)(cid:3)(cid:49)(cid:4)(cid:8)(cid:5)(cid:2)(cid:28)(cid:3,,7450.0
,,16,,,Unknown,,cid:10)(cid:11)(cid:10)(cid:46)(cid:14)(cid:2)(cid:9)(cid:11)(cid:4)(cid:3)(cid:49)(cid:4)(cid:8)(cid:5)(cid:2)(cid:28)(cid:3,,7466.0
,,34,,,Unknown,,cid:10)(cid:11)(cid:10)(cid:46)(cid:14)(cid:2)(cid:9)(cid:11)(cid:4)(cid:3)(cid:49)(cid:4)(cid:8)(cid:5)(cid:2)(cid:28)(cid:3,,7500.0
,,33,,,Unknown,,cid:10)(cid:11)(cid:10)(cid:46)(cid:14)(cid:2)(cid:9)(cid:11)(cid:4)(cid:3)(cid:49)(cid:4)(cid:8)(cid:5)(cid:2)(cid:28)(cid:3,,7533.0
,,18,,,Unknown,,cid:10)(cid:11)(cid:10)(cid:46)(cid:14)(cid:2)(cid:9)(cid:11)(cid:4)(cid:3)(cid:49)(cid:4)(cid:8)(cid:5)(cid:2)(cid:28)(cid:3,,7551.0
,,34,,,Unknown,,cid:10)(cid:11)(cid:10)(cid:46)(cid:14)(cid:2)(cid:9)(cid:11)(cid:4)(cid:3)(cid:49)(cid:4)(cid:8)(cid:5)(cid:2)(cid:28)(cid:3,,7585.0
,,45,,,Unknown,,cid:10)(cid:11)(cid:10)(cid:46)(cid:14)(cid:2)(cid:9)(cid:11)(cid:4)(cid:3)(cid:49)(cid:4)(cid:8)(cid:5)(cid:2)(cid:28)(cid:3,,7630.0
,,18,,,Unknown,,cid:10)(cid:11)(cid:10)(cid:46)(cid:14)(cid:2)(cid:9)(cid:11)(cid:4)(cid:3)(cid:49)(cid:4)(cid:8)(cid:5)(cid:2)(cid:28)(cid:3,,7648.0
,,35,,,Unknown,,cid:10)(cid:11)(cid:10)(cid:46)(cid:14)(cid:2)(cid:9)(cid:11)(cid:4)(cid:3)(cid:49)(cid:4)(cid:8)(cid:5)(cid:2)(cid:28)(cid:3,,7683.0
,,14,,,Unknown,,cid:10)(cid:11)(cid:10)(cid:46)(cid:14)(cid:2)(cid:9)(cid:11)(cid:4)(cid:3)(cid:49)(cid:4)(cid:8)(cid:5)(cid:2)(cid:28)(cid:3,,7697.0
,,46,,,Unknown,,cid:10)(cid:11)(cid:10)(cid:46)(cid:14)(cid:2)(cid:9)(cid:11)(cid:4)(cid:3)(cid:49)(cid:4)(cid:8)(cid:5)(cid:2)(cid:28)(cid:3,,7743.0
,,2,,,Unknown,,cid:10)(cid:11)(cid:10)(cid:46)(cid:14)(cid:2)(cid:9)(cid:11)(cid:4)(cid:3)(cid:49)(cid:4)(cid:8)(cid:5)(cid:2)(cid:28)(cid:3,,7745.0
,,39,,,Unknown,,cid:10)(cid:11)(cid:10)(cid:46)(cid:14)(cid:2)(cid:9)(cid:11)(cid:4)(cid:3)(cid:49)(cid:4)(cid:8)(cid:5)(cid:2)(cid:28)(cid:3,,7784.0
,,11,,,Unknown,,cid:10)(cid:11)(cid:10)(cid:46)(cid:14)(cid:2)(cid:9)(cid:11)(cid:4)(cid:3)(cid:49)(cid:4)(cid:8)(cid:5)(cid:2)(cid:28)(cid:3,,7795.0
,,9,,,Unknown,,cid:10)(cid:11)(cid:10)(cid:46)(cid:14)(cid:2)(cid:9)(cid:11)(cid:4)(cid:3)(cid:49)(cid:4)(cid:8)(cid:5)(cid:2)(cid:28)(cid:3,,7804.0
,,10,,,Unknown,,cid:10)(cid:11)(cid:10)(cid:46)(cid:14)(cid:2)(cid:9)(cid:11)(cid:4)(cid:3)(cid:49)(cid:4)(cid:8)(cid:5)(cid:2)(cid:28)(cid:3,,7814.0
,,5,,,Unknown,,cid:10)(cid:11)(cid:10)(cid:46)(cid:14)(cid:2)(cid:9)(cid:11)(cid:4)(cid:3)(cid:49)(cid:4)(cid:8)(cid:5)(cid:2)(cid:28)(cid:3,,7819.0
,,2,,,Unknown,,cid:10)(cid:11)(cid:10)(cid:46)(cid:14)(cid:2)(cid:9)(cid:11)(cid:4)(cid:3)(cid:49)(cid:4)(cid:8)(cid:5)(cid:2)(cid:28)(cid:3,,7821.0
,,16,,,Unknown,,cid:10)(cid:11)(cid:10)(cid:46)(cid:14)(cid:2)(cid:9)(cid:11)(cid:4)(cid:3)(cid:49)(cid:4)(cid:8)(cid:5)(cid:2)(cid:28)(cid:3,,7837.0
,,16,,,Unknown,,cid:10)(cid:11)(cid:10)(cid:46)(cid:14)(cid:2)(cid:9)(cid:11)(cid:4)(cid:3)(cid:49)(cid:4)(cid:8)(cid:5)(cid:2)(cid:28)(cid:3,,7853.0
,,33,,,Unknown,,cid:10)(cid:11)(cid:10)(cid:46)(cid:14)(cid:2)(cid:9)(cid:11)(cid:4)(cid:3)(cid:49)(cid:4)(cid:8)(cid:5)(cid:2)(cid:28)(cid:3,,7886.0
,,1,,,Unknown,,cid:10)(cid:11)(cid:10)(cid:46)(cid:14)(cid:2)(cid:9)(cid:11)(cid:4)(cid:3)(cid:49)(cid:4)(cid:8)(cid:5)(cid:2)(cid:28)(cid:3,,7887.0
,,36,,,Unknown,,cid:10)(cid:11)(cid:10)(cid:46)(cid:14)(cid:2)(cid:9)(cid:11)(cid:4)(cid:3)(cid:49)(cid:4)(cid:8)(cid:5)(cid:2)(cid:28)(cid:3,,7923.0
,,18,,,Unknown,,cid:10)(cid:11)(cid:10)(cid:46)(cid:14)(cid:2)(cid:9)(cid:11)(cid:4)(cid:3)(cid:49)(cid:4)(cid:8)(cid:5)(cid:2)(cid:28)(cid:3,,7941.0
,,2,,,Unknown,,cid:10)(cid:11)(cid:10)(cid:46)(cid:14)(cid:2)(cid:9)(cid:11)(cid:4)(cid:3)(cid:49)(cid:4)(cid:8)(cid:5)(cid:2)(cid:28)(cid:3,,7943.0
,,12,,,Unknown,,cid:10)(cid:11)(cid:10)(cid:46)(cid:14)(cid:2)(cid:9)(cid:11)(cid:4)(cid:3)(cid:49)(cid:4)(cid:8)(cid:5)(cid:2)(cid:28)(cid:3,,7955.0
,,11,,,Unknown,,cid:10)(cid:11)(cid:10)(cid:46)(cid:14)(cid:2)(cid:9)(cid:11)(cid:4)(cid:3)(cid:49)(cid:4)(cid:8)(cid:5)(cid:2)(cid:28)(cid:3,,7966.0
,,4,,,Unknown,,cid:10)(cid:11)(cid:10)(cid:46)(cid:14)(cid:2)(cid:9)(cid:11)(cid:4)(cid:3)(cid:49)(cid:4)(cid:8)(cid:5)(cid:2)(cid:28)(cid:3,,7970.0
,,14,,,Unknown,,cid:10)(cid:11)(cid:10)(cid:46)(cid:14)(cid:2)(cid:9)(cid:11)(cid:4)(cid:3)(cid:49)(cid:4)(cid:8)(cid:5)(cid:2)(cid:28)(cid:3,,7984.0
,,11,,,Unknown,,cid:10)(cid:11)(cid:10)(cid:46)(cid:14)(cid:2)(cid:9)(cid:11)(cid:4)(cid:3)(cid:49)(cid:4)(cid:8)(cid:5)(cid:2)(cid:28)(cid:3,,7995.0
,,54,,,Unknown,,cid:10)(cid:11)(cid:10)(cid:46)(cid:14)(cid:2)(cid:9)(cid:11)(cid:4)(cid:3)(cid:49)(cid:4)(cid:8)(cid:5)(cid:2)(cid:28)(cid:3,,8049.0
,,54,,,Unknown,,cid:10)(cid:11)(cid:10)(cid:46)(cid:14)(cid:2)(cid:9)(cid:11)(cid:4)(cid:3)(cid:49)(cid:4)(cid:8)(cid:5)(cid:2)(cid:28)(cid:3,,8103.0
,,7,,,Unknown,,cid:10)(cid:11)(cid:10)(cid:46)(cid:14)(cid:2)(cid:9)(cid:11)(cid:4)(cid:3)(cid:49)(cid:4)(cid:8)(cid:5)(cid:2)(cid:28)(cid:3,,8110.0
,,5,,,Unknown,,cid:10)(cid:11)(cid:10)(cid:46)(cid:14)(cid:2)(cid:9)(cid:11)(cid:4)(cid:3)(cid:49)(cid:4)(cid:8)(cid:5)(cid:2)(cid:28)(cid:3,,8115.0
,,3,,,Unknown,,cid:10)(cid:11)(cid:10)(cid:46)(cid:14)(cid:2)(cid:9)(cid:11)(cid:4)(cid:3)(cid:49)(cid:4)(cid:8)(cid:5)(cid:2)(cid:28)(cid:3,,8118.0
,,9,,,Unknown,,cid:10)(cid:11)(cid:10)(cid:46)(cid:14)(cid:2)(cid:9)(cid:11)(cid:4)(cid:3)(cid:49)(cid:4)(cid:8)(cid:5)(cid:2)(cid:28)(cid:3,,8127.0
,,2,,,Unknown,,cid:10)(cid:11)(cid:10)(cid:46)(cid:14)(cid:2)(cid:9)(cid:11)(cid:4)(cid:3)(cid:49)(cid:4)(cid:8)(cid:5)(cid:2)(cid:28)(cid:3,,8129.0
,,28,,,Unknown,,cid:10)(cid:11)(cid:10)(cid:46)(cid:14)(cid:2)(cid:9)(cid:11)(cid:4)(cid:3)(cid:49)(cid:4)(cid:8)(cid:5)(cid:2)(cid:28)(cid:3,,8157.0
,,3,,,Unknown,,cid:10)(cid:11)(cid:10)(cid:46)(cid:14)(cid:2)(cid:9)(cid:11)(cid:4)(cid:3)(cid:49)(cid:4)(cid:8)(cid:5)(cid:2)(cid:28)(cid:3,,8160.0
,,15,,,Unknown,,cid:10)(cid:11)(cid:10)(cid:46)(cid:14)(cid:2)(cid:9)(cid:11)(cid:4)(cid:3)(cid:49)(cid:4)(cid:8)(cid:5)(cid:2)(cid:28)(cid:3,,8175.0
,,2,,,Unknown,,cid:10)(cid:11)(cid:10)(cid:46)(cid:14)(cid:2)(cid:9)(cid:11)(cid:4)(cid:3)(cid:49)(cid:4)(cid:8)(cid:5)(cid:2)(cid:28)(cid:3,,8177.0
,,17,,,Unknown,,cid:10)(cid:11)(cid:10)(cid:46)(cid:14)(cid:2)(cid:9)(cid:11)(cid:4)(cid:3)(cid:49)(cid:4)(cid:8)(cid:5)(cid:2)(cid:28)(cid:3,,8194.0
,,19,,,Unknown,,cid:10)(cid:11)(cid:10)(cid:46)(cid:14)(cid:2)(cid:9)(cid:11)(cid:4)(cid:3)(cid:49)(cid:4)(cid:8)(cid:5)(cid:2)(cid:28)(cid:3,,8213.0
,,16,,,Unknown,,cid:10)(cid:11)(cid:10)(cid:46)(cid:14)(cid:2)(cid:9)(cid:11)(cid:4)(cid:3)(cid:49)(cid:4)(cid:8)(cid:5)(cid:2)(cid:28)(cid:3,,8229.0
,,32,,,Unknown,,cid:10)(cid:11)(cid:10)(cid:46)(cid:14)(cid:2)(cid:9)(cid:11)(cid:4)(cid:3)(cid:49)(cid:4)(cid:8)(cid:5)(cid:2)(cid:28)(cid:3,,8261.0
,,2,,,Unknown,,cid:10)(cid:11)(cid:10)(cid:46)(cid:14)(cid:2)(cid:9)(cid:11)(cid:4)(cid:3)(cid:49)(cid:4)(cid:8)(cid:5)(cid:2)(cid:28)(cid:3,,8263.0
,,44,,,Unknown,,cid:10)(cid:11)(cid:10)(cid:46)(cid:14)(cid:2)(cid:9)(cid:11)(cid:4)(cid:3)(cid:49)(cid:4)(cid:8)(cid:5)(cid:2)(cid:28)(cid:3,,8307.0
,,12,,,Unknown,,cid:10)(cid:11)(cid:10)(cid:46)(cid:14)(cid:2)(cid:9)(cid:11)(cid:4)(cid:3)(cid:49)(cid:4)(cid:8)(cid:5)(cid:2)(cid:28)(cid:3,,8319.0
,,29,,,Unknown,,cid:10)(cid:11)(cid:10)(cid:46)(cid:14)(cid:2)(cid:9)(cid:11)(cid:4)(cid:3)(cid:49)(cid:4)(cid:8)(cid:5)(cid:2)(cid:28)(cid:3,,8348.0
,,26,,,Unknown,,cid:10)(cid:11)(cid:10)(cid:46)(cid:14)(cid:2)(cid:9)(cid:11)(cid:4)(cid:3)(cid:49)(cid:4)(cid:8)(cid:5)(cid:2)(cid:28)(cid:3,,8374.0
,,41,,,Unknown,,cid:10)(cid:11)(cid:10)(cid:46)(cid:14)(cid:2)(cid:9)(cid:11)(cid:4)(cid:3)(cid:49)(cid:4)(cid:8)(cid:5)(cid:2)(cid:28)(cid:3,,8415.0
,,25,,,Unknown,,cid:10)(cid:11)(cid:10)(cid:46)(cid:14)(cid:2)(cid:9)(cid:11)(cid:4)(cid:3)(cid:49)(cid:4)(cid:8)(cid:5)(cid:2)(cid:28)(cid:3,,8440.0
,,2,,,Unknown,,cid:10)(cid:11)(cid:10)(cid:46)(cid:14)(cid:2)(cid:9)(cid:11)(cid:4)(cid:3)(cid:49)(cid:4)(cid:8)(cid:5)(cid:2)(cid:28)(cid:3,,8442.0
,,50,,,Unknown,,cid:10)(cid:11)(cid:10)(cid:46)(cid:14)(cid:2)(cid:9)(cid:11)(cid:4)(cid:3)(cid:49)(cid:4)(cid:8)(cid:5)(cid:2)(cid:28)(cid:3,,8492.0
,,50,,,Unknown,,cid:10)(cid:11)(cid:10)(cid:46)(cid:14)(cid:2)(cid:9)(cid:11)(cid:4)(cid:3)(cid:49)(cid:4)(cid:8)(cid:5)(cid:2)(cid:28)(cid:3,,8542.0
,,37,,,Unknown,,cid:10)(cid:11)(cid:10)(cid:46)(cid:14)(cid:2)(cid:9)(cid:11)(cid:4)(cid:3)(cid:49)(cid:4)(cid:8)(cid:5)(cid:2)(cid:28)(cid:3,,8579.0
,,16,,,Unknown,,cid:10)(cid:11)(cid:10)(cid:46)(cid:14)(cid:2)(cid:9)(cid:11)(cid:4)(cid:3)(cid:49)(cid:4)(cid:8)(cid:5)(cid:2)(cid:28)(cid:3,,8595.0
,,34,,,Unknown,,cid:10)(cid:11)(cid:10)(cid:46)(cid:14)(cid:2)(cid:9)(cid:11)(cid:4)(cid:3)(cid:49)(cid:4)(cid:8)(cid:5)(cid:2)(cid:28)(cid:3,,8629.0
,,33,,,Unknown,,cid:10)(cid:11)(cid:10)(cid:46)(cid:14)(cid:2)(cid:9)(cid:11)(cid:4)(cid:3)(cid:49)(cid:4)(cid:8)(cid:5)(cid:2)(cid:28)(cid:3,,8662.0
,,18,,,Unknown,,cid:10)(cid:11)(cid:10)(cid:46)(cid:14)(cid:2)(cid:9)(cid:11)(cid:4)(cid:3)(cid:49)(cid:4)(cid:8)(cid:5)(cid:2)(cid:28)(cid:3,,8680.0
,,34,,,Unknown,,cid:10)(cid:11)(cid:10)(cid:46)(cid:14)(cid:2)(cid:9)(cid:11)(cid:4)(cid:3)(cid:49)(cid:4)(cid:8)(cid:5)(cid:2)(cid:28)(cid:3,,8714.0
,,45,,,Unknown,,cid:10)(cid:11)(cid:10)(cid:46)(cid:14)(cid:2)(cid:9)(cid:11)(cid:4)(cid:3)(cid:49)(cid:4)(cid:8)(cid:5)(cid:2)(cid:28)(cid:3,,8759.0
,,18,,,Unknown,,cid:10)(cid:11)(cid:10)(cid:46)(cid:14)(cid:2)(cid:9)(cid:11)(cid:4)(cid:3)(cid:49)(cid:4)(cid:8)(cid:5)(cid:2)(cid:28)(cid:3,,8777.0
,,35,,,Unknown,,cid:10)(cid:11)(cid:10)(cid:46)(cid:14)(cid:2)(cid:9)(cid:11)(cid:4)(cid:3)(cid:49)(cid:4)(cid:8)(cid:5)(cid:2)(cid:28)(cid:3,,8812.0
,,46,,,Unknown,,cid:10)(cid:11)(cid:10)(cid:46)(cid:14)(cid:2)(cid:9)(cid:11)(cid:4)(cid:3)(cid:49)(cid:4)(cid:8)(cid:5)(cid:2)(cid:28)(cid:3,,8858.0
,,31,,,Unknown,,cid:10)(cid:11)(cid:10)(cid:46)(cid:14)(cid:2)(cid:9)(cid:11)(cid:4)(cid:3)(cid:49)(cid:4)(cid:8)(cid:5)(cid:2)(cid:28)(cid:3,,8889.0
,,41,,,Unknown,,cid:10)(cid:11)(cid:10)(cid:46)(cid:14)(cid:2)(cid:9)(cid:11)(cid:4)(cid:3)(cid:49)(cid:4)(cid:8)(cid:5)(cid:2)(cid:28)(cid:3,,8930.0
,,24,,,Unknown,,cid:10)(cid:11)(cid:10)(cid:46)(cid:14)(cid:2)(cid:9)(cid:11)(cid:4)(cid:3)(cid:49)(cid:4)(cid:8)(cid:5)(cid:2)(cid:28)(cid:3,,8954.0
,,20,,,Unknown,,cid:10)(cid:11)(cid:10)(cid:46)(cid:14)(cid:2)(cid:9)(cid:11)(cid:4)(cid:3)(cid:49)(cid:4)(cid:8)(cid:5)(cid:2)(cid:28)(cid:3,,8974.0
,,30,,,Unknown,,cid:10)(cid:11)(cid:10)(cid:46)(cid:14)(cid:2)(cid:9)(cid:11)(cid:4)(cid:3)(cid:49)(cid:4)(cid:8)(cid:5)(cid:2)(cid:28)(cid:3,,9004.0
,,2,,,Unknown,,cid:10)(cid:11)(cid:10)(cid:46)(cid:14)(cid:2)(cid:9)(cid:11)(cid:4)(cid:3)(cid:49)(cid:4)(cid:8)(cid:5)(cid:2)(cid:28)(cid:3,,9006.0
,,36,,,Unknown,,cid:10)(cid:11)(cid:10)(cid:46)(cid:14)(cid:2)(cid:9)(cid:11)(cid:4)(cid:3)(cid:49)(cid:4)(cid:8)(cid:5)(cid:2)(cid:28)(cid:3,,9042.0
,,17,,,Unknown,,cid:10)(cid:11)(cid:10)(cid:46)(cid:14)(cid:2)(cid:9)(cid:11)(cid:4)(cid:3)(cid:49)(cid:4)(cid:8)(cid:5)(cid:2)(cid:28)(cid:3,,9059.0
,,17,,,Unknown,,cid:10)(cid:11)(cid:10)(cid:46)(cid:14)(cid:2)(cid:9)(cid:11)(cid:4)(cid:3)(cid:49)(cid:4)(cid:8)(cid:5)(cid:2)(cid:28)(cid:3,,9076.0
,,33,,,Unknown,,cid:10)(cid:11)(cid:10)(cid:46)(cid:14)(cid:2)(cid:9)(cid:11)(cid:4)(cid:3)(cid:49)(cid:4)(cid:8)(cid:5)(cid:2)(cid:28)(cid:3,,9109.0
,,2,,,Unknown,,cid:10)(cid:11)(cid:10)(cid:46)(cid:14)(cid:2)(cid:9)(cid:11)(cid:4)(cid:3)(cid:49)(cid:4)(cid:8)(cid:5)(cid:2)(cid:28)(cid:3,,9111.0
,,12,,,Unknown,,cid:10)(cid:11)(cid:10)(cid:46)(cid:14)(cid:2)(cid:9)(cid:11)(cid:4)(cid:3)(cid:49)(cid:4)(cid:8)(cid:5)(cid:2)(cid:28)(cid:3,,9123.0
,,20,,,Unknown,,cid:10)(cid:11)(cid:10)(cid:46)(cid:14)(cid:2)(cid:9)(cid:11)(cid:4)(cid:3)(cid:49)(cid:4)(cid:8)(cid:5)(cid:2)(cid:28)(cid:3,,9143.0
,,21,,,Unknown,,cid:10)(cid:11)(cid:10)(cid:46)(cid:14)(cid:2)(cid:9)(cid:11)(cid:4)(cid:3)(cid:49)(cid:4)(cid:8)(cid:5)(cid:2)(cid:28)(cid:3,,9164.0
,,22,,,Unknown,,cid:10)(cid:11)(cid:10)(cid:46)(cid:14)(cid:2)(cid:9)(cid:11)(cid:4)(cid:3)(cid:49)(cid:4)(cid:8)(cid:5)(cid:2)(cid:28)(cid:3,,9186.0
,,20,,,Unknown,,cid:10)(cid:11)(cid:10)(cid:46)(cid:14)(cid:2)(cid:9)(cid:11)(cid:4)(cid:3)(cid:49)(cid:4)(cid:8)(cid:5)(cid:2)(cid:28)(cid:3,,9206.0
,,23,,,Unknown,,cid:10)(cid:11)(cid:10)(cid:46)(cid:14)(cid:2)(cid:9)(cid:11)(cid:4)(cid:3)(cid:49)(cid:4)(cid:8)(cid:5)(cid:2)(cid:28)(cid:3,,9229.0
,,23,,,Unknown,,cid:10)(cid:11)(cid:10)(cid:46)(cid:14)(cid:2)(cid:9)(cid:11)(cid:4)(cid:3)(cid:49)(cid:4)(cid:8)(cid:5)(cid:2)(cid:28)(cid:3,,9252.0
,,24,,,Unknown,,cid:10)(cid:11)(cid:10)(cid:46)(cid:14)(cid:2)(cid:9)(cid:11)(cid:4)(cid:3)(cid:49)(cid:4)(cid:8)(cid:5)(cid:2)(cid:28)(cid:3,,9276.0
,,25,,,Unknown,,cid:10)(cid:11)(cid:10)(cid:46)(cid:14)(cid:2)(cid:9)(cid:11)(cid:4)(cid:3)(cid:49)(cid:4)(cid:8)(cid:5)(cid:2)(cid:28)(cid:3,,9301.0
,,26,,,Unknown,,cid:10)(cid:11)(cid:10)(cid:46)(cid:14)(cid:2)(cid:9)(cid:11)(cid:4)(cid:3)(cid:49)(cid:4)(cid:8)(cid:5)(cid:2)(cid:28)(cid:3,,9327.0
,,27,,,Unknown,,cid:10)(cid:11)(cid:10)(cid:46)(cid:14)(cid:2)(cid:9)(cid:11)(cid:4)(cid:3)(cid:49)(cid:4)(cid:8)(cid:5)(cid:2)(cid:28)(cid:3,,9354.0
,,2,,,Unknown,,cid:10)(cid:11)(cid:10)(cid:46)(cid:14)(cid:2)(cid:9)(cid:11)(cid:4)(cid:3)(cid:49)(cid:4)(cid:8)(cid:5)(cid:2)(cid:28)(cid:3,,9356.0
,,28,,,Unknown,,cid:10)(cid:11)(cid:10)(cid:46)(cid:14)(cid:2)(cid:9)(cid:11)(cid:4)(cid:3)(cid:49)(cid:4)(cid:8)(cid:5)(cid:2)(cid:28)(cid:3,,9384.0
,,3,,,Unknown,,cid:10)(cid:11)(cid:10)(cid:46)(cid:14)(cid:2)(cid:9)(cid:11)(cid:4)(cid:3)(cid:49)(cid:4)(cid:8)(cid:5)(cid:2)(cid:28)(cid:3,,9387.0
,,15,,,Unknown,,cid:10)(cid:11)(cid:10)(cid:46)(cid:14)(cid:2)(cid:9)(cid:11)(cid:4)(cid:3)(cid:49)(cid:4)(cid:8)(cid:5)(cid:2)(cid:28)(cid:3,,9402.0
,,2,,,Unknown,,cid:10)(cid:11)(cid:10)(cid:46)(cid:14)(cid:2)(cid:9)(cid:11)(cid:4)(cid:3)(cid:49)(cid:4)(cid:8)(cid:5)(cid:2)(cid:28)(cid:3,,9404.0
,,16,,,Unknown,,cid:10)(cid:11)(cid:10)(cid:46)(cid:14)(cid:2)(cid:9)(cid:11)(cid:4)(cid:3)(cid:49)(cid:4)(cid:8)(cid:5)(cid:2)(cid:28)(cid:3,,9420.0
,,33,,,Unknown,,cid:10)(cid:11)(cid:10)(cid:46)(cid:14)(cid:2)(cid:9)(cid:11)(cid:4)(cid:3)(cid:49)(cid:4)(cid:8)(cid:5)(cid:2)(cid:28)(cid:3,,9453.0
,,19,,,Unknown,,cid:10)(cid:11)(cid:10)(cid:46)(cid:14)(cid:2)(cid:9)(cid:11)(cid:4)(cid:3)(cid:49)(cid:4)(cid:8)(cid:5)(cid:2)(cid:28)(cid:3,,9472.0
,,16,,,Unknown,,cid:10)(cid:11)(cid:10)(cid:46)(cid:14)(cid:2)(cid:9)(cid:11)(cid:4)(cid:3)(cid:49)(cid:4)(cid:8)(cid:5)(cid:2)(cid:28)(cid:3,,9488.0
,,35,,,Unknown,,cid:10)(cid:11)(cid:10)(cid:46)(cid:14)(cid:2)(cid:9)(cid:11)(cid:4)(cid:3)(cid:49)(cid:4)(cid:8)(cid:5)(cid:2)(cid:28)(cid:3,,9523.0
,,2,,,Unknown,,cid:10)(cid:11)(cid:10)(cid:46)(cid:14)(cid:2)(cid:9)(cid:11)(cid:4)(cid:3)(cid:49)(cid:4)(cid:8)(cid:5)(cid:2)(cid:28)(cid:3,,9525.0
,,44,,,Unknown,,cid:10)(cid:11)(cid:10)(cid:46)(cid:14)(cid:2)(cid:9)(cid:11)(cid:4)(cid:3)(cid:49)(cid:4)(cid:8)(cid:5)(cid:2)(cid:28)(cid:3,,9569.0
,,12,,,Unknown,,cid:10)(cid:11)(cid:10)(cid:46)(cid:14)(cid:2)(cid:9)(cid:11)(cid:4)(cid:3)(cid:49)(cid:4)(cid:8)(cid:5)(cid:2)(cid:28)(cid:3,,9581.0
,,29,,,Unknown,,cid:10)(cid:11)(cid:10)(cid:46)(cid:14)(cid:2)(cid:9)(cid:11)(cid:4)(cid:3)(cid:49)(cid:4)(cid:8)(cid:5)(cid:2)(cid:28)(cid:3,,9610.0
,,26,,,Unknown,,cid:10)(cid:11)(cid:10)(cid:46)(cid:14)(cid:2)(cid:9)(cid:11)(cid:4)(cid:3)(cid:49)(cid:4)(cid:8)(cid:5)(cid:2)(cid:28)(cid:3,,9636.0
,,41,,,Unknown,,cid:10)(cid:11)(cid:10)(cid:46)(cid:14)(cid:2)(cid:9)(cid:11)(cid:4)(cid:3)(cid:49)(cid:4)(cid:8)(cid:5)(cid:2)(cid:28)(cid:3,,9677.0
,,25,,,Unknown,,cid:10)(cid:11)(cid:10)(cid:46)(cid:14)(cid:2)(cid:9)(cid:11)(cid:4)(cid:3)(cid:49)(cid:4)(cid:8)(cid:5)(cid:2)(cid:28)(cid:3,,9702.0
,,2,,,Unknown,,cid:10)(cid:11)(cid:10)(cid:46)(cid:14)(cid:2)(cid:9)(cid:11)(cid:4)(cid:3)(cid:49)(cid:4)(cid:8)(cid:5)(cid:2)(cid:28)(cid:3,,9704.0
,,50,,,Unknown,,cid:10)(cid:11)(cid:10)(cid:46)(cid:14)(cid:2)(cid:9)(cid:11)(cid:4)(cid:3)(cid:49)(cid:4)(cid:8)(cid:5)(cid:2)(cid:28)(cid:3,,9754.0
,,50,,,Unknown,,cid:10)(cid:11)(cid:10)(cid:46)(cid:14)(cid:2)(cid:9)(cid:11)(cid:4)(cid:3)(cid:49)(cid:4)(cid:8)(cid:5)(cid:2)(cid:28)(cid:3,,9804.0
,,37,,,Unknown,,cid:10)(cid:11)(cid:10)(cid:46)(cid:14)(cid:2)(cid:9)(cid:11)(cid:4)(cid:3)(cid:49)(cid:4)(cid:8)(cid:5)(cid:2)(cid:28)(cid:3,,9841.0
,,16,,,Unknown,,cid:10)(cid:11)(cid:10)(cid:46)(cid:14)(cid:2)(cid:9)(cid:11)(cid:4)(cid:3)(cid:49)(cid:4)(cid:8)(cid:5)(cid:2)(cid:28)(cid:3,,9857.0
,,34,,,Unknown,,cid:10)(cid:11)(cid:10)(cid:46)(cid:14)(cid:2)(cid:9)(cid:11)(cid:4)(cid:3)(cid:49)(cid:4)(cid:8)(cid:5)(cid:2)(cid:28)(cid:3,,9891.0
,,33,,,Unknown,,cid:10)(cid:11)(cid:10)(cid:46)(cid:14)(cid:2)(cid:9)(cid:11)(cid:4)(cid:3)(cid:49)(cid:4)(cid:8)(cid:5)(cid:2)(cid:28)(cid:3,,9924.0
,,18,,,Unknown,,cid:10)(cid:11)(cid:10)(cid:46)(cid:14)(cid:2)(cid:9)(cid:11)(cid:4)(cid:3)(cid:49)(cid:4)(cid:8)(cid:5)(cid:2)(cid:28)(cid:3,,9942.0
,,34,,,Unknown,,cid:10)(cid:11)(cid:10)(cid:46)(cid:14)(cid:2)(cid:9)(cid:11)(cid:4)(cid:3)(cid:49)(cid:4)(cid:8)(cid:5)(cid:2)(cid:28)(cid:3,,9976.0
,,45,,,Unknown,,cid:10)(cid:11)(cid:10)(cid:46)(cid:14)(cid:2)(cid:9)(cid:11)(cid:4)(cid:3)(cid:49)(cid:4)(cid:8)(cid:5)(cid:2)(cid:28)(cid:3,,10021.0
,,18,,,Unknown,,cid:10)(cid:11)(cid:10)(cid:46)(cid:14)(cid:2)(cid:9)(cid:11)(cid:4)(cid:3)(cid:49)(cid:4)(cid:8)(cid:5)(cid:2)(cid:28)(cid:3,,10039.0
,,35,,,Unknown,,cid:10)(cid:11)(cid:10)(cid:46)(cid:14)(cid:2)(cid:9)(cid:11)(cid:4)(cid:3)(cid:49)(cid:4)(cid:8)(cid:5)(cid:2)(cid:28)(cid:3,,10074.0
,,14,,,Unknown,,cid:10)(cid:11)(cid:10)(cid:46)(cid:14)(cid:2)(cid:9)(cid:11)(cid:4)(cid:3)(cid:49)(cid:4)(cid:8)(cid:5)(cid:2)(cid:28)(cid:3,,10088.0
,,5,,,Unknown,,cid:10)(cid:11)(cid:10)(cid:46)(cid:14)(cid:2)(cid:9)(cid:11)(cid:4)(cid:3)(cid:49)(cid:4)(cid:8)(cid:5)(cid:2)(cid:28)(cid:3,,10093.0
,,9,,,Unknown,,cid:10)(cid:11)(cid:10)(cid:46)(cid:14)(cid:2)(cid:9)(cid:11)(cid:4)(cid:3)(cid:49)(cid:4)(cid:8)(cid:5)(cid:2)(cid:28)(cid:3,,10102.0
,,2,,,Unknown,,cid:10)(cid:11)(cid:10)(cid:46)(cid:14)(cid:2)(cid:9)(cid:11)(cid:4)(cid:3)(cid:49)(cid:4)(cid:8)(cid:5)(cid:2)(cid:28)(cid:3,,10104.0
,,10,,,Unknown,,cid:10)(cid:11)(cid:10)(cid:46)(cid:14)(cid:2)(cid:9)(cid:11)(cid:4)(cid:3)(cid:49)(cid:4)(cid:8)(cid:5)(cid:2)(cid:28)(cid:3,,10114.0
,,5,,,Unknown,,cid:10)(cid:11)(cid:10)(cid:46)(cid:14)(cid:2)(cid:9)(cid:11)(cid:4)(cid:3)(cid:49)(cid:4)(cid:8)(cid:5)(cid:2)(cid:28)(cid:3,,10119.0
,,54,,,Unknown,,cid:10)(cid:11)(cid:10)(cid:46)(cid:14)(cid:2)(cid:9)(cid:11)(cid:4)(cid:3)(cid:49)(cid:4)(cid:8)(cid:5)(cid:2)(cid:28)(cid:3,,10173.0
,,39,,,Unknown,,cid:10)(cid:11)(cid:10)(cid:46)(cid:14)(cid:2)(cid:9)(cid:11)(cid:4)(cid:3)(cid:49)(cid:4)(cid:8)(cid:5)(cid:2)(cid:28)(cid:3,,10212.0
,,14,,,Unknown,,cid:10)(cid:11)(cid:10)(cid:46)(cid:14)(cid:2)(cid:9)(cid:11)(cid:4)(cid:3)(cid:49)(cid:4)(cid:8)(cid:5)(cid:2)(cid:28)(cid:3,,10226.0
,,7,,,Unknown,,cid:10)(cid:11)(cid:10)(cid:46)(cid:14)(cid:2)(cid:9)(cid:11)(cid:4)(cid:3)(cid:49)(cid:4)(cid:8)(cid:5)(cid:2)(cid:28)(cid:3,,10233.0
,,5,,,Unknown,,cid:10)(cid:11)(cid:10)(cid:46)(cid:14)(cid:2)(cid:9)(cid:11)(cid:4)(cid:3)(cid:49)(cid:4)(cid:8)(cid:5)(cid:2)(cid:28)(cid:3,,10238.0
,,3,,,Unknown,,cid:10)(cid:11)(cid:10)(cid:46)(cid:14)(cid:2)(cid:9)(cid:11)(cid:4)(cid:3)(cid:49)(cid:4)(cid:8)(cid:5)(cid:2)(cid:28)(cid:3,,10241.0
,,9,,,Unknown,,cid:10)(cid:11)(cid:10)(cid:46)(cid:14)(cid:2)(cid:9)(cid:11)(cid:4)(cid:3)(cid:49)(cid:4)(cid:8)(cid:5)(cid:2)(cid:28)(cid:3,,10250.0
,,2,,,Unknown,,cid:10)(cid:11)(cid:10)(cid:46)(cid:14)(cid:2)(cid:9)(cid:11)(cid:4)(cid:3)(cid:49)(cid:4)(cid:8)(cid:5)(cid:2)(cid:28)(cid:3,,10252.0
,,12,,,Unknown,,cid:10)(cid:11)(cid:10)(cid:46)(cid:14)(cid:2)(cid:9)(cid:11)(cid:4)(cid:3)(cid:49)(cid:4)(cid:8)(cid:5)(cid:2)(cid:28)(cid:3,,10264.0
,,11,,,Unknown,,cid:10)(cid:11)(cid:10)(cid:46)(cid:14)(cid:2)(cid:9)(cid:11)(cid:4)(cid:3)(cid:49)(cid:4)(cid:8)(cid:5)(cid:2)(cid:28)(cid:3,,10275.0
,,4,,,Unknown,,cid:10)(cid:11)(cid:10)(cid:46)(cid:14)(cid:2)(cid:9)(cid:11)(cid:4)(cid:3)(cid:49)(cid:4)(cid:8)(cid:5)(cid:2)(cid:28)(cid:3,,10279.0
,,14,,,Unknown,,cid:10)(cid:11)(cid:10)(cid:46)(cid:14)(cid:2)(cid:9)(cid:11)(cid:4)(cid:3)(cid:49)(cid:4)(cid:8)(cid:5)(cid:2)(cid:28)(cid:3,,10293.0
,,11,,,Unknown,,cid:10)(cid:11)(cid:10)(cid:46)(cid:14)(cid:2)(cid:9)(cid:11)(cid:4)(cid:3)(cid:49)(cid:4)(cid:8)(cid:5)(cid:2)(cid:28)(cid:3,,10304.0
,,54,,,Unknown,,cid:10)(cid:11)(cid:10)(cid:46)(cid:14)(cid:2)(cid:9)(cid:11)(cid:4)(cid:3)(cid:49)(cid:4)(cid:8)(cid:5)(cid:2)(cid:28)(cid:3,,10358.0
,,54,,,Unknown,,cid:10)(cid:11)(cid:10)(cid:46)(cid:14)(cid:2)(cid:9)(cid:11)(cid:4)(cid:3)(cid:49)(cid:4)(cid:8)(cid:5)(cid:2)(cid:28)(cid:3,,10412.0
,,7,,,Unknown,,cid:10)(cid:11)(cid:10)(cid:46)(cid:14)(cid:2)(cid:9)(cid:11)(cid:4)(cid:3)(cid:49)(cid:4)(cid:8)(cid:5)(cid:2)(cid:28)(cid:3,,10419.0
,,5,,,Unknown,,cid:10)(cid:11)(cid:10)(cid:46)(cid:14)(cid:2)(cid:9)(cid:11)(cid:4)(cid:3)(cid:49)(cid:4)(cid:8)(cid:5)(cid:2)(cid:28)(cid:3,,10424.0
,,3,,,Unknown,,cid:10)(cid:11)(cid:10)(cid:46)(cid:14)(cid:2)(cid:9)(cid:11)(cid:4)(cid:3)(cid:49)(cid:4)(cid:8)(cid:5)(cid:2)(cid:28)(cid:3,,10427.0
,,2,,,Unknown,,cid:10)(cid:11)(cid:10)(cid:46)(cid:14)(cid:2)(cid:9)(cid:11)(cid:4)(cid:3)(cid:49)(cid:4)(cid:8)(cid:5)(cid:2)(cid:28)(cid:3,,10429.0
,,28,,,Unknown,,cid:10)(cid:11)(cid:10)(cid:46)(cid:14)(cid:2)(cid:9)(cid:11)(cid:4)(cid:3)(cid:49)(cid:4)(cid:8)(cid:5)(cid:2)(cid:28)(cid:3,,10457.0
,,3,,,Unknown,,cid:10)(cid:11)(cid:10)(cid:46)(cid:14)(cid:2)(cid:9)(cid:11)(cid:4)(cid:3)(cid:49)(cid:4)(cid:8)(cid:5)(cid:2)(cid:28)(cid:3,,10460.0
,,15,,,Unknown,,cid:10)(cid:11)(cid:10)(cid:46)(cid:14)(cid:2)(cid:9)(cid:11)(cid:4)(cid:3)(cid:49)(cid:4)(cid:8)(cid:5)(cid:2)(cid:28)(cid:3,,10475.0
,,2,,,Unknown,,cid:10)(cid:11)(cid:10)(cid:46)(cid:14)(cid:2)(cid:9)(cid:11)(cid:4)(cid:3)(cid:49)(cid:4)(cid:8)(cid:5)(cid:2)(cid:28)(cid:3,,10477.0
,,17,,,Unknown,,cid:10)(cid:11)(cid:10)(cid:46)(cid:14)(cid:2)(cid:9)(cid:11)(cid:4)(cid:3)(cid:49)(cid:4)(cid:8)(cid:5)(cid:2)(cid:28)(cid:3,,10494.0
,,18,,,Unknown,,cid:10)(cid:11)(cid:10)(cid:46)(cid:14)(cid:2)(cid:9)(cid:11)(cid:4)(cid:3)(cid:49)(cid:4)(cid:8)(cid:5)(cid:2)(cid:28)(cid:3,,10512.0
,,37,,,Unknown,,cid:10)(cid:11)(cid:10)(cid:46)(cid:14)(cid:2)(cid:9)(cid:11)(cid:4)(cid:3)(cid:49)(cid:4)(cid:8)(cid:5)(cid:2)(cid:28)(cid:3,,10549.0
,,19,,,Unknown,,cid:10)(cid:11)(cid:10)(cid:46)(cid:14)(cid:2)(cid:9)(cid:11)(cid:4)(cid:3)(cid:49)(cid:4)(cid:8)(cid:5)(cid:2)(cid:28)(cid:3,,10568.0
,,16,,,Unknown,,cid:10)(cid:11)(cid:10)(cid:46)(cid:14)(cid:2)(cid:9)(cid:11)(cid:4)(cid:3)(cid:49)(cid:4)(cid:8)(cid:5)(cid:2)(cid:28)(cid:3,,10584.0
,,1,,,Unknown,,cid:10)(cid:11)(cid:10)(cid:46)(cid:14)(cid:2)(cid:9)(cid:11)(cid:4)(cid:3)(cid:49)(cid:4)(cid:8)(cid:5)(cid:2)(cid:28)(cid:3,,10585.0
,,2,,,Unknown,,cid:10)(cid:11)(cid:10)(cid:46)(cid:14)(cid:2)(cid:9)(cid:11)(cid:4)(cid:3)(cid:49)(cid:4)(cid:8)(cid:5)(cid:2)(cid:28)(cid:3,,10587.0
,,44,,,Unknown,,cid:10)(cid:11)(cid:10)(cid:46)(cid:14)(cid:2)(cid:9)(cid:11)(cid:4)(cid:3)(cid:49)(cid:4)(cid:8)(cid:5)(cid:2)(cid:28)(cid:3,,10631.0
,,12,,,Unknown,,cid:10)(cid:11)(cid:10)(cid:46)(cid:14)(cid:2)(cid:9)(cid:11)(cid:4)(cid:3)(cid:49)(cid:4)(cid:8)(cid:5)(cid:2)(cid:28)(cid:3,,10643.0
,,29,,,Unknown,,cid:10)(cid:11)(cid:10)(cid:46)(cid:14)(cid:2)(cid:9)(cid:11)(cid:4)(cid:3)(cid:49)(cid:4)(cid:8)(cid:5)(cid:2)(cid:28)(cid:3,,10672.0
,,26,,,Unknown,,cid:10)(cid:11)(cid:10)(cid:46)(cid:14)(cid:2)(cid:9)(cid:11)(cid:4)(cid:3)(cid:49)(cid:4)(cid:8)(cid:5)(cid:2)(cid:28)(cid:3,,10698.0
,,41,,,Unknown,,cid:10)(cid:11)(cid:10)(cid:46)(cid:14)(cid:2)(cid:9)(cid:11)(cid:4)(cid:3)(cid:49)(cid:4)(cid:8)(cid:5)(cid:2)(cid:28)(cid:3,,10739.0
,,25,,,Unknown,,cid:10)(cid:11)(cid:10)(cid:46)(cid:14)(cid:2)(cid:9)(cid:11)(cid:4)(cid:3)(cid:49)(cid:4)(cid:8)(cid:5)(cid:2)(cid:28)(cid:3,,10764.0
,,2,,,Unknown,,cid:10)(cid:11)(cid:10)(cid:46)(cid:14)(cid:2)(cid:9)(cid:11)(cid:4)(cid:3)(cid:49)(cid:4)(cid:8)(cid:5)(cid:2)(cid:28)(cid:3,,10766.0
,,50,,,Unknown,,cid:10)(cid:11)(cid:10)(cid:46)(cid:14)(cid:2)(cid:9)(cid:11)(cid:4)(cid:3)(cid:49)(cid:4)(cid:8)(cid:5)(cid:2)(cid:28)(cid:3,,10816.0
,,50,,,Unknown,,cid:10)(cid:11)(cid:10)(cid:46)(cid:14)(cid:2)(cid:9)(cid:11)(cid:4)(cid:3)(cid:49)(cid:4)(cid:8)(cid:5)(cid:2)(cid:28)(cid:3,,10866.0
,,37,,,Unknown,,cid:10)(cid:11)(cid:10)(cid:46)(cid:14)(cid:2)(cid:9)(cid:11)(cid:4)(cid:3)(cid:49)(cid:4)(cid:8)(cid:5)(cid:2)(cid:28)(cid:3,,10903.0
,,16,,,Unknown,,cid:10)(cid:11)(cid:10)(cid:46)(cid:14)(cid:2)(cid:9)(cid:11)(cid:4)(cid:3)(cid:49)(cid:4)(cid:8)(cid:5)(cid:2)(cid:28)(cid:3,,10919.0
,,34,,,Unknown,,cid:10)(cid:11)(cid:10)(cid:46)(cid:14)(cid:2)(cid:9)(cid:11)(cid:4)(cid:3)(cid:49)(cid:4)(cid:8)(cid:5)(cid:2)(cid:28)(cid:3,,10953.0
,,33,,,Unknown,,cid:10)(cid:11)(cid:10)(cid:46)(cid:14)(cid:2)(cid:9)(cid:11)(cid:4)(cid:3)(cid:49)(cid:4)(cid:8)(cid:5)(cid:2)(cid:28)(cid:3,,10986.0
,,18,,,Unknown,,cid:10)(cid:11)(cid:10)(cid:46)(cid:14)(cid:2)(cid:9)(cid:11)(cid:4)(cid:3)(cid:49)(cid:4)(cid:8)(cid:5)(cid:2)(cid:28)(cid:3,,11004.0
,,32,,,Unknown,,cid:10)(cid:11)(cid:10)(cid:46)(cid:14)(cid:2)(cid:9)(cid:11)(cid:4)(cid:3)(cid:49)(cid:4)(cid:8)(cid:5)(cid:2)(cid:28)(cid:3,,11036.0
,,45,,,Unknown,,cid:10)(cid:11)(cid:10)(cid:46)(cid:14)(cid:2)(cid:9)(cid:11)(cid:4)(cid:3)(cid:49)(cid:4)(cid:8)(cid:5)(cid:2)(cid:28)(cid:3,,11081.0
,,18,,,Unknown,,cid:10)(cid:11)(cid:10)(cid:46)(cid:14)(cid:2)(cid:9)(cid:11)(cid:4)(cid:3)(cid:49)(cid:4)(cid:8)(cid:5)(cid:2)(cid:28)(cid:3,,11099.0
,,35,,,Unknown,,cid:10)(cid:11)(cid:10)(cid:46)(cid:14)(cid:2)(cid:9)(cid:11)(cid:4)(cid:3)(cid:49)(cid:4)(cid:8)(cid:5)(cid:2)(cid:28)(cid:3,,11134.0
,,14,,,Unknown,,cid:10)(cid:11)(cid:10)(cid:46)(cid:14)(cid:2)(cid:9)(cid:11)(cid:4)(cid:3)(cid:49)(cid:4)(cid:8)(cid:5)(cid:2)(cid:28)(cid:3,,11148.0
,,5,,,Unknown,,cid:10)(cid:11)(cid:10)(cid:46)(cid:14)(cid:2)(cid:9)(cid:11)(cid:4)(cid:3)(cid:49)(cid:4)(cid:8)(cid:5)(cid:2)(cid:28)(cid:3,,11153.0
,,12,,,Unknown,,cid:10)(cid:11)(cid:10)(cid:46)(cid:14)(cid:2)(cid:9)(cid:11)(cid:4)(cid:3)(cid:49)(cid:4)(cid:8)(cid:5)(cid:2)(cid:28)(cid:3,,11165.0
,,14,,,Unknown,,cid:10)(cid:11)(cid:10)(cid:46)(cid:14)(cid:2)(cid:9)(cid:11)(cid:4)(cid:3)(cid:49)(cid:4)(cid:8)(cid:5)(cid:2)(cid:28)(cid:3,,11179.0
,,5,,,Unknown,,cid:10)(cid:11)(cid:10)(cid:46)(cid:14)(cid:2)(cid:9)(cid:11)(cid:4)(cid:3)(cid:49)(cid:4)(cid:8)(cid:5)(cid:2)(cid:28)(cid:3,,11184.0
,,3,,,Unknown,,cid:10)(cid:11)(cid:10)(cid:46)(cid:14)(cid:2)(cid:9)(cid:11)(cid:4)(cid:3)(cid:49)(cid:4)(cid:8)(cid:5)(cid:2)(cid:28)(cid:3,,11187.0
,,12,,,Unknown,,cid:10)(cid:11)(cid:10)(cid:46)(cid:14)(cid:2)(cid:9)(cid:11)(cid:4)(cid:3)(cid:49)(cid:4)(cid:8)(cid:5)(cid:2)(cid:28)(cid:3,,11199.0
,,2,,,Unknown,,cid:10)(cid:11)(cid:10)(cid:46)(cid:14)(cid:2)(cid:9)(cid:11)(cid:4)(cid:3)(cid:49)(cid:4)(cid:8)(cid:5)(cid:2)(cid:28)(cid:3,,11201.0
,,49,,,Unknown,,cid:10)(cid:11)(cid:10)(cid:46)(cid:14)(cid:2)(cid:9)(cid:11)(cid:4)(cid:3)(cid:49)(cid:4)(cid:8)(cid:5)(cid:2)(cid:28)(cid:3,,11250.0
,,7,,,Unknown,,cid:10)(cid:11)(cid:10)(cid:46)(cid:14)(cid:2)(cid:9)(cid:11)(cid:4)(cid:3)(cid:49)(cid:4)(cid:8)(cid:5)(cid:2)(cid:28)(cid:3,,11257.0
,,9,,,Unknown,,cid:10)(cid:11)(cid:10)(cid:46)(cid:14)(cid:2)(cid:9)(cid:11)(cid:4)(cid:3)(cid:49)(cid:4)(cid:8)(cid:5)(cid:2)(cid:28)(cid:3,,11266.0
,,10,,,Unknown,,cid:10)(cid:11)(cid:10)(cid:46)(cid:14)(cid:2)(cid:9)(cid:11)(cid:4)(cid:3)(cid:49)(cid:4)(cid:8)(cid:5)(cid:2)(cid:28)(cid:3,,11276.0
,,3,,,Unknown,,cid:10)(cid:11)(cid:10)(cid:46)(cid:14)(cid:2)(cid:9)(cid:11)(cid:4)(cid:3)(cid:49)(cid:4)(cid:8)(cid:5)(cid:2)(cid:28)(cid:3,,11279.0
,,2,,,Unknown,,cid:10)(cid:11)(cid:10)(cid:46)(cid:14)(cid:2)(cid:9)(cid:11)(cid:4)(cid:3)(cid:49)(cid:4)(cid:8)(cid:5)(cid:2)(cid:28)(cid:3,,11281.0
,,12,,,Unknown,,cid:10)(cid:11)(cid:10)(cid:46)(cid:14)(cid:2)(cid:9)(cid:11)(cid:4)(cid:3)(cid:49)(cid:4)(cid:8)(cid:5)(cid:2)(cid:28)(cid:3,,11293.0
,,11,,,Unknown,,cid:10)(cid:11)(cid:10)(cid:46)(cid:14)(cid:2)(cid:9)(cid:11)(cid:4)(cid:3)(cid:49)(cid:4)(cid:8)(cid:5)(cid:2)(cid:28)(cid:3,,11304.0
,,4,,,Unknown,,cid:10)(cid:11)(cid:10)(cid:46)(cid:14)(cid:2)(cid:9)(cid:11)(cid:4)(cid:3)(cid:49)(cid:4)(cid:8)(cid:5)(cid:2)(cid:28)(cid:3,,11308.0
,,14,,,Unknown,,cid:10)(cid:11)(cid:10)(cid:46)(cid:14)(cid:2)(cid:9)(cid:11)(cid:4)(cid:3)(cid:49)(cid:4)(cid:8)(cid:5)(cid:2)(cid:28)(cid:3,,11322.0
,,11,,,Unknown,,cid:10)(cid:11)(cid:10)(cid:46)(cid:14)(cid:2)(cid:9)(cid:11)(cid:4)(cid:3)(cid:49)(cid:4)(cid:8)(cid:5)(cid:2)(cid:28)(cid:3,,11333.0
,,54,,,Unknown,,cid:10)(cid:11)(cid:10)(cid:46)(cid:14)(cid:2)(cid:9)(cid:11)(cid:4)(cid:3)(cid:49)(cid:4)(cid:8)(cid:5)(cid:2)(cid:28)(cid:3,,11387.0
,,54,,,Unknown,,cid:10)(cid:11)(cid:10)(cid:46)(cid:14)(cid:2)(cid:9)(cid:11)(cid:4)(cid:3)(cid:49)(cid:4)(cid:8)(cid:5)(cid:2)(cid:28)(cid:3,,11441.0
,,7,,,Unknown,,cid:10)(cid:11)(cid:10)(cid:46)(cid:14)(cid:2)(cid:9)(cid:11)(cid:4)(cid:3)(cid:49)(cid:4)(cid:8)(cid:5)(cid:2)(cid:28)(cid:3,,11448.0
,,5,,,Unknown,,cid:10)(cid:11)(cid:10)(cid:46)(cid:14)(cid:2)(cid:9)(cid:11)(cid:4)(cid:3)(cid:49)(cid:4)(cid:8)(cid:5)(cid:2)(cid:28)(cid:3,,11453.0
,,3,,,Unknown,,cid:10)(cid:11)(cid:10)(cid:46)(cid:14)(cid:2)(cid:9)(cid:11)(cid:4)(cid:3)(cid:49)(cid:4)(cid:8)(cid:5)(cid:2)(cid:28)(cid:3,,11456.0
,,2,,,Unknown,,cid:10)(cid:11)(cid:10)(cid:46)(cid:14)(cid:2)(cid:9)(cid:11)(cid:4)(cid:3)(cid:49)(cid:4)(cid:8)(cid:5)(cid:2)(cid:28)(cid:3,,11458.0
,,28,,,Unknown,,cid:10)(cid:11)(cid:10)(cid:46)(cid:14)(cid:2)(cid:9)(cid:11)(cid:4)(cid:3)(cid:49)(cid:4)(cid:8)(cid:5)(cid:2)(cid:28)(cid:3,,11486.0
,,3,,,Unknown,,cid:10)(cid:11)(cid:10)(cid:46)(cid:14)(cid:2)(cid:9)(cid:11)(cid:4)(cid:3)(cid:49)(cid:4)(cid:8)(cid:5)(cid:2)(cid:28)(cid:3,,11489.0
,,15,,,Unknown,,cid:10)(cid:11)(cid:10)(cid:46)(cid:14)(cid:2)(cid:9)(cid:11)(cid:4)(cid:3)(cid:49)(cid:4)(cid:8)(cid:5)(cid:2)(cid:28)(cid:3,,11504.0
,,2,,,Unknown,,cid:10)(cid:11)(cid:10)(cid:46)(cid:14)(cid:2)(cid:9)(cid:11)(cid:4)(cid:3)(cid:49)(cid:4)(cid:8)(cid:5)(cid:2)(cid:28)(cid:3,,11506.0
,,1,,,Unknown,,cid:10)(cid:11)(cid:10)(cid:46)(cid:14)(cid:2)(cid:9)(cid:11)(cid:4)(cid:3)(cid:49)(cid:4)(cid:8)(cid:5)(cid:2)(cid:28)(cid:3,,11507.0
,,33,,,Unknown,,cid:10)(cid:11)(cid:10)(cid:46)(cid:14)(cid:2)(cid:9)(cid:11)(cid:4)(cid:3)(cid:49)(cid:4)(cid:8)(cid:5)(cid:2)(cid:28)(cid:3,,11540.0
,,36,,,Unknown,,cid:10)(cid:11)(cid:10)(cid:46)(cid:14)(cid:2)(cid:9)(cid:11)(cid:4)(cid:3)(cid:49)(cid:4)(cid:8)(cid:5)(cid:2)(cid:28)(cid:3,,11576.0
,,19,,,Unknown,,cid:10)(cid:11)(cid:10)(cid:46)(cid:14)(cid:2)(cid:9)(cid:11)(cid:4)(cid:3)(cid:49)(cid:4)(cid:8)(cid:5)(cid:2)(cid:28)(cid:3,,11595.0
,,35,,,Unknown,,cid:10)(cid:11)(cid:10)(cid:46)(cid:14)(cid:2)(cid:9)(cid:11)(cid:4)(cid:3)(cid:49)(cid:4)(cid:8)(cid:5)(cid:2)(cid:28)(cid:3,,11630.0
,,16,,,Unknown,,cid:10)(cid:11)(cid:10)(cid:46)(cid:14)(cid:2)(cid:9)(cid:11)(cid:4)(cid:3)(cid:49)(cid:4)(cid:8)(cid:5)(cid:2)(cid:28)(cid:3,,11646.0
,,2,,,Unknown,,cid:10)(cid:11)(cid:10)(cid:46)(cid:14)(cid:2)(cid:9)(cid:11)(cid:4)(cid:3)(cid:49)(cid:4)(cid:8)(cid:5)(cid:2)(cid:28)(cid:3,,11648.0
,,44,,,Unknown,,cid:10)(cid:11)(cid:10)(cid:46)(cid:14)(cid:2)(cid:9)(cid:11)(cid:4)(cid:3)(cid:49)(cid:4)(cid:8)(cid:5)(cid:2)(cid:28)(cid:3,,11692.0
,,12,,,Unknown,,cid:10)(cid:11)(cid:10)(cid:46)(cid:14)(cid:2)(cid:9)(cid:11)(cid:4)(cid:3)(cid:49)(cid:4)(cid:8)(cid:5)(cid:2)(cid:28)(cid:3,,11704.0
,,29,,,Unknown,,cid:10)(cid:11)(cid:10)(cid:46)(cid:14)(cid:2)(cid:9)(cid:11)(cid:4)(cid:3)(cid:49)(cid:4)(cid:8)(cid:5)(cid:2)(cid:28)(cid:3,,11733.0
,,26,,,Unknown,,cid:10)(cid:11)(cid:10)(cid:46)(cid:14)(cid:2)(cid:9)(cid:11)(cid:4)(cid:3)(cid:49)(cid:4)(cid:8)(cid:5)(cid:2)(cid:28)(cid:3,,11759.0
,,41,,,Unknown,,cid:10)(cid:11)(cid:10)(cid:46)(cid:14)(cid:2)(cid:9)(cid:11)(cid:4)(cid:3)(cid:49)(cid:4)(cid:8)(cid:5)(cid:2)(cid:28)(cid:3,,11800.0
,,25,,,Unknown,,cid:10)(cid:11)(cid:10)(cid:46)(cid:14)(cid:2)(cid:9)(cid:11)(cid:4)(cid:3)(cid:49)(cid:4)(cid:8)(cid:5)(cid:2)(cid:28)(cid:3,,11825.0
,,2,,,Unknown,,cid:10)(cid:11)(cid:10)(cid:46)(cid:14)(cid:2)(cid:9)(cid:11)(cid:4)(cid:3)(cid:49)(cid:4)(cid:8)(cid:5)(cid:2)(cid:28)(cid:3,,11827.0
,,50,,,Unknown,,cid:10)(cid:11)(cid:10)(cid:46)(cid:14)(cid:2)(cid:9)(cid:11)(cid:4)(cid:3)(cid:49)(cid:4)(cid:8)(cid:5)(cid:2)(cid:28)(cid:3,,11877.0
,,50,,,Unknown,,cid:10)(cid:11)(cid:10)(cid:46)(cid:14)(cid:2)(cid:9)(cid:11)(cid:4)(cid:3)(cid:49)(cid:4)(cid:8)(cid:5)(cid:2)(cid:28)(cid:3,,11927.0
,,37,,,Unknown,,cid:10)(cid:11)(cid:10)(cid:46)(cid:14)(cid:2)(cid:9)(cid:11)(cid:4)(cid:3)(cid:49)(cid:4)(cid:8)(cid:5)(cid:2)(cid:28)(cid:3,,11964.0
,,16,,,Unknown,,cid:10)(cid:11)(cid:10)(cid:46)(cid:14)(cid:2)(cid:9)(cid:11)(cid:4)(cid:3)(cid:49)(cid:4)(cid:8)(cid:5)(cid:2)(cid:28)(cid:3,,11980.0
,,34,,,Unknown,,cid:10)(cid:11)(cid:10)(cid:46)(cid:14)(cid:2)(cid:9)(cid:11)(cid:4)(cid:3)(cid:49)(cid:4)(cid:8)(cid:5)(cid:2)(cid:28)(cid:3,,12014.0
,,33,,,Unknown,,cid:10)(cid:11)(cid:10)(cid:46)(cid:14)(cid:2)(cid:9)(cid:11)(cid:4)(cid:3)(cid:49)(cid:4)(cid:8)(cid:5)(cid:2)(cid:28)(cid:3,,12047.0
,,18,,,Unknown,,cid:10)(cid:11)(cid:10)(cid:46)(cid:14)(cid:2)(cid:9)(cid:11)(cid:4)(cid:3)(cid:49)(cid:4)(cid:8)(cid:5)(cid:2)(cid:28)(cid:3,,12065.0
,,32,,,Unknown,,cid:10)(cid:11)(cid:10)(cid:46)(cid:14)(cid:2)(cid:9)(cid:11)(cid:4)(cid:3)(cid:49)(cid:4)(cid:8)(cid:5)(cid:2)(cid:28)(cid:3,,12097.0
,,45,,,Unknown,,cid:10)(cid:11)(cid:10)(cid:46)(cid:14)(cid:2)(cid:9)(cid:11)(cid:4)(cid:3)(cid:49)(cid:4)(cid:8)(cid:5)(cid:2)(cid:28)(cid:3,,12142.0
,,18,,,Unknown,,cid:10)(cid:11)(cid:10)(cid:46)(cid:14)(cid:2)(cid:9)(cid:11)(cid:4)(cid:3)(cid:49)(cid:4)(cid:8)(cid:5)(cid:2)(cid:28)(cid:3,,12160.0
,,35,,,Unknown,,cid:10)(cid:11)(cid:10)(cid:46)(cid:14)(cid:2)(cid:9)(cid:11)(cid:4)(cid:3)(cid:49)(cid:4)(cid:8)(cid:5)(cid:2)(cid:28)(cid:3,,12195.0
,,54,,,Unknown,,cid:10)(cid:11)(cid:10)(cid:46)(cid:14)(cid:2)(cid:9)(cid:11)(cid:4)(cid:3)(cid:49)(cid:4)(cid:8)(cid:5)(cid:2)(cid:28)(cid:3,,12249.0
,,12,,,Unknown,,cid:10)(cid:11)(cid:10)(cid:46)(cid:14)(cid:2)(cid:9)(cid:11)(cid:4)(cid:3)(cid:49)(cid:4)(cid:8)(cid:5)(cid:2)(cid:28)(cid:3,,12261.0
,,2,,,Unknown,,cid:10)(cid:11)(cid:10)(cid:46)(cid:14)(cid:2)(cid:9)(cid:11)(cid:4)(cid:3)(cid:49)(cid:4)(cid:8)(cid:5)(cid:2)(cid:28)(cid:3,,12263.0
,,49,,,Unknown,,cid:10)(cid:11)(cid:10)(cid:46)(cid:14)(cid:2)(cid:9)(cid:11)(cid:4)(cid:3)(cid:49)(cid:4)(cid:8)(cid:5)(cid:2)(cid:28)(cid:3,,12312.0
,,11,,,Unknown,,cid:10)(cid:11)(cid:10)(cid:46)(cid:14)(cid:2)(cid:9)(cid:11)(cid:4)(cid:3)(cid:49)(cid:4)(cid:8)(cid:5)(cid:2)(cid:28)(cid:3,,12323.0
,,8,,,Unknown,,cid:10)(cid:11)(cid:10)(cid:46)(cid:14)(cid:2)(cid:9)(cid:11)(cid:4)(cid:3)(cid:49)(cid:4)(cid:8)(cid:5)(cid:2)(cid:28)(cid:3,,12331.0
,,46,,,Unknown,,cid:10)(cid:11)(cid:10)(cid:46)(cid:14)(cid:2)(cid:9)(cid:11)(cid:4)(cid:3)(cid:49)(cid:4)(cid:8)(cid:5)(cid:2)(cid:28)(cid:3,,12377.0
,,14,,,Unknown,,cid:10)(cid:11)(cid:10)(cid:46)(cid:14)(cid:2)(cid:9)(cid:11)(cid:4)(cid:3)(cid:49)(cid:4)(cid:8)(cid:5)(cid:2)(cid:28)(cid:3,,12391.0
,,49,,,Unknown,,cid:10)(cid:11)(cid:10)(cid:46)(cid:14)(cid:2)(cid:9)(cid:11)(cid:4)(cid:3)(cid:49)(cid:4)(cid:8)(cid:5)(cid:2)(cid:28)(cid:3,,12440.0
,,55,,,Unknown,,cid:10)(cid:11)(cid:10)(cid:46)(cid:14)(cid:2)(cid:9)(cid:11)(cid:4)(cid:3)(cid:49)(cid:4)(cid:8)(cid:5)(cid:2)(cid:28)(cid:3,,12495.0
,,9,,,Unknown,,cid:10)(cid:11)(cid:10)(cid:46)(cid:14)(cid:2)(cid:9)(cid:11)(cid:4)(cid:3)(cid:49)(cid:4)(cid:8)(cid:5)(cid:2)(cid:28)(cid:3,,12504.0
,,2,,,Unknown,,cid:10)(cid:11)(cid:10)(cid:46)(cid:14)(cid:2)(cid:9)(cid:11)(cid:4)(cid:3)(cid:49)(cid:4)(cid:8)(cid:5)(cid:2)(cid:28)(cid:3,,12506.0
,,12,,,Unknown,,cid:10)(cid:11)(cid:10)(cid:46)(cid:14)(cid:2)(cid:9)(cid:11)(cid:4)(cid:3)(cid:49)(cid:4)(cid:8)(cid:5)(cid:2)(cid:28)(cid:3,,12518.0
,,11,,,Unknown,,cid:10)(cid:11)(cid:10)(cid:46)(cid:14)(cid:2)(cid:9)(cid:11)(cid:4)(cid:3)(cid:49)(cid:4)(cid:8)(cid:5)(cid:2)(cid:28)(cid:3,,12529.0
,,4,,,Unknown,,cid:10)(cid:11)(cid:10)(cid:46)(cid:14)(cid:2)(cid:9)(cid:11)(cid:4)(cid:3)(cid:49)(cid:4)(cid:8)(cid:5)(cid:2)(cid:28)(cid:3,,12533.0
,,14,,,Unknown,,cid:10)(cid:11)(cid:10)(cid:46)(cid:14)(cid:2)(cid:9)(cid:11)(cid:4)(cid:3)(cid:49)(cid:4)(cid:8)(cid:5)(cid:2)(cid:28)(cid:3,,12547.0
,,11,,,Unknown,,cid:10)(cid:11)(cid:10)(cid:46)(cid:14)(cid:2)(cid:9)(cid:11)(cid:4)(cid:3)(cid:49)(cid:4)(cid:8)(cid:5)(cid:2)(cid:28)(cid:3,,12558.0
,,54,,,Unknown,,cid:10)(cid:11)(cid:10)(cid:46)(cid:14)(cid:2)(cid:9)(cid:11)(cid:4)(cid:3)(cid:49)(cid:4)(cid:8)(cid:5)(cid:2)(cid:28)(cid:3,,12612.0
,,54,,,Unknown,,cid:10)(cid:11)(cid:10)(cid:46)(cid:14)(cid:2)(cid:9)(cid:11)(cid:4)(cid:3)(cid:49)(cid:4)(cid:8)(cid:5)(cid:2)(cid:28)(cid:3,,12666.0
,,7,,,Unknown,,cid:10)(cid:11)(cid:10)(cid:46)(cid:14)(cid:2)(cid:9)(cid:11)(cid:4)(cid:3)(cid:49)(cid:4)(cid:8)(cid:5)(cid:2)(cid:28)(cid:3,,12673.0
,,5,,,Unknown,,cid:10)(cid:11)(cid:10)(cid:46)(cid:14)(cid:2)(cid:9)(cid:11)(cid:4)(cid:3)(cid:49)(cid:4)(cid:8)(cid:5)(cid:2)(cid:28)(cid:3,,12678.0
,,3,,,Unknown,,cid:10)(cid:11)(cid:10)(cid:46)(cid:14)(cid:2)(cid:9)(cid:11)(cid:4)(cid:3)(cid:49)(cid:4)(cid:8)(cid:5)(cid:2)(cid:28)(cid:3,,12681.0
,,2,,,Unknown,,cid:10)(cid:11)(cid:10)(cid:46)(cid:14)(cid:2)(cid:9)(cid:11)(cid:4)(cid:3)(cid:49)(cid:4)(cid:8)(cid:5)(cid:2)(cid:28)(cid:3,,12683.0
,,28,,,Unknown,,cid:10)(cid:11)(cid:10)(cid:46)(cid:14)(cid:2)(cid:9)(cid:11)(cid:4)(cid:3)(cid:49)(cid:4)(cid:8)(cid:5)(cid:2)(cid:28)(cid:3,,12711.0
,,3,,,Unknown,,cid:10)(cid:11)(cid:10)(cid:46)(cid:14)(cid:2)(cid:9)(cid:11)(cid:4)(cid:3)(cid:49)(cid:4)(cid:8)(cid:5)(cid:2)(cid:28)(cid:3,,12714.0
,,15,,,Unknown,,cid:10)(cid:11)(cid:10)(cid:46)(cid:14)(cid:2)(cid:9)(cid:11)(cid:4)(cid:3)(cid:49)(cid:4)(cid:8)(cid:5)(cid:2)(cid:28)(cid:3,,12729.0
,,2,,,Unknown,,cid:10)(cid:11)(cid:10)(cid:46)(cid:14)(cid:2)(cid:9)(cid:11)(cid:4)(cid:3)(cid:49)(cid:4)(cid:8)(cid:5)(cid:2)(cid:28)(cid:3,,12731.0
,,37,,,Unknown,,cid:10)(cid:11)(cid:10)(cid:46)(cid:14)(cid:2)(cid:9)(cid:11)(cid:4)(cid:3)(cid:49)(cid:4)(cid:8)(cid:5)(cid:2)(cid:28)(cid:3,,12768.0
,,34,,,Unknown,,cid:10)(cid:11)(cid:10)(cid:46)(cid:14)(cid:2)(cid:9)(cid:11)(cid:4)(cid:3)(cid:49)(cid:4)(cid:8)(cid:5)(cid:2)(cid:28)(cid:3,,12802.0
,,19,,,Unknown,,cid:10)(cid:11)(cid:10)(cid:46)(cid:14)(cid:2)(cid:9)(cid:11)(cid:4)(cid:3)(cid:49)(cid:4)(cid:8)(cid:5)(cid:2)(cid:28)(cid:3,,12821.0
,,18,,,Unknown,,cid:10)(cid:11)(cid:10)(cid:46)(cid:14)(cid:2)(cid:9)(cid:11)(cid:4)(cid:3)(cid:49)(cid:4)(cid:8)(cid:5)(cid:2)(cid:28)(cid:3,,12839.0
,,18,,,Unknown,,cid:10)(cid:11)(cid:10)(cid:46)(cid:14)(cid:2)(cid:9)(cid:11)(cid:4)(cid:3)(cid:49)(cid:4)(cid:8)(cid:5)(cid:2)(cid:28)(cid:3,,12857.0
,,2,,,Unknown,,cid:10)(cid:11)(cid:10)(cid:46)(cid:14)(cid:2)(cid:9)(cid:11)(cid:4)(cid:3)(cid:49)(cid:4)(cid:8)(cid:5)(cid:2)(cid:28)(cid:3,,12859.0
,,44,,,Unknown,,cid:10)(cid:11)(cid:10)(cid:46)(cid:14)(cid:2)(cid:9)(cid:11)(cid:4)(cid:3)(cid:49)(cid:4)(cid:8)(cid:5)(cid:2)(cid:28)(cid:3,,12903.0
,,12,,,Unknown,,cid:10)(cid:11)(cid:10)(cid:46)(cid:14)(cid:2)(cid:9)(cid:11)(cid:4)(cid:3)(cid:49)(cid:4)(cid:8)(cid:5)(cid:2)(cid:28)(cid:3,,12915.0
,,29,,,Unknown,,cid:10)(cid:11)(cid:10)(cid:46)(cid:14)(cid:2)(cid:9)(cid:11)(cid:4)(cid:3)(cid:49)(cid:4)(cid:8)(cid:5)(cid:2)(cid:28)(cid:3,,12944.0
,,26,,,Unknown,,cid:10)(cid:11)(cid:10)(cid:46)(cid:14)(cid:2)(cid:9)(cid:11)(cid:4)(cid:3)(cid:49)(cid:4)(cid:8)(cid:5)(cid:2)(cid:28)(cid:3,,12970.0
,,41,,,Unknown,,cid:10)(cid:11)(cid:10)(cid:46)(cid:14)(cid:2)(cid:9)(cid:11)(cid:4)(cid:3)(cid:49)(cid:4)(cid:8)(cid:5)(cid:2)(cid:28)(cid:3,,13011.0
,,25,,,Unknown,,cid:10)(cid:11)(cid:10)(cid:46)(cid:14)(cid:2)(cid:9)(cid:11)(cid:4)(cid:3)(cid:49)(cid:4)(cid:8)(cid:5)(cid:2)(cid:28)(cid:3,,13036.0
,,2,,,Unknown,,cid:10)(cid:11)(cid:10)(cid:46)(cid:14)(cid:2)(cid:9)(cid:11)(cid:4)(cid:3)(cid:49)(cid:4)(cid:8)(cid:5)(cid:2)(cid:28)(cid:3,,13038.0
,,50,,,Unknown,,cid:10)(cid:11)(cid:10)(cid:46)(cid:14)(cid:2)(cid:9)(cid:11)(cid:4)(cid:3)(cid:49)(cid:4)(cid:8)(cid:5)(cid:2)(cid:28)(cid:3,,13088.0
,,50,,,Unknown,,cid:10)(cid:11)(cid:10)(cid:46)(cid:14)(cid:2)(cid:9)(cid:11)(cid:4)(cid:3)(cid:49)(cid:4)(cid:8)(cid:5)(cid:2)(cid:28)(cid:3,,13138.0
,,37,,,Unknown,,cid:10)(cid:11)(cid:10)(cid:46)(cid:14)(cid:2)(cid:9)(cid:11)(cid:4)(cid:3)(cid:49)(cid:4)(cid:8)(cid:5)(cid:2)(cid:28)(cid:3,,13175.0
,,16,,,Unknown,,cid:10)(cid:11)(cid:10)(cid:46)(cid:14)(cid:2)(cid:9)(cid:11)(cid:4)(cid:3)(cid:49)(cid:4)(cid:8)(cid:5)(cid:2)(cid:28)(cid:3,,13191.0
,,34,,,Unknown,,cid:10)(cid:11)(cid:10)(cid:46)(cid:14)(cid:2)(cid:9)(cid:11)(cid:4)(cid:3)(cid:49)(cid:4)(cid:8)(cid:5)(cid:2)(cid:28)(cid:3,,13225.0
,,33,,,Unknown,,cid:10)(cid:11)(cid:10)(cid:46)(cid:14)(cid:2)(cid:9)(cid:11)(cid:4)(cid:3)(cid:49)(cid:4)(cid:8)(cid:5)(cid:2)(cid:28)(cid:3,,13258.0
,,18,,,Unknown,,cid:10)(cid:11)(cid:10)(cid:46)(cid:14)(cid:2)(cid:9)(cid:11)(cid:4)(cid:3)(cid:49)(cid:4)(cid:8)(cid:5)(cid:2)(cid:28)(cid:3,,13276.0
,,32,,,Unknown,,cid:10)(cid:11)(cid:10)(cid:46)(cid:14)(cid:2)(cid:9)(cid:11)(cid:4)(cid:3)(cid:49)(cid:4)(cid:8)(cid:5)(cid:2)(cid:28)(cid:3,,13308.0
,,45,,,Unknown,,cid:10)(cid:11)(cid:10)(cid:46)(cid:14)(cid:2)(cid:9)(cid:11)(cid:4)(cid:3)(cid:49)(cid:4)(cid:8)(cid:5)(cid:2)(cid:28)(cid:3,,13353.0
,,18,,,Unknown,,cid:10)(cid:11)(cid:10)(cid:46)(cid:14)(cid:2)(cid:9)(cid:11)(cid:4)(cid:3)(cid:49)(cid:4)(cid:8)(cid:5)(cid:2)(cid:28)(cid:3,,13371.0
,,35,,,Unknown,,cid:10)(cid:11)(cid:10)(cid:46)(cid:14)(cid:2)(cid:9)(cid:11)(cid:4)(cid:3)(cid:49)(cid:4)(cid:8)(cid:5)(cid:2)(cid:28)(cid:3,,13406.0
,,14,,,Unknown,,cid:10)(cid:11)(cid:10)(cid:46)(cid:14)(cid:2)(cid:9)(cid:11)(cid:4)(cid:3)(cid:49)(cid:4)(cid:8)(cid:5)(cid:2)(cid:28)(cid:3,,13420.0
,,46,,,Unknown,,cid:10)(cid:11)(cid:10)(cid:46)(cid:14)(cid:2)(cid:9)(cid:11)(cid:4)(cid:3)(cid:49)(cid:4)(cid:8)(cid:5)(cid:2)(cid:28)(cid:3,,13466.0
,,2,,,Unknown,,cid:10)(cid:11)(cid:10)(cid:46)(cid:14)(cid:2)(cid:9)(cid:11)(cid:4)(cid:3)(cid:49)(cid:4)(cid:8)(cid:5)(cid:2)(cid:28)(cid:3,,13468.0
,,9,,,Unknown,,cid:10)(cid:11)(cid:10)(cid:46)(cid:14)(cid:2)(cid:9)(cid:11)(cid:4)(cid:3)(cid:49)(cid:4)(cid:8)(cid:5)(cid:2)(cid:28)(cid:3,,13477.0
,,4,,,Unknown,,cid:10)(cid:11)(cid:10)(cid:46)(cid:14)(cid:2)(cid:9)(cid:11)(cid:4)(cid:3)(cid:49)(cid:4)(cid:8)(cid:5)(cid:2)(cid:28)(cid:3,,13481.0
,,12,,,Unknown,,cid:10)(cid:11)(cid:10)(cid:46)(cid:14)(cid:2)(cid:9)(cid:11)(cid:4)(cid:3)(cid:49)(cid:4)(cid:8)(cid:5)(cid:2)(cid:28)(cid:3,,13493.0
,,3,,,Unknown,,cid:10)(cid:11)(cid:10)(cid:46)(cid:14)(cid:2)(cid:9)(cid:11)(cid:4)(cid:3)(cid:49)(cid:4)(cid:8)(cid:5)(cid:2)(cid:28)(cid:3,,13496.0
,,5,,,Unknown,,cid:10)(cid:11)(cid:10)(cid:46)(cid:14)(cid:2)(cid:9)(cid:11)(cid:4)(cid:3)(cid:49)(cid:4)(cid:8)(cid:5)(cid:2)(cid:28)(cid:3,,13501.0
,,3,,,Unknown,,cid:10)(cid:11)(cid:10)(cid:46)(cid:14)(cid:2)(cid:9)(cid:11)(cid:4)(cid:3)(cid:49)(cid:4)(cid:8)(cid:5)(cid:2)(cid:28)(cid:3,,13504.0
,,7,,,Unknown,,cid:10)(cid:11)(cid:10)(cid:46)(cid:14)(cid:2)(cid:9)(cid:11)(cid:4)(cid:3)(cid:49)(cid:4)(cid:8)(cid:5)(cid:2)(cid:28)(cid:3,,13511.0
,,5,,,Unknown,,cid:10)(cid:11)(cid:10)(cid:46)(cid:14)(cid:2)(cid:9)(cid:11)(cid:4)(cid:3)(cid:49)(cid:4)(cid:8)(cid:5)(cid:2)(cid:28)(cid:3,,13516.0
,,2,,,Unknown,,cid:10)(cid:11)(cid:10)(cid:46)(cid:14)(cid:2)(cid:9)(cid:11)(cid:4)(cid:3)(cid:49)(cid:4)(cid:8)(cid:5)(cid:2)(cid:28)(cid:3,,13518.0
,,12,,,Unknown,,cid:10)(cid:11)(cid:10)(cid:46)(cid:14)(cid:2)(cid:9)(cid:11)(cid:4)(cid:3)(cid:49)(cid:4)(cid:8)(cid:5)(cid:2)(cid:28)(cid:3,,13530.0
,,11,,,Unknown,,cid:10)(cid:11)(cid:10)(cid:46)(cid:14)(cid:2)(cid:9)(cid:11)(cid:4)(cid:3)(cid:49)(cid:4)(cid:8)(cid:5)(cid:2)(cid:28)(cid:3,,13541.0
,,4,,,Unknown,,cid:10)(cid:11)(cid:10)(cid:46)(cid:14)(cid:2)(cid:9)(cid:11)(cid:4)(cid:3)(cid:49)(cid:4)(cid:8)(cid:5)(cid:2)(cid:28)(cid:3,,13545.0
,,14,,,Unknown,,cid:10)(cid:11)(cid:10)(cid:46)(cid:14)(cid:2)(cid:9)(cid:11)(cid:4)(cid:3)(cid:49)(cid:4)(cid:8)(cid:5)(cid:2)(cid:28)(cid:3,,13559.0
,,11,,,Unknown,,cid:10)(cid:11)(cid:10)(cid:46)(cid:14)(cid:2)(cid:9)(cid:11)(cid:4)(cid:3)(cid:49)(cid:4)(cid:8)(cid:5)(cid:2)(cid:28)(cid:3,,13570.0
,,54,,,Unknown,,cid:10)(cid:11)(cid:10)(cid:46)(cid:14)(cid:2)(cid:9)(cid:11)(cid:4)(cid:3)(cid:49)(cid:4)(cid:8)(cid:5)(cid:2)(cid:28)(cid:3,,13624.0
,,54,,,Unknown,,cid:10)(cid:11)(cid:10)(cid:46)(cid:14)(cid:2)(cid:9)(cid:11)(cid:4)(cid:3)(cid:49)(cid:4)(cid:8)(cid:5)(cid:2)(cid:28)(cid:3,,13678.0
,,7,,,Unknown,,cid:10)(cid:11)(cid:10)(cid:46)(cid:14)(cid:2)(cid:9)(cid:11)(cid:4)(cid:3)(cid:49)(cid:4)(cid:8)(cid:5)(cid:2)(cid:28)(cid:3,,13685.0
,,5,,,Unknown,,cid:10)(cid:11)(cid:10)(cid:46)(cid:14)(cid:2)(cid:9)(cid:11)(cid:4)(cid:3)(cid:49)(cid:4)(cid:8)(cid:5)(cid:2)(cid:28)(cid:3,,13690.0
,,3,,,Unknown,,cid:10)(cid:11)(cid:10)(cid:46)(cid:14)(cid:2)(cid:9)(cid:11)(cid:4)(cid:3)(cid:49)(cid:4)(cid:8)(cid:5)(cid:2)(cid:28)(cid:3,,13693.0
,,9,,,Unknown,,cid:10)(cid:11)(cid:10)(cid:46)(cid:14)(cid:2)(cid:9)(cid:11)(cid:4)(cid:3)(cid:49)(cid:4)(cid:8)(cid:5)(cid:2)(cid:28)(cid:3,,13702.0
,,2,,,Unknown,,cid:10)(cid:11)(cid:10)(cid:46)(cid:14)(cid:2)(cid:9)(cid:11)(cid:4)(cid:3)(cid:49)(cid:4)(cid:8)(cid:5)(cid:2)(cid:28)(cid:3,,13704.0
,,28,,,Unknown,,cid:10)(cid:11)(cid:10)(cid:46)(cid:14)(cid:2)(cid:9)(cid:11)(cid:4)(cid:3)(cid:49)(cid:4)(cid:8)(cid:5)(cid:2)(cid:28)(cid:3,,13732.0
,,3,,,Unknown,,cid:10)(cid:11)(cid:10)(cid:46)(cid:14)(cid:2)(cid:9)(cid:11)(cid:4)(cid:3)(cid:49)(cid:4)(cid:8)(cid:5)(cid:2)(cid:28)(cid:3,,13735.0
,,15,,,Unknown,,cid:10)(cid:11)(cid:10)(cid:46)(cid:14)(cid:2)(cid:9)(cid:11)(cid:4)(cid:3)(cid:49)(cid:4)(cid:8)(cid:5)(cid:2)(cid:28)(cid:3,,13750.0
,,2,,,Unknown,,cid:10)(cid:11)(cid:10)(cid:46)(cid:14)(cid:2)(cid:9)(cid:11)(cid:4)(cid:3)(cid:49)(cid:4)(cid:8)(cid:5)(cid:2)(cid:28)(cid:3,,13752.0
,,1,,,Unknown,,cid:10)(cid:11)(cid:10)(cid:46)(cid:14)(cid:2)(cid:9)(cid:11)(cid:4)(cid:3)(cid:49)(cid:4)(cid:8)(cid:5)(cid:2)(cid:28)(cid:3,,13753.0
,,1,,,Unknown,,cid:10)(cid:11)(cid:10)(cid:46)(cid:14)(cid:2)(cid:9)(cid:11)(cid:4)(cid:3)(cid:49)(cid:4)(cid:8)(cid:5)(cid:2)(cid:28)(cid:3,,13754.0
,,19,,,Unknown,,cid:10)(cid:11)(cid:10)(cid:46)(cid:14)(cid:2)(cid:9)(cid:11)(cid:4)(cid:3)(cid:49)(cid:4)(cid:8)(cid:5)(cid:2)(cid:28)(cid:3,,13773.0
,,34,,,Unknown,,cid:10)(cid:11)(cid:10)(cid:46)(cid:14)(cid:2)(cid:9)(cid:11)(cid:4)(cid:3)(cid:49)(cid:4)(cid:8)(cid:5)(cid:2)(cid:28)(cid:3,,13807.0
,,18,,,Unknown,,cid:10)(cid:11)(cid:10)(cid:46)(cid:14)(cid:2)(cid:9)(cid:11)(cid:4)(cid:3)(cid:49)(cid:4)(cid:8)(cid:5)(cid:2)(cid:28)(cid:3,,13825.0
,,2,,,Unknown,,cid:10)(cid:11)(cid:10)(cid:46)(cid:14)(cid:2)(cid:9)(cid:11)(cid:4)(cid:3)(cid:49)(cid:4)(cid:8)(cid:5)(cid:2)(cid:28)(cid:3,,13827.0
,,44,,,Unknown,,cid:10)(cid:11)(cid:10)(cid:46)(cid:14)(cid:2)(cid:9)(cid:11)(cid:4)(cid:3)(cid:49)(cid:4)(cid:8)(cid:5)(cid:2)(cid:28)(cid:3,,13871.0
,,12,,,Unknown,,cid:10)(cid:11)(cid:10)(cid:46)(cid:14)(cid:2)(cid:9)(cid:11)(cid:4)(cid:3)(cid:49)(cid:4)(cid:8)(cid:5)(cid:2)(cid:28)(cid:3,,13883.0
,,29,,,Unknown,,cid:10)(cid:11)(cid:10)(cid:46)(cid:14)(cid:2)(cid:9)(cid:11)(cid:4)(cid:3)(cid:49)(cid:4)(cid:8)(cid:5)(cid:2)(cid:28)(cid:3,,13912.0
,,26,,,Unknown,,cid:10)(cid:11)(cid:10)(cid:46)(cid:14)(cid:2)(cid:9)(cid:11)(cid:4)(cid:3)(cid:49)(cid:4)(cid:8)(cid:5)(cid:2)(cid:28)(cid:3,,13938.0
,,41,,,Unknown,,cid:10)(cid:11)(cid:10)(cid:46)(cid:14)(cid:2)(cid:9)(cid:11)(cid:4)(cid:3)(cid:49)(cid:4)(cid:8)(cid:5)(cid:2)(cid:28)(cid:3,,13979.0
,,25,,,Unknown,,cid:10)(cid:11)(cid:10)(cid:46)(cid:14)(cid:2)(cid:9)(cid:11)(cid:4)(cid:3)(cid:49)(cid:4)(cid:8)(cid:5)(cid:2)(cid:28)(cid:3,,14004.0
,,2,,,Unknown,,cid:10)(cid:11)(cid:10)(cid:46)(cid:14)(cid:2)(cid:9)(cid:11)(cid:4)(cid:3)(cid:49)(cid:4)(cid:8)(cid:5)(cid:2)(cid:28)(cid:3,,14006.0
,,50,,,Unknown,,cid:10)(cid:11)(cid:10)(cid:46)(cid:14)(cid:2)(cid:9)(cid:11)(cid:4)(cid:3)(cid:49)(cid:4)(cid:8)(cid:5)(cid:2)(cid:28)(cid:3,,14056.0
,,50,,,Unknown,,cid:10)(cid:11)(cid:10)(cid:46)(cid:14)(cid:2)(cid:9)(cid:11)(cid:4)(cid:3)(cid:49)(cid:4)(cid:8)(cid:5)(cid:2)(cid:28)(cid:3,,14106.0
,,18,,,Unknown,,cid:10)(cid:11)(cid:10)(cid:46)(cid:14)(cid:2)(cid:9)(cid:11)(cid:4)(cid:3)(cid:49)(cid:4)(cid:8)(cid:5)(cid:2)(cid:28)(cid:3,,14124.0
,,1,,,Unknown,,cid:10)(cid:11)(cid:10)(cid:46)(cid:14)(cid:2)(cid:9)(cid:11)(cid:4)(cid:3)(cid:49)(cid:4)(cid:8)(cid:5)(cid:2)(cid:28)(cid:3,,14125.0
,,1,,,Unknown,,cid:10)(cid:11)(cid:10)(cid:46)(cid:14)(cid:2)(cid:9)(cid:11)(cid:4)(cid:3)(cid:49)(cid:4)(cid:8)(cid:5)(cid:2)(cid:28)(cid:3,,14126.0
,,37,,,Unknown,,cid:10)(cid:11)(cid:10)(cid:46)(cid:14)(cid:2)(cid:9)(cid:11)(cid:4)(cid:3)(cid:49)(cid:4)(cid:8)(cid:5)(cid:2)(cid:28)(cid:3,,14163.0
,,18,,,Unknown,,cid:10)(cid:11)(cid:10)(cid:46)(cid:14)(cid:2)(cid:9)(cid:11)(cid:4)(cid:3)(cid:49)(cid:4)(cid:8)(cid:5)(cid:2)(cid:28)(cid:3,,14181.0
,,33,,,Unknown,,cid:10)(cid:11)(cid:10)(cid:46)(cid:14)(cid:2)(cid:9)(cid:11)(cid:4)(cid:3)(cid:49)(cid:4)(cid:8)(cid:5)(cid:2)(cid:28)(cid:3,,14214.0
,,45,,,Unknown,,cid:10)(cid:11)(cid:10)(cid:46)(cid:14)(cid:2)(cid:9)(cid:11)(cid:4)(cid:3)(cid:49)(cid:4)(cid:8)(cid:5)(cid:2)(cid:28)(cid:3,,14259.0
,,18,,,Unknown,,cid:10)(cid:11)(cid:10)(cid:46)(cid:14)(cid:2)(cid:9)(cid:11)(cid:4)(cid:3)(cid:49)(cid:4)(cid:8)(cid:5)(cid:2)(cid:28)(cid:3,,14277.0
,,35,,,Unknown,,cid:10)(cid:11)(cid:10)(cid:46)(cid:14)(cid:2)(cid:9)(cid:11)(cid:4)(cid:3)(cid:49)(cid:4)(cid:8)(cid:5)(cid:2)(cid:28)(cid:3,,14312.0
,,12,,,Unknown,,cid:10)(cid:11)(cid:10)(cid:46)(cid:14)(cid:2)(cid:9)(cid:11)(cid:4)(cid:3)(cid:49)(cid:4)(cid:8)(cid:5)(cid:2)(cid:28)(cid:3,,14324.0
,,46,,,Unknown,,cid:10)(cid:11)(cid:10)(cid:46)(cid:14)(cid:2)(cid:9)(cid:11)(cid:4)(cid:3)(cid:49)(cid:4)(cid:8)(cid:5)(cid:2)(cid:28)(cid:3,,14370.0
,,38,,,Unknown,,cid:10)(cid:11)(cid:10)(cid:46)(cid:14)(cid:2)(cid:9)(cid:11)(cid:4)(cid:3)(cid:49)(cid:4)(cid:8)(cid:5)(cid:2)(cid:28)(cid:3,,14408.0
,,4,,,Unknown,,cid:10)(cid:11)(cid:10)(cid:46)(cid:14)(cid:2)(cid:9)(cid:11)(cid:4)(cid:3)(cid:49)(cid:4)(cid:8)(cid:5)(cid:2)(cid:28)(cid:3,,14412.0
,,46,,,Unknown,,cid:10)(cid:11)(cid:10)(cid:46)(cid:14)(cid:2)(cid:9)(cid:11)(cid:4)(cid:3)(cid:49)(cid:4)(cid:8)(cid:5)(cid:2)(cid:28)(cid:3,,14458.0
,,8,,,Unknown,,cid:10)(cid:11)(cid:10)(cid:46)(cid:14)(cid:2)(cid:9)(cid:11)(cid:4)(cid:3)(cid:49)(cid:4)(cid:8)(cid:5)(cid:2)(cid:28)(cid:3,,14466.0
,,10,,,Unknown,,cid:10)(cid:11)(cid:10)(cid:46)(cid:14)(cid:2)(cid:9)(cid:11)(cid:4)(cid:3)(cid:49)(cid:4)(cid:8)(cid:5)(cid:2)(cid:28)(cid:3,,14476.0
,,2,,,Unknown,,cid:10)(cid:11)(cid:10)(cid:46)(cid:14)(cid:2)(cid:9)(cid:11)(cid:4)(cid:3)(cid:49)(cid:4)(cid:8)(cid:5)(cid:2)(cid:28)(cid:3,,14478.0
,,13,,,Unknown,,cid:10)(cid:11)(cid:10)(cid:46)(cid:14)(cid:2)(cid:9)(cid:11)(cid:4)(cid:3)(cid:49)(cid:4)(cid:8)(cid:5)(cid:2)(cid:28)(cid:3,,14491.0
,,5,,,Unknown,,cid:10)(cid:11)(cid:10)(cid:46)(cid:14)(cid:2)(cid:9)(cid:11)(cid:4)(cid:3)(cid:49)(cid:4)(cid:8)(cid:5)(cid:2)(cid:28)(cid:3,,14496.0
,,3,,,Unknown,,cid:10)(cid:11)(cid:10)(cid:46)(cid:14)(cid:2)(cid:9)(cid:11)(cid:4)(cid:3)(cid:49)(cid:4)(cid:8)(cid:5)(cid:2)(cid:28)(cid:3,,14499.0
,,52,,,Unknown,,cid:10)(cid:11)(cid:10)(cid:46)(cid:14)(cid:2)(cid:9)(cid:11)(cid:4)(cid:3)(cid:49)(cid:4)(cid:8)(cid:5)(cid:2)(cid:28)(cid:3,,14551.0
,,5,,,Unknown,,cid:10)(cid:11)(cid:10)(cid:46)(cid:14)(cid:2)(cid:9)(cid:11)(cid:4)(cid:3)(cid:49)(cid:4)(cid:8)(cid:5)(cid:2)(cid:28)(cid:3,,14556.0
,,43,,,Unknown,,cid:10)(cid:11)(cid:10)(cid:46)(cid:14)(cid:2)(cid:9)(cid:11)(cid:4)(cid:3)(cid:49)(cid:4)(cid:8)(cid:5)(cid:2)(cid:28)(cid:3,,14599.0
,,2,,,Unknown,,cid:10)(cid:11)(cid:10)(cid:46)(cid:14)(cid:2)(cid:9)(cid:11)(cid:4)(cid:3)(cid:49)(cid:4)(cid:8)(cid:5)(cid:2)(cid:28)(cid:3,,14601.0
,,37,,,Unknown,,cid:10)(cid:11)(cid:10)(cid:46)(cid:14)(cid:2)(cid:9)(cid:11)(cid:4)(cid:3)(cid:49)(cid:4)(cid:8)(cid:5)(cid:2)(cid:28)(cid:3,,14638.0
,,37,,,Unknown,,cid:10)(cid:11)(cid:10)(cid:46)(cid:14)(cid:2)(cid:9)(cid:11)(cid:4)(cid:3)(cid:49)(cid:4)(cid:8)(cid:5)(cid:2)(cid:28)(cid:3,,14675.0
,,32,,,Unknown,,cid:10)(cid:11)(cid:10)(cid:46)(cid:14)(cid:2)(cid:9)(cid:11)(cid:4)(cid:3)(cid:49)(cid:4)(cid:8)(cid:5)(cid:2)(cid:28)(cid:3,,14707.0
,,19,,,Unknown,,cid:10)(cid:11)(cid:10)(cid:46)(cid:14)(cid:2)(cid:9)(cid:11)(cid:4)(cid:3)(cid:49)(cid:4)(cid:8)(cid:5)(cid:2)(cid:28)(cid:3,,14726.0
,,18,,,Unknown,,cid:10)(cid:11)(cid:10)(cid:46)(cid:14)(cid:2)(cid:9)(cid:11)(cid:4)(cid:3)(cid:49)(cid:4)(cid:8)(cid:5)(cid:2)(cid:28)(cid:3,,14744.0
,,18,,,Unknown,,cid:10)(cid:11)(cid:10)(cid:46)(cid:14)(cid:2)(cid:9)(cid:11)(cid:4)(cid:3)(cid:49)(cid:4)(cid:8)(cid:5)(cid:2)(cid:28)(cid:3,,14762.0
,,2,,,Unknown,,cid:10)(cid:11)(cid:10)(cid:46)(cid:14)(cid:2)(cid:9)(cid:11)(cid:4)(cid:3)(cid:49)(cid:4)(cid:8)(cid:5)(cid:2)(cid:28)(cid:3,,14764.0
,,44,,,Unknown,,cid:10)(cid:11)(cid:10)(cid:46)(cid:14)(cid:2)(cid:9)(cid:11)(cid:4)(cid:3)(cid:49)(cid:4)(cid:8)(cid:5)(cid:2)(cid:28)(cid:3,,14808.0
,,49,,,Unknown,,cid:10)(cid:11)(cid:10)(cid:46)(cid:14)(cid:2)(cid:9)(cid:11)(cid:4)(cid:3)(cid:49)(cid:4)(cid:8)(cid:5)(cid:2)(cid:28)(cid:3,,14857.0
,,42,,,Unknown,,cid:10)(cid:11)(cid:10)(cid:46)(cid:14)(cid:2)(cid:9)(cid:11)(cid:4)(cid:3)(cid:49)(cid:4)(cid:8)(cid:5)(cid:2)(cid:28)(cid:3,,14899.0
,,56,,,Unknown,,cid:10)(cid:11)(cid:10)(cid:46)(cid:14)(cid:2)(cid:9)(cid:11)(cid:4)(cid:3)(cid:49)(cid:4)(cid:8)(cid:5)(cid:2)(cid:28)(cid:3,,14955.0
,,57,,,Unknown,,cid:10)(cid:11)(cid:10)(cid:46)(cid:14)(cid:2)(cid:9)(cid:11)(cid:4)(cid:3)(cid:49)(cid:4)(cid:8)(cid:5)(cid:2)(cid:28)(cid:3,,15012.0
,,41,,,Unknown,,cid:10)(cid:11)(cid:10)(cid:46)(cid:14)(cid:2)(cid:9)(cid:11)(cid:4)(cid:3)(cid:49)(cid:4)(cid:8)(cid:5)(cid:2)(cid:28)(cid:3,,15053.0
,,2,,,Unknown,,cid:10)(cid:11)(cid:10)(cid:46)(cid:14)(cid:2)(cid:9)(cid:11)(cid:4)(cid:3)(cid:49)(cid:4)(cid:8)(cid:5)(cid:2)(cid:28)(cid:3,,15055.0
,,48,,,Unknown,,cid:10)(cid:11)(cid:10)(cid:46)(cid:14)(cid:2)(cid:9)(cid:11)(cid:4)(cid:3)(cid:49)(cid:4)(cid:8)(cid:5)(cid:2)(cid:28)(cid:3,,15103.0
,,25,,,Unknown,,cid:10)(cid:11)(cid:10)(cid:46)(cid:14)(cid:2)(cid:9)(cid:11)(cid:4)(cid:3)(cid:49)(cid:4)(cid:8)(cid:5)(cid:2)(cid:28)(cid:3,,15128.0
,,2,,,Unknown,,cid:10)(cid:11)(cid:10)(cid:46)(cid:14)(cid:2)(cid:9)(cid:11)(cid:4)(cid:3)(cid:49)(cid:4)(cid:8)(cid:5)(cid:2)(cid:28)(cid:3,,15130.0
,,31,,,Unknown,,cid:10)(cid:11)(cid:10)(cid:46)(cid:14)(cid:2)(cid:9)(cid:11)(cid:4)(cid:3)(cid:49)(cid:4)(cid:8)(cid:5)(cid:2)(cid:28)(cid:3,,15161.0
,,58,,,Unknown,,cid:10)(cid:11)(cid:10)(cid:46)(cid:14)(cid:2)(cid:9)(cid:11)(cid:4)(cid:3)(cid:49)(cid:4)(cid:8)(cid:5)(cid:2)(cid:28)(cid:3,,15219.0
,,59,,,Unknown,,cid:10)(cid:11)(cid:10)(cid:46)(cid:14)(cid:2)(cid:9)(cid:11)(cid:4)(cid:3)(cid:49)(cid:4)(cid:8)(cid:5)(cid:2)(cid:28)(cid:3,,15278.0
,,60,,,Unknown,,cid:10)(cid:11)(cid:10)(cid:46)(cid:14)(cid:2)(cid:9)(cid:11)(cid:4)(cid:3)(cid:49)(cid:4)(cid:8)(cid:5)(cid:2)(cid:28)(cid:3,,15338.0
,,21,,,Unknown,,cid:10)(cid:11)(cid:10)(cid:46)(cid:14)(cid:2)(cid:9)(cid:11)(cid:4)(cid:3)(cid:49)(cid:4)(cid:8)(cid:5)(cid:2)(cid:28)(cid:3,,15359.0
,,25,,,Unknown,,cid:10)(cid:11)(cid:10)(cid:46)(cid:14)(cid:2)(cid:9)(cid:11)(cid:4)(cid:3)(cid:49)(cid:4)(cid:8)(cid:5)(cid:2)(cid:28)(cid:3,,15384.0
,,18,,,Unknown,,cid:10)(cid:11)(cid:10)(cid:46)(cid:14)(cid:2)(cid:9)(cid:11)(cid:4)(cid:3)(cid:49)(cid:4)(cid:8)(cid:5)(cid:2)(cid:28)(cid:3,,15402.0
,,33,,,Unknown,,cid:10)(cid:11)(cid:10)(cid:46)(cid:14)(cid:2)(cid:9)(cid:11)(cid:4)(cid:3)(cid:49)(cid:4)(cid:8)(cid:5)(cid:2)(cid:28)(cid:3,,15435.0
,,45,,,Unknown,,cid:10)(cid:11)(cid:10)(cid:46)(cid:14)(cid:2)(cid:9)(cid:11)(cid:4)(cid:3)(cid:49)(cid:4)(cid:8)(cid:5)(cid:2)(cid:28)(cid:3,,15480.0
,,18,,,Unknown,,cid:10)(cid:11)(cid:10)(cid:46)(cid:14)(cid:2)(cid:9)(cid:11)(cid:4)(cid:3)(cid:49)(cid:4)(cid:8)(cid:5)(cid:2)(cid:28)(cid:3,,15498.0
,,35,,,Unknown,,cid:10)(cid:11)(cid:10)(cid:46)(cid:14)(cid:2)(cid:9)(cid:11)(cid:4)(cid:3)(cid:49)(cid:4)(cid:8)(cid:5)(cid:2)(cid:28)(cid:3,,15533.0
,,54,,,Unknown,,cid:10)(cid:11)(cid:10)(cid:46)(cid:14)(cid:2)(cid:9)(cid:11)(cid:4)(cid:3)(cid:49)(cid:4)(cid:8)(cid:5)(cid:2)(cid:28)(cid:3,,15587.0
,,7,,,Unknown,,cid:10)(cid:11)(cid:10)(cid:46)(cid:14)(cid:2)(cid:9)(cid:11)(cid:4)(cid:3)(cid:49)(cid:4)(cid:8)(cid:5)(cid:2)(cid:28)(cid:3,,15594.0
,,12,,,Unknown,,cid:10)(cid:11)(cid:10)(cid:46)(cid:14)(cid:2)(cid:9)(cid:11)(cid:4)(cid:3)(cid:49)(cid:4)(cid:8)(cid:5)(cid:2)(cid:28)(cid:3,,15606.0
,,13,,,Unknown,,cid:10)(cid:11)(cid:10)(cid:46)(cid:14)(cid:2)(cid:9)(cid:11)(cid:4)(cid:3)(cid:49)(cid:4)(cid:8)(cid:5)(cid:2)(cid:28)(cid:3,,15619.0
,,5,,,Unknown,,cid:10)(cid:11)(cid:10)(cid:46)(cid:14)(cid:2)(cid:9)(cid:11)(cid:4)(cid:3)(cid:49)(cid:4)(cid:8)(cid:5)(cid:2)(cid:28)(cid:3,,15624.0
,,14,,,Unknown,,cid:10)(cid:11)(cid:10)(cid:46)(cid:14)(cid:2)(cid:9)(cid:11)(cid:4)(cid:3)(cid:49)(cid:4)(cid:8)(cid:5)(cid:2)(cid:28)(cid:3,,15638.0
,,2,,,Unknown,,cid:10)(cid:11)(cid:10)(cid:46)(cid:14)(cid:2)(cid:9)(cid:11)(cid:4)(cid:3)(cid:49)(cid:4)(cid:8)(cid:5)(cid:2)(cid:28)(cid:3,,15640.0
,,53,,,Unknown,,cid:10)(cid:11)(cid:10)(cid:46)(cid:14)(cid:2)(cid:9)(cid:11)(cid:4)(cid:3)(cid:49)(cid:4)(cid:8)(cid:5)(cid:2)(cid:28)(cid:3,,15693.0
,,5,,,Unknown,,cid:10)(cid:11)(cid:10)(cid:46)(cid:14)(cid:2)(cid:9)(cid:11)(cid:4)(cid:3)(cid:49)(cid:4)(cid:8)(cid:5)(cid:2)(cid:28)(cid:3,,15698.0
,,11,,,Unknown,,cid:10)(cid:11)(cid:10)(cid:46)(cid:14)(cid:2)(cid:9)(cid:11)(cid:4)(cid:3)(cid:49)(cid:4)(cid:8)(cid:5)(cid:2)(cid:28)(cid:3,,15709.0
,,3,,,Unknown,,cid:10)(cid:11)(cid:10)(cid:46)(cid:14)(cid:2)(cid:9)(cid:11)(cid:4)(cid:3)(cid:49)(cid:4)(cid:8)(cid:5)(cid:2)(cid:28)(cid:3,,15712.0
,,53,,,Unknown,,cid:10)(cid:11)(cid:10)(cid:46)(cid:14)(cid:2)(cid:9)(cid:11)(cid:4)(cid:3)(cid:49)(cid:4)(cid:8)(cid:5)(cid:2)(cid:28)(cid:3,,15765.0
,,5,,,Unknown,,cid:10)(cid:11)(cid:10)(cid:46)(cid:14)(cid:2)(cid:9)(cid:11)(cid:4)(cid:3)(cid:49)(cid:4)(cid:8)(cid:5)(cid:2)(cid:28)(cid:3,,15770.0
,,9,,,Unknown,,cid:10)(cid:11)(cid:10)(cid:46)(cid:14)(cid:2)(cid:9)(cid:11)(cid:4)(cid:3)(cid:49)(cid:4)(cid:8)(cid:5)(cid:2)(cid:28)(cid:3,,15779.0
,,43,,,Unknown,,cid:10)(cid:11)(cid:10)(cid:46)(cid:14)(cid:2)(cid:9)(cid:11)(cid:4)(cid:3)(cid:49)(cid:4)(cid:8)(cid:5)(cid:2)(cid:28)(cid:3,,15822.0
,,2,,,Unknown,,cid:10)(cid:11)(cid:10)(cid:46)(cid:14)(cid:2)(cid:9)(cid:11)(cid:4)(cid:3)(cid:49)(cid:4)(cid:8)(cid:5)(cid:2)(cid:28)(cid:3,,15824.0
,,1,,,Unknown,,cid:10)(cid:11)(cid:10)(cid:46)(cid:14)(cid:2)(cid:9)(cid:11)(cid:4)(cid:3)(cid:49)(cid:4)(cid:8)(cid:5)(cid:2)(cid:28)(cid:3,,15825.0
,,36,,,Unknown,,cid:10)(cid:11)(cid:10)(cid:46)(cid:14)(cid:2)(cid:9)(cid:11)(cid:4)(cid:3)(cid:49)(cid:4)(cid:8)(cid:5)(cid:2)(cid:28)(cid:3,,15861.0
,,18,,,Unknown,,cid:10)(cid:11)(cid:10)(cid:46)(cid:14)(cid:2)(cid:9)(cid:11)(cid:4)(cid:3)(cid:49)(cid:4)(cid:8)(cid:5)(cid:2)(cid:28)(cid:3,,15879.0
,,19,,,Unknown,,cid:10)(cid:11)(cid:10)(cid:46)(cid:14)(cid:2)(cid:9)(cid:11)(cid:4)(cid:3)(cid:49)(cid:4)(cid:8)(cid:5)(cid:2)(cid:28)(cid:3,,15898.0
,,18,,,Unknown,,cid:10)(cid:11)(cid:10)(cid:46)(cid:14)(cid:2)(cid:9)(cid:11)(cid:4)(cid:3)(cid:49)(cid:4)(cid:8)(cid:5)(cid:2)(cid:28)(cid:3,,15916.0
,,18,,,Unknown,,cid:10)(cid:11)(cid:10)(cid:46)(cid:14)(cid:2)(cid:9)(cid:11)(cid:4)(cid:3)(cid:49)(cid:4)(cid:8)(cid:5)(cid:2)(cid:28)(cid:3,,15934.0
,,2,,,Unknown,,cid:10)(cid:11)(cid:10)(cid:46)(cid:14)(cid:2)(cid:9)(cid:11)(cid:4)(cid:3)(cid:49)(cid:4)(cid:8)(cid:5)(cid:2)(cid:28)(cid:3,,15936.0
,,44,,,Unknown,,cid:10)(cid:11)(cid:10)(cid:46)(cid:14)(cid:2)(cid:9)(cid:11)(cid:4)(cid:3)(cid:49)(cid:4)(cid:8)(cid:5)(cid:2)(cid:28)(cid:3,,15980.0
,,49,,,Unknown,,cid:10)(cid:11)(cid:10)(cid:46)(cid:14)(cid:2)(cid:9)(cid:11)(cid:4)(cid:3)(cid:49)(cid:4)(cid:8)(cid:5)(cid:2)(cid:28)(cid:3,,16029.0
,,42,,,Unknown,,cid:10)(cid:11)(cid:10)(cid:46)(cid:14)(cid:2)(cid:9)(cid:11)(cid:4)(cid:3)(cid:49)(cid:4)(cid:8)(cid:5)(cid:2)(cid:28)(cid:3,,16071.0
,,56,,,Unknown,,cid:10)(cid:11)(cid:10)(cid:46)(cid:14)(cid:2)(cid:9)(cid:11)(cid:4)(cid:3)(cid:49)(cid:4)(cid:8)(cid:5)(cid:2)(cid:28)(cid:3,,16127.0
,,57,,,Unknown,,cid:10)(cid:11)(cid:10)(cid:46)(cid:14)(cid:2)(cid:9)(cid:11)(cid:4)(cid:3)(cid:49)(cid:4)(cid:8)(cid:5)(cid:2)(cid:28)(cid:3,,16184.0
,,41,,,Unknown,,cid:10)(cid:11)(cid:10)(cid:46)(cid:14)(cid:2)(cid:9)(cid:11)(cid:4)(cid:3)(cid:49)(cid:4)(cid:8)(cid:5)(cid:2)(cid:28)(cid:3,,16225.0
,,2,,,Unknown,,cid:10)(cid:11)(cid:10)(cid:46)(cid:14)(cid:2)(cid:9)(cid:11)(cid:4)(cid:3)(cid:49)(cid:4)(cid:8)(cid:5)(cid:2)(cid:28)(cid:3,,16227.0
,,48,,,Unknown,,cid:10)(cid:11)(cid:10)(cid:46)(cid:14)(cid:2)(cid:9)(cid:11)(cid:4)(cid:3)(cid:49)(cid:4)(cid:8)(cid:5)(cid:2)(cid:28)(cid:3,,16275.0
,,25,,,Unknown,,cid:10)(cid:11)(cid:10)(cid:46)(cid:14)(cid:2)(cid:9)(cid:11)(cid:4)(cid:3)(cid:49)(cid:4)(cid:8)(cid:5)(cid:2)(cid:28)(cid:3,,16300.0
,,2,,,Unknown,,cid:10)(cid:11)(cid:10)(cid:46)(cid:14)(cid:2)(cid:9)(cid:11)(cid:4)(cid:3)(cid:49)(cid:4)(cid:8)(cid:5)(cid:2)(cid:28)(cid:3,,16302.0
,,31,,,Unknown,,cid:10)(cid:11)(cid:10)(cid:46)(cid:14)(cid:2)(cid:9)(cid:11)(cid:4)(cid:3)(cid:49)(cid:4)(cid:8)(cid:5)(cid:2)(cid:28)(cid:3,,16333.0
,,58,,,Unknown,,cid:10)(cid:11)(cid:10)(cid:46)(cid:14)(cid:2)(cid:9)(cid:11)(cid:4)(cid:3)(cid:49)(cid:4)(cid:8)(cid:5)(cid:2)(cid:28)(cid:3,,16391.0
,,59,,,Unknown,,cid:10)(cid:11)(cid:10)(cid:46)(cid:14)(cid:2)(cid:9)(cid:11)(cid:4)(cid:3)(cid:49)(cid:4)(cid:8)(cid:5)(cid:2)(cid:28)(cid:3,,16450.0
,,60,,,Unknown,,cid:10)(cid:11)(cid:10)(cid:46)(cid:14)(cid:2)(cid:9)(cid:11)(cid:4)(cid:3)(cid:49)(cid:4)(cid:8)(cid:5)(cid:2)(cid:28)(cid:3,,16510.0
,,21,,,Unknown,,cid:10)(cid:11)(cid:10)(cid:46)(cid:14)(cid:2)(cid:9)(cid:11)(cid:4)(cid:3)(cid:49)(cid:4)(cid:8)(cid:5)(cid:2)(cid:28)(cid:3,,16531.0
,,25,,,Unknown,,cid:10)(cid:11)(cid:10)(cid:46)(cid:14)(cid:2)(cid:9)(cid:11)(cid:4)(cid:3)(cid:49)(cid:4)(cid:8)(cid:5)(cid:2)(cid:28)(cid:3,,16556.0
,,18,,,Unknown,,cid:10)(cid:11)(cid:10)(cid:46)(cid:14)(cid:2)(cid:9)(cid:11)(cid:4)(cid:3)(cid:49)(cid:4)(cid:8)(cid:5)(cid:2)(cid:28)(cid:3,,16574.0
,,33,,,Unknown,,cid:10)(cid:11)(cid:10)(cid:46)(cid:14)(cid:2)(cid:9)(cid:11)(cid:4)(cid:3)(cid:49)(cid:4)(cid:8)(cid:5)(cid:2)(cid:28)(cid:3,,16607.0
,,45,,,Unknown,,cid:10)(cid:11)(cid:10)(cid:46)(cid:14)(cid:2)(cid:9)(cid:11)(cid:4)(cid:3)(cid:49)(cid:4)(cid:8)(cid:5)(cid:2)(cid:28)(cid:3,,16652.0
,,18,,,Unknown,,cid:10)(cid:11)(cid:10)(cid:46)(cid:14)(cid:2)(cid:9)(cid:11)(cid:4)(cid:3)(cid:49)(cid:4)(cid:8)(cid:5)(cid:2)(cid:28)(cid:3,,16670.0
,,35,,,Unknown,,cid:10)(cid:11)(cid:10)(cid:46)(cid:14)(cid:2)(cid:9)(cid:11)(cid:4)(cid:3)(cid:49)(cid:4)(cid:8)(cid:5)(cid:2)(cid:28)(cid:3,,16705.0
,,54,,,Unknown,,cid:10)(cid:11)(cid:10)(cid:46)(cid:14)(cid:2)(cid:9)(cid:11)(cid:4)(cid:3)(cid:49)(cid:4)(cid:8)(cid:5)(cid:2)(cid:28)(cid:3,,16759.0
,,46,,,Unknown,,cid:10)(cid:11)(cid:10)(cid:46)(cid:14)(cid:2)(cid:9)(cid:11)(cid:4)(cid:3)(cid:49)(cid:4)(cid:8)(cid:5)(cid:2)(cid:28)(cid:3,,16805.0
,,53,,,Unknown,,cid:10)(cid:11)(cid:10)(cid:46)(cid:14)(cid:2)(cid:9)(cid:11)(cid:4)(cid:3)(cid:49)(cid:4)(cid:8)(cid:5)(cid:2)(cid:28)(cid:3,,16858.0
,,8,,,Unknown,,cid:10)(cid:11)(cid:10)(cid:46)(cid:14)(cid:2)(cid:9)(cid:11)(cid:4)(cid:3)(cid:49)(cid:4)(cid:8)(cid:5)(cid:2)(cid:28)(cid:3,,16866.0
,,46,,,Unknown,,cid:10)(cid:11)(cid:10)(cid:46)(cid:14)(cid:2)(cid:9)(cid:11)(cid:4)(cid:3)(cid:49)(cid:4)(cid:8)(cid:5)(cid:2)(cid:28)(cid:3,,16912.0
,,8,,,Unknown,,cid:10)(cid:11)(cid:10)(cid:46)(cid:14)(cid:2)(cid:9)(cid:11)(cid:4)(cid:3)(cid:49)(cid:4)(cid:8)(cid:5)(cid:2)(cid:28)(cid:3,,16920.0
,,7,,,Unknown,,cid:10)(cid:11)(cid:10)(cid:46)(cid:14)(cid:2)(cid:9)(cid:11)(cid:4)(cid:3)(cid:49)(cid:4)(cid:8)(cid:5)(cid:2)(cid:28)(cid:3,,16927.0
,,43,,,Unknown,,cid:10)(cid:11)(cid:10)(cid:46)(cid:14)(cid:2)(cid:9)(cid:11)(cid:4)(cid:3)(cid:49)(cid:4)(cid:8)(cid:5)(cid:2)(cid:28)(cid:3,,16970.0
,,2,,,Unknown,,cid:10)(cid:11)(cid:10)(cid:46)(cid:14)(cid:2)(cid:9)(cid:11)(cid:4)(cid:3)(cid:49)(cid:4)(cid:8)(cid:5)(cid:2)(cid:28)(cid:3,,16972.0
,,17,,,Unknown,,cid:10)(cid:11)(cid:10)(cid:46)(cid:14)(cid:2)(cid:9)(cid:11)(cid:4)(cid:3)(cid:49)(cid:4)(cid:8)(cid:5)(cid:2)(cid:28)(cid:3,,16989.0
,,36,,,Unknown,,cid:10)(cid:11)(cid:10)(cid:46)(cid:14)(cid:2)(cid:9)(cid:11)(cid:4)(cid:3)(cid:49)(cid:4)(cid:8)(cid:5)(cid:2)(cid:28)(cid:3,,17025.0
,,36,,,Unknown,,cid:10)(cid:11)(cid:10)(cid:46)(cid:14)(cid:2)(cid:9)(cid:11)(cid:4)(cid:3)(cid:49)(cid:4)(cid:8)(cid:5)(cid:2)(cid:28)(cid:3,,17061.0
,,19,,,Unknown,,cid:10)(cid:11)(cid:10)(cid:46)(cid:14)(cid:2)(cid:9)(cid:11)(cid:4)(cid:3)(cid:49)(cid:4)(cid:8)(cid:5)(cid:2)(cid:28)(cid:3,,17080.0
,,18,,,Unknown,,cid:10)(cid:11)(cid:10)(cid:46)(cid:14)(cid:2)(cid:9)(cid:11)(cid:4)(cid:3)(cid:49)(cid:4)(cid:8)(cid:5)(cid:2)(cid:28)(cid:3,,17098.0
,,18,,,Unknown,,cid:10)(cid:11)(cid:10)(cid:46)(cid:14)(cid:2)(cid:9)(cid:11)(cid:4)(cid:3)(cid:49)(cid:4)(cid:8)(cid:5)(cid:2)(cid:28)(cid:3,,17116.0
,,2,,,Unknown,,cid:10)(cid:11)(cid:10)(cid:46)(cid:14)(cid:2)(cid:9)(cid:11)(cid:4)(cid:3)(cid:49)(cid:4)(cid:8)(cid:5)(cid:2)(cid:28)(cid:3,,17118.0
,,44,,,Unknown,,cid:10)(cid:11)(cid:10)(cid:46)(cid:14)(cid:2)(cid:9)(cid:11)(cid:4)(cid:3)(cid:49)(cid:4)(cid:8)(cid:5)(cid:2)(cid:28)(cid:3,,17162.0
,,49,,,Unknown,,cid:10)(cid:11)(cid:10)(cid:46)(cid:14)(cid:2)(cid:9)(cid:11)(cid:4)(cid:3)(cid:49)(cid:4)(cid:8)(cid:5)(cid:2)(cid:28)(cid:3,,17211.0
,,42,,,Unknown,,cid:10)(cid:11)(cid:10)(cid:46)(cid:14)(cid:2)(cid:9)(cid:11)(cid:4)(cid:3)(cid:49)(cid:4)(cid:8)(cid:5)(cid:2)(cid:28)(cid:3,,17253.0
,,56,,,Unknown,,cid:10)(cid:11)(cid:10)(cid:46)(cid:14)(cid:2)(cid:9)(cid:11)(cid:4)(cid:3)(cid:49)(cid:4)(cid:8)(cid:5)(cid:2)(cid:28)(cid:3,,17309.0
,,57,,,Unknown,,cid:10)(cid:11)(cid:10)(cid:46)(cid:14)(cid:2)(cid:9)(cid:11)(cid:4)(cid:3)(cid:49)(cid:4)(cid:8)(cid:5)(cid:2)(cid:28)(cid:3,,17366.0
,,41,,,Unknown,,cid:10)(cid:11)(cid:10)(cid:46)(cid:14)(cid:2)(cid:9)(cid:11)(cid:4)(cid:3)(cid:49)(cid:4)(cid:8)(cid:5)(cid:2)(cid:28)(cid:3,,17407.0
,,2,,,Unknown,,cid:10)(cid:11)(cid:10)(cid:46)(cid:14)(cid:2)(cid:9)(cid:11)(cid:4)(cid:3)(cid:49)(cid:4)(cid:8)(cid:5)(cid:2)(cid:28)(cid:3,,17409.0
,,48,,,Unknown,,cid:10)(cid:11)(cid:10)(cid:46)(cid:14)(cid:2)(cid:9)(cid:11)(cid:4)(cid:3)(cid:49)(cid:4)(cid:8)(cid:5)(cid:2)(cid:28)(cid:3,,17457.0
,,25,,,Unknown,,cid:10)(cid:11)(cid:10)(cid:46)(cid:14)(cid:2)(cid:9)(cid:11)(cid:4)(cid:3)(cid:49)(cid:4)(cid:8)(cid:5)(cid:2)(cid:28)(cid:3,,17482.0
,,2,,,Unknown,,cid:10)(cid:11)(cid:10)(cid:46)(cid:14)(cid:2)(cid:9)(cid:11)(cid:4)(cid:3)(cid:49)(cid:4)(cid:8)(cid:5)(cid:2)(cid:28)(cid:3,,17484.0
,,31,,,Unknown,,cid:10)(cid:11)(cid:10)(cid:46)(cid:14)(cid:2)(cid:9)(cid:11)(cid:4)(cid:3)(cid:49)(cid:4)(cid:8)(cid:5)(cid:2)(cid:28)(cid:3,,17515.0
,,58,,,Unknown,,cid:10)(cid:11)(cid:10)(cid:46)(cid:14)(cid:2)(cid:9)(cid:11)(cid:4)(cid:3)(cid:49)(cid:4)(cid:8)(cid:5)(cid:2)(cid:28)(cid:3,,17573.0
,,59,,,Unknown,,cid:10)(cid:11)(cid:10)(cid:46)(cid:14)(cid:2)(cid:9)(cid:11)(cid:4)(cid:3)(cid:49)(cid:4)(cid:8)(cid:5)(cid:2)(cid:28)(cid:3,,17632.0
,,60,,,Unknown,,cid:10)(cid:11)(cid:10)(cid:46)(cid:14)(cid:2)(cid:9)(cid:11)(cid:4)(cid:3)(cid:49)(cid:4)(cid:8)(cid:5)(cid:2)(cid:28)(cid:3,,17692.0
,,21,,,Unknown,,cid:10)(cid:11)(cid:10)(cid:46)(cid:14)(cid:2)(cid:9)(cid:11)(cid:4)(cid:3)(cid:49)(cid:4)(cid:8)(cid:5)(cid:2)(cid:28)(cid:3,,17713.0
,,25,,,Unknown,,cid:10)(cid:11)(cid:10)(cid:46)(cid:14)(cid:2)(cid:9)(cid:11)(cid:4)(cid:3)(cid:49)(cid:4)(cid:8)(cid:5)(cid:2)(cid:28)(cid:3,,17738.0
,,18,,,Unknown,,cid:10)(cid:11)(cid:10)(cid:46)(cid:14)(cid:2)(cid:9)(cid:11)(cid:4)(cid:3)(cid:49)(cid:4)(cid:8)(cid:5)(cid:2)(cid:28)(cid:3,,17756.0
,,33,,,Unknown,,cid:10)(cid:11)(cid:10)(cid:46)(cid:14)(cid:2)(cid:9)(cid:11)(cid:4)(cid:3)(cid:49)(cid:4)(cid:8)(cid:5)(cid:2)(cid:28)(cid:3,,17789.0
,,45,,,Unknown,,cid:10)(cid:11)(cid:10)(cid:46)(cid:14)(cid:2)(cid:9)(cid:11)(cid:4)(cid:3)(cid:49)(cid:4)(cid:8)(cid:5)(cid:2)(cid:28)(cid:3,,17834.0
,,18,,,Unknown,,cid:10)(cid:11)(cid:10)(cid:46)(cid:14)(cid:2)(cid:9)(cid:11)(cid:4)(cid:3)(cid:49)(cid:4)(cid:8)(cid:5)(cid:2)(cid:28)(cid:3,,17852.0
,,35,,,Unknown,,cid:10)(cid:11)(cid:10)(cid:46)(cid:14)(cid:2)(cid:9)(cid:11)(cid:4)(cid:3)(cid:49)(cid:4)(cid:8)(cid:5)(cid:2)(cid:28)(cid:3,,17887.0
,,38,,,Unknown,,cid:10)(cid:11)(cid:10)(cid:46)(cid:14)(cid:2)(cid:9)(cid:11)(cid:4)(cid:3)(cid:49)(cid:4)(cid:8)(cid:5)(cid:2)(cid:28)(cid:3,,17925.0
,,20,,,Unknown,,cid:10)(cid:11)(cid:10)(cid:46)(cid:14)(cid:2)(cid:9)(cid:11)(cid:4)(cid:3)(cid:49)(cid:4)(cid:8)(cid:5)(cid:2)(cid:28)(cid:3,,17945.0
,,30,,,Unknown,,cid:10)(cid:11)(cid:10)(cid:46)(cid:14)(cid:2)(cid:9)(cid:11)(cid:4)(cid:3)(cid:49)(cid:4)(cid:8)(cid:5)(cid:2)(cid:28)(cid:3,,17975.0
,,41,,,Unknown,,cid:10)(cid:11)(cid:10)(cid:46)(cid:14)(cid:2)(cid:9)(cid:11)(cid:4)(cid:3)(cid:49)(cid:4)(cid:8)(cid:5)(cid:2)(cid:28)(cid:3,,18016.0
,,20,,,Unknown,,cid:10)(cid:11)(cid:10)(cid:46)(cid:14)(cid:2)(cid:9)(cid:11)(cid:4)(cid:3)(cid:49)(cid:4)(cid:8)(cid:5)(cid:2)(cid:28)(cid:3,,18036.0
,,15,,,Unknown,,cid:10)(cid:11)(cid:10)(cid:46)(cid:14)(cid:2)(cid:9)(cid:11)(cid:4)(cid:3)(cid:49)(cid:4)(cid:8)(cid:5)(cid:2)(cid:28)(cid:3,,18051.0
,,2,,,Unknown,,cid:10)(cid:11)(cid:10)(cid:46)(cid:14)(cid:2)(cid:9)(cid:11)(cid:4)(cid:3)(cid:49)(cid:4)(cid:8)(cid:5)(cid:2)(cid:28)(cid:3,,18053.0
,,1,,,Unknown,,cid:10)(cid:11)(cid:10)(cid:46)(cid:14)(cid:2)(cid:9)(cid:11)(cid:4)(cid:3)(cid:49)(cid:4)(cid:8)(cid:5)(cid:2)(cid:28)(cid:3,,18054.0
,,19,,,Unknown,,cid:10)(cid:11)(cid:10)(cid:46)(cid:14)(cid:2)(cid:9)(cid:11)(cid:4)(cid:3)(cid:49)(cid:4)(cid:8)(cid:5)(cid:2)(cid:28)(cid:3,,18073.0
,,36,,,Unknown,,cid:10)(cid:11)(cid:10)(cid:46)(cid:14)(cid:2)(cid:9)(cid:11)(cid:4)(cid:3)(cid:49)(cid:4)(cid:8)(cid:5)(cid:2)(cid:28)(cid:3,,18109.0
,,18,,,Unknown,,cid:10)(cid:11)(cid:10)(cid:46)(cid:14)(cid:2)(cid:9)(cid:11)(cid:4)(cid:3)(cid:49)(cid:4)(cid:8)(cid:5)(cid:2)(cid:28)(cid:3,,18127.0
,,2,,,Unknown,,cid:10)(cid:11)(cid:10)(cid:46)(cid:14)(cid:2)(cid:9)(cid:11)(cid:4)(cid:3)(cid:49)(cid:4)(cid:8)(cid:5)(cid:2)(cid:28)(cid:3,,18129.0
,,44,,,Unknown,,cid:10)(cid:11)(cid:10)(cid:46)(cid:14)(cid:2)(cid:9)(cid:11)(cid:4)(cid:3)(cid:49)(cid:4)(cid:8)(cid:5)(cid:2)(cid:28)(cid:3,,18173.0
,,46,,,Unknown,,cid:10)(cid:11)(cid:10)(cid:46)(cid:14)(cid:2)(cid:9)(cid:11)(cid:4)(cid:3)(cid:49)(cid:4)(cid:8)(cid:5)(cid:2)(cid:28)(cid:3,,18219.0
,,47,,,Unknown,,cid:10)(cid:11)(cid:10)(cid:46)(cid:14)(cid:2)(cid:9)(cid:11)(cid:4)(cid:3)(cid:49)(cid:4)(cid:8)(cid:5)(cid:2)(cid:28)(cid:3,,18266.0
,,20,,,Unknown,,cid:10)(cid:11)(cid:10)(cid:46)(cid:14)(cid:2)(cid:9)(cid:11)(cid:4)(cid:3)(cid:49)(cid:4)(cid:8)(cid:5)(cid:2)(cid:28)(cid:3,,18286.0
,,30,,,Unknown,,cid:10)(cid:11)(cid:10)(cid:46)(cid:14)(cid:2)(cid:9)(cid:11)(cid:4)(cid:3)(cid:49)(cid:4)(cid:8)(cid:5)(cid:2)(cid:28)(cid:3,,18316.0
,,30,,,Unknown,,cid:10)(cid:11)(cid:10)(cid:46)(cid:14)(cid:2)(cid:9)(cid:11)(cid:4)(cid:3)(cid:49)(cid:4)(cid:8)(cid:5)(cid:2)(cid:28)(cid:3,,18346.0
,,25,,,Unknown,,cid:10)(cid:11)(cid:10)(cid:46)(cid:14)(cid:2)(cid:9)(cid:11)(cid:4)(cid:3)(cid:49)(cid:4)(cid:8)(cid:5)(cid:2)(cid:28)(cid:3,,18371.0
,,23,,,Unknown,,cid:10)(cid:11)(cid:10)(cid:46)(cid:14)(cid:2)(cid:9)(cid:11)(cid:4)(cid:3)(cid:49)(cid:4)(cid:8)(cid:5)(cid:2)(cid:28)(cid:3,,18394.0
,,25,,,Unknown,,cid:10)(cid:11)(cid:10)(cid:46)(cid:14)(cid:2)(cid:9)(cid:11)(cid:4)(cid:3)(cid:49)(cid:4)(cid:8)(cid:5)(cid:2)(cid:28)(cid:3,,18419.0
,,30,,,Unknown,,cid:10)(cid:11)(cid:10)(cid:46)(cid:14)(cid:2)(cid:9)(cid:11)(cid:4)(cid:3)(cid:49)(cid:4)(cid:8)(cid:5)(cid:2)(cid:28)(cid:3,,18449.0
,,41,,,Unknown,,cid:10)(cid:11)(cid:10)(cid:46)(cid:14)(cid:2)(cid:9)(cid:11)(cid:4)(cid:3)(cid:49)(cid:4)(cid:8)(cid:5)(cid:2)(cid:28)(cid:3,,18490.0
,,2,,,Unknown,,cid:10)(cid:11)(cid:10)(cid:46)(cid:14)(cid:2)(cid:9)(cid:11)(cid:4)(cid:3)(cid:49)(cid:4)(cid:8)(cid:5)(cid:2)(cid:28)(cid:3,,18492.0
,,45,,,Unknown,,cid:10)(cid:11)(cid:10)(cid:46)(cid:14)(cid:2)(cid:9)(cid:11)(cid:4)(cid:3)(cid:49)(cid:4)(cid:8)(cid:5)(cid:2)(cid:28)(cid:3,,18537.0
,,2,,,Unknown,,cid:10)(cid:11)(cid:10)(cid:46)(cid:14)(cid:2)(cid:9)(cid:11)(cid:4)(cid:3)(cid:49)(cid:4)(cid:8)(cid:5)(cid:2)(cid:28)(cid:3,,18539.0
,,28,,,Unknown,,cid:10)(cid:11)(cid:10)(cid:46)(cid:14)(cid:2)(cid:9)(cid:11)(cid:4)(cid:3)(cid:49)(cid:4)(cid:8)(cid:5)(cid:2)(cid:28)(cid:3,,18567.0
,,26,,,Unknown,,cid:10)(cid:11)(cid:10)(cid:46)(cid:14)(cid:2)(cid:9)(cid:11)(cid:4)(cid:3)(cid:49)(cid:4)(cid:8)(cid:5)(cid:2)(cid:28)(cid:3,,18593.0
,,29,,,Unknown,,cid:10)(cid:11)(cid:10)(cid:46)(cid:14)(cid:2)(cid:9)(cid:11)(cid:4)(cid:3)(cid:49)(cid:4)(cid:8)(cid:5)(cid:2)(cid:28)(cid:3,,18622.0
,,24,,,Unknown,,cid:10)(cid:11)(cid:10)(cid:46)(cid:14)(cid:2)(cid:9)(cid:11)(cid:4)(cid:3)(cid:49)(cid:4)(cid:8)(cid:5)(cid:2)(cid:28)(cid:3,,18646.0
,,27,,,Unknown,,cid:10)(cid:11)(cid:10)(cid:46)(cid:14)(cid:2)(cid:9)(cid:11)(cid:4)(cid:3)(cid:49)(cid:4)(cid:8)(cid:5)(cid:2)(cid:28)(cid:3,,18673.0
,,2,,,Unknown,,cid:10)(cid:11)(cid:10)(cid:46)(cid:14)(cid:2)(cid:9)(cid:11)(cid:4)(cid:3)(cid:49)(cid:4)(cid:8)(cid:5)(cid:2)(cid:28)(cid:3,,18675.0
,,29,,,Unknown,,cid:10)(cid:11)(cid:10)(cid:46)(cid:14)(cid:2)(cid:9)(cid:11)(cid:4)(cid:3)(cid:49)(cid:4)(cid:8)(cid:5)(cid:2)(cid:28)(cid:3,,18704.0
,,48,,,Unknown,,cid:10)(cid:11)(cid:10)(cid:46)(cid:14)(cid:2)(cid:9)(cid:11)(cid:4)(cid:3)(cid:49)(cid:4)(cid:8)(cid:5)(cid:2)(cid:28)(cid:3,,18752.0
,,48,,,Unknown,,cid:10)(cid:11)(cid:10)(cid:46)(cid:14)(cid:2)(cid:9)(cid:11)(cid:4)(cid:3)(cid:49)(cid:4)(cid:8)(cid:5)(cid:2)(cid:28)(cid:3,,18800.0
,,24,,,Unknown,,cid:10)(cid:11)(cid:10)(cid:46)(cid:14)(cid:2)(cid:9)(cid:11)(cid:4)(cid:3)(cid:49)(cid:4)(cid:8)(cid:5)(cid:2)(cid:28)(cid:3,,18824.0
,,41,,,Unknown,,cid:10)(cid:11)(cid:10)(cid:46)(cid:14)(cid:2)(cid:9)(cid:11)(cid:4)(cid:3)(cid:49)(cid:4)(cid:8)(cid:5)(cid:2)(cid:28)(cid:3,,18865.0
,,24,,,Unknown,,cid:10)(cid:11)(cid:10)(cid:46)(cid:14)(cid:2)(cid:9)(cid:11)(cid:4)(cid:3)(cid:49)(cid:4)(cid:8)(cid:5)(cid:2)(cid:28)(cid:3,,18889.0
,,20,,,Unknown,,cid:10)(cid:11)(cid:10)(cid:46)(cid:14)(cid:2)(cid:9)(cid:11)(cid:4)(cid:3)(cid:49)(cid:4)(cid:8)(cid:5)(cid:2)(cid:28)(cid:3,,18909.0
,,30,,,Unknown,,cid:10)(cid:11)(cid:10)(cid:46)(cid:14)(cid:2)(cid:9)(cid:11)(cid:4)(cid:3)(cid:49)(cid:4)(cid:8)(cid:5)(cid:2)(cid:28)(cid:3,,18939.0
,,30,,,Unknown,,cid:10)(cid:11)(cid:10)(cid:46)(cid:14)(cid:2)(cid:9)(cid:11)(cid:4)(cid:3)(cid:49)(cid:4)(cid:8)(cid:5)(cid:2)(cid:28)(cid:3,,18969.0
,,25,,,Unknown,,cid:10)(cid:11)(cid:10)(cid:46)(cid:14)(cid:2)(cid:9)(cid:11)(cid:4)(cid:3)(cid:49)(cid:4)(cid:8)(cid:5)(cid:2)(cid:28)(cid:3,,18994.0
,,22,,,Unknown,,cid:10)(cid:11)(cid:10)(cid:46)(cid:14)(cid:2)(cid:9)(cid:11)(cid:4)(cid:3)(cid:49)(cid:4)(cid:8)(cid:5)(cid:2)(cid:28)(cid:3,,19016.0
,,27,,,Unknown,,cid:10)(cid:11)(cid:10)(cid:46)(cid:14)(cid:2)(cid:9)(cid:11)(cid:4)(cid:3)(cid:49)(cid:4)(cid:8)(cid:5)(cid:2)(cid:28)(cid:3,,19043.0
,,18,,,Unknown,,cid:43)(cid:2)(cid:1)(cid:34)(cid:34)(cid:19)(cid:18)(cid:18)(cid:2)(cid:44,cid:54)(cid:46)(cid:4)(cid:10)(cid:9)(cid:10)(cid:5)(cid:14)(cid:14)(cid:5)(cid:2)(cid:3)(cid:11)(cid:9)(cid:5)(cid:8)(cid:51)(cid:46)(cid:12)(cid:13)(cid:2)(cid:3)(cid:11)(cid:9)(cid:5)(cid:8)(cid:51)(cid:46)(cid:12)(cid:13)(cid:2)(cid:46)(cid:10,18.0
,,33,,,Unknown,,cid:43)(cid:2)(cid:1)(cid:34)(cid:34)(cid:19)(cid:18)(cid:18)(cid:2)(cid:44,cid:17)(cid:16)(cid:45)(cid:18)(cid:35,51.0
,,45,,,Unknown,,cid:43)(cid:2)(cid:1)(cid:34)(cid:34)(cid:19)(cid:18)(cid:18)(cid:2)(cid:44,cid:52)(cid:7)(cid:52)(cid:46)(cid:2)(cid:28)(cid:3)(cid:5)(cid:9)(cid:13)(cid:2)(cid:28)(cid:5)(cid:3)(cid:7)(cid:64)(cid:46)(cid:65)(cid:2)(cid:38)(cid:64,96.0
,,18,,,Unknown,,cid:43)(cid:2)(cid:1)(cid:34)(cid:34)(cid:19)(cid:18)(cid:18)(cid:2)(cid:44,cid:15)(cid:2)(cid:33)(cid:1)(cid:19)(cid:36)(cid:18)(cid:2)(cid:44,114.0
,,35,,,Unknown,,cid:43)(cid:2)(cid:1)(cid:34)(cid:34)(cid:19)(cid:18)(cid:18)(cid:2)(cid:44,,149.0
,,38,,,Unknown,,cid:43)(cid:2)(cid:1)(cid:34)(cid:34)(cid:19)(cid:18)(cid:18)(cid:2)(cid:44,,187.0
,,20,,,Unknown,,cid:43)(cid:2)(cid:1)(cid:34)(cid:34)(cid:19)(cid:18)(cid:18)(cid:2)(cid:44,,207.0
,,30,,,Unknown,,cid:43)(cid:2)(cid:1)(cid:34)(cid:34)(cid:19)(cid:18)(cid:18)(cid:2)(cid:44,,237.0
,,41,,,Unknown,,cid:43)(cid:2)(cid:1)(cid:34)(cid:34)(cid:19)(cid:18)(cid:18)(cid:2)(cid:44,,278.0
,,20,,,Unknown,,cid:43)(cid:2)(cid:1)(cid:34)(cid:34)(cid:19)(cid:18)(cid:18)(cid:2)(cid:44,,298.0
,,15,,,Unknown,,cid:43)(cid:2)(cid:1)(cid:34)(cid:34)(cid:19)(cid:18)(cid:18)(cid:2)(cid:44,,313.0
,,2,,,Unknown,,cid:43)(cid:2)(cid:1)(cid:34)(cid:34)(cid:19)(cid:18)(cid:18)(cid:2)(cid:44,,315.0
,,1,,,Unknown,,cid:43)(cid:2)(cid:1)(cid:34)(cid:34)(cid:19)(cid:18)(cid:18)(cid:2)(cid:44,,316.0
,,19,,,Unknown,,cid:43)(cid:2)(cid:1)(cid:34)(cid:34)(cid:19)(cid:18)(cid:18)(cid:2)(cid:44,,335.0
,,36,,,Unknown,,cid:43)(cid:2)(cid:1)(cid:34)(cid:34)(cid:19)(cid:18)(cid:18)(cid:2)(cid:44,,371.0
,,18,,,Unknown,,cid:43)(cid:2)(cid:1)(cid:34)(cid:34)(cid:19)(cid:18)(cid:18)(cid:2)(cid:44,,389.0
,,2,,,Unknown,,cid:43)(cid:2)(cid:1)(cid:34)(cid:34)(cid:19)(cid:18)(cid:18)(cid:2)(cid:44,,391.0
,,44,,,Unknown,,cid:43)(cid:2)(cid:1)(cid:34)(cid:34)(cid:19)(cid:18)(cid:18)(cid:2)(cid:44,,435.0
,,46,,,Unknown,,cid:43)(cid:2)(cid:1)(cid:34)(cid:34)(cid:19)(cid:18)(cid:18)(cid:2)(cid:44,,481.0
,,47,,,Unknown,,cid:43)(cid:2)(cid:1)(cid:34)(cid:34)(cid:19)(cid:18)(cid:18)(cid:2)(cid:44,,528.0
,,20,,,Unknown,,cid:43)(cid:2)(cid:1)(cid:34)(cid:34)(cid:19)(cid:18)(cid:18)(cid:2)(cid:44,,548.0
,,30,,,Unknown,,cid:43)(cid:2)(cid:1)(cid:34)(cid:34)(cid:19)(cid:18)(cid:18)(cid:2)(cid:44,,578.0
,,30,,,Unknown,,cid:43)(cid:2)(cid:1)(cid:34)(cid:34)(cid:19)(cid:18)(cid:18)(cid:2)(cid:44,,608.0
,,25,,,Unknown,,cid:43)(cid:2)(cid:1)(cid:34)(cid:34)(cid:19)(cid:18)(cid:18)(cid:2)(cid:44,,633.0
,,23,,,Unknown,,cid:43)(cid:2)(cid:1)(cid:34)(cid:34)(cid:19)(cid:18)(cid:18)(cid:2)(cid:44,,656.0
,,25,,,Unknown,,cid:43)(cid:2)(cid:1)(cid:34)(cid:34)(cid:19)(cid:18)(cid:18)(cid:2)(cid:44,,681.0
,,30,,,Unknown,,cid:43)(cid:2)(cid:1)(cid:34)(cid:34)(cid:19)(cid:18)(cid:18)(cid:2)(cid:44,,711.0
,,41,,,Unknown,,cid:43)(cid:2)(cid:1)(cid:34)(cid:34)(cid:19)(cid:18)(cid:18)(cid:2)(cid:44,,752.0
,,2,,,Unknown,,cid:43)(cid:2)(cid:1)(cid:34)(cid:34)(cid:19)(cid:18)(cid:18)(cid:2)(cid:44,,754.0
,,45,,,Unknown,,cid:43)(cid:2)(cid:1)(cid:34)(cid:34)(cid:19)(cid:18)(cid:18)(cid:2)(cid:44,,799.0
,,2,,,Unknown,,cid:43)(cid:2)(cid:1)(cid:34)(cid:34)(cid:19)(cid:18)(cid:18)(cid:2)(cid:44,,801.0
,,28,,,Unknown,,cid:43)(cid:2)(cid:1)(cid:34)(cid:34)(cid:19)(cid:18)(cid:18)(cid:2)(cid:44,,829.0
,,26,,,Unknown,,cid:43)(cid:2)(cid:1)(cid:34)(cid:34)(cid:19)(cid:18)(cid:18)(cid:2)(cid:44,,855.0
,,29,,,Unknown,,cid:43)(cid:2)(cid:1)(cid:34)(cid:34)(cid:19)(cid:18)(cid:18)(cid:2)(cid:44,,884.0
,,24,,,Unknown,,cid:43)(cid:2)(cid:1)(cid:34)(cid:34)(cid:19)(cid:18)(cid:18)(cid:2)(cid:44,,908.0
,,27,,,Unknown,,cid:43)(cid:2)(cid:1)(cid:34)(cid:34)(cid:19)(cid:18)(cid:18)(cid:2)(cid:44,,935.0
,,2,,,Unknown,,cid:43)(cid:2)(cid:1)(cid:34)(cid:34)(cid:19)(cid:18)(cid:18)(cid:2)(cid:44,,937.0
,,29,,,Unknown,,cid:43)(cid:2)(cid:1)(cid:34)(cid:34)(cid:19)(cid:18)(cid:18)(cid:2)(cid:44,,966.0
,,48,,,Unknown,,cid:43)(cid:2)(cid:1)(cid:34)(cid:34)(cid:19)(cid:18)(cid:18)(cid:2)(cid:44,,1014.0
,,48,,,Unknown,,cid:43)(cid:2)(cid:1)(cid:34)(cid:34)(cid:19)(cid:18)(cid:18)(cid:2)(cid:44,,1062.0
,,24,,,Unknown,,cid:43)(cid:2)(cid:1)(cid:34)(cid:34)(cid:19)(cid:18)(cid:18)(cid:2)(cid:44,,1086.0
,,41,,,Unknown,,cid:43)(cid:2)(cid:1)(cid:34)(cid:34)(cid:19)(cid:18)(cid:18)(cid:2)(cid:44,,1127.0
,,24,,,Unknown,,cid:43)(cid:2)(cid:1)(cid:34)(cid:34)(cid:19)(cid:18)(cid:18)(cid:2)(cid:44,,1151.0
,,20,,,Unknown,,cid:43)(cid:2)(cid:1)(cid:34)(cid:34)(cid:19)(cid:18)(cid:18)(cid:2)(cid:44,,1171.0
,,30,,,Unknown,,cid:43)(cid:2)(cid:1)(cid:34)(cid:34)(cid:19)(cid:18)(cid:18)(cid:2)(cid:44,,1201.0
,,30,,,Unknown,,cid:43)(cid:2)(cid:1)(cid:34)(cid:34)(cid:19)(cid:18)(cid:18)(cid:2)(cid:44,,1231.0
,,25,,,Unknown,,cid:43)(cid:2)(cid:1)(cid:34)(cid:34)(cid:19)(cid:18)(cid:18)(cid:2)(cid:44,,1256.0
,,22,,,Unknown,,cid:43)(cid:2)(cid:1)(cid:34)(cid:34)(cid:19)(cid:18)(cid:18)(cid:2)(cid:44,,1278.0
,,27,,,Unknown,,cid:43)(cid:2)(cid:1)(cid:34)(cid:34)(cid:19)(cid:18)(cid:18)(cid:2)(cid:44,,1305.0
,,18,,,Unknown,,cid:43)(cid:2)(cid:1)(cid:34)(cid:34)(cid:19)(cid:18)(cid:18)(cid:2)(cid:44,,1323.0
,,33,,,Unknown,,cid:43)(cid:2)(cid:1)(cid:34)(cid:34)(cid:19)(cid:18)(cid:18)(cid:2)(cid:44,,1356.0
,,45,,,Unknown,,cid:43)(cid:2)(cid:1)(cid:34)(cid:34)(cid:19)(cid:18)(cid:18)(cid:2)(cid:44,,1401.0
,,18,,,Unknown,,cid:43)(cid:2)(cid:1)(cid:34)(cid:34)(cid:19)(cid:18)(cid:18)(cid:2)(cid:44,,1419.0
,,35,,,Unknown,,cid:43)(cid:2)(cid:1)(cid:34)(cid:34)(cid:19)(cid:18)(cid:18)(cid:2)(cid:44,,1454.0
,,38,,,Unknown,,cid:43)(cid:2)(cid:1)(cid:34)(cid:34)(cid:19)(cid:18)(cid:18)(cid:2)(cid:44,,1492.0
,,20,,,Unknown,,cid:43)(cid:2)(cid:1)(cid:34)(cid:34)(cid:19)(cid:18)(cid:18)(cid:2)(cid:44,,1512.0
,,30,,,Unknown,,cid:43)(cid:2)(cid:1)(cid:34)(cid:34)(cid:19)(cid:18)(cid:18)(cid:2)(cid:44,,1542.0
,,41,,,Unknown,,cid:43)(cid:2)(cid:1)(cid:34)(cid:34)(cid:19)(cid:18)(cid:18)(cid:2)(cid:44,,1583.0
,,20,,,Unknown,,cid:43)(cid:2)(cid:1)(cid:34)(cid:34)(cid:19)(cid:18)(cid:18)(cid:2)(cid:44,,1603.0
,,15,,,Unknown,,cid:43)(cid:2)(cid:1)(cid:34)(cid:34)(cid:19)(cid:18)(cid:18)(cid:2)(cid:44,,1618.0
,,2,,,Unknown,,cid:43)(cid:2)(cid:1)(cid:34)(cid:34)(cid:19)(cid:18)(cid:18)(cid:2)(cid:44,,1620.0
,,1,,,Unknown,,cid:43)(cid:2)(cid:1)(cid:34)(cid:34)(cid:19)(cid:18)(cid:18)(cid:2)(cid:44,,1621.0
,,19,,,Unknown,,cid:43)(cid:2)(cid:1)(cid:34)(cid:34)(cid:19)(cid:18)(cid:18)(cid:2)(cid:44,,1640.0
,,36,,,Unknown,,cid:43)(cid:2)(cid:1)(cid:34)(cid:34)(cid:19)(cid:18)(cid:18)(cid:2)(cid:44,,1676.0
,,18,,,Unknown,,cid:43)(cid:2)(cid:1)(cid:34)(cid:34)(cid:19)(cid:18)(cid:18)(cid:2)(cid:44,,1694.0
,,2,,,Unknown,,cid:43)(cid:2)(cid:1)(cid:34)(cid:34)(cid:19)(cid:18)(cid:18)(cid:2)(cid:44,,1696.0
,,44,,,Unknown,,cid:43)(cid:2)(cid:1)(cid:34)(cid:34)(cid:19)(cid:18)(cid:18)(cid:2)(cid:44,,1740.0
,,46,,,Unknown,,cid:43)(cid:2)(cid:1)(cid:34)(cid:34)(cid:19)(cid:18)(cid:18)(cid:2)(cid:44,,1786.0
,,47,,,Unknown,,cid:43)(cid:2)(cid:1)(cid:34)(cid:34)(cid:19)(cid:18)(cid:18)(cid:2)(cid:44,,1833.0
,,20,,,Unknown,,cid:43)(cid:2)(cid:1)(cid:34)(cid:34)(cid:19)(cid:18)(cid:18)(cid:2)(cid:44,,1853.0
,,30,,,Unknown,,cid:43)(cid:2)(cid:1)(cid:34)(cid:34)(cid:19)(cid:18)(cid:18)(cid:2)(cid:44,,1883.0
,,30,,,Unknown,,cid:43)(cid:2)(cid:1)(cid:34)(cid:34)(cid:19)(cid:18)(cid:18)(cid:2)(cid:44,,1913.0
,,25,,,Unknown,,cid:43)(cid:2)(cid:1)(cid:34)(cid:34)(cid:19)(cid:18)(cid:18)(cid:2)(cid:44,,1938.0
,,23,,,Unknown,,cid:43)(cid:2)(cid:1)(cid:34)(cid:34)(cid:19)(cid:18)(cid:18)(cid:2)(cid:44,,1961.0
,,25,,,Unknown,,cid:43)(cid:2)(cid:1)(cid:34)(cid:34)(cid:19)(cid:18)(cid:18)(cid:2)(cid:44,,1986.0
,,30,,,Unknown,,cid:43)(cid:2)(cid:1)(cid:34)(cid:34)(cid:19)(cid:18)(cid:18)(cid:2)(cid:44,,2016.0
,,41,,,Unknown,,cid:43)(cid:2)(cid:1)(cid:34)(cid:34)(cid:19)(cid:18)(cid:18)(cid:2)(cid:44,,2057.0
,,2,,,Unknown,,cid:43)(cid:2)(cid:1)(cid:34)(cid:34)(cid:19)(cid:18)(cid:18)(cid:2)(cid:44,,2059.0
,,45,,,Unknown,,cid:43)(cid:2)(cid:1)(cid:34)(cid:34)(cid:19)(cid:18)(cid:18)(cid:2)(cid:44,,2104.0
,,2,,,Unknown,,cid:43)(cid:2)(cid:1)(cid:34)(cid:34)(cid:19)(cid:18)(cid:18)(cid:2)(cid:44,,2106.0
,,28,,,Unknown,,cid:43)(cid:2)(cid:1)(cid:34)(cid:34)(cid:19)(cid:18)(cid:18)(cid:2)(cid:44,,2134.0
,,26,,,Unknown,,cid:43)(cid:2)(cid:1)(cid:34)(cid:34)(cid:19)(cid:18)(cid:18)(cid:2)(cid:44,,2160.0
,,29,,,Unknown,,cid:43)(cid:2)(cid:1)(cid:34)(cid:34)(cid:19)(cid:18)(cid:18)(cid:2)(cid:44,,2189.0
,,24,,,Unknown,,cid:43)(cid:2)(cid:1)(cid:34)(cid:34)(cid:19)(cid:18)(cid:18)(cid:2)(cid:44,,2213.0
,,27,,,Unknown,,cid:43)(cid:2)(cid:1)(cid:34)(cid:34)(cid:19)(cid:18)(cid:18)(cid:2)(cid:44,,2240.0
,,2,,,Unknown,,cid:43)(cid:2)(cid:1)(cid:34)(cid:34)(cid:19)(cid:18)(cid:18)(cid:2)(cid:44,,2242.0
,,29,,,Unknown,,cid:43)(cid:2)(cid:1)(cid:34)(cid:34)(cid:19)(cid:18)(cid:18)(cid:2)(cid:44,,2271.0
,,48,,,Unknown,,cid:43)(cid:2)(cid:1)(cid:34)(cid:34)(cid:19)(cid:18)(cid:18)(cid:2)(cid:44,,2319.0
,,48,,,Unknown,,cid:43)(cid:2)(cid:1)(cid:34)(cid:34)(cid:19)(cid:18)(cid:18)(cid:2)(cid:44,,2367.0
,,24,,,Unknown,,cid:43)(cid:2)(cid:1)(cid:34)(cid:34)(cid:19)(cid:18)(cid:18)(cid:2)(cid:44,,2391.0
,,41,,,Unknown,,cid:43)(cid:2)(cid:1)(cid:34)(cid:34)(cid:19)(cid:18)(cid:18)(cid:2)(cid:44,,2432.0
,,24,,,Unknown,,cid:43)(cid:2)(cid:1)(cid:34)(cid:34)(cid:19)(cid:18)(cid:18)(cid:2)(cid:44,,2456.0
,,20,,,Unknown,,cid:43)(cid:2)(cid:1)(cid:34)(cid:34)(cid:19)(cid:18)(cid:18)(cid:2)(cid:44,,2476.0
,,30,,,Unknown,,cid:43)(cid:2)(cid:1)(cid:34)(cid:34)(cid:19)(cid:18)(cid:18)(cid:2)(cid:44,,2506.0
,,30,,,Unknown,,cid:43)(cid:2)(cid:1)(cid:34)(cid:34)(cid:19)(cid:18)(cid:18)(cid:2)(cid:44,,2536.0
,,25,,,Unknown,,cid:43)(cid:2)(cid:1)(cid:34)(cid:34)(cid:19)(cid:18)(cid:18)(cid:2)(cid:44,,2561.0
,,22,,,Unknown,,cid:43)(cid:2)(cid:1)(cid:34)(cid:34)(cid:19)(cid:18)(cid:18)(cid:2)(cid:44,,2583.0
,,27,,,Unknown,,cid:43)(cid:2)(cid:1)(cid:34)(cid:34)(cid:19)(cid:18)(cid:18)(cid:2)(cid:44,,2610.0
,,17,,,Unknown,,cid:43)(cid:2)(cid:1)(cid:34)(cid:34)(cid:19)(cid:18)(cid:18)(cid:2)(cid:44,,2627.0
,,18,,,Unknown,,cid:43)(cid:2)(cid:1)(cid:34)(cid:34)(cid:19)(cid:18)(cid:18)(cid:2)(cid:44,,2645.0
,,45,,,Unknown,,cid:43)(cid:2)(cid:1)(cid:34)(cid:34)(cid:19)(cid:18)(cid:18)(cid:2)(cid:44,,2690.0
,,18,,,Unknown,,cid:43)(cid:2)(cid:1)(cid:34)(cid:34)(cid:19)(cid:18)(cid:18)(cid:2)(cid:44,,2708.0
,,35,,,Unknown,,cid:43)(cid:2)(cid:1)(cid:34)(cid:34)(cid:19)(cid:18)(cid:18)(cid:2)(cid:44,,2743.0
,,53,,,Unknown,,cid:43)(cid:2)(cid:1)(cid:34)(cid:34)(cid:19)(cid:18)(cid:18)(cid:2)(cid:44,,2796.0
,,3,,,Unknown,,cid:43)(cid:2)(cid:1)(cid:34)(cid:34)(cid:19)(cid:18)(cid:18)(cid:2)(cid:44,,2799.0
,,11,,,Unknown,,cid:43)(cid:2)(cid:1)(cid:34)(cid:34)(cid:19)(cid:18)(cid:18)(cid:2)(cid:44,,2810.0
,,4,,,Unknown,,cid:43)(cid:2)(cid:1)(cid:34)(cid:34)(cid:19)(cid:18)(cid:18)(cid:2)(cid:44,,2814.0
,,39,,,Unknown,,cid:43)(cid:2)(cid:1)(cid:34)(cid:34)(cid:19)(cid:18)(cid:18)(cid:2)(cid:44,,2853.0
,,46,,,Unknown,,cid:43)(cid:2)(cid:1)(cid:34)(cid:34)(cid:19)(cid:18)(cid:18)(cid:2)(cid:44,,2899.0
,,54,,,Unknown,,cid:43)(cid:2)(cid:1)(cid:34)(cid:34)(cid:19)(cid:18)(cid:18)(cid:2)(cid:44,,2953.0
,,46,,,Unknown,,cid:43)(cid:2)(cid:1)(cid:34)(cid:34)(cid:19)(cid:18)(cid:18)(cid:2)(cid:44,,2999.0
,,2,,,Unknown,,cid:43)(cid:2)(cid:1)(cid:34)(cid:34)(cid:19)(cid:18)(cid:18)(cid:2)(cid:44,,3001.0
,,36,,,Unknown,,cid:43)(cid:2)(cid:1)(cid:34)(cid:34)(cid:19)(cid:18)(cid:18)(cid:2)(cid:44,,3037.0
,,18,,,Unknown,,cid:43)(cid:2)(cid:1)(cid:34)(cid:34)(cid:19)(cid:18)(cid:18)(cid:2)(cid:44,,3055.0
,,17,,,Unknown,,cid:43)(cid:2)(cid:1)(cid:34)(cid:34)(cid:19)(cid:18)(cid:18)(cid:2)(cid:44,,3072.0
,,37,,,Unknown,,cid:43)(cid:2)(cid:1)(cid:34)(cid:34)(cid:19)(cid:18)(cid:18)(cid:2)(cid:44,,3109.0
,,16,,,Unknown,,cid:43)(cid:2)(cid:1)(cid:34)(cid:34)(cid:19)(cid:18)(cid:18)(cid:2)(cid:44,,3125.0
,,36,,,Unknown,,cid:43)(cid:2)(cid:1)(cid:34)(cid:34)(cid:19)(cid:18)(cid:18)(cid:2)(cid:44,,3161.0
,,15,,,Unknown,,cid:43)(cid:2)(cid:1)(cid:34)(cid:34)(cid:19)(cid:18)(cid:18)(cid:2)(cid:44,,3176.0
,,2,,,Unknown,,cid:43)(cid:2)(cid:1)(cid:34)(cid:34)(cid:19)(cid:18)(cid:18)(cid:2)(cid:44,,3178.0
,,1,,,Unknown,,cid:43)(cid:2)(cid:1)(cid:34)(cid:34)(cid:19)(cid:18)(cid:18)(cid:2)(cid:44,,3179.0
,,33,,,Unknown,,cid:43)(cid:2)(cid:1)(cid:34)(cid:34)(cid:19)(cid:18)(cid:18)(cid:2)(cid:44,,3212.0
,,19,,,Unknown,,cid:43)(cid:2)(cid:1)(cid:34)(cid:34)(cid:19)(cid:18)(cid:18)(cid:2)(cid:44,,3231.0
,,33,,,Unknown,,cid:43)(cid:2)(cid:1)(cid:34)(cid:34)(cid:19)(cid:18)(cid:18)(cid:2)(cid:44,,3264.0
,,33,,,Unknown,,cid:43)(cid:2)(cid:1)(cid:34)(cid:34)(cid:19)(cid:18)(cid:18)(cid:2)(cid:44,,3297.0
,,2,,,Unknown,,cid:43)(cid:2)(cid:1)(cid:34)(cid:34)(cid:19)(cid:18)(cid:18)(cid:2)(cid:44,,3299.0
,,44,,,Unknown,,cid:43)(cid:2)(cid:1)(cid:34)(cid:34)(cid:19)(cid:18)(cid:18)(cid:2)(cid:44,,3343.0
,,39,,,Unknown,,cid:43)(cid:2)(cid:1)(cid:34)(cid:34)(cid:19)(cid:18)(cid:18)(cid:2)(cid:44,,3382.0
,,18,,,Unknown,,cid:43)(cid:2)(cid:1)(cid:34)(cid:34)(cid:19)(cid:18)(cid:18)(cid:2)(cid:44,,3400.0
,,16,,,Unknown,,cid:43)(cid:2)(cid:1)(cid:34)(cid:34)(cid:19)(cid:18)(cid:18)(cid:2)(cid:44,,3416.0
,,37,,,Unknown,,cid:43)(cid:2)(cid:1)(cid:34)(cid:34)(cid:19)(cid:18)(cid:18)(cid:2)(cid:44,,3453.0
,,18,,,Unknown,,cid:43)(cid:2)(cid:1)(cid:34)(cid:34)(cid:19)(cid:18)(cid:18)(cid:2)(cid:44,,3471.0
,,35,,,Unknown,,cid:43)(cid:2)(cid:1)(cid:34)(cid:34)(cid:19)(cid:18)(cid:18)(cid:2)(cid:44,,3506.0
,,16,,,Unknown,,cid:43)(cid:2)(cid:1)(cid:34)(cid:34)(cid:19)(cid:18)(cid:18)(cid:2)(cid:44,,3522.0
,,17,,,Unknown,,cid:43)(cid:2)(cid:1)(cid:34)(cid:34)(cid:19)(cid:18)(cid:18)(cid:2)(cid:44,,3539.0
,,33,,,Unknown,,cid:43)(cid:2)(cid:1)(cid:34)(cid:34)(cid:19)(cid:18)(cid:18)(cid:2)(cid:44,,3572.0
,,32,,,Unknown,,cid:43)(cid:2)(cid:1)(cid:34)(cid:34)(cid:19)(cid:18)(cid:18)(cid:2)(cid:44,,3604.0
,,2,,,Unknown,,cid:43)(cid:2)(cid:1)(cid:34)(cid:34)(cid:19)(cid:18)(cid:18)(cid:2)(cid:44,,3606.0
,,17,,,Unknown,,cid:43)(cid:2)(cid:1)(cid:34)(cid:34)(cid:19)(cid:18)(cid:18)(cid:2)(cid:44,,3623.0
,,35,,,Unknown,,cid:43)(cid:2)(cid:1)(cid:34)(cid:34)(cid:19)(cid:18)(cid:18)(cid:2)(cid:44,,3658.0
,,37,,,Unknown,,cid:43)(cid:2)(cid:1)(cid:34)(cid:34)(cid:19)(cid:18)(cid:18)(cid:2)(cid:44,,3695.0
,,36,,,Unknown,,cid:43)(cid:2)(cid:1)(cid:34)(cid:34)(cid:19)(cid:18)(cid:18)(cid:2)(cid:44,,3731.0
,,16,,,Unknown,,cid:43)(cid:2)(cid:1)(cid:34)(cid:34)(cid:19)(cid:18)(cid:18)(cid:2)(cid:44,,3747.0
,,36,,,Unknown,,cid:43)(cid:2)(cid:1)(cid:34)(cid:34)(cid:19)(cid:18)(cid:18)(cid:2)(cid:44,,3783.0
,,32,,,Unknown,,cid:43)(cid:2)(cid:1)(cid:34)(cid:34)(cid:19)(cid:18)(cid:18)(cid:2)(cid:44,,3815.0
,,18,,,Unknown,,cid:43)(cid:2)(cid:1)(cid:34)(cid:34)(cid:19)(cid:18)(cid:18)(cid:2)(cid:44,,3833.0
,,18,,,Unknown,,cid:43)(cid:2)(cid:1)(cid:34)(cid:34)(cid:19)(cid:18)(cid:18)(cid:2)(cid:44,,3851.0
,,18,,,Unknown,,cid:43)(cid:2)(cid:1)(cid:34)(cid:34)(cid:19)(cid:18)(cid:18)(cid:2)(cid:44,,3869.0
,,18,,,Unknown,,cid:43)(cid:2)(cid:1)(cid:34)(cid:34)(cid:19)(cid:18)(cid:18)(cid:2)(cid:44,,3887.0
,,18,,,Unknown,,cid:43)(cid:2)(cid:1)(cid:34)(cid:34)(cid:19)(cid:18)(cid:18)(cid:2)(cid:44,,3905.0
,,18,,,Unknown,,cid:43)(cid:2)(cid:1)(cid:34)(cid:34)(cid:19)(cid:18)(cid:18)(cid:2)(cid:44,,3923.0
,,36,,,Unknown,,cid:43)(cid:2)(cid:1)(cid:34)(cid:34)(cid:19)(cid:18)(cid:18)(cid:2)(cid:44,,3959.0
,,17,,,Unknown,,cid:43)(cid:2)(cid:1)(cid:34)(cid:34)(cid:19)(cid:18)(cid:18)(cid:2)(cid:44,,3976.0
,,18,,,Unknown,,cid:43)(cid:2)(cid:1)(cid:34)(cid:34)(cid:19)(cid:18)(cid:18)(cid:2)(cid:44,,3994.0
,,45,,,Unknown,,cid:43)(cid:2)(cid:1)(cid:34)(cid:34)(cid:19)(cid:18)(cid:18)(cid:2)(cid:44,,4039.0
,,18,,,Unknown,,cid:43)(cid:2)(cid:1)(cid:34)(cid:34)(cid:19)(cid:18)(cid:18)(cid:2)(cid:44,,4057.0
,,35,,,Unknown,,cid:43)(cid:2)(cid:1)(cid:34)(cid:34)(cid:19)(cid:18)(cid:18)(cid:2)(cid:44,,4092.0
,,46,,,Unknown,,cid:43)(cid:2)(cid:1)(cid:34)(cid:34)(cid:19)(cid:18)(cid:18)(cid:2)(cid:44,,4138.0
,,14,,,Unknown,,cid:43)(cid:2)(cid:1)(cid:34)(cid:34)(cid:19)(cid:18)(cid:18)(cid:2)(cid:44,,4152.0
,,52,,,Unknown,,cid:43)(cid:2)(cid:1)(cid:34)(cid:34)(cid:19)(cid:18)(cid:18)(cid:2)(cid:44,,4204.0
,,5,,,Unknown,,cid:43)(cid:2)(cid:1)(cid:34)(cid:34)(cid:19)(cid:18)(cid:18)(cid:2)(cid:44,,4209.0
,,9,,,Unknown,,cid:43)(cid:2)(cid:1)(cid:34)(cid:34)(cid:19)(cid:18)(cid:18)(cid:2)(cid:44,,4218.0
,,43,,,Unknown,,cid:43)(cid:2)(cid:1)(cid:34)(cid:34)(cid:19)(cid:18)(cid:18)(cid:2)(cid:44,,4261.0
,,2,,,Unknown,,cid:43)(cid:2)(cid:1)(cid:34)(cid:34)(cid:19)(cid:18)(cid:18)(cid:2)(cid:44,,4263.0
,,1,,,Unknown,,cid:43)(cid:2)(cid:1)(cid:34)(cid:34)(cid:19)(cid:18)(cid:18)(cid:2)(cid:44,,4264.0
,,34,,,Unknown,,cid:43)(cid:2)(cid:1)(cid:34)(cid:34)(cid:19)(cid:18)(cid:18)(cid:2)(cid:44,,4298.0
,,34,,,Unknown,,cid:43)(cid:2)(cid:1)(cid:34)(cid:34)(cid:19)(cid:18)(cid:18)(cid:2)(cid:44,,4332.0
,,19,,,Unknown,,cid:43)(cid:2)(cid:1)(cid:34)(cid:34)(cid:19)(cid:18)(cid:18)(cid:2)(cid:44,,4351.0
,,18,,,Unknown,,cid:43)(cid:2)(cid:1)(cid:34)(cid:34)(cid:19)(cid:18)(cid:18)(cid:2)(cid:44,,4369.0
,,18,,,Unknown,,cid:43)(cid:2)(cid:1)(cid:34)(cid:34)(cid:19)(cid:18)(cid:18)(cid:2)(cid:44,,4387.0
,,2,,,Unknown,,cid:43)(cid:2)(cid:1)(cid:34)(cid:34)(cid:19)(cid:18)(cid:18)(cid:2)(cid:44,,4389.0
,,44,,,Unknown,,cid:43)(cid:2)(cid:1)(cid:34)(cid:34)(cid:19)(cid:18)(cid:18)(cid:2)(cid:44,,4433.0
,,49,,,Unknown,,cid:43)(cid:2)(cid:1)(cid:34)(cid:34)(cid:19)(cid:18)(cid:18)(cid:2)(cid:44,,4482.0
,,42,,,Unknown,,cid:43)(cid:2)(cid:1)(cid:34)(cid:34)(cid:19)(cid:18)(cid:18)(cid:2)(cid:44,,4524.0
,,56,,,Unknown,,cid:43)(cid:2)(cid:1)(cid:34)(cid:34)(cid:19)(cid:18)(cid:18)(cid:2)(cid:44,,4580.0
,,57,,,Unknown,,cid:43)(cid:2)(cid:1)(cid:34)(cid:34)(cid:19)(cid:18)(cid:18)(cid:2)(cid:44,,4637.0
,,41,,,Unknown,,cid:43)(cid:2)(cid:1)(cid:34)(cid:34)(cid:19)(cid:18)(cid:18)(cid:2)(cid:44,,4678.0
,,2,,,Unknown,,cid:43)(cid:2)(cid:1)(cid:34)(cid:34)(cid:19)(cid:18)(cid:18)(cid:2)(cid:44,,4680.0
,,48,,,Unknown,,cid:43)(cid:2)(cid:1)(cid:34)(cid:34)(cid:19)(cid:18)(cid:18)(cid:2)(cid:44,,4728.0
,,25,,,Unknown,,cid:43)(cid:2)(cid:1)(cid:34)(cid:34)(cid:19)(cid:18)(cid:18)(cid:2)(cid:44,,4753.0
,,2,,,Unknown,,cid:43)(cid:2)(cid:1)(cid:34)(cid:34)(cid:19)(cid:18)(cid:18)(cid:2)(cid:44,,4755.0
,,31,,,Unknown,,cid:43)(cid:2)(cid:1)(cid:34)(cid:34)(cid:19)(cid:18)(cid:18)(cid:2)(cid:44,,4786.0
,,58,,,Unknown,,cid:43)(cid:2)(cid:1)(cid:34)(cid:34)(cid:19)(cid:18)(cid:18)(cid:2)(cid:44,,4844.0
,,59,,,Unknown,,cid:43)(cid:2)(cid:1)(cid:34)(cid:34)(cid:19)(cid:18)(cid:18)(cid:2)(cid:44,,4903.0
,,60,,,Unknown,,cid:43)(cid:2)(cid:1)(cid:34)(cid:34)(cid:19)(cid:18)(cid:18)(cid:2)(cid:44,,4963.0
,,21,,,Unknown,,cid:43)(cid:2)(cid:1)(cid:34)(cid:34)(cid:19)(cid:18)(cid:18)(cid:2)(cid:44,,4984.0
,,25,,,Unknown,,cid:43)(cid:2)(cid:1)(cid:34)(cid:34)(cid:19)(cid:18)(cid:18)(cid:2)(cid:44,,5009.0
,,17,,,Unknown,,cid:43)(cid:2)(cid:1)(cid:34)(cid:34)(cid:19)(cid:18)(cid:18)(cid:2)(cid:44,,5026.0
,,18,,,Unknown,,cid:43)(cid:2)(cid:1)(cid:34)(cid:34)(cid:19)(cid:18)(cid:18)(cid:2)(cid:44,,5044.0
,,45,,,Unknown,,cid:43)(cid:2)(cid:1)(cid:34)(cid:34)(cid:19)(cid:18)(cid:18)(cid:2)(cid:44,,5089.0
,,18,,,Unknown,,cid:43)(cid:2)(cid:1)(cid:34)(cid:34)(cid:19)(cid:18)(cid:18)(cid:2)(cid:44,,5107.0
,,35,,,Unknown,,cid:43)(cid:2)(cid:1)(cid:34)(cid:34)(cid:19)(cid:18)(cid:18)(cid:2)(cid:44,,5142.0
,,54,,,Unknown,,cid:43)(cid:2)(cid:1)(cid:34)(cid:34)(cid:19)(cid:18)(cid:18)(cid:2)(cid:44,,5196.0
,,7,,,Unknown,,cid:43)(cid:2)(cid:1)(cid:34)(cid:34)(cid:19)(cid:18)(cid:18)(cid:2)(cid:44,,5203.0
,,5,,,Unknown,,cid:43)(cid:2)(cid:1)(cid:34)(cid:34)(cid:19)(cid:18)(cid:18)(cid:2)(cid:44,,5208.0
,,10,,,Unknown,,cid:43)(cid:2)(cid:1)(cid:34)(cid:34)(cid:19)(cid:18)(cid:18)(cid:2)(cid:44,,5218.0
,,10,,,Unknown,,cid:43)(cid:2)(cid:1)(cid:34)(cid:34)(cid:19)(cid:18)(cid:18)(cid:2)(cid:44,,5228.0
,,5,,,Unknown,,cid:43)(cid:2)(cid:1)(cid:34)(cid:34)(cid:19)(cid:18)(cid:18)(cid:2)(cid:44,,5233.0
,,43,,,Unknown,,cid:43)(cid:2)(cid:1)(cid:34)(cid:34)(cid:19)(cid:18)(cid:18)(cid:2)(cid:44,,5276.0
,,2,,,Unknown,,cid:43)(cid:2)(cid:1)(cid:34)(cid:34)(cid:19)(cid:18)(cid:18)(cid:2)(cid:44,,5278.0
,,37,,,Unknown,,cid:43)(cid:2)(cid:1)(cid:34)(cid:34)(cid:19)(cid:18)(cid:18)(cid:2)(cid:44,,5315.0
,,16,,,Unknown,,cid:43)(cid:2)(cid:1)(cid:34)(cid:34)(cid:19)(cid:18)(cid:18)(cid:2)(cid:44,,5331.0
,,32,,,Unknown,,cid:43)(cid:2)(cid:1)(cid:34)(cid:34)(cid:19)(cid:18)(cid:18)(cid:2)(cid:44,,5363.0
,,19,,,Unknown,,cid:43)(cid:2)(cid:1)(cid:34)(cid:34)(cid:19)(cid:18)(cid:18)(cid:2)(cid:44,,5382.0
,,18,,,Unknown,,cid:43)(cid:2)(cid:1)(cid:34)(cid:34)(cid:19)(cid:18)(cid:18)(cid:2)(cid:44,,5400.0
,,18,,,Unknown,,cid:43)(cid:2)(cid:1)(cid:34)(cid:34)(cid:19)(cid:18)(cid:18)(cid:2)(cid:44,,5418.0
,,2,,,Unknown,,cid:43)(cid:2)(cid:1)(cid:34)(cid:34)(cid:19)(cid:18)(cid:18)(cid:2)(cid:44,,5420.0
,,44,,,Unknown,,cid:43)(cid:2)(cid:1)(cid:34)(cid:34)(cid:19)(cid:18)(cid:18)(cid:2)(cid:44,,5464.0
,,49,,,Unknown,,cid:43)(cid:2)(cid:1)(cid:34)(cid:34)(cid:19)(cid:18)(cid:18)(cid:2)(cid:44,,5513.0
,,42,,,Unknown,,cid:43)(cid:2)(cid:1)(cid:34)(cid:34)(cid:19)(cid:18)(cid:18)(cid:2)(cid:44,,5555.0
,,56,,,Unknown,,cid:43)(cid:2)(cid:1)(cid:34)(cid:34)(cid:19)(cid:18)(cid:18)(cid:2)(cid:44,,5611.0
,,57,,,Unknown,,cid:43)(cid:2)(cid:1)(cid:34)(cid:34)(cid:19)(cid:18)(cid:18)(cid:2)(cid:44,,5668.0
,,41,,,Unknown,,cid:43)(cid:2)(cid:1)(cid:34)(cid:34)(cid:19)(cid:18)(cid:18)(cid:2)(cid:44,,5709.0
,,2,,,Unknown,,cid:43)(cid:2)(cid:1)(cid:34)(cid:34)(cid:19)(cid:18)(cid:18)(cid:2)(cid:44,,5711.0
,,48,,,Unknown,,cid:43)(cid:2)(cid:1)(cid:34)(cid:34)(cid:19)(cid:18)(cid:18)(cid:2)(cid:44,,5759.0
,,25,,,Unknown,,cid:43)(cid:2)(cid:1)(cid:34)(cid:34)(cid:19)(cid:18)(cid:18)(cid:2)(cid:44,,5784.0
,,2,,,Unknown,,cid:43)(cid:2)(cid:1)(cid:34)(cid:34)(cid:19)(cid:18)(cid:18)(cid:2)(cid:44,,5786.0
,,31,,,Unknown,,cid:43)(cid:2)(cid:1)(cid:34)(cid:34)(cid:19)(cid:18)(cid:18)(cid:2)(cid:44,,5817.0
,,58,,,Unknown,,cid:43)(cid:2)(cid:1)(cid:34)(cid:34)(cid:19)(cid:18)(cid:18)(cid:2)(cid:44,,5875.0
,,59,,,Unknown,,cid:43)(cid:2)(cid:1)(cid:34)(cid:34)(cid:19)(cid:18)(cid:18)(cid:2)(cid:44,,5934.0
,,60,,,Unknown,,cid:43)(cid:2)(cid:1)(cid:34)(cid:34)(cid:19)(cid:18)(cid:18)(cid:2)(cid:44,,5994.0
,,21,,,Unknown,,cid:43)(cid:2)(cid:1)(cid:34)(cid:34)(cid:19)(cid:18)(cid:18)(cid:2)(cid:44,,6015.0
,,25,,,Unknown,,cid:43)(cid:2)(cid:1)(cid:34)(cid:34)(cid:19)(cid:18)(cid:18)(cid:2)(cid:44,,6040.0
,,17,,,Unknown,,cid:43)(cid:2)(cid:1)(cid:34)(cid:34)(cid:19)(cid:18)(cid:18)(cid:2)(cid:44,,6057.0
,,18,,,Unknown,,cid:43)(cid:2)(cid:1)(cid:34)(cid:34)(cid:19)(cid:18)(cid:18)(cid:2)(cid:44,,6075.0
,,45,,,Unknown,,cid:43)(cid:2)(cid:1)(cid:34)(cid:34)(cid:19)(cid:18)(cid:18)(cid:2)(cid:44,,6120.0
,,18,,,Unknown,,cid:43)(cid:2)(cid:1)(cid:34)(cid:34)(cid:19)(cid:18)(cid:18)(cid:2)(cid:44,,6138.0
,,35,,,Unknown,,cid:43)(cid:2)(cid:1)(cid:34)(cid:34)(cid:19)(cid:18)(cid:18)(cid:2)(cid:44,,6173.0
,,28,,,Unknown,,cid:43)(cid:2)(cid:1)(cid:34)(cid:34)(cid:19)(cid:18)(cid:18)(cid:2)(cid:44,,6201.0
,,11,,,Unknown,,cid:43)(cid:2)(cid:1)(cid:34)(cid:34)(cid:19)(cid:18)(cid:18)(cid:2)(cid:44,,6212.0
,,4,,,Unknown,,cid:43)(cid:2)(cid:1)(cid:34)(cid:34)(cid:19)(cid:18)(cid:18)(cid:2)(cid:44,,6216.0
,,12,,,Unknown,,cid:43)(cid:2)(cid:1)(cid:34)(cid:34)(cid:19)(cid:18)(cid:18)(cid:2)(cid:44,,6228.0
,,13,,,Unknown,,cid:43)(cid:2)(cid:1)(cid:34)(cid:34)(cid:19)(cid:18)(cid:18)(cid:2)(cid:44,,6241.0
,,5,,,Unknown,,cid:43)(cid:2)(cid:1)(cid:34)(cid:34)(cid:19)(cid:18)(cid:18)(cid:2)(cid:44,,6246.0
,,3,,,Unknown,,cid:43)(cid:2)(cid:1)(cid:34)(cid:34)(cid:19)(cid:18)(cid:18)(cid:2)(cid:44,,6249.0
,,43,,,Unknown,,cid:43)(cid:2)(cid:1)(cid:34)(cid:34)(cid:19)(cid:18)(cid:18)(cid:2)(cid:44,,6292.0
,,2,,,Unknown,,cid:43)(cid:2)(cid:1)(cid:34)(cid:34)(cid:19)(cid:18)(cid:18)(cid:2)(cid:44,,6294.0
,,1,,,Unknown,,cid:43)(cid:2)(cid:1)(cid:34)(cid:34)(cid:19)(cid:18)(cid:18)(cid:2)(cid:44,,6295.0
,,16,,,Unknown,,cid:43)(cid:2)(cid:1)(cid:34)(cid:34)(cid:19)(cid:18)(cid:18)(cid:2)(cid:44,,6311.0
,,34,,,Unknown,,cid:43)(cid:2)(cid:1)(cid:34)(cid:34)(cid:19)(cid:18)(cid:18)(cid:2)(cid:44,,6345.0
,,19,,,Unknown,,cid:43)(cid:2)(cid:1)(cid:34)(cid:34)(cid:19)(cid:18)(cid:18)(cid:2)(cid:44,,6364.0
,,18,,,Unknown,,cid:43)(cid:2)(cid:1)(cid:34)(cid:34)(cid:19)(cid:18)(cid:18)(cid:2)(cid:44,,6382.0
,,18,,,Unknown,,cid:43)(cid:2)(cid:1)(cid:34)(cid:34)(cid:19)(cid:18)(cid:18)(cid:2)(cid:44,,6400.0
,,2,,,Unknown,,cid:43)(cid:2)(cid:1)(cid:34)(cid:34)(cid:19)(cid:18)(cid:18)(cid:2)(cid:44,,6402.0
,,44,,,Unknown,,cid:43)(cid:2)(cid:1)(cid:34)(cid:34)(cid:19)(cid:18)(cid:18)(cid:2)(cid:44,,6446.0
,,49,,,Unknown,,cid:43)(cid:2)(cid:1)(cid:34)(cid:34)(cid:19)(cid:18)(cid:18)(cid:2)(cid:44,,6495.0
,,42,,,Unknown,,cid:43)(cid:2)(cid:1)(cid:34)(cid:34)(cid:19)(cid:18)(cid:18)(cid:2)(cid:44,,6537.0
,,56,,,Unknown,,cid:43)(cid:2)(cid:1)(cid:34)(cid:34)(cid:19)(cid:18)(cid:18)(cid:2)(cid:44,,6593.0
,,57,,,Unknown,,cid:43)(cid:2)(cid:1)(cid:34)(cid:34)(cid:19)(cid:18)(cid:18)(cid:2)(cid:44,,6650.0
,,41,,,Unknown,,cid:43)(cid:2)(cid:1)(cid:34)(cid:34)(cid:19)(cid:18)(cid:18)(cid:2)(cid:44,,6691.0
,,2,,,Unknown,,cid:43)(cid:2)(cid:1)(cid:34)(cid:34)(cid:19)(cid:18)(cid:18)(cid:2)(cid:44,,6693.0
,,48,,,Unknown,,cid:43)(cid:2)(cid:1)(cid:34)(cid:34)(cid:19)(cid:18)(cid:18)(cid:2)(cid:44,,6741.0
,,25,,,Unknown,,cid:43)(cid:2)(cid:1)(cid:34)(cid:34)(cid:19)(cid:18)(cid:18)(cid:2)(cid:44,,6766.0
,,2,,,Unknown,,cid:43)(cid:2)(cid:1)(cid:34)(cid:34)(cid:19)(cid:18)(cid:18)(cid:2)(cid:44,,6768.0
,,31,,,Unknown,,cid:43)(cid:2)(cid:1)(cid:34)(cid:34)(cid:19)(cid:18)(cid:18)(cid:2)(cid:44,,6799.0
,,58,,,Unknown,,cid:43)(cid:2)(cid:1)(cid:34)(cid:34)(cid:19)(cid:18)(cid:18)(cid:2)(cid:44,,6857.0
,,59,,,Unknown,,cid:43)(cid:2)(cid:1)(cid:34)(cid:34)(cid:19)(cid:18)(cid:18)(cid:2)(cid:44,,6916.0
,,60,,,Unknown,,cid:43)(cid:2)(cid:1)(cid:34)(cid:34)(cid:19)(cid:18)(cid:18)(cid:2)(cid:44,,6976.0
,,21,,,Unknown,,cid:43)(cid:2)(cid:1)(cid:34)(cid:34)(cid:19)(cid:18)(cid:18)(cid:2)(cid:44,,6997.0
,,25,,,Unknown,,cid:43)(cid:2)(cid:1)(cid:34)(cid:34)(cid:19)(cid:18)(cid:18)(cid:2)(cid:44,,7022.0
,,17,,,Unknown,,cid:43)(cid:2)(cid:1)(cid:34)(cid:34)(cid:19)(cid:18)(cid:18)(cid:2)(cid:44,,7039.0
,,18,,,Unknown,,cid:43)(cid:2)(cid:1)(cid:34)(cid:34)(cid:19)(cid:18)(cid:18)(cid:2)(cid:44,,7057.0
,,45,,,Unknown,,cid:43)(cid:2)(cid:1)(cid:34)(cid:34)(cid:19)(cid:18)(cid:18)(cid:2)(cid:44,,7102.0
,,18,,,Unknown,,cid:43)(cid:2)(cid:1)(cid:34)(cid:34)(cid:19)(cid:18)(cid:18)(cid:2)(cid:44,,7120.0
,,35,,,Unknown,,cid:43)(cid:2)(cid:1)(cid:34)(cid:34)(cid:19)(cid:18)(cid:18)(cid:2)(cid:44,,7155.0
,,38,,,Unknown,,cid:43)(cid:2)(cid:1)(cid:34)(cid:34)(cid:19)(cid:18)(cid:18)(cid:2)(cid:44,,7193.0
,,20,,,Unknown,,cid:43)(cid:2)(cid:1)(cid:34)(cid:34)(cid:19)(cid:18)(cid:18)(cid:2)(cid:44,,7213.0
,,30,,,Unknown,,cid:43)(cid:2)(cid:1)(cid:34)(cid:34)(cid:19)(cid:18)(cid:18)(cid:2)(cid:44,,7243.0
,,41,,,Unknown,,cid:43)(cid:2)(cid:1)(cid:34)(cid:34)(cid:19)(cid:18)(cid:18)(cid:2)(cid:44,,7284.0
,,20,,,Unknown,,cid:43)(cid:2)(cid:1)(cid:34)(cid:34)(cid:19)(cid:18)(cid:18)(cid:2)(cid:44,,7304.0
,,15,,,Unknown,,cid:43)(cid:2)(cid:1)(cid:34)(cid:34)(cid:19)(cid:18)(cid:18)(cid:2)(cid:44,,7319.0
,,2,,,Unknown,,cid:43)(cid:2)(cid:1)(cid:34)(cid:34)(cid:19)(cid:18)(cid:18)(cid:2)(cid:44,,7321.0
,,1,,,Unknown,,cid:43)(cid:2)(cid:1)(cid:34)(cid:34)(cid:19)(cid:18)(cid:18)(cid:2)(cid:44,,7322.0
,,19,,,Unknown,,cid:43)(cid:2)(cid:1)(cid:34)(cid:34)(cid:19)(cid:18)(cid:18)(cid:2)(cid:44,,7341.0
,,36,,,Unknown,,cid:43)(cid:2)(cid:1)(cid:34)(cid:34)(cid:19)(cid:18)(cid:18)(cid:2)(cid:44,,7377.0
,,18,,,Unknown,,cid:43)(cid:2)(cid:1)(cid:34)(cid:34)(cid:19)(cid:18)(cid:18)(cid:2)(cid:44,,7395.0
,,2,,,Unknown,,cid:43)(cid:2)(cid:1)(cid:34)(cid:34)(cid:19)(cid:18)(cid:18)(cid:2)(cid:44,,7397.0
,,44,,,Unknown,,cid:43)(cid:2)(cid:1)(cid:34)(cid:34)(cid:19)(cid:18)(cid:18)(cid:2)(cid:44,,7441.0
,,46,,,Unknown,,cid:43)(cid:2)(cid:1)(cid:34)(cid:34)(cid:19)(cid:18)(cid:18)(cid:2)(cid:44,,7487.0
,,47,,,Unknown,,cid:43)(cid:2)(cid:1)(cid:34)(cid:34)(cid:19)(cid:18)(cid:18)(cid:2)(cid:44,,7534.0
,,20,,,Unknown,,cid:43)(cid:2)(cid:1)(cid:34)(cid:34)(cid:19)(cid:18)(cid:18)(cid:2)(cid:44,,7554.0
,,30,,,Unknown,,cid:43)(cid:2)(cid:1)(cid:34)(cid:34)(cid:19)(cid:18)(cid:18)(cid:2)(cid:44,,7584.0
,,30,,,Unknown,,cid:43)(cid:2)(cid:1)(cid:34)(cid:34)(cid:19)(cid:18)(cid:18)(cid:2)(cid:44,,7614.0
,,25,,,Unknown,,cid:43)(cid:2)(cid:1)(cid:34)(cid:34)(cid:19)(cid:18)(cid:18)(cid:2)(cid:44,,7639.0
,,23,,,Unknown,,cid:43)(cid:2)(cid:1)(cid:34)(cid:34)(cid:19)(cid:18)(cid:18)(cid:2)(cid:44,,7662.0
,,25,,,Unknown,,cid:43)(cid:2)(cid:1)(cid:34)(cid:34)(cid:19)(cid:18)(cid:18)(cid:2)(cid:44,,7687.0
,,30,,,Unknown,,cid:43)(cid:2)(cid:1)(cid:34)(cid:34)(cid:19)(cid:18)(cid:18)(cid:2)(cid:44,,7717.0
,,41,,,Unknown,,cid:43)(cid:2)(cid:1)(cid:34)(cid:34)(cid:19)(cid:18)(cid:18)(cid:2)(cid:44,,7758.0
,,2,,,Unknown,,cid:43)(cid:2)(cid:1)(cid:34)(cid:34)(cid:19)(cid:18)(cid:18)(cid:2)(cid:44,,7760.0
,,45,,,Unknown,,cid:43)(cid:2)(cid:1)(cid:34)(cid:34)(cid:19)(cid:18)(cid:18)(cid:2)(cid:44,,7805.0
,,2,,,Unknown,,cid:43)(cid:2)(cid:1)(cid:34)(cid:34)(cid:19)(cid:18)(cid:18)(cid:2)(cid:44,,7807.0
,,28,,,Unknown,,cid:43)(cid:2)(cid:1)(cid:34)(cid:34)(cid:19)(cid:18)(cid:18)(cid:2)(cid:44,,7835.0
,,26,,,Unknown,,cid:43)(cid:2)(cid:1)(cid:34)(cid:34)(cid:19)(cid:18)(cid:18)(cid:2)(cid:44,,7861.0
,,29,,,Unknown,,cid:43)(cid:2)(cid:1)(cid:34)(cid:34)(cid:19)(cid:18)(cid:18)(cid:2)(cid:44,,7890.0
,,24,,,Unknown,,cid:43)(cid:2)(cid:1)(cid:34)(cid:34)(cid:19)(cid:18)(cid:18)(cid:2)(cid:44,,7914.0
,,27,,,Unknown,,cid:43)(cid:2)(cid:1)(cid:34)(cid:34)(cid:19)(cid:18)(cid:18)(cid:2)(cid:44,,7941.0
,,2,,,Unknown,,cid:43)(cid:2)(cid:1)(cid:34)(cid:34)(cid:19)(cid:18)(cid:18)(cid:2)(cid:44,,7943.0
,,29,,,Unknown,,cid:43)(cid:2)(cid:1)(cid:34)(cid:34)(cid:19)(cid:18)(cid:18)(cid:2)(cid:44,,7972.0
,,48,,,Unknown,,cid:43)(cid:2)(cid:1)(cid:34)(cid:34)(cid:19)(cid:18)(cid:18)(cid:2)(cid:44,,8020.0
,,48,,,Unknown,,cid:43)(cid:2)(cid:1)(cid:34)(cid:34)(cid:19)(cid:18)(cid:18)(cid:2)(cid:44,,8068.0
,,24,,,Unknown,,cid:43)(cid:2)(cid:1)(cid:34)(cid:34)(cid:19)(cid:18)(cid:18)(cid:2)(cid:44,,8092.0
,,41,,,Unknown,,cid:43)(cid:2)(cid:1)(cid:34)(cid:34)(cid:19)(cid:18)(cid:18)(cid:2)(cid:44,,8133.0
,,24,,,Unknown,,cid:43)(cid:2)(cid:1)(cid:34)(cid:34)(cid:19)(cid:18)(cid:18)(cid:2)(cid:44,,8157.0
,,20,,,Unknown,,cid:43)(cid:2)(cid:1)(cid:34)(cid:34)(cid:19)(cid:18)(cid:18)(cid:2)(cid:44,,8177.0
,,30,,,Unknown,,cid:43)(cid:2)(cid:1)(cid:34)(cid:34)(cid:19)(cid:18)(cid:18)(cid:2)(cid:44,,8207.0
,,30,,,Unknown,,cid:43)(cid:2)(cid:1)(cid:34)(cid:34)(cid:19)(cid:18)(cid:18)(cid:2)(cid:44,,8237.0
,,25,,,Unknown,,cid:43)(cid:2)(cid:1)(cid:34)(cid:34)(cid:19)(cid:18)(cid:18)(cid:2)(cid:44,,8262.0
,,22,,,Unknown,,cid:43)(cid:2)(cid:1)(cid:34)(cid:34)(cid:19)(cid:18)(cid:18)(cid:2)(cid:44,,8284.0
,,27,,,Unknown,,cid:43)(cid:2)(cid:1)(cid:34)(cid:34)(cid:19)(cid:18)(cid:18)(cid:2)(cid:44,,8311.0
,,17,,,Unknown,,cid:43)(cid:2)(cid:1)(cid:34)(cid:34)(cid:19)(cid:18)(cid:18)(cid:2)(cid:44,,8328.0
,,18,,,Unknown,,cid:43)(cid:2)(cid:1)(cid:34)(cid:34)(cid:19)(cid:18)(cid:18)(cid:2)(cid:44,,8346.0
,,45,,,Unknown,,cid:43)(cid:2)(cid:1)(cid:34)(cid:34)(cid:19)(cid:18)(cid:18)(cid:2)(cid:44,,8391.0
,,18,,,Unknown,,cid:43)(cid:2)(cid:1)(cid:34)(cid:34)(cid:19)(cid:18)(cid:18)(cid:2)(cid:44,,8409.0
,,35,,,Unknown,,cid:43)(cid:2)(cid:1)(cid:34)(cid:34)(cid:19)(cid:18)(cid:18)(cid:2)(cid:44,,8444.0
,,38,,,Unknown,,cid:43)(cid:2)(cid:1)(cid:34)(cid:34)(cid:19)(cid:18)(cid:18)(cid:2)(cid:44,,8482.0
,,20,,,Unknown,,cid:43)(cid:2)(cid:1)(cid:34)(cid:34)(cid:19)(cid:18)(cid:18)(cid:2)(cid:44,,8502.0
,,30,,,Unknown,,cid:43)(cid:2)(cid:1)(cid:34)(cid:34)(cid:19)(cid:18)(cid:18)(cid:2)(cid:44,,8532.0
,,41,,,Unknown,,cid:43)(cid:2)(cid:1)(cid:34)(cid:34)(cid:19)(cid:18)(cid:18)(cid:2)(cid:44,,8573.0
,,20,,,Unknown,,cid:43)(cid:2)(cid:1)(cid:34)(cid:34)(cid:19)(cid:18)(cid:18)(cid:2)(cid:44,,8593.0
,,15,,,Unknown,,cid:43)(cid:2)(cid:1)(cid:34)(cid:34)(cid:19)(cid:18)(cid:18)(cid:2)(cid:44,,8608.0
,,2,,,Unknown,,cid:43)(cid:2)(cid:1)(cid:34)(cid:34)(cid:19)(cid:18)(cid:18)(cid:2)(cid:44,,8610.0
,,1,,,Unknown,,cid:43)(cid:2)(cid:1)(cid:34)(cid:34)(cid:19)(cid:18)(cid:18)(cid:2)(cid:44,,8611.0
,,19,,,Unknown,,cid:43)(cid:2)(cid:1)(cid:34)(cid:34)(cid:19)(cid:18)(cid:18)(cid:2)(cid:44,,8630.0
,,36,,,Unknown,,cid:43)(cid:2)(cid:1)(cid:34)(cid:34)(cid:19)(cid:18)(cid:18)(cid:2)(cid:44,,8666.0
,,18,,,Unknown,,cid:43)(cid:2)(cid:1)(cid:34)(cid:34)(cid:19)(cid:18)(cid:18)(cid:2)(cid:44,,8684.0
,,2,,,Unknown,,cid:43)(cid:2)(cid:1)(cid:34)(cid:34)(cid:19)(cid:18)(cid:18)(cid:2)(cid:44,,8686.0
,,44,,,Unknown,,cid:43)(cid:2)(cid:1)(cid:34)(cid:34)(cid:19)(cid:18)(cid:18)(cid:2)(cid:44,,8730.0
,,46,,,Unknown,,cid:43)(cid:2)(cid:1)(cid:34)(cid:34)(cid:19)(cid:18)(cid:18)(cid:2)(cid:44,,8776.0
,,47,,,Unknown,,cid:43)(cid:2)(cid:1)(cid:34)(cid:34)(cid:19)(cid:18)(cid:18)(cid:2)(cid:44,,8823.0
,,20,,,Unknown,,cid:43)(cid:2)(cid:1)(cid:34)(cid:34)(cid:19)(cid:18)(cid:18)(cid:2)(cid:44,,8843.0
,,30,,,Unknown,,cid:43)(cid:2)(cid:1)(cid:34)(cid:34)(cid:19)(cid:18)(cid:18)(cid:2)(cid:44,,8873.0
,,30,,,Unknown,,cid:43)(cid:2)(cid:1)(cid:34)(cid:34)(cid:19)(cid:18)(cid:18)(cid:2)(cid:44,,8903.0
,,25,,,Unknown,,cid:43)(cid:2)(cid:1)(cid:34)(cid:34)(cid:19)(cid:18)(cid:18)(cid:2)(cid:44,,8928.0
,,23,,,Unknown,,cid:43)(cid:2)(cid:1)(cid:34)(cid:34)(cid:19)(cid:18)(cid:18)(cid:2)(cid:44,,8951.0
,,25,,,Unknown,,cid:43)(cid:2)(cid:1)(cid:34)(cid:34)(cid:19)(cid:18)(cid:18)(cid:2)(cid:44,,8976.0
,,30,,,Unknown,,cid:43)(cid:2)(cid:1)(cid:34)(cid:34)(cid:19)(cid:18)(cid:18)(cid:2)(cid:44,,9006.0
,,41,,,Unknown,,cid:43)(cid:2)(cid:1)(cid:34)(cid:34)(cid:19)(cid:18)(cid:18)(cid:2)(cid:44,,9047.0
,,2,,,Unknown,,cid:43)(cid:2)(cid:1)(cid:34)(cid:34)(cid:19)(cid:18)(cid:18)(cid:2)(cid:44,,9049.0
,,45,,,Unknown,,cid:43)(cid:2)(cid:1)(cid:34)(cid:34)(cid:19)(cid:18)(cid:18)(cid:2)(cid:44,,9094.0
,,2,,,Unknown,,cid:43)(cid:2)(cid:1)(cid:34)(cid:34)(cid:19)(cid:18)(cid:18)(cid:2)(cid:44,,9096.0
,,28,,,Unknown,,cid:43)(cid:2)(cid:1)(cid:34)(cid:34)(cid:19)(cid:18)(cid:18)(cid:2)(cid:44,,9124.0
,,26,,,Unknown,,cid:43)(cid:2)(cid:1)(cid:34)(cid:34)(cid:19)(cid:18)(cid:18)(cid:2)(cid:44,,9150.0
,,29,,,Unknown,,cid:43)(cid:2)(cid:1)(cid:34)(cid:34)(cid:19)(cid:18)(cid:18)(cid:2)(cid:44,,9179.0
,,24,,,Unknown,,cid:43)(cid:2)(cid:1)(cid:34)(cid:34)(cid:19)(cid:18)(cid:18)(cid:2)(cid:44,,9203.0
,,27,,,Unknown,,cid:43)(cid:2)(cid:1)(cid:34)(cid:34)(cid:19)(cid:18)(cid:18)(cid:2)(cid:44,,9230.0
,,2,,,Unknown,,cid:43)(cid:2)(cid:1)(cid:34)(cid:34)(cid:19)(cid:18)(cid:18)(cid:2)(cid:44,,9232.0
,,29,,,Unknown,,cid:43)(cid:2)(cid:1)(cid:34)(cid:34)(cid:19)(cid:18)(cid:18)(cid:2)(cid:44,,9261.0
,,48,,,Unknown,,cid:43)(cid:2)(cid:1)(cid:34)(cid:34)(cid:19)(cid:18)(cid:18)(cid:2)(cid:44,,9309.0
,,48,,,Unknown,,cid:43)(cid:2)(cid:1)(cid:34)(cid:34)(cid:19)(cid:18)(cid:18)(cid:2)(cid:44,,9357.0
,,24,,,Unknown,,cid:43)(cid:2)(cid:1)(cid:34)(cid:34)(cid:19)(cid:18)(cid:18)(cid:2)(cid:44,,9381.0
,,41,,,Unknown,,cid:43)(cid:2)(cid:1)(cid:34)(cid:34)(cid:19)(cid:18)(cid:18)(cid:2)(cid:44,,9422.0
,,24,,,Unknown,,cid:43)(cid:2)(cid:1)(cid:34)(cid:34)(cid:19)(cid:18)(cid:18)(cid:2)(cid:44,,9446.0
,,20,,,Unknown,,cid:43)(cid:2)(cid:1)(cid:34)(cid:34)(cid:19)(cid:18)(cid:18)(cid:2)(cid:44,,9466.0
,,30,,,Unknown,,cid:43)(cid:2)(cid:1)(cid:34)(cid:34)(cid:19)(cid:18)(cid:18)(cid:2)(cid:44,,9496.0
,,30,,,Unknown,,cid:43)(cid:2)(cid:1)(cid:34)(cid:34)(cid:19)(cid:18)(cid:18)(cid:2)(cid:44,,9526.0
,,25,,,Unknown,,cid:43)(cid:2)(cid:1)(cid:34)(cid:34)(cid:19)(cid:18)(cid:18)(cid:2)(cid:44,,9551.0
,,22,,,Unknown,,cid:43)(cid:2)(cid:1)(cid:34)(cid:34)(cid:19)(cid:18)(cid:18)(cid:2)(cid:44,,9573.0
,,27,,,Unknown,,cid:43)(cid:2)(cid:1)(cid:34)(cid:34)(cid:19)(cid:18)(cid:18)(cid:2)(cid:44,,9600.0
,,17,,,Unknown,,cid:43)(cid:2)(cid:1)(cid:34)(cid:34)(cid:19)(cid:18)(cid:18)(cid:2)(cid:44,,9617.0
,,18,,,Unknown,,cid:43)(cid:2)(cid:1)(cid:34)(cid:34)(cid:19)(cid:18)(cid:18)(cid:2)(cid:44,,9635.0
,,45,,,Unknown,,cid:43)(cid:2)(cid:1)(cid:34)(cid:34)(cid:19)(cid:18)(cid:18)(cid:2)(cid:44,,9680.0
,,18,,,Unknown,,cid:43)(cid:2)(cid:1)(cid:34)(cid:34)(cid:19)(cid:18)(cid:18)(cid:2)(cid:44,,9698.0
,,35,,,Unknown,,cid:43)(cid:2)(cid:1)(cid:34)(cid:34)(cid:19)(cid:18)(cid:18)(cid:2)(cid:44,,9733.0
,,38,,,Unknown,,cid:43)(cid:2)(cid:1)(cid:34)(cid:34)(cid:19)(cid:18)(cid:18)(cid:2)(cid:44,,9771.0
,,20,,,Unknown,,cid:43)(cid:2)(cid:1)(cid:34)(cid:34)(cid:19)(cid:18)(cid:18)(cid:2)(cid:44,,9791.0
,,30,,,Unknown,,cid:43)(cid:2)(cid:1)(cid:34)(cid:34)(cid:19)(cid:18)(cid:18)(cid:2)(cid:44,,9821.0
,,41,,,Unknown,,cid:43)(cid:2)(cid:1)(cid:34)(cid:34)(cid:19)(cid:18)(cid:18)(cid:2)(cid:44,,9862.0
,,20,,,Unknown,,cid:43)(cid:2)(cid:1)(cid:34)(cid:34)(cid:19)(cid:18)(cid:18)(cid:2)(cid:44,,9882.0
,,15,,,Unknown,,cid:43)(cid:2)(cid:1)(cid:34)(cid:34)(cid:19)(cid:18)(cid:18)(cid:2)(cid:44,,9897.0
,,2,,,Unknown,,cid:43)(cid:2)(cid:1)(cid:34)(cid:34)(cid:19)(cid:18)(cid:18)(cid:2)(cid:44,,9899.0
,,1,,,Unknown,,cid:43)(cid:2)(cid:1)(cid:34)(cid:34)(cid:19)(cid:18)(cid:18)(cid:2)(cid:44,,9900.0
,,19,,,Unknown,,cid:43)(cid:2)(cid:1)(cid:34)(cid:34)(cid:19)(cid:18)(cid:18)(cid:2)(cid:44,,9919.0
,,36,,,Unknown,,cid:43)(cid:2)(cid:1)(cid:34)(cid:34)(cid:19)(cid:18)(cid:18)(cid:2)(cid:44,,9955.0
,,18,,,Unknown,,cid:43)(cid:2)(cid:1)(cid:34)(cid:34)(cid:19)(cid:18)(cid:18)(cid:2)(cid:44,,9973.0
,,2,,,Unknown,,cid:43)(cid:2)(cid:1)(cid:34)(cid:34)(cid:19)(cid:18)(cid:18)(cid:2)(cid:44,,9975.0
,,44,,,Unknown,,cid:43)(cid:2)(cid:1)(cid:34)(cid:34)(cid:19)(cid:18)(cid:18)(cid:2)(cid:44,,10019.0
,,46,,,Unknown,,cid:43)(cid:2)(cid:1)(cid:34)(cid:34)(cid:19)(cid:18)(cid:18)(cid:2)(cid:44,,10065.0
,,47,,,Unknown,,cid:43)(cid:2)(cid:1)(cid:34)(cid:34)(cid:19)(cid:18)(cid:18)(cid:2)(cid:44,,10112.0
,,20,,,Unknown,,cid:43)(cid:2)(cid:1)(cid:34)(cid:34)(cid:19)(cid:18)(cid:18)(cid:2)(cid:44,,10132.0
,,30,,,Unknown,,cid:43)(cid:2)(cid:1)(cid:34)(cid:34)(cid:19)(cid:18)(cid:18)(cid:2)(cid:44,,10162.0
,,30,,,Unknown,,cid:43)(cid:2)(cid:1)(cid:34)(cid:34)(cid:19)(cid:18)(cid:18)(cid:2)(cid:44,,10192.0
,,25,,,Unknown,,cid:43)(cid:2)(cid:1)(cid:34)(cid:34)(cid:19)(cid:18)(cid:18)(cid:2)(cid:44,,10217.0
,,23,,,Unknown,,cid:43)(cid:2)(cid:1)(cid:34)(cid:34)(cid:19)(cid:18)(cid:18)(cid:2)(cid:44,,10240.0
,,25,,,Unknown,,cid:43)(cid:2)(cid:1)(cid:34)(cid:34)(cid:19)(cid:18)(cid:18)(cid:2)(cid:44,,10265.0
,,30,,,Unknown,,cid:43)(cid:2)(cid:1)(cid:34)(cid:34)(cid:19)(cid:18)(cid:18)(cid:2)(cid:44,,10295.0
,,41,,,Unknown,,cid:43)(cid:2)(cid:1)(cid:34)(cid:34)(cid:19)(cid:18)(cid:18)(cid:2)(cid:44,,10336.0
,,2,,,Unknown,,cid:43)(cid:2)(cid:1)(cid:34)(cid:34)(cid:19)(cid:18)(cid:18)(cid:2)(cid:44,,10338.0
,,45,,,Unknown,,cid:43)(cid:2)(cid:1)(cid:34)(cid:34)(cid:19)(cid:18)(cid:18)(cid:2)(cid:44,,10383.0
,,2,,,Unknown,,cid:43)(cid:2)(cid:1)(cid:34)(cid:34)(cid:19)(cid:18)(cid:18)(cid:2)(cid:44,,10385.0
,,28,,,Unknown,,cid:43)(cid:2)(cid:1)(cid:34)(cid:34)(cid:19)(cid:18)(cid:18)(cid:2)(cid:44,,10413.0
,,26,,,Unknown,,cid:43)(cid:2)(cid:1)(cid:34)(cid:34)(cid:19)(cid:18)(cid:18)(cid:2)(cid:44,,10439.0
,,29,,,Unknown,,cid:43)(cid:2)(cid:1)(cid:34)(cid:34)(cid:19)(cid:18)(cid:18)(cid:2)(cid:44,,10468.0
,,24,,,Unknown,,cid:43)(cid:2)(cid:1)(cid:34)(cid:34)(cid:19)(cid:18)(cid:18)(cid:2)(cid:44,,10492.0
,,27,,,Unknown,,cid:43)(cid:2)(cid:1)(cid:34)(cid:34)(cid:19)(cid:18)(cid:18)(cid:2)(cid:44,,10519.0
,,2,,,Unknown,,cid:43)(cid:2)(cid:1)(cid:34)(cid:34)(cid:19)(cid:18)(cid:18)(cid:2)(cid:44,,10521.0
,,29,,,Unknown,,cid:43)(cid:2)(cid:1)(cid:34)(cid:34)(cid:19)(cid:18)(cid:18)(cid:2)(cid:44,,10550.0
,,48,,,Unknown,,cid:43)(cid:2)(cid:1)(cid:34)(cid:34)(cid:19)(cid:18)(cid:18)(cid:2)(cid:44,,10598.0
,,48,,,Unknown,,cid:43)(cid:2)(cid:1)(cid:34)(cid:34)(cid:19)(cid:18)(cid:18)(cid:2)(cid:44,,10646.0
,,24,,,Unknown,,cid:43)(cid:2)(cid:1)(cid:34)(cid:34)(cid:19)(cid:18)(cid:18)(cid:2)(cid:44,,10670.0
,,41,,,Unknown,,cid:43)(cid:2)(cid:1)(cid:34)(cid:34)(cid:19)(cid:18)(cid:18)(cid:2)(cid:44,,10711.0
,,24,,,Unknown,,cid:43)(cid:2)(cid:1)(cid:34)(cid:34)(cid:19)(cid:18)(cid:18)(cid:2)(cid:44,,10735.0
,,20,,,Unknown,,cid:43)(cid:2)(cid:1)(cid:34)(cid:34)(cid:19)(cid:18)(cid:18)(cid:2)(cid:44,,10755.0
,,30,,,Unknown,,cid:43)(cid:2)(cid:1)(cid:34)(cid:34)(cid:19)(cid:18)(cid:18)(cid:2)(cid:44,,10785.0
,,30,,,Unknown,,cid:43)(cid:2)(cid:1)(cid:34)(cid:34)(cid:19)(cid:18)(cid:18)(cid:2)(cid:44,,10815.0
,,25,,,Unknown,,cid:43)(cid:2)(cid:1)(cid:34)(cid:34)(cid:19)(cid:18)(cid:18)(cid:2)(cid:44,,10840.0
,,22,,,Unknown,,cid:43)(cid:2)(cid:1)(cid:34)(cid:34)(cid:19)(cid:18)(cid:18)(cid:2)(cid:44,,10862.0
,,27,,,Unknown,,cid:43)(cid:2)(cid:1)(cid:34)(cid:34)(cid:19)(cid:18)(cid:18)(cid:2)(cid:44,,10889.0
,,17,,,Unknown,,cid:43)(cid:2)(cid:1)(cid:34)(cid:34)(cid:19)(cid:18)(cid:18)(cid:2)(cid:44,,10906.0
,,17,,,Unknown,,cid:43)(cid:2)(cid:1)(cid:34)(cid:34)(cid:19)(cid:18)(cid:18)(cid:2)(cid:44,,10923.0
,,45,,,Unknown,,cid:43)(cid:2)(cid:1)(cid:34)(cid:34)(cid:19)(cid:18)(cid:18)(cid:2)(cid:44,,10968.0
,,18,,,Unknown,,cid:43)(cid:2)(cid:1)(cid:34)(cid:34)(cid:19)(cid:18)(cid:18)(cid:2)(cid:44,,10986.0
,,35,,,Unknown,,cid:43)(cid:2)(cid:1)(cid:34)(cid:34)(cid:19)(cid:18)(cid:18)(cid:2)(cid:44,,11021.0
,,9,,,Unknown,,cid:43)(cid:2)(cid:1)(cid:34)(cid:34)(cid:19)(cid:18)(cid:18)(cid:2)(cid:44,,11030.0
,,46,,,Unknown,,cid:43)(cid:2)(cid:1)(cid:34)(cid:34)(cid:19)(cid:18)(cid:18)(cid:2)(cid:44,,11076.0
,,8,,,Unknown,,cid:43)(cid:2)(cid:1)(cid:34)(cid:34)(cid:19)(cid:18)(cid:18)(cid:2)(cid:44,,11084.0
,,5,,,Unknown,,cid:43)(cid:2)(cid:1)(cid:34)(cid:34)(cid:19)(cid:18)(cid:18)(cid:2)(cid:44,,11089.0
,,28,,,Unknown,,cid:43)(cid:2)(cid:1)(cid:34)(cid:34)(cid:19)(cid:18)(cid:18)(cid:2)(cid:44,,11117.0
,,2,,,Unknown,,cid:43)(cid:2)(cid:1)(cid:34)(cid:34)(cid:19)(cid:18)(cid:18)(cid:2)(cid:44,,11119.0
,,9,,,Unknown,,cid:43)(cid:2)(cid:1)(cid:34)(cid:34)(cid:19)(cid:18)(cid:18)(cid:2)(cid:44,,11128.0
,,5,,,Unknown,,cid:43)(cid:2)(cid:1)(cid:34)(cid:34)(cid:19)(cid:18)(cid:18)(cid:2)(cid:44,,11133.0
,,8,,,Unknown,,cid:43)(cid:2)(cid:1)(cid:34)(cid:34)(cid:19)(cid:18)(cid:18)(cid:2)(cid:44,,11141.0
,,14,,,Unknown,,cid:43)(cid:2)(cid:1)(cid:34)(cid:34)(cid:19)(cid:18)(cid:18)(cid:2)(cid:44,,11155.0
,,7,,,Unknown,,cid:43)(cid:2)(cid:1)(cid:34)(cid:34)(cid:19)(cid:18)(cid:18)(cid:2)(cid:44,,11162.0
,,9,,,Unknown,,cid:43)(cid:2)(cid:1)(cid:34)(cid:34)(cid:19)(cid:18)(cid:18)(cid:2)(cid:44,,11171.0
,,2,,,Unknown,,cid:43)(cid:2)(cid:1)(cid:34)(cid:34)(cid:19)(cid:18)(cid:18)(cid:2)(cid:44,,11173.0
,,28,,,Unknown,,cid:43)(cid:2)(cid:1)(cid:34)(cid:34)(cid:19)(cid:18)(cid:18)(cid:2)(cid:44,,11201.0
,,3,,,Unknown,,cid:43)(cid:2)(cid:1)(cid:34)(cid:34)(cid:19)(cid:18)(cid:18)(cid:2)(cid:44,,11204.0
,,15,,,Unknown,,cid:43)(cid:2)(cid:1)(cid:34)(cid:34)(cid:19)(cid:18)(cid:18)(cid:2)(cid:44,,11219.0
,,2,,,Unknown,,cid:43)(cid:2)(cid:1)(cid:34)(cid:34)(cid:19)(cid:18)(cid:18)(cid:2)(cid:44,,11221.0
,,1,,,Unknown,,cid:43)(cid:2)(cid:1)(cid:34)(cid:34)(cid:19)(cid:18)(cid:18)(cid:2)(cid:44,,11222.0
,,1,,,Unknown,,cid:43)(cid:2)(cid:1)(cid:34)(cid:34)(cid:19)(cid:18)(cid:18)(cid:2)(cid:44,,11223.0
,,19,,,Unknown,,cid:43)(cid:2)(cid:1)(cid:34)(cid:34)(cid:19)(cid:18)(cid:18)(cid:2)(cid:44,,11242.0
,,34,,,Unknown,,cid:43)(cid:2)(cid:1)(cid:34)(cid:34)(cid:19)(cid:18)(cid:18)(cid:2)(cid:44,,11276.0
,,18,,,Unknown,,cid:43)(cid:2)(cid:1)(cid:34)(cid:34)(cid:19)(cid:18)(cid:18)(cid:2)(cid:44,,11294.0
,,2,,,Unknown,,cid:43)(cid:2)(cid:1)(cid:34)(cid:34)(cid:19)(cid:18)(cid:18)(cid:2)(cid:44,,11296.0
,,44,,,Unknown,,cid:43)(cid:2)(cid:1)(cid:34)(cid:34)(cid:19)(cid:18)(cid:18)(cid:2)(cid:44,,11340.0
,,12,,,Unknown,,cid:43)(cid:2)(cid:1)(cid:34)(cid:34)(cid:19)(cid:18)(cid:18)(cid:2)(cid:44,,11352.0
,,29,,,Unknown,,cid:43)(cid:2)(cid:1)(cid:34)(cid:34)(cid:19)(cid:18)(cid:18)(cid:2)(cid:44,,11381.0
,,26,,,Unknown,,cid:43)(cid:2)(cid:1)(cid:34)(cid:34)(cid:19)(cid:18)(cid:18)(cid:2)(cid:44,,11407.0
,,41,,,Unknown,,cid:43)(cid:2)(cid:1)(cid:34)(cid:34)(cid:19)(cid:18)(cid:18)(cid:2)(cid:44,,11448.0
,,25,,,Unknown,,cid:43)(cid:2)(cid:1)(cid:34)(cid:34)(cid:19)(cid:18)(cid:18)(cid:2)(cid:44,,11473.0
,,2,,,Unknown,,cid:43)(cid:2)(cid:1)(cid:34)(cid:34)(cid:19)(cid:18)(cid:18)(cid:2)(cid:44,,11475.0
,,50,,,Unknown,,cid:43)(cid:2)(cid:1)(cid:34)(cid:34)(cid:19)(cid:18)(cid:18)(cid:2)(cid:44,,11525.0
,,50,,,Unknown,,cid:43)(cid:2)(cid:1)(cid:34)(cid:34)(cid:19)(cid:18)(cid:18)(cid:2)(cid:44,,11575.0
,,37,,,Unknown,,cid:43)(cid:2)(cid:1)(cid:34)(cid:34)(cid:19)(cid:18)(cid:18)(cid:2)(cid:44,,11612.0
,,16,,,Unknown,,cid:43)(cid:2)(cid:1)(cid:34)(cid:34)(cid:19)(cid:18)(cid:18)(cid:2)(cid:44,,11628.0
,,34,,,Unknown,,cid:43)(cid:2)(cid:1)(cid:34)(cid:34)(cid:19)(cid:18)(cid:18)(cid:2)(cid:44,,11662.0
,,33,,,Unknown,,cid:43)(cid:2)(cid:1)(cid:34)(cid:34)(cid:19)(cid:18)(cid:18)(cid:2)(cid:44,,11695.0
,,17,,,Unknown,,cid:43)(cid:2)(cid:1)(cid:34)(cid:34)(cid:19)(cid:18)(cid:18)(cid:2)(cid:44,,11712.0
,,17,,,Unknown,,cid:43)(cid:2)(cid:1)(cid:34)(cid:34)(cid:19)(cid:18)(cid:18)(cid:2)(cid:44,,11729.0
,,45,,,Unknown,,cid:43)(cid:2)(cid:1)(cid:34)(cid:34)(cid:19)(cid:18)(cid:18)(cid:2)(cid:44,,11774.0
,,18,,,Unknown,,cid:43)(cid:2)(cid:1)(cid:34)(cid:34)(cid:19)(cid:18)(cid:18)(cid:2)(cid:44,,11792.0
,,35,,,Unknown,,cid:43)(cid:2)(cid:1)(cid:34)(cid:34)(cid:19)(cid:18)(cid:18)(cid:2)(cid:44,,11827.0
,,54,,,Unknown,,cid:43)(cid:2)(cid:1)(cid:34)(cid:34)(cid:19)(cid:18)(cid:18)(cid:2)(cid:44,,11881.0
,,46,,,Unknown,,cid:43)(cid:2)(cid:1)(cid:34)(cid:34)(cid:19)(cid:18)(cid:18)(cid:2)(cid:44,,11927.0
,,4,,,Unknown,,cid:43)(cid:2)(cid:1)(cid:34)(cid:34)(cid:19)(cid:18)(cid:18)(cid:2)(cid:44,,11931.0
,,10,,,Unknown,,cid:43)(cid:2)(cid:1)(cid:34)(cid:34)(cid:19)(cid:18)(cid:18)(cid:2)(cid:44,,11941.0
,,9,,,Unknown,,cid:43)(cid:2)(cid:1)(cid:34)(cid:34)(cid:19)(cid:18)(cid:18)(cid:2)(cid:44,,11950.0
,,10,,,Unknown,,cid:43)(cid:2)(cid:1)(cid:34)(cid:34)(cid:19)(cid:18)(cid:18)(cid:2)(cid:44,,11960.0
,,5,,,Unknown,,cid:43)(cid:2)(cid:1)(cid:34)(cid:34)(cid:19)(cid:18)(cid:18)(cid:2)(cid:44,,11965.0
,,14,,,Unknown,,cid:43)(cid:2)(cid:1)(cid:34)(cid:34)(cid:19)(cid:18)(cid:18)(cid:2)(cid:44,,11979.0
,,14,,,Unknown,,cid:43)(cid:2)(cid:1)(cid:34)(cid:34)(cid:19)(cid:18)(cid:18)(cid:2)(cid:44,,11993.0
,,5,,,Unknown,,cid:43)(cid:2)(cid:1)(cid:34)(cid:34)(cid:19)(cid:18)(cid:18)(cid:2)(cid:44,,11998.0
,,2,,,Unknown,,cid:43)(cid:2)(cid:1)(cid:34)(cid:34)(cid:19)(cid:18)(cid:18)(cid:2)(cid:44,,12000.0
,,3,,,Unknown,,cid:43)(cid:2)(cid:1)(cid:34)(cid:34)(cid:19)(cid:18)(cid:18)(cid:2)(cid:44,,12003.0
,,11,,,Unknown,,cid:43)(cid:2)(cid:1)(cid:34)(cid:34)(cid:19)(cid:18)(cid:18)(cid:2)(cid:44,,12014.0
,,9,,,Unknown,,cid:43)(cid:2)(cid:1)(cid:34)(cid:34)(cid:19)(cid:18)(cid:18)(cid:2)(cid:44,,12023.0
,,5,,,Unknown,,cid:43)(cid:2)(cid:1)(cid:34)(cid:34)(cid:19)(cid:18)(cid:18)(cid:2)(cid:44,,12028.0
,,8,,,Unknown,,cid:43)(cid:2)(cid:1)(cid:34)(cid:34)(cid:19)(cid:18)(cid:18)(cid:2)(cid:44,,12036.0
,,51,,,Unknown,,cid:43)(cid:2)(cid:1)(cid:34)(cid:34)(cid:19)(cid:18)(cid:18)(cid:2)(cid:44,,12087.0
,,46,,,Unknown,,cid:43)(cid:2)(cid:1)(cid:34)(cid:34)(cid:19)(cid:18)(cid:18)(cid:2)(cid:44,,12133.0
,,12,,,Unknown,,cid:43)(cid:2)(cid:1)(cid:34)(cid:34)(cid:19)(cid:18)(cid:18)(cid:2)(cid:44,,12145.0
,,13,,,Unknown,,cid:43)(cid:2)(cid:1)(cid:34)(cid:34)(cid:19)(cid:18)(cid:18)(cid:2)(cid:44,,12158.0
,,2,,,Unknown,,cid:43)(cid:2)(cid:1)(cid:34)(cid:34)(cid:19)(cid:18)(cid:18)(cid:2)(cid:44,,12160.0
,,3,,,Unknown,,cid:43)(cid:2)(cid:1)(cid:34)(cid:34)(cid:19)(cid:18)(cid:18)(cid:2)(cid:44,,12163.0
,,11,,,Unknown,,cid:43)(cid:2)(cid:1)(cid:34)(cid:34)(cid:19)(cid:18)(cid:18)(cid:2)(cid:44,,12174.0
,,9,,,Unknown,,cid:43)(cid:2)(cid:1)(cid:34)(cid:34)(cid:19)(cid:18)(cid:18)(cid:2)(cid:44,,12183.0
,,5,,,Unknown,,cid:43)(cid:2)(cid:1)(cid:34)(cid:34)(cid:19)(cid:18)(cid:18)(cid:2)(cid:44,,12188.0
,,8,,,Unknown,,cid:43)(cid:2)(cid:1)(cid:34)(cid:34)(cid:19)(cid:18)(cid:18)(cid:2)(cid:44,,12196.0
,,51,,,Unknown,,cid:43)(cid:2)(cid:1)(cid:34)(cid:34)(cid:19)(cid:18)(cid:18)(cid:2)(cid:44,,12247.0
,,46,,,Unknown,,cid:43)(cid:2)(cid:1)(cid:34)(cid:34)(cid:19)(cid:18)(cid:18)(cid:2)(cid:44,,12293.0
,,12,,,Unknown,,cid:43)(cid:2)(cid:1)(cid:34)(cid:34)(cid:19)(cid:18)(cid:18)(cid:2)(cid:44,,12305.0
,,13,,,Unknown,,cid:43)(cid:2)(cid:1)(cid:34)(cid:34)(cid:19)(cid:18)(cid:18)(cid:2)(cid:44,,12318.0
,,2,,,Unknown,,cid:43)(cid:2)(cid:1)(cid:34)(cid:34)(cid:19)(cid:18)(cid:18)(cid:2)(cid:44,,12320.0
,,46,,,Unknown,,cid:43)(cid:2)(cid:1)(cid:34)(cid:34)(cid:19)(cid:18)(cid:18)(cid:2)(cid:44,,12366.0
,,10,,,Unknown,,cid:43)(cid:2)(cid:1)(cid:34)(cid:34)(cid:19)(cid:18)(cid:18)(cid:2)(cid:44,,12376.0
,,15,,,Unknown,,cid:43)(cid:2)(cid:1)(cid:34)(cid:34)(cid:19)(cid:18)(cid:18)(cid:2)(cid:44,,12391.0
,,2,,,Unknown,,cid:43)(cid:2)(cid:1)(cid:34)(cid:34)(cid:19)(cid:18)(cid:18)(cid:2)(cid:44,,12393.0
,,16,,,Unknown,,cid:43)(cid:2)(cid:1)(cid:34)(cid:34)(cid:19)(cid:18)(cid:18)(cid:2)(cid:44,,12409.0
,,19,,,Unknown,,cid:43)(cid:2)(cid:1)(cid:34)(cid:34)(cid:19)(cid:18)(cid:18)(cid:2)(cid:44,,12428.0
,,32,,,Unknown,,cid:43)(cid:2)(cid:1)(cid:34)(cid:34)(cid:19)(cid:18)(cid:18)(cid:2)(cid:44,,12460.0
,,18,,,Unknown,,cid:43)(cid:2)(cid:1)(cid:34)(cid:34)(cid:19)(cid:18)(cid:18)(cid:2)(cid:44,,12478.0
,,2,,,Unknown,,cid:43)(cid:2)(cid:1)(cid:34)(cid:34)(cid:19)(cid:18)(cid:18)(cid:2)(cid:44,,12480.0
,,44,,,Unknown,,cid:43)(cid:2)(cid:1)(cid:34)(cid:34)(cid:19)(cid:18)(cid:18)(cid:2)(cid:44,,12524.0
,,12,,,Unknown,,cid:43)(cid:2)(cid:1)(cid:34)(cid:34)(cid:19)(cid:18)(cid:18)(cid:2)(cid:44,,12536.0
,,29,,,Unknown,,cid:43)(cid:2)(cid:1)(cid:34)(cid:34)(cid:19)(cid:18)(cid:18)(cid:2)(cid:44,,12565.0
,,26,,,Unknown,,cid:43)(cid:2)(cid:1)(cid:34)(cid:34)(cid:19)(cid:18)(cid:18)(cid:2)(cid:44,,12591.0
,,41,,,Unknown,,cid:43)(cid:2)(cid:1)(cid:34)(cid:34)(cid:19)(cid:18)(cid:18)(cid:2)(cid:44,,12632.0
,,25,,,Unknown,,cid:43)(cid:2)(cid:1)(cid:34)(cid:34)(cid:19)(cid:18)(cid:18)(cid:2)(cid:44,,12657.0
,,2,,,Unknown,,cid:43)(cid:2)(cid:1)(cid:34)(cid:34)(cid:19)(cid:18)(cid:18)(cid:2)(cid:44,,12659.0
,,50,,,Unknown,,cid:43)(cid:2)(cid:1)(cid:34)(cid:34)(cid:19)(cid:18)(cid:18)(cid:2)(cid:44,,12709.0
,,50,,,Unknown,,cid:43)(cid:2)(cid:1)(cid:34)(cid:34)(cid:19)(cid:18)(cid:18)(cid:2)(cid:44,,12759.0
,,18,,,Unknown,,cid:43)(cid:2)(cid:1)(cid:34)(cid:34)(cid:19)(cid:18)(cid:18)(cid:2)(cid:44,,12777.0
,,1,,,Unknown,,cid:43)(cid:2)(cid:1)(cid:34)(cid:34)(cid:19)(cid:18)(cid:18)(cid:2)(cid:44,,12778.0
,,1,,,Unknown,,cid:43)(cid:2)(cid:1)(cid:34)(cid:34)(cid:19)(cid:18)(cid:18)(cid:2)(cid:44,,12779.0
,,37,,,Unknown,,cid:43)(cid:2)(cid:1)(cid:34)(cid:34)(cid:19)(cid:18)(cid:18)(cid:2)(cid:44,,12816.0
,,17,,,Unknown,,cid:43)(cid:2)(cid:1)(cid:34)(cid:34)(cid:19)(cid:18)(cid:18)(cid:2)(cid:44,,12833.0
,,16,,,Unknown,,cid:43)(cid:2)(cid:1)(cid:34)(cid:34)(cid:19)(cid:18)(cid:18)(cid:2)(cid:44,,12849.0
,,45,,,Unknown,,cid:43)(cid:2)(cid:1)(cid:34)(cid:34)(cid:19)(cid:18)(cid:18)(cid:2)(cid:44,,12894.0
,,18,,,Unknown,,cid:43)(cid:2)(cid:1)(cid:34)(cid:34)(cid:19)(cid:18)(cid:18)(cid:2)(cid:44,,12912.0
,,35,,,Unknown,,cid:43)(cid:2)(cid:1)(cid:34)(cid:34)(cid:19)(cid:18)(cid:18)(cid:2)(cid:44,,12947.0
,,8,,,Unknown,,cid:43)(cid:2)(cid:1)(cid:34)(cid:34)(cid:19)(cid:18)(cid:18)(cid:2)(cid:44,,12955.0
,,5,,,Unknown,,cid:43)(cid:2)(cid:1)(cid:34)(cid:34)(cid:19)(cid:18)(cid:18)(cid:2)(cid:44,,12960.0
,,6,,,Unknown,,cid:43)(cid:2)(cid:1)(cid:34)(cid:34)(cid:19)(cid:18)(cid:18)(cid:2)(cid:44,,12966.0
,,12,,,Unknown,,cid:43)(cid:2)(cid:1)(cid:34)(cid:34)(cid:19)(cid:18)(cid:18)(cid:2)(cid:44,,12978.0
,,11,,,Unknown,,cid:43)(cid:2)(cid:1)(cid:34)(cid:34)(cid:19)(cid:18)(cid:18)(cid:2)(cid:44,,12989.0
,,2,,,Unknown,,cid:43)(cid:2)(cid:1)(cid:34)(cid:34)(cid:19)(cid:18)(cid:18)(cid:2)(cid:44,,12991.0
,,52,,,Unknown,,cid:43)(cid:2)(cid:1)(cid:34)(cid:34)(cid:19)(cid:18)(cid:18)(cid:2)(cid:44,,13043.0
,,7,,,Unknown,,cid:43)(cid:2)(cid:1)(cid:34)(cid:34)(cid:19)(cid:18)(cid:18)(cid:2)(cid:44,,13050.0
,,14,,,Unknown,,cid:43)(cid:2)(cid:1)(cid:34)(cid:34)(cid:19)(cid:18)(cid:18)(cid:2)(cid:44,,13064.0
,,14,,,Unknown,,cid:43)(cid:2)(cid:1)(cid:34)(cid:34)(cid:19)(cid:18)(cid:18)(cid:2)(cid:44,,13078.0
,,46,,,Unknown,,cid:43)(cid:2)(cid:1)(cid:34)(cid:34)(cid:19)(cid:18)(cid:18)(cid:2)(cid:44,,13124.0
,,2,,,Unknown,,cid:43)(cid:2)(cid:1)(cid:34)(cid:34)(cid:19)(cid:18)(cid:18)(cid:2)(cid:44,,13126.0
,,53,,,Unknown,,cid:43)(cid:2)(cid:1)(cid:34)(cid:34)(cid:19)(cid:18)(cid:18)(cid:2)(cid:44,,13179.0
,,5,,,Unknown,,cid:43)(cid:2)(cid:1)(cid:34)(cid:34)(cid:19)(cid:18)(cid:18)(cid:2)(cid:44,,13184.0
,,3,,,Unknown,,cid:43)(cid:2)(cid:1)(cid:34)(cid:34)(cid:19)(cid:18)(cid:18)(cid:2)(cid:44,,13187.0
,,54,,,Unknown,,cid:43)(cid:2)(cid:1)(cid:34)(cid:34)(cid:19)(cid:18)(cid:18)(cid:2)(cid:44,,13241.0
,,7,,,Unknown,,cid:43)(cid:2)(cid:1)(cid:34)(cid:34)(cid:19)(cid:18)(cid:18)(cid:2)(cid:44,,13248.0
,,46,,,Unknown,,cid:43)(cid:2)(cid:1)(cid:34)(cid:34)(cid:19)(cid:18)(cid:18)(cid:2)(cid:44,,13294.0
,,2,,,Unknown,,cid:43)(cid:2)(cid:1)(cid:34)(cid:34)(cid:19)(cid:18)(cid:18)(cid:2)(cid:44,,13296.0
,,14,,,Unknown,,cid:43)(cid:2)(cid:1)(cid:34)(cid:34)(cid:19)(cid:18)(cid:18)(cid:2)(cid:44,,13310.0
,,63,,,Unknown,,cid:43)(cid:2)(cid:1)(cid:34)(cid:34)(cid:19)(cid:18)(cid:18)(cid:2)(cid:44,,13373.0
,,14,,,Unknown,,cid:43)(cid:2)(cid:1)(cid:34)(cid:34)(cid:19)(cid:18)(cid:18)(cid:2)(cid:44,,13387.0
,,2,,,Unknown,,cid:43)(cid:2)(cid:1)(cid:34)(cid:34)(cid:19)(cid:18)(cid:18)(cid:2)(cid:44,,13389.0
,,39,,,Unknown,,cid:43)(cid:2)(cid:1)(cid:34)(cid:34)(cid:19)(cid:18)(cid:18)(cid:2)(cid:44,,13428.0
,,3,,,Unknown,,cid:43)(cid:2)(cid:1)(cid:34)(cid:34)(cid:19)(cid:18)(cid:18)(cid:2)(cid:44,,13431.0
,,7,,,Unknown,,cid:43)(cid:2)(cid:1)(cid:34)(cid:34)(cid:19)(cid:18)(cid:18)(cid:2)(cid:44,,13438.0
,,9,,,Unknown,,cid:43)(cid:2)(cid:1)(cid:34)(cid:34)(cid:19)(cid:18)(cid:18)(cid:2)(cid:44,,13447.0
,,13,,,Unknown,,cid:43)(cid:2)(cid:1)(cid:34)(cid:34)(cid:19)(cid:18)(cid:18)(cid:2)(cid:44,,13460.0
,,10,,,Unknown,,cid:43)(cid:2)(cid:1)(cid:34)(cid:34)(cid:19)(cid:18)(cid:18)(cid:2)(cid:44,,13470.0
,,7,,,Unknown,,cid:43)(cid:2)(cid:1)(cid:34)(cid:34)(cid:19)(cid:18)(cid:18)(cid:2)(cid:44,,13477.0
,,8,,,Unknown,,cid:43)(cid:2)(cid:1)(cid:34)(cid:34)(cid:19)(cid:18)(cid:18)(cid:2)(cid:44,,13485.0
,,46,,,Unknown,,cid:43)(cid:2)(cid:1)(cid:34)(cid:34)(cid:19)(cid:18)(cid:18)(cid:2)(cid:44,,13531.0
,,2,,,Unknown,,cid:43)(cid:2)(cid:1)(cid:34)(cid:34)(cid:19)(cid:18)(cid:18)(cid:2)(cid:44,,13533.0
,,38,,,Unknown,,cid:43)(cid:2)(cid:1)(cid:34)(cid:34)(cid:19)(cid:18)(cid:18)(cid:2)(cid:44,,13571.0
,,64,,,Unknown,,cid:43)(cid:2)(cid:1)(cid:34)(cid:34)(cid:19)(cid:18)(cid:18)(cid:2)(cid:44,,13635.0
,,15,,,Unknown,,cid:43)(cid:2)(cid:1)(cid:34)(cid:34)(cid:19)(cid:18)(cid:18)(cid:2)(cid:44,,13650.0
,,2,,,Unknown,,cid:43)(cid:2)(cid:1)(cid:34)(cid:34)(cid:19)(cid:18)(cid:18)(cid:2)(cid:44,,13652.0
,,35,,,Unknown,,cid:43)(cid:2)(cid:1)(cid:34)(cid:34)(cid:19)(cid:18)(cid:18)(cid:2)(cid:44,,13687.0
,,32,,,Unknown,,cid:43)(cid:2)(cid:1)(cid:34)(cid:34)(cid:19)(cid:18)(cid:18)(cid:2)(cid:44,,13719.0
,,19,,,Unknown,,cid:43)(cid:2)(cid:1)(cid:34)(cid:34)(cid:19)(cid:18)(cid:18)(cid:2)(cid:44,,13738.0
,,18,,,Unknown,,cid:43)(cid:2)(cid:1)(cid:34)(cid:34)(cid:19)(cid:18)(cid:18)(cid:2)(cid:44,,13756.0
,,18,,,Unknown,,cid:43)(cid:2)(cid:1)(cid:34)(cid:34)(cid:19)(cid:18)(cid:18)(cid:2)(cid:44,,13774.0
,,2,,,Unknown,,cid:43)(cid:2)(cid:1)(cid:34)(cid:34)(cid:19)(cid:18)(cid:18)(cid:2)(cid:44,,13776.0
,,44,,,Unknown,,cid:43)(cid:2)(cid:1)(cid:34)(cid:34)(cid:19)(cid:18)(cid:18)(cid:2)(cid:44,,13820.0
,,12,,,Unknown,,cid:43)(cid:2)(cid:1)(cid:34)(cid:34)(cid:19)(cid:18)(cid:18)(cid:2)(cid:44,,13832.0
,,29,,,Unknown,,cid:43)(cid:2)(cid:1)(cid:34)(cid:34)(cid:19)(cid:18)(cid:18)(cid:2)(cid:44,,13861.0
,,26,,,Unknown,,cid:43)(cid:2)(cid:1)(cid:34)(cid:34)(cid:19)(cid:18)(cid:18)(cid:2)(cid:44,,13887.0
,,41,,,Unknown,,cid:43)(cid:2)(cid:1)(cid:34)(cid:34)(cid:19)(cid:18)(cid:18)(cid:2)(cid:44,,13928.0
,,25,,,Unknown,,cid:43)(cid:2)(cid:1)(cid:34)(cid:34)(cid:19)(cid:18)(cid:18)(cid:2)(cid:44,,13953.0
,,2,,,Unknown,,cid:43)(cid:2)(cid:1)(cid:34)(cid:34)(cid:19)(cid:18)(cid:18)(cid:2)(cid:44,,13955.0
,,50,,,Unknown,,cid:43)(cid:2)(cid:1)(cid:34)(cid:34)(cid:19)(cid:18)(cid:18)(cid:2)(cid:44,,14005.0
,,50,,,Unknown,,cid:43)(cid:2)(cid:1)(cid:34)(cid:34)(cid:19)(cid:18)(cid:18)(cid:2)(cid:44,,14055.0
,,37,,,Unknown,,cid:43)(cid:2)(cid:1)(cid:34)(cid:34)(cid:19)(cid:18)(cid:18)(cid:2)(cid:44,,14092.0
,,16,,,Unknown,,cid:43)(cid:2)(cid:1)(cid:34)(cid:34)(cid:19)(cid:18)(cid:18)(cid:2)(cid:44,,14108.0
,,34,,,Unknown,,cid:43)(cid:2)(cid:1)(cid:34)(cid:34)(cid:19)(cid:18)(cid:18)(cid:2)(cid:44,,14142.0
,,33,,,Unknown,,cid:43)(cid:2)(cid:1)(cid:34)(cid:34)(cid:19)(cid:18)(cid:18)(cid:2)(cid:44,,14175.0
,,1,,,Unknown,,cid:43)(cid:2)(cid:1)(cid:34)(cid:34)(cid:19)(cid:18)(cid:18)(cid:2)(cid:44,,14176.0
,,18,,,Unknown,,cid:43)(cid:2)(cid:1)(cid:34)(cid:34)(cid:19)(cid:18)(cid:18)(cid:2)(cid:44,,14194.0
,,45,,,Unknown,,cid:43)(cid:2)(cid:1)(cid:34)(cid:34)(cid:19)(cid:18)(cid:18)(cid:2)(cid:44,,14239.0
,,18,,,Unknown,,cid:43)(cid:2)(cid:1)(cid:34)(cid:34)(cid:19)(cid:18)(cid:18)(cid:2)(cid:44,,14257.0
,,35,,,Unknown,,cid:43)(cid:2)(cid:1)(cid:34)(cid:34)(cid:19)(cid:18)(cid:18)(cid:2)(cid:44,,14292.0
,,46,,,Unknown,,cid:43)(cid:2)(cid:1)(cid:34)(cid:34)(cid:19)(cid:18)(cid:18)(cid:2)(cid:44,,14338.0
,,3,,,Unknown,,cid:43)(cid:2)(cid:1)(cid:34)(cid:34)(cid:19)(cid:18)(cid:18)(cid:2)(cid:44,,14341.0
,,9,,,Unknown,,cid:43)(cid:2)(cid:1)(cid:34)(cid:34)(cid:19)(cid:18)(cid:18)(cid:2)(cid:44,,14350.0
,,5,,,Unknown,,cid:43)(cid:2)(cid:1)(cid:34)(cid:34)(cid:19)(cid:18)(cid:18)(cid:2)(cid:44,,14355.0
,,8,,,Unknown,,cid:43)(cid:2)(cid:1)(cid:34)(cid:34)(cid:19)(cid:18)(cid:18)(cid:2)(cid:44,,14363.0
,,46,,,Unknown,,cid:43)(cid:2)(cid:1)(cid:34)(cid:34)(cid:19)(cid:18)(cid:18)(cid:2)(cid:44,,14409.0
,,14,,,Unknown,,cid:43)(cid:2)(cid:1)(cid:34)(cid:34)(cid:19)(cid:18)(cid:18)(cid:2)(cid:44,,14423.0
,,2,,,Unknown,,cid:43)(cid:2)(cid:1)(cid:34)(cid:34)(cid:19)(cid:18)(cid:18)(cid:2)(cid:44,,14425.0
,,1,,,Unknown,,cid:43)(cid:2)(cid:1)(cid:34)(cid:34)(cid:19)(cid:18)(cid:18)(cid:2)(cid:44,,14426.0
,,2,,,Unknown,,cid:43)(cid:2)(cid:1)(cid:34)(cid:34)(cid:19)(cid:18)(cid:18)(cid:2)(cid:44,,14428.0
,,8,,,Unknown,,cid:43)(cid:2)(cid:1)(cid:34)(cid:34)(cid:19)(cid:18)(cid:18)(cid:2)(cid:44,,14436.0
,,39,,,Unknown,,cid:43)(cid:2)(cid:1)(cid:34)(cid:34)(cid:19)(cid:18)(cid:18)(cid:2)(cid:44,,14475.0
,,10,,,Unknown,,cid:43)(cid:2)(cid:1)(cid:34)(cid:34)(cid:19)(cid:18)(cid:18)(cid:2)(cid:44,,14485.0
,,2,,,Unknown,,cid:43)(cid:2)(cid:1)(cid:34)(cid:34)(cid:19)(cid:18)(cid:18)(cid:2)(cid:44,,14487.0
,,49,,,Unknown,,cid:43)(cid:2)(cid:1)(cid:34)(cid:34)(cid:19)(cid:18)(cid:18)(cid:2)(cid:44,,14536.0
,,46,,,Unknown,,cid:43)(cid:2)(cid:1)(cid:34)(cid:34)(cid:19)(cid:18)(cid:18)(cid:2)(cid:44,,14582.0
,,3,,,Unknown,,cid:43)(cid:2)(cid:1)(cid:34)(cid:34)(cid:19)(cid:18)(cid:18)(cid:2)(cid:44,,14585.0
,,49,,,Unknown,,cid:43)(cid:2)(cid:1)(cid:34)(cid:34)(cid:19)(cid:18)(cid:18)(cid:2)(cid:44,,14634.0
,,46,,,Unknown,,cid:43)(cid:2)(cid:1)(cid:34)(cid:34)(cid:19)(cid:18)(cid:18)(cid:2)(cid:44,,14680.0
,,8,,,Unknown,,cid:43)(cid:2)(cid:1)(cid:34)(cid:34)(cid:19)(cid:18)(cid:18)(cid:2)(cid:44,,14688.0
,,7,,,Unknown,,cid:43)(cid:2)(cid:1)(cid:34)(cid:34)(cid:19)(cid:18)(cid:18)(cid:2)(cid:44,,14695.0
,,46,,,Unknown,,cid:43)(cid:2)(cid:1)(cid:34)(cid:34)(cid:19)(cid:18)(cid:18)(cid:2)(cid:44,,14741.0
,,2,,,Unknown,,cid:43)(cid:2)(cid:1)(cid:34)(cid:34)(cid:19)(cid:18)(cid:18)(cid:2)(cid:44,,14743.0
,,38,,,Unknown,,cid:43)(cid:2)(cid:1)(cid:34)(cid:34)(cid:19)(cid:18)(cid:18)(cid:2)(cid:44,,14781.0
,,64,,,Unknown,,cid:43)(cid:2)(cid:1)(cid:34)(cid:34)(cid:19)(cid:18)(cid:18)(cid:2)(cid:44,,14845.0
,,15,,,Unknown,,cid:43)(cid:2)(cid:1)(cid:34)(cid:34)(cid:19)(cid:18)(cid:18)(cid:2)(cid:44,,14860.0
,,2,,,Unknown,,cid:43)(cid:2)(cid:1)(cid:34)(cid:34)(cid:19)(cid:18)(cid:18)(cid:2)(cid:44,,14862.0
,,17,,,Unknown,,cid:43)(cid:2)(cid:1)(cid:34)(cid:34)(cid:19)(cid:18)(cid:18)(cid:2)(cid:44,,14879.0
,,1,,,Unknown,,cid:43)(cid:2)(cid:1)(cid:34)(cid:34)(cid:19)(cid:18)(cid:18)(cid:2)(cid:44,,14880.0
,,36,,,Unknown,,cid:43)(cid:2)(cid:1)(cid:34)(cid:34)(cid:19)(cid:18)(cid:18)(cid:2)(cid:44,,14916.0
,,19,,,Unknown,,cid:43)(cid:2)(cid:1)(cid:34)(cid:34)(cid:19)(cid:18)(cid:18)(cid:2)(cid:44,,14935.0
,,18,,,Unknown,,cid:43)(cid:2)(cid:1)(cid:34)(cid:34)(cid:19)(cid:18)(cid:18)(cid:2)(cid:44,,14953.0
,,18,,,Unknown,,cid:43)(cid:2)(cid:1)(cid:34)(cid:34)(cid:19)(cid:18)(cid:18)(cid:2)(cid:44,,14971.0
,,2,,,Unknown,,cid:43)(cid:2)(cid:1)(cid:34)(cid:34)(cid:19)(cid:18)(cid:18)(cid:2)(cid:44,,14973.0
,,44,,,Unknown,,cid:43)(cid:2)(cid:1)(cid:34)(cid:34)(cid:19)(cid:18)(cid:18)(cid:2)(cid:44,,15017.0
,,12,,,Unknown,,cid:43)(cid:2)(cid:1)(cid:34)(cid:34)(cid:19)(cid:18)(cid:18)(cid:2)(cid:44,,15029.0
,,29,,,Unknown,,cid:43)(cid:2)(cid:1)(cid:34)(cid:34)(cid:19)(cid:18)(cid:18)(cid:2)(cid:44,,15058.0
,,26,,,Unknown,,cid:43)(cid:2)(cid:1)(cid:34)(cid:34)(cid:19)(cid:18)(cid:18)(cid:2)(cid:44,,15084.0
,,41,,,Unknown,,cid:43)(cid:2)(cid:1)(cid:34)(cid:34)(cid:19)(cid:18)(cid:18)(cid:2)(cid:44,,15125.0
,,25,,,Unknown,,cid:43)(cid:2)(cid:1)(cid:34)(cid:34)(cid:19)(cid:18)(cid:18)(cid:2)(cid:44,,15150.0
,,2,,,Unknown,,cid:43)(cid:2)(cid:1)(cid:34)(cid:34)(cid:19)(cid:18)(cid:18)(cid:2)(cid:44,,15152.0
,,50,,,Unknown,,cid:43)(cid:2)(cid:1)(cid:34)(cid:34)(cid:19)(cid:18)(cid:18)(cid:2)(cid:44,,15202.0
,,50,,,Unknown,,cid:43)(cid:2)(cid:1)(cid:34)(cid:34)(cid:19)(cid:18)(cid:18)(cid:2)(cid:44,,15252.0
,,37,,,Unknown,,cid:43)(cid:2)(cid:1)(cid:34)(cid:34)(cid:19)(cid:18)(cid:18)(cid:2)(cid:44,,15289.0
,,16,,,Unknown,,cid:43)(cid:2)(cid:1)(cid:34)(cid:34)(cid:19)(cid:18)(cid:18)(cid:2)(cid:44,,15305.0
,,34,,,Unknown,,cid:43)(cid:2)(cid:1)(cid:34)(cid:34)(cid:19)(cid:18)(cid:18)(cid:2)(cid:44,,15339.0
,,33,,,Unknown,,cid:43)(cid:2)(cid:1)(cid:34)(cid:34)(cid:19)(cid:18)(cid:18)(cid:2)(cid:44,,15372.0
,,1,,,Unknown,,cid:43)(cid:2)(cid:1)(cid:34)(cid:34)(cid:19)(cid:18)(cid:18)(cid:2)(cid:44,,15373.0
,,37,,,Unknown,,cid:43)(cid:2)(cid:1)(cid:34)(cid:34)(cid:19)(cid:18)(cid:18)(cid:2)(cid:44,,15410.0
,,45,,,Unknown,,cid:43)(cid:2)(cid:1)(cid:34)(cid:34)(cid:19)(cid:18)(cid:18)(cid:2)(cid:44,,15455.0
,,18,,,Unknown,,cid:43)(cid:2)(cid:1)(cid:34)(cid:34)(cid:19)(cid:18)(cid:18)(cid:2)(cid:44,,15473.0
,,35,,,Unknown,,cid:43)(cid:2)(cid:1)(cid:34)(cid:34)(cid:19)(cid:18)(cid:18)(cid:2)(cid:44,,15508.0
,,52,,,Unknown,,cid:43)(cid:2)(cid:1)(cid:34)(cid:34)(cid:19)(cid:18)(cid:18)(cid:2)(cid:44,,15560.0
,,7,,,Unknown,,cid:43)(cid:2)(cid:1)(cid:34)(cid:34)(cid:19)(cid:18)(cid:18)(cid:2)(cid:44,,15567.0
,,52,,,Unknown,,cid:43)(cid:2)(cid:1)(cid:34)(cid:34)(cid:19)(cid:18)(cid:18)(cid:2)(cid:44,,15619.0
,,46,,,Unknown,,cid:43)(cid:2)(cid:1)(cid:34)(cid:34)(cid:19)(cid:18)(cid:18)(cid:2)(cid:44,,15665.0
,,2,,,Unknown,,cid:43)(cid:2)(cid:1)(cid:34)(cid:34)(cid:19)(cid:18)(cid:18)(cid:2)(cid:44,,15667.0
,,28,,,Unknown,,cid:43)(cid:2)(cid:1)(cid:34)(cid:34)(cid:19)(cid:18)(cid:18)(cid:2)(cid:44,,15695.0
,,3,,,Unknown,,cid:43)(cid:2)(cid:1)(cid:34)(cid:34)(cid:19)(cid:18)(cid:18)(cid:2)(cid:44,,15698.0
,,5,,,Unknown,,cid:43)(cid:2)(cid:1)(cid:34)(cid:34)(cid:19)(cid:18)(cid:18)(cid:2)(cid:44,,15703.0
,,9,,,Unknown,,cid:43)(cid:2)(cid:1)(cid:34)(cid:34)(cid:19)(cid:18)(cid:18)(cid:2)(cid:44,,15712.0
,,13,,,Unknown,,cid:43)(cid:2)(cid:1)(cid:34)(cid:34)(cid:19)(cid:18)(cid:18)(cid:2)(cid:44,,15725.0
,,2,,,Unknown,,cid:43)(cid:2)(cid:1)(cid:34)(cid:34)(cid:19)(cid:18)(cid:18)(cid:2)(cid:44,,15727.0
,,28,,,Unknown,,cid:43)(cid:2)(cid:1)(cid:34)(cid:34)(cid:19)(cid:18)(cid:18)(cid:2)(cid:44,,15755.0
,,5,,,Unknown,,cid:43)(cid:2)(cid:1)(cid:34)(cid:34)(cid:19)(cid:18)(cid:18)(cid:2)(cid:44,,15760.0
,,3,,,Unknown,,cid:43)(cid:2)(cid:1)(cid:34)(cid:34)(cid:19)(cid:18)(cid:18)(cid:2)(cid:44,,15763.0
,,7,,,Unknown,,cid:43)(cid:2)(cid:1)(cid:34)(cid:34)(cid:19)(cid:18)(cid:18)(cid:2)(cid:44,,15770.0
,,64,,,Unknown,,cid:43)(cid:2)(cid:1)(cid:34)(cid:34)(cid:19)(cid:18)(cid:18)(cid:2)(cid:44,,15834.0
,,46,,,Unknown,,cid:43)(cid:2)(cid:1)(cid:34)(cid:34)(cid:19)(cid:18)(cid:18)(cid:2)(cid:44,,15880.0
,,65,,,Unknown,,cid:43)(cid:2)(cid:1)(cid:34)(cid:34)(cid:19)(cid:18)(cid:18)(cid:2)(cid:44,,15945.0
,,2,,,Unknown,,cid:43)(cid:2)(cid:1)(cid:34)(cid:34)(cid:19)(cid:18)(cid:18)(cid:2)(cid:44,,15947.0
,,38,,,Unknown,,cid:43)(cid:2)(cid:1)(cid:34)(cid:34)(cid:19)(cid:18)(cid:18)(cid:2)(cid:44,,15985.0
,,64,,,Unknown,,cid:43)(cid:2)(cid:1)(cid:34)(cid:34)(cid:19)(cid:18)(cid:18)(cid:2)(cid:44,,16049.0
,,15,,,Unknown,,cid:43)(cid:2)(cid:1)(cid:34)(cid:34)(cid:19)(cid:18)(cid:18)(cid:2)(cid:44,,16064.0
,,2,,,Unknown,,cid:43)(cid:2)(cid:1)(cid:34)(cid:34)(cid:19)(cid:18)(cid:18)(cid:2)(cid:44,,16066.0
,,37,,,Unknown,,cid:43)(cid:2)(cid:1)(cid:34)(cid:34)(cid:19)(cid:18)(cid:18)(cid:2)(cid:44,,16103.0
,,18,,,Unknown,,cid:43)(cid:2)(cid:1)(cid:34)(cid:34)(cid:19)(cid:18)(cid:18)(cid:2)(cid:44,,16121.0
,,19,,,Unknown,,cid:43)(cid:2)(cid:1)(cid:34)(cid:34)(cid:19)(cid:18)(cid:18)(cid:2)(cid:44,,16140.0
,,32,,,Unknown,,cid:43)(cid:2)(cid:1)(cid:34)(cid:34)(cid:19)(cid:18)(cid:18)(cid:2)(cid:44,,16172.0
,,17,,,Unknown,,cid:43)(cid:2)(cid:1)(cid:34)(cid:34)(cid:19)(cid:18)(cid:18)(cid:2)(cid:44,,16189.0
,,2,,,Unknown,,cid:43)(cid:2)(cid:1)(cid:34)(cid:34)(cid:19)(cid:18)(cid:18)(cid:2)(cid:44,,16191.0
,,44,,,Unknown,,cid:43)(cid:2)(cid:1)(cid:34)(cid:34)(cid:19)(cid:18)(cid:18)(cid:2)(cid:44,,16235.0
,,12,,,Unknown,,cid:43)(cid:2)(cid:1)(cid:34)(cid:34)(cid:19)(cid:18)(cid:18)(cid:2)(cid:44,,16247.0
,,29,,,Unknown,,cid:43)(cid:2)(cid:1)(cid:34)(cid:34)(cid:19)(cid:18)(cid:18)(cid:2)(cid:44,,16276.0
,,26,,,Unknown,,cid:43)(cid:2)(cid:1)(cid:34)(cid:34)(cid:19)(cid:18)(cid:18)(cid:2)(cid:44,,16302.0
,,41,,,Unknown,,cid:43)(cid:2)(cid:1)(cid:34)(cid:34)(cid:19)(cid:18)(cid:18)(cid:2)(cid:44,,16343.0
,,25,,,Unknown,,cid:43)(cid:2)(cid:1)(cid:34)(cid:34)(cid:19)(cid:18)(cid:18)(cid:2)(cid:44,,16368.0
,,2,,,Unknown,,cid:43)(cid:2)(cid:1)(cid:34)(cid:34)(cid:19)(cid:18)(cid:18)(cid:2)(cid:44,,16370.0
,,50,,,Unknown,,cid:43)(cid:2)(cid:1)(cid:34)(cid:34)(cid:19)(cid:18)(cid:18)(cid:2)(cid:44,,16420.0
,,50,,,Unknown,,cid:43)(cid:2)(cid:1)(cid:34)(cid:34)(cid:19)(cid:18)(cid:18)(cid:2)(cid:44,,16470.0
,,37,,,Unknown,,cid:43)(cid:2)(cid:1)(cid:34)(cid:34)(cid:19)(cid:18)(cid:18)(cid:2)(cid:44,,16507.0
,,16,,,Unknown,,cid:43)(cid:2)(cid:1)(cid:34)(cid:34)(cid:19)(cid:18)(cid:18)(cid:2)(cid:44,,16523.0
,,34,,,Unknown,,cid:43)(cid:2)(cid:1)(cid:34)(cid:34)(cid:19)(cid:18)(cid:18)(cid:2)(cid:44,,16557.0
,,33,,,Unknown,,cid:43)(cid:2)(cid:1)(cid:34)(cid:34)(cid:19)(cid:18)(cid:18)(cid:2)(cid:44,,16590.0
,,1,,,Unknown,,cid:43)(cid:2)(cid:1)(cid:34)(cid:34)(cid:19)(cid:18)(cid:18)(cid:2)(cid:44,,16591.0
,,37,,,Unknown,,cid:43)(cid:2)(cid:1)(cid:34)(cid:34)(cid:19)(cid:18)(cid:18)(cid:2)(cid:44,,16628.0
,,45,,,Unknown,,cid:43)(cid:2)(cid:1)(cid:34)(cid:34)(cid:19)(cid:18)(cid:18)(cid:2)(cid:44,,16673.0
,,18,,,Unknown,,cid:43)(cid:2)(cid:1)(cid:34)(cid:34)(cid:19)(cid:18)(cid:18)(cid:2)(cid:44,,16691.0
,,35,,,Unknown,,cid:43)(cid:2)(cid:1)(cid:34)(cid:34)(cid:19)(cid:18)(cid:18)(cid:2)(cid:44,,16726.0
,,46,,,Unknown,,cid:43)(cid:2)(cid:1)(cid:34)(cid:34)(cid:19)(cid:18)(cid:18)(cid:2)(cid:44,,16772.0
,,14,,,Unknown,,cid:43)(cid:2)(cid:1)(cid:34)(cid:34)(cid:19)(cid:18)(cid:18)(cid:2)(cid:44,,16786.0
,,51,,,Unknown,,cid:43)(cid:2)(cid:1)(cid:34)(cid:34)(cid:19)(cid:18)(cid:18)(cid:2)(cid:44,,16837.0
,,7,,,Unknown,,cid:43)(cid:2)(cid:1)(cid:34)(cid:34)(cid:19)(cid:18)(cid:18)(cid:2)(cid:44,,16844.0
,,2,,,Unknown,,cid:43)(cid:2)(cid:1)(cid:34)(cid:34)(cid:19)(cid:18)(cid:18)(cid:2)(cid:44,,16846.0
,,66,,,Unknown,,cid:43)(cid:2)(cid:1)(cid:34)(cid:34)(cid:19)(cid:18)(cid:18)(cid:2)(cid:44,,16912.0
,,2,,,Unknown,,cid:43)(cid:2)(cid:1)(cid:34)(cid:34)(cid:19)(cid:18)(cid:18)(cid:2)(cid:44,,16914.0
,,28,,,Unknown,,cid:43)(cid:2)(cid:1)(cid:34)(cid:34)(cid:19)(cid:18)(cid:18)(cid:2)(cid:44,,16942.0
,,46,,,Unknown,,cid:43)(cid:2)(cid:1)(cid:34)(cid:34)(cid:19)(cid:18)(cid:18)(cid:2)(cid:44,,16988.0
,,9,,,Unknown,,cid:43)(cid:2)(cid:1)(cid:34)(cid:34)(cid:19)(cid:18)(cid:18)(cid:2)(cid:44,,16997.0
,,13,,,Unknown,,cid:43)(cid:2)(cid:1)(cid:34)(cid:34)(cid:19)(cid:18)(cid:18)(cid:2)(cid:44,,17010.0
,,7,,,Unknown,,cid:43)(cid:2)(cid:1)(cid:34)(cid:34)(cid:19)(cid:18)(cid:18)(cid:2)(cid:44,,17017.0
,,11,,,Unknown,,cid:43)(cid:2)(cid:1)(cid:34)(cid:34)(cid:19)(cid:18)(cid:18)(cid:2)(cid:44,,17028.0
,,8,,,Unknown,,cid:43)(cid:2)(cid:1)(cid:34)(cid:34)(cid:19)(cid:18)(cid:18)(cid:2)(cid:44,,17036.0
,,2,,,Unknown,,cid:43)(cid:2)(cid:1)(cid:34)(cid:34)(cid:19)(cid:18)(cid:18)(cid:2)(cid:44,,17038.0
,,15,,,Unknown,,cid:43)(cid:2)(cid:1)(cid:34)(cid:34)(cid:19)(cid:18)(cid:18)(cid:2)(cid:44,,17053.0
,,10,,,Unknown,,cid:43)(cid:2)(cid:1)(cid:34)(cid:34)(cid:19)(cid:18)(cid:18)(cid:2)(cid:44,,17063.0
,,24,,,Unknown,,cid:43)(cid:2)(cid:1)(cid:34)(cid:34)(cid:19)(cid:18)(cid:18)(cid:2)(cid:44,,17087.0
,,23,,,Unknown,,cid:43)(cid:2)(cid:1)(cid:34)(cid:34)(cid:19)(cid:18)(cid:18)(cid:2)(cid:44,,17110.0
,,47,,,Unknown,,cid:43)(cid:2)(cid:1)(cid:34)(cid:34)(cid:19)(cid:18)(cid:18)(cid:2)(cid:44,,17157.0
,,2,,,Unknown,,cid:43)(cid:2)(cid:1)(cid:34)(cid:34)(cid:19)(cid:18)(cid:18)(cid:2)(cid:44,,17159.0
,,39,,,Unknown,,cid:43)(cid:2)(cid:1)(cid:34)(cid:34)(cid:19)(cid:18)(cid:18)(cid:2)(cid:44,,17198.0
,,3,,,Unknown,,cid:43)(cid:2)(cid:1)(cid:34)(cid:34)(cid:19)(cid:18)(cid:18)(cid:2)(cid:44,,17201.0
,,7,,,Unknown,,cid:43)(cid:2)(cid:1)(cid:34)(cid:34)(cid:19)(cid:18)(cid:18)(cid:2)(cid:44,,17208.0
,,9,,,Unknown,,cid:43)(cid:2)(cid:1)(cid:34)(cid:34)(cid:19)(cid:18)(cid:18)(cid:2)(cid:44,,17217.0
,,13,,,Unknown,,cid:43)(cid:2)(cid:1)(cid:34)(cid:34)(cid:19)(cid:18)(cid:18)(cid:2)(cid:44,,17230.0
,,10,,,Unknown,,cid:43)(cid:2)(cid:1)(cid:34)(cid:34)(cid:19)(cid:18)(cid:18)(cid:2)(cid:44,,17240.0
,,7,,,Unknown,,cid:43)(cid:2)(cid:1)(cid:34)(cid:34)(cid:19)(cid:18)(cid:18)(cid:2)(cid:44,,17247.0
,,8,,,Unknown,,cid:43)(cid:2)(cid:1)(cid:34)(cid:34)(cid:19)(cid:18)(cid:18)(cid:2)(cid:44,,17255.0
,,46,,,Unknown,,cid:43)(cid:2)(cid:1)(cid:34)(cid:34)(cid:19)(cid:18)(cid:18)(cid:2)(cid:44,,17301.0
,,2,,,Unknown,,cid:43)(cid:2)(cid:1)(cid:34)(cid:34)(cid:19)(cid:18)(cid:18)(cid:2)(cid:44,,17303.0
,,38,,,Unknown,,cid:43)(cid:2)(cid:1)(cid:34)(cid:34)(cid:19)(cid:18)(cid:18)(cid:2)(cid:44,,17341.0
,,64,,,Unknown,,cid:43)(cid:2)(cid:1)(cid:34)(cid:34)(cid:19)(cid:18)(cid:18)(cid:2)(cid:44,,17405.0
,,15,,,Unknown,,cid:43)(cid:2)(cid:1)(cid:34)(cid:34)(cid:19)(cid:18)(cid:18)(cid:2)(cid:44,,17420.0
,,2,,,Unknown,,cid:43)(cid:2)(cid:1)(cid:34)(cid:34)(cid:19)(cid:18)(cid:18)(cid:2)(cid:44,,17422.0
,,36,,,Unknown,,cid:43)(cid:2)(cid:1)(cid:34)(cid:34)(cid:19)(cid:18)(cid:18)(cid:2)(cid:44,,17458.0
,,33,,,Unknown,,cid:43)(cid:2)(cid:1)(cid:34)(cid:34)(cid:19)(cid:18)(cid:18)(cid:2)(cid:44,,17491.0
,,19,,,Unknown,,cid:43)(cid:2)(cid:1)(cid:34)(cid:34)(cid:19)(cid:18)(cid:18)(cid:2)(cid:44,,17510.0
,,34,,,Unknown,,cid:43)(cid:2)(cid:1)(cid:34)(cid:34)(cid:19)(cid:18)(cid:18)(cid:2)(cid:44,,17544.0
,,18,,,Unknown,,cid:43)(cid:2)(cid:1)(cid:34)(cid:34)(cid:19)(cid:18)(cid:18)(cid:2)(cid:44,,17562.0
,,2,,,Unknown,,cid:43)(cid:2)(cid:1)(cid:34)(cid:34)(cid:19)(cid:18)(cid:18)(cid:2)(cid:44,,17564.0
,,44,,,Unknown,,cid:43)(cid:2)(cid:1)(cid:34)(cid:34)(cid:19)(cid:18)(cid:18)(cid:2)(cid:44,,17608.0
,,12,,,Unknown,,cid:43)(cid:2)(cid:1)(cid:34)(cid:34)(cid:19)(cid:18)(cid:18)(cid:2)(cid:44,,17620.0
,,29,,,Unknown,,cid:43)(cid:2)(cid:1)(cid:34)(cid:34)(cid:19)(cid:18)(cid:18)(cid:2)(cid:44,,17649.0
,,26,,,Unknown,,cid:43)(cid:2)(cid:1)(cid:34)(cid:34)(cid:19)(cid:18)(cid:18)(cid:2)(cid:44,,17675.0
,,41,,,Unknown,,cid:43)(cid:2)(cid:1)(cid:34)(cid:34)(cid:19)(cid:18)(cid:18)(cid:2)(cid:44,,17716.0
,,25,,,Unknown,,cid:43)(cid:2)(cid:1)(cid:34)(cid:34)(cid:19)(cid:18)(cid:18)(cid:2)(cid:44,,17741.0
,,2,,,Unknown,,cid:43)(cid:2)(cid:1)(cid:34)(cid:34)(cid:19)(cid:18)(cid:18)(cid:2)(cid:44,,17743.0
,,50,,,Unknown,,cid:43)(cid:2)(cid:1)(cid:34)(cid:34)(cid:19)(cid:18)(cid:18)(cid:2)(cid:44,,17793.0
,,50,,,Unknown,,cid:43)(cid:2)(cid:1)(cid:34)(cid:34)(cid:19)(cid:18)(cid:18)(cid:2)(cid:44,,17843.0
,,18,,,Unknown,,cid:43)(cid:2)(cid:1)(cid:34)(cid:34)(cid:19)(cid:18)(cid:18)(cid:2)(cid:44,,17861.0
,,1,,,Unknown,,cid:43)(cid:2)(cid:1)(cid:34)(cid:34)(cid:19)(cid:18)(cid:18)(cid:2)(cid:44,,17862.0
,,1,,,Unknown,,cid:43)(cid:2)(cid:1)(cid:34)(cid:34)(cid:19)(cid:18)(cid:18)(cid:2)(cid:44,,17863.0
,,37,,,Unknown,,cid:43)(cid:2)(cid:1)(cid:34)(cid:34)(cid:19)(cid:18)(cid:18)(cid:2)(cid:44,,17900.0
,,1,,,Unknown,,cid:43)(cid:2)(cid:1)(cid:34)(cid:34)(cid:19)(cid:18)(cid:18)(cid:2)(cid:44,,17901.0
,,37,,,Unknown,,cid:43)(cid:2)(cid:1)(cid:34)(cid:34)(cid:19)(cid:18)(cid:18)(cid:2)(cid:44,,17938.0
,,45,,,Unknown,,cid:43)(cid:2)(cid:1)(cid:34)(cid:34)(cid:19)(cid:18)(cid:18)(cid:2)(cid:44,,17983.0
,,18,,,Unknown,,cid:43)(cid:2)(cid:1)(cid:34)(cid:34)(cid:19)(cid:18)(cid:18)(cid:2)(cid:44,,18001.0
,,35,,,Unknown,,cid:43)(cid:2)(cid:1)(cid:34)(cid:34)(cid:19)(cid:18)(cid:18)(cid:2)(cid:44,,18036.0
,,51,,,Unknown,,cid:43)(cid:2)(cid:1)(cid:34)(cid:34)(cid:19)(cid:18)(cid:18)(cid:2)(cid:44,,18087.0
,,5,,,Unknown,,cid:43)(cid:2)(cid:1)(cid:34)(cid:34)(cid:19)(cid:18)(cid:18)(cid:2)(cid:44,,18092.0
,,67,,,Unknown,,cid:43)(cid:2)(cid:1)(cid:34)(cid:34)(cid:19)(cid:18)(cid:18)(cid:2)(cid:44,,18159.0
,,46,,,Unknown,,cid:43)(cid:2)(cid:1)(cid:34)(cid:34)(cid:19)(cid:18)(cid:18)(cid:2)(cid:44,,18205.0
,,2,,,Unknown,,cid:43)(cid:2)(cid:1)(cid:34)(cid:34)(cid:19)(cid:18)(cid:18)(cid:2)(cid:44,,18207.0
,,10,,,Unknown,,cid:43)(cid:2)(cid:1)(cid:34)(cid:34)(cid:19)(cid:18)(cid:18)(cid:2)(cid:44,,18217.0
,,3,,,Unknown,,cid:43)(cid:2)(cid:1)(cid:34)(cid:34)(cid:19)(cid:18)(cid:18)(cid:2)(cid:44,,18220.0
,,46,,,Unknown,,cid:43)(cid:2)(cid:1)(cid:34)(cid:34)(cid:19)(cid:18)(cid:18)(cid:2)(cid:44,,18266.0
,,49,,,Unknown,,cid:43)(cid:2)(cid:1)(cid:34)(cid:34)(cid:19)(cid:18)(cid:18)(cid:2)(cid:44,,18315.0
,,5,,,Unknown,,cid:43)(cid:2)(cid:1)(cid:34)(cid:34)(cid:19)(cid:18)(cid:18)(cid:2)(cid:44,,18320.0
,,2,,,Unknown,,cid:43)(cid:2)(cid:1)(cid:34)(cid:34)(cid:19)(cid:18)(cid:18)(cid:2)(cid:44,,18322.0
,,9,,,Unknown,,cid:43)(cid:2)(cid:1)(cid:34)(cid:34)(cid:19)(cid:18)(cid:18)(cid:2)(cid:44,,18331.0
,,13,,,Unknown,,cid:43)(cid:2)(cid:1)(cid:34)(cid:34)(cid:19)(cid:18)(cid:18)(cid:2)(cid:44,,18344.0
,,39,,,Unknown,,cid:43)(cid:2)(cid:1)(cid:34)(cid:34)(cid:19)(cid:18)(cid:18)(cid:2)(cid:44,,18383.0
,,67,,,Unknown,,cid:43)(cid:2)(cid:1)(cid:34)(cid:34)(cid:19)(cid:18)(cid:18)(cid:2)(cid:44,,18450.0
,,2,,,Unknown,,cid:43)(cid:2)(cid:1)(cid:34)(cid:34)(cid:19)(cid:18)(cid:18)(cid:2)(cid:44,,18452.0
,,39,,,Unknown,,cid:43)(cid:2)(cid:1)(cid:34)(cid:34)(cid:19)(cid:18)(cid:18)(cid:2)(cid:44,,18491.0
,,3,,,Unknown,,cid:43)(cid:2)(cid:1)(cid:34)(cid:34)(cid:19)(cid:18)(cid:18)(cid:2)(cid:44,,18494.0
,,7,,,Unknown,,cid:43)(cid:2)(cid:1)(cid:34)(cid:34)(cid:19)(cid:18)(cid:18)(cid:2)(cid:44,,18501.0
,,9,,,Unknown,,cid:43)(cid:2)(cid:1)(cid:34)(cid:34)(cid:19)(cid:18)(cid:18)(cid:2)(cid:44,,18510.0
,,13,,,Unknown,,cid:43)(cid:2)(cid:1)(cid:34)(cid:34)(cid:19)(cid:18)(cid:18)(cid:2)(cid:44,,18523.0
,,10,,,Unknown,,cid:43)(cid:2)(cid:1)(cid:34)(cid:34)(cid:19)(cid:18)(cid:18)(cid:2)(cid:44,,18533.0
,,7,,,Unknown,,cid:43)(cid:2)(cid:1)(cid:34)(cid:34)(cid:19)(cid:18)(cid:18)(cid:2)(cid:44,,18540.0
,,8,,,Unknown,,cid:43)(cid:2)(cid:1)(cid:34)(cid:34)(cid:19)(cid:18)(cid:18)(cid:2)(cid:44,,18548.0
,,46,,,Unknown,,cid:43)(cid:2)(cid:1)(cid:34)(cid:34)(cid:19)(cid:18)(cid:18)(cid:2)(cid:44,,18594.0
,,2,,,Unknown,,cid:43)(cid:2)(cid:1)(cid:34)(cid:34)(cid:19)(cid:18)(cid:18)(cid:2)(cid:44,,18596.0
,,38,,,Unknown,,cid:43)(cid:2)(cid:1)(cid:34)(cid:34)(cid:19)(cid:18)(cid:18)(cid:2)(cid:44,,18634.0
,,64,,,Unknown,,cid:43)(cid:2)(cid:1)(cid:34)(cid:34)(cid:19)(cid:18)(cid:18)(cid:2)(cid:44,,18698.0
,,15,,,Unknown,,cid:43)(cid:2)(cid:1)(cid:34)(cid:34)(cid:19)(cid:18)(cid:18)(cid:2)(cid:44,,18713.0
,,2,,,Unknown,,cid:43)(cid:2)(cid:1)(cid:34)(cid:34)(cid:19)(cid:18)(cid:18)(cid:2)(cid:44,,18715.0
,,17,,,Unknown,,cid:43)(cid:2)(cid:1)(cid:34)(cid:34)(cid:19)(cid:18)(cid:18)(cid:2)(cid:44,,18732.0
,,18,,,Unknown,,cid:43)(cid:2)(cid:1)(cid:34)(cid:34)(cid:19)(cid:18)(cid:18)(cid:2)(cid:44,,18750.0
,,19,,,Unknown,,cid:43)(cid:2)(cid:1)(cid:34)(cid:34)(cid:19)(cid:18)(cid:18)(cid:2)(cid:44,,18769.0
,,37,,,Unknown,,cid:43)(cid:2)(cid:1)(cid:34)(cid:34)(cid:19)(cid:18)(cid:18)(cid:2)(cid:44,,18806.0
,,33,,,Unknown,,cid:43)(cid:2)(cid:1)(cid:34)(cid:34)(cid:19)(cid:18)(cid:18)(cid:2)(cid:44,,18839.0
,,2,,,Unknown,,cid:43)(cid:2)(cid:1)(cid:34)(cid:34)(cid:19)(cid:18)(cid:18)(cid:2)(cid:44,,18841.0
,,44,,,Unknown,,cid:43)(cid:2)(cid:1)(cid:34)(cid:34)(cid:19)(cid:18)(cid:18)(cid:2)(cid:44,,18885.0
,,12,,,Unknown,,cid:43)(cid:2)(cid:1)(cid:34)(cid:34)(cid:19)(cid:18)(cid:18)(cid:2)(cid:44,,18897.0
,,29,,,Unknown,,cid:43)(cid:2)(cid:1)(cid:34)(cid:34)(cid:19)(cid:18)(cid:18)(cid:2)(cid:44,,18926.0
,,26,,,Unknown,,cid:43)(cid:2)(cid:1)(cid:34)(cid:34)(cid:19)(cid:18)(cid:18)(cid:2)(cid:44,,18952.0
,,41,,,Unknown,,cid:43)(cid:2)(cid:1)(cid:34)(cid:34)(cid:19)(cid:18)(cid:18)(cid:2)(cid:44,,18993.0
,,25,,,Unknown,,cid:43)(cid:2)(cid:1)(cid:34)(cid:34)(cid:19)(cid:18)(cid:18)(cid:2)(cid:44,,19018.0
,,2,,,Unknown,,cid:43)(cid:2)(cid:1)(cid:34)(cid:34)(cid:19)(cid:18)(cid:18)(cid:2)(cid:44,,19020.0
,,50,,,Unknown,,cid:43)(cid:2)(cid:1)(cid:34)(cid:34)(cid:19)(cid:18)(cid:18)(cid:2)(cid:44,,19070.0
,,50,,,Unknown,,cid:43)(cid:2)(cid:1)(cid:34)(cid:34)(cid:19)(cid:18)(cid:18)(cid:2)(cid:44,,19120.0
,,37,,,Unknown,,cid:43)(cid:2)(cid:1)(cid:34)(cid:34)(cid:19)(cid:18)(cid:18)(cid:2)(cid:44,,19157.0
,,16,,,Unknown,,cid:43)(cid:2)(cid:1)(cid:34)(cid:34)(cid:19)(cid:18)(cid:18)(cid:2)(cid:44,,19173.0
,,34,,,Unknown,,cid:43)(cid:2)(cid:1)(cid:34)(cid:34)(cid:19)(cid:18)(cid:18)(cid:2)(cid:44,,19207.0
,,33,,,Unknown,,cid:43)(cid:2)(cid:1)(cid:34)(cid:34)(cid:19)(cid:18)(cid:18)(cid:2)(cid:44,,19240.0
,,1,,,Unknown,,cid:43)(cid:2)(cid:1)(cid:34)(cid:34)(cid:19)(cid:18)(cid:18)(cid:2)(cid:44,,19241.0
,,36,,,Unknown,,cid:43)(cid:2)(cid:1)(cid:34)(cid:34)(cid:19)(cid:18)(cid:18)(cid:2)(cid:44,,19277.0
,,45,,,Unknown,,cid:43)(cid:2)(cid:1)(cid:34)(cid:34)(cid:19)(cid:18)(cid:18)(cid:2)(cid:44,,19322.0
,,18,,,Unknown,,cid:43)(cid:2)(cid:1)(cid:34)(cid:34)(cid:19)(cid:18)(cid:18)(cid:2)(cid:44,,19340.0
,,35,,,Unknown,,cid:43)(cid:2)(cid:1)(cid:34)(cid:34)(cid:19)(cid:18)(cid:18)(cid:2)(cid:44,,19375.0
,,9,,,Unknown,,cid:43)(cid:2)(cid:1)(cid:34)(cid:34)(cid:19)(cid:18)(cid:18)(cid:2)(cid:44,,19384.0
,,39,,,Unknown,,cid:43)(cid:2)(cid:1)(cid:34)(cid:34)(cid:19)(cid:18)(cid:18)(cid:2)(cid:44,,19423.0
,,11,,,Unknown,,cid:43)(cid:2)(cid:1)(cid:34)(cid:34)(cid:19)(cid:18)(cid:18)(cid:2)(cid:44,,19434.0
,,3,,,Unknown,,cid:43)(cid:2)(cid:1)(cid:34)(cid:34)(cid:19)(cid:18)(cid:18)(cid:2)(cid:44,,19437.0
,,10,,,Unknown,,cid:43)(cid:2)(cid:1)(cid:34)(cid:34)(cid:19)(cid:18)(cid:18)(cid:2)(cid:44,,19447.0
,,2,,,Unknown,,cid:43)(cid:2)(cid:1)(cid:34)(cid:34)(cid:19)(cid:18)(cid:18)(cid:2)(cid:44,,19449.0
,,7,,,Unknown,,cid:43)(cid:2)(cid:1)(cid:34)(cid:34)(cid:19)(cid:18)(cid:18)(cid:2)(cid:44,,19456.0
,,8,,,Unknown,,cid:43)(cid:2)(cid:1)(cid:34)(cid:34)(cid:19)(cid:18)(cid:18)(cid:2)(cid:44,,19464.0
,,15,,,Unknown,,cid:43)(cid:2)(cid:1)(cid:34)(cid:34)(cid:19)(cid:18)(cid:18)(cid:2)(cid:44,,19479.0
,,7,,,Unknown,,cid:43)(cid:2)(cid:1)(cid:34)(cid:34)(cid:19)(cid:18)(cid:18)(cid:2)(cid:44,,19486.0
,,8,,,Unknown,,cid:43)(cid:2)(cid:1)(cid:34)(cid:34)(cid:19)(cid:18)(cid:18)(cid:2)(cid:44,,19494.0
,,10,,,Unknown,,cid:43)(cid:2)(cid:1)(cid:34)(cid:34)(cid:19)(cid:18)(cid:18)(cid:2)(cid:44,,19504.0
,,5,,,Unknown,,cid:43)(cid:2)(cid:1)(cid:34)(cid:34)(cid:19)(cid:18)(cid:18)(cid:2)(cid:44,,19509.0
,,3,,,Unknown,,cid:43)(cid:2)(cid:1)(cid:34)(cid:34)(cid:19)(cid:18)(cid:18)(cid:2)(cid:44,,19512.0
,,2,,,Unknown,,cid:43)(cid:2)(cid:1)(cid:34)(cid:34)(cid:19)(cid:18)(cid:18)(cid:2)(cid:44,,19514.0
,,9,,,Unknown,,cid:43)(cid:2)(cid:1)(cid:34)(cid:34)(cid:19)(cid:18)(cid:18)(cid:2)(cid:44,,19523.0
,,39,,,Unknown,,cid:43)(cid:2)(cid:1)(cid:34)(cid:34)(cid:19)(cid:18)(cid:18)(cid:2)(cid:44,,19562.0
,,11,,,Unknown,,cid:43)(cid:2)(cid:1)(cid:34)(cid:34)(cid:19)(cid:18)(cid:18)(cid:2)(cid:44,,19573.0
,,3,,,Unknown,,cid:43)(cid:2)(cid:1)(cid:34)(cid:34)(cid:19)(cid:18)(cid:18)(cid:2)(cid:44,,19576.0
,,10,,,Unknown,,cid:43)(cid:2)(cid:1)(cid:34)(cid:34)(cid:19)(cid:18)(cid:18)(cid:2)(cid:44,,19586.0
,,2,,,Unknown,,cid:43)(cid:2)(cid:1)(cid:34)(cid:34)(cid:19)(cid:18)(cid:18)(cid:2)(cid:44,,19588.0
,,39,,,Unknown,,cid:43)(cid:2)(cid:1)(cid:34)(cid:34)(cid:19)(cid:18)(cid:18)(cid:2)(cid:44,,19627.0
,,3,,,Unknown,,cid:43)(cid:2)(cid:1)(cid:34)(cid:34)(cid:19)(cid:18)(cid:18)(cid:2)(cid:44,,19630.0
,,7,,,Unknown,,cid:43)(cid:2)(cid:1)(cid:34)(cid:34)(cid:19)(cid:18)(cid:18)(cid:2)(cid:44,,19637.0
,,9,,,Unknown,,cid:43)(cid:2)(cid:1)(cid:34)(cid:34)(cid:19)(cid:18)(cid:18)(cid:2)(cid:44,,19646.0
,,13,,,Unknown,,cid:43)(cid:2)(cid:1)(cid:34)(cid:34)(cid:19)(cid:18)(cid:18)(cid:2)(cid:44,,19659.0
,,10,,,Unknown,,cid:43)(cid:2)(cid:1)(cid:34)(cid:34)(cid:19)(cid:18)(cid:18)(cid:2)(cid:44,,19669.0
,,7,,,Unknown,,cid:43)(cid:2)(cid:1)(cid:34)(cid:34)(cid:19)(cid:18)(cid:18)(cid:2)(cid:44,,19676.0
,,8,,,Unknown,,cid:43)(cid:2)(cid:1)(cid:34)(cid:34)(cid:19)(cid:18)(cid:18)(cid:2)(cid:44,,19684.0
,,5,,,Unknown,,cid:43)(cid:2)(cid:1)(cid:34)(cid:34)(cid:19)(cid:18)(cid:18)(cid:2)(cid:44,,19689.0
,,2,,,Unknown,,cid:43)(cid:2)(cid:1)(cid:34)(cid:34)(cid:19)(cid:18)(cid:18)(cid:2)(cid:44,,19691.0
,,38,,,Unknown,,cid:43)(cid:2)(cid:1)(cid:34)(cid:34)(cid:19)(cid:18)(cid:18)(cid:2)(cid:44,,19729.0
,,64,,,Unknown,,cid:43)(cid:2)(cid:1)(cid:34)(cid:34)(cid:19)(cid:18)(cid:18)(cid:2)(cid:44,,19793.0
,,15,,,Unknown,,cid:43)(cid:2)(cid:1)(cid:34)(cid:34)(cid:19)(cid:18)(cid:18)(cid:2)(cid:44,,19808.0
,,2,,,Unknown,,cid:43)(cid:2)(cid:1)(cid:34)(cid:34)(cid:19)(cid:18)(cid:18)(cid:2)(cid:44,,19810.0
,,17,,,Unknown,,cid:43)(cid:2)(cid:1)(cid:34)(cid:34)(cid:19)(cid:18)(cid:18)(cid:2)(cid:44,,19827.0
,,1,,,Unknown,,cid:43)(cid:2)(cid:1)(cid:34)(cid:34)(cid:19)(cid:18)(cid:18)(cid:2)(cid:44,,19828.0
,,1,,,Unknown,,cid:43)(cid:2)(cid:1)(cid:34)(cid:34)(cid:19)(cid:18)(cid:18)(cid:2)(cid:44,,19829.0
,,19,,,Unknown,,cid:43)(cid:2)(cid:1)(cid:34)(cid:34)(cid:19)(cid:18)(cid:18)(cid:2)(cid:44,,19848.0
,,18,,,Unknown,,cid:43)(cid:2)(cid:1)(cid:34)(cid:34)(cid:19)(cid:18)(cid:18)(cid:2)(cid:44,,19866.0
,,18,,,Unknown,,cid:43)(cid:2)(cid:1)(cid:34)(cid:34)(cid:19)(cid:18)(cid:18)(cid:2)(cid:44,,19884.0
,,2,,,Unknown,,cid:43)(cid:2)(cid:1)(cid:34)(cid:34)(cid:19)(cid:18)(cid:18)(cid:2)(cid:44,,19886.0
,,44,,,Unknown,,cid:43)(cid:2)(cid:1)(cid:34)(cid:34)(cid:19)(cid:18)(cid:18)(cid:2)(cid:44,,19930.0
,,12,,,Unknown,,cid:43)(cid:2)(cid:1)(cid:34)(cid:34)(cid:19)(cid:18)(cid:18)(cid:2)(cid:44,,19942.0
,,29,,,Unknown,,cid:43)(cid:2)(cid:1)(cid:34)(cid:34)(cid:19)(cid:18)(cid:18)(cid:2)(cid:44,,19971.0
,,26,,,Unknown,,cid:43)(cid:2)(cid:1)(cid:34)(cid:34)(cid:19)(cid:18)(cid:18)(cid:2)(cid:44,,19997.0
,,41,,,Unknown,,cid:43)(cid:2)(cid:1)(cid:34)(cid:34)(cid:19)(cid:18)(cid:18)(cid:2)(cid:44,,20038.0
,,25,,,Unknown,,cid:43)(cid:2)(cid:1)(cid:34)(cid:34)(cid:19)(cid:18)(cid:18)(cid:2)(cid:44,,20063.0
,,2,,,Unknown,,cid:43)(cid:2)(cid:1)(cid:34)(cid:34)(cid:19)(cid:18)(cid:18)(cid:2)(cid:44,,20065.0
,,50,,,Unknown,,cid:43)(cid:2)(cid:1)(cid:34)(cid:34)(cid:19)(cid:18)(cid:18)(cid:2)(cid:44,,20115.0
,,50,,,Unknown,,cid:43)(cid:2)(cid:1)(cid:34)(cid:34)(cid:19)(cid:18)(cid:18)(cid:2)(cid:44,,20165.0
,,18,,,Unknown,,cid:43)(cid:2)(cid:1)(cid:34)(cid:34)(cid:19)(cid:18)(cid:18)(cid:2)(cid:44,,20183.0
,,1,,,Unknown,,cid:43)(cid:2)(cid:1)(cid:34)(cid:34)(cid:19)(cid:18)(cid:18)(cid:2)(cid:44,,20184.0
,,1,,,Unknown,,cid:43)(cid:2)(cid:1)(cid:34)(cid:34)(cid:19)(cid:18)(cid:18)(cid:2)(cid:44,,20185.0
,,37,,,Unknown,,cid:43)(cid:2)(cid:1)(cid:34)(cid:34)(cid:19)(cid:18)(cid:18)(cid:2)(cid:44,,20222.0
,,1,,,Unknown,,cid:43)(cid:2)(cid:1)(cid:34)(cid:34)(cid:19)(cid:18)(cid:18)(cid:2)(cid:44,,20223.0
,,36,,,Unknown,,cid:43)(cid:2)(cid:1)(cid:34)(cid:34)(cid:19)(cid:18)(cid:18)(cid:2)(cid:44,,20259.0
,,45,,,Unknown,,cid:43)(cid:2)(cid:1)(cid:34)(cid:34)(cid:19)(cid:18)(cid:18)(cid:2)(cid:44,,20304.0
,,18,,,Unknown,,cid:43)(cid:2)(cid:1)(cid:34)(cid:34)(cid:19)(cid:18)(cid:18)(cid:2)(cid:44,,20322.0
,,35,,,Unknown,,cid:43)(cid:2)(cid:1)(cid:34)(cid:34)(cid:19)(cid:18)(cid:18)(cid:2)(cid:44,,20357.0
,,53,,,Unknown,,cid:43)(cid:2)(cid:1)(cid:34)(cid:34)(cid:19)(cid:18)(cid:18)(cid:2)(cid:44,,20410.0
,,5,,,Unknown,,cid:43)(cid:2)(cid:1)(cid:34)(cid:34)(cid:19)(cid:18)(cid:18)(cid:2)(cid:44,,20415.0
,,8,,,Unknown,,cid:43)(cid:2)(cid:1)(cid:34)(cid:34)(cid:19)(cid:18)(cid:18)(cid:2)(cid:44,,20423.0
,,5,,,Unknown,,cid:43)(cid:2)(cid:1)(cid:34)(cid:34)(cid:19)(cid:18)(cid:18)(cid:2)(cid:44,,20428.0
,,3,,,Unknown,,cid:43)(cid:2)(cid:1)(cid:34)(cid:34)(cid:19)(cid:18)(cid:18)(cid:2)(cid:44,,20431.0
,,46,,,Unknown,,cid:43)(cid:2)(cid:1)(cid:34)(cid:34)(cid:19)(cid:18)(cid:18)(cid:2)(cid:44,,20477.0
,,14,,,Unknown,,cid:43)(cid:2)(cid:1)(cid:34)(cid:34)(cid:19)(cid:18)(cid:18)(cid:2)(cid:44,,20491.0
,,7,,,Unknown,,cid:43)(cid:2)(cid:1)(cid:34)(cid:34)(cid:19)(cid:18)(cid:18)(cid:2)(cid:44,,20498.0
,,2,,,Unknown,,cid:43)(cid:2)(cid:1)(cid:34)(cid:34)(cid:19)(cid:18)(cid:18)(cid:2)(cid:44,,20500.0
,,7,,,Unknown,,cid:43)(cid:2)(cid:1)(cid:34)(cid:34)(cid:19)(cid:18)(cid:18)(cid:2)(cid:44,,20507.0
,,46,,,Unknown,,cid:43)(cid:2)(cid:1)(cid:34)(cid:34)(cid:19)(cid:18)(cid:18)(cid:2)(cid:44,,20553.0
,,3,,,Unknown,,cid:43)(cid:2)(cid:1)(cid:34)(cid:34)(cid:19)(cid:18)(cid:18)(cid:2)(cid:44,,20556.0
,,49,,,Unknown,,cid:43)(cid:2)(cid:1)(cid:34)(cid:34)(cid:19)(cid:18)(cid:18)(cid:2)(cid:44,,20605.0
,,2,,,Unknown,,cid:43)(cid:2)(cid:1)(cid:34)(cid:34)(cid:19)(cid:18)(cid:18)(cid:2)(cid:44,,20607.0
,,9,,,Unknown,,cid:43)(cid:2)(cid:1)(cid:34)(cid:34)(cid:19)(cid:18)(cid:18)(cid:2)(cid:44,,20616.0
,,46,,,Unknown,,cid:43)(cid:2)(cid:1)(cid:34)(cid:34)(cid:19)(cid:18)(cid:18)(cid:2)(cid:44,,20662.0
,,15,,,Unknown,,cid:43)(cid:2)(cid:1)(cid:34)(cid:34)(cid:19)(cid:18)(cid:18)(cid:2)(cid:44,,20677.0
,,2,,,Unknown,,cid:43)(cid:2)(cid:1)(cid:34)(cid:34)(cid:19)(cid:18)(cid:18)(cid:2)(cid:44,,20679.0
,,1,,,Unknown,,cid:43)(cid:2)(cid:1)(cid:34)(cid:34)(cid:19)(cid:18)(cid:18)(cid:2)(cid:44,,20680.0
,,37,,,Unknown,,cid:43)(cid:2)(cid:1)(cid:34)(cid:34)(cid:19)(cid:18)(cid:18)(cid:2)(cid:44,,20717.0
,,16,,,Unknown,,cid:43)(cid:2)(cid:1)(cid:34)(cid:34)(cid:19)(cid:18)(cid:18)(cid:2)(cid:44,,20733.0
,,19,,,Unknown,,cid:43)(cid:2)(cid:1)(cid:34)(cid:34)(cid:19)(cid:18)(cid:18)(cid:2)(cid:44,,20752.0
,,16,,,Unknown,,cid:43)(cid:2)(cid:1)(cid:34)(cid:34)(cid:19)(cid:18)(cid:18)(cid:2)(cid:44,,20768.0
,,35,,,Unknown,,cid:43)(cid:2)(cid:1)(cid:34)(cid:34)(cid:19)(cid:18)(cid:18)(cid:2)(cid:44,,20803.0
,,2,,,Unknown,,cid:43)(cid:2)(cid:1)(cid:34)(cid:34)(cid:19)(cid:18)(cid:18)(cid:2)(cid:44,,20805.0
,,44,,,Unknown,,cid:43)(cid:2)(cid:1)(cid:34)(cid:34)(cid:19)(cid:18)(cid:18)(cid:2)(cid:44,,20849.0
,,3,,,Unknown,,cid:43)(cid:2)(cid:1)(cid:34)(cid:34)(cid:19)(cid:18)(cid:18)(cid:2)(cid:44,,20852.0
,,5,,,Unknown,,cid:43)(cid:2)(cid:1)(cid:34)(cid:34)(cid:19)(cid:18)(cid:18)(cid:2)(cid:44,,20857.0
,,39,,,Unknown,,cid:43)(cid:2)(cid:1)(cid:34)(cid:34)(cid:19)(cid:18)(cid:18)(cid:2)(cid:44,,20896.0
,,3,,,Unknown,,cid:43)(cid:2)(cid:1)(cid:34)(cid:34)(cid:19)(cid:18)(cid:18)(cid:2)(cid:44,,20899.0
,,5,,,Unknown,,cid:43)(cid:2)(cid:1)(cid:34)(cid:34)(cid:19)(cid:18)(cid:18)(cid:2)(cid:44,,20904.0
,,9,,,Unknown,,cid:43)(cid:2)(cid:1)(cid:34)(cid:34)(cid:19)(cid:18)(cid:18)(cid:2)(cid:44,,20913.0
,,5,,,Unknown,,cid:43)(cid:2)(cid:1)(cid:34)(cid:34)(cid:19)(cid:18)(cid:18)(cid:2)(cid:44,,20918.0
,,8,,,Unknown,,cid:43)(cid:2)(cid:1)(cid:34)(cid:34)(cid:19)(cid:18)(cid:18)(cid:2)(cid:44,,20926.0
,,10,,,Unknown,,cid:43)(cid:2)(cid:1)(cid:34)(cid:34)(cid:19)(cid:18)(cid:18)(cid:2)(cid:44,,20936.0
,,46,,,Unknown,,cid:43)(cid:2)(cid:1)(cid:34)(cid:34)(cid:19)(cid:18)(cid:18)(cid:2)(cid:44,,20982.0
,,10,,,Unknown,,cid:43)(cid:2)(cid:1)(cid:34)(cid:34)(cid:19)(cid:18)(cid:18)(cid:2)(cid:44,,20992.0
,,7,,,Unknown,,cid:43)(cid:2)(cid:1)(cid:34)(cid:34)(cid:19)(cid:18)(cid:18)(cid:2)(cid:44,,20999.0
,,11,,,Unknown,,cid:43)(cid:2)(cid:1)(cid:34)(cid:34)(cid:19)(cid:18)(cid:18)(cid:2)(cid:44,,21010.0
,,8,,,Unknown,,cid:43)(cid:2)(cid:1)(cid:34)(cid:34)(cid:19)(cid:18)(cid:18)(cid:2)(cid:44,,21018.0
,,2,,,Unknown,,cid:43)(cid:2)(cid:1)(cid:34)(cid:34)(cid:19)(cid:18)(cid:18)(cid:2)(cid:44,,21020.0
,,12,,,Unknown,,cid:43)(cid:2)(cid:1)(cid:34)(cid:34)(cid:19)(cid:18)(cid:18)(cid:2)(cid:44,,21032.0
,,20,,,Unknown,,cid:43)(cid:2)(cid:1)(cid:34)(cid:34)(cid:19)(cid:18)(cid:18)(cid:2)(cid:44,,21052.0
,,30,,,Unknown,,cid:43)(cid:2)(cid:1)(cid:34)(cid:34)(cid:19)(cid:18)(cid:18)(cid:2)(cid:44,,21082.0
,,41,,,Unknown,,cid:43)(cid:2)(cid:1)(cid:34)(cid:34)(cid:19)(cid:18)(cid:18)(cid:2)(cid:44,,21123.0
,,26,,,Unknown,,cid:43)(cid:2)(cid:1)(cid:34)(cid:34)(cid:19)(cid:18)(cid:18)(cid:2)(cid:44,,21149.0
,,29,,,Unknown,,cid:43)(cid:2)(cid:1)(cid:34)(cid:34)(cid:19)(cid:18)(cid:18)(cid:2)(cid:44,,21178.0
,,41,,,Unknown,,cid:43)(cid:2)(cid:1)(cid:34)(cid:34)(cid:19)(cid:18)(cid:18)(cid:2)(cid:44,,21219.0
,,2,,,Unknown,,cid:43)(cid:2)(cid:1)(cid:34)(cid:34)(cid:19)(cid:18)(cid:18)(cid:2)(cid:44,,21221.0
,,46,,,Unknown,,cid:43)(cid:2)(cid:1)(cid:34)(cid:34)(cid:19)(cid:18)(cid:18)(cid:2)(cid:44,,21267.0
,,10,,,Unknown,,cid:43)(cid:2)(cid:1)(cid:34)(cid:34)(cid:19)(cid:18)(cid:18)(cid:2)(cid:44,,21277.0
,,1,,,Unknown,,cid:43)(cid:2)(cid:1)(cid:34)(cid:34)(cid:19)(cid:18)(cid:18)(cid:2)(cid:44,,21278.0
,,37,,,Unknown,,cid:43)(cid:2)(cid:1)(cid:34)(cid:34)(cid:19)(cid:18)(cid:18)(cid:2)(cid:44,,21315.0
,,37,,,Unknown,,cid:43)(cid:2)(cid:1)(cid:34)(cid:34)(cid:19)(cid:18)(cid:18)(cid:2)(cid:44,,21352.0
,,1,,,Unknown,,cid:43)(cid:2)(cid:1)(cid:34)(cid:34)(cid:19)(cid:18)(cid:18)(cid:2)(cid:44,,21353.0
,,34,,,Unknown,,cid:43)(cid:2)(cid:1)(cid:34)(cid:34)(cid:19)(cid:18)(cid:18)(cid:2)(cid:44,,21387.0
,,16,,,Unknown,,cid:43)(cid:2)(cid:1)(cid:34)(cid:34)(cid:19)(cid:18)(cid:18)(cid:2)(cid:44,,21403.0
,,2,,,Unknown,,cid:43)(cid:2)(cid:1)(cid:34)(cid:34)(cid:19)(cid:18)(cid:18)(cid:2)(cid:44,,21405.0
,,15,,,Unknown,,cid:43)(cid:2)(cid:1)(cid:34)(cid:34)(cid:19)(cid:18)(cid:18)(cid:2)(cid:44,,21420.0
,,1,,,Unknown,,cid:43)(cid:2)(cid:1)(cid:34)(cid:34)(cid:19)(cid:18)(cid:18)(cid:2)(cid:44,,21421.0
,,33,,,Unknown,,cid:43)(cid:2)(cid:1)(cid:34)(cid:34)(cid:19)(cid:18)(cid:18)(cid:2)(cid:44,,21454.0
,,18,,,Unknown,,cid:43)(cid:2)(cid:1)(cid:34)(cid:34)(cid:19)(cid:18)(cid:18)(cid:2)(cid:44,,21472.0
,,16,,,Unknown,,cid:43)(cid:2)(cid:1)(cid:34)(cid:34)(cid:19)(cid:18)(cid:18)(cid:2)(cid:44,,21488.0
,,1,,,Unknown,,cid:43)(cid:2)(cid:1)(cid:34)(cid:34)(cid:19)(cid:18)(cid:18)(cid:2)(cid:44,,21489.0
,,18,,,Unknown,,cid:43)(cid:2)(cid:1)(cid:34)(cid:34)(cid:19)(cid:18)(cid:18)(cid:2)(cid:44,,21507.0
,,1,,,Unknown,,cid:43)(cid:2)(cid:1)(cid:34)(cid:34)(cid:19)(cid:18)(cid:18)(cid:2)(cid:44,,21508.0
,,17,,,Unknown,,cid:43)(cid:2)(cid:1)(cid:34)(cid:34)(cid:19)(cid:18)(cid:18)(cid:2)(cid:44,,21525.0
,,17,,,Unknown,,cid:43)(cid:2)(cid:1)(cid:34)(cid:34)(cid:19)(cid:18)(cid:18)(cid:2)(cid:44,,21542.0
,,34,,,Unknown,,cid:43)(cid:2)(cid:1)(cid:34)(cid:34)(cid:19)(cid:18)(cid:18)(cid:2)(cid:44,,21576.0
,,36,,,Unknown,,cid:43)(cid:2)(cid:1)(cid:34)(cid:34)(cid:19)(cid:18)(cid:18)(cid:2)(cid:44,,21612.0
,,32,,,Unknown,,cid:43)(cid:2)(cid:1)(cid:34)(cid:34)(cid:19)(cid:18)(cid:18)(cid:2)(cid:44,,21644.0
,,1,,,Unknown,,cid:43)(cid:2)(cid:1)(cid:34)(cid:34)(cid:19)(cid:18)(cid:18)(cid:2)(cid:44,,21645.0
,,32,,,Unknown,,cid:43)(cid:2)(cid:1)(cid:34)(cid:34)(cid:19)(cid:18)(cid:18)(cid:2)(cid:44,,21677.0
,,17,,,Unknown,,cid:43)(cid:2)(cid:1)(cid:34)(cid:34)(cid:19)(cid:18)(cid:18)(cid:2)(cid:44,,21694.0
,,1,,,Unknown,,cid:43)(cid:2)(cid:1)(cid:34)(cid:34)(cid:19)(cid:18)(cid:18)(cid:2)(cid:44,,21695.0
,,36,,,Unknown,,cid:43)(cid:2)(cid:1)(cid:34)(cid:34)(cid:19)(cid:18)(cid:18)(cid:2)(cid:44,,21731.0
,,45,,,Unknown,,cid:43)(cid:2)(cid:1)(cid:34)(cid:34)(cid:19)(cid:18)(cid:18)(cid:2)(cid:44,,21776.0
,,18,,,Unknown,,cid:43)(cid:2)(cid:1)(cid:34)(cid:34)(cid:19)(cid:18)(cid:18)(cid:2)(cid:44,,21794.0
,,35,,,Unknown,,cid:43)(cid:2)(cid:1)(cid:34)(cid:34)(cid:19)(cid:18)(cid:18)(cid:2)(cid:44,,21829.0
,,52,,,Unknown,,cid:43)(cid:2)(cid:1)(cid:34)(cid:34)(cid:19)(cid:18)(cid:18)(cid:2)(cid:44,,21881.0
,,7,,,Unknown,,cid:43)(cid:2)(cid:1)(cid:34)(cid:34)(cid:19)(cid:18)(cid:18)(cid:2)(cid:44,,21888.0
,,52,,,Unknown,,cid:43)(cid:2)(cid:1)(cid:34)(cid:34)(cid:19)(cid:18)(cid:18)(cid:2)(cid:44,,21940.0
,,46,,,Unknown,,cid:43)(cid:2)(cid:1)(cid:34)(cid:34)(cid:19)(cid:18)(cid:18)(cid:2)(cid:44,,21986.0
,,2,,,Unknown,,cid:43)(cid:2)(cid:1)(cid:34)(cid:34)(cid:19)(cid:18)(cid:18)(cid:2)(cid:44,,21988.0
,,28,,,Unknown,,cid:43)(cid:2)(cid:1)(cid:34)(cid:34)(cid:19)(cid:18)(cid:18)(cid:2)(cid:44,,22016.0
,,3,,,Unknown,,cid:43)(cid:2)(cid:1)(cid:34)(cid:34)(cid:19)(cid:18)(cid:18)(cid:2)(cid:44,,22019.0
,,5,,,Unknown,,cid:43)(cid:2)(cid:1)(cid:34)(cid:34)(cid:19)(cid:18)(cid:18)(cid:2)(cid:44,,22024.0
,,9,,,Unknown,,cid:43)(cid:2)(cid:1)(cid:34)(cid:34)(cid:19)(cid:18)(cid:18)(cid:2)(cid:44,,22033.0
,,13,,,Unknown,,cid:43)(cid:2)(cid:1)(cid:34)(cid:34)(cid:19)(cid:18)(cid:18)(cid:2)(cid:44,,22046.0
,,2,,,Unknown,,cid:43)(cid:2)(cid:1)(cid:34)(cid:34)(cid:19)(cid:18)(cid:18)(cid:2)(cid:44,,22048.0
,,39,,,Unknown,,cid:43)(cid:2)(cid:1)(cid:34)(cid:34)(cid:19)(cid:18)(cid:18)(cid:2)(cid:44,,22087.0
,,3,,,Unknown,,cid:43)(cid:2)(cid:1)(cid:34)(cid:34)(cid:19)(cid:18)(cid:18)(cid:2)(cid:44,,22090.0
,,7,,,Unknown,,cid:43)(cid:2)(cid:1)(cid:34)(cid:34)(cid:19)(cid:18)(cid:18)(cid:2)(cid:44,,22097.0
,,9,,,Unknown,,cid:43)(cid:2)(cid:1)(cid:34)(cid:34)(cid:19)(cid:18)(cid:18)(cid:2)(cid:44,,22106.0
,,13,,,Unknown,,cid:43)(cid:2)(cid:1)(cid:34)(cid:34)(cid:19)(cid:18)(cid:18)(cid:2)(cid:44,,22119.0
,,10,,,Unknown,,cid:43)(cid:2)(cid:1)(cid:34)(cid:34)(cid:19)(cid:18)(cid:18)(cid:2)(cid:44,,22129.0
,,7,,,Unknown,,cid:43)(cid:2)(cid:1)(cid:34)(cid:34)(cid:19)(cid:18)(cid:18)(cid:2)(cid:44,,22136.0
,,8,,,Unknown,,cid:43)(cid:2)(cid:1)(cid:34)(cid:34)(cid:19)(cid:18)(cid:18)(cid:2)(cid:44,,22144.0
,,5,,,Unknown,,cid:43)(cid:2)(cid:1)(cid:34)(cid:34)(cid:19)(cid:18)(cid:18)(cid:2)(cid:44,,22149.0
,,2,,,Unknown,,cid:43)(cid:2)(cid:1)(cid:34)(cid:34)(cid:19)(cid:18)(cid:18)(cid:2)(cid:44,,22151.0
,,38,,,Unknown,,cid:43)(cid:2)(cid:1)(cid:34)(cid:34)(cid:19)(cid:18)(cid:18)(cid:2)(cid:44,,22189.0
,,64,,,Unknown,,cid:43)(cid:2)(cid:1)(cid:34)(cid:34)(cid:19)(cid:18)(cid:18)(cid:2)(cid:44,,22253.0
,,15,,,Unknown,,cid:43)(cid:2)(cid:1)(cid:34)(cid:34)(cid:19)(cid:18)(cid:18)(cid:2)(cid:44,,22268.0
,,2,,,Unknown,,cid:43)(cid:2)(cid:1)(cid:34)(cid:34)(cid:19)(cid:18)(cid:18)(cid:2)(cid:44,,22270.0
,,17,,,Unknown,,cid:43)(cid:2)(cid:1)(cid:34)(cid:34)(cid:19)(cid:18)(cid:18)(cid:2)(cid:44,,22287.0
,,17,,,Unknown,,cid:43)(cid:2)(cid:1)(cid:34)(cid:34)(cid:19)(cid:18)(cid:18)(cid:2)(cid:44,,22304.0
,,19,,,Unknown,,cid:43)(cid:2)(cid:1)(cid:34)(cid:34)(cid:19)(cid:18)(cid:18)(cid:2)(cid:44,,22323.0
,,33,,,Unknown,,cid:43)(cid:2)(cid:1)(cid:34)(cid:34)(cid:19)(cid:18)(cid:18)(cid:2)(cid:44,,22356.0
,,18,,,Unknown,,cid:43)(cid:2)(cid:1)(cid:34)(cid:34)(cid:19)(cid:18)(cid:18)(cid:2)(cid:44,,22374.0
,,2,,,Unknown,,cid:43)(cid:2)(cid:1)(cid:34)(cid:34)(cid:19)(cid:18)(cid:18)(cid:2)(cid:44,,22376.0
,,44,,,Unknown,,cid:43)(cid:2)(cid:1)(cid:34)(cid:34)(cid:19)(cid:18)(cid:18)(cid:2)(cid:44,,22420.0
,,12,,,Unknown,,cid:43)(cid:2)(cid:1)(cid:34)(cid:34)(cid:19)(cid:18)(cid:18)(cid:2)(cid:44,,22432.0
,,29,,,Unknown,,cid:43)(cid:2)(cid:1)(cid:34)(cid:34)(cid:19)(cid:18)(cid:18)(cid:2)(cid:44,,22461.0
,,26,,,Unknown,,cid:43)(cid:2)(cid:1)(cid:34)(cid:34)(cid:19)(cid:18)(cid:18)(cid:2)(cid:44,,22487.0
,,41,,,Unknown,,cid:43)(cid:2)(cid:1)(cid:34)(cid:34)(cid:19)(cid:18)(cid:18)(cid:2)(cid:44,,22528.0
,,25,,,Unknown,,cid:43)(cid:2)(cid:1)(cid:34)(cid:34)(cid:19)(cid:18)(cid:18)(cid:2)(cid:44,,22553.0
,,2,,,Unknown,,cid:43)(cid:2)(cid:1)(cid:34)(cid:34)(cid:19)(cid:18)(cid:18)(cid:2)(cid:44,,22555.0
,,50,,,Unknown,,cid:43)(cid:2)(cid:1)(cid:34)(cid:34)(cid:19)(cid:18)(cid:18)(cid:2)(cid:44,,22605.0
,,50,,,Unknown,,cid:43)(cid:2)(cid:1)(cid:34)(cid:34)(cid:19)(cid:18)(cid:18)(cid:2)(cid:44,,22655.0
,,37,,,Unknown,,cid:43)(cid:2)(cid:1)(cid:34)(cid:34)(cid:19)(cid:18)(cid:18)(cid:2)(cid:44,,22692.0
,,16,,,Unknown,,cid:43)(cid:2)(cid:1)(cid:34)(cid:34)(cid:19)(cid:18)(cid:18)(cid:2)(cid:44,,22708.0
,,34,,,Unknown,,cid:43)(cid:2)(cid:1)(cid:34)(cid:34)(cid:19)(cid:18)(cid:18)(cid:2)(cid:44,,22742.0
,,33,,,Unknown,,cid:43)(cid:2)(cid:1)(cid:34)(cid:34)(cid:19)(cid:18)(cid:18)(cid:2)(cid:44,,22775.0
,,1,,,Unknown,,cid:43)(cid:2)(cid:1)(cid:34)(cid:34)(cid:19)(cid:18)(cid:18)(cid:2)(cid:44,,22776.0
,,36,,,Unknown,,cid:43)(cid:2)(cid:1)(cid:34)(cid:34)(cid:19)(cid:18)(cid:18)(cid:2)(cid:44,,22812.0
,,45,,,Unknown,,cid:43)(cid:2)(cid:1)(cid:34)(cid:34)(cid:19)(cid:18)(cid:18)(cid:2)(cid:44,,22857.0
,,18,,,Unknown,,cid:43)(cid:2)(cid:1)(cid:34)(cid:34)(cid:19)(cid:18)(cid:18)(cid:2)(cid:44,,22875.0
,,35,,,Unknown,,cid:43)(cid:2)(cid:1)(cid:34)(cid:34)(cid:19)(cid:18)(cid:18)(cid:2)(cid:44,,22910.0
,,46,,,Unknown,,cid:43)(cid:2)(cid:1)(cid:34)(cid:34)(cid:19)(cid:18)(cid:18)(cid:2)(cid:44,,22956.0
,,14,,,Unknown,,cid:43)(cid:2)(cid:1)(cid:34)(cid:34)(cid:19)(cid:18)(cid:18)(cid:2)(cid:44,,22970.0
,,51,,,Unknown,,cid:43)(cid:2)(cid:1)(cid:34)(cid:34)(cid:19)(cid:18)(cid:18)(cid:2)(cid:44,,23021.0
,,7,,,Unknown,,cid:43)(cid:2)(cid:1)(cid:34)(cid:34)(cid:19)(cid:18)(cid:18)(cid:2)(cid:44,,23028.0
,,2,,,Unknown,,cid:43)(cid:2)(cid:1)(cid:34)(cid:34)(cid:19)(cid:18)(cid:18)(cid:2)(cid:44,,23030.0
,,28,,,Unknown,,cid:43)(cid:2)(cid:1)(cid:34)(cid:34)(cid:19)(cid:18)(cid:18)(cid:2)(cid:44,,23058.0
,,46,,,Unknown,,cid:43)(cid:2)(cid:1)(cid:34)(cid:34)(cid:19)(cid:18)(cid:18)(cid:2)(cid:44,,23104.0
,,9,,,Unknown,,cid:43)(cid:2)(cid:1)(cid:34)(cid:34)(cid:19)(cid:18)(cid:18)(cid:2)(cid:44,,23113.0
,,13,,,Unknown,,cid:43)(cid:2)(cid:1)(cid:34)(cid:34)(cid:19)(cid:18)(cid:18)(cid:2)(cid:44,,23126.0
,,7,,,Unknown,,cid:43)(cid:2)(cid:1)(cid:34)(cid:34)(cid:19)(cid:18)(cid:18)(cid:2)(cid:44,,23133.0
,,11,,,Unknown,,cid:43)(cid:2)(cid:1)(cid:34)(cid:34)(cid:19)(cid:18)(cid:18)(cid:2)(cid:44,,23144.0
,,8,,,Unknown,,cid:43)(cid:2)(cid:1)(cid:34)(cid:34)(cid:19)(cid:18)(cid:18)(cid:2)(cid:44,,23152.0
,,2,,,Unknown,,cid:43)(cid:2)(cid:1)(cid:34)(cid:34)(cid:19)(cid:18)(cid:18)(cid:2)(cid:44,,23154.0
,,9,,,Unknown,,cid:43)(cid:2)(cid:1)(cid:34)(cid:34)(cid:19)(cid:18)(cid:18)(cid:2)(cid:44,,23163.0
,,13,,,Unknown,,cid:43)(cid:2)(cid:1)(cid:34)(cid:34)(cid:19)(cid:18)(cid:18)(cid:2)(cid:44,,23176.0
,,39,,,Unknown,,cid:43)(cid:2)(cid:1)(cid:34)(cid:34)(cid:19)(cid:18)(cid:18)(cid:2)(cid:44,,23215.0
,,67,,,Unknown,,cid:43)(cid:2)(cid:1)(cid:34)(cid:34)(cid:19)(cid:18)(cid:18)(cid:2)(cid:44,,23282.0
,,2,,,Unknown,,cid:43)(cid:2)(cid:1)(cid:34)(cid:34)(cid:19)(cid:18)(cid:18)(cid:2)(cid:44,,23284.0
,,39,,,Unknown,,cid:43)(cid:2)(cid:1)(cid:34)(cid:34)(cid:19)(cid:18)(cid:18)(cid:2)(cid:44,,23323.0
,,3,,,Unknown,,cid:43)(cid:2)(cid:1)(cid:34)(cid:34)(cid:19)(cid:18)(cid:18)(cid:2)(cid:44,,23326.0
,,7,,,Unknown,,cid:43)(cid:2)(cid:1)(cid:34)(cid:34)(cid:19)(cid:18)(cid:18)(cid:2)(cid:44,,23333.0
,,9,,,Unknown,,cid:43)(cid:2)(cid:1)(cid:34)(cid:34)(cid:19)(cid:18)(cid:18)(cid:2)(cid:44,,23342.0
,,13,,,Unknown,,cid:43)(cid:2)(cid:1)(cid:34)(cid:34)(cid:19)(cid:18)(cid:18)(cid:2)(cid:44,,23355.0
,,10,,,Unknown,,cid:43)(cid:2)(cid:1)(cid:34)(cid:34)(cid:19)(cid:18)(cid:18)(cid:2)(cid:44,,23365.0
,,7,,,Unknown,,cid:43)(cid:2)(cid:1)(cid:34)(cid:34)(cid:19)(cid:18)(cid:18)(cid:2)(cid:44,,23372.0
,,8,,,Unknown,,cid:43)(cid:2)(cid:1)(cid:34)(cid:34)(cid:19)(cid:18)(cid:18)(cid:2)(cid:44,,23380.0
,,46,,,Unknown,,cid:43)(cid:2)(cid:1)(cid:34)(cid:34)(cid:19)(cid:18)(cid:18)(cid:2)(cid:44,,23426.0
,,2,,,Unknown,,cid:43)(cid:2)(cid:1)(cid:34)(cid:34)(cid:19)(cid:18)(cid:18)(cid:2)(cid:44,,23428.0
,,38,,,Unknown,,cid:43)(cid:2)(cid:1)(cid:34)(cid:34)(cid:19)(cid:18)(cid:18)(cid:2)(cid:44,,23466.0
,,64,,,Unknown,,cid:43)(cid:2)(cid:1)(cid:34)(cid:34)(cid:19)(cid:18)(cid:18)(cid:2)(cid:44,,23530.0
,,15,,,Unknown,,cid:43)(cid:2)(cid:1)(cid:34)(cid:34)(cid:19)(cid:18)(cid:18)(cid:2)(cid:44,,23545.0
,,2,,,Unknown,,cid:43)(cid:2)(cid:1)(cid:34)(cid:34)(cid:19)(cid:18)(cid:18)(cid:2)(cid:44,,23547.0
,,17,,,Unknown,,cid:43)(cid:2)(cid:1)(cid:34)(cid:34)(cid:19)(cid:18)(cid:18)(cid:2)(cid:44,,23564.0
,,36,,,Unknown,,cid:43)(cid:2)(cid:1)(cid:34)(cid:34)(cid:19)(cid:18)(cid:18)(cid:2)(cid:44,,23600.0
,,33,,,Unknown,,cid:43)(cid:2)(cid:1)(cid:34)(cid:34)(cid:19)(cid:18)(cid:18)(cid:2)(cid:44,,23633.0
,,19,,,Unknown,,cid:43)(cid:2)(cid:1)(cid:34)(cid:34)(cid:19)(cid:18)(cid:18)(cid:2)(cid:44,,23652.0
,,34,,,Unknown,,cid:43)(cid:2)(cid:1)(cid:34)(cid:34)(cid:19)(cid:18)(cid:18)(cid:2)(cid:44,,23686.0
,,32,,,Unknown,,cid:43)(cid:2)(cid:1)(cid:34)(cid:34)(cid:19)(cid:18)(cid:18)(cid:2)(cid:44,,23718.0
,,2,,,Unknown,,cid:43)(cid:2)(cid:1)(cid:34)(cid:34)(cid:19)(cid:18)(cid:18)(cid:2)(cid:44,,23720.0
,,44,,,Unknown,,cid:43)(cid:2)(cid:1)(cid:34)(cid:34)(cid:19)(cid:18)(cid:18)(cid:2)(cid:44,,23764.0
,,12,,,Unknown,,cid:43)(cid:2)(cid:1)(cid:34)(cid:34)(cid:19)(cid:18)(cid:18)(cid:2)(cid:44,,23776.0
,,29,,,Unknown,,cid:43)(cid:2)(cid:1)(cid:34)(cid:34)(cid:19)(cid:18)(cid:18)(cid:2)(cid:44,,23805.0
,,26,,,Unknown,,cid:43)(cid:2)(cid:1)(cid:34)(cid:34)(cid:19)(cid:18)(cid:18)(cid:2)(cid:44,,23831.0
,,41,,,Unknown,,cid:43)(cid:2)(cid:1)(cid:34)(cid:34)(cid:19)(cid:18)(cid:18)(cid:2)(cid:44,,23872.0
,,25,,,Unknown,,cid:43)(cid:2)(cid:1)(cid:34)(cid:34)(cid:19)(cid:18)(cid:18)(cid:2)(cid:44,,23897.0
,,2,,,Unknown,,cid:43)(cid:2)(cid:1)(cid:34)(cid:34)(cid:19)(cid:18)(cid:18)(cid:2)(cid:44,,23899.0
,,50,,,Unknown,,cid:43)(cid:2)(cid:1)(cid:34)(cid:34)(cid:19)(cid:18)(cid:18)(cid:2)(cid:44,,23949.0
,,50,,,Unknown,,cid:43)(cid:2)(cid:1)(cid:34)(cid:34)(cid:19)(cid:18)(cid:18)(cid:2)(cid:44,,23999.0
,,37,,,Unknown,,cid:43)(cid:2)(cid:1)(cid:34)(cid:34)(cid:19)(cid:18)(cid:18)(cid:2)(cid:44,,24036.0
,,16,,,Unknown,,cid:43)(cid:2)(cid:1)(cid:34)(cid:34)(cid:19)(cid:18)(cid:18)(cid:2)(cid:44,,24052.0
,,34,,,Unknown,,cid:43)(cid:2)(cid:1)(cid:34)(cid:34)(cid:19)(cid:18)(cid:18)(cid:2)(cid:44,,24086.0
,,33,,,Unknown,,cid:43)(cid:2)(cid:1)(cid:34)(cid:34)(cid:19)(cid:18)(cid:18)(cid:2)(cid:44,,24119.0
,,1,,,Unknown,,cid:43)(cid:2)(cid:1)(cid:34)(cid:34)(cid:19)(cid:18)(cid:18)(cid:2)(cid:44,,24120.0
,,32,,,Unknown,,cid:43)(cid:2)(cid:1)(cid:34)(cid:34)(cid:19)(cid:18)(cid:18)(cid:2)(cid:44,,24152.0
,,45,,,Unknown,,cid:43)(cid:2)(cid:1)(cid:34)(cid:34)(cid:19)(cid:18)(cid:18)(cid:2)(cid:44,,24197.0
,,18,,,Unknown,,cid:43)(cid:2)(cid:1)(cid:34)(cid:34)(cid:19)(cid:18)(cid:18)(cid:2)(cid:44,,24215.0
,,35,,,Unknown,,cid:43)(cid:2)(cid:1)(cid:34)(cid:34)(cid:19)(cid:18)(cid:18)(cid:2)(cid:44,,24250.0
,,51,,,Unknown,,cid:43)(cid:2)(cid:1)(cid:34)(cid:34)(cid:19)(cid:18)(cid:18)(cid:2)(cid:44,,24301.0
,,11,,,Unknown,,cid:43)(cid:2)(cid:1)(cid:34)(cid:34)(cid:19)(cid:18)(cid:18)(cid:2)(cid:44,,24312.0
,,4,,,Unknown,,cid:43)(cid:2)(cid:1)(cid:34)(cid:34)(cid:19)(cid:18)(cid:18)(cid:2)(cid:44,,24316.0
,,68,,,Unknown,,cid:43)(cid:2)(cid:1)(cid:34)(cid:34)(cid:19)(cid:18)(cid:18)(cid:2)(cid:44,,24384.0
,,53,,,Unknown,,cid:43)(cid:2)(cid:1)(cid:34)(cid:34)(cid:19)(cid:18)(cid:18)(cid:2)(cid:44,,24437.0
,,10,,,Unknown,,cid:43)(cid:2)(cid:1)(cid:34)(cid:34)(cid:19)(cid:18)(cid:18)(cid:2)(cid:44,,24447.0
,,5,,,Unknown,,cid:43)(cid:2)(cid:1)(cid:34)(cid:34)(cid:19)(cid:18)(cid:18)(cid:2)(cid:44,,24452.0
,,14,,,Unknown,,cid:43)(cid:2)(cid:1)(cid:34)(cid:34)(cid:19)(cid:18)(cid:18)(cid:2)(cid:44,,24466.0
,,2,,,Unknown,,cid:43)(cid:2)(cid:1)(cid:34)(cid:34)(cid:19)(cid:18)(cid:18)(cid:2)(cid:44,,24468.0
,,52,,,Unknown,,cid:43)(cid:2)(cid:1)(cid:34)(cid:34)(cid:19)(cid:18)(cid:18)(cid:2)(cid:44,,24520.0
,,46,,,Unknown,,cid:43)(cid:2)(cid:1)(cid:34)(cid:34)(cid:19)(cid:18)(cid:18)(cid:2)(cid:44,,24566.0
,,49,,,Unknown,,cid:43)(cid:2)(cid:1)(cid:34)(cid:34)(cid:19)(cid:18)(cid:18)(cid:2)(cid:44,,24615.0
,,2,,,Unknown,,cid:43)(cid:2)(cid:1)(cid:34)(cid:34)(cid:19)(cid:18)(cid:18)(cid:2)(cid:44,,24617.0
,,7,,,Unknown,,cid:43)(cid:2)(cid:1)(cid:34)(cid:34)(cid:19)(cid:18)(cid:18)(cid:2)(cid:44,,24624.0
,,9,,,Unknown,,cid:43)(cid:2)(cid:1)(cid:34)(cid:34)(cid:19)(cid:18)(cid:18)(cid:2)(cid:44,,24633.0
,,9,,,Unknown,,cid:43)(cid:2)(cid:1)(cid:34)(cid:34)(cid:19)(cid:18)(cid:18)(cid:2)(cid:44,,24642.0
,,68,,,Unknown,,cid:43)(cid:2)(cid:1)(cid:34)(cid:34)(cid:19)(cid:18)(cid:18)(cid:2)(cid:44,,24710.0
,,2,,,Unknown,,cid:43)(cid:2)(cid:1)(cid:34)(cid:34)(cid:19)(cid:18)(cid:18)(cid:2)(cid:44,,24712.0
,,14,,,Unknown,,cid:43)(cid:2)(cid:1)(cid:34)(cid:34)(cid:19)(cid:18)(cid:18)(cid:2)(cid:44,,24726.0
,,5,,,Unknown,,cid:43)(cid:2)(cid:1)(cid:34)(cid:34)(cid:19)(cid:18)(cid:18)(cid:2)(cid:44,,24731.0
,,9,,,Unknown,,cid:43)(cid:2)(cid:1)(cid:34)(cid:34)(cid:19)(cid:18)(cid:18)(cid:2)(cid:44,,24740.0
,,2,,,Unknown,,cid:43)(cid:2)(cid:1)(cid:34)(cid:34)(cid:19)(cid:18)(cid:18)(cid:2)(cid:44,,24742.0
,,54,,,Unknown,,cid:43)(cid:2)(cid:1)(cid:34)(cid:34)(cid:19)(cid:18)(cid:18)(cid:2)(cid:44,,24796.0
,,11,,,Unknown,,cid:43)(cid:2)(cid:1)(cid:34)(cid:34)(cid:19)(cid:18)(cid:18)(cid:2)(cid:44,,24807.0
,,4,,,Unknown,,cid:43)(cid:2)(cid:1)(cid:34)(cid:34)(cid:19)(cid:18)(cid:18)(cid:2)(cid:44,,24811.0
,,14,,,Unknown,,cid:43)(cid:2)(cid:1)(cid:34)(cid:34)(cid:19)(cid:18)(cid:18)(cid:2)(cid:44,,24825.0
,,2,,,Unknown,,cid:43)(cid:2)(cid:1)(cid:34)(cid:34)(cid:19)(cid:18)(cid:18)(cid:2)(cid:44,,24827.0
,,28,,,Unknown,,cid:43)(cid:2)(cid:1)(cid:34)(cid:34)(cid:19)(cid:18)(cid:18)(cid:2)(cid:44,,24855.0
,,3,,,Unknown,,cid:43)(cid:2)(cid:1)(cid:34)(cid:34)(cid:19)(cid:18)(cid:18)(cid:2)(cid:44,,24858.0
,,15,,,Unknown,,cid:43)(cid:2)(cid:1)(cid:34)(cid:34)(cid:19)(cid:18)(cid:18)(cid:2)(cid:44,,24873.0
,,2,,,Unknown,,cid:43)(cid:2)(cid:1)(cid:34)(cid:34)(cid:19)(cid:18)(cid:18)(cid:2)(cid:44,,24875.0
,,16,,,Unknown,,cid:43)(cid:2)(cid:1)(cid:34)(cid:34)(cid:19)(cid:18)(cid:18)(cid:2)(cid:44,,24891.0
,,37,,,Unknown,,cid:43)(cid:2)(cid:1)(cid:34)(cid:34)(cid:19)(cid:18)(cid:18)(cid:2)(cid:44,,24928.0
,,19,,,Unknown,,cid:43)(cid:2)(cid:1)(cid:34)(cid:34)(cid:19)(cid:18)(cid:18)(cid:2)(cid:44,,24947.0
,,33,,,Unknown,,cid:43)(cid:2)(cid:1)(cid:34)(cid:34)(cid:19)(cid:18)(cid:18)(cid:2)(cid:44,,24980.0
,,33,,,Unknown,,cid:43)(cid:2)(cid:1)(cid:34)(cid:34)(cid:19)(cid:18)(cid:18)(cid:2)(cid:44,,25013.0
,,2,,,Unknown,,cid:43)(cid:2)(cid:1)(cid:34)(cid:34)(cid:19)(cid:18)(cid:18)(cid:2)(cid:44,,25015.0
,,44,,,Unknown,,cid:43)(cid:2)(cid:1)(cid:34)(cid:34)(cid:19)(cid:18)(cid:18)(cid:2)(cid:44,,25059.0
,,12,,,Unknown,,cid:43)(cid:2)(cid:1)(cid:34)(cid:34)(cid:19)(cid:18)(cid:18)(cid:2)(cid:44,,25071.0
,,29,,,Unknown,,cid:43)(cid:2)(cid:1)(cid:34)(cid:34)(cid:19)(cid:18)(cid:18)(cid:2)(cid:44,,25100.0
,,26,,,Unknown,,cid:43)(cid:2)(cid:1)(cid:34)(cid:34)(cid:19)(cid:18)(cid:18)(cid:2)(cid:44,,25126.0
,,41,,,Unknown,,cid:43)(cid:2)(cid:1)(cid:34)(cid:34)(cid:19)(cid:18)(cid:18)(cid:2)(cid:44,,25167.0
,,25,,,Unknown,,cid:43)(cid:2)(cid:1)(cid:34)(cid:34)(cid:19)(cid:18)(cid:18)(cid:2)(cid:44,,25192.0
,,2,,,Unknown,,cid:43)(cid:2)(cid:1)(cid:34)(cid:34)(cid:19)(cid:18)(cid:18)(cid:2)(cid:44,,25194.0
,,50,,,Unknown,,cid:43)(cid:2)(cid:1)(cid:34)(cid:34)(cid:19)(cid:18)(cid:18)(cid:2)(cid:44,,25244.0
,,50,,,Unknown,,cid:43)(cid:2)(cid:1)(cid:34)(cid:34)(cid:19)(cid:18)(cid:18)(cid:2)(cid:44,,25294.0
,,37,,,Unknown,,cid:43)(cid:2)(cid:1)(cid:34)(cid:34)(cid:19)(cid:18)(cid:18)(cid:2)(cid:44,,25331.0
,,16,,,Unknown,,cid:43)(cid:2)(cid:1)(cid:34)(cid:34)(cid:19)(cid:18)(cid:18)(cid:2)(cid:44,,25347.0
,,34,,,Unknown,,cid:43)(cid:2)(cid:1)(cid:34)(cid:34)(cid:19)(cid:18)(cid:18)(cid:2)(cid:44,,25381.0
,,33,,,Unknown,,cid:43)(cid:2)(cid:1)(cid:34)(cid:34)(cid:19)(cid:18)(cid:18)(cid:2)(cid:44,,25414.0
,,1,,,Unknown,,cid:43)(cid:2)(cid:1)(cid:34)(cid:34)(cid:19)(cid:18)(cid:18)(cid:2)(cid:44,,25415.0
,,32,,,Unknown,,cid:43)(cid:2)(cid:1)(cid:34)(cid:34)(cid:19)(cid:18)(cid:18)(cid:2)(cid:44,,25447.0
,,45,,,Unknown,,cid:43)(cid:2)(cid:1)(cid:34)(cid:34)(cid:19)(cid:18)(cid:18)(cid:2)(cid:44,,25492.0
,,18,,,Unknown,,cid:43)(cid:2)(cid:1)(cid:34)(cid:34)(cid:19)(cid:18)(cid:18)(cid:2)(cid:44,,25510.0
,,35,,,Unknown,,cid:43)(cid:2)(cid:1)(cid:34)(cid:34)(cid:19)(cid:18)(cid:18)(cid:2)(cid:44,,25545.0
,,51,,,Unknown,,cid:43)(cid:2)(cid:1)(cid:34)(cid:34)(cid:19)(cid:18)(cid:18)(cid:2)(cid:44,,25596.0
,,11,,,Unknown,,cid:43)(cid:2)(cid:1)(cid:34)(cid:34)(cid:19)(cid:18)(cid:18)(cid:2)(cid:44,,25607.0
,,4,,,Unknown,,cid:43)(cid:2)(cid:1)(cid:34)(cid:34)(cid:19)(cid:18)(cid:18)(cid:2)(cid:44,,25611.0
,,68,,,Unknown,,cid:43)(cid:2)(cid:1)(cid:34)(cid:34)(cid:19)(cid:18)(cid:18)(cid:2)(cid:44,,25679.0
,,53,,,Unknown,,cid:43)(cid:2)(cid:1)(cid:34)(cid:34)(cid:19)(cid:18)(cid:18)(cid:2)(cid:44,,25732.0
,,10,,,Unknown,,cid:43)(cid:2)(cid:1)(cid:34)(cid:34)(cid:19)(cid:18)(cid:18)(cid:2)(cid:44,,25742.0
,,5,,,Unknown,,cid:43)(cid:2)(cid:1)(cid:34)(cid:34)(cid:19)(cid:18)(cid:18)(cid:2)(cid:44,,25747.0
,,14,,,Unknown,,cid:43)(cid:2)(cid:1)(cid:34)(cid:34)(cid:19)(cid:18)(cid:18)(cid:2)(cid:44,,25761.0
,,2,,,Unknown,,cid:43)(cid:2)(cid:1)(cid:34)(cid:34)(cid:19)(cid:18)(cid:18)(cid:2)(cid:44,,25763.0
,,52,,,Unknown,,cid:43)(cid:2)(cid:1)(cid:34)(cid:34)(cid:19)(cid:18)(cid:18)(cid:2)(cid:44,,25815.0
,,46,,,Unknown,,cid:43)(cid:2)(cid:1)(cid:34)(cid:34)(cid:19)(cid:18)(cid:18)(cid:2)(cid:44,,25861.0
,,49,,,Unknown,,cid:43)(cid:2)(cid:1)(cid:34)(cid:34)(cid:19)(cid:18)(cid:18)(cid:2)(cid:44,,25910.0
,,2,,,Unknown,,cid:43)(cid:2)(cid:1)(cid:34)(cid:34)(cid:19)(cid:18)(cid:18)(cid:2)(cid:44,,25912.0
,,7,,,Unknown,,cid:43)(cid:2)(cid:1)(cid:34)(cid:34)(cid:19)(cid:18)(cid:18)(cid:2)(cid:44,,25919.0
,,9,,,Unknown,,cid:43)(cid:2)(cid:1)(cid:34)(cid:34)(cid:19)(cid:18)(cid:18)(cid:2)(cid:44,,25928.0
,,9,,,Unknown,,cid:43)(cid:2)(cid:1)(cid:34)(cid:34)(cid:19)(cid:18)(cid:18)(cid:2)(cid:44,,25937.0
,,68,,,Unknown,,cid:43)(cid:2)(cid:1)(cid:34)(cid:34)(cid:19)(cid:18)(cid:18)(cid:2)(cid:44,,26005.0
,,2,,,Unknown,,cid:43)(cid:2)(cid:1)(cid:34)(cid:34)(cid:19)(cid:18)(cid:18)(cid:2)(cid:44,,26007.0
,,14,,,Unknown,,cid:43)(cid:2)(cid:1)(cid:34)(cid:34)(cid:19)(cid:18)(cid:18)(cid:2)(cid:44,,26021.0
,,5,,,Unknown,,cid:43)(cid:2)(cid:1)(cid:34)(cid:34)(cid:19)(cid:18)(cid:18)(cid:2)(cid:44,,26026.0
,,9,,,Unknown,,cid:43)(cid:2)(cid:1)(cid:34)(cid:34)(cid:19)(cid:18)(cid:18)(cid:2)(cid:44,,26035.0
,,2,,,Unknown,,cid:43)(cid:2)(cid:1)(cid:34)(cid:34)(cid:19)(cid:18)(cid:18)(cid:2)(cid:44,,26037.0
,,54,,,Unknown,,cid:43)(cid:2)(cid:1)(cid:34)(cid:34)(cid:19)(cid:18)(cid:18)(cid:2)(cid:44,,26091.0
,,11,,,Unknown,,cid:43)(cid:2)(cid:1)(cid:34)(cid:34)(cid:19)(cid:18)(cid:18)(cid:2)(cid:44,,26102.0
,,4,,,Unknown,,cid:43)(cid:2)(cid:1)(cid:34)(cid:34)(cid:19)(cid:18)(cid:18)(cid:2)(cid:44,,26106.0
,,14,,,Unknown,,cid:43)(cid:2)(cid:1)(cid:34)(cid:34)(cid:19)(cid:18)(cid:18)(cid:2)(cid:44,,26120.0
,,2,,,Unknown,,cid:43)(cid:2)(cid:1)(cid:34)(cid:34)(cid:19)(cid:18)(cid:18)(cid:2)(cid:44,,26122.0
,,28,,,Unknown,,cid:43)(cid:2)(cid:1)(cid:34)(cid:34)(cid:19)(cid:18)(cid:18)(cid:2)(cid:44,,26150.0
,,3,,,Unknown,,cid:43)(cid:2)(cid:1)(cid:34)(cid:34)(cid:19)(cid:18)(cid:18)(cid:2)(cid:44,,26153.0
,,15,,,Unknown,,cid:43)(cid:2)(cid:1)(cid:34)(cid:34)(cid:19)(cid:18)(cid:18)(cid:2)(cid:44,,26168.0
,,2,,,Unknown,,cid:43)(cid:2)(cid:1)(cid:34)(cid:34)(cid:19)(cid:18)(cid:18)(cid:2)(cid:44,,26170.0
,,35,,,Unknown,,cid:43)(cid:2)(cid:1)(cid:34)(cid:34)(cid:19)(cid:18)(cid:18)(cid:2)(cid:44,,26205.0
,,1,,,Unknown,,cid:43)(cid:2)(cid:1)(cid:34)(cid:34)(cid:19)(cid:18)(cid:18)(cid:2)(cid:44,,26206.0
,,19,,,Unknown,,cid:43)(cid:2)(cid:1)(cid:34)(cid:34)(cid:19)(cid:18)(cid:18)(cid:2)(cid:44,,26225.0
,,33,,,Unknown,,cid:43)(cid:2)(cid:1)(cid:34)(cid:34)(cid:19)(cid:18)(cid:18)(cid:2)(cid:44,,26258.0
,,16,,,Unknown,,cid:43)(cid:2)(cid:1)(cid:34)(cid:34)(cid:19)(cid:18)(cid:18)(cid:2)(cid:44,,26274.0
,,2,,,Unknown,,cid:43)(cid:2)(cid:1)(cid:34)(cid:34)(cid:19)(cid:18)(cid:18)(cid:2)(cid:44,,26276.0
,,44,,,Unknown,,cid:43)(cid:2)(cid:1)(cid:34)(cid:34)(cid:19)(cid:18)(cid:18)(cid:2)(cid:44,,26320.0
,,12,,,Unknown,,cid:43)(cid:2)(cid:1)(cid:34)(cid:34)(cid:19)(cid:18)(cid:18)(cid:2)(cid:44,,26332.0
,,29,,,Unknown,,cid:43)(cid:2)(cid:1)(cid:34)(cid:34)(cid:19)(cid:18)(cid:18)(cid:2)(cid:44,,26361.0
,,26,,,Unknown,,cid:43)(cid:2)(cid:1)(cid:34)(cid:34)(cid:19)(cid:18)(cid:18)(cid:2)(cid:44,,26387.0
,,41,,,Unknown,,cid:43)(cid:2)(cid:1)(cid:34)(cid:34)(cid:19)(cid:18)(cid:18)(cid:2)(cid:44,,26428.0
,,25,,,Unknown,,cid:43)(cid:2)(cid:1)(cid:34)(cid:34)(cid:19)(cid:18)(cid:18)(cid:2)(cid:44,,26453.0
,,2,,,Unknown,,cid:43)(cid:2)(cid:1)(cid:34)(cid:34)(cid:19)(cid:18)(cid:18)(cid:2)(cid:44,,26455.0
,,50,,,Unknown,,cid:43)(cid:2)(cid:1)(cid:34)(cid:34)(cid:19)(cid:18)(cid:18)(cid:2)(cid:44,,26505.0
,,50,,,Unknown,,cid:43)(cid:2)(cid:1)(cid:34)(cid:34)(cid:19)(cid:18)(cid:18)(cid:2)(cid:44,,26555.0
,,37,,,Unknown,,cid:43)(cid:2)(cid:1)(cid:34)(cid:34)(cid:19)(cid:18)(cid:18)(cid:2)(cid:44,,26592.0
,,16,,,Unknown,,cid:43)(cid:2)(cid:1)(cid:34)(cid:34)(cid:19)(cid:18)(cid:18)(cid:2)(cid:44,,26608.0
,,34,,,Unknown,,cid:43)(cid:2)(cid:1)(cid:34)(cid:34)(cid:19)(cid:18)(cid:18)(cid:2)(cid:44,,26642.0
,,33,,,Unknown,,cid:43)(cid:2)(cid:1)(cid:34)(cid:34)(cid:19)(cid:18)(cid:18)(cid:2)(cid:44,,26675.0
,,1,,,Unknown,,cid:43)(cid:2)(cid:1)(cid:34)(cid:34)(cid:19)(cid:18)(cid:18)(cid:2)(cid:44,,26676.0
,,32,,,Unknown,,cid:43)(cid:2)(cid:1)(cid:34)(cid:34)(cid:19)(cid:18)(cid:18)(cid:2)(cid:44,,26708.0
,,45,,,Unknown,,cid:43)(cid:2)(cid:1)(cid:34)(cid:34)(cid:19)(cid:18)(cid:18)(cid:2)(cid:44,,26753.0
,,18,,,Unknown,,cid:43)(cid:2)(cid:1)(cid:34)(cid:34)(cid:19)(cid:18)(cid:18)(cid:2)(cid:44,,26771.0
,,35,,,Unknown,,cid:43)(cid:2)(cid:1)(cid:34)(cid:34)(cid:19)(cid:18)(cid:18)(cid:2)(cid:44,,26806.0
,,52,,,Unknown,,cid:43)(cid:2)(cid:1)(cid:34)(cid:34)(cid:19)(cid:18)(cid:18)(cid:2)(cid:44,,26858.0
,,7,,,Unknown,,cid:43)(cid:2)(cid:1)(cid:34)(cid:34)(cid:19)(cid:18)(cid:18)(cid:2)(cid:44,,26865.0
,,14,,,Unknown,,cid:43)(cid:2)(cid:1)(cid:34)(cid:34)(cid:19)(cid:18)(cid:18)(cid:2)(cid:44,,26879.0
,,46,,,Unknown,,cid:43)(cid:2)(cid:1)(cid:34)(cid:34)(cid:19)(cid:18)(cid:18)(cid:2)(cid:44,,26925.0
,,2,,,Unknown,,cid:43)(cid:2)(cid:1)(cid:34)(cid:34)(cid:19)(cid:18)(cid:18)(cid:2)(cid:44,,26927.0
,,53,,,Unknown,,cid:43)(cid:2)(cid:1)(cid:34)(cid:34)(cid:19)(cid:18)(cid:18)(cid:2)(cid:44,,26980.0
,,5,,,Unknown,,cid:43)(cid:2)(cid:1)(cid:34)(cid:34)(cid:19)(cid:18)(cid:18)(cid:2)(cid:44,,26985.0
,,3,,,Unknown,,cid:43)(cid:2)(cid:1)(cid:34)(cid:34)(cid:19)(cid:18)(cid:18)(cid:2)(cid:44,,26988.0
,,54,,,Unknown,,cid:43)(cid:2)(cid:1)(cid:34)(cid:34)(cid:19)(cid:18)(cid:18)(cid:2)(cid:44,,27042.0
,,7,,,Unknown,,cid:43)(cid:2)(cid:1)(cid:34)(cid:34)(cid:19)(cid:18)(cid:18)(cid:2)(cid:44,,27049.0
,,46,,,Unknown,,cid:43)(cid:2)(cid:1)(cid:34)(cid:34)(cid:19)(cid:18)(cid:18)(cid:2)(cid:44,,27095.0
,,2,,,Unknown,,cid:43)(cid:2)(cid:1)(cid:34)(cid:34)(cid:19)(cid:18)(cid:18)(cid:2)(cid:44,,27097.0
,,39,,,Unknown,,cid:43)(cid:2)(cid:1)(cid:34)(cid:34)(cid:19)(cid:18)(cid:18)(cid:2)(cid:44,,27136.0
,,26,,,Unknown,,cid:43)(cid:2)(cid:1)(cid:34)(cid:34)(cid:19)(cid:18)(cid:18)(cid:2)(cid:44,,27162.0
,,24,,,Unknown,,cid:43)(cid:2)(cid:1)(cid:34)(cid:34)(cid:19)(cid:18)(cid:18)(cid:2)(cid:44,,27186.0
,,27,,,Unknown,,cid:43)(cid:2)(cid:1)(cid:34)(cid:34)(cid:19)(cid:18)(cid:18)(cid:2)(cid:44,,27213.0
,,58,,,Unknown,,cid:43)(cid:2)(cid:1)(cid:34)(cid:34)(cid:19)(cid:18)(cid:18)(cid:2)(cid:44,,27271.0
,,41,,,Unknown,,cid:43)(cid:2)(cid:1)(cid:34)(cid:34)(cid:19)(cid:18)(cid:18)(cid:2)(cid:44,,27312.0
,,24,,,Unknown,,cid:43)(cid:2)(cid:1)(cid:34)(cid:34)(cid:19)(cid:18)(cid:18)(cid:2)(cid:44,,27336.0
,,30,,,Unknown,,cid:43)(cid:2)(cid:1)(cid:34)(cid:34)(cid:19)(cid:18)(cid:18)(cid:2)(cid:44,,27366.0
,,25,,,Unknown,,cid:43)(cid:2)(cid:1)(cid:34)(cid:34)(cid:19)(cid:18)(cid:18)(cid:2)(cid:44,,27391.0
,,2,,,Unknown,,cid:43)(cid:2)(cid:1)(cid:34)(cid:34)(cid:19)(cid:18)(cid:18)(cid:2)(cid:44,,27393.0
,,38,,,Unknown,,cid:43)(cid:2)(cid:1)(cid:34)(cid:34)(cid:19)(cid:18)(cid:18)(cid:2)(cid:44,,27431.0
,,64,,,Unknown,,cid:43)(cid:2)(cid:1)(cid:34)(cid:34)(cid:19)(cid:18)(cid:18)(cid:2)(cid:44,,27495.0
,,15,,,Unknown,,cid:43)(cid:2)(cid:1)(cid:34)(cid:34)(cid:19)(cid:18)(cid:18)(cid:2)(cid:44,,27510.0
,,2,,,Unknown,,cid:43)(cid:2)(cid:1)(cid:34)(cid:34)(cid:19)(cid:18)(cid:18)(cid:2)(cid:44,,27512.0
,,33,,,Unknown,,cid:43)(cid:2)(cid:1)(cid:34)(cid:34)(cid:19)(cid:18)(cid:18)(cid:2)(cid:44,,27545.0
,,1,,,Unknown,,cid:43)(cid:2)(cid:1)(cid:34)(cid:34)(cid:19)(cid:18)(cid:18)(cid:2)(cid:44,,27546.0
,,19,,,Unknown,,cid:43)(cid:2)(cid:1)(cid:34)(cid:34)(cid:19)(cid:18)(cid:18)(cid:2)(cid:44,,27565.0
,,36,,,Unknown,,cid:43)(cid:2)(cid:1)(cid:34)(cid:34)(cid:19)(cid:18)(cid:18)(cid:2)(cid:44,,27601.0
,,18,,,Unknown,,cid:43)(cid:2)(cid:1)(cid:34)(cid:34)(cid:19)(cid:18)(cid:18)(cid:2)(cid:44,,27619.0
,,2,,,Unknown,,cid:43)(cid:2)(cid:1)(cid:34)(cid:34)(cid:19)(cid:18)(cid:18)(cid:2)(cid:44,,27621.0
,,44,,,Unknown,,cid:43)(cid:2)(cid:1)(cid:34)(cid:34)(cid:19)(cid:18)(cid:18)(cid:2)(cid:44,,27665.0
,,12,,,Unknown,,cid:43)(cid:2)(cid:1)(cid:34)(cid:34)(cid:19)(cid:18)(cid:18)(cid:2)(cid:44,,27677.0
,,29,,,Unknown,,cid:43)(cid:2)(cid:1)(cid:34)(cid:34)(cid:19)(cid:18)(cid:18)(cid:2)(cid:44,,27706.0
,,26,,,Unknown,,cid:43)(cid:2)(cid:1)(cid:34)(cid:34)(cid:19)(cid:18)(cid:18)(cid:2)(cid:44,,27732.0
,,41,,,Unknown,,cid:43)(cid:2)(cid:1)(cid:34)(cid:34)(cid:19)(cid:18)(cid:18)(cid:2)(cid:44,,27773.0
,,25,,,Unknown,,cid:43)(cid:2)(cid:1)(cid:34)(cid:34)(cid:19)(cid:18)(cid:18)(cid:2)(cid:44,,27798.0
,,2,,,Unknown,,cid:43)(cid:2)(cid:1)(cid:34)(cid:34)(cid:19)(cid:18)(cid:18)(cid:2)(cid:44,,27800.0
,,50,,,Unknown,,cid:43)(cid:2)(cid:1)(cid:34)(cid:34)(cid:19)(cid:18)(cid:18)(cid:2)(cid:44,,27850.0
,,50,,,Unknown,,cid:43)(cid:2)(cid:1)(cid:34)(cid:34)(cid:19)(cid:18)(cid:18)(cid:2)(cid:44,,27900.0
,,37,,,Unknown,,cid:43)(cid:2)(cid:1)(cid:34)(cid:34)(cid:19)(cid:18)(cid:18)(cid:2)(cid:44,,27937.0
,,16,,,Unknown,,cid:43)(cid:2)(cid:1)(cid:34)(cid:34)(cid:19)(cid:18)(cid:18)(cid:2)(cid:44,,27953.0
,,34,,,Unknown,,cid:43)(cid:2)(cid:1)(cid:34)(cid:34)(cid:19)(cid:18)(cid:18)(cid:2)(cid:44,,27987.0
,,33,,,Unknown,,cid:43)(cid:2)(cid:1)(cid:34)(cid:34)(cid:19)(cid:18)(cid:18)(cid:2)(cid:44,,28020.0
,,1,,,Unknown,,cid:43)(cid:2)(cid:1)(cid:34)(cid:34)(cid:19)(cid:18)(cid:18)(cid:2)(cid:44,,28021.0
,,32,,,Unknown,,cid:43)(cid:2)(cid:1)(cid:34)(cid:34)(cid:19)(cid:18)(cid:18)(cid:2)(cid:44,,28053.0
,,45,,,Unknown,,cid:43)(cid:2)(cid:1)(cid:34)(cid:34)(cid:19)(cid:18)(cid:18)(cid:2)(cid:44,,28098.0
,,18,,,Unknown,,cid:43)(cid:2)(cid:1)(cid:34)(cid:34)(cid:19)(cid:18)(cid:18)(cid:2)(cid:44,,28116.0
,,35,,,Unknown,,cid:43)(cid:2)(cid:1)(cid:34)(cid:34)(cid:19)(cid:18)(cid:18)(cid:2)(cid:44,,28151.0
,,51,,,Unknown,,cid:43)(cid:2)(cid:1)(cid:34)(cid:34)(cid:19)(cid:18)(cid:18)(cid:2)(cid:44,,28202.0
,,5,,,Unknown,,cid:43)(cid:2)(cid:1)(cid:34)(cid:34)(cid:19)(cid:18)(cid:18)(cid:2)(cid:44,,28207.0
,,67,,,Unknown,,cid:43)(cid:2)(cid:1)(cid:34)(cid:34)(cid:19)(cid:18)(cid:18)(cid:2)(cid:44,,28274.0
,,46,,,Unknown,,cid:43)(cid:2)(cid:1)(cid:34)(cid:34)(cid:19)(cid:18)(cid:18)(cid:2)(cid:44,,28320.0
,,2,,,Unknown,,cid:43)(cid:2)(cid:1)(cid:34)(cid:34)(cid:19)(cid:18)(cid:18)(cid:2)(cid:44,,28322.0
,,10,,,Unknown,,cid:43)(cid:2)(cid:1)(cid:34)(cid:34)(cid:19)(cid:18)(cid:18)(cid:2)(cid:44,,28332.0
,,3,,,Unknown,,cid:43)(cid:2)(cid:1)(cid:34)(cid:34)(cid:19)(cid:18)(cid:18)(cid:2)(cid:44,,28335.0
,,46,,,Unknown,,cid:43)(cid:2)(cid:1)(cid:34)(cid:34)(cid:19)(cid:18)(cid:18)(cid:2)(cid:44,,28381.0
,,49,,,Unknown,,cid:43)(cid:2)(cid:1)(cid:34)(cid:34)(cid:19)(cid:18)(cid:18)(cid:2)(cid:44,,28430.0
,,5,,,Unknown,,cid:43)(cid:2)(cid:1)(cid:34)(cid:34)(cid:19)(cid:18)(cid:18)(cid:2)(cid:44,,28435.0
,,2,,,Unknown,,cid:43)(cid:2)(cid:1)(cid:34)(cid:34)(cid:19)(cid:18)(cid:18)(cid:2)(cid:44,,28437.0
,,9,,,Unknown,,cid:43)(cid:2)(cid:1)(cid:34)(cid:34)(cid:19)(cid:18)(cid:18)(cid:2)(cid:44,,28446.0
,,13,,,Unknown,,cid:43)(cid:2)(cid:1)(cid:34)(cid:34)(cid:19)(cid:18)(cid:18)(cid:2)(cid:44,,28459.0
,,39,,,Unknown,,cid:43)(cid:2)(cid:1)(cid:34)(cid:34)(cid:19)(cid:18)(cid:18)(cid:2)(cid:44,,28498.0
,,67,,,Unknown,,cid:43)(cid:2)(cid:1)(cid:34)(cid:34)(cid:19)(cid:18)(cid:18)(cid:2)(cid:44,,28565.0
,,2,,,Unknown,,cid:43)(cid:2)(cid:1)(cid:34)(cid:34)(cid:19)(cid:18)(cid:18)(cid:2)(cid:44,,28567.0
,,39,,,Unknown,,cid:43)(cid:2)(cid:1)(cid:34)(cid:34)(cid:19)(cid:18)(cid:18)(cid:2)(cid:44,,28606.0
,,3,,,Unknown,,cid:43)(cid:2)(cid:1)(cid:34)(cid:34)(cid:19)(cid:18)(cid:18)(cid:2)(cid:44,,28609.0
,,7,,,Unknown,,cid:43)(cid:2)(cid:1)(cid:34)(cid:34)(cid:19)(cid:18)(cid:18)(cid:2)(cid:44,,28616.0
,,9,,,Unknown,,cid:43)(cid:2)(cid:1)(cid:34)(cid:34)(cid:19)(cid:18)(cid:18)(cid:2)(cid:44,,28625.0
,,13,,,Unknown,,cid:43)(cid:2)(cid:1)(cid:34)(cid:34)(cid:19)(cid:18)(cid:18)(cid:2)(cid:44,,28638.0
,,10,,,Unknown,,cid:43)(cid:2)(cid:1)(cid:34)(cid:34)(cid:19)(cid:18)(cid:18)(cid:2)(cid:44,,28648.0
,,7,,,Unknown,,cid:43)(cid:2)(cid:1)(cid:34)(cid:34)(cid:19)(cid:18)(cid:18)(cid:2)(cid:44,,28655.0
,,8,,,Unknown,,cid:43)(cid:2)(cid:1)(cid:34)(cid:34)(cid:19)(cid:18)(cid:18)(cid:2)(cid:44,,28663.0
,,46,,,Unknown,,cid:43)(cid:2)(cid:1)(cid:34)(cid:34)(cid:19)(cid:18)(cid:18)(cid:2)(cid:44,,28709.0
,,2,,,Unknown,,cid:43)(cid:2)(cid:1)(cid:34)(cid:34)(cid:19)(cid:18)(cid:18)(cid:2)(cid:44,,28711.0
,,38,,,Unknown,,cid:43)(cid:2)(cid:1)(cid:34)(cid:34)(cid:19)(cid:18)(cid:18)(cid:2)(cid:44,,28749.0
,,64,,,Unknown,,cid:43)(cid:2)(cid:1)(cid:34)(cid:34)(cid:19)(cid:18)(cid:18)(cid:2)(cid:44,,28813.0
,,15,,,Unknown,,cid:43)(cid:2)(cid:1)(cid:34)(cid:34)(cid:19)(cid:18)(cid:18)(cid:2)(cid:44,,28828.0
,,2,,,Unknown,,cid:43)(cid:2)(cid:1)(cid:34)(cid:34)(cid:19)(cid:18)(cid:18)(cid:2)(cid:44,,28830.0
,,37,,,Unknown,,cid:43)(cid:2)(cid:1)(cid:34)(cid:34)(cid:19)(cid:18)(cid:18)(cid:2)(cid:44,,28867.0
,,18,,,Unknown,,cid:43)(cid:2)(cid:1)(cid:34)(cid:34)(cid:19)(cid:18)(cid:18)(cid:2)(cid:44,,28885.0
,,19,,,Unknown,,cid:43)(cid:2)(cid:1)(cid:34)(cid:34)(cid:19)(cid:18)(cid:18)(cid:2)(cid:44,,28904.0
,,17,,,Unknown,,cid:43)(cid:2)(cid:1)(cid:34)(cid:34)(cid:19)(cid:18)(cid:18)(cid:2)(cid:44,,28921.0
,,16,,,Unknown,,cid:43)(cid:2)(cid:1)(cid:34)(cid:34)(cid:19)(cid:18)(cid:18)(cid:2)(cid:44,,28937.0
,,2,,,Unknown,,cid:43)(cid:2)(cid:1)(cid:34)(cid:34)(cid:19)(cid:18)(cid:18)(cid:2)(cid:44,,28939.0
,,44,,,Unknown,,cid:43)(cid:2)(cid:1)(cid:34)(cid:34)(cid:19)(cid:18)(cid:18)(cid:2)(cid:44,,28983.0
,,12,,,Unknown,,cid:43)(cid:2)(cid:1)(cid:34)(cid:34)(cid:19)(cid:18)(cid:18)(cid:2)(cid:44,,28995.0
,,29,,,Unknown,,cid:43)(cid:2)(cid:1)(cid:34)(cid:34)(cid:19)(cid:18)(cid:18)(cid:2)(cid:44,,29024.0
,,26,,,Unknown,,cid:43)(cid:2)(cid:1)(cid:34)(cid:34)(cid:19)(cid:18)(cid:18)(cid:2)(cid:44,,29050.0
,,41,,,Unknown,,cid:43)(cid:2)(cid:1)(cid:34)(cid:34)(cid:19)(cid:18)(cid:18)(cid:2)(cid:44,,29091.0
,,25,,,Unknown,,cid:43)(cid:2)(cid:1)(cid:34)(cid:34)(cid:19)(cid:18)(cid:18)(cid:2)(cid:44,,29116.0
,,2,,,Unknown,,cid:43)(cid:2)(cid:1)(cid:34)(cid:34)(cid:19)(cid:18)(cid:18)(cid:2)(cid:44,,29118.0
,,50,,,Unknown,,cid:43)(cid:2)(cid:1)(cid:34)(cid:34)(cid:19)(cid:18)(cid:18)(cid:2)(cid:44,,29168.0
,,50,,,Unknown,,cid:43)(cid:2)(cid:1)(cid:34)(cid:34)(cid:19)(cid:18)(cid:18)(cid:2)(cid:44,,29218.0
,,18,,,Unknown,,cid:43)(cid:2)(cid:1)(cid:34)(cid:34)(cid:19)(cid:18)(cid:18)(cid:2)(cid:44,,29236.0
,,1,,,Unknown,,cid:43)(cid:2)(cid:1)(cid:34)(cid:34)(cid:19)(cid:18)(cid:18)(cid:2)(cid:44,,29237.0
,,1,,,Unknown,,cid:43)(cid:2)(cid:1)(cid:34)(cid:34)(cid:19)(cid:18)(cid:18)(cid:2)(cid:44,,29238.0
,,37,,,Unknown,,cid:43)(cid:2)(cid:1)(cid:34)(cid:34)(cid:19)(cid:18)(cid:18)(cid:2)(cid:44,,29275.0
,,1,,,Unknown,,cid:15)(cid:2)(cid:17)(cid:2)(cid:18)(cid:1)(cid:18)(cid:19)(cid:18)(cid:18)(cid:2)(cid:1)(cid:2)(cid:3,cid:16)(cid:19)(cid:36)(cid:36)(cid:32)(cid:35)(cid:18)(cid:35)(cid:34)(cid:17)(cid:18)(cid:32)(cid:37)(cid:35)(cid:37)(cid:2)(cid:74)(cid:30)(cid:2)(cid:73)(cid:2)(cid:17)(cid:19)(cid:18)(cid:18)(cid:2)(cid:44,1.0
,,16,,,Unknown,,cid:15)(cid:2)(cid:17)(cid:2)(cid:18)(cid:1)(cid:18)(cid:19)(cid:18)(cid:18)(cid:2)(cid:1)(cid:2)(cid:3,cid:15)(cid:2)(cid:17)(cid:32)(cid:37)(cid:19)(cid:17)(cid:33)(cid:2)(cid:44,17.0
,,45,,,Unknown,,cid:15)(cid:2)(cid:17)(cid:2)(cid:18)(cid:1)(cid:18)(cid:19)(cid:18)(cid:18)(cid:2)(cid:1)(cid:2)(cid:3,cid:9)(cid:46)(cid:8)(cid:5)(cid:28)(cid:2)(cid:9)(cid:5)(cid:8)(cid:14)(cid:7)(cid:9)(cid:2)(cid:28)(cid:3,62.0
,,18,,,Unknown,,cid:15)(cid:2)(cid:17)(cid:2)(cid:18)(cid:1)(cid:18)(cid:19)(cid:18)(cid:18)(cid:2)(cid:1)(cid:2)(cid:3,cid:9)(cid:46)(cid:8)(cid:5)(cid:28)(cid:2)(cid:9)(cid:5)(cid:8)(cid:14)(cid:7)(cid:9)(cid:2)(cid:28)(cid:3,80.0
,,35,,,Unknown,,cid:15)(cid:2)(cid:17)(cid:2)(cid:18)(cid:1)(cid:18)(cid:19)(cid:18)(cid:18)(cid:2)(cid:1)(cid:2)(cid:3,,115.0
,,65,,,Unknown,,cid:15)(cid:2)(cid:17)(cid:2)(cid:18)(cid:1)(cid:18)(cid:19)(cid:18)(cid:18)(cid:2)(cid:1)(cid:2)(cid:3,,180.0
,,39,,,Unknown,,cid:15)(cid:2)(cid:17)(cid:2)(cid:18)(cid:1)(cid:18)(cid:19)(cid:18)(cid:18)(cid:2)(cid:1)(cid:2)(cid:3,,219.0
,,2,,,Unknown,,cid:15)(cid:2)(cid:17)(cid:2)(cid:18)(cid:1)(cid:18)(cid:19)(cid:18)(cid:18)(cid:2)(cid:1)(cid:2)(cid:3,,221.0
,,39,,,Unknown,,cid:15)(cid:2)(cid:17)(cid:2)(cid:18)(cid:1)(cid:18)(cid:19)(cid:18)(cid:18)(cid:2)(cid:1)(cid:2)(cid:3,,260.0
,,4,,,Unknown,,cid:15)(cid:2)(cid:17)(cid:2)(cid:18)(cid:1)(cid:18)(cid:19)(cid:18)(cid:18)(cid:2)(cid:1)(cid:2)(cid:3,,264.0
,,10,,,Unknown,,cid:15)(cid:2)(cid:17)(cid:2)(cid:18)(cid:1)(cid:18)(cid:19)(cid:18)(cid:18)(cid:2)(cid:1)(cid:2)(cid:3,,274.0
,,5,,,Unknown,,cid:15)(cid:2)(cid:17)(cid:2)(cid:18)(cid:1)(cid:18)(cid:19)(cid:18)(cid:18)(cid:2)(cid:1)(cid:2)(cid:3,,279.0
,,52,,,Unknown,,cid:15)(cid:2)(cid:17)(cid:2)(cid:18)(cid:1)(cid:18)(cid:19)(cid:18)(cid:18)(cid:2)(cid:1)(cid:2)(cid:3,,331.0
,,7,,,Unknown,,cid:15)(cid:2)(cid:17)(cid:2)(cid:18)(cid:1)(cid:18)(cid:19)(cid:18)(cid:18)(cid:2)(cid:1)(cid:2)(cid:3,,338.0
,,2,,,Unknown,,cid:15)(cid:2)(cid:17)(cid:2)(cid:18)(cid:1)(cid:18)(cid:19)(cid:18)(cid:18)(cid:2)(cid:1)(cid:2)(cid:3,,340.0
,,51,,,Unknown,,cid:15)(cid:2)(cid:17)(cid:2)(cid:18)(cid:1)(cid:18)(cid:19)(cid:18)(cid:18)(cid:2)(cid:1)(cid:2)(cid:3,,391.0
,,5,,,Unknown,,cid:15)(cid:2)(cid:17)(cid:2)(cid:18)(cid:1)(cid:18)(cid:19)(cid:18)(cid:18)(cid:2)(cid:1)(cid:2)(cid:3,,396.0
,,11,,,Unknown,,cid:15)(cid:2)(cid:17)(cid:2)(cid:18)(cid:1)(cid:18)(cid:19)(cid:18)(cid:18)(cid:2)(cid:1)(cid:2)(cid:3,,407.0
,,53,,,Unknown,,cid:15)(cid:2)(cid:17)(cid:2)(cid:18)(cid:1)(cid:18)(cid:19)(cid:18)(cid:18)(cid:2)(cid:1)(cid:2)(cid:3,,460.0
,,3,,,Unknown,,cid:15)(cid:2)(cid:17)(cid:2)(cid:18)(cid:1)(cid:18)(cid:19)(cid:18)(cid:18)(cid:2)(cid:1)(cid:2)(cid:3,,463.0
,,46,,,Unknown,,cid:15)(cid:2)(cid:17)(cid:2)(cid:18)(cid:1)(cid:18)(cid:19)(cid:18)(cid:18)(cid:2)(cid:1)(cid:2)(cid:3,,509.0
,,49,,,Unknown,,cid:15)(cid:2)(cid:17)(cid:2)(cid:18)(cid:1)(cid:18)(cid:19)(cid:18)(cid:18)(cid:2)(cid:1)(cid:2)(cid:3,,558.0
,,2,,,Unknown,,cid:15)(cid:2)(cid:17)(cid:2)(cid:18)(cid:1)(cid:18)(cid:19)(cid:18)(cid:18)(cid:2)(cid:1)(cid:2)(cid:3,,560.0
,,17,,,Unknown,,cid:15)(cid:2)(cid:17)(cid:2)(cid:18)(cid:1)(cid:18)(cid:19)(cid:18)(cid:18)(cid:2)(cid:1)(cid:2)(cid:3,,577.0
,,37,,,Unknown,,cid:15)(cid:2)(cid:17)(cid:2)(cid:18)(cid:1)(cid:18)(cid:19)(cid:18)(cid:18)(cid:2)(cid:1)(cid:2)(cid:3,,614.0
,,2,,,Unknown,,cid:15)(cid:2)(cid:17)(cid:2)(cid:18)(cid:1)(cid:18)(cid:19)(cid:18)(cid:18)(cid:2)(cid:1)(cid:2)(cid:3,,616.0
,,51,,,Unknown,,cid:15)(cid:2)(cid:17)(cid:2)(cid:18)(cid:1)(cid:18)(cid:19)(cid:18)(cid:18)(cid:2)(cid:1)(cid:2)(cid:3,,667.0
,,5,,,Unknown,,cid:15)(cid:2)(cid:17)(cid:2)(cid:18)(cid:1)(cid:18)(cid:19)(cid:18)(cid:18)(cid:2)(cid:1)(cid:2)(cid:3,,672.0
,,11,,,Unknown,,cid:15)(cid:2)(cid:17)(cid:2)(cid:18)(cid:1)(cid:18)(cid:19)(cid:18)(cid:18)(cid:2)(cid:1)(cid:2)(cid:3,,683.0
,,53,,,Unknown,,cid:15)(cid:2)(cid:17)(cid:2)(cid:18)(cid:1)(cid:18)(cid:19)(cid:18)(cid:18)(cid:2)(cid:1)(cid:2)(cid:3,,736.0
,,3,,,Unknown,,cid:15)(cid:2)(cid:17)(cid:2)(cid:18)(cid:1)(cid:18)(cid:19)(cid:18)(cid:18)(cid:2)(cid:1)(cid:2)(cid:3,,739.0
,,46,,,Unknown,,cid:15)(cid:2)(cid:17)(cid:2)(cid:18)(cid:1)(cid:18)(cid:19)(cid:18)(cid:18)(cid:2)(cid:1)(cid:2)(cid:3,,785.0
,,49,,,Unknown,,cid:15)(cid:2)(cid:17)(cid:2)(cid:18)(cid:1)(cid:18)(cid:19)(cid:18)(cid:18)(cid:2)(cid:1)(cid:2)(cid:3,,834.0
,,2,,,Unknown,,cid:15)(cid:2)(cid:17)(cid:2)(cid:18)(cid:1)(cid:18)(cid:19)(cid:18)(cid:18)(cid:2)(cid:1)(cid:2)(cid:3,,836.0
,,3,,,Unknown,,cid:15)(cid:2)(cid:17)(cid:2)(cid:18)(cid:1)(cid:18)(cid:19)(cid:18)(cid:18)(cid:2)(cid:1)(cid:2)(cid:3,,839.0
,,9,,,Unknown,,cid:15)(cid:2)(cid:17)(cid:2)(cid:18)(cid:1)(cid:18)(cid:19)(cid:18)(cid:18)(cid:2)(cid:1)(cid:2)(cid:3,,848.0
,,15,,,Unknown,,cid:15)(cid:2)(cid:17)(cid:2)(cid:18)(cid:1)(cid:18)(cid:19)(cid:18)(cid:18)(cid:2)(cid:1)(cid:2)(cid:3,,863.0
,,2,,,Unknown,,cid:15)(cid:2)(cid:17)(cid:2)(cid:18)(cid:1)(cid:18)(cid:19)(cid:18)(cid:18)(cid:2)(cid:1)(cid:2)(cid:3,,865.0
,,35,,,Unknown,,cid:15)(cid:2)(cid:17)(cid:2)(cid:18)(cid:1)(cid:18)(cid:19)(cid:18)(cid:18)(cid:2)(cid:1)(cid:2)(cid:3,,900.0
,,19,,,Unknown,,cid:15)(cid:2)(cid:17)(cid:2)(cid:18)(cid:1)(cid:18)(cid:19)(cid:18)(cid:18)(cid:2)(cid:1)(cid:2)(cid:3,,919.0
,,16,,,Unknown,,cid:15)(cid:2)(cid:17)(cid:2)(cid:18)(cid:1)(cid:18)(cid:19)(cid:18)(cid:18)(cid:2)(cid:1)(cid:2)(cid:3,,935.0
,,18,,,Unknown,,cid:15)(cid:2)(cid:17)(cid:2)(cid:18)(cid:1)(cid:18)(cid:19)(cid:18)(cid:18)(cid:2)(cid:1)(cid:2)(cid:3,,953.0
,,2,,,Unknown,,cid:15)(cid:2)(cid:17)(cid:2)(cid:18)(cid:1)(cid:18)(cid:19)(cid:18)(cid:18)(cid:2)(cid:1)(cid:2)(cid:3,,955.0
,,44,,,Unknown,,cid:15)(cid:2)(cid:17)(cid:2)(cid:18)(cid:1)(cid:18)(cid:19)(cid:18)(cid:18)(cid:2)(cid:1)(cid:2)(cid:3,,999.0
,,17,,,Unknown,,cid:15)(cid:2)(cid:17)(cid:2)(cid:18)(cid:1)(cid:18)(cid:19)(cid:18)(cid:18)(cid:2)(cid:1)(cid:2)(cid:3,,1016.0
,,17,,,Unknown,,cid:15)(cid:2)(cid:17)(cid:2)(cid:18)(cid:1)(cid:18)(cid:19)(cid:18)(cid:18)(cid:2)(cid:1)(cid:2)(cid:3,,1033.0
,,16,,,Unknown,,cid:15)(cid:2)(cid:17)(cid:2)(cid:18)(cid:1)(cid:18)(cid:19)(cid:18)(cid:18)(cid:2)(cid:1)(cid:2)(cid:3,,1049.0
,,19,,,Unknown,,cid:15)(cid:2)(cid:17)(cid:2)(cid:18)(cid:1)(cid:18)(cid:19)(cid:18)(cid:18)(cid:2)(cid:1)(cid:2)(cid:3,,1068.0
,,1,,,Unknown,,cid:15)(cid:2)(cid:17)(cid:2)(cid:18)(cid:1)(cid:18)(cid:19)(cid:18)(cid:18)(cid:2)(cid:1)(cid:2)(cid:3,,1069.0
,,36,,,Unknown,,cid:15)(cid:2)(cid:17)(cid:2)(cid:18)(cid:1)(cid:18)(cid:19)(cid:18)(cid:18)(cid:2)(cid:1)(cid:2)(cid:3,,1105.0
,,17,,,Unknown,,cid:15)(cid:2)(cid:17)(cid:2)(cid:18)(cid:1)(cid:18)(cid:19)(cid:18)(cid:18)(cid:2)(cid:1)(cid:2)(cid:3,,1122.0
,,37,,,Unknown,,cid:15)(cid:2)(cid:17)(cid:2)(cid:18)(cid:1)(cid:18)(cid:19)(cid:18)(cid:18)(cid:2)(cid:1)(cid:2)(cid:3,,1159.0
,,16,,,Unknown,,cid:15)(cid:2)(cid:17)(cid:2)(cid:18)(cid:1)(cid:18)(cid:19)(cid:18)(cid:18)(cid:2)(cid:1)(cid:2)(cid:3,,1175.0
,,33,,,Unknown,,cid:15)(cid:2)(cid:17)(cid:2)(cid:18)(cid:1)(cid:18)(cid:19)(cid:18)(cid:18)(cid:2)(cid:1)(cid:2)(cid:3,,1208.0
,,37,,,Unknown,,cid:15)(cid:2)(cid:17)(cid:2)(cid:18)(cid:1)(cid:18)(cid:19)(cid:18)(cid:18)(cid:2)(cid:1)(cid:2)(cid:3,,1245.0
,,17,,,Unknown,,cid:15)(cid:2)(cid:17)(cid:2)(cid:18)(cid:1)(cid:18)(cid:19)(cid:18)(cid:18)(cid:2)(cid:1)(cid:2)(cid:3,,1262.0
,,18,,,Unknown,,cid:15)(cid:2)(cid:17)(cid:2)(cid:18)(cid:1)(cid:18)(cid:19)(cid:18)(cid:18)(cid:2)(cid:1)(cid:2)(cid:3,,1280.0
,,37,,,Unknown,,cid:15)(cid:2)(cid:17)(cid:2)(cid:18)(cid:1)(cid:18)(cid:19)(cid:18)(cid:18)(cid:2)(cid:1)(cid:2)(cid:3,,1317.0
,,36,,,Unknown,,cid:15)(cid:2)(cid:17)(cid:2)(cid:18)(cid:1)(cid:18)(cid:19)(cid:18)(cid:18)(cid:2)(cid:1)(cid:2)(cid:3,,1353.0
,,34,,,Unknown,,cid:15)(cid:2)(cid:17)(cid:2)(cid:18)(cid:1)(cid:18)(cid:19)(cid:18)(cid:18)(cid:2)(cid:1)(cid:2)(cid:3,,1387.0
,,2,,,Unknown,,cid:15)(cid:2)(cid:17)(cid:2)(cid:18)(cid:1)(cid:18)(cid:19)(cid:18)(cid:18)(cid:2)(cid:1)(cid:2)(cid:3,,1389.0
,,1,,,Unknown,,cid:15)(cid:2)(cid:17)(cid:2)(cid:18)(cid:1)(cid:18)(cid:19)(cid:18)(cid:18)(cid:2)(cid:1)(cid:2)(cid:3,,1390.0
,,2,,,Unknown,,cid:15)(cid:2)(cid:17)(cid:2)(cid:18)(cid:1)(cid:18)(cid:19)(cid:18)(cid:18)(cid:2)(cid:1)(cid:2)(cid:3,,1392.0
,,3,,,Unknown,,cid:15)(cid:2)(cid:17)(cid:2)(cid:18)(cid:1)(cid:18)(cid:19)(cid:18)(cid:18)(cid:2)(cid:1)(cid:2)(cid:3,,1395.0
,,2,,,Unknown,,cid:15)(cid:2)(cid:17)(cid:2)(cid:18)(cid:1)(cid:18)(cid:19)(cid:18)(cid:18)(cid:2)(cid:1)(cid:2)(cid:3,,1397.0
,,73,,,Unknown,,cid:15)(cid:2)(cid:17)(cid:2)(cid:18)(cid:1)(cid:18)(cid:19)(cid:18)(cid:18)(cid:2)(cid:1)(cid:2)(cid:3,,1470.0
,,2,,,Unknown,,cid:15)(cid:2)(cid:17)(cid:2)(cid:18)(cid:1)(cid:18)(cid:19)(cid:18)(cid:18)(cid:2)(cid:1)(cid:2)(cid:3,,1472.0
,,17,,,Unknown,,cid:15)(cid:2)(cid:17)(cid:2)(cid:18)(cid:1)(cid:18)(cid:19)(cid:18)(cid:18)(cid:2)(cid:1)(cid:2)(cid:3,,1489.0
,,19,,,Unknown,,cid:15)(cid:2)(cid:17)(cid:2)(cid:18)(cid:1)(cid:18)(cid:19)(cid:18)(cid:18)(cid:2)(cid:1)(cid:2)(cid:3,,1508.0
,,18,,,Unknown,,cid:15)(cid:2)(cid:17)(cid:2)(cid:18)(cid:1)(cid:18)(cid:19)(cid:18)(cid:18)(cid:2)(cid:1)(cid:2)(cid:3,,1526.0
,,18,,,Unknown,,cid:15)(cid:2)(cid:17)(cid:2)(cid:18)(cid:1)(cid:18)(cid:19)(cid:18)(cid:18)(cid:2)(cid:1)(cid:2)(cid:3,,1544.0
,,2,,,Unknown,,cid:15)(cid:2)(cid:17)(cid:2)(cid:18)(cid:1)(cid:18)(cid:19)(cid:18)(cid:18)(cid:2)(cid:1)(cid:2)(cid:3,,1546.0
,,44,,,Unknown,,cid:15)(cid:2)(cid:17)(cid:2)(cid:18)(cid:1)(cid:18)(cid:19)(cid:18)(cid:18)(cid:2)(cid:1)(cid:2)(cid:3,,1590.0
,,15,,,Unknown,,cid:15)(cid:2)(cid:17)(cid:2)(cid:18)(cid:1)(cid:18)(cid:19)(cid:18)(cid:18)(cid:2)(cid:1)(cid:2)(cid:3,,1605.0
,,2,,,Unknown,,cid:15)(cid:2)(cid:17)(cid:2)(cid:18)(cid:1)(cid:18)(cid:19)(cid:18)(cid:18)(cid:2)(cid:1)(cid:2)(cid:3,,1607.0
,,17,,,Unknown,,cid:15)(cid:2)(cid:17)(cid:2)(cid:18)(cid:1)(cid:18)(cid:19)(cid:18)(cid:18)(cid:2)(cid:1)(cid:2)(cid:3,,1624.0
,,2,,,Unknown,,cid:15)(cid:2)(cid:17)(cid:2)(cid:18)(cid:1)(cid:18)(cid:19)(cid:18)(cid:18)(cid:2)(cid:1)(cid:2)(cid:3,,1626.0
,,18,,,Unknown,,cid:15)(cid:2)(cid:17)(cid:2)(cid:18)(cid:1)(cid:18)(cid:19)(cid:18)(cid:18)(cid:2)(cid:1)(cid:2)(cid:3,,1644.0
,,1,,,Unknown,,cid:15)(cid:2)(cid:17)(cid:2)(cid:18)(cid:1)(cid:18)(cid:19)(cid:18)(cid:18)(cid:2)(cid:1)(cid:2)(cid:3,,1645.0
,,18,,,Unknown,,cid:15)(cid:2)(cid:17)(cid:2)(cid:18)(cid:1)(cid:18)(cid:19)(cid:18)(cid:18)(cid:2)(cid:1)(cid:2)(cid:3,,1663.0
,,19,,,Unknown,,cid:15)(cid:2)(cid:17)(cid:2)(cid:18)(cid:1)(cid:18)(cid:19)(cid:18)(cid:18)(cid:2)(cid:1)(cid:2)(cid:3,,1682.0
,,18,,,Unknown,,cid:15)(cid:2)(cid:17)(cid:2)(cid:18)(cid:1)(cid:18)(cid:19)(cid:18)(cid:18)(cid:2)(cid:1)(cid:2)(cid:3,,1700.0
,,18,,,Unknown,,cid:15)(cid:2)(cid:17)(cid:2)(cid:18)(cid:1)(cid:18)(cid:19)(cid:18)(cid:18)(cid:2)(cid:1)(cid:2)(cid:3,,1718.0
,,2,,,Unknown,,cid:15)(cid:2)(cid:17)(cid:2)(cid:18)(cid:1)(cid:18)(cid:19)(cid:18)(cid:18)(cid:2)(cid:1)(cid:2)(cid:3,,1720.0
,,1,,,Unknown,,cid:15)(cid:2)(cid:17)(cid:2)(cid:18)(cid:1)(cid:18)(cid:19)(cid:18)(cid:18)(cid:2)(cid:1)(cid:2)(cid:3,,1721.0
,,2,,,Unknown,,cid:15)(cid:2)(cid:17)(cid:2)(cid:18)(cid:1)(cid:18)(cid:19)(cid:18)(cid:18)(cid:2)(cid:1)(cid:2)(cid:3,,1723.0
,,3,,,Unknown,,cid:15)(cid:2)(cid:17)(cid:2)(cid:18)(cid:1)(cid:18)(cid:19)(cid:18)(cid:18)(cid:2)(cid:1)(cid:2)(cid:3,,1726.0
,,12,,,Unknown,,cid:15)(cid:2)(cid:17)(cid:2)(cid:18)(cid:1)(cid:18)(cid:19)(cid:18)(cid:18)(cid:2)(cid:1)(cid:2)(cid:3,,1738.0
,,29,,,Unknown,,cid:15)(cid:2)(cid:17)(cid:2)(cid:18)(cid:1)(cid:18)(cid:19)(cid:18)(cid:18)(cid:2)(cid:1)(cid:2)(cid:3,,1767.0
,,26,,,Unknown,,cid:15)(cid:2)(cid:17)(cid:2)(cid:18)(cid:1)(cid:18)(cid:19)(cid:18)(cid:18)(cid:2)(cid:1)(cid:2)(cid:3,,1793.0
,,41,,,Unknown,,cid:15)(cid:2)(cid:17)(cid:2)(cid:18)(cid:1)(cid:18)(cid:19)(cid:18)(cid:18)(cid:2)(cid:1)(cid:2)(cid:3,,1834.0
,,25,,,Unknown,,cid:15)(cid:2)(cid:17)(cid:2)(cid:18)(cid:1)(cid:18)(cid:19)(cid:18)(cid:18)(cid:2)(cid:1)(cid:2)(cid:3,,1859.0
,,2,,,Unknown,,cid:15)(cid:2)(cid:17)(cid:2)(cid:18)(cid:1)(cid:18)(cid:19)(cid:18)(cid:18)(cid:2)(cid:1)(cid:2)(cid:3,,1861.0
,,50,,,Unknown,,cid:15)(cid:2)(cid:17)(cid:2)(cid:18)(cid:1)(cid:18)(cid:19)(cid:18)(cid:18)(cid:2)(cid:1)(cid:2)(cid:3,,1911.0
,,50,,,Unknown,,cid:15)(cid:2)(cid:17)(cid:2)(cid:18)(cid:1)(cid:18)(cid:19)(cid:18)(cid:18)(cid:2)(cid:1)(cid:2)(cid:3,,1961.0
,,18,,,Unknown,,cid:15)(cid:2)(cid:17)(cid:2)(cid:18)(cid:1)(cid:18)(cid:19)(cid:18)(cid:18)(cid:2)(cid:1)(cid:2)(cid:3,,1979.0
,,1,,,Unknown,,cid:15)(cid:2)(cid:17)(cid:2)(cid:18)(cid:1)(cid:18)(cid:19)(cid:18)(cid:18)(cid:2)(cid:1)(cid:2)(cid:3,,1980.0
,,1,,,Unknown,,cid:15)(cid:2)(cid:17)(cid:2)(cid:18)(cid:1)(cid:18)(cid:19)(cid:18)(cid:18)(cid:2)(cid:1)(cid:2)(cid:3,,1981.0
,,37,,,Unknown,,cid:15)(cid:2)(cid:17)(cid:2)(cid:18)(cid:1)(cid:18)(cid:19)(cid:18)(cid:18)(cid:2)(cid:1)(cid:2)(cid:3,,2018.0
,,1,,,Unknown,,cid:15)(cid:2)(cid:17)(cid:2)(cid:18)(cid:1)(cid:18)(cid:19)(cid:18)(cid:18)(cid:2)(cid:1)(cid:2)(cid:3,,2019.0
,,35,,,Unknown,,cid:15)(cid:2)(cid:17)(cid:2)(cid:18)(cid:1)(cid:18)(cid:19)(cid:18)(cid:18)(cid:2)(cid:1)(cid:2)(cid:3,,2054.0
,,45,,,Unknown,,cid:15)(cid:2)(cid:17)(cid:2)(cid:18)(cid:1)(cid:18)(cid:19)(cid:18)(cid:18)(cid:2)(cid:1)(cid:2)(cid:3,,2099.0
,,18,,,Unknown,,cid:15)(cid:2)(cid:17)(cid:2)(cid:18)(cid:1)(cid:18)(cid:19)(cid:18)(cid:18)(cid:2)(cid:1)(cid:2)(cid:3,,2117.0
,,35,,,Unknown,,cid:15)(cid:2)(cid:17)(cid:2)(cid:18)(cid:1)(cid:18)(cid:19)(cid:18)(cid:18)(cid:2)(cid:1)(cid:2)(cid:3,,2152.0
,,46,,,Unknown,,cid:15)(cid:2)(cid:17)(cid:2)(cid:18)(cid:1)(cid:18)(cid:19)(cid:18)(cid:18)(cid:2)(cid:1)(cid:2)(cid:3,,2198.0
,,37,,,Unknown,,cid:15)(cid:2)(cid:17)(cid:2)(cid:18)(cid:1)(cid:18)(cid:19)(cid:18)(cid:18)(cid:2)(cid:1)(cid:2)(cid:3,,2235.0
,,2,,,Unknown,,cid:15)(cid:2)(cid:17)(cid:2)(cid:18)(cid:1)(cid:18)(cid:19)(cid:18)(cid:18)(cid:2)(cid:1)(cid:2)(cid:3,,2237.0
,,7,,,Unknown,,cid:15)(cid:2)(cid:17)(cid:2)(cid:18)(cid:1)(cid:18)(cid:19)(cid:18)(cid:18)(cid:2)(cid:1)(cid:2)(cid:3,,2244.0
,,52,,,Unknown,,cid:15)(cid:2)(cid:17)(cid:2)(cid:18)(cid:1)(cid:18)(cid:19)(cid:18)(cid:18)(cid:2)(cid:1)(cid:2)(cid:3,,2296.0
,,46,,,Unknown,,cid:15)(cid:2)(cid:17)(cid:2)(cid:18)(cid:1)(cid:18)(cid:19)(cid:18)(cid:18)(cid:2)(cid:1)(cid:2)(cid:3,,2342.0
,,8,,,Unknown,,cid:15)(cid:2)(cid:17)(cid:2)(cid:18)(cid:1)(cid:18)(cid:19)(cid:18)(cid:18)(cid:2)(cid:1)(cid:2)(cid:3,,2350.0
,,65,,,Unknown,,cid:15)(cid:2)(cid:17)(cid:2)(cid:18)(cid:1)(cid:18)(cid:19)(cid:18)(cid:18)(cid:2)(cid:1)(cid:2)(cid:3,,2415.0
,,46,,,Unknown,,cid:15)(cid:2)(cid:17)(cid:2)(cid:18)(cid:1)(cid:18)(cid:19)(cid:18)(cid:18)(cid:2)(cid:1)(cid:2)(cid:3,,2461.0
,,2,,,Unknown,,cid:15)(cid:2)(cid:17)(cid:2)(cid:18)(cid:1)(cid:18)(cid:19)(cid:18)(cid:18)(cid:2)(cid:1)(cid:2)(cid:3,,2463.0
,,3,,,Unknown,,cid:15)(cid:2)(cid:17)(cid:2)(cid:18)(cid:1)(cid:18)(cid:19)(cid:18)(cid:18)(cid:2)(cid:1)(cid:2)(cid:3,,2466.0
,,5,,,Unknown,,cid:15)(cid:2)(cid:17)(cid:2)(cid:18)(cid:1)(cid:18)(cid:19)(cid:18)(cid:18)(cid:2)(cid:1)(cid:2)(cid:3,,2471.0
,,67,,,Unknown,,cid:15)(cid:2)(cid:17)(cid:2)(cid:18)(cid:1)(cid:18)(cid:19)(cid:18)(cid:18)(cid:2)(cid:1)(cid:2)(cid:3,,2538.0
,,46,,,Unknown,,cid:15)(cid:2)(cid:17)(cid:2)(cid:18)(cid:1)(cid:18)(cid:19)(cid:18)(cid:18)(cid:2)(cid:1)(cid:2)(cid:3,,2584.0
,,2,,,Unknown,,cid:15)(cid:2)(cid:17)(cid:2)(cid:18)(cid:1)(cid:18)(cid:19)(cid:18)(cid:18)(cid:2)(cid:1)(cid:2)(cid:3,,2586.0
,,67,,,Unknown,,cid:15)(cid:2)(cid:17)(cid:2)(cid:18)(cid:1)(cid:18)(cid:19)(cid:18)(cid:18)(cid:2)(cid:1)(cid:2)(cid:3,,2653.0
,,4,,,Unknown,,cid:15)(cid:2)(cid:17)(cid:2)(cid:18)(cid:1)(cid:18)(cid:19)(cid:18)(cid:18)(cid:2)(cid:1)(cid:2)(cid:3,,2657.0
,,10,,,Unknown,,cid:15)(cid:2)(cid:17)(cid:2)(cid:18)(cid:1)(cid:18)(cid:19)(cid:18)(cid:18)(cid:2)(cid:1)(cid:2)(cid:3,,2667.0
,,7,,,Unknown,,cid:15)(cid:2)(cid:17)(cid:2)(cid:18)(cid:1)(cid:18)(cid:19)(cid:18)(cid:18)(cid:2)(cid:1)(cid:2)(cid:3,,2674.0
,,8,,,Unknown,,cid:15)(cid:2)(cid:17)(cid:2)(cid:18)(cid:1)(cid:18)(cid:19)(cid:18)(cid:18)(cid:2)(cid:1)(cid:2)(cid:3,,2682.0
,,46,,,Unknown,,cid:15)(cid:2)(cid:17)(cid:2)(cid:18)(cid:1)(cid:18)(cid:19)(cid:18)(cid:18)(cid:2)(cid:1)(cid:2)(cid:3,,2728.0
,,2,,,Unknown,,cid:15)(cid:2)(cid:17)(cid:2)(cid:18)(cid:1)(cid:18)(cid:19)(cid:18)(cid:18)(cid:2)(cid:1)(cid:2)(cid:3,,2730.0
,,49,,,Unknown,,cid:15)(cid:2)(cid:17)(cid:2)(cid:18)(cid:1)(cid:18)(cid:19)(cid:18)(cid:18)(cid:2)(cid:1)(cid:2)(cid:3,,2779.0
,,21,,,Unknown,,cid:15)(cid:2)(cid:17)(cid:2)(cid:18)(cid:1)(cid:18)(cid:19)(cid:18)(cid:18)(cid:2)(cid:1)(cid:2)(cid:3,,2800.0
,,71,,,Unknown,,cid:15)(cid:2)(cid:17)(cid:2)(cid:18)(cid:1)(cid:18)(cid:19)(cid:18)(cid:18)(cid:2)(cid:1)(cid:2)(cid:3,,2871.0
,,20,,,Unknown,,cid:15)(cid:2)(cid:17)(cid:2)(cid:18)(cid:1)(cid:18)(cid:19)(cid:18)(cid:18)(cid:2)(cid:1)(cid:2)(cid:3,,2891.0
,,2,,,Unknown,,cid:15)(cid:2)(cid:17)(cid:2)(cid:18)(cid:1)(cid:18)(cid:19)(cid:18)(cid:18)(cid:2)(cid:1)(cid:2)(cid:3,,2893.0
,,9,,,Unknown,,cid:15)(cid:2)(cid:17)(cid:2)(cid:18)(cid:1)(cid:18)(cid:19)(cid:18)(cid:18)(cid:2)(cid:1)(cid:2)(cid:3,,2902.0
,,25,,,Unknown,,cid:15)(cid:2)(cid:17)(cid:2)(cid:18)(cid:1)(cid:18)(cid:19)(cid:18)(cid:18)(cid:2)(cid:1)(cid:2)(cid:3,,2927.0
,,22,,,Unknown,,cid:15)(cid:2)(cid:17)(cid:2)(cid:18)(cid:1)(cid:18)(cid:19)(cid:18)(cid:18)(cid:2)(cid:1)(cid:2)(cid:3,,2949.0
,,20,,,Unknown,,cid:15)(cid:2)(cid:17)(cid:2)(cid:18)(cid:1)(cid:18)(cid:19)(cid:18)(cid:18)(cid:2)(cid:1)(cid:2)(cid:3,,2969.0
,,2,,,Unknown,,cid:15)(cid:2)(cid:17)(cid:2)(cid:18)(cid:1)(cid:18)(cid:19)(cid:18)(cid:18)(cid:2)(cid:1)(cid:2)(cid:3,,2971.0
,,13,,,Unknown,,cid:15)(cid:2)(cid:17)(cid:2)(cid:18)(cid:1)(cid:18)(cid:19)(cid:18)(cid:18)(cid:2)(cid:1)(cid:2)(cid:3,,2984.0
,,3,,,Unknown,,cid:15)(cid:2)(cid:17)(cid:2)(cid:18)(cid:1)(cid:18)(cid:19)(cid:18)(cid:18)(cid:2)(cid:1)(cid:2)(cid:3,,2987.0
,,15,,,Unknown,,cid:15)(cid:2)(cid:17)(cid:2)(cid:18)(cid:1)(cid:18)(cid:19)(cid:18)(cid:18)(cid:2)(cid:1)(cid:2)(cid:3,,3002.0
,,2,,,Unknown,,cid:15)(cid:2)(cid:17)(cid:2)(cid:18)(cid:1)(cid:18)(cid:19)(cid:18)(cid:18)(cid:2)(cid:1)(cid:2)(cid:3,,3004.0
,,17,,,Unknown,,cid:15)(cid:2)(cid:17)(cid:2)(cid:18)(cid:1)(cid:18)(cid:19)(cid:18)(cid:18)(cid:2)(cid:1)(cid:2)(cid:3,,3021.0
,,16,,,Unknown,,cid:15)(cid:2)(cid:17)(cid:2)(cid:18)(cid:1)(cid:18)(cid:19)(cid:18)(cid:18)(cid:2)(cid:1)(cid:2)(cid:3,,3037.0
,,19,,,Unknown,,cid:15)(cid:2)(cid:17)(cid:2)(cid:18)(cid:1)(cid:18)(cid:19)(cid:18)(cid:18)(cid:2)(cid:1)(cid:2)(cid:3,,3056.0
,,17,,,Unknown,,cid:15)(cid:2)(cid:17)(cid:2)(cid:18)(cid:1)(cid:18)(cid:19)(cid:18)(cid:18)(cid:2)(cid:1)(cid:2)(cid:3,,3073.0
,,34,,,Unknown,,cid:15)(cid:2)(cid:17)(cid:2)(cid:18)(cid:1)(cid:18)(cid:19)(cid:18)(cid:18)(cid:2)(cid:1)(cid:2)(cid:3,,3107.0
,,2,,,Unknown,,cid:15)(cid:2)(cid:17)(cid:2)(cid:18)(cid:1)(cid:18)(cid:19)(cid:18)(cid:18)(cid:2)(cid:1)(cid:2)(cid:3,,3109.0
,,44,,,Unknown,,cid:15)(cid:2)(cid:17)(cid:2)(cid:18)(cid:1)(cid:18)(cid:19)(cid:18)(cid:18)(cid:2)(cid:1)(cid:2)(cid:3,,3153.0
,,16,,,Unknown,,cid:15)(cid:2)(cid:17)(cid:2)(cid:18)(cid:1)(cid:18)(cid:19)(cid:18)(cid:18)(cid:2)(cid:1)(cid:2)(cid:3,,3169.0
,,19,,,Unknown,,cid:15)(cid:2)(cid:17)(cid:2)(cid:18)(cid:1)(cid:18)(cid:19)(cid:18)(cid:18)(cid:2)(cid:1)(cid:2)(cid:3,,3188.0
,,36,,,Unknown,,cid:15)(cid:2)(cid:17)(cid:2)(cid:18)(cid:1)(cid:18)(cid:19)(cid:18)(cid:18)(cid:2)(cid:1)(cid:2)(cid:3,,3224.0
,,32,,,Unknown,,cid:15)(cid:2)(cid:17)(cid:2)(cid:18)(cid:1)(cid:18)(cid:19)(cid:18)(cid:18)(cid:2)(cid:1)(cid:2)(cid:3,,3256.0
,,37,,,Unknown,,cid:15)(cid:2)(cid:17)(cid:2)(cid:18)(cid:1)(cid:18)(cid:19)(cid:18)(cid:18)(cid:2)(cid:1)(cid:2)(cid:3,,3293.0
,,34,,,Unknown,,cid:15)(cid:2)(cid:17)(cid:2)(cid:18)(cid:1)(cid:18)(cid:19)(cid:18)(cid:18)(cid:2)(cid:1)(cid:2)(cid:3,,3327.0
,,34,,,Unknown,,cid:15)(cid:2)(cid:17)(cid:2)(cid:18)(cid:1)(cid:18)(cid:19)(cid:18)(cid:18)(cid:2)(cid:1)(cid:2)(cid:3,,3361.0
,,32,,,Unknown,,cid:15)(cid:2)(cid:17)(cid:2)(cid:18)(cid:1)(cid:18)(cid:19)(cid:18)(cid:18)(cid:2)(cid:1)(cid:2)(cid:3,,3393.0
,,35,,,Unknown,,cid:15)(cid:2)(cid:17)(cid:2)(cid:18)(cid:1)(cid:18)(cid:19)(cid:18)(cid:18)(cid:2)(cid:1)(cid:2)(cid:3,,3428.0
,,34,,,Unknown,,cid:15)(cid:2)(cid:17)(cid:2)(cid:18)(cid:1)(cid:18)(cid:19)(cid:18)(cid:18)(cid:2)(cid:1)(cid:2)(cid:3,,3462.0
,,17,,,Unknown,,cid:15)(cid:2)(cid:17)(cid:2)(cid:18)(cid:1)(cid:18)(cid:19)(cid:18)(cid:18)(cid:2)(cid:1)(cid:2)(cid:3,,3479.0
,,37,,,Unknown,,cid:15)(cid:2)(cid:17)(cid:2)(cid:18)(cid:1)(cid:18)(cid:19)(cid:18)(cid:18)(cid:2)(cid:1)(cid:2)(cid:3,,3516.0
,,17,,,Unknown,,cid:15)(cid:2)(cid:17)(cid:2)(cid:18)(cid:1)(cid:18)(cid:19)(cid:18)(cid:18)(cid:2)(cid:1)(cid:2)(cid:3,,3533.0
,,17,,,Unknown,,cid:15)(cid:2)(cid:17)(cid:2)(cid:18)(cid:1)(cid:18)(cid:19)(cid:18)(cid:18)(cid:2)(cid:1)(cid:2)(cid:3,,3550.0
,,33,,,Unknown,,cid:15)(cid:2)(cid:17)(cid:2)(cid:18)(cid:1)(cid:18)(cid:19)(cid:18)(cid:18)(cid:2)(cid:1)(cid:2)(cid:3,,3583.0
,,34,,,Unknown,,cid:15)(cid:2)(cid:17)(cid:2)(cid:18)(cid:1)(cid:18)(cid:19)(cid:18)(cid:18)(cid:2)(cid:1)(cid:2)(cid:3,,3617.0
,,2,,,Unknown,,cid:15)(cid:2)(cid:17)(cid:2)(cid:18)(cid:1)(cid:18)(cid:19)(cid:18)(cid:18)(cid:2)(cid:1)(cid:2)(cid:3,,3619.0
,,74,,,Unknown,,cid:15)(cid:2)(cid:17)(cid:2)(cid:18)(cid:1)(cid:18)(cid:19)(cid:18)(cid:18)(cid:2)(cid:1)(cid:2)(cid:3,,3693.0
,,30,,,Unknown,,cid:15)(cid:2)(cid:17)(cid:2)(cid:18)(cid:1)(cid:18)(cid:19)(cid:18)(cid:18)(cid:2)(cid:1)(cid:2)(cid:3,,3723.0
,,2,,,Unknown,,cid:15)(cid:2)(cid:17)(cid:2)(cid:18)(cid:1)(cid:18)(cid:19)(cid:18)(cid:18)(cid:2)(cid:1)(cid:2)(cid:3,,3725.0
,,73,,,Unknown,,cid:15)(cid:2)(cid:17)(cid:2)(cid:18)(cid:1)(cid:18)(cid:19)(cid:18)(cid:18)(cid:2)(cid:1)(cid:2)(cid:3,,3798.0
,,2,,,Unknown,,cid:15)(cid:2)(cid:17)(cid:2)(cid:18)(cid:1)(cid:18)(cid:19)(cid:18)(cid:18)(cid:2)(cid:1)(cid:2)(cid:3,,3800.0
,,17,,,Unknown,,cid:15)(cid:2)(cid:17)(cid:2)(cid:18)(cid:1)(cid:18)(cid:19)(cid:18)(cid:18)(cid:2)(cid:1)(cid:2)(cid:3,,3817.0
,,19,,,Unknown,,cid:15)(cid:2)(cid:17)(cid:2)(cid:18)(cid:1)(cid:18)(cid:19)(cid:18)(cid:18)(cid:2)(cid:1)(cid:2)(cid:3,,3836.0
,,18,,,Unknown,,cid:15)(cid:2)(cid:17)(cid:2)(cid:18)(cid:1)(cid:18)(cid:19)(cid:18)(cid:18)(cid:2)(cid:1)(cid:2)(cid:3,,3854.0
,,18,,,Unknown,,cid:15)(cid:2)(cid:17)(cid:2)(cid:18)(cid:1)(cid:18)(cid:19)(cid:18)(cid:18)(cid:2)(cid:1)(cid:2)(cid:3,,3872.0
,,2,,,Unknown,,cid:15)(cid:2)(cid:17)(cid:2)(cid:18)(cid:1)(cid:18)(cid:19)(cid:18)(cid:18)(cid:2)(cid:1)(cid:2)(cid:3,,3874.0
,,44,,,Unknown,,cid:15)(cid:2)(cid:17)(cid:2)(cid:18)(cid:1)(cid:18)(cid:19)(cid:18)(cid:18)(cid:2)(cid:1)(cid:2)(cid:3,,3918.0
,,15,,,Unknown,,cid:15)(cid:2)(cid:17)(cid:2)(cid:18)(cid:1)(cid:18)(cid:19)(cid:18)(cid:18)(cid:2)(cid:1)(cid:2)(cid:3,,3933.0
,,2,,,Unknown,,cid:15)(cid:2)(cid:17)(cid:2)(cid:18)(cid:1)(cid:18)(cid:19)(cid:18)(cid:18)(cid:2)(cid:1)(cid:2)(cid:3,,3935.0
,,17,,,Unknown,,cid:15)(cid:2)(cid:17)(cid:2)(cid:18)(cid:1)(cid:18)(cid:19)(cid:18)(cid:18)(cid:2)(cid:1)(cid:2)(cid:3,,3952.0
,,1,,,Unknown,,cid:15)(cid:2)(cid:17)(cid:2)(cid:18)(cid:1)(cid:18)(cid:19)(cid:18)(cid:18)(cid:2)(cid:1)(cid:2)(cid:3,,3953.0
,,35,,,Unknown,,cid:15)(cid:2)(cid:17)(cid:2)(cid:18)(cid:1)(cid:18)(cid:19)(cid:18)(cid:18)(cid:2)(cid:1)(cid:2)(cid:3,,3988.0
,,19,,,Unknown,,cid:15)(cid:2)(cid:17)(cid:2)(cid:18)(cid:1)(cid:18)(cid:19)(cid:18)(cid:18)(cid:2)(cid:1)(cid:2)(cid:3,,4007.0
,,18,,,Unknown,,cid:15)(cid:2)(cid:17)(cid:2)(cid:18)(cid:1)(cid:18)(cid:19)(cid:18)(cid:18)(cid:2)(cid:1)(cid:2)(cid:3,,4025.0
,,18,,,Unknown,,cid:15)(cid:2)(cid:17)(cid:2)(cid:18)(cid:1)(cid:18)(cid:19)(cid:18)(cid:18)(cid:2)(cid:1)(cid:2)(cid:3,,4043.0
,,2,,,Unknown,,cid:15)(cid:2)(cid:17)(cid:2)(cid:18)(cid:1)(cid:18)(cid:19)(cid:18)(cid:18)(cid:2)(cid:1)(cid:2)(cid:3,,4045.0
,,74,,,Unknown,,cid:15)(cid:2)(cid:17)(cid:2)(cid:18)(cid:1)(cid:18)(cid:19)(cid:18)(cid:18)(cid:2)(cid:1)(cid:2)(cid:3,,4119.0
,,30,,,Unknown,,cid:15)(cid:2)(cid:17)(cid:2)(cid:18)(cid:1)(cid:18)(cid:19)(cid:18)(cid:18)(cid:2)(cid:1)(cid:2)(cid:3,,4149.0
,,12,,,Unknown,,cid:15)(cid:2)(cid:17)(cid:2)(cid:18)(cid:1)(cid:18)(cid:19)(cid:18)(cid:18)(cid:2)(cid:1)(cid:2)(cid:3,,4161.0
,,29,,,Unknown,,cid:15)(cid:2)(cid:17)(cid:2)(cid:18)(cid:1)(cid:18)(cid:19)(cid:18)(cid:18)(cid:2)(cid:1)(cid:2)(cid:3,,4190.0
,,26,,,Unknown,,cid:15)(cid:2)(cid:17)(cid:2)(cid:18)(cid:1)(cid:18)(cid:19)(cid:18)(cid:18)(cid:2)(cid:1)(cid:2)(cid:3,,4216.0
,,41,,,Unknown,,cid:15)(cid:2)(cid:17)(cid:2)(cid:18)(cid:1)(cid:18)(cid:19)(cid:18)(cid:18)(cid:2)(cid:1)(cid:2)(cid:3,,4257.0
,,25,,,Unknown,,cid:15)(cid:2)(cid:17)(cid:2)(cid:18)(cid:1)(cid:18)(cid:19)(cid:18)(cid:18)(cid:2)(cid:1)(cid:2)(cid:3,,4282.0
,,2,,,Unknown,,cid:15)(cid:2)(cid:17)(cid:2)(cid:18)(cid:1)(cid:18)(cid:19)(cid:18)(cid:18)(cid:2)(cid:1)(cid:2)(cid:3,,4284.0
,,50,,,Unknown,,cid:15)(cid:2)(cid:17)(cid:2)(cid:18)(cid:1)(cid:18)(cid:19)(cid:18)(cid:18)(cid:2)(cid:1)(cid:2)(cid:3,,4334.0
,,50,,,Unknown,,cid:15)(cid:2)(cid:17)(cid:2)(cid:18)(cid:1)(cid:18)(cid:19)(cid:18)(cid:18)(cid:2)(cid:1)(cid:2)(cid:3,,4384.0
,,18,,,Unknown,,cid:15)(cid:2)(cid:17)(cid:2)(cid:18)(cid:1)(cid:18)(cid:19)(cid:18)(cid:18)(cid:2)(cid:1)(cid:2)(cid:3,,4402.0
,,1,,,Unknown,,cid:15)(cid:2)(cid:17)(cid:2)(cid:18)(cid:1)(cid:18)(cid:19)(cid:18)(cid:18)(cid:2)(cid:1)(cid:2)(cid:3,,4403.0
,,1,,,Unknown,,cid:15)(cid:2)(cid:17)(cid:2)(cid:18)(cid:1)(cid:18)(cid:19)(cid:18)(cid:18)(cid:2)(cid:1)(cid:2)(cid:3,,4404.0
,,37,,,Unknown,,cid:15)(cid:2)(cid:17)(cid:2)(cid:18)(cid:1)(cid:18)(cid:19)(cid:18)(cid:18)(cid:2)(cid:1)(cid:2)(cid:3,,4441.0
,,1,,,Unknown,,cid:15)(cid:2)(cid:17)(cid:2)(cid:18)(cid:1)(cid:18)(cid:19)(cid:18)(cid:18)(cid:2)(cid:1)(cid:2)(cid:3,,4442.0
,,35,,,Unknown,,cid:15)(cid:2)(cid:17)(cid:2)(cid:18)(cid:1)(cid:18)(cid:19)(cid:18)(cid:18)(cid:2)(cid:1)(cid:2)(cid:3,,4477.0
,,45,,,Unknown,,cid:15)(cid:2)(cid:17)(cid:2)(cid:18)(cid:1)(cid:18)(cid:19)(cid:18)(cid:18)(cid:2)(cid:1)(cid:2)(cid:3,,4522.0
,,18,,,Unknown,,cid:15)(cid:2)(cid:17)(cid:2)(cid:18)(cid:1)(cid:18)(cid:19)(cid:18)(cid:18)(cid:2)(cid:1)(cid:2)(cid:3,,4540.0
,,35,,,Unknown,,cid:15)(cid:2)(cid:17)(cid:2)(cid:18)(cid:1)(cid:18)(cid:19)(cid:18)(cid:18)(cid:2)(cid:1)(cid:2)(cid:3,,4575.0
,,46,,,Unknown,,cid:15)(cid:2)(cid:17)(cid:2)(cid:18)(cid:1)(cid:18)(cid:19)(cid:18)(cid:18)(cid:2)(cid:1)(cid:2)(cid:3,,4621.0
,,4,,,Unknown,,cid:15)(cid:2)(cid:17)(cid:2)(cid:18)(cid:1)(cid:18)(cid:19)(cid:18)(cid:18)(cid:2)(cid:1)(cid:2)(cid:3,,4625.0
,,10,,,Unknown,,cid:15)(cid:2)(cid:17)(cid:2)(cid:18)(cid:1)(cid:18)(cid:19)(cid:18)(cid:18)(cid:2)(cid:1)(cid:2)(cid:3,,4635.0
,,11,,,Unknown,,cid:15)(cid:2)(cid:17)(cid:2)(cid:18)(cid:1)(cid:18)(cid:19)(cid:18)(cid:18)(cid:2)(cid:1)(cid:2)(cid:3,,4646.0
,,12,,,Unknown,,cid:15)(cid:2)(cid:17)(cid:2)(cid:18)(cid:1)(cid:18)(cid:19)(cid:18)(cid:18)(cid:2)(cid:1)(cid:2)(cid:3,,4658.0
,,5,,,Unknown,,cid:15)(cid:2)(cid:17)(cid:2)(cid:18)(cid:1)(cid:18)(cid:19)(cid:18)(cid:18)(cid:2)(cid:1)(cid:2)(cid:3,,4663.0
,,9,,,Unknown,,cid:15)(cid:2)(cid:17)(cid:2)(cid:18)(cid:1)(cid:18)(cid:19)(cid:18)(cid:18)(cid:2)(cid:1)(cid:2)(cid:3,,4672.0
,,10,,,Unknown,,cid:15)(cid:2)(cid:17)(cid:2)(cid:18)(cid:1)(cid:18)(cid:19)(cid:18)(cid:18)(cid:2)(cid:1)(cid:2)(cid:3,,4682.0
,,46,,,Unknown,,cid:15)(cid:2)(cid:17)(cid:2)(cid:18)(cid:1)(cid:18)(cid:19)(cid:18)(cid:18)(cid:2)(cid:1)(cid:2)(cid:3,,4728.0
,,2,,,Unknown,,cid:15)(cid:2)(cid:17)(cid:2)(cid:18)(cid:1)(cid:18)(cid:19)(cid:18)(cid:18)(cid:2)(cid:1)(cid:2)(cid:3,,4730.0
,,46,,,Unknown,,cid:15)(cid:2)(cid:17)(cid:2)(cid:18)(cid:1)(cid:18)(cid:19)(cid:18)(cid:18)(cid:2)(cid:1)(cid:2)(cid:3,,4776.0
,,37,,,Unknown,,cid:15)(cid:2)(cid:17)(cid:2)(cid:18)(cid:1)(cid:18)(cid:19)(cid:18)(cid:18)(cid:2)(cid:1)(cid:2)(cid:3,,4813.0
,,2,,,Unknown,,cid:15)(cid:2)(cid:17)(cid:2)(cid:18)(cid:1)(cid:18)(cid:19)(cid:18)(cid:18)(cid:2)(cid:1)(cid:2)(cid:3,,4815.0
,,51,,,Unknown,,cid:15)(cid:2)(cid:17)(cid:2)(cid:18)(cid:1)(cid:18)(cid:19)(cid:18)(cid:18)(cid:2)(cid:1)(cid:2)(cid:3,,4866.0
,,3,,,Unknown,,cid:15)(cid:2)(cid:17)(cid:2)(cid:18)(cid:1)(cid:18)(cid:19)(cid:18)(cid:18)(cid:2)(cid:1)(cid:2)(cid:3,,4869.0
,,5,,,Unknown,,cid:15)(cid:2)(cid:17)(cid:2)(cid:18)(cid:1)(cid:18)(cid:19)(cid:18)(cid:18)(cid:2)(cid:1)(cid:2)(cid:3,,4874.0
,,53,,,Unknown,,cid:15)(cid:2)(cid:17)(cid:2)(cid:18)(cid:1)(cid:18)(cid:19)(cid:18)(cid:18)(cid:2)(cid:1)(cid:2)(cid:3,,4927.0
,,46,,,Unknown,,cid:15)(cid:2)(cid:17)(cid:2)(cid:18)(cid:1)(cid:18)(cid:19)(cid:18)(cid:18)(cid:2)(cid:1)(cid:2)(cid:3,,4973.0
,,8,,,Unknown,,cid:15)(cid:2)(cid:17)(cid:2)(cid:18)(cid:1)(cid:18)(cid:19)(cid:18)(cid:18)(cid:2)(cid:1)(cid:2)(cid:3,,4981.0
,,46,,,Unknown,,cid:15)(cid:2)(cid:17)(cid:2)(cid:18)(cid:1)(cid:18)(cid:19)(cid:18)(cid:18)(cid:2)(cid:1)(cid:2)(cid:3,,5027.0
,,2,,,Unknown,,cid:15)(cid:2)(cid:17)(cid:2)(cid:18)(cid:1)(cid:18)(cid:19)(cid:18)(cid:18)(cid:2)(cid:1)(cid:2)(cid:3,,5029.0
,,9,,,Unknown,,cid:15)(cid:2)(cid:17)(cid:2)(cid:18)(cid:1)(cid:18)(cid:19)(cid:18)(cid:18)(cid:2)(cid:1)(cid:2)(cid:3,,5038.0
,,29,,,Unknown,,cid:15)(cid:2)(cid:17)(cid:2)(cid:18)(cid:1)(cid:18)(cid:19)(cid:18)(cid:18)(cid:2)(cid:1)(cid:2)(cid:3,,5067.0
,,23,,,Unknown,,cid:15)(cid:2)(cid:17)(cid:2)(cid:18)(cid:1)(cid:18)(cid:19)(cid:18)(cid:18)(cid:2)(cid:1)(cid:2)(cid:3,,5090.0
,,20,,,Unknown,,cid:15)(cid:2)(cid:17)(cid:2)(cid:18)(cid:1)(cid:18)(cid:19)(cid:18)(cid:18)(cid:2)(cid:1)(cid:2)(cid:3,,5110.0
,,47,,,Unknown,,cid:15)(cid:2)(cid:17)(cid:2)(cid:18)(cid:1)(cid:18)(cid:19)(cid:18)(cid:18)(cid:2)(cid:1)(cid:2)(cid:3,,5157.0
,,20,,,Unknown,,cid:15)(cid:2)(cid:17)(cid:2)(cid:18)(cid:1)(cid:18)(cid:19)(cid:18)(cid:18)(cid:2)(cid:1)(cid:2)(cid:3,,5177.0
,,26,,,Unknown,,cid:15)(cid:2)(cid:17)(cid:2)(cid:18)(cid:1)(cid:18)(cid:19)(cid:18)(cid:18)(cid:2)(cid:1)(cid:2)(cid:3,,5203.0
,,2,,,Unknown,,cid:15)(cid:2)(cid:17)(cid:2)(cid:18)(cid:1)(cid:18)(cid:19)(cid:18)(cid:18)(cid:2)(cid:1)(cid:2)(cid:3,,5205.0
,,13,,,Unknown,,cid:15)(cid:2)(cid:17)(cid:2)(cid:18)(cid:1)(cid:18)(cid:19)(cid:18)(cid:18)(cid:2)(cid:1)(cid:2)(cid:3,,5218.0
,,3,,,Unknown,,cid:15)(cid:2)(cid:17)(cid:2)(cid:18)(cid:1)(cid:18)(cid:19)(cid:18)(cid:18)(cid:2)(cid:1)(cid:2)(cid:3,,5221.0
,,15,,,Unknown,,cid:15)(cid:2)(cid:17)(cid:2)(cid:18)(cid:1)(cid:18)(cid:19)(cid:18)(cid:18)(cid:2)(cid:1)(cid:2)(cid:3,,5236.0
,,2,,,Unknown,,cid:15)(cid:2)(cid:17)(cid:2)(cid:18)(cid:1)(cid:18)(cid:19)(cid:18)(cid:18)(cid:2)(cid:1)(cid:2)(cid:3,,5238.0
,,18,,,Unknown,,cid:15)(cid:2)(cid:17)(cid:2)(cid:18)(cid:1)(cid:18)(cid:19)(cid:18)(cid:18)(cid:2)(cid:1)(cid:2)(cid:3,,5256.0
,,19,,,Unknown,,cid:15)(cid:2)(cid:17)(cid:2)(cid:18)(cid:1)(cid:18)(cid:19)(cid:18)(cid:18)(cid:2)(cid:1)(cid:2)(cid:3,,5275.0
,,33,,,Unknown,,cid:15)(cid:2)(cid:17)(cid:2)(cid:18)(cid:1)(cid:18)(cid:19)(cid:18)(cid:18)(cid:2)(cid:1)(cid:2)(cid:3,,5308.0
,,36,,,Unknown,,cid:15)(cid:2)(cid:17)(cid:2)(cid:18)(cid:1)(cid:18)(cid:19)(cid:18)(cid:18)(cid:2)(cid:1)(cid:2)(cid:3,,5344.0
,,2,,,Unknown,,cid:15)(cid:2)(cid:17)(cid:2)(cid:18)(cid:1)(cid:18)(cid:19)(cid:18)(cid:18)(cid:2)(cid:1)(cid:2)(cid:3,,5346.0
,,44,,,Unknown,,cid:15)(cid:2)(cid:17)(cid:2)(cid:18)(cid:1)(cid:18)(cid:19)(cid:18)(cid:18)(cid:2)(cid:1)(cid:2)(cid:3,,5390.0
,,16,,,Unknown,,cid:15)(cid:2)(cid:17)(cid:2)(cid:18)(cid:1)(cid:18)(cid:19)(cid:18)(cid:18)(cid:2)(cid:1)(cid:2)(cid:3,,5406.0
,,19,,,Unknown,,cid:15)(cid:2)(cid:17)(cid:2)(cid:18)(cid:1)(cid:18)(cid:19)(cid:18)(cid:18)(cid:2)(cid:1)(cid:2)(cid:3,,5425.0
,,36,,,Unknown,,cid:15)(cid:2)(cid:17)(cid:2)(cid:18)(cid:1)(cid:18)(cid:19)(cid:18)(cid:18)(cid:2)(cid:1)(cid:2)(cid:3,,5461.0
,,36,,,Unknown,,cid:15)(cid:2)(cid:17)(cid:2)(cid:18)(cid:1)(cid:18)(cid:19)(cid:18)(cid:18)(cid:2)(cid:1)(cid:2)(cid:3,,5497.0
,,32,,,Unknown,,cid:15)(cid:2)(cid:17)(cid:2)(cid:18)(cid:1)(cid:18)(cid:19)(cid:18)(cid:18)(cid:2)(cid:1)(cid:2)(cid:3,,5529.0
,,35,,,Unknown,,cid:15)(cid:2)(cid:17)(cid:2)(cid:18)(cid:1)(cid:18)(cid:19)(cid:18)(cid:18)(cid:2)(cid:1)(cid:2)(cid:3,,5564.0
,,18,,,Unknown,,cid:15)(cid:2)(cid:17)(cid:2)(cid:18)(cid:1)(cid:18)(cid:19)(cid:18)(cid:18)(cid:2)(cid:1)(cid:2)(cid:3,,5582.0
,,35,,,Unknown,,cid:15)(cid:2)(cid:17)(cid:2)(cid:18)(cid:1)(cid:18)(cid:19)(cid:18)(cid:18)(cid:2)(cid:1)(cid:2)(cid:3,,5617.0
,,34,,,Unknown,,cid:15)(cid:2)(cid:17)(cid:2)(cid:18)(cid:1)(cid:18)(cid:19)(cid:18)(cid:18)(cid:2)(cid:1)(cid:2)(cid:3,,5651.0
,,17,,,Unknown,,cid:15)(cid:2)(cid:17)(cid:2)(cid:18)(cid:1)(cid:18)(cid:19)(cid:18)(cid:18)(cid:2)(cid:1)(cid:2)(cid:3,,5668.0
,,18,,,Unknown,,cid:15)(cid:2)(cid:17)(cid:2)(cid:18)(cid:1)(cid:18)(cid:19)(cid:18)(cid:18)(cid:2)(cid:1)(cid:2)(cid:3,,5686.0
,,32,,,Unknown,,cid:15)(cid:2)(cid:17)(cid:2)(cid:18)(cid:1)(cid:18)(cid:19)(cid:18)(cid:18)(cid:2)(cid:1)(cid:2)(cid:3,,5718.0
,,37,,,Unknown,,cid:15)(cid:2)(cid:17)(cid:2)(cid:18)(cid:1)(cid:18)(cid:19)(cid:18)(cid:18)(cid:2)(cid:1)(cid:2)(cid:3,,5755.0
,,35,,,Unknown,,cid:15)(cid:2)(cid:17)(cid:2)(cid:18)(cid:1)(cid:18)(cid:19)(cid:18)(cid:18)(cid:2)(cid:1)(cid:2)(cid:3,,5790.0
,,37,,,Unknown,,cid:15)(cid:2)(cid:17)(cid:2)(cid:18)(cid:1)(cid:18)(cid:19)(cid:18)(cid:18)(cid:2)(cid:1)(cid:2)(cid:3,,5827.0
,,2,,,Unknown,,cid:15)(cid:2)(cid:17)(cid:2)(cid:18)(cid:1)(cid:18)(cid:19)(cid:18)(cid:18)(cid:2)(cid:1)(cid:2)(cid:3,,5829.0
,,74,,,Unknown,,cid:15)(cid:2)(cid:17)(cid:2)(cid:18)(cid:1)(cid:18)(cid:19)(cid:18)(cid:18)(cid:2)(cid:1)(cid:2)(cid:3,,5903.0
,,30,,,Unknown,,cid:15)(cid:2)(cid:17)(cid:2)(cid:18)(cid:1)(cid:18)(cid:19)(cid:18)(cid:18)(cid:2)(cid:1)(cid:2)(cid:3,,5933.0
,,2,,,Unknown,,cid:15)(cid:2)(cid:17)(cid:2)(cid:18)(cid:1)(cid:18)(cid:19)(cid:18)(cid:18)(cid:2)(cid:1)(cid:2)(cid:3,,5935.0
,,73,,,Unknown,,cid:15)(cid:2)(cid:17)(cid:2)(cid:18)(cid:1)(cid:18)(cid:19)(cid:18)(cid:18)(cid:2)(cid:1)(cid:2)(cid:3,,6008.0
,,2,,,Unknown,,cid:15)(cid:2)(cid:17)(cid:2)(cid:18)(cid:1)(cid:18)(cid:19)(cid:18)(cid:18)(cid:2)(cid:1)(cid:2)(cid:3,,6010.0
,,17,,,Unknown,,cid:15)(cid:2)(cid:17)(cid:2)(cid:18)(cid:1)(cid:18)(cid:19)(cid:18)(cid:18)(cid:2)(cid:1)(cid:2)(cid:3,,6027.0
,,19,,,Unknown,,cid:15)(cid:2)(cid:17)(cid:2)(cid:18)(cid:1)(cid:18)(cid:19)(cid:18)(cid:18)(cid:2)(cid:1)(cid:2)(cid:3,,6046.0
,,18,,,Unknown,,cid:15)(cid:2)(cid:17)(cid:2)(cid:18)(cid:1)(cid:18)(cid:19)(cid:18)(cid:18)(cid:2)(cid:1)(cid:2)(cid:3,,6064.0
,,18,,,Unknown,,cid:15)(cid:2)(cid:17)(cid:2)(cid:18)(cid:1)(cid:18)(cid:19)(cid:18)(cid:18)(cid:2)(cid:1)(cid:2)(cid:3,,6082.0
,,2,,,Unknown,,cid:15)(cid:2)(cid:17)(cid:2)(cid:18)(cid:1)(cid:18)(cid:19)(cid:18)(cid:18)(cid:2)(cid:1)(cid:2)(cid:3,,6084.0
,,44,,,Unknown,,cid:15)(cid:2)(cid:17)(cid:2)(cid:18)(cid:1)(cid:18)(cid:19)(cid:18)(cid:18)(cid:2)(cid:1)(cid:2)(cid:3,,6128.0
,,15,,,Unknown,,cid:15)(cid:2)(cid:17)(cid:2)(cid:18)(cid:1)(cid:18)(cid:19)(cid:18)(cid:18)(cid:2)(cid:1)(cid:2)(cid:3,,6143.0
,,2,,,Unknown,,cid:15)(cid:2)(cid:17)(cid:2)(cid:18)(cid:1)(cid:18)(cid:19)(cid:18)(cid:18)(cid:2)(cid:1)(cid:2)(cid:3,,6145.0
,,16,,,Unknown,,cid:15)(cid:2)(cid:17)(cid:2)(cid:18)(cid:1)(cid:18)(cid:19)(cid:18)(cid:18)(cid:2)(cid:1)(cid:2)(cid:3,,6161.0
,,19,,,Unknown,,cid:15)(cid:2)(cid:17)(cid:2)(cid:18)(cid:1)(cid:18)(cid:19)(cid:18)(cid:18)(cid:2)(cid:1)(cid:2)(cid:3,,6180.0
,,18,,,Unknown,,cid:15)(cid:2)(cid:17)(cid:2)(cid:18)(cid:1)(cid:18)(cid:19)(cid:18)(cid:18)(cid:2)(cid:1)(cid:2)(cid:3,,6198.0
,,18,,,Unknown,,cid:15)(cid:2)(cid:17)(cid:2)(cid:18)(cid:1)(cid:18)(cid:19)(cid:18)(cid:18)(cid:2)(cid:1)(cid:2)(cid:3,,6216.0
,,2,,,Unknown,,cid:15)(cid:2)(cid:17)(cid:2)(cid:18)(cid:1)(cid:18)(cid:19)(cid:18)(cid:18)(cid:2)(cid:1)(cid:2)(cid:3,,6218.0
,,74,,,Unknown,,cid:15)(cid:2)(cid:17)(cid:2)(cid:18)(cid:1)(cid:18)(cid:19)(cid:18)(cid:18)(cid:2)(cid:1)(cid:2)(cid:3,,6292.0
,,30,,,Unknown,,cid:15)(cid:2)(cid:17)(cid:2)(cid:18)(cid:1)(cid:18)(cid:19)(cid:18)(cid:18)(cid:2)(cid:1)(cid:2)(cid:3,,6322.0
,,12,,,Unknown,,cid:15)(cid:2)(cid:17)(cid:2)(cid:18)(cid:1)(cid:18)(cid:19)(cid:18)(cid:18)(cid:2)(cid:1)(cid:2)(cid:3,,6334.0
,,29,,,Unknown,,cid:15)(cid:2)(cid:17)(cid:2)(cid:18)(cid:1)(cid:18)(cid:19)(cid:18)(cid:18)(cid:2)(cid:1)(cid:2)(cid:3,,6363.0
,,26,,,Unknown,,cid:15)(cid:2)(cid:17)(cid:2)(cid:18)(cid:1)(cid:18)(cid:19)(cid:18)(cid:18)(cid:2)(cid:1)(cid:2)(cid:3,,6389.0
,,41,,,Unknown,,cid:15)(cid:2)(cid:17)(cid:2)(cid:18)(cid:1)(cid:18)(cid:19)(cid:18)(cid:18)(cid:2)(cid:1)(cid:2)(cid:3,,6430.0
,,25,,,Unknown,,cid:15)(cid:2)(cid:17)(cid:2)(cid:18)(cid:1)(cid:18)(cid:19)(cid:18)(cid:18)(cid:2)(cid:1)(cid:2)(cid:3,,6455.0
,,2,,,Unknown,,cid:15)(cid:2)(cid:17)(cid:2)(cid:18)(cid:1)(cid:18)(cid:19)(cid:18)(cid:18)(cid:2)(cid:1)(cid:2)(cid:3,,6457.0
,,50,,,Unknown,,cid:15)(cid:2)(cid:17)(cid:2)(cid:18)(cid:1)(cid:18)(cid:19)(cid:18)(cid:18)(cid:2)(cid:1)(cid:2)(cid:3,,6507.0
,,50,,,Unknown,,cid:15)(cid:2)(cid:17)(cid:2)(cid:18)(cid:1)(cid:18)(cid:19)(cid:18)(cid:18)(cid:2)(cid:1)(cid:2)(cid:3,,6557.0
,,18,,,Unknown,,cid:15)(cid:2)(cid:17)(cid:2)(cid:18)(cid:1)(cid:18)(cid:19)(cid:18)(cid:18)(cid:2)(cid:1)(cid:2)(cid:3,,6575.0
,,1,,,Unknown,,cid:15)(cid:2)(cid:17)(cid:2)(cid:18)(cid:1)(cid:18)(cid:19)(cid:18)(cid:18)(cid:2)(cid:1)(cid:2)(cid:3,,6576.0
,,1,,,Unknown,,cid:15)(cid:2)(cid:17)(cid:2)(cid:18)(cid:1)(cid:18)(cid:19)(cid:18)(cid:18)(cid:2)(cid:1)(cid:2)(cid:3,,6577.0
,,37,,,Unknown,,cid:15)(cid:2)(cid:17)(cid:2)(cid:18)(cid:1)(cid:18)(cid:19)(cid:18)(cid:18)(cid:2)(cid:1)(cid:2)(cid:3,,6614.0
,,1,,,Unknown,,cid:15)(cid:2)(cid:17)(cid:2)(cid:18)(cid:1)(cid:18)(cid:19)(cid:18)(cid:18)(cid:2)(cid:1)(cid:2)(cid:3,,6615.0
,,33,,,Unknown,,cid:15)(cid:2)(cid:17)(cid:2)(cid:18)(cid:1)(cid:18)(cid:19)(cid:18)(cid:18)(cid:2)(cid:1)(cid:2)(cid:3,,6648.0
,,45,,,Unknown,,cid:15)(cid:2)(cid:17)(cid:2)(cid:18)(cid:1)(cid:18)(cid:19)(cid:18)(cid:18)(cid:2)(cid:1)(cid:2)(cid:3,,6693.0
,,18,,,Unknown,,cid:15)(cid:2)(cid:17)(cid:2)(cid:18)(cid:1)(cid:18)(cid:19)(cid:18)(cid:18)(cid:2)(cid:1)(cid:2)(cid:3,,6711.0
,,35,,,Unknown,,cid:15)(cid:2)(cid:17)(cid:2)(cid:18)(cid:1)(cid:18)(cid:19)(cid:18)(cid:18)(cid:2)(cid:1)(cid:2)(cid:3,,6746.0
,,9,,,Unknown,,cid:15)(cid:2)(cid:17)(cid:2)(cid:18)(cid:1)(cid:18)(cid:19)(cid:18)(cid:18)(cid:2)(cid:1)(cid:2)(cid:3,,6755.0
,,13,,,Unknown,,cid:15)(cid:2)(cid:17)(cid:2)(cid:18)(cid:1)(cid:18)(cid:19)(cid:18)(cid:18)(cid:2)(cid:1)(cid:2)(cid:3,,6768.0
,,5,,,Unknown,,cid:15)(cid:2)(cid:17)(cid:2)(cid:18)(cid:1)(cid:18)(cid:19)(cid:18)(cid:18)(cid:2)(cid:1)(cid:2)(cid:3,,6773.0
,,14,,,Unknown,,cid:15)(cid:2)(cid:17)(cid:2)(cid:18)(cid:1)(cid:18)(cid:19)(cid:18)(cid:18)(cid:2)(cid:1)(cid:2)(cid:3,,6787.0
,,14,,,Unknown,,cid:15)(cid:2)(cid:17)(cid:2)(cid:18)(cid:1)(cid:18)(cid:19)(cid:18)(cid:18)(cid:2)(cid:1)(cid:2)(cid:3,,6801.0
,,2,,,Unknown,,cid:15)(cid:2)(cid:17)(cid:2)(cid:18)(cid:1)(cid:18)(cid:19)(cid:18)(cid:18)(cid:2)(cid:1)(cid:2)(cid:3,,6803.0
,,17,,,Unknown,,cid:15)(cid:2)(cid:17)(cid:2)(cid:18)(cid:1)(cid:18)(cid:19)(cid:18)(cid:18)(cid:2)(cid:1)(cid:2)(cid:3,,6820.0
,,1,,,Unknown,,cid:15)(cid:2)(cid:17)(cid:2)(cid:18)(cid:1)(cid:18)(cid:19)(cid:18)(cid:18)(cid:2)(cid:1)(cid:2)(cid:3,,6821.0
,,16,,,Unknown,,cid:15)(cid:2)(cid:17)(cid:2)(cid:18)(cid:1)(cid:18)(cid:19)(cid:18)(cid:18)(cid:2)(cid:1)(cid:2)(cid:3,,6837.0
,,17,,,Unknown,,cid:15)(cid:2)(cid:17)(cid:2)(cid:18)(cid:1)(cid:18)(cid:19)(cid:18)(cid:18)(cid:2)(cid:1)(cid:2)(cid:3,,6854.0
,,2,,,Unknown,,cid:15)(cid:2)(cid:17)(cid:2)(cid:18)(cid:1)(cid:18)(cid:19)(cid:18)(cid:18)(cid:2)(cid:1)(cid:2)(cid:3,,6856.0
,,13,,,Unknown,,cid:15)(cid:2)(cid:17)(cid:2)(cid:18)(cid:1)(cid:18)(cid:19)(cid:18)(cid:18)(cid:2)(cid:1)(cid:2)(cid:3,,6869.0
,,20,,,Unknown,,cid:15)(cid:2)(cid:17)(cid:2)(cid:18)(cid:1)(cid:18)(cid:19)(cid:18)(cid:18)(cid:2)(cid:1)(cid:2)(cid:3,,6889.0
,,22,,,Unknown,,cid:15)(cid:2)(cid:17)(cid:2)(cid:18)(cid:1)(cid:18)(cid:19)(cid:18)(cid:18)(cid:2)(cid:1)(cid:2)(cid:3,,6911.0
,,75,,,Unknown,,cid:15)(cid:2)(cid:17)(cid:2)(cid:18)(cid:1)(cid:18)(cid:19)(cid:18)(cid:18)(cid:2)(cid:1)(cid:2)(cid:3,,6986.0
,,74,,,Unknown,,cid:15)(cid:2)(cid:17)(cid:2)(cid:18)(cid:1)(cid:18)(cid:19)(cid:18)(cid:18)(cid:2)(cid:1)(cid:2)(cid:3,,7060.0
,,24,,,Unknown,,cid:15)(cid:2)(cid:17)(cid:2)(cid:18)(cid:1)(cid:18)(cid:19)(cid:18)(cid:18)(cid:2)(cid:1)(cid:2)(cid:3,,7084.0
,,26,,,Unknown,,cid:15)(cid:2)(cid:17)(cid:2)(cid:18)(cid:1)(cid:18)(cid:19)(cid:18)(cid:18)(cid:2)(cid:1)(cid:2)(cid:3,,7110.0
,,31,,,Unknown,,cid:15)(cid:2)(cid:17)(cid:2)(cid:18)(cid:1)(cid:18)(cid:19)(cid:18)(cid:18)(cid:2)(cid:1)(cid:2)(cid:3,,7141.0
,,58,,,Unknown,,cid:15)(cid:2)(cid:17)(cid:2)(cid:18)(cid:1)(cid:18)(cid:19)(cid:18)(cid:18)(cid:2)(cid:1)(cid:2)(cid:3,,7199.0
,,25,,,Unknown,,cid:15)(cid:2)(cid:17)(cid:2)(cid:18)(cid:1)(cid:18)(cid:19)(cid:18)(cid:18)(cid:2)(cid:1)(cid:2)(cid:3,,7224.0
,,30,,,Unknown,,cid:15)(cid:2)(cid:17)(cid:2)(cid:18)(cid:1)(cid:18)(cid:19)(cid:18)(cid:18)(cid:2)(cid:1)(cid:2)(cid:3,,7254.0
,,2,,,Unknown,,cid:15)(cid:2)(cid:17)(cid:2)(cid:18)(cid:1)(cid:18)(cid:19)(cid:18)(cid:18)(cid:2)(cid:1)(cid:2)(cid:3,,7256.0
,,11,,,Unknown,,cid:15)(cid:2)(cid:17)(cid:2)(cid:18)(cid:1)(cid:18)(cid:19)(cid:18)(cid:18)(cid:2)(cid:1)(cid:2)(cid:3,,7267.0
,,2,,,Unknown,,cid:15)(cid:2)(cid:17)(cid:2)(cid:18)(cid:1)(cid:18)(cid:19)(cid:18)(cid:18)(cid:2)(cid:1)(cid:2)(cid:3,,7269.0
,,49,,,Unknown,,cid:15)(cid:2)(cid:17)(cid:2)(cid:18)(cid:1)(cid:18)(cid:19)(cid:18)(cid:18)(cid:2)(cid:1)(cid:2)(cid:3,,7318.0
,,5,,,Unknown,,cid:15)(cid:2)(cid:17)(cid:2)(cid:18)(cid:1)(cid:18)(cid:19)(cid:18)(cid:18)(cid:2)(cid:1)(cid:2)(cid:3,,7323.0
,,15,,,Unknown,,cid:15)(cid:2)(cid:17)(cid:2)(cid:18)(cid:1)(cid:18)(cid:19)(cid:18)(cid:18)(cid:2)(cid:1)(cid:2)(cid:3,,7338.0
,,2,,,Unknown,,cid:15)(cid:2)(cid:17)(cid:2)(cid:18)(cid:1)(cid:18)(cid:19)(cid:18)(cid:18)(cid:2)(cid:1)(cid:2)(cid:3,,7340.0
,,17,,,Unknown,,cid:15)(cid:2)(cid:17)(cid:2)(cid:18)(cid:1)(cid:18)(cid:19)(cid:18)(cid:18)(cid:2)(cid:1)(cid:2)(cid:3,,7357.0
,,32,,,Unknown,,cid:15)(cid:2)(cid:17)(cid:2)(cid:18)(cid:1)(cid:18)(cid:19)(cid:18)(cid:18)(cid:2)(cid:1)(cid:2)(cid:3,,7389.0
,,37,,,Unknown,,cid:15)(cid:2)(cid:17)(cid:2)(cid:18)(cid:1)(cid:18)(cid:19)(cid:18)(cid:18)(cid:2)(cid:1)(cid:2)(cid:3,,7426.0
,,19,,,Unknown,,cid:15)(cid:2)(cid:17)(cid:2)(cid:18)(cid:1)(cid:18)(cid:19)(cid:18)(cid:18)(cid:2)(cid:1)(cid:2)(cid:3,,7445.0
,,17,,,Unknown,,cid:15)(cid:2)(cid:17)(cid:2)(cid:18)(cid:1)(cid:18)(cid:19)(cid:18)(cid:18)(cid:2)(cid:1)(cid:2)(cid:3,,7462.0
,,33,,,Unknown,,cid:15)(cid:2)(cid:17)(cid:2)(cid:18)(cid:1)(cid:18)(cid:19)(cid:18)(cid:18)(cid:2)(cid:1)(cid:2)(cid:3,,7495.0
,,2,,,Unknown,,cid:15)(cid:2)(cid:17)(cid:2)(cid:18)(cid:1)(cid:18)(cid:19)(cid:18)(cid:18)(cid:2)(cid:1)(cid:2)(cid:3,,7497.0
,,44,,,Unknown,,cid:15)(cid:2)(cid:17)(cid:2)(cid:18)(cid:1)(cid:18)(cid:19)(cid:18)(cid:18)(cid:2)(cid:1)(cid:2)(cid:3,,7541.0
,,12,,,Unknown,,cid:15)(cid:2)(cid:17)(cid:2)(cid:18)(cid:1)(cid:18)(cid:19)(cid:18)(cid:18)(cid:2)(cid:1)(cid:2)(cid:3,,7553.0
,,29,,,Unknown,,cid:15)(cid:2)(cid:17)(cid:2)(cid:18)(cid:1)(cid:18)(cid:19)(cid:18)(cid:18)(cid:2)(cid:1)(cid:2)(cid:3,,7582.0
,,26,,,Unknown,,cid:15)(cid:2)(cid:17)(cid:2)(cid:18)(cid:1)(cid:18)(cid:19)(cid:18)(cid:18)(cid:2)(cid:1)(cid:2)(cid:3,,7608.0
,,41,,,Unknown,,cid:15)(cid:2)(cid:17)(cid:2)(cid:18)(cid:1)(cid:18)(cid:19)(cid:18)(cid:18)(cid:2)(cid:1)(cid:2)(cid:3,,7649.0
,,25,,,Unknown,,cid:15)(cid:2)(cid:17)(cid:2)(cid:18)(cid:1)(cid:18)(cid:19)(cid:18)(cid:18)(cid:2)(cid:1)(cid:2)(cid:3,,7674.0
,,2,,,Unknown,,cid:15)(cid:2)(cid:17)(cid:2)(cid:18)(cid:1)(cid:18)(cid:19)(cid:18)(cid:18)(cid:2)(cid:1)(cid:2)(cid:3,,7676.0
,,50,,,Unknown,,cid:15)(cid:2)(cid:17)(cid:2)(cid:18)(cid:1)(cid:18)(cid:19)(cid:18)(cid:18)(cid:2)(cid:1)(cid:2)(cid:3,,7726.0
,,50,,,Unknown,,cid:15)(cid:2)(cid:17)(cid:2)(cid:18)(cid:1)(cid:18)(cid:19)(cid:18)(cid:18)(cid:2)(cid:1)(cid:2)(cid:3,,7776.0
,,37,,,Unknown,,cid:15)(cid:2)(cid:17)(cid:2)(cid:18)(cid:1)(cid:18)(cid:19)(cid:18)(cid:18)(cid:2)(cid:1)(cid:2)(cid:3,,7813.0
,,16,,,Unknown,,cid:15)(cid:2)(cid:17)(cid:2)(cid:18)(cid:1)(cid:18)(cid:19)(cid:18)(cid:18)(cid:2)(cid:1)(cid:2)(cid:3,,7829.0
,,34,,,Unknown,,cid:15)(cid:2)(cid:17)(cid:2)(cid:18)(cid:1)(cid:18)(cid:19)(cid:18)(cid:18)(cid:2)(cid:1)(cid:2)(cid:3,,7863.0
,,33,,,Unknown,,cid:15)(cid:2)(cid:17)(cid:2)(cid:18)(cid:1)(cid:18)(cid:19)(cid:18)(cid:18)(cid:2)(cid:1)(cid:2)(cid:3,,7896.0
,,37,,,Unknown,,cid:15)(cid:2)(cid:17)(cid:2)(cid:18)(cid:1)(cid:18)(cid:19)(cid:18)(cid:18)(cid:2)(cid:1)(cid:2)(cid:3,,7933.0
,,18,,,Unknown,,cid:15)(cid:2)(cid:17)(cid:2)(cid:18)(cid:1)(cid:18)(cid:19)(cid:18)(cid:18)(cid:2)(cid:1)(cid:2)(cid:3,,7951.0
,,45,,,Unknown,,cid:15)(cid:2)(cid:17)(cid:2)(cid:18)(cid:1)(cid:18)(cid:19)(cid:18)(cid:18)(cid:2)(cid:1)(cid:2)(cid:3,,7996.0
,,18,,,Unknown,,cid:15)(cid:2)(cid:17)(cid:2)(cid:18)(cid:1)(cid:18)(cid:19)(cid:18)(cid:18)(cid:2)(cid:1)(cid:2)(cid:3,,8014.0
,,35,,,Unknown,,cid:15)(cid:2)(cid:17)(cid:2)(cid:18)(cid:1)(cid:18)(cid:19)(cid:18)(cid:18)(cid:2)(cid:1)(cid:2)(cid:3,,8049.0
,,12,,,Unknown,,cid:15)(cid:2)(cid:17)(cid:2)(cid:18)(cid:1)(cid:18)(cid:19)(cid:18)(cid:18)(cid:2)(cid:1)(cid:2)(cid:3,,8061.0
,,39,,,Unknown,,cid:15)(cid:2)(cid:17)(cid:2)(cid:18)(cid:1)(cid:18)(cid:19)(cid:18)(cid:18)(cid:2)(cid:1)(cid:2)(cid:3,,8100.0
,,2,,,Unknown,,cid:15)(cid:2)(cid:17)(cid:2)(cid:18)(cid:1)(cid:18)(cid:19)(cid:18)(cid:18)(cid:2)(cid:1)(cid:2)(cid:3,,8102.0
,,13,,,Unknown,,cid:15)(cid:2)(cid:17)(cid:2)(cid:18)(cid:1)(cid:18)(cid:19)(cid:18)(cid:18)(cid:2)(cid:1)(cid:2)(cid:3,,8115.0
,,3,,,Unknown,,cid:15)(cid:2)(cid:17)(cid:2)(cid:18)(cid:1)(cid:18)(cid:19)(cid:18)(cid:18)(cid:2)(cid:1)(cid:2)(cid:3,,8118.0
,,4,,,Unknown,,cid:15)(cid:2)(cid:17)(cid:2)(cid:18)(cid:1)(cid:18)(cid:19)(cid:18)(cid:18)(cid:2)(cid:1)(cid:2)(cid:3,,8122.0
,,9,,,Unknown,,cid:15)(cid:2)(cid:17)(cid:2)(cid:18)(cid:1)(cid:18)(cid:19)(cid:18)(cid:18)(cid:2)(cid:1)(cid:2)(cid:3,,8131.0
,,7,,,Unknown,,cid:15)(cid:2)(cid:17)(cid:2)(cid:18)(cid:1)(cid:18)(cid:19)(cid:18)(cid:18)(cid:2)(cid:1)(cid:2)(cid:3,,8138.0
,,12,,,Unknown,,cid:15)(cid:2)(cid:17)(cid:2)(cid:18)(cid:1)(cid:18)(cid:19)(cid:18)(cid:18)(cid:2)(cid:1)(cid:2)(cid:3,,8150.0
,,46,,,Unknown,,cid:15)(cid:2)(cid:17)(cid:2)(cid:18)(cid:1)(cid:18)(cid:19)(cid:18)(cid:18)(cid:2)(cid:1)(cid:2)(cid:3,,8196.0
,,2,,,Unknown,,cid:15)(cid:2)(cid:17)(cid:2)(cid:18)(cid:1)(cid:18)(cid:19)(cid:18)(cid:18)(cid:2)(cid:1)(cid:2)(cid:3,,8198.0
,,13,,,Unknown,,cid:15)(cid:2)(cid:17)(cid:2)(cid:18)(cid:1)(cid:18)(cid:19)(cid:18)(cid:18)(cid:2)(cid:1)(cid:2)(cid:3,,8211.0
,,3,,,Unknown,,cid:15)(cid:2)(cid:17)(cid:2)(cid:18)(cid:1)(cid:18)(cid:19)(cid:18)(cid:18)(cid:2)(cid:1)(cid:2)(cid:3,,8214.0
,,4,,,Unknown,,cid:15)(cid:2)(cid:17)(cid:2)(cid:18)(cid:1)(cid:18)(cid:19)(cid:18)(cid:18)(cid:2)(cid:1)(cid:2)(cid:3,,8218.0
,,9,,,Unknown,,cid:15)(cid:2)(cid:17)(cid:2)(cid:18)(cid:1)(cid:18)(cid:19)(cid:18)(cid:18)(cid:2)(cid:1)(cid:2)(cid:3,,8227.0
,,7,,,Unknown,,cid:15)(cid:2)(cid:17)(cid:2)(cid:18)(cid:1)(cid:18)(cid:19)(cid:18)(cid:18)(cid:2)(cid:1)(cid:2)(cid:3,,8234.0
,,12,,,Unknown,,cid:15)(cid:2)(cid:17)(cid:2)(cid:18)(cid:1)(cid:18)(cid:19)(cid:18)(cid:18)(cid:2)(cid:1)(cid:2)(cid:3,,8246.0
,,46,,,Unknown,,cid:15)(cid:2)(cid:17)(cid:2)(cid:18)(cid:1)(cid:18)(cid:19)(cid:18)(cid:18)(cid:2)(cid:1)(cid:2)(cid:3,,8292.0
,,2,,,Unknown,,cid:15)(cid:2)(cid:17)(cid:2)(cid:18)(cid:1)(cid:18)(cid:19)(cid:18)(cid:18)(cid:2)(cid:1)(cid:2)(cid:3,,8294.0
,,9,,,Unknown,,cid:15)(cid:2)(cid:17)(cid:2)(cid:18)(cid:1)(cid:18)(cid:19)(cid:18)(cid:18)(cid:2)(cid:1)(cid:2)(cid:3,,8303.0
,,7,,,Unknown,,cid:15)(cid:2)(cid:17)(cid:2)(cid:18)(cid:1)(cid:18)(cid:19)(cid:18)(cid:18)(cid:2)(cid:1)(cid:2)(cid:3,,8310.0
,,15,,,Unknown,,cid:15)(cid:2)(cid:17)(cid:2)(cid:18)(cid:1)(cid:18)(cid:19)(cid:18)(cid:18)(cid:2)(cid:1)(cid:2)(cid:3,,8325.0
,,2,,,Unknown,,cid:15)(cid:2)(cid:17)(cid:2)(cid:18)(cid:1)(cid:18)(cid:19)(cid:18)(cid:18)(cid:2)(cid:1)(cid:2)(cid:3,,8327.0
,,16,,,Unknown,,cid:15)(cid:2)(cid:17)(cid:2)(cid:18)(cid:1)(cid:18)(cid:19)(cid:18)(cid:18)(cid:2)(cid:1)(cid:2)(cid:3,,8343.0
,,19,,,Unknown,,cid:15)(cid:2)(cid:17)(cid:2)(cid:18)(cid:1)(cid:18)(cid:19)(cid:18)(cid:18)(cid:2)(cid:1)(cid:2)(cid:3,,8362.0
,,32,,,Unknown,,cid:15)(cid:2)(cid:17)(cid:2)(cid:18)(cid:1)(cid:18)(cid:19)(cid:18)(cid:18)(cid:2)(cid:1)(cid:2)(cid:3,,8394.0
,,18,,,Unknown,,cid:15)(cid:2)(cid:17)(cid:2)(cid:18)(cid:1)(cid:18)(cid:19)(cid:18)(cid:18)(cid:2)(cid:1)(cid:2)(cid:3,,8412.0
,,2,,,Unknown,,cid:15)(cid:2)(cid:17)(cid:2)(cid:18)(cid:1)(cid:18)(cid:19)(cid:18)(cid:18)(cid:2)(cid:1)(cid:2)(cid:3,,8414.0
,,44,,,Unknown,,cid:15)(cid:2)(cid:17)(cid:2)(cid:18)(cid:1)(cid:18)(cid:19)(cid:18)(cid:18)(cid:2)(cid:1)(cid:2)(cid:3,,8458.0
,,12,,,Unknown,,cid:15)(cid:2)(cid:17)(cid:2)(cid:18)(cid:1)(cid:18)(cid:19)(cid:18)(cid:18)(cid:2)(cid:1)(cid:2)(cid:3,,8470.0
,,29,,,Unknown,,cid:15)(cid:2)(cid:17)(cid:2)(cid:18)(cid:1)(cid:18)(cid:19)(cid:18)(cid:18)(cid:2)(cid:1)(cid:2)(cid:3,,8499.0
,,26,,,Unknown,,cid:15)(cid:2)(cid:17)(cid:2)(cid:18)(cid:1)(cid:18)(cid:19)(cid:18)(cid:18)(cid:2)(cid:1)(cid:2)(cid:3,,8525.0
,,41,,,Unknown,,cid:15)(cid:2)(cid:17)(cid:2)(cid:18)(cid:1)(cid:18)(cid:19)(cid:18)(cid:18)(cid:2)(cid:1)(cid:2)(cid:3,,8566.0
,,25,,,Unknown,,cid:15)(cid:2)(cid:17)(cid:2)(cid:18)(cid:1)(cid:18)(cid:19)(cid:18)(cid:18)(cid:2)(cid:1)(cid:2)(cid:3,,8591.0
,,2,,,Unknown,,cid:15)(cid:2)(cid:17)(cid:2)(cid:18)(cid:1)(cid:18)(cid:19)(cid:18)(cid:18)(cid:2)(cid:1)(cid:2)(cid:3,,8593.0
,,50,,,Unknown,,cid:15)(cid:2)(cid:17)(cid:2)(cid:18)(cid:1)(cid:18)(cid:19)(cid:18)(cid:18)(cid:2)(cid:1)(cid:2)(cid:3,,8643.0
,,50,,,Unknown,,cid:15)(cid:2)(cid:17)(cid:2)(cid:18)(cid:1)(cid:18)(cid:19)(cid:18)(cid:18)(cid:2)(cid:1)(cid:2)(cid:3,,8693.0
,,18,,,Unknown,,cid:15)(cid:2)(cid:17)(cid:2)(cid:18)(cid:1)(cid:18)(cid:19)(cid:18)(cid:18)(cid:2)(cid:1)(cid:2)(cid:3,,8711.0
,,1,,,Unknown,,cid:15)(cid:2)(cid:17)(cid:2)(cid:18)(cid:1)(cid:18)(cid:19)(cid:18)(cid:18)(cid:2)(cid:1)(cid:2)(cid:3,,8712.0
,,1,,,Unknown,,cid:15)(cid:2)(cid:17)(cid:2)(cid:18)(cid:1)(cid:18)(cid:19)(cid:18)(cid:18)(cid:2)(cid:1)(cid:2)(cid:3,,8713.0
,,37,,,Unknown,,cid:15)(cid:2)(cid:17)(cid:2)(cid:18)(cid:1)(cid:18)(cid:19)(cid:18)(cid:18)(cid:2)(cid:1)(cid:2)(cid:3,,8750.0
,,37,,,Unknown,,cid:15)(cid:2)(cid:17)(cid:2)(cid:18)(cid:1)(cid:18)(cid:19)(cid:18)(cid:18)(cid:2)(cid:1)(cid:2)(cid:3,,8787.0
,,18,,,Unknown,,cid:15)(cid:2)(cid:17)(cid:2)(cid:18)(cid:1)(cid:18)(cid:19)(cid:18)(cid:18)(cid:2)(cid:1)(cid:2)(cid:3,,8805.0
,,45,,,Unknown,,cid:15)(cid:2)(cid:17)(cid:2)(cid:18)(cid:1)(cid:18)(cid:19)(cid:18)(cid:18)(cid:2)(cid:1)(cid:2)(cid:3,,8850.0
,,18,,,Unknown,,cid:15)(cid:2)(cid:17)(cid:2)(cid:18)(cid:1)(cid:18)(cid:19)(cid:18)(cid:18)(cid:2)(cid:1)(cid:2)(cid:3,,8868.0
,,35,,,Unknown,,cid:15)(cid:2)(cid:17)(cid:2)(cid:18)(cid:1)(cid:18)(cid:19)(cid:18)(cid:18)(cid:2)(cid:1)(cid:2)(cid:3,,8903.0
,,10,,,Unknown,,cid:15)(cid:2)(cid:17)(cid:2)(cid:18)(cid:1)(cid:18)(cid:19)(cid:18)(cid:18)(cid:2)(cid:1)(cid:2)(cid:3,,8913.0
,,11,,,Unknown,,cid:15)(cid:2)(cid:17)(cid:2)(cid:18)(cid:1)(cid:18)(cid:19)(cid:18)(cid:18)(cid:2)(cid:1)(cid:2)(cid:3,,8924.0
,,10,,,Unknown,,cid:15)(cid:2)(cid:17)(cid:2)(cid:18)(cid:1)(cid:18)(cid:19)(cid:18)(cid:18)(cid:2)(cid:1)(cid:2)(cid:3,,8934.0
,,46,,,Unknown,,cid:15)(cid:2)(cid:17)(cid:2)(cid:18)(cid:1)(cid:18)(cid:19)(cid:18)(cid:18)(cid:2)(cid:1)(cid:2)(cid:3,,8980.0
,,14,,,Unknown,,cid:15)(cid:2)(cid:17)(cid:2)(cid:18)(cid:1)(cid:18)(cid:19)(cid:18)(cid:18)(cid:2)(cid:1)(cid:2)(cid:3,,8994.0
,,49,,,Unknown,,cid:15)(cid:2)(cid:17)(cid:2)(cid:18)(cid:1)(cid:18)(cid:19)(cid:18)(cid:18)(cid:2)(cid:1)(cid:2)(cid:3,,9043.0
,,46,,,Unknown,,cid:15)(cid:2)(cid:17)(cid:2)(cid:18)(cid:1)(cid:18)(cid:19)(cid:18)(cid:18)(cid:2)(cid:1)(cid:2)(cid:3,,9089.0
,,14,,,Unknown,,cid:15)(cid:2)(cid:17)(cid:2)(cid:18)(cid:1)(cid:18)(cid:19)(cid:18)(cid:18)(cid:2)(cid:1)(cid:2)(cid:3,,9103.0
,,10,,,Unknown,,cid:15)(cid:2)(cid:17)(cid:2)(cid:18)(cid:1)(cid:18)(cid:19)(cid:18)(cid:18)(cid:2)(cid:1)(cid:2)(cid:3,,9113.0
,,68,,,Unknown,,cid:15)(cid:2)(cid:17)(cid:2)(cid:18)(cid:1)(cid:18)(cid:19)(cid:18)(cid:18)(cid:2)(cid:1)(cid:2)(cid:3,,9181.0
,,9,,,Unknown,,cid:15)(cid:2)(cid:17)(cid:2)(cid:18)(cid:1)(cid:18)(cid:19)(cid:18)(cid:18)(cid:2)(cid:1)(cid:2)(cid:3,,9190.0
,,46,,,Unknown,,cid:15)(cid:2)(cid:17)(cid:2)(cid:18)(cid:1)(cid:18)(cid:19)(cid:18)(cid:18)(cid:2)(cid:1)(cid:2)(cid:3,,9236.0
,,36,,,Unknown,,cid:15)(cid:2)(cid:17)(cid:2)(cid:18)(cid:1)(cid:18)(cid:19)(cid:18)(cid:18)(cid:2)(cid:1)(cid:2)(cid:3,,9272.0
,,2,,,Unknown,,cid:15)(cid:2)(cid:17)(cid:2)(cid:18)(cid:1)(cid:18)(cid:19)(cid:18)(cid:18)(cid:2)(cid:1)(cid:2)(cid:3,,9274.0
,,9,,,Unknown,,cid:15)(cid:2)(cid:17)(cid:2)(cid:18)(cid:1)(cid:18)(cid:19)(cid:18)(cid:18)(cid:2)(cid:1)(cid:2)(cid:3,,9283.0
,,10,,,Unknown,,cid:15)(cid:2)(cid:17)(cid:2)(cid:18)(cid:1)(cid:18)(cid:19)(cid:18)(cid:18)(cid:2)(cid:1)(cid:2)(cid:3,,9293.0
,,2,,,Unknown,,cid:15)(cid:2)(cid:17)(cid:2)(cid:18)(cid:1)(cid:18)(cid:19)(cid:18)(cid:18)(cid:2)(cid:1)(cid:2)(cid:3,,9295.0
,,39,,,Unknown,,cid:15)(cid:2)(cid:17)(cid:2)(cid:18)(cid:1)(cid:18)(cid:19)(cid:18)(cid:18)(cid:2)(cid:1)(cid:2)(cid:3,,9334.0
,,3,,,Unknown,,cid:15)(cid:2)(cid:17)(cid:2)(cid:18)(cid:1)(cid:18)(cid:19)(cid:18)(cid:18)(cid:2)(cid:1)(cid:2)(cid:3,,9337.0
,,7,,,Unknown,,cid:15)(cid:2)(cid:17)(cid:2)(cid:18)(cid:1)(cid:18)(cid:19)(cid:18)(cid:18)(cid:2)(cid:1)(cid:2)(cid:3,,9344.0
,,52,,,Unknown,,cid:15)(cid:2)(cid:17)(cid:2)(cid:18)(cid:1)(cid:18)(cid:19)(cid:18)(cid:18)(cid:2)(cid:1)(cid:2)(cid:3,,9396.0
,,46,,,Unknown,,cid:15)(cid:2)(cid:17)(cid:2)(cid:18)(cid:1)(cid:18)(cid:19)(cid:18)(cid:18)(cid:2)(cid:1)(cid:2)(cid:3,,9442.0
,,10,,,Unknown,,cid:15)(cid:2)(cid:17)(cid:2)(cid:18)(cid:1)(cid:18)(cid:19)(cid:18)(cid:18)(cid:2)(cid:1)(cid:2)(cid:3,,9452.0
,,2,,,Unknown,,cid:15)(cid:2)(cid:17)(cid:2)(cid:18)(cid:1)(cid:18)(cid:19)(cid:18)(cid:18)(cid:2)(cid:1)(cid:2)(cid:3,,9454.0
,,14,,,Unknown,,cid:15)(cid:2)(cid:17)(cid:2)(cid:18)(cid:1)(cid:18)(cid:19)(cid:18)(cid:18)(cid:2)(cid:1)(cid:2)(cid:3,,9468.0
,,46,,,Unknown,,cid:15)(cid:2)(cid:17)(cid:2)(cid:18)(cid:1)(cid:18)(cid:19)(cid:18)(cid:18)(cid:2)(cid:1)(cid:2)(cid:3,,9514.0
,,2,,,Unknown,,cid:15)(cid:2)(cid:17)(cid:2)(cid:18)(cid:1)(cid:18)(cid:19)(cid:18)(cid:18)(cid:2)(cid:1)(cid:2)(cid:3,,9516.0
,,28,,,Unknown,,cid:15)(cid:2)(cid:17)(cid:2)(cid:18)(cid:1)(cid:18)(cid:19)(cid:18)(cid:18)(cid:2)(cid:1)(cid:2)(cid:3,,9544.0
,,3,,,Unknown,,cid:15)(cid:2)(cid:17)(cid:2)(cid:18)(cid:1)(cid:18)(cid:19)(cid:18)(cid:18)(cid:2)(cid:1)(cid:2)(cid:3,,9547.0
,,15,,,Unknown,,cid:15)(cid:2)(cid:17)(cid:2)(cid:18)(cid:1)(cid:18)(cid:19)(cid:18)(cid:18)(cid:2)(cid:1)(cid:2)(cid:3,,9562.0
,,2,,,Unknown,,cid:15)(cid:2)(cid:17)(cid:2)(cid:18)(cid:1)(cid:18)(cid:19)(cid:18)(cid:18)(cid:2)(cid:1)(cid:2)(cid:3,,9564.0
,,1,,,Unknown,,cid:15)(cid:2)(cid:17)(cid:2)(cid:18)(cid:1)(cid:18)(cid:19)(cid:18)(cid:18)(cid:2)(cid:1)(cid:2)(cid:3,,9565.0
,,19,,,Unknown,,cid:15)(cid:2)(cid:17)(cid:2)(cid:18)(cid:1)(cid:18)(cid:19)(cid:18)(cid:18)(cid:2)(cid:1)(cid:2)(cid:3,,9584.0
,,18,,,Unknown,,cid:15)(cid:2)(cid:17)(cid:2)(cid:18)(cid:1)(cid:18)(cid:19)(cid:18)(cid:18)(cid:2)(cid:1)(cid:2)(cid:3,,9602.0
,,18,,,Unknown,,cid:15)(cid:2)(cid:17)(cid:2)(cid:18)(cid:1)(cid:18)(cid:19)(cid:18)(cid:18)(cid:2)(cid:1)(cid:2)(cid:3,,9620.0
,,2,,,Unknown,,cid:15)(cid:2)(cid:17)(cid:2)(cid:18)(cid:1)(cid:18)(cid:19)(cid:18)(cid:18)(cid:2)(cid:1)(cid:2)(cid:3,,9622.0
,,44,,,Unknown,,cid:15)(cid:2)(cid:17)(cid:2)(cid:18)(cid:1)(cid:18)(cid:19)(cid:18)(cid:18)(cid:2)(cid:1)(cid:2)(cid:3,,9666.0
,,12,,,Unknown,,cid:15)(cid:2)(cid:17)(cid:2)(cid:18)(cid:1)(cid:18)(cid:19)(cid:18)(cid:18)(cid:2)(cid:1)(cid:2)(cid:3,,9678.0
,,29,,,Unknown,,cid:15)(cid:2)(cid:17)(cid:2)(cid:18)(cid:1)(cid:18)(cid:19)(cid:18)(cid:18)(cid:2)(cid:1)(cid:2)(cid:3,,9707.0
,,26,,,Unknown,,cid:15)(cid:2)(cid:17)(cid:2)(cid:18)(cid:1)(cid:18)(cid:19)(cid:18)(cid:18)(cid:2)(cid:1)(cid:2)(cid:3,,9733.0
,,41,,,Unknown,,cid:15)(cid:2)(cid:17)(cid:2)(cid:18)(cid:1)(cid:18)(cid:19)(cid:18)(cid:18)(cid:2)(cid:1)(cid:2)(cid:3,,9774.0
,,25,,,Unknown,,cid:15)(cid:2)(cid:17)(cid:2)(cid:18)(cid:1)(cid:18)(cid:19)(cid:18)(cid:18)(cid:2)(cid:1)(cid:2)(cid:3,,9799.0
,,2,,,Unknown,,cid:15)(cid:2)(cid:17)(cid:2)(cid:18)(cid:1)(cid:18)(cid:19)(cid:18)(cid:18)(cid:2)(cid:1)(cid:2)(cid:3,,9801.0
,,50,,,Unknown,,cid:15)(cid:2)(cid:17)(cid:2)(cid:18)(cid:1)(cid:18)(cid:19)(cid:18)(cid:18)(cid:2)(cid:1)(cid:2)(cid:3,,9851.0
,,50,,,Unknown,,cid:15)(cid:2)(cid:17)(cid:2)(cid:18)(cid:1)(cid:18)(cid:19)(cid:18)(cid:18)(cid:2)(cid:1)(cid:2)(cid:3,,9901.0
,,18,,,Unknown,,cid:15)(cid:2)(cid:17)(cid:2)(cid:18)(cid:1)(cid:18)(cid:19)(cid:18)(cid:18)(cid:2)(cid:1)(cid:2)(cid:3,,9919.0
,,1,,,Unknown,,cid:15)(cid:2)(cid:17)(cid:2)(cid:18)(cid:1)(cid:18)(cid:19)(cid:18)(cid:18)(cid:2)(cid:1)(cid:2)(cid:3,,9920.0
,,1,,,Unknown,,cid:15)(cid:2)(cid:17)(cid:2)(cid:18)(cid:1)(cid:18)(cid:19)(cid:18)(cid:18)(cid:2)(cid:1)(cid:2)(cid:3,,9921.0
,,37,,,Unknown,,cid:15)(cid:2)(cid:17)(cid:2)(cid:18)(cid:1)(cid:18)(cid:19)(cid:18)(cid:18)(cid:2)(cid:1)(cid:2)(cid:3,,9958.0
,,37,,,Unknown,,cid:15)(cid:2)(cid:17)(cid:2)(cid:18)(cid:1)(cid:18)(cid:19)(cid:18)(cid:18)(cid:2)(cid:1)(cid:2)(cid:3,,9995.0
,,18,,,Unknown,,cid:15)(cid:2)(cid:17)(cid:2)(cid:18)(cid:1)(cid:18)(cid:19)(cid:18)(cid:18)(cid:2)(cid:1)(cid:2)(cid:3,,10013.0
,,45,,,Unknown,,cid:15)(cid:2)(cid:17)(cid:2)(cid:18)(cid:1)(cid:18)(cid:19)(cid:18)(cid:18)(cid:2)(cid:1)(cid:2)(cid:3,,10058.0
,,18,,,Unknown,,cid:15)(cid:2)(cid:17)(cid:2)(cid:18)(cid:1)(cid:18)(cid:19)(cid:18)(cid:18)(cid:2)(cid:1)(cid:2)(cid:3,,10076.0
,,35,,,Unknown,,cid:15)(cid:2)(cid:17)(cid:2)(cid:18)(cid:1)(cid:18)(cid:19)(cid:18)(cid:18)(cid:2)(cid:1)(cid:2)(cid:3,,10111.0
,,54,,,Unknown,,cid:15)(cid:2)(cid:17)(cid:2)(cid:18)(cid:1)(cid:18)(cid:19)(cid:18)(cid:18)(cid:2)(cid:1)(cid:2)(cid:3,,10165.0
,,46,,,Unknown,,cid:15)(cid:2)(cid:17)(cid:2)(cid:18)(cid:1)(cid:18)(cid:19)(cid:18)(cid:18)(cid:2)(cid:1)(cid:2)(cid:3,,10211.0
,,4,,,Unknown,,cid:15)(cid:2)(cid:17)(cid:2)(cid:18)(cid:1)(cid:18)(cid:19)(cid:18)(cid:18)(cid:2)(cid:1)(cid:2)(cid:3,,10215.0
,,10,,,Unknown,,cid:15)(cid:2)(cid:17)(cid:2)(cid:18)(cid:1)(cid:18)(cid:19)(cid:18)(cid:18)(cid:2)(cid:1)(cid:2)(cid:3,,10225.0
,,9,,,Unknown,,cid:15)(cid:2)(cid:17)(cid:2)(cid:18)(cid:1)(cid:18)(cid:19)(cid:18)(cid:18)(cid:2)(cid:1)(cid:2)(cid:3,,10234.0
,,10,,,Unknown,,cid:15)(cid:2)(cid:17)(cid:2)(cid:18)(cid:1)(cid:18)(cid:19)(cid:18)(cid:18)(cid:2)(cid:1)(cid:2)(cid:3,,10244.0
,,5,,,Unknown,,cid:15)(cid:2)(cid:17)(cid:2)(cid:18)(cid:1)(cid:18)(cid:19)(cid:18)(cid:18)(cid:2)(cid:1)(cid:2)(cid:3,,10249.0
,,14,,,Unknown,,cid:15)(cid:2)(cid:17)(cid:2)(cid:18)(cid:1)(cid:18)(cid:19)(cid:18)(cid:18)(cid:2)(cid:1)(cid:2)(cid:3,,10263.0
,,14,,,Unknown,,cid:15)(cid:2)(cid:17)(cid:2)(cid:18)(cid:1)(cid:18)(cid:19)(cid:18)(cid:18)(cid:2)(cid:1)(cid:2)(cid:3,,10277.0
,,5,,,Unknown,,cid:15)(cid:2)(cid:17)(cid:2)(cid:18)(cid:1)(cid:18)(cid:19)(cid:18)(cid:18)(cid:2)(cid:1)(cid:2)(cid:3,,10282.0
,,2,,,Unknown,,cid:15)(cid:2)(cid:17)(cid:2)(cid:18)(cid:1)(cid:18)(cid:19)(cid:18)(cid:18)(cid:2)(cid:1)(cid:2)(cid:3,,10284.0
,,9,,,Unknown,,cid:15)(cid:2)(cid:17)(cid:2)(cid:18)(cid:1)(cid:18)(cid:19)(cid:18)(cid:18)(cid:2)(cid:1)(cid:2)(cid:3,,10293.0
,,10,,,Unknown,,cid:15)(cid:2)(cid:17)(cid:2)(cid:18)(cid:1)(cid:18)(cid:19)(cid:18)(cid:18)(cid:2)(cid:1)(cid:2)(cid:3,,10303.0
,,2,,,Unknown,,cid:15)(cid:2)(cid:17)(cid:2)(cid:18)(cid:1)(cid:18)(cid:19)(cid:18)(cid:18)(cid:2)(cid:1)(cid:2)(cid:3,,10305.0
,,54,,,Unknown,,cid:15)(cid:2)(cid:17)(cid:2)(cid:18)(cid:1)(cid:18)(cid:19)(cid:18)(cid:18)(cid:2)(cid:1)(cid:2)(cid:3,,10359.0
,,7,,,Unknown,,cid:15)(cid:2)(cid:17)(cid:2)(cid:18)(cid:1)(cid:18)(cid:19)(cid:18)(cid:18)(cid:2)(cid:1)(cid:2)(cid:3,,10366.0
,,12,,,Unknown,,cid:15)(cid:2)(cid:17)(cid:2)(cid:18)(cid:1)(cid:18)(cid:19)(cid:18)(cid:18)(cid:2)(cid:1)(cid:2)(cid:3,,10378.0
,,13,,,Unknown,,cid:15)(cid:2)(cid:17)(cid:2)(cid:18)(cid:1)(cid:18)(cid:19)(cid:18)(cid:18)(cid:2)(cid:1)(cid:2)(cid:3,,10391.0
,,46,,,Unknown,,cid:15)(cid:2)(cid:17)(cid:2)(cid:18)(cid:1)(cid:18)(cid:19)(cid:18)(cid:18)(cid:2)(cid:1)(cid:2)(cid:3,,10437.0
,,5,,,Unknown,,cid:15)(cid:2)(cid:17)(cid:2)(cid:18)(cid:1)(cid:18)(cid:19)(cid:18)(cid:18)(cid:2)(cid:1)(cid:2)(cid:3,,10442.0
,,14,,,Unknown,,cid:15)(cid:2)(cid:17)(cid:2)(cid:18)(cid:1)(cid:18)(cid:19)(cid:18)(cid:18)(cid:2)(cid:1)(cid:2)(cid:3,,10456.0
,,2,,,Unknown,,cid:15)(cid:2)(cid:17)(cid:2)(cid:18)(cid:1)(cid:18)(cid:19)(cid:18)(cid:18)(cid:2)(cid:1)(cid:2)(cid:3,,10458.0
,,9,,,Unknown,,cid:15)(cid:2)(cid:17)(cid:2)(cid:18)(cid:1)(cid:18)(cid:19)(cid:18)(cid:18)(cid:2)(cid:1)(cid:2)(cid:3,,10467.0
,,10,,,Unknown,,cid:15)(cid:2)(cid:17)(cid:2)(cid:18)(cid:1)(cid:18)(cid:19)(cid:18)(cid:18)(cid:2)(cid:1)(cid:2)(cid:3,,10477.0
,,63,,,Unknown,,cid:15)(cid:2)(cid:17)(cid:2)(cid:18)(cid:1)(cid:18)(cid:19)(cid:18)(cid:18)(cid:2)(cid:1)(cid:2)(cid:3,,10540.0
,,54,,,Unknown,,cid:15)(cid:2)(cid:17)(cid:2)(cid:18)(cid:1)(cid:18)(cid:19)(cid:18)(cid:18)(cid:2)(cid:1)(cid:2)(cid:3,,10594.0
,,7,,,Unknown,,cid:15)(cid:2)(cid:17)(cid:2)(cid:18)(cid:1)(cid:18)(cid:19)(cid:18)(cid:18)(cid:2)(cid:1)(cid:2)(cid:3,,10601.0
,,12,,,Unknown,,cid:15)(cid:2)(cid:17)(cid:2)(cid:18)(cid:1)(cid:18)(cid:19)(cid:18)(cid:18)(cid:2)(cid:1)(cid:2)(cid:3,,10613.0
,,13,,,Unknown,,cid:15)(cid:2)(cid:17)(cid:2)(cid:18)(cid:1)(cid:18)(cid:19)(cid:18)(cid:18)(cid:2)(cid:1)(cid:2)(cid:3,,10626.0
,,46,,,Unknown,,cid:15)(cid:2)(cid:17)(cid:2)(cid:18)(cid:1)(cid:18)(cid:19)(cid:18)(cid:18)(cid:2)(cid:1)(cid:2)(cid:3,,10672.0
,,5,,,Unknown,,cid:15)(cid:2)(cid:17)(cid:2)(cid:18)(cid:1)(cid:18)(cid:19)(cid:18)(cid:18)(cid:2)(cid:1)(cid:2)(cid:3,,10677.0
,,14,,,Unknown,,cid:15)(cid:2)(cid:17)(cid:2)(cid:18)(cid:1)(cid:18)(cid:19)(cid:18)(cid:18)(cid:2)(cid:1)(cid:2)(cid:3,,10691.0
,,45,,,Unknown,,cid:15)(cid:2)(cid:17)(cid:2)(cid:18)(cid:1)(cid:18)(cid:19)(cid:18)(cid:18)(cid:2)(cid:1)(cid:2)(cid:3,,10736.0
,,14,,,Unknown,,cid:15)(cid:2)(cid:17)(cid:2)(cid:18)(cid:1)(cid:18)(cid:19)(cid:18)(cid:18)(cid:2)(cid:1)(cid:2)(cid:3,,10750.0
,,4,,,Unknown,,cid:15)(cid:2)(cid:17)(cid:2)(cid:18)(cid:1)(cid:18)(cid:19)(cid:18)(cid:18)(cid:2)(cid:1)(cid:2)(cid:3,,10754.0
,,2,,,Unknown,,cid:15)(cid:2)(cid:17)(cid:2)(cid:18)(cid:1)(cid:18)(cid:19)(cid:18)(cid:18)(cid:2)(cid:1)(cid:2)(cid:3,,10756.0
,,46,,,Unknown,,cid:15)(cid:2)(cid:17)(cid:2)(cid:18)(cid:1)(cid:18)(cid:19)(cid:18)(cid:18)(cid:2)(cid:1)(cid:2)(cid:3,,10802.0
,,10,,,Unknown,,cid:15)(cid:2)(cid:17)(cid:2)(cid:18)(cid:1)(cid:18)(cid:19)(cid:18)(cid:18)(cid:2)(cid:1)(cid:2)(cid:3,,10812.0
,,15,,,Unknown,,cid:15)(cid:2)(cid:17)(cid:2)(cid:18)(cid:1)(cid:18)(cid:19)(cid:18)(cid:18)(cid:2)(cid:1)(cid:2)(cid:3,,10827.0
,,2,,,Unknown,,cid:15)(cid:2)(cid:17)(cid:2)(cid:18)(cid:1)(cid:18)(cid:19)(cid:18)(cid:18)(cid:2)(cid:1)(cid:2)(cid:3,,10829.0
,,17,,,Unknown,,cid:15)(cid:2)(cid:17)(cid:2)(cid:18)(cid:1)(cid:18)(cid:19)(cid:18)(cid:18)(cid:2)(cid:1)(cid:2)(cid:3,,10846.0
,,1,,,Unknown,,cid:15)(cid:2)(cid:17)(cid:2)(cid:18)(cid:1)(cid:18)(cid:19)(cid:18)(cid:18)(cid:2)(cid:1)(cid:2)(cid:3,,10847.0
,,19,,,Unknown,,cid:15)(cid:2)(cid:17)(cid:2)(cid:18)(cid:1)(cid:18)(cid:19)(cid:18)(cid:18)(cid:2)(cid:1)(cid:2)(cid:3,,10866.0
,,34,,,Unknown,,cid:15)(cid:2)(cid:17)(cid:2)(cid:18)(cid:1)(cid:18)(cid:19)(cid:18)(cid:18)(cid:2)(cid:1)(cid:2)(cid:3,,10900.0
,,18,,,Unknown,,cid:15)(cid:2)(cid:17)(cid:2)(cid:18)(cid:1)(cid:18)(cid:19)(cid:18)(cid:18)(cid:2)(cid:1)(cid:2)(cid:3,,10918.0
,,2,,,Unknown,,cid:15)(cid:2)(cid:17)(cid:2)(cid:18)(cid:1)(cid:18)(cid:19)(cid:18)(cid:18)(cid:2)(cid:1)(cid:2)(cid:3,,10920.0
,,44,,,Unknown,,cid:15)(cid:2)(cid:17)(cid:2)(cid:18)(cid:1)(cid:18)(cid:19)(cid:18)(cid:18)(cid:2)(cid:1)(cid:2)(cid:3,,10964.0
,,12,,,Unknown,,cid:15)(cid:2)(cid:17)(cid:2)(cid:18)(cid:1)(cid:18)(cid:19)(cid:18)(cid:18)(cid:2)(cid:1)(cid:2)(cid:3,,10976.0
,,29,,,Unknown,,cid:15)(cid:2)(cid:17)(cid:2)(cid:18)(cid:1)(cid:18)(cid:19)(cid:18)(cid:18)(cid:2)(cid:1)(cid:2)(cid:3,,11005.0
,,26,,,Unknown,,cid:15)(cid:2)(cid:17)(cid:2)(cid:18)(cid:1)(cid:18)(cid:19)(cid:18)(cid:18)(cid:2)(cid:1)(cid:2)(cid:3,,11031.0
,,41,,,Unknown,,cid:15)(cid:2)(cid:17)(cid:2)(cid:18)(cid:1)(cid:18)(cid:19)(cid:18)(cid:18)(cid:2)(cid:1)(cid:2)(cid:3,,11072.0
,,25,,,Unknown,,cid:15)(cid:2)(cid:17)(cid:2)(cid:18)(cid:1)(cid:18)(cid:19)(cid:18)(cid:18)(cid:2)(cid:1)(cid:2)(cid:3,,11097.0
,,2,,,Unknown,,cid:15)(cid:2)(cid:17)(cid:2)(cid:18)(cid:1)(cid:18)(cid:19)(cid:18)(cid:18)(cid:2)(cid:1)(cid:2)(cid:3,,11099.0
,,50,,,Unknown,,cid:15)(cid:2)(cid:17)(cid:2)(cid:18)(cid:1)(cid:18)(cid:19)(cid:18)(cid:18)(cid:2)(cid:1)(cid:2)(cid:3,,11149.0
,,50,,,Unknown,,cid:15)(cid:2)(cid:17)(cid:2)(cid:18)(cid:1)(cid:18)(cid:19)(cid:18)(cid:18)(cid:2)(cid:1)(cid:2)(cid:3,,11199.0
,,18,,,Unknown,,cid:15)(cid:2)(cid:17)(cid:2)(cid:18)(cid:1)(cid:18)(cid:19)(cid:18)(cid:18)(cid:2)(cid:1)(cid:2)(cid:3,,11217.0
,,1,,,Unknown,,cid:15)(cid:2)(cid:17)(cid:2)(cid:18)(cid:1)(cid:18)(cid:19)(cid:18)(cid:18)(cid:2)(cid:1)(cid:2)(cid:3,,11218.0
,,1,,,Unknown,,cid:15)(cid:2)(cid:17)(cid:2)(cid:18)(cid:1)(cid:18)(cid:19)(cid:18)(cid:18)(cid:2)(cid:1)(cid:2)(cid:3,,11219.0
,,37,,,Unknown,,cid:15)(cid:2)(cid:17)(cid:2)(cid:18)(cid:1)(cid:18)(cid:19)(cid:18)(cid:18)(cid:2)(cid:1)(cid:2)(cid:3,,11256.0
,,37,,,Unknown,,cid:15)(cid:2)(cid:17)(cid:2)(cid:18)(cid:1)(cid:18)(cid:19)(cid:18)(cid:18)(cid:2)(cid:1)(cid:2)(cid:3,,11293.0
,,17,,,Unknown,,cid:15)(cid:2)(cid:17)(cid:2)(cid:18)(cid:1)(cid:18)(cid:19)(cid:18)(cid:18)(cid:2)(cid:1)(cid:2)(cid:3,,11310.0
,,45,,,Unknown,,cid:15)(cid:2)(cid:17)(cid:2)(cid:18)(cid:1)(cid:18)(cid:19)(cid:18)(cid:18)(cid:2)(cid:1)(cid:2)(cid:3,,11355.0
,,18,,,Unknown,,cid:15)(cid:2)(cid:17)(cid:2)(cid:18)(cid:1)(cid:18)(cid:19)(cid:18)(cid:18)(cid:2)(cid:1)(cid:2)(cid:3,,11373.0
,,35,,,Unknown,,cid:15)(cid:2)(cid:17)(cid:2)(cid:18)(cid:1)(cid:18)(cid:19)(cid:18)(cid:18)(cid:2)(cid:1)(cid:2)(cid:3,,11408.0
,,65,,,Unknown,,cid:15)(cid:2)(cid:17)(cid:2)(cid:18)(cid:1)(cid:18)(cid:19)(cid:18)(cid:18)(cid:2)(cid:1)(cid:2)(cid:3,,11473.0
,,39,,,Unknown,,cid:15)(cid:2)(cid:17)(cid:2)(cid:18)(cid:1)(cid:18)(cid:19)(cid:18)(cid:18)(cid:2)(cid:1)(cid:2)(cid:3,,11512.0
,,2,,,Unknown,,cid:15)(cid:2)(cid:17)(cid:2)(cid:18)(cid:1)(cid:18)(cid:19)(cid:18)(cid:18)(cid:2)(cid:1)(cid:2)(cid:3,,11514.0
,,39,,,Unknown,,cid:15)(cid:2)(cid:17)(cid:2)(cid:18)(cid:1)(cid:18)(cid:19)(cid:18)(cid:18)(cid:2)(cid:1)(cid:2)(cid:3,,11553.0
,,4,,,Unknown,,cid:15)(cid:2)(cid:17)(cid:2)(cid:18)(cid:1)(cid:18)(cid:19)(cid:18)(cid:18)(cid:2)(cid:1)(cid:2)(cid:3,,11557.0
,,10,,,Unknown,,cid:15)(cid:2)(cid:17)(cid:2)(cid:18)(cid:1)(cid:18)(cid:19)(cid:18)(cid:18)(cid:2)(cid:1)(cid:2)(cid:3,,11567.0
,,5,,,Unknown,,cid:15)(cid:2)(cid:17)(cid:2)(cid:18)(cid:1)(cid:18)(cid:19)(cid:18)(cid:18)(cid:2)(cid:1)(cid:2)(cid:3,,11572.0
,,52,,,Unknown,,cid:15)(cid:2)(cid:17)(cid:2)(cid:18)(cid:1)(cid:18)(cid:19)(cid:18)(cid:18)(cid:2)(cid:1)(cid:2)(cid:3,,11624.0
,,7,,,Unknown,,cid:15)(cid:2)(cid:17)(cid:2)(cid:18)(cid:1)(cid:18)(cid:19)(cid:18)(cid:18)(cid:2)(cid:1)(cid:2)(cid:3,,11631.0
,,2,,,Unknown,,cid:15)(cid:2)(cid:17)(cid:2)(cid:18)(cid:1)(cid:18)(cid:19)(cid:18)(cid:18)(cid:2)(cid:1)(cid:2)(cid:3,,11633.0
,,9,,,Unknown,,cid:15)(cid:2)(cid:17)(cid:2)(cid:18)(cid:1)(cid:18)(cid:19)(cid:18)(cid:18)(cid:2)(cid:1)(cid:2)(cid:3,,11642.0
,,7,,,Unknown,,cid:15)(cid:2)(cid:17)(cid:2)(cid:18)(cid:1)(cid:18)(cid:19)(cid:18)(cid:18)(cid:2)(cid:1)(cid:2)(cid:3,,11649.0
,,49,,,Unknown,,cid:15)(cid:2)(cid:17)(cid:2)(cid:18)(cid:1)(cid:18)(cid:19)(cid:18)(cid:18)(cid:2)(cid:1)(cid:2)(cid:3,,11698.0
,,2,,,Unknown,,cid:15)(cid:2)(cid:17)(cid:2)(cid:18)(cid:1)(cid:18)(cid:19)(cid:18)(cid:18)(cid:2)(cid:1)(cid:2)(cid:3,,11700.0
,,37,,,Unknown,,cid:15)(cid:2)(cid:17)(cid:2)(cid:18)(cid:1)(cid:18)(cid:19)(cid:18)(cid:18)(cid:2)(cid:1)(cid:2)(cid:3,,11737.0
,,2,,,Unknown,,cid:15)(cid:2)(cid:17)(cid:2)(cid:18)(cid:1)(cid:18)(cid:19)(cid:18)(cid:18)(cid:2)(cid:1)(cid:2)(cid:3,,11739.0
,,9,,,Unknown,,cid:15)(cid:2)(cid:17)(cid:2)(cid:18)(cid:1)(cid:18)(cid:19)(cid:18)(cid:18)(cid:2)(cid:1)(cid:2)(cid:3,,11748.0
,,7,,,Unknown,,cid:15)(cid:2)(cid:17)(cid:2)(cid:18)(cid:1)(cid:18)(cid:19)(cid:18)(cid:18)(cid:2)(cid:1)(cid:2)(cid:3,,11755.0
,,49,,,Unknown,,cid:15)(cid:2)(cid:17)(cid:2)(cid:18)(cid:1)(cid:18)(cid:19)(cid:18)(cid:18)(cid:2)(cid:1)(cid:2)(cid:3,,11804.0
,,2,,,Unknown,,cid:15)(cid:2)(cid:17)(cid:2)(cid:18)(cid:1)(cid:18)(cid:19)(cid:18)(cid:18)(cid:2)(cid:1)(cid:2)(cid:3,,11806.0
,,3,,,Unknown,,cid:15)(cid:2)(cid:17)(cid:2)(cid:18)(cid:1)(cid:18)(cid:19)(cid:18)(cid:18)(cid:2)(cid:1)(cid:2)(cid:3,,11809.0
,,9,,,Unknown,,cid:15)(cid:2)(cid:17)(cid:2)(cid:18)(cid:1)(cid:18)(cid:19)(cid:18)(cid:18)(cid:2)(cid:1)(cid:2)(cid:3,,11818.0
,,15,,,Unknown,,cid:15)(cid:2)(cid:17)(cid:2)(cid:18)(cid:1)(cid:18)(cid:19)(cid:18)(cid:18)(cid:2)(cid:1)(cid:2)(cid:3,,11833.0
,,2,,,Unknown,,cid:15)(cid:2)(cid:17)(cid:2)(cid:18)(cid:1)(cid:18)(cid:19)(cid:18)(cid:18)(cid:2)(cid:1)(cid:2)(cid:3,,11835.0
,,37,,,Unknown,,cid:15)(cid:2)(cid:17)(cid:2)(cid:18)(cid:1)(cid:18)(cid:19)(cid:18)(cid:18)(cid:2)(cid:1)(cid:2)(cid:3,,11872.0
,,19,,,Unknown,,cid:15)(cid:2)(cid:17)(cid:2)(cid:18)(cid:1)(cid:18)(cid:19)(cid:18)(cid:18)(cid:2)(cid:1)(cid:2)(cid:3,,11891.0
,,34,,,Unknown,,cid:15)(cid:2)(cid:17)(cid:2)(cid:18)(cid:1)(cid:18)(cid:19)(cid:18)(cid:18)(cid:2)(cid:1)(cid:2)(cid:3,,11925.0
,,35,,,Unknown,,cid:15)(cid:2)(cid:17)(cid:2)(cid:18)(cid:1)(cid:18)(cid:19)(cid:18)(cid:18)(cid:2)(cid:1)(cid:2)(cid:3,,11960.0
,,2,,,Unknown,,cid:15)(cid:2)(cid:17)(cid:2)(cid:18)(cid:1)(cid:18)(cid:19)(cid:18)(cid:18)(cid:2)(cid:1)(cid:2)(cid:3,,11962.0
,,44,,,Unknown,,cid:15)(cid:2)(cid:17)(cid:2)(cid:18)(cid:1)(cid:18)(cid:19)(cid:18)(cid:18)(cid:2)(cid:1)(cid:2)(cid:3,,12006.0
,,17,,,Unknown,,cid:15)(cid:2)(cid:17)(cid:2)(cid:18)(cid:1)(cid:18)(cid:19)(cid:18)(cid:18)(cid:2)(cid:1)(cid:2)(cid:3,,12023.0
,,17,,,Unknown,,cid:15)(cid:2)(cid:17)(cid:2)(cid:18)(cid:1)(cid:18)(cid:19)(cid:18)(cid:18)(cid:2)(cid:1)(cid:2)(cid:3,,12040.0
,,16,,,Unknown,,cid:15)(cid:2)(cid:17)(cid:2)(cid:18)(cid:1)(cid:18)(cid:19)(cid:18)(cid:18)(cid:2)(cid:1)(cid:2)(cid:3,,12056.0
,,19,,,Unknown,,cid:15)(cid:2)(cid:17)(cid:2)(cid:18)(cid:1)(cid:18)(cid:19)(cid:18)(cid:18)(cid:2)(cid:1)(cid:2)(cid:3,,12075.0
,,37,,,Unknown,,cid:15)(cid:2)(cid:17)(cid:2)(cid:18)(cid:1)(cid:18)(cid:19)(cid:18)(cid:18)(cid:2)(cid:1)(cid:2)(cid:3,,12112.0
,,17,,,Unknown,,cid:15)(cid:2)(cid:17)(cid:2)(cid:18)(cid:1)(cid:18)(cid:19)(cid:18)(cid:18)(cid:2)(cid:1)(cid:2)(cid:3,,12129.0
,,35,,,Unknown,,cid:15)(cid:2)(cid:17)(cid:2)(cid:18)(cid:1)(cid:18)(cid:19)(cid:18)(cid:18)(cid:2)(cid:1)(cid:2)(cid:3,,12164.0
,,36,,,Unknown,,cid:15)(cid:2)(cid:17)(cid:2)(cid:18)(cid:1)(cid:18)(cid:19)(cid:18)(cid:18)(cid:2)(cid:1)(cid:2)(cid:3,,12200.0
,,37,,,Unknown,,cid:15)(cid:2)(cid:17)(cid:2)(cid:18)(cid:1)(cid:18)(cid:19)(cid:18)(cid:18)(cid:2)(cid:1)(cid:2)(cid:3,,12237.0
,,34,,,Unknown,,cid:15)(cid:2)(cid:17)(cid:2)(cid:18)(cid:1)(cid:18)(cid:19)(cid:18)(cid:18)(cid:2)(cid:1)(cid:2)(cid:3,,12271.0
,,16,,,Unknown,,cid:15)(cid:2)(cid:17)(cid:2)(cid:18)(cid:1)(cid:18)(cid:19)(cid:18)(cid:18)(cid:2)(cid:1)(cid:2)(cid:3,,12287.0
,,34,,,Unknown,,cid:15)(cid:2)(cid:17)(cid:2)(cid:18)(cid:1)(cid:18)(cid:19)(cid:18)(cid:18)(cid:2)(cid:1)(cid:2)(cid:3,,12321.0
,,36,,,Unknown,,cid:15)(cid:2)(cid:17)(cid:2)(cid:18)(cid:1)(cid:18)(cid:19)(cid:18)(cid:18)(cid:2)(cid:1)(cid:2)(cid:3,,12357.0
,,17,,,Unknown,,cid:15)(cid:2)(cid:17)(cid:2)(cid:18)(cid:1)(cid:18)(cid:19)(cid:18)(cid:18)(cid:2)(cid:1)(cid:2)(cid:3,,12374.0
,,33,,,Unknown,,cid:15)(cid:2)(cid:17)(cid:2)(cid:18)(cid:1)(cid:18)(cid:19)(cid:18)(cid:18)(cid:2)(cid:1)(cid:2)(cid:3,,12407.0
,,2,,,Unknown,,cid:15)(cid:2)(cid:17)(cid:2)(cid:18)(cid:1)(cid:18)(cid:19)(cid:18)(cid:18)(cid:2)(cid:1)(cid:2)(cid:3,,12409.0
,,1,,,Unknown,,cid:15)(cid:2)(cid:17)(cid:2)(cid:18)(cid:1)(cid:18)(cid:19)(cid:18)(cid:18)(cid:2)(cid:1)(cid:2)(cid:3,,12410.0
,,2,,,Unknown,,cid:15)(cid:2)(cid:17)(cid:2)(cid:18)(cid:1)(cid:18)(cid:19)(cid:18)(cid:18)(cid:2)(cid:1)(cid:2)(cid:3,,12412.0
,,3,,,Unknown,,cid:15)(cid:2)(cid:17)(cid:2)(cid:18)(cid:1)(cid:18)(cid:19)(cid:18)(cid:18)(cid:2)(cid:1)(cid:2)(cid:3,,12415.0
,,2,,,Unknown,,cid:15)(cid:2)(cid:17)(cid:2)(cid:18)(cid:1)(cid:18)(cid:19)(cid:18)(cid:18)(cid:2)(cid:1)(cid:2)(cid:3,,12417.0
,,73,,,Unknown,,cid:15)(cid:2)(cid:17)(cid:2)(cid:18)(cid:1)(cid:18)(cid:19)(cid:18)(cid:18)(cid:2)(cid:1)(cid:2)(cid:3,,12490.0
,,2,,,Unknown,,cid:15)(cid:2)(cid:17)(cid:2)(cid:18)(cid:1)(cid:18)(cid:19)(cid:18)(cid:18)(cid:2)(cid:1)(cid:2)(cid:3,,12492.0
,,17,,,Unknown,,cid:15)(cid:2)(cid:17)(cid:2)(cid:18)(cid:1)(cid:18)(cid:19)(cid:18)(cid:18)(cid:2)(cid:1)(cid:2)(cid:3,,12509.0
,,19,,,Unknown,,cid:15)(cid:2)(cid:17)(cid:2)(cid:18)(cid:1)(cid:18)(cid:19)(cid:18)(cid:18)(cid:2)(cid:1)(cid:2)(cid:3,,12528.0
,,18,,,Unknown,,cid:15)(cid:2)(cid:17)(cid:2)(cid:18)(cid:1)(cid:18)(cid:19)(cid:18)(cid:18)(cid:2)(cid:1)(cid:2)(cid:3,,12546.0
,,18,,,Unknown,,cid:15)(cid:2)(cid:17)(cid:2)(cid:18)(cid:1)(cid:18)(cid:19)(cid:18)(cid:18)(cid:2)(cid:1)(cid:2)(cid:3,,12564.0
,,2,,,Unknown,,cid:15)(cid:2)(cid:17)(cid:2)(cid:18)(cid:1)(cid:18)(cid:19)(cid:18)(cid:18)(cid:2)(cid:1)(cid:2)(cid:3,,12566.0
,,44,,,Unknown,,cid:15)(cid:2)(cid:17)(cid:2)(cid:18)(cid:1)(cid:18)(cid:19)(cid:18)(cid:18)(cid:2)(cid:1)(cid:2)(cid:3,,12610.0
,,15,,,Unknown,,cid:15)(cid:2)(cid:17)(cid:2)(cid:18)(cid:1)(cid:18)(cid:19)(cid:18)(cid:18)(cid:2)(cid:1)(cid:2)(cid:3,,12625.0
,,2,,,Unknown,,cid:15)(cid:2)(cid:17)(cid:2)(cid:18)(cid:1)(cid:18)(cid:19)(cid:18)(cid:18)(cid:2)(cid:1)(cid:2)(cid:3,,12627.0
,,36,,,Unknown,,cid:15)(cid:2)(cid:17)(cid:2)(cid:18)(cid:1)(cid:18)(cid:19)(cid:18)(cid:18)(cid:2)(cid:1)(cid:2)(cid:3,,12663.0
,,1,,,Unknown,,cid:15)(cid:2)(cid:17)(cid:2)(cid:18)(cid:1)(cid:18)(cid:19)(cid:18)(cid:18)(cid:2)(cid:1)(cid:2)(cid:3,,12664.0
,,18,,,Unknown,,cid:15)(cid:2)(cid:17)(cid:2)(cid:18)(cid:1)(cid:18)(cid:19)(cid:18)(cid:18)(cid:2)(cid:1)(cid:2)(cid:3,,12682.0
,,19,,,Unknown,,cid:15)(cid:2)(cid:17)(cid:2)(cid:18)(cid:1)(cid:18)(cid:19)(cid:18)(cid:18)(cid:2)(cid:1)(cid:2)(cid:3,,12701.0
,,18,,,Unknown,,cid:15)(cid:2)(cid:17)(cid:2)(cid:18)(cid:1)(cid:18)(cid:19)(cid:18)(cid:18)(cid:2)(cid:1)(cid:2)(cid:3,,12719.0
,,18,,,Unknown,,cid:15)(cid:2)(cid:17)(cid:2)(cid:18)(cid:1)(cid:18)(cid:19)(cid:18)(cid:18)(cid:2)(cid:1)(cid:2)(cid:3,,12737.0
,,2,,,Unknown,,cid:15)(cid:2)(cid:17)(cid:2)(cid:18)(cid:1)(cid:18)(cid:19)(cid:18)(cid:18)(cid:2)(cid:1)(cid:2)(cid:3,,12739.0
,,1,,,Unknown,,cid:15)(cid:2)(cid:17)(cid:2)(cid:18)(cid:1)(cid:18)(cid:19)(cid:18)(cid:18)(cid:2)(cid:1)(cid:2)(cid:3,,12740.0
,,2,,,Unknown,,cid:15)(cid:2)(cid:17)(cid:2)(cid:18)(cid:1)(cid:18)(cid:19)(cid:18)(cid:18)(cid:2)(cid:1)(cid:2)(cid:3,,12742.0
,,3,,,Unknown,,cid:15)(cid:2)(cid:17)(cid:2)(cid:18)(cid:1)(cid:18)(cid:19)(cid:18)(cid:18)(cid:2)(cid:1)(cid:2)(cid:3,,12745.0
,,12,,,Unknown,,cid:15)(cid:2)(cid:17)(cid:2)(cid:18)(cid:1)(cid:18)(cid:19)(cid:18)(cid:18)(cid:2)(cid:1)(cid:2)(cid:3,,12757.0
,,29,,,Unknown,,cid:15)(cid:2)(cid:17)(cid:2)(cid:18)(cid:1)(cid:18)(cid:19)(cid:18)(cid:18)(cid:2)(cid:1)(cid:2)(cid:3,,12786.0
,,26,,,Unknown,,cid:15)(cid:2)(cid:17)(cid:2)(cid:18)(cid:1)(cid:18)(cid:19)(cid:18)(cid:18)(cid:2)(cid:1)(cid:2)(cid:3,,12812.0
,,41,,,Unknown,,cid:15)(cid:2)(cid:17)(cid:2)(cid:18)(cid:1)(cid:18)(cid:19)(cid:18)(cid:18)(cid:2)(cid:1)(cid:2)(cid:3,,12853.0
,,25,,,Unknown,,cid:15)(cid:2)(cid:17)(cid:2)(cid:18)(cid:1)(cid:18)(cid:19)(cid:18)(cid:18)(cid:2)(cid:1)(cid:2)(cid:3,,12878.0
,,2,,,Unknown,,cid:15)(cid:2)(cid:17)(cid:2)(cid:18)(cid:1)(cid:18)(cid:19)(cid:18)(cid:18)(cid:2)(cid:1)(cid:2)(cid:3,,12880.0
,,50,,,Unknown,,cid:15)(cid:2)(cid:17)(cid:2)(cid:18)(cid:1)(cid:18)(cid:19)(cid:18)(cid:18)(cid:2)(cid:1)(cid:2)(cid:3,,12930.0
,,50,,,Unknown,,cid:15)(cid:2)(cid:17)(cid:2)(cid:18)(cid:1)(cid:18)(cid:19)(cid:18)(cid:18)(cid:2)(cid:1)(cid:2)(cid:3,,12980.0
,,18,,,Unknown,,cid:15)(cid:2)(cid:17)(cid:2)(cid:18)(cid:1)(cid:18)(cid:19)(cid:18)(cid:18)(cid:2)(cid:1)(cid:2)(cid:3,,12998.0
,,1,,,Unknown,,cid:15)(cid:2)(cid:17)(cid:2)(cid:18)(cid:1)(cid:18)(cid:19)(cid:18)(cid:18)(cid:2)(cid:1)(cid:2)(cid:3,,12999.0
,,1,,,Unknown,,cid:15)(cid:2)(cid:17)(cid:2)(cid:18)(cid:1)(cid:18)(cid:19)(cid:18)(cid:18)(cid:2)(cid:1)(cid:2)(cid:3,,13000.0
,,37,,,Unknown,,cid:15)(cid:2)(cid:17)(cid:2)(cid:18)(cid:1)(cid:18)(cid:19)(cid:18)(cid:18)(cid:2)(cid:1)(cid:2)(cid:3,,13037.0
,,37,,,Unknown,,cid:15)(cid:2)(cid:17)(cid:2)(cid:18)(cid:1)(cid:18)(cid:19)(cid:18)(cid:18)(cid:2)(cid:1)(cid:2)(cid:3,,13074.0
,,17,,,Unknown,,cid:15)(cid:2)(cid:17)(cid:2)(cid:18)(cid:1)(cid:18)(cid:19)(cid:18)(cid:18)(cid:2)(cid:1)(cid:2)(cid:3,,13091.0
,,45,,,Unknown,,cid:15)(cid:2)(cid:17)(cid:2)(cid:18)(cid:1)(cid:18)(cid:19)(cid:18)(cid:18)(cid:2)(cid:1)(cid:2)(cid:3,,13136.0
,,18,,,Unknown,,cid:15)(cid:2)(cid:17)(cid:2)(cid:18)(cid:1)(cid:18)(cid:19)(cid:18)(cid:18)(cid:2)(cid:1)(cid:2)(cid:3,,13154.0
,,35,,,Unknown,,cid:15)(cid:2)(cid:17)(cid:2)(cid:18)(cid:1)(cid:18)(cid:19)(cid:18)(cid:18)(cid:2)(cid:1)(cid:2)(cid:3,,13189.0
,,11,,,Unknown,,cid:15)(cid:2)(cid:17)(cid:2)(cid:18)(cid:1)(cid:18)(cid:19)(cid:18)(cid:18)(cid:2)(cid:1)(cid:2)(cid:3,,13200.0
,,3,,,Unknown,,cid:15)(cid:2)(cid:17)(cid:2)(cid:18)(cid:1)(cid:18)(cid:19)(cid:18)(cid:18)(cid:2)(cid:1)(cid:2)(cid:3,,13203.0
,,46,,,Unknown,,cid:15)(cid:2)(cid:17)(cid:2)(cid:18)(cid:1)(cid:18)(cid:19)(cid:18)(cid:18)(cid:2)(cid:1)(cid:2)(cid:3,,13249.0
,,8,,,Unknown,,cid:15)(cid:2)(cid:17)(cid:2)(cid:18)(cid:1)(cid:18)(cid:19)(cid:18)(cid:18)(cid:2)(cid:1)(cid:2)(cid:3,,13257.0
,,53,,,Unknown,,cid:15)(cid:2)(cid:17)(cid:2)(cid:18)(cid:1)(cid:18)(cid:19)(cid:18)(cid:18)(cid:2)(cid:1)(cid:2)(cid:3,,13310.0
,,5,,,Unknown,,cid:15)(cid:2)(cid:17)(cid:2)(cid:18)(cid:1)(cid:18)(cid:19)(cid:18)(cid:18)(cid:2)(cid:1)(cid:2)(cid:3,,13315.0
,,2,,,Unknown,,cid:15)(cid:2)(cid:17)(cid:2)(cid:18)(cid:1)(cid:18)(cid:19)(cid:18)(cid:18)(cid:2)(cid:1)(cid:2)(cid:3,,13317.0
,,28,,,Unknown,,cid:15)(cid:2)(cid:17)(cid:2)(cid:18)(cid:1)(cid:18)(cid:19)(cid:18)(cid:18)(cid:2)(cid:1)(cid:2)(cid:3,,13345.0
,,46,,,Unknown,,cid:15)(cid:2)(cid:17)(cid:2)(cid:18)(cid:1)(cid:18)(cid:19)(cid:18)(cid:18)(cid:2)(cid:1)(cid:2)(cid:3,,13391.0
,,12,,,Unknown,,cid:15)(cid:2)(cid:17)(cid:2)(cid:18)(cid:1)(cid:18)(cid:19)(cid:18)(cid:18)(cid:2)(cid:1)(cid:2)(cid:3,,13403.0
,,10,,,Unknown,,cid:15)(cid:2)(cid:17)(cid:2)(cid:18)(cid:1)(cid:18)(cid:19)(cid:18)(cid:18)(cid:2)(cid:1)(cid:2)(cid:3,,13413.0
,,2,,,Unknown,,cid:15)(cid:2)(cid:17)(cid:2)(cid:18)(cid:1)(cid:18)(cid:19)(cid:18)(cid:18)(cid:2)(cid:1)(cid:2)(cid:3,,13415.0
,,16,,,Unknown,,cid:15)(cid:2)(cid:17)(cid:2)(cid:18)(cid:1)(cid:18)(cid:19)(cid:18)(cid:18)(cid:2)(cid:1)(cid:2)(cid:3,,13431.0
,,36,,,Unknown,,cid:15)(cid:2)(cid:17)(cid:2)(cid:18)(cid:1)(cid:18)(cid:19)(cid:18)(cid:18)(cid:2)(cid:1)(cid:2)(cid:3,,13467.0
,,2,,,Unknown,,cid:15)(cid:2)(cid:17)(cid:2)(cid:18)(cid:1)(cid:18)(cid:19)(cid:18)(cid:18)(cid:2)(cid:1)(cid:2)(cid:3,,13469.0
,,39,,,Unknown,,cid:15)(cid:2)(cid:17)(cid:2)(cid:18)(cid:1)(cid:18)(cid:19)(cid:18)(cid:18)(cid:2)(cid:1)(cid:2)(cid:3,,13508.0
,,46,,,Unknown,,cid:15)(cid:2)(cid:17)(cid:2)(cid:18)(cid:1)(cid:18)(cid:19)(cid:18)(cid:18)(cid:2)(cid:1)(cid:2)(cid:3,,13554.0
,,3,,,Unknown,,cid:15)(cid:2)(cid:17)(cid:2)(cid:18)(cid:1)(cid:18)(cid:19)(cid:18)(cid:18)(cid:2)(cid:1)(cid:2)(cid:3,,13557.0
,,7,,,Unknown,,cid:15)(cid:2)(cid:17)(cid:2)(cid:18)(cid:1)(cid:18)(cid:19)(cid:18)(cid:18)(cid:2)(cid:1)(cid:2)(cid:3,,13564.0
,,9,,,Unknown,,cid:15)(cid:2)(cid:17)(cid:2)(cid:18)(cid:1)(cid:18)(cid:19)(cid:18)(cid:18)(cid:2)(cid:1)(cid:2)(cid:3,,13573.0
,,2,,,Unknown,,cid:15)(cid:2)(cid:17)(cid:2)(cid:18)(cid:1)(cid:18)(cid:19)(cid:18)(cid:18)(cid:2)(cid:1)(cid:2)(cid:3,,13575.0
,,28,,,Unknown,,cid:15)(cid:2)(cid:17)(cid:2)(cid:18)(cid:1)(cid:18)(cid:19)(cid:18)(cid:18)(cid:2)(cid:1)(cid:2)(cid:3,,13603.0
,,3,,,Unknown,,cid:15)(cid:2)(cid:17)(cid:2)(cid:18)(cid:1)(cid:18)(cid:19)(cid:18)(cid:18)(cid:2)(cid:1)(cid:2)(cid:3,,13606.0
,,15,,,Unknown,,cid:15)(cid:2)(cid:17)(cid:2)(cid:18)(cid:1)(cid:18)(cid:19)(cid:18)(cid:18)(cid:2)(cid:1)(cid:2)(cid:3,,13621.0
,,2,,,Unknown,,cid:15)(cid:2)(cid:17)(cid:2)(cid:18)(cid:1)(cid:18)(cid:19)(cid:18)(cid:18)(cid:2)(cid:1)(cid:2)(cid:3,,13623.0
,,32,,,Unknown,,cid:15)(cid:2)(cid:17)(cid:2)(cid:18)(cid:1)(cid:18)(cid:19)(cid:18)(cid:18)(cid:2)(cid:1)(cid:2)(cid:3,,13655.0
,,36,,,Unknown,,cid:15)(cid:2)(cid:17)(cid:2)(cid:18)(cid:1)(cid:18)(cid:19)(cid:18)(cid:18)(cid:2)(cid:1)(cid:2)(cid:3,,13691.0
,,19,,,Unknown,,cid:15)(cid:2)(cid:17)(cid:2)(cid:18)(cid:1)(cid:18)(cid:19)(cid:18)(cid:18)(cid:2)(cid:1)(cid:2)(cid:3,,13710.0
,,33,,,Unknown,,cid:15)(cid:2)(cid:17)(cid:2)(cid:18)(cid:1)(cid:18)(cid:19)(cid:18)(cid:18)(cid:2)(cid:1)(cid:2)(cid:3,,13743.0
,,33,,,Unknown,,cid:15)(cid:2)(cid:17)(cid:2)(cid:18)(cid:1)(cid:18)(cid:19)(cid:18)(cid:18)(cid:2)(cid:1)(cid:2)(cid:3,,13776.0
,,2,,,Unknown,,cid:15)(cid:2)(cid:17)(cid:2)(cid:18)(cid:1)(cid:18)(cid:19)(cid:18)(cid:18)(cid:2)(cid:1)(cid:2)(cid:3,,13778.0
,,44,,,Unknown,,cid:15)(cid:2)(cid:17)(cid:2)(cid:18)(cid:1)(cid:18)(cid:19)(cid:18)(cid:18)(cid:2)(cid:1)(cid:2)(cid:3,,13822.0
,,12,,,Unknown,,cid:15)(cid:2)(cid:17)(cid:2)(cid:18)(cid:1)(cid:18)(cid:19)(cid:18)(cid:18)(cid:2)(cid:1)(cid:2)(cid:3,,13834.0
,,29,,,Unknown,,cid:15)(cid:2)(cid:17)(cid:2)(cid:18)(cid:1)(cid:18)(cid:19)(cid:18)(cid:18)(cid:2)(cid:1)(cid:2)(cid:3,,13863.0
,,26,,,Unknown,,cid:15)(cid:2)(cid:17)(cid:2)(cid:18)(cid:1)(cid:18)(cid:19)(cid:18)(cid:18)(cid:2)(cid:1)(cid:2)(cid:3,,13889.0
,,41,,,Unknown,,cid:15)(cid:2)(cid:17)(cid:2)(cid:18)(cid:1)(cid:18)(cid:19)(cid:18)(cid:18)(cid:2)(cid:1)(cid:2)(cid:3,,13930.0
,,25,,,Unknown,,cid:15)(cid:2)(cid:17)(cid:2)(cid:18)(cid:1)(cid:18)(cid:19)(cid:18)(cid:18)(cid:2)(cid:1)(cid:2)(cid:3,,13955.0
,,2,,,Unknown,,cid:15)(cid:2)(cid:17)(cid:2)(cid:18)(cid:1)(cid:18)(cid:19)(cid:18)(cid:18)(cid:2)(cid:1)(cid:2)(cid:3,,13957.0
,,50,,,Unknown,,cid:15)(cid:2)(cid:17)(cid:2)(cid:18)(cid:1)(cid:18)(cid:19)(cid:18)(cid:18)(cid:2)(cid:1)(cid:2)(cid:3,,14007.0
,,50,,,Unknown,,cid:15)(cid:2)(cid:17)(cid:2)(cid:18)(cid:1)(cid:18)(cid:19)(cid:18)(cid:18)(cid:2)(cid:1)(cid:2)(cid:3,,14057.0
,,37,,,Unknown,,cid:15)(cid:2)(cid:17)(cid:2)(cid:18)(cid:1)(cid:18)(cid:19)(cid:18)(cid:18)(cid:2)(cid:1)(cid:2)(cid:3,,14094.0
,,16,,,Unknown,,cid:15)(cid:2)(cid:17)(cid:2)(cid:18)(cid:1)(cid:18)(cid:19)(cid:18)(cid:18)(cid:2)(cid:1)(cid:2)(cid:3,,14110.0
,,34,,,Unknown,,cid:15)(cid:2)(cid:17)(cid:2)(cid:18)(cid:1)(cid:18)(cid:19)(cid:18)(cid:18)(cid:2)(cid:1)(cid:2)(cid:3,,14144.0
,,33,,,Unknown,,cid:15)(cid:2)(cid:17)(cid:2)(cid:18)(cid:1)(cid:18)(cid:19)(cid:18)(cid:18)(cid:2)(cid:1)(cid:2)(cid:3,,14177.0
,,37,,,Unknown,,cid:15)(cid:2)(cid:17)(cid:2)(cid:18)(cid:1)(cid:18)(cid:19)(cid:18)(cid:18)(cid:2)(cid:1)(cid:2)(cid:3,,14214.0
,,17,,,Unknown,,cid:15)(cid:2)(cid:17)(cid:2)(cid:18)(cid:1)(cid:18)(cid:19)(cid:18)(cid:18)(cid:2)(cid:1)(cid:2)(cid:3,,14231.0
,,45,,,Unknown,,cid:15)(cid:2)(cid:17)(cid:2)(cid:18)(cid:1)(cid:18)(cid:19)(cid:18)(cid:18)(cid:2)(cid:1)(cid:2)(cid:3,,14276.0
,,18,,,Unknown,,cid:15)(cid:2)(cid:17)(cid:2)(cid:18)(cid:1)(cid:18)(cid:19)(cid:18)(cid:18)(cid:2)(cid:1)(cid:2)(cid:3,,14294.0
,,35,,,Unknown,,cid:15)(cid:2)(cid:17)(cid:2)(cid:18)(cid:1)(cid:18)(cid:19)(cid:18)(cid:18)(cid:2)(cid:1)(cid:2)(cid:3,,14329.0
,,5,,,Unknown,,cid:15)(cid:2)(cid:17)(cid:2)(cid:18)(cid:1)(cid:18)(cid:19)(cid:18)(cid:18)(cid:2)(cid:1)(cid:2)(cid:3,,14334.0
,,14,,,Unknown,,cid:15)(cid:2)(cid:17)(cid:2)(cid:18)(cid:1)(cid:18)(cid:19)(cid:18)(cid:18)(cid:2)(cid:1)(cid:2)(cid:3,,14348.0
,,5,,,Unknown,,cid:15)(cid:2)(cid:17)(cid:2)(cid:18)(cid:1)(cid:18)(cid:19)(cid:18)(cid:18)(cid:2)(cid:1)(cid:2)(cid:3,,14353.0
,,39,,,Unknown,,cid:15)(cid:2)(cid:17)(cid:2)(cid:18)(cid:1)(cid:18)(cid:19)(cid:18)(cid:18)(cid:2)(cid:1)(cid:2)(cid:3,,14392.0
,,13,,,Unknown,,cid:15)(cid:2)(cid:17)(cid:2)(cid:18)(cid:1)(cid:18)(cid:19)(cid:18)(cid:18)(cid:2)(cid:1)(cid:2)(cid:3,,14405.0
,,46,,,Unknown,,cid:15)(cid:2)(cid:17)(cid:2)(cid:18)(cid:1)(cid:18)(cid:19)(cid:18)(cid:18)(cid:2)(cid:1)(cid:2)(cid:3,,14451.0
,,8,,,Unknown,,cid:15)(cid:2)(cid:17)(cid:2)(cid:18)(cid:1)(cid:18)(cid:19)(cid:18)(cid:18)(cid:2)(cid:1)(cid:2)(cid:3,,14459.0
,,10,,,Unknown,,cid:15)(cid:2)(cid:17)(cid:2)(cid:18)(cid:1)(cid:18)(cid:19)(cid:18)(cid:18)(cid:2)(cid:1)(cid:2)(cid:3,,14469.0
,,2,,,Unknown,,cid:15)(cid:2)(cid:17)(cid:2)(cid:18)(cid:1)(cid:18)(cid:19)(cid:18)(cid:18)(cid:2)(cid:1)(cid:2)(cid:3,,14471.0
,,51,,,Unknown,,cid:15)(cid:2)(cid:17)(cid:2)(cid:18)(cid:1)(cid:18)(cid:19)(cid:18)(cid:18)(cid:2)(cid:1)(cid:2)(cid:3,,14522.0
,,14,,,Unknown,,cid:15)(cid:2)(cid:17)(cid:2)(cid:18)(cid:1)(cid:18)(cid:19)(cid:18)(cid:18)(cid:2)(cid:1)(cid:2)(cid:3,,14536.0
,,5,,,Unknown,,cid:15)(cid:2)(cid:17)(cid:2)(cid:18)(cid:1)(cid:18)(cid:19)(cid:18)(cid:18)(cid:2)(cid:1)(cid:2)(cid:3,,14541.0
,,4,,,Unknown,,cid:15)(cid:2)(cid:17)(cid:2)(cid:18)(cid:1)(cid:18)(cid:19)(cid:18)(cid:18)(cid:2)(cid:1)(cid:2)(cid:3,,14545.0
,,2,,,Unknown,,cid:15)(cid:2)(cid:17)(cid:2)(cid:18)(cid:1)(cid:18)(cid:19)(cid:18)(cid:18)(cid:2)(cid:1)(cid:2)(cid:3,,14547.0
,,12,,,Unknown,,cid:15)(cid:2)(cid:17)(cid:2)(cid:18)(cid:1)(cid:18)(cid:19)(cid:18)(cid:18)(cid:2)(cid:1)(cid:2)(cid:3,,14559.0
,,11,,,Unknown,,cid:15)(cid:2)(cid:17)(cid:2)(cid:18)(cid:1)(cid:18)(cid:19)(cid:18)(cid:18)(cid:2)(cid:1)(cid:2)(cid:3,,14570.0
,,4,,,Unknown,,cid:15)(cid:2)(cid:17)(cid:2)(cid:18)(cid:1)(cid:18)(cid:19)(cid:18)(cid:18)(cid:2)(cid:1)(cid:2)(cid:3,,14574.0
,,14,,,Unknown,,cid:15)(cid:2)(cid:17)(cid:2)(cid:18)(cid:1)(cid:18)(cid:19)(cid:18)(cid:18)(cid:2)(cid:1)(cid:2)(cid:3,,14588.0
,,11,,,Unknown,,cid:15)(cid:2)(cid:17)(cid:2)(cid:18)(cid:1)(cid:18)(cid:19)(cid:18)(cid:18)(cid:2)(cid:1)(cid:2)(cid:3,,14599.0
,,54,,,Unknown,,cid:15)(cid:2)(cid:17)(cid:2)(cid:18)(cid:1)(cid:18)(cid:19)(cid:18)(cid:18)(cid:2)(cid:1)(cid:2)(cid:3,,14653.0
,,54,,,Unknown,,cid:15)(cid:2)(cid:17)(cid:2)(cid:18)(cid:1)(cid:18)(cid:19)(cid:18)(cid:18)(cid:2)(cid:1)(cid:2)(cid:3,,14707.0
,,7,,,Unknown,,cid:15)(cid:2)(cid:17)(cid:2)(cid:18)(cid:1)(cid:18)(cid:19)(cid:18)(cid:18)(cid:2)(cid:1)(cid:2)(cid:3,,14714.0
,,5,,,Unknown,,cid:15)(cid:2)(cid:17)(cid:2)(cid:18)(cid:1)(cid:18)(cid:19)(cid:18)(cid:18)(cid:2)(cid:1)(cid:2)(cid:3,,14719.0
,,3,,,Unknown,,cid:15)(cid:2)(cid:17)(cid:2)(cid:18)(cid:1)(cid:18)(cid:19)(cid:18)(cid:18)(cid:2)(cid:1)(cid:2)(cid:3,,14722.0
,,2,,,Unknown,,cid:15)(cid:2)(cid:17)(cid:2)(cid:18)(cid:1)(cid:18)(cid:19)(cid:18)(cid:18)(cid:2)(cid:1)(cid:2)(cid:3,,14724.0
,,28,,,Unknown,,cid:15)(cid:2)(cid:17)(cid:2)(cid:18)(cid:1)(cid:18)(cid:19)(cid:18)(cid:18)(cid:2)(cid:1)(cid:2)(cid:3,,14752.0
,,3,,,Unknown,,cid:15)(cid:2)(cid:17)(cid:2)(cid:18)(cid:1)(cid:18)(cid:19)(cid:18)(cid:18)(cid:2)(cid:1)(cid:2)(cid:3,,14755.0
,,15,,,Unknown,,cid:15)(cid:2)(cid:17)(cid:2)(cid:18)(cid:1)(cid:18)(cid:19)(cid:18)(cid:18)(cid:2)(cid:1)(cid:2)(cid:3,,14770.0
,,2,,,Unknown,,cid:15)(cid:2)(cid:17)(cid:2)(cid:18)(cid:1)(cid:18)(cid:19)(cid:18)(cid:18)(cid:2)(cid:1)(cid:2)(cid:3,,14772.0
,,17,,,Unknown,,cid:15)(cid:2)(cid:17)(cid:2)(cid:18)(cid:1)(cid:18)(cid:19)(cid:18)(cid:18)(cid:2)(cid:1)(cid:2)(cid:3,,14789.0
,,32,,,Unknown,,cid:15)(cid:2)(cid:17)(cid:2)(cid:18)(cid:1)(cid:18)(cid:19)(cid:18)(cid:18)(cid:2)(cid:1)(cid:2)(cid:3,,14821.0
,,19,,,Unknown,,cid:15)(cid:2)(cid:17)(cid:2)(cid:18)(cid:1)(cid:18)(cid:19)(cid:18)(cid:18)(cid:2)(cid:1)(cid:2)(cid:3,,14840.0
,,18,,,Unknown,,cid:15)(cid:2)(cid:17)(cid:2)(cid:18)(cid:1)(cid:18)(cid:19)(cid:18)(cid:18)(cid:2)(cid:1)(cid:2)(cid:3,,14858.0
,,18,,,Unknown,,cid:15)(cid:2)(cid:17)(cid:2)(cid:18)(cid:1)(cid:18)(cid:19)(cid:18)(cid:18)(cid:2)(cid:1)(cid:2)(cid:3,,14876.0
,,2,,,Unknown,,cid:15)(cid:2)(cid:17)(cid:2)(cid:18)(cid:1)(cid:18)(cid:19)(cid:18)(cid:18)(cid:2)(cid:1)(cid:2)(cid:3,,14878.0
,,44,,,Unknown,,cid:15)(cid:2)(cid:17)(cid:2)(cid:18)(cid:1)(cid:18)(cid:19)(cid:18)(cid:18)(cid:2)(cid:1)(cid:2)(cid:3,,14922.0
,,12,,,Unknown,,cid:15)(cid:2)(cid:17)(cid:2)(cid:18)(cid:1)(cid:18)(cid:19)(cid:18)(cid:18)(cid:2)(cid:1)(cid:2)(cid:3,,14934.0
,,29,,,Unknown,,cid:15)(cid:2)(cid:17)(cid:2)(cid:18)(cid:1)(cid:18)(cid:19)(cid:18)(cid:18)(cid:2)(cid:1)(cid:2)(cid:3,,14963.0
,,26,,,Unknown,,cid:15)(cid:2)(cid:17)(cid:2)(cid:18)(cid:1)(cid:18)(cid:19)(cid:18)(cid:18)(cid:2)(cid:1)(cid:2)(cid:3,,14989.0
,,41,,,Unknown,,cid:15)(cid:2)(cid:17)(cid:2)(cid:18)(cid:1)(cid:18)(cid:19)(cid:18)(cid:18)(cid:2)(cid:1)(cid:2)(cid:3,,15030.0
,,25,,,Unknown,,cid:15)(cid:2)(cid:17)(cid:2)(cid:18)(cid:1)(cid:18)(cid:19)(cid:18)(cid:18)(cid:2)(cid:1)(cid:2)(cid:3,,15055.0
,,2,,,Unknown,,cid:15)(cid:2)(cid:17)(cid:2)(cid:18)(cid:1)(cid:18)(cid:19)(cid:18)(cid:18)(cid:2)(cid:1)(cid:2)(cid:3,,15057.0
,,50,,,Unknown,,cid:15)(cid:2)(cid:17)(cid:2)(cid:18)(cid:1)(cid:18)(cid:19)(cid:18)(cid:18)(cid:2)(cid:1)(cid:2)(cid:3,,15107.0
,,50,,,Unknown,,cid:15)(cid:2)(cid:17)(cid:2)(cid:18)(cid:1)(cid:18)(cid:19)(cid:18)(cid:18)(cid:2)(cid:1)(cid:2)(cid:3,,15157.0
,,18,,,Unknown,,cid:15)(cid:2)(cid:17)(cid:2)(cid:18)(cid:1)(cid:18)(cid:19)(cid:18)(cid:18)(cid:2)(cid:1)(cid:2)(cid:3,,15175.0
,,1,,,Unknown,,cid:15)(cid:2)(cid:17)(cid:2)(cid:18)(cid:1)(cid:18)(cid:19)(cid:18)(cid:18)(cid:2)(cid:1)(cid:2)(cid:3,,15176.0
,,1,,,Unknown,,cid:15)(cid:2)(cid:17)(cid:2)(cid:18)(cid:1)(cid:18)(cid:19)(cid:18)(cid:18)(cid:2)(cid:1)(cid:2)(cid:3,,15177.0
,,37,,,Unknown,,cid:15)(cid:2)(cid:17)(cid:2)(cid:18)(cid:1)(cid:18)(cid:19)(cid:18)(cid:18)(cid:2)(cid:1)(cid:2)(cid:3,,15214.0
,,37,,,Unknown,,cid:15)(cid:2)(cid:17)(cid:2)(cid:18)(cid:1)(cid:18)(cid:19)(cid:18)(cid:18)(cid:2)(cid:1)(cid:2)(cid:3,,15251.0
,,17,,,Unknown,,cid:15)(cid:2)(cid:17)(cid:2)(cid:18)(cid:1)(cid:18)(cid:19)(cid:18)(cid:18)(cid:2)(cid:1)(cid:2)(cid:3,,15268.0
,,45,,,Unknown,,cid:15)(cid:2)(cid:17)(cid:2)(cid:18)(cid:1)(cid:18)(cid:19)(cid:18)(cid:18)(cid:2)(cid:1)(cid:2)(cid:3,,15313.0
,,18,,,Unknown,,cid:15)(cid:2)(cid:17)(cid:2)(cid:18)(cid:1)(cid:18)(cid:19)(cid:18)(cid:18)(cid:2)(cid:1)(cid:2)(cid:3,,15331.0
,,35,,,Unknown,,cid:15)(cid:2)(cid:17)(cid:2)(cid:18)(cid:1)(cid:18)(cid:19)(cid:18)(cid:18)(cid:2)(cid:1)(cid:2)(cid:3,,15366.0
,,9,,,Unknown,,cid:15)(cid:2)(cid:17)(cid:2)(cid:18)(cid:1)(cid:18)(cid:19)(cid:18)(cid:18)(cid:2)(cid:1)(cid:2)(cid:3,,15375.0
,,46,,,Unknown,,cid:15)(cid:2)(cid:17)(cid:2)(cid:18)(cid:1)(cid:18)(cid:19)(cid:18)(cid:18)(cid:2)(cid:1)(cid:2)(cid:3,,15421.0
,,8,,,Unknown,,cid:15)(cid:2)(cid:17)(cid:2)(cid:18)(cid:1)(cid:18)(cid:19)(cid:18)(cid:18)(cid:2)(cid:1)(cid:2)(cid:3,,15429.0
,,5,,,Unknown,,cid:15)(cid:2)(cid:17)(cid:2)(cid:18)(cid:1)(cid:18)(cid:19)(cid:18)(cid:18)(cid:2)(cid:1)(cid:2)(cid:3,,15434.0
,,28,,,Unknown,,cid:15)(cid:2)(cid:17)(cid:2)(cid:18)(cid:1)(cid:18)(cid:19)(cid:18)(cid:18)(cid:2)(cid:1)(cid:2)(cid:3,,15462.0
,,2,,,Unknown,,cid:15)(cid:2)(cid:17)(cid:2)(cid:18)(cid:1)(cid:18)(cid:19)(cid:18)(cid:18)(cid:2)(cid:1)(cid:2)(cid:3,,15464.0
,,9,,,Unknown,,cid:15)(cid:2)(cid:17)(cid:2)(cid:18)(cid:1)(cid:18)(cid:19)(cid:18)(cid:18)(cid:2)(cid:1)(cid:2)(cid:3,,15473.0
,,5,,,Unknown,,cid:15)(cid:2)(cid:17)(cid:2)(cid:18)(cid:1)(cid:18)(cid:19)(cid:18)(cid:18)(cid:2)(cid:1)(cid:2)(cid:3,,15478.0
,,8,,,Unknown,,cid:15)(cid:2)(cid:17)(cid:2)(cid:18)(cid:1)(cid:18)(cid:19)(cid:18)(cid:18)(cid:2)(cid:1)(cid:2)(cid:3,,15486.0
,,14,,,Unknown,,cid:15)(cid:2)(cid:17)(cid:2)(cid:18)(cid:1)(cid:18)(cid:19)(cid:18)(cid:18)(cid:2)(cid:1)(cid:2)(cid:3,,15500.0
,,7,,,Unknown,,cid:15)(cid:2)(cid:17)(cid:2)(cid:18)(cid:1)(cid:18)(cid:19)(cid:18)(cid:18)(cid:2)(cid:1)(cid:2)(cid:3,,15507.0
,,9,,,Unknown,,cid:15)(cid:2)(cid:17)(cid:2)(cid:18)(cid:1)(cid:18)(cid:19)(cid:18)(cid:18)(cid:2)(cid:1)(cid:2)(cid:3,,15516.0
,,2,,,Unknown,,cid:15)(cid:2)(cid:17)(cid:2)(cid:18)(cid:1)(cid:18)(cid:19)(cid:18)(cid:18)(cid:2)(cid:1)(cid:2)(cid:3,,15518.0
,,28,,,Unknown,,cid:15)(cid:2)(cid:17)(cid:2)(cid:18)(cid:1)(cid:18)(cid:19)(cid:18)(cid:18)(cid:2)(cid:1)(cid:2)(cid:3,,15546.0
,,3,,,Unknown,,cid:15)(cid:2)(cid:17)(cid:2)(cid:18)(cid:1)(cid:18)(cid:19)(cid:18)(cid:18)(cid:2)(cid:1)(cid:2)(cid:3,,15549.0
,,15,,,Unknown,,cid:15)(cid:2)(cid:17)(cid:2)(cid:18)(cid:1)(cid:18)(cid:19)(cid:18)(cid:18)(cid:2)(cid:1)(cid:2)(cid:3,,15564.0
,,2,,,Unknown,,cid:15)(cid:2)(cid:17)(cid:2)(cid:18)(cid:1)(cid:18)(cid:19)(cid:18)(cid:18)(cid:2)(cid:1)(cid:2)(cid:3,,15566.0
,,1,,,Unknown,,cid:15)(cid:2)(cid:17)(cid:2)(cid:18)(cid:1)(cid:18)(cid:19)(cid:18)(cid:18)(cid:2)(cid:1)(cid:2)(cid:3,,15567.0
,,1,,,Unknown,,cid:15)(cid:2)(cid:17)(cid:2)(cid:18)(cid:1)(cid:18)(cid:19)(cid:18)(cid:18)(cid:2)(cid:1)(cid:2)(cid:3,,15568.0
,,19,,,Unknown,,cid:15)(cid:2)(cid:17)(cid:2)(cid:18)(cid:1)(cid:18)(cid:19)(cid:18)(cid:18)(cid:2)(cid:1)(cid:2)(cid:3,,15587.0
,,34,,,Unknown,,cid:15)(cid:2)(cid:17)(cid:2)(cid:18)(cid:1)(cid:18)(cid:19)(cid:18)(cid:18)(cid:2)(cid:1)(cid:2)(cid:3,,15621.0
,,18,,,Unknown,,cid:15)(cid:2)(cid:17)(cid:2)(cid:18)(cid:1)(cid:18)(cid:19)(cid:18)(cid:18)(cid:2)(cid:1)(cid:2)(cid:3,,15639.0
,,2,,,Unknown,,cid:15)(cid:2)(cid:17)(cid:2)(cid:18)(cid:1)(cid:18)(cid:19)(cid:18)(cid:18)(cid:2)(cid:1)(cid:2)(cid:3,,15641.0
,,44,,,Unknown,,cid:15)(cid:2)(cid:17)(cid:2)(cid:18)(cid:1)(cid:18)(cid:19)(cid:18)(cid:18)(cid:2)(cid:1)(cid:2)(cid:3,,15685.0
,,12,,,Unknown,,cid:15)(cid:2)(cid:17)(cid:2)(cid:18)(cid:1)(cid:18)(cid:19)(cid:18)(cid:18)(cid:2)(cid:1)(cid:2)(cid:3,,15697.0
,,29,,,Unknown,,cid:15)(cid:2)(cid:17)(cid:2)(cid:18)(cid:1)(cid:18)(cid:19)(cid:18)(cid:18)(cid:2)(cid:1)(cid:2)(cid:3,,15726.0
,,26,,,Unknown,,cid:15)(cid:2)(cid:17)(cid:2)(cid:18)(cid:1)(cid:18)(cid:19)(cid:18)(cid:18)(cid:2)(cid:1)(cid:2)(cid:3,,15752.0
,,41,,,Unknown,,cid:15)(cid:2)(cid:17)(cid:2)(cid:18)(cid:1)(cid:18)(cid:19)(cid:18)(cid:18)(cid:2)(cid:1)(cid:2)(cid:3,,15793.0
,,25,,,Unknown,,cid:15)(cid:2)(cid:17)(cid:2)(cid:18)(cid:1)(cid:18)(cid:19)(cid:18)(cid:18)(cid:2)(cid:1)(cid:2)(cid:3,,15818.0
,,2,,,Unknown,,cid:15)(cid:2)(cid:17)(cid:2)(cid:18)(cid:1)(cid:18)(cid:19)(cid:18)(cid:18)(cid:2)(cid:1)(cid:2)(cid:3,,15820.0
,,50,,,Unknown,,cid:15)(cid:2)(cid:17)(cid:2)(cid:18)(cid:1)(cid:18)(cid:19)(cid:18)(cid:18)(cid:2)(cid:1)(cid:2)(cid:3,,15870.0
,,50,,,Unknown,,cid:15)(cid:2)(cid:17)(cid:2)(cid:18)(cid:1)(cid:18)(cid:19)(cid:18)(cid:18)(cid:2)(cid:1)(cid:2)(cid:3,,15920.0
,,37,,,Unknown,,cid:15)(cid:2)(cid:17)(cid:2)(cid:18)(cid:1)(cid:18)(cid:19)(cid:18)(cid:18)(cid:2)(cid:1)(cid:2)(cid:3,,15957.0
,,16,,,Unknown,,cid:15)(cid:2)(cid:17)(cid:2)(cid:18)(cid:1)(cid:18)(cid:19)(cid:18)(cid:18)(cid:2)(cid:1)(cid:2)(cid:3,,15973.0
,,34,,,Unknown,,cid:15)(cid:2)(cid:17)(cid:2)(cid:18)(cid:1)(cid:18)(cid:19)(cid:18)(cid:18)(cid:2)(cid:1)(cid:2)(cid:3,,16007.0
,,33,,,Unknown,,cid:15)(cid:2)(cid:17)(cid:2)(cid:18)(cid:1)(cid:18)(cid:19)(cid:18)(cid:18)(cid:2)(cid:1)(cid:2)(cid:3,,16040.0
,,37,,,Unknown,,cid:15)(cid:2)(cid:17)(cid:2)(cid:18)(cid:1)(cid:18)(cid:19)(cid:18)(cid:18)(cid:2)(cid:1)(cid:2)(cid:3,,16077.0
,,17,,,Unknown,,cid:15)(cid:2)(cid:17)(cid:2)(cid:18)(cid:1)(cid:18)(cid:19)(cid:18)(cid:18)(cid:2)(cid:1)(cid:2)(cid:3,,16094.0
,,45,,,Unknown,,cid:15)(cid:2)(cid:17)(cid:2)(cid:18)(cid:1)(cid:18)(cid:19)(cid:18)(cid:18)(cid:2)(cid:1)(cid:2)(cid:3,,16139.0
,,18,,,Unknown,,cid:15)(cid:2)(cid:17)(cid:2)(cid:18)(cid:1)(cid:18)(cid:19)(cid:18)(cid:18)(cid:2)(cid:1)(cid:2)(cid:3,,16157.0
,,35,,,Unknown,,cid:15)(cid:2)(cid:17)(cid:2)(cid:18)(cid:1)(cid:18)(cid:19)(cid:18)(cid:18)(cid:2)(cid:1)(cid:2)(cid:3,,16192.0
,,9,,,Unknown,,cid:15)(cid:2)(cid:17)(cid:2)(cid:18)(cid:1)(cid:18)(cid:19)(cid:18)(cid:18)(cid:2)(cid:1)(cid:2)(cid:3,,16201.0
,,46,,,Unknown,,cid:15)(cid:2)(cid:17)(cid:2)(cid:18)(cid:1)(cid:18)(cid:19)(cid:18)(cid:18)(cid:2)(cid:1)(cid:2)(cid:3,,16247.0
,,8,,,Unknown,,cid:15)(cid:2)(cid:17)(cid:2)(cid:18)(cid:1)(cid:18)(cid:19)(cid:18)(cid:18)(cid:2)(cid:1)(cid:2)(cid:3,,16255.0
,,5,,,Unknown,,cid:15)(cid:2)(cid:17)(cid:2)(cid:18)(cid:1)(cid:18)(cid:19)(cid:18)(cid:18)(cid:2)(cid:1)(cid:2)(cid:3,,16260.0
,,28,,,Unknown,,cid:15)(cid:2)(cid:17)(cid:2)(cid:18)(cid:1)(cid:18)(cid:19)(cid:18)(cid:18)(cid:2)(cid:1)(cid:2)(cid:3,,16288.0
,,2,,,Unknown,,cid:15)(cid:2)(cid:17)(cid:2)(cid:18)(cid:1)(cid:18)(cid:19)(cid:18)(cid:18)(cid:2)(cid:1)(cid:2)(cid:3,,16290.0
,,9,,,Unknown,,cid:15)(cid:2)(cid:17)(cid:2)(cid:18)(cid:1)(cid:18)(cid:19)(cid:18)(cid:18)(cid:2)(cid:1)(cid:2)(cid:3,,16299.0
,,5,,,Unknown,,cid:15)(cid:2)(cid:17)(cid:2)(cid:18)(cid:1)(cid:18)(cid:19)(cid:18)(cid:18)(cid:2)(cid:1)(cid:2)(cid:3,,16304.0
,,8,,,Unknown,,cid:15)(cid:2)(cid:17)(cid:2)(cid:18)(cid:1)(cid:18)(cid:19)(cid:18)(cid:18)(cid:2)(cid:1)(cid:2)(cid:3,,16312.0
,,14,,,Unknown,,cid:15)(cid:2)(cid:17)(cid:2)(cid:18)(cid:1)(cid:18)(cid:19)(cid:18)(cid:18)(cid:2)(cid:1)(cid:2)(cid:3,,16326.0
,,7,,,Unknown,,cid:15)(cid:2)(cid:17)(cid:2)(cid:18)(cid:1)(cid:18)(cid:19)(cid:18)(cid:18)(cid:2)(cid:1)(cid:2)(cid:3,,16333.0
,,9,,,Unknown,,cid:15)(cid:2)(cid:17)(cid:2)(cid:18)(cid:1)(cid:18)(cid:19)(cid:18)(cid:18)(cid:2)(cid:1)(cid:2)(cid:3,,16342.0
,,2,,,Unknown,,cid:15)(cid:2)(cid:17)(cid:2)(cid:18)(cid:1)(cid:18)(cid:19)(cid:18)(cid:18)(cid:2)(cid:1)(cid:2)(cid:3,,16344.0
,,28,,,Unknown,,cid:15)(cid:2)(cid:17)(cid:2)(cid:18)(cid:1)(cid:18)(cid:19)(cid:18)(cid:18)(cid:2)(cid:1)(cid:2)(cid:3,,16372.0
,,3,,,Unknown,,cid:15)(cid:2)(cid:17)(cid:2)(cid:18)(cid:1)(cid:18)(cid:19)(cid:18)(cid:18)(cid:2)(cid:1)(cid:2)(cid:3,,16375.0
,,15,,,Unknown,,cid:15)(cid:2)(cid:17)(cid:2)(cid:18)(cid:1)(cid:18)(cid:19)(cid:18)(cid:18)(cid:2)(cid:1)(cid:2)(cid:3,,16390.0
,,2,,,Unknown,,cid:15)(cid:2)(cid:17)(cid:2)(cid:18)(cid:1)(cid:18)(cid:19)(cid:18)(cid:18)(cid:2)(cid:1)(cid:2)(cid:3,,16392.0
,,33,,,Unknown,,cid:15)(cid:2)(cid:17)(cid:2)(cid:18)(cid:1)(cid:18)(cid:19)(cid:18)(cid:18)(cid:2)(cid:1)(cid:2)(cid:3,,16425.0
,,19,,,Unknown,,cid:15)(cid:2)(cid:17)(cid:2)(cid:18)(cid:1)(cid:18)(cid:19)(cid:18)(cid:18)(cid:2)(cid:1)(cid:2)(cid:3,,16444.0
,,17,,,Unknown,,cid:15)(cid:2)(cid:17)(cid:2)(cid:18)(cid:1)(cid:18)(cid:19)(cid:18)(cid:18)(cid:2)(cid:1)(cid:2)(cid:3,,16461.0
,,18,,,Unknown,,cid:15)(cid:2)(cid:17)(cid:2)(cid:18)(cid:1)(cid:18)(cid:19)(cid:18)(cid:18)(cid:2)(cid:1)(cid:2)(cid:3,,16479.0
,,2,,,Unknown,,cid:15)(cid:2)(cid:17)(cid:2)(cid:18)(cid:1)(cid:18)(cid:19)(cid:18)(cid:18)(cid:2)(cid:1)(cid:2)(cid:3,,16481.0
,,44,,,Unknown,,cid:15)(cid:2)(cid:17)(cid:2)(cid:18)(cid:1)(cid:18)(cid:19)(cid:18)(cid:18)(cid:2)(cid:1)(cid:2)(cid:3,,16525.0
,,12,,,Unknown,,cid:15)(cid:2)(cid:17)(cid:2)(cid:18)(cid:1)(cid:18)(cid:19)(cid:18)(cid:18)(cid:2)(cid:1)(cid:2)(cid:3,,16537.0
,,29,,,Unknown,,cid:15)(cid:2)(cid:17)(cid:2)(cid:18)(cid:1)(cid:18)(cid:19)(cid:18)(cid:18)(cid:2)(cid:1)(cid:2)(cid:3,,16566.0
,,26,,,Unknown,,cid:15)(cid:2)(cid:17)(cid:2)(cid:18)(cid:1)(cid:18)(cid:19)(cid:18)(cid:18)(cid:2)(cid:1)(cid:2)(cid:3,,16592.0
,,41,,,Unknown,,cid:15)(cid:2)(cid:17)(cid:2)(cid:18)(cid:1)(cid:18)(cid:19)(cid:18)(cid:18)(cid:2)(cid:1)(cid:2)(cid:3,,16633.0
,,25,,,Unknown,,cid:15)(cid:2)(cid:17)(cid:2)(cid:18)(cid:1)(cid:18)(cid:19)(cid:18)(cid:18)(cid:2)(cid:1)(cid:2)(cid:3,,16658.0
,,2,,,Unknown,,cid:15)(cid:2)(cid:17)(cid:2)(cid:18)(cid:1)(cid:18)(cid:19)(cid:18)(cid:18)(cid:2)(cid:1)(cid:2)(cid:3,,16660.0
,,50,,,Unknown,,cid:15)(cid:2)(cid:17)(cid:2)(cid:18)(cid:1)(cid:18)(cid:19)(cid:18)(cid:18)(cid:2)(cid:1)(cid:2)(cid:3,,16710.0
,,50,,,Unknown,,cid:15)(cid:2)(cid:17)(cid:2)(cid:18)(cid:1)(cid:18)(cid:19)(cid:18)(cid:18)(cid:2)(cid:1)(cid:2)(cid:3,,16760.0
,,18,,,Unknown,,cid:15)(cid:2)(cid:17)(cid:2)(cid:18)(cid:1)(cid:18)(cid:19)(cid:18)(cid:18)(cid:2)(cid:1)(cid:2)(cid:3,,16778.0
,,1,,,Unknown,,cid:15)(cid:2)(cid:17)(cid:2)(cid:18)(cid:1)(cid:18)(cid:19)(cid:18)(cid:18)(cid:2)(cid:1)(cid:2)(cid:3,,16779.0
,,1,,,Unknown,,cid:15)(cid:2)(cid:17)(cid:2)(cid:18)(cid:1)(cid:18)(cid:19)(cid:18)(cid:18)(cid:2)(cid:1)(cid:2)(cid:3,,16780.0
,,37,,,Unknown,,cid:15)(cid:2)(cid:17)(cid:2)(cid:18)(cid:1)(cid:18)(cid:19)(cid:18)(cid:18)(cid:2)(cid:1)(cid:2)(cid:3,,16817.0
,,37,,,Unknown,,cid:15)(cid:2)(cid:17)(cid:2)(cid:18)(cid:1)(cid:18)(cid:19)(cid:18)(cid:18)(cid:2)(cid:1)(cid:2)(cid:3,,16854.0
,,17,,,Unknown,,cid:15)(cid:2)(cid:17)(cid:2)(cid:18)(cid:1)(cid:18)(cid:19)(cid:18)(cid:18)(cid:2)(cid:1)(cid:2)(cid:3,,16871.0
,,45,,,Unknown,,cid:15)(cid:2)(cid:17)(cid:2)(cid:18)(cid:1)(cid:18)(cid:19)(cid:18)(cid:18)(cid:2)(cid:1)(cid:2)(cid:3,,16916.0
,,18,,,Unknown,,cid:15)(cid:2)(cid:17)(cid:2)(cid:18)(cid:1)(cid:18)(cid:19)(cid:18)(cid:18)(cid:2)(cid:1)(cid:2)(cid:3,,16934.0
,,35,,,Unknown,,cid:15)(cid:2)(cid:17)(cid:2)(cid:18)(cid:1)(cid:18)(cid:19)(cid:18)(cid:18)(cid:2)(cid:1)(cid:2)(cid:3,,16969.0
,,10,,,Unknown,,cid:15)(cid:2)(cid:17)(cid:2)(cid:18)(cid:1)(cid:18)(cid:19)(cid:18)(cid:18)(cid:2)(cid:1)(cid:2)(cid:3,,16979.0
,,11,,,Unknown,,cid:15)(cid:2)(cid:17)(cid:2)(cid:18)(cid:1)(cid:18)(cid:19)(cid:18)(cid:18)(cid:2)(cid:1)(cid:2)(cid:3,,16990.0
,,10,,,Unknown,,cid:15)(cid:2)(cid:17)(cid:2)(cid:18)(cid:1)(cid:18)(cid:19)(cid:18)(cid:18)(cid:2)(cid:1)(cid:2)(cid:3,,17000.0
,,46,,,Unknown,,cid:15)(cid:2)(cid:17)(cid:2)(cid:18)(cid:1)(cid:18)(cid:19)(cid:18)(cid:18)(cid:2)(cid:1)(cid:2)(cid:3,,17046.0
,,14,,,Unknown,,cid:15)(cid:2)(cid:17)(cid:2)(cid:18)(cid:1)(cid:18)(cid:19)(cid:18)(cid:18)(cid:2)(cid:1)(cid:2)(cid:3,,17060.0
,,2,,,Unknown,,cid:15)(cid:2)(cid:17)(cid:2)(cid:18)(cid:1)(cid:18)(cid:19)(cid:18)(cid:18)(cid:2)(cid:1)(cid:2)(cid:3,,17062.0
,,12,,,Unknown,,cid:15)(cid:2)(cid:17)(cid:2)(cid:18)(cid:1)(cid:18)(cid:19)(cid:18)(cid:18)(cid:2)(cid:1)(cid:2)(cid:3,,17074.0
,,11,,,Unknown,,cid:15)(cid:2)(cid:17)(cid:2)(cid:18)(cid:1)(cid:18)(cid:19)(cid:18)(cid:18)(cid:2)(cid:1)(cid:2)(cid:3,,17085.0
,,4,,,Unknown,,cid:15)(cid:2)(cid:17)(cid:2)(cid:18)(cid:1)(cid:18)(cid:19)(cid:18)(cid:18)(cid:2)(cid:1)(cid:2)(cid:3,,17089.0
,,14,,,Unknown,,cid:15)(cid:2)(cid:17)(cid:2)(cid:18)(cid:1)(cid:18)(cid:19)(cid:18)(cid:18)(cid:2)(cid:1)(cid:2)(cid:3,,17103.0
,,11,,,Unknown,,cid:15)(cid:2)(cid:17)(cid:2)(cid:18)(cid:1)(cid:18)(cid:19)(cid:18)(cid:18)(cid:2)(cid:1)(cid:2)(cid:3,,17114.0
,,54,,,Unknown,,cid:15)(cid:2)(cid:17)(cid:2)(cid:18)(cid:1)(cid:18)(cid:19)(cid:18)(cid:18)(cid:2)(cid:1)(cid:2)(cid:3,,17168.0
,,54,,,Unknown,,cid:15)(cid:2)(cid:17)(cid:2)(cid:18)(cid:1)(cid:18)(cid:19)(cid:18)(cid:18)(cid:2)(cid:1)(cid:2)(cid:3,,17222.0
,,7,,,Unknown,,cid:15)(cid:2)(cid:17)(cid:2)(cid:18)(cid:1)(cid:18)(cid:19)(cid:18)(cid:18)(cid:2)(cid:1)(cid:2)(cid:3,,17229.0
,,5,,,Unknown,,cid:15)(cid:2)(cid:17)(cid:2)(cid:18)(cid:1)(cid:18)(cid:19)(cid:18)(cid:18)(cid:2)(cid:1)(cid:2)(cid:3,,17234.0
,,3,,,Unknown,,cid:15)(cid:2)(cid:17)(cid:2)(cid:18)(cid:1)(cid:18)(cid:19)(cid:18)(cid:18)(cid:2)(cid:1)(cid:2)(cid:3,,17237.0
,,9,,,Unknown,,cid:15)(cid:2)(cid:17)(cid:2)(cid:18)(cid:1)(cid:18)(cid:19)(cid:18)(cid:18)(cid:2)(cid:1)(cid:2)(cid:3,,17246.0
,,2,,,Unknown,,cid:15)(cid:2)(cid:17)(cid:2)(cid:18)(cid:1)(cid:18)(cid:19)(cid:18)(cid:18)(cid:2)(cid:1)(cid:2)(cid:3,,17248.0
,,28,,,Unknown,,cid:15)(cid:2)(cid:17)(cid:2)(cid:18)(cid:1)(cid:18)(cid:19)(cid:18)(cid:18)(cid:2)(cid:1)(cid:2)(cid:3,,17276.0
,,3,,,Unknown,,cid:15)(cid:2)(cid:17)(cid:2)(cid:18)(cid:1)(cid:18)(cid:19)(cid:18)(cid:18)(cid:2)(cid:1)(cid:2)(cid:3,,17279.0
,,15,,,Unknown,,cid:15)(cid:2)(cid:17)(cid:2)(cid:18)(cid:1)(cid:18)(cid:19)(cid:18)(cid:18)(cid:2)(cid:1)(cid:2)(cid:3,,17294.0
,,2,,,Unknown,,cid:15)(cid:2)(cid:17)(cid:2)(cid:18)(cid:1)(cid:18)(cid:19)(cid:18)(cid:18)(cid:2)(cid:1)(cid:2)(cid:3,,17296.0
,,16,,,Unknown,,cid:15)(cid:2)(cid:17)(cid:2)(cid:18)(cid:1)(cid:18)(cid:19)(cid:18)(cid:18)(cid:2)(cid:1)(cid:2)(cid:3,,17312.0
,,18,,,Unknown,,cid:15)(cid:2)(cid:17)(cid:2)(cid:18)(cid:1)(cid:18)(cid:19)(cid:18)(cid:18)(cid:2)(cid:1)(cid:2)(cid:3,,17330.0
,,19,,,Unknown,,cid:15)(cid:2)(cid:17)(cid:2)(cid:18)(cid:1)(cid:18)(cid:19)(cid:18)(cid:18)(cid:2)(cid:1)(cid:2)(cid:3,,17349.0
,,18,,,Unknown,,cid:15)(cid:2)(cid:17)(cid:2)(cid:18)(cid:1)(cid:18)(cid:19)(cid:18)(cid:18)(cid:2)(cid:1)(cid:2)(cid:3,,17367.0
,,34,,,Unknown,,cid:15)(cid:2)(cid:17)(cid:2)(cid:18)(cid:1)(cid:18)(cid:19)(cid:18)(cid:18)(cid:2)(cid:1)(cid:2)(cid:3,,17401.0
,,2,,,Unknown,,cid:15)(cid:2)(cid:17)(cid:2)(cid:18)(cid:1)(cid:18)(cid:19)(cid:18)(cid:18)(cid:2)(cid:1)(cid:2)(cid:3,,17403.0
,,44,,,Unknown,,cid:15)(cid:2)(cid:17)(cid:2)(cid:18)(cid:1)(cid:18)(cid:19)(cid:18)(cid:18)(cid:2)(cid:1)(cid:2)(cid:3,,17447.0
,,12,,,Unknown,,cid:15)(cid:2)(cid:17)(cid:2)(cid:18)(cid:1)(cid:18)(cid:19)(cid:18)(cid:18)(cid:2)(cid:1)(cid:2)(cid:3,,17459.0
,,29,,,Unknown,,cid:15)(cid:2)(cid:17)(cid:2)(cid:18)(cid:1)(cid:18)(cid:19)(cid:18)(cid:18)(cid:2)(cid:1)(cid:2)(cid:3,,17488.0
,,26,,,Unknown,,cid:15)(cid:2)(cid:17)(cid:2)(cid:18)(cid:1)(cid:18)(cid:19)(cid:18)(cid:18)(cid:2)(cid:1)(cid:2)(cid:3,,17514.0
,,41,,,Unknown,,cid:15)(cid:2)(cid:17)(cid:2)(cid:18)(cid:1)(cid:18)(cid:19)(cid:18)(cid:18)(cid:2)(cid:1)(cid:2)(cid:3,,17555.0
,,25,,,Unknown,,cid:15)(cid:2)(cid:17)(cid:2)(cid:18)(cid:1)(cid:18)(cid:19)(cid:18)(cid:18)(cid:2)(cid:1)(cid:2)(cid:3,,17580.0
,,2,,,Unknown,,cid:15)(cid:2)(cid:17)(cid:2)(cid:18)(cid:1)(cid:18)(cid:19)(cid:18)(cid:18)(cid:2)(cid:1)(cid:2)(cid:3,,17582.0
,,50,,,Unknown,,cid:15)(cid:2)(cid:17)(cid:2)(cid:18)(cid:1)(cid:18)(cid:19)(cid:18)(cid:18)(cid:2)(cid:1)(cid:2)(cid:3,,17632.0
,,50,,,Unknown,,cid:15)(cid:2)(cid:17)(cid:2)(cid:18)(cid:1)(cid:18)(cid:19)(cid:18)(cid:18)(cid:2)(cid:1)(cid:2)(cid:3,,17682.0
,,18,,,Unknown,,cid:15)(cid:2)(cid:17)(cid:2)(cid:18)(cid:1)(cid:18)(cid:19)(cid:18)(cid:18)(cid:2)(cid:1)(cid:2)(cid:3,,17700.0
,,1,,,Unknown,,cid:15)(cid:2)(cid:17)(cid:2)(cid:18)(cid:1)(cid:18)(cid:19)(cid:18)(cid:18)(cid:2)(cid:1)(cid:2)(cid:3,,17701.0
,,1,,,Unknown,,cid:15)(cid:2)(cid:17)(cid:2)(cid:18)(cid:1)(cid:18)(cid:19)(cid:18)(cid:18)(cid:2)(cid:1)(cid:2)(cid:3,,17702.0
,,37,,,Unknown,,cid:15)(cid:2)(cid:17)(cid:2)(cid:18)(cid:1)(cid:18)(cid:19)(cid:18)(cid:18)(cid:2)(cid:1)(cid:2)(cid:3,,17739.0
,,37,,,Unknown,,cid:15)(cid:2)(cid:17)(cid:2)(cid:18)(cid:1)(cid:18)(cid:19)(cid:18)(cid:18)(cid:2)(cid:1)(cid:2)(cid:3,,17776.0
,,17,,,Unknown,,cid:15)(cid:2)(cid:17)(cid:2)(cid:18)(cid:1)(cid:18)(cid:19)(cid:18)(cid:18)(cid:2)(cid:1)(cid:2)(cid:3,,17793.0
,,45,,,Unknown,,cid:15)(cid:2)(cid:17)(cid:2)(cid:18)(cid:1)(cid:18)(cid:19)(cid:18)(cid:18)(cid:2)(cid:1)(cid:2)(cid:3,,17838.0
,,18,,,Unknown,,cid:15)(cid:2)(cid:17)(cid:2)(cid:18)(cid:1)(cid:18)(cid:19)(cid:18)(cid:18)(cid:2)(cid:1)(cid:2)(cid:3,,17856.0
,,35,,,Unknown,,cid:15)(cid:2)(cid:17)(cid:2)(cid:18)(cid:1)(cid:18)(cid:19)(cid:18)(cid:18)(cid:2)(cid:1)(cid:2)(cid:3,,17891.0
,,54,,,Unknown,,cid:15)(cid:2)(cid:17)(cid:2)(cid:18)(cid:1)(cid:18)(cid:19)(cid:18)(cid:18)(cid:2)(cid:1)(cid:2)(cid:3,,17945.0
,,12,,,Unknown,,cid:15)(cid:2)(cid:17)(cid:2)(cid:18)(cid:1)(cid:18)(cid:19)(cid:18)(cid:18)(cid:2)(cid:1)(cid:2)(cid:3,,17957.0
,,2,,,Unknown,,cid:15)(cid:2)(cid:17)(cid:2)(cid:18)(cid:1)(cid:18)(cid:19)(cid:18)(cid:18)(cid:2)(cid:1)(cid:2)(cid:3,,17959.0
,,49,,,Unknown,,cid:15)(cid:2)(cid:17)(cid:2)(cid:18)(cid:1)(cid:18)(cid:19)(cid:18)(cid:18)(cid:2)(cid:1)(cid:2)(cid:3,,18008.0
,,11,,,Unknown,,cid:15)(cid:2)(cid:17)(cid:2)(cid:18)(cid:1)(cid:18)(cid:19)(cid:18)(cid:18)(cid:2)(cid:1)(cid:2)(cid:3,,18019.0
,,8,,,Unknown,,cid:15)(cid:2)(cid:17)(cid:2)(cid:18)(cid:1)(cid:18)(cid:19)(cid:18)(cid:18)(cid:2)(cid:1)(cid:2)(cid:3,,18027.0
,,46,,,Unknown,,cid:15)(cid:2)(cid:17)(cid:2)(cid:18)(cid:1)(cid:18)(cid:19)(cid:18)(cid:18)(cid:2)(cid:1)(cid:2)(cid:3,,18073.0
,,14,,,Unknown,,cid:15)(cid:2)(cid:17)(cid:2)(cid:18)(cid:1)(cid:18)(cid:19)(cid:18)(cid:18)(cid:2)(cid:1)(cid:2)(cid:3,,18087.0
,,49,,,Unknown,,cid:15)(cid:2)(cid:17)(cid:2)(cid:18)(cid:1)(cid:18)(cid:19)(cid:18)(cid:18)(cid:2)(cid:1)(cid:2)(cid:3,,18136.0
,,55,,,Unknown,,cid:15)(cid:2)(cid:17)(cid:2)(cid:18)(cid:1)(cid:18)(cid:19)(cid:18)(cid:18)(cid:2)(cid:1)(cid:2)(cid:3,,18191.0
,,9,,,Unknown,,cid:15)(cid:2)(cid:17)(cid:2)(cid:18)(cid:1)(cid:18)(cid:19)(cid:18)(cid:18)(cid:2)(cid:1)(cid:2)(cid:3,,18200.0
,,2,,,Unknown,,cid:15)(cid:2)(cid:17)(cid:2)(cid:18)(cid:1)(cid:18)(cid:19)(cid:18)(cid:18)(cid:2)(cid:1)(cid:2)(cid:3,,18202.0
,,12,,,Unknown,,cid:15)(cid:2)(cid:17)(cid:2)(cid:18)(cid:1)(cid:18)(cid:19)(cid:18)(cid:18)(cid:2)(cid:1)(cid:2)(cid:3,,18214.0
,,11,,,Unknown,,cid:15)(cid:2)(cid:17)(cid:2)(cid:18)(cid:1)(cid:18)(cid:19)(cid:18)(cid:18)(cid:2)(cid:1)(cid:2)(cid:3,,18225.0
,,4,,,Unknown,,cid:15)(cid:2)(cid:17)(cid:2)(cid:18)(cid:1)(cid:18)(cid:19)(cid:18)(cid:18)(cid:2)(cid:1)(cid:2)(cid:3,,18229.0
,,14,,,Unknown,,cid:15)(cid:2)(cid:17)(cid:2)(cid:18)(cid:1)(cid:18)(cid:19)(cid:18)(cid:18)(cid:2)(cid:1)(cid:2)(cid:3,,18243.0
,,11,,,Unknown,,cid:15)(cid:2)(cid:17)(cid:2)(cid:18)(cid:1)(cid:18)(cid:19)(cid:18)(cid:18)(cid:2)(cid:1)(cid:2)(cid:3,,18254.0
,,54,,,Unknown,,cid:15)(cid:2)(cid:17)(cid:2)(cid:18)(cid:1)(cid:18)(cid:19)(cid:18)(cid:18)(cid:2)(cid:1)(cid:2)(cid:3,,18308.0
,,54,,,Unknown,,cid:15)(cid:2)(cid:17)(cid:2)(cid:18)(cid:1)(cid:18)(cid:19)(cid:18)(cid:18)(cid:2)(cid:1)(cid:2)(cid:3,,18362.0
,,7,,,Unknown,,cid:15)(cid:2)(cid:17)(cid:2)(cid:18)(cid:1)(cid:18)(cid:19)(cid:18)(cid:18)(cid:2)(cid:1)(cid:2)(cid:3,,18369.0
,,5,,,Unknown,,cid:15)(cid:2)(cid:17)(cid:2)(cid:18)(cid:1)(cid:18)(cid:19)(cid:18)(cid:18)(cid:2)(cid:1)(cid:2)(cid:3,,18374.0
,,3,,,Unknown,,cid:15)(cid:2)(cid:17)(cid:2)(cid:18)(cid:1)(cid:18)(cid:19)(cid:18)(cid:18)(cid:2)(cid:1)(cid:2)(cid:3,,18377.0
,,2,,,Unknown,,cid:15)(cid:2)(cid:17)(cid:2)(cid:18)(cid:1)(cid:18)(cid:19)(cid:18)(cid:18)(cid:2)(cid:1)(cid:2)(cid:3,,18379.0
,,28,,,Unknown,,cid:15)(cid:2)(cid:17)(cid:2)(cid:18)(cid:1)(cid:18)(cid:19)(cid:18)(cid:18)(cid:2)(cid:1)(cid:2)(cid:3,,18407.0
,,3,,,Unknown,,cid:15)(cid:2)(cid:17)(cid:2)(cid:18)(cid:1)(cid:18)(cid:19)(cid:18)(cid:18)(cid:2)(cid:1)(cid:2)(cid:3,,18410.0
,,15,,,Unknown,,cid:15)(cid:2)(cid:17)(cid:2)(cid:18)(cid:1)(cid:18)(cid:19)(cid:18)(cid:18)(cid:2)(cid:1)(cid:2)(cid:3,,18425.0
,,2,,,Unknown,,cid:15)(cid:2)(cid:17)(cid:2)(cid:18)(cid:1)(cid:18)(cid:19)(cid:18)(cid:18)(cid:2)(cid:1)(cid:2)(cid:3,,18427.0
,,37,,,Unknown,,cid:15)(cid:2)(cid:17)(cid:2)(cid:18)(cid:1)(cid:18)(cid:19)(cid:18)(cid:18)(cid:2)(cid:1)(cid:2)(cid:3,,18464.0
,,33,,,Unknown,,cid:15)(cid:2)(cid:17)(cid:2)(cid:18)(cid:1)(cid:18)(cid:19)(cid:18)(cid:18)(cid:2)(cid:1)(cid:2)(cid:3,,18497.0
,,19,,,Unknown,,cid:15)(cid:2)(cid:17)(cid:2)(cid:18)(cid:1)(cid:18)(cid:19)(cid:18)(cid:18)(cid:2)(cid:1)(cid:2)(cid:3,,18516.0
,,34,,,Unknown,,cid:15)(cid:2)(cid:17)(cid:2)(cid:18)(cid:1)(cid:18)(cid:19)(cid:18)(cid:18)(cid:2)(cid:1)(cid:2)(cid:3,,18550.0
,,34,,,Unknown,,cid:15)(cid:2)(cid:17)(cid:2)(cid:18)(cid:1)(cid:18)(cid:19)(cid:18)(cid:18)(cid:2)(cid:1)(cid:2)(cid:3,,18584.0
,,2,,,Unknown,,cid:15)(cid:2)(cid:17)(cid:2)(cid:18)(cid:1)(cid:18)(cid:19)(cid:18)(cid:18)(cid:2)(cid:1)(cid:2)(cid:3,,18586.0
,,44,,,Unknown,,cid:15)(cid:2)(cid:17)(cid:2)(cid:18)(cid:1)(cid:18)(cid:19)(cid:18)(cid:18)(cid:2)(cid:1)(cid:2)(cid:3,,18630.0
,,12,,,Unknown,,cid:15)(cid:2)(cid:17)(cid:2)(cid:18)(cid:1)(cid:18)(cid:19)(cid:18)(cid:18)(cid:2)(cid:1)(cid:2)(cid:3,,18642.0
,,29,,,Unknown,,cid:15)(cid:2)(cid:17)(cid:2)(cid:18)(cid:1)(cid:18)(cid:19)(cid:18)(cid:18)(cid:2)(cid:1)(cid:2)(cid:3,,18671.0
,,26,,,Unknown,,cid:15)(cid:2)(cid:17)(cid:2)(cid:18)(cid:1)(cid:18)(cid:19)(cid:18)(cid:18)(cid:2)(cid:1)(cid:2)(cid:3,,18697.0
,,41,,,Unknown,,cid:15)(cid:2)(cid:17)(cid:2)(cid:18)(cid:1)(cid:18)(cid:19)(cid:18)(cid:18)(cid:2)(cid:1)(cid:2)(cid:3,,18738.0
,,25,,,Unknown,,cid:15)(cid:2)(cid:17)(cid:2)(cid:18)(cid:1)(cid:18)(cid:19)(cid:18)(cid:18)(cid:2)(cid:1)(cid:2)(cid:3,,18763.0
,,2,,,Unknown,,cid:15)(cid:2)(cid:17)(cid:2)(cid:18)(cid:1)(cid:18)(cid:19)(cid:18)(cid:18)(cid:2)(cid:1)(cid:2)(cid:3,,18765.0
,,50,,,Unknown,,cid:15)(cid:2)(cid:17)(cid:2)(cid:18)(cid:1)(cid:18)(cid:19)(cid:18)(cid:18)(cid:2)(cid:1)(cid:2)(cid:3,,18815.0
,,50,,,Unknown,,cid:15)(cid:2)(cid:17)(cid:2)(cid:18)(cid:1)(cid:18)(cid:19)(cid:18)(cid:18)(cid:2)(cid:1)(cid:2)(cid:3,,18865.0
,,18,,,Unknown,,cid:15)(cid:2)(cid:17)(cid:2)(cid:18)(cid:1)(cid:18)(cid:19)(cid:18)(cid:18)(cid:2)(cid:1)(cid:2)(cid:3,,18883.0
,,1,,,Unknown,,cid:15)(cid:2)(cid:17)(cid:2)(cid:18)(cid:1)(cid:18)(cid:19)(cid:18)(cid:18)(cid:2)(cid:1)(cid:2)(cid:3,,18884.0
,,1,,,Unknown,,cid:15)(cid:2)(cid:17)(cid:2)(cid:18)(cid:1)(cid:18)(cid:19)(cid:18)(cid:18)(cid:2)(cid:1)(cid:2)(cid:3,,18885.0
,,37,,,Unknown,,cid:15)(cid:2)(cid:17)(cid:2)(cid:18)(cid:1)(cid:18)(cid:19)(cid:18)(cid:18)(cid:2)(cid:1)(cid:2)(cid:3,,18922.0
,,37,,,Unknown,,cid:15)(cid:2)(cid:17)(cid:2)(cid:18)(cid:1)(cid:18)(cid:19)(cid:18)(cid:18)(cid:2)(cid:1)(cid:2)(cid:3,,18959.0
,,17,,,Unknown,,cid:15)(cid:2)(cid:17)(cid:2)(cid:18)(cid:1)(cid:18)(cid:19)(cid:18)(cid:18)(cid:2)(cid:1)(cid:2)(cid:3,,18976.0
,,45,,,Unknown,,cid:15)(cid:2)(cid:17)(cid:2)(cid:18)(cid:1)(cid:18)(cid:19)(cid:18)(cid:18)(cid:2)(cid:1)(cid:2)(cid:3,,19021.0
,,18,,,Unknown,,cid:15)(cid:2)(cid:17)(cid:2)(cid:18)(cid:1)(cid:18)(cid:19)(cid:18)(cid:18)(cid:2)(cid:1)(cid:2)(cid:3,,19039.0
,,35,,,Unknown,,cid:15)(cid:2)(cid:17)(cid:2)(cid:18)(cid:1)(cid:18)(cid:19)(cid:18)(cid:18)(cid:2)(cid:1)(cid:2)(cid:3,,19074.0
,,9,,,Unknown,,cid:15)(cid:2)(cid:17)(cid:2)(cid:18)(cid:1)(cid:18)(cid:19)(cid:18)(cid:18)(cid:2)(cid:1)(cid:2)(cid:3,,19083.0
,,46,,,Unknown,,cid:15)(cid:2)(cid:17)(cid:2)(cid:18)(cid:1)(cid:18)(cid:19)(cid:18)(cid:18)(cid:2)(cid:1)(cid:2)(cid:3,,19129.0
,,8,,,Unknown,,cid:15)(cid:2)(cid:17)(cid:2)(cid:18)(cid:1)(cid:18)(cid:19)(cid:18)(cid:18)(cid:2)(cid:1)(cid:2)(cid:3,,19137.0
,,5,,,Unknown,,cid:15)(cid:2)(cid:17)(cid:2)(cid:18)(cid:1)(cid:18)(cid:19)(cid:18)(cid:18)(cid:2)(cid:1)(cid:2)(cid:3,,19142.0
,,28,,,Unknown,,cid:15)(cid:2)(cid:17)(cid:2)(cid:18)(cid:1)(cid:18)(cid:19)(cid:18)(cid:18)(cid:2)(cid:1)(cid:2)(cid:3,,19170.0
,,2,,,Unknown,,cid:15)(cid:2)(cid:17)(cid:2)(cid:18)(cid:1)(cid:18)(cid:19)(cid:18)(cid:18)(cid:2)(cid:1)(cid:2)(cid:3,,19172.0
,,46,,,Unknown,,cid:15)(cid:2)(cid:17)(cid:2)(cid:18)(cid:1)(cid:18)(cid:19)(cid:18)(cid:18)(cid:2)(cid:1)(cid:2)(cid:3,,19218.0
,,4,,,Unknown,,cid:15)(cid:2)(cid:17)(cid:2)(cid:18)(cid:1)(cid:18)(cid:19)(cid:18)(cid:18)(cid:2)(cid:1)(cid:2)(cid:3,,19222.0
,,10,,,Unknown,,cid:15)(cid:2)(cid:17)(cid:2)(cid:18)(cid:1)(cid:18)(cid:19)(cid:18)(cid:18)(cid:2)(cid:1)(cid:2)(cid:3,,19232.0
,,11,,,Unknown,,cid:15)(cid:2)(cid:17)(cid:2)(cid:18)(cid:1)(cid:18)(cid:19)(cid:18)(cid:18)(cid:2)(cid:1)(cid:2)(cid:3,,19243.0
,,3,,,Unknown,,cid:15)(cid:2)(cid:17)(cid:2)(cid:18)(cid:1)(cid:18)(cid:19)(cid:18)(cid:18)(cid:2)(cid:1)(cid:2)(cid:3,,19246.0
,,11,,,Unknown,,cid:15)(cid:2)(cid:17)(cid:2)(cid:18)(cid:1)(cid:18)(cid:19)(cid:18)(cid:18)(cid:2)(cid:1)(cid:2)(cid:3,,19257.0
,,4,,,Unknown,,cid:15)(cid:2)(cid:17)(cid:2)(cid:18)(cid:1)(cid:18)(cid:19)(cid:18)(cid:18)(cid:2)(cid:1)(cid:2)(cid:3,,19261.0
,,10,,,Unknown,,cid:15)(cid:2)(cid:17)(cid:2)(cid:18)(cid:1)(cid:18)(cid:19)(cid:18)(cid:18)(cid:2)(cid:1)(cid:2)(cid:3,,19271.0
,,5,,,Unknown,,cid:15)(cid:2)(cid:17)(cid:2)(cid:18)(cid:1)(cid:18)(cid:19)(cid:18)(cid:18)(cid:2)(cid:1)(cid:2)(cid:3,,19276.0
,,2,,,Unknown,,cid:15)(cid:2)(cid:17)(cid:2)(cid:18)(cid:1)(cid:18)(cid:19)(cid:18)(cid:18)(cid:2)(cid:1)(cid:2)(cid:3,,19278.0
,,9,,,Unknown,,cid:15)(cid:2)(cid:17)(cid:2)(cid:18)(cid:1)(cid:18)(cid:19)(cid:18)(cid:18)(cid:2)(cid:1)(cid:2)(cid:3,,19287.0
,,5,,,Unknown,,cid:15)(cid:2)(cid:17)(cid:2)(cid:18)(cid:1)(cid:18)(cid:19)(cid:18)(cid:18)(cid:2)(cid:1)(cid:2)(cid:3,,19292.0
,,8,,,Unknown,,cid:15)(cid:2)(cid:17)(cid:2)(cid:18)(cid:1)(cid:18)(cid:19)(cid:18)(cid:18)(cid:2)(cid:1)(cid:2)(cid:3,,19300.0
,,14,,,Unknown,,cid:15)(cid:2)(cid:17)(cid:2)(cid:18)(cid:1)(cid:18)(cid:19)(cid:18)(cid:18)(cid:2)(cid:1)(cid:2)(cid:3,,19314.0
,,7,,,Unknown,,cid:15)(cid:2)(cid:17)(cid:2)(cid:18)(cid:1)(cid:18)(cid:19)(cid:18)(cid:18)(cid:2)(cid:1)(cid:2)(cid:3,,19321.0
,,9,,,Unknown,,cid:15)(cid:2)(cid:17)(cid:2)(cid:18)(cid:1)(cid:18)(cid:19)(cid:18)(cid:18)(cid:2)(cid:1)(cid:2)(cid:3,,19330.0
,,2,,,Unknown,,cid:15)(cid:2)(cid:17)(cid:2)(cid:18)(cid:1)(cid:18)(cid:19)(cid:18)(cid:18)(cid:2)(cid:1)(cid:2)(cid:3,,19332.0
,,12,,,Unknown,,cid:15)(cid:2)(cid:17)(cid:2)(cid:18)(cid:1)(cid:18)(cid:19)(cid:18)(cid:18)(cid:2)(cid:1)(cid:2)(cid:3,,19344.0
,,5,,,Unknown,,cid:15)(cid:2)(cid:17)(cid:2)(cid:18)(cid:1)(cid:18)(cid:19)(cid:18)(cid:18)(cid:2)(cid:1)(cid:2)(cid:3,,19349.0
,,49,,,Unknown,,cid:15)(cid:2)(cid:17)(cid:2)(cid:18)(cid:1)(cid:18)(cid:19)(cid:18)(cid:18)(cid:2)(cid:1)(cid:2)(cid:3,,19398.0
,,5,,,Unknown,,cid:15)(cid:2)(cid:17)(cid:2)(cid:18)(cid:1)(cid:18)(cid:19)(cid:18)(cid:18)(cid:2)(cid:1)(cid:2)(cid:3,,19403.0
,,40,,,Unknown,,cid:15)(cid:2)(cid:17)(cid:2)(cid:18)(cid:1)(cid:18)(cid:19)(cid:18)(cid:18)(cid:2)(cid:1)(cid:2)(cid:3,,19443.0
,,2,,,Unknown,,cid:15)(cid:2)(cid:17)(cid:2)(cid:18)(cid:1)(cid:18)(cid:19)(cid:18)(cid:18)(cid:2)(cid:1)(cid:2)(cid:3,,19445.0
,,28,,,Unknown,,cid:15)(cid:2)(cid:17)(cid:2)(cid:18)(cid:1)(cid:18)(cid:19)(cid:18)(cid:18)(cid:2)(cid:1)(cid:2)(cid:3,,19473.0
,,3,,,Unknown,,cid:15)(cid:2)(cid:17)(cid:2)(cid:18)(cid:1)(cid:18)(cid:19)(cid:18)(cid:18)(cid:2)(cid:1)(cid:2)(cid:3,,19476.0
,,15,,,Unknown,,cid:15)(cid:2)(cid:17)(cid:2)(cid:18)(cid:1)(cid:18)(cid:19)(cid:18)(cid:18)(cid:2)(cid:1)(cid:2)(cid:3,,19491.0
,,2,,,Unknown,,cid:15)(cid:2)(cid:17)(cid:2)(cid:18)(cid:1)(cid:18)(cid:19)(cid:18)(cid:18)(cid:2)(cid:1)(cid:2)(cid:3,,19493.0
,,36,,,Unknown,,cid:15)(cid:2)(cid:17)(cid:2)(cid:18)(cid:1)(cid:18)(cid:19)(cid:18)(cid:18)(cid:2)(cid:1)(cid:2)(cid:3,,19529.0
,,19,,,Unknown,,cid:15)(cid:2)(cid:17)(cid:2)(cid:18)(cid:1)(cid:18)(cid:19)(cid:18)(cid:18)(cid:2)(cid:1)(cid:2)(cid:3,,19548.0
,,32,,,Unknown,,cid:15)(cid:2)(cid:17)(cid:2)(cid:18)(cid:1)(cid:18)(cid:19)(cid:18)(cid:18)(cid:2)(cid:1)(cid:2)(cid:3,,19580.0
,,18,,,Unknown,,cid:15)(cid:2)(cid:17)(cid:2)(cid:18)(cid:1)(cid:18)(cid:19)(cid:18)(cid:18)(cid:2)(cid:1)(cid:2)(cid:3,,19598.0
,,2,,,Unknown,,cid:15)(cid:2)(cid:17)(cid:2)(cid:18)(cid:1)(cid:18)(cid:19)(cid:18)(cid:18)(cid:2)(cid:1)(cid:2)(cid:3,,19600.0
,,44,,,Unknown,,cid:15)(cid:2)(cid:17)(cid:2)(cid:18)(cid:1)(cid:18)(cid:19)(cid:18)(cid:18)(cid:2)(cid:1)(cid:2)(cid:3,,19644.0
,,12,,,Unknown,,cid:15)(cid:2)(cid:17)(cid:2)(cid:18)(cid:1)(cid:18)(cid:19)(cid:18)(cid:18)(cid:2)(cid:1)(cid:2)(cid:3,,19656.0
,,29,,,Unknown,,cid:15)(cid:2)(cid:17)(cid:2)(cid:18)(cid:1)(cid:18)(cid:19)(cid:18)(cid:18)(cid:2)(cid:1)(cid:2)(cid:3,,19685.0
,,26,,,Unknown,,cid:15)(cid:2)(cid:17)(cid:2)(cid:18)(cid:1)(cid:18)(cid:19)(cid:18)(cid:18)(cid:2)(cid:1)(cid:2)(cid:3,,19711.0
,,41,,,Unknown,,cid:15)(cid:2)(cid:17)(cid:2)(cid:18)(cid:1)(cid:18)(cid:19)(cid:18)(cid:18)(cid:2)(cid:1)(cid:2)(cid:3,,19752.0
,,25,,,Unknown,,cid:15)(cid:2)(cid:17)(cid:2)(cid:18)(cid:1)(cid:18)(cid:19)(cid:18)(cid:18)(cid:2)(cid:1)(cid:2)(cid:3,,19777.0
,,2,,,Unknown,,cid:15)(cid:2)(cid:17)(cid:2)(cid:18)(cid:1)(cid:18)(cid:19)(cid:18)(cid:18)(cid:2)(cid:1)(cid:2)(cid:3,,19779.0
,,50,,,Unknown,,cid:15)(cid:2)(cid:17)(cid:2)(cid:18)(cid:1)(cid:18)(cid:19)(cid:18)(cid:18)(cid:2)(cid:1)(cid:2)(cid:3,,19829.0
,,50,,,Unknown,,cid:15)(cid:2)(cid:17)(cid:2)(cid:18)(cid:1)(cid:18)(cid:19)(cid:18)(cid:18)(cid:2)(cid:1)(cid:2)(cid:3,,19879.0
,,18,,,Unknown,,cid:15)(cid:2)(cid:17)(cid:2)(cid:18)(cid:1)(cid:18)(cid:19)(cid:18)(cid:18)(cid:2)(cid:1)(cid:2)(cid:3,,19897.0
,,1,,,Unknown,,cid:15)(cid:2)(cid:17)(cid:2)(cid:18)(cid:1)(cid:18)(cid:19)(cid:18)(cid:18)(cid:2)(cid:1)(cid:2)(cid:3,,19898.0
,,1,,,Unknown,,cid:15)(cid:2)(cid:17)(cid:2)(cid:18)(cid:1)(cid:18)(cid:19)(cid:18)(cid:18)(cid:2)(cid:1)(cid:2)(cid:3,,19899.0
,,37,,,Unknown,,cid:15)(cid:2)(cid:17)(cid:2)(cid:18)(cid:1)(cid:18)(cid:19)(cid:18)(cid:18)(cid:2)(cid:1)(cid:2)(cid:3,,19936.0
14/02/2022,,18,,,Cheque,,C8,VOTRE COMPTE COURANT N' 02421381795 DATE,18.0
31/03/2022,,03,,,Cheque,,C8,DEPOT AGENCE 0006,21.0
,,19,,,Cheque,,C8,SOUS RESERVEDE CoMptaGE,40.0
,,03,,,Cheque,,C8,ReMISE,43.0
,,388,,,Cheque,,C8,BRUT 388 12e,431.0
,,1,,,Cheque,,C8,ReMISE,432.0
,,21,,,Cheque,,C8,CoMoooE M80o51/131122,453.0
,,03,,,Cheque,,C8,REMISE,456.0
,,467 456,,,Cheque,,C8,BRUT 30 0E COH 0 0OE,467912.0
,,21,,,Cheque,,C8,ReMISE,467933.0
,,03,,,Cheque,,C8,Soe CoM,467936.0
,,50,,,Cheque,,C8,REMISE C8,467986.0
,,30,,,Cheque,,C8,REMISE,468016.0
,,0,,,Cheque,,C8,BRUT 471 896 Cou 0oe,468016.0
,,21,,,Cheque,,C8,DAC CASINOSS867O1CO FRAICON,468037.0
,,03,,,Cheque,,C8,DEPOT AGENCE 0006,468040.0
,,3,,,Cheque,,C8,SOUS ReSERVEDE CoMPTAGE,468043.0
,,21,,,Cheque,,C8,"DOT CAP 247,30",468064.0
,,03,,,Cheque,,C8,COM,468067.0
,,326,,,Cheque,,C8,REMISE,468393.0
,,0,,,Cheque,,C8,Goe CoH,468393.0
,,21,,,Cheque,,C8,DATE DaTE OPERATION,468414.0
,,03,,,Cheque,,C8,OAIV7H3,468417.0
,,540,,,Cheque,,C8,OAJSHIK,468957.0
,,21,,,Cheque,,C8,Franche-Conté,468978.0
,,03,,,Cheque,,C8,QOMIE,468981.0
,,40,,,Cheque,,C8,Q5 0235,469021.0
,,0 136,,,Cheque,,C8,Bd0le Iremoulle,469157.0
,,21,,,Cheque,,C8,Coer F CCP Dion,469178.0
,,03,,,Cheque,,C8,Carba Assuaces,469181.0
,,471 896,,,Cheque,,C8,,941077.0
,,21,,,Cheque,,C8,,941098.0
,,03,,,Cheque,,C8,,941101.0
,,50,,,Cheque,,C8,,941151.0
,,311,,,Cheque,,C8,,941462.0
,,21,,,Cheque,,C8,,941483.0
,,03,,,Cheque,,C8,,941486.0
,,128,,,Cheque,,C8,,941614.0
,,05 21,,,Cheque,,C8,,942135.0
,,03,,,Cheque,,C8,,942138.0
,,21,,,Cheque,,C8,,942159.0
,,03,,,Cheque,,C8,,942162.0
,,470,,,Cheque,,C8,,942632.0
,,21,,,Cheque,,C8,,942653.0
,,03,,,Cheque,,C8,,942656.0
,,21,,,Cheque,,C8,,942677.0
,,03,,,Cheque,,C8,,942680.0
,,21,,,Cheque,,C8,,942701.0
,,03,,,Cheque,,C8,,942704.0
,,320 21,,,Cheque,,C8,,974725.0
,,03,,,Cheque,,C8,,974728.0
,,21,,,Cheque,,C8,,974749.0
,,03,,,Cheque,,C8,,974752.0
,,14,,,Cheque,,C8,,974766.0
,,02,,,Cheque,,C8,,974768.0
,,21,,,Cheque,,C8,,974789.0
,,03,,,Cheque,,C8,,974792.0
,,22,,,Cheque,,C8,,974814.0
,,03,,,Cheque,,C8,,974817.0
,,"247,30",,,Cheque,,C8,,999547.0
,,"12,35",,,Cheque,,C8,,1000782.0
,,22,,,Cheque,,C8,,1000804.0
,,03,,,Cheque,,C8,,1000807.0
,,335,,,Cheque,,C8,,1001142.0
,,22,,,Cheque,,C8,,1001164.0
,,03,,,Cheque,,C8,,1001167.0
,,50,,,Cheque,,C8,,1001217.0
,,185,,,Cheque,,C8,,1001402.0
,,0,,,Cheque,,C8,,1001402.0
,,22,,,Cheque,,C8,,1001424.0
,,03,,,Cheque,,C8,,1001427.0
,,22,,,Cheque,,C8,,1001449.0
,,03,,,Cheque,,C8,,1001452.0
,,22,,,Cheque,,C8,,1001474.0
,,03,,,Cheque,,C8,,1001477.0
,,22,,,Cheque,,C8,,1001499.0
,,03,,,Cheque,,C8,,1001502.0
,,000,,,Cheque,,C8,,1001502.0
,,2,,,Cheque,,C8,,1001504.0
,,31,,,Cheque,,C8,,1001535.0
,,03,,,Cheque,,C8,,1001538.0
,,"610,00",,,Cheque,,C8,,1062538.0
,,18,,,Cheque,,C8,,1062556.0
,,03 18,,,Cheque,,C8,,1062874.0
,,03,,,Cheque,,C8,,1062877.0
,,18,,,Cheque,,C8,,1062895.0
,,03 18,,,Cheque,,C8,,1063213.0
,,03 386 89,,,Cheque,,C8,,1401902.0
,,21,,,Cheque,,C8,,1401923.0
,,03 21,,,Cheque,,C8,,1402244.0
,,03 467 45,,,Cheque,,C8,,1748989.0
,,21,,,Cheque,,C8,,1749010.0
,,03 21,,,Cheque,,C8,,1749331.0
,,03 30,,,Cheque,,C8,,1749661.0
,,00,,,Cheque,,C8,,1749661.0
,,21,,,Cheque,,C8,,1749682.0
,,03 21,,,Cheque,,C8,,1750003.0
,,03,,,Cheque,,C8,,1750006.0
,,"3,49",,,Cheque,,C8,,1750355.0
,,21,,,Cheque,,C8,,1750376.0
,,03 21,,,Cheque,,C8,,1750697.0
,,"03 253,50",,,Cheque,,C8,,2076047.0
,,21,,,Cheque,,C8,,2076068.0
,,03 21,,,Cheque,,C8,,2076389.0
,,"03 540,24",,,Cheque,,C8,,2430413.0
,,21,,,Cheque,,C8,,2430434.0
,,03 21,,,Cheque,,C8,,2430755.0
,,03 39,,,Cheque,,C8,,2431094.0
,,87,,,Cheque,,C8,,2431181.0
,,21,,,Cheque,,C8,,2431202.0
,,03 21,,,Cheque,,C8,,2431523.0
,,"03 471,89",,,Cheque,,C8,,2778712.0
,,21,,,Cheque,,C8,,2778733.0
,,03 21,,,Cheque,,C8,,2779054.0
,,03 310 20,,,Cheque,,C8,,3110074.0
,,21,,,Cheque,,C8,,3110095.0
,,03 21,,,Cheque,,C8,,3110416.0
,,03,,,Cheque,,C8,,3110419.0
,,"5,38",,,Cheque,,C8,,3110957.0
,,21,,,Cheque,,C8,,3110978.0
,,03 21,,,Cheque,,C8,,3111299.0
,,03,,,Cheque,,C8,,3111302.0
,,21,,,Cheque,,C8,,3111323.0
,,03 21,,,Cheque,,C8,,3111644.0
,,"03 103,01",,,Cheque,,C8,,3421945.0
,,21,,,Cheque,,C8,,3421966.0
,,03 21,,,Cheque,,C8,,3422287.0
,,"03 546,70",,,Cheque,,C8,,3776957.0
,,21,,,Cheque,,C8,,3776978.0
,,03 21,,,Cheque,,C8,,3777299.0
,,03 21,,,Cheque,,C8,,3777620.0
,,03 21,,,Cheque,,C8,,3777941.0
,,03,,,Cheque,,C8,,3777944.0
,,"3 260,00",,,Cheque,,C8,,4103944.0
,,"292,54",,,Cheque,,C8,,4133198.0
,,17,,,Cheque,,C8,,4133215.0
,,03,,,Cheque,,C8,,4133218.0
,,17,,,Cheque,,C8,,4133235.0
,,03,,,Cheque,,C8,,4133238.0
,,388 26,,,Cheque,,C8,,4172064.0
,,"820,00",,,Cheque,,C8,,4254064.0
,,21,,,Cheque,,C8,,4254085.0
,,03,,,Cheque,,C8,,4254088.0
,,21,,,Cheque,,C8,,4254109.0
,,03 21,,,Cheque,,C8,,4254430.0
,,03 19,,,Cheque,,C8,,4254749.0
,,"03 571,75",,,Cheque,,C8,,4611924.0
,,"267,55",,,Cheque,,C8,,4638679.0
,,21,,,Cheque,,C8,,4638700.0
,,03 21,,,Cheque,,C8,,4639021.0
,,"03 335,19",,,Cheque,,C8,,4972540.0
,,21,,,Cheque,,C8,,4972561.0
,,03 21,,,Cheque,,C8,,4972882.0
,,03,,,Cheque,,C8,,4972885.0
,,21,,,Cheque,,C8,,4972906.0
,,03 21,,,Cheque,,C8,,4973227.0
,,03 14,,,Cheque,,C8,,4973541.0
,,00,,,Cheque,,C8,,4973541.0
,,21,,,Cheque,,C8,,4973562.0
,,03 21,,,Cheque,,C8,,4973883.0
,,03,,,Cheque,,C8,,4973886.0
,,"3,90",,,Cheque,,C8,,4974276.0
,,22,,,Cheque,,C8,,4974298.0
,,03,,,Cheque,,C8,,4974301.0
,,"12,00",,,Cheque,,C8,,4975501.0
,,22,,,Cheque,,C8,,4975523.0
,,03,,,Cheque,,C8,,4975526.0
,,"4,60",,,Cheque,,C8,,4975986.0
,,6,,,Cheque,,C8,,4975992.0
,,0,,,Cheque,,C8,,4975992.0
,,2,,,Cheque,,C8,,4975994.0
,,14,,,Cheque,,C8,,4976008.0
,,07,,,Cheque,,C8,,4976015.0
31/03/2022,,23,,,Cheque,,RELNS,BANQUE POPULAIRE +X BOURGOGNE FRANCHE,23.0
,,03,,,Cheque,,RELNS,DATE,26.0
,,23,,,Cheque,,RELNS,Codi,49.0
,,03,,,Cheque,,RELNS,Sas Promnogros,52.0
,,50,,,Cheque,,RELNS,BRUT,102.0
,,481,,,Cheque,,RELNS,V7e,583.0
,,0,,,Cheque,,RELNS,REMISE,583.0
,,23,,,Cheque,,RELNS,CoM 0 79e Me0016/176756,606.0
,,03,,,Cheque,,RELNS,ReMISE,609.0
,,241,,,Cheque,,RELNS,CoM,850.0
,,0,,,Cheque,,RELNS,INFONET FR-IEL ES BaRceloiu,850.0
,,23,,,Cheque,,RELNS,ChEquE 24/03 REMISE,873.0
,,03,,,Cheque,,RELNS,BRUT,876.0
,,23,,,Cheque,,RELNS,CoM,899.0
,,03,,,Cheque,,RELNS,REMISE C8,902.0
,,23,,,Cheque,,RELNS,ReMISE,925.0
,,03,,,Cheque,,RELNS,CoM,928.0
,,23,,,Cheque,,RELNS,DEPOT,951.0
,,03,,,Cheque,,RELNS,AGENCE 00064,954.0
,,470,,,Cheque,,RELNS,ReMISE,1424.0
,,23,,,Cheque,,RELNS,BRUT 147 74E,1447.0
,,03,,,Cheque,,RELNS,REMISE,1450.0
,,24,,,Cheque,,RELNS,BRUT 86e,1474.0
,,03,,,Cheque,,RELNS,BRUT 49E,1477.0
,,128 606,,,Cheque,,RELNS,BRUT 1 8e,130083.0
,,5,,,Cheque,,RELNS,ReMISE,130088.0
,,24,,,Cheque,,RELNS,BRUT 202,130112.0
,,03,,,Cheque,,RELNS,"CoM 0,62E M80016/163163 28/03",130115.0
,,501 826,,,Cheque,,RELNS,ReMISE,631941.0
,,0,,,Cheque,,RELNS,Cou Oo7E,631941.0
,,24,,,Cheque,,RELNS,ReMISE,631965.0
,,03,,,Cheque,,RELNS,BRUT 124 38e,631968.0
,,23,,,Cheque,,RELNS,38E MBooo8 163331,631991.0
,,24,,,Cheque,,RELNS,BRUT,632015.0
,,03,,,Cheque,,RELNS,Ye CoH,632018.0
,,24,,,Cheque,,RELNS,Cheque RELEVE,632042.0
,,03,,,Cheque,,RELNS,DATE DaTE OPERATION VALEUR,632045.0
,,25,,,Cheque,,RELNS,Franche-Conté,632070.0
,,03,,,Cheque,,RELNS,QOMIE,632073.0
,,50,,,Cheque,,RELNS,Bd0le Iremoulle,632123.0
,,401,,,Cheque,,RELNS,Coer F CCP Dion,632524.0
,,0,,,Cheque,,RELNS,CCBPFFPPOMI 01s,632524.0
,,25,,,Cheque,,RELNS,,632549.0
,,03,,,Cheque,,RELNS,,632552.0
,,147,,,Cheque,,RELNS,,632699.0
,,0,,,Cheque,,RELNS,,632699.0
,,25,,,Cheque,,RELNS,,632724.0
,,03,,,Cheque,,RELNS,,632727.0
,,25,,,Cheque,,RELNS,,632752.0
,,03,,,Cheque,,RELNS,,632755.0
,,25,,,Cheque,,RELNS,,632780.0
,,03,,,Cheque,,RELNS,,632783.0
,,1,,,Cheque,,RELNS,,632784.0
,,00,,,Cheque,,RELNS,,632784.0
,,26,,,Cheque,,RELNS,,632810.0
,,03,,,Cheque,,RELNS,,632813.0
,,202,,,Cheque,,RELNS,,633015.0
,,0,,,Cheque,,RELNS,,633015.0
,,28,,,Cheque,,RELNS,,633043.0
,,03,,,Cheque,,RELNS,,633046.0
,,456,,,Cheque,,RELNS,,633502.0
,,0,,,Cheque,,RELNS,,633502.0
,,28,,,Cheque,,RELNS,,633530.0
,,03,,,Cheque,,RELNS,,633533.0
,,28,,,Cheque,,RELNS,,633561.0
,,03,,,Cheque,,RELNS,,633564.0
,,124,,,Cheque,,RELNS,,633688.0
,,0,,,Cheque,,RELNS,,633688.0
,,28,,,Cheque,,RELNS,,633716.0
,,03,,,Cheque,,RELNS,,633719.0
,,"747,396",,,Cheque,,RELNS,,1381115.0
,,28,,,Cheque,,RELNS,,1381143.0
,,03,,,Cheque,,RELNS,,1381146.0
,,50,,,Cheque,,RELNS,,1381196.0
,,6,,,Cheque,,RELNS,,1381202.0
,,28,,,Cheque,,RELNS,,1381230.0
,,03,,,Cheque,,RELNS,,1381233.0
,,2,,,Cheque,,RELNS,,1381235.0
,,31,,,Cheque,,RELNS,,1381266.0
,,03,,,Cheque,,RELNS,,1381269.0
,,"3 629,70",,,Cheque,,RELNS,,1744239.0
,,23,,,Cheque,,RELNS,,1744262.0
,,03,,,Cheque,,RELNS,,1744265.0
,,22,,,Cheque,,RELNS,,1744287.0
,,03,,,Cheque,,RELNS,,1744290.0
,,"481,17",,,Cheque,,RELNS,,1792407.0
,,22,,,Cheque,,RELNS,,1792429.0
,,03,,,Cheque,,RELNS,,1792432.0
,,"240,45",,,Cheque,,RELNS,,1816477.0
,,22,,,Cheque,,RELNS,,1816499.0
,,03,,,Cheque,,RELNS,,1816502.0
,,"4,49",,,Cheque,,RELNS,,1816951.0
,,21,,,Cheque,,RELNS,,1816972.0
,,03 21,,,Cheque,,RELNS,,1817293.0
,,03 35,,,Cheque,,RELNS,,1817628.0
,,60,,,Cheque,,RELNS,,1817688.0
,,23,,,Cheque,,RELNS,,1817711.0
,,03 85,,,Cheque,,RELNS,,1818096.0
,,30,,,Cheque,,RELNS,,1818126.0
,,23,,,Cheque,,RELNS,,1818149.0
,,03 23,,,Cheque,,RELNS,,1818472.0
,,03,,,Cheque,,RELNS,,1818475.0
,,"1,90",,,Cheque,,RELNS,,1818665.0
,,23,,,Cheque,,RELNS,,1818688.0
,,03 23,,,Cheque,,RELNS,,1819011.0
,,03 23,,,Cheque,,RELNS,,1819334.0
,,03 23,,,Cheque,,RELNS,,1819657.0
,,03 006 30,,,Cheque,,RELNS,,2120287.0
,,"128,19",,,Cheque,,RELNS,,2133106.0
,,8,,,Cheque,,RELNS,,2133114.0
,,24,,,Cheque,,RELNS,,2133138.0
,,03 24,,,Cheque,,RELNS,,2133462.0
,,03 501 82,,,Cheque,,RELNS,,2483644.0
,,24,,,Cheque,,RELNS,,2483668.0
,,03 24,,,Cheque,,RELNS,,2483992.0
,,03,,,Cheque,,RELNS,,2483995.0
,,24,,,Cheque,,RELNS,,2484019.0
,,03 24,,,Cheque,,RELNS,,2484343.0
,,"03 400,00",,,Cheque,,RELNS,,2824343.0
,,24,,,Cheque,,RELNS,,2824367.0
,,03 24,,,Cheque,,RELNS,,2824691.0
,,"03 600,00",,,Cheque,,RELNS,,3184691.0
,,"401,46",,,Cheque,,RELNS,,3224837.0
,,24,,,Cheque,,RELNS,,3224861.0
,,03 24,,,Cheque,,RELNS,,3225185.0
,,03,,,Cheque,,RELNS,,3225188.0
,,24,,,Cheque,,RELNS,,3225212.0
,,03 24,,,Cheque,,RELNS,,3225536.0
,,"03 147,26",,,Cheque,,RELNS,,3540262.0
,,24,,,Cheque,,RELNS,,3540286.0
,,03 24,,,Cheque,,RELNS,,3540610.0
,,03 285,,,Cheque,,RELNS,,3543895.0
,,24,,,Cheque,,RELNS,,3543919.0
,,03 24,,,Cheque,,RELNS,,3544243.0
,,03,,,Cheque,,RELNS,,3544246.0
,,"4,48",,,Cheque,,RELNS,,3544694.0
,,25,,,Cheque,,RELNS,,3544719.0
,,03 25,,,Cheque,,RELNS,,3545044.0
,,03,,,Cheque,,RELNS,,3545047.0
,,"1,80",,,Cheque,,RELNS,,3545227.0
,,8,,,Cheque,,RELNS,,3545235.0
,,25,,,Cheque,,RELNS,,3545260.0
,,03 25,,,Cheque,,RELNS,,3545585.0
,,"03 201,45",,,Cheque,,RELNS,,3865730.0
,,8,,,Cheque,,RELNS,,3865738.0
,,28,,,Cheque,,RELNS,,3865766.0
,,03 28,,,Cheque,,RELNS,,3866094.0
,,"03 456,07",,,Cheque,,RELNS,,4211701.0
,,28,,,Cheque,,RELNS,,4211729.0
,,03 28,,,Cheque,,RELNS,,4212057.0
,,03 22,,,Cheque,,RELNS,,4212379.0
,,33,,,Cheque,,RELNS,,4212412.0
,,28,,,Cheque,,RELNS,,4212440.0
,,03 28,,,Cheque,,RELNS,,4212768.0
,,"03 123,98",,,Cheque,,RELNS,,4525166.0
,,28,,,Cheque,,RELNS,,4525194.0
,,03 28,,,Cheque,,RELNS,,4525522.0
,,"03 747,39",,,Cheque,,RELNS,,4900261.0
,,28,,,Cheque,,RELNS,,4900289.0
,,03 28,,,Cheque,,RELNS,,4900617.0
,,03,,,Cheque,,RELNS,,4900620.0
,,"6,42",,,Cheque,,RELNS,,4901262.0
,,28,,,Cheque,,RELNS,,4901290.0
,,03 28,,,Cheque,,RELNS,,4901618.0
,,03,,,Cheque,,RELNS,,4901621.0
,,7,,,Cheque,,RELNS,,4901628.0
,,0,,,Cheque,,RELNS,,4901628.0
,,25,,,Cheque,,RELNS,,4901653.0
,,14,,,Cheque,,RELNS,,4901667.0
,,07,,,Cheque,,RELNS,,4901674.0
31/10/2019,,9,,,Credit,,Mall magale sevin@nvesparis banquepopulaire t RELEVE N 9,BANQUE POPULAIRE +X,9.0
01/12/2019,,31,,,Credit,,Mall magale sevin@nvesparis banquepopulaire t RELEVE N 9,MAGALIE,40.0
30/09/2019,,10,,,Credit,,Mall magale sevin@nvesparis banquepopulaire t RELEVE N 9,DOURDAN 6 RUE,50.0
,,6,,,Credit,,Mall magale sevin@nvesparis banquepopulaire t RELEVE N 9,OUFAUBOURG DE CHARTRES,56.0
,,01 70,,,Credit,,Mall magale sevin@nvesparis banquepopulaire t RELEVE N 9,DoURON,226.0
,,91 98,,,Credit,,Mall magale sevin@nvesparis banquepopulaire t RELEVE N 9,Far:01,9424.0
,,34,,,Credit,,Mall magale sevin@nvesparis banquepopulaire t RELEVE N 9,Cyberplus Identhant,9458.0
,,01 80,,,Credit,,Mall magale sevin@nvesparis banquepopulaire t RELEVE N 9,TONALITE,9638.0
,,36,,,Credit,,Mall magale sevin@nvesparis banquepopulaire t RELEVE N 9,SERVCE,9674.0
,,892 092,,,Credit,,Mall magale sevin@nvesparis banquepopulaire t RELEVE N 9,PRix Appel,901766.0
,,0,,,Credit,,Mall magale sevin@nvesparis banquepopulaire t RELEVE N 9,LE MARCHE DE GARLANDE,901766.0
,,6 11,,,Credit,,Mall magale sevin@nvesparis banquepopulaire t RELEVE N 9,NOTRE,902377.0
,,10,,,Credit,,Mall magale sevin@nvesparis banquepopulaire t RELEVE N 9,METTONS A VOTRE DISPOSITION A COMPTER DU,902387.0
,,01,,,Credit,,Mall magale sevin@nvesparis banquepopulaire t RELEVE N 9,DANS TOUTES NOS,902388.0
,,12,,,Credit,,Mall magale sevin@nvesparis banquepopulaire t RELEVE N 9,TARIFAIRES APPLICABLES,902400.0
,,8,,,Credit,,Mall magale sevin@nvesparis banquepopulaire t RELEVE N 9,LE MARCHE DE GARLANDE BIC,902408.0
,,859,,,Credit,,Mall magale sevin@nvesparis banquepopulaire t RELEVE N 9,DaTE,903267.0
,,"300,96",,,Credit,,Mall magale sevin@nvesparis banquepopulaire t RELEVE N 9,DATE DaTE,933363.0
,,"48,19",,,Credit,,Mall magale sevin@nvesparis banquepopulaire t RELEVE N 9,UBELLEREFERENCE,938182.0
,,30,,,Credit,,Mall magale sevin@nvesparis banquepopulaire t RELEVE N 9,Cou O3E,938212.0
,,09,,,Credit,,Mall magale sevin@nvesparis banquepopulaire t RELEVE N 9,C8 5142949015,938221.0
,,48,,,Credit,,Mall magale sevin@nvesparis banquepopulaire t RELEVE N 9,M80005,938269.0
,,136,,,Credit,,Mall magale sevin@nvesparis banquepopulaire t RELEVE N 9,LLOY,938405.0
,,0,,,Credit,,Mall magale sevin@nvesparis banquepopulaire t RELEVE N 9,MoiS,938405.0
,,35,,,Credit,,Mall magale sevin@nvesparis banquepopulaire t RELEVE N 9,SEPTEMBRE 2019 HT 35 I/IVAZ0 0O,938440.0
,,703,,,Credit,,Mall magale sevin@nvesparis banquepopulaire t RELEVE N 9,CLT38JO ElECERC,939143.0
,,92,,,Credit,,Mall magale sevin@nvesparis banquepopulaire t RELEVE N 9,ChATILLO,939235.0
,,0,,,Credit,,Mall magale sevin@nvesparis banquepopulaire t RELEVE N 9,LCR DoMiCILIeE,939235.0
,,380,,,Credit,,Mall magale sevin@nvesparis banquepopulaire t RELEVE N 9,REMISE,939615.0
,,2,,,Credit,,Mall magale sevin@nvesparis banquepopulaire t RELEVE N 9,Cou 2,939617.0
,,173 886,,,Credit,,Mall magale sevin@nvesparis banquepopulaire t RELEVE N 9,ChEQUE 0000186 CHEQUE 0000185,1113503.0
,,146,,,Credit,,Mall magale sevin@nvesparis banquepopulaire t RELEVE N 9,Co 2e 180013164397,1113649.0
,,03,,,Credit,,Mall magale sevin@nvesparis banquepopulaire t RELEVE N 9,CoM 102E,1113652.0
,,10,,,Credit,,Mall magale sevin@nvesparis banquepopulaire t RELEVE N 9,DOUROA/ OCV REMISE,1113662.0
,,01,,,Credit,,Mall magale sevin@nvesparis banquepopulaire t RELEVE N 9,CHEQUES,1113663.0
,,10 01,,,Credit,,Mall magale sevin@nvesparis banquepopulaire t RELEVE N 9,ReM Cho,1114664.0
,,10 01,,,Credit,,Mall magale sevin@nvesparis banquepopulaire t RELEVE N 9,ChEquE 0000187,1115665.0
,,10 01,,,Credit,,Mall magale sevin@nvesparis banquepopulaire t RELEVE N 9,Banque Populaire Rives,1116666.0
,,10 01,,,Credit,,Mall magale sevin@nvesparis banquepopulaire t RELEVE N 9,Paris,1117667.0
,,10 01,,,Credit,,Mall magale sevin@nvesparis banquepopulaire t RELEVE N 9,Aswna sousk,1118668.0
,,10 135 25,,,Credit,,Mall magale sevin@nvesparis banquepopulaire t RELEVE N 9,Sko sai 11 ano fino,2132193.0
,,01,,,Credit,,Mall magale sevin@nvesparis banquepopulaire t RELEVE N 9,pouZ(Poulor,2132194.0
,,10 01,,,Credit,,Mall magale sevin@nvesparis banquepopulaire t RELEVE N 9,Pourlo,2133195.0
,,10 01,,,Credit,,Mall magale sevin@nvesparis banquepopulaire t RELEVE N 9,Sltelntna,2134196.0
,,10 42,,,Credit,,Mall magale sevin@nvesparis banquepopulaire t RELEVE N 9,,2135238.0
,,17 01,,,Credit,,Mall magale sevin@nvesparis banquepopulaire t RELEVE N 9,,2136939.0
,,10 01,,,Credit,,Mall magale sevin@nvesparis banquepopulaire t RELEVE N 9,,2137940.0
,,10 01,,,Credit,,Mall magale sevin@nvesparis banquepopulaire t RELEVE N 9,,2138941.0
,,"10 278,18",,,Credit,,Mall magale sevin@nvesparis banquepopulaire t RELEVE N 9,,3166759.0
,,02,,,Credit,,Mall magale sevin@nvesparis banquepopulaire t RELEVE N 9,,3166761.0
,,10 02,,,Credit,,Mall magale sevin@nvesparis banquepopulaire t RELEVE N 9,,3167763.0
,,10 02,,,Credit,,Mall magale sevin@nvesparis banquepopulaire t RELEVE N 9,,3168765.0
,,10 02,,,Credit,,Mall magale sevin@nvesparis banquepopulaire t RELEVE N 9,,3169767.0
,,10 01,,,Credit,,Mall magale sevin@nvesparis banquepopulaire t RELEVE N 9,,3170768.0
,,10 02,,,Credit,,Mall magale sevin@nvesparis banquepopulaire t RELEVE N 9,,3171770.0
,,10,,,Credit,,Mall magale sevin@nvesparis banquepopulaire t RELEVE N 9,,3171780.0
,,"2 152,53",,,Credit,,Mall magale sevin@nvesparis banquepopulaire t RELEVE N 9,,3387033.0
,,"91,53",,,Credit,,Mall magale sevin@nvesparis banquepopulaire t RELEVE N 9,,3396186.0
,,02,,,Credit,,Mall magale sevin@nvesparis banquepopulaire t RELEVE N 9,,3396188.0
,,10 02,,,Credit,,Mall magale sevin@nvesparis banquepopulaire t RELEVE N 9,,3397190.0
,,10 02,,,Credit,,Mall magale sevin@nvesparis banquepopulaire t RELEVE N 9,,3398192.0
,,"10 377,79",,,Credit,,Mall magale sevin@nvesparis banquepopulaire t RELEVE N 9,,4435971.0
,,9 02,,,Credit,,Mall magale sevin@nvesparis banquepopulaire t RELEVE N 9,,4436873.0
,,10 02,,,Credit,,Mall magale sevin@nvesparis banquepopulaire t RELEVE N 9,,4437875.0
,,10 03,,,Credit,,Mall magale sevin@nvesparis banquepopulaire t RELEVE N 9,,4438878.0
,,10 02,,,Credit,,Mall magale sevin@nvesparis banquepopulaire t RELEVE N 9,,4439880.0
,,10 02,,,Credit,,Mall magale sevin@nvesparis banquepopulaire t RELEVE N 9,,4440882.0
,,10 03,,,Credit,,Mall magale sevin@nvesparis banquepopulaire t RELEVE N 9,,4441885.0
,,10 02,,,Credit,,Mall magale sevin@nvesparis banquepopulaire t RELEVE N 9,,4442887.0
,,10 02,,,Credit,,Mall magale sevin@nvesparis banquepopulaire t RELEVE N 9,,4443889.0
,,10 03,,,Credit,,Mall magale sevin@nvesparis banquepopulaire t RELEVE N 9,,4444892.0
,,10 26,,,Credit,,Mall magale sevin@nvesparis banquepopulaire t RELEVE N 9,,4445918.0
,,00 26,,,Credit,,Mall magale sevin@nvesparis banquepopulaire t RELEVE N 9,,4445944.0
,,00 172.64,,,Credit,,Mall magale sevin@nvesparis banquepopulaire t RELEVE N 9,,4446116.64
,,03,,,Credit,,Mall magale sevin@nvesparis banquepopulaire t RELEVE N 9,,4446119.64
,,10 03,,,Credit,,Mall magale sevin@nvesparis banquepopulaire t RELEVE N 9,,4447122.64
,,10 03,,,Credit,,Mall magale sevin@nvesparis banquepopulaire t RELEVE N 9,,4448125.64
,,"10 145,44",,,Credit,,Mall magale sevin@nvesparis banquepopulaire t RELEVE N 9,,5462669.64
,,03,,,Credit,,Mall magale sevin@nvesparis banquepopulaire t RELEVE N 9,,5462672.64
,,10 03,,,Credit,,Mall magale sevin@nvesparis banquepopulaire t RELEVE N 9,,5463675.64
,,10 03,,,Credit,,Mall magale sevin@nvesparis banquepopulaire t RELEVE N 9,,5464678.64
,,"10 550,00",,,Credit,,Mall magale sevin@nvesparis banquepopulaire t RELEVE N 9,,6519678.64
,,03,,,Credit,,Mall magale sevin@nvesparis banquepopulaire t RELEVE N 9,,6519681.64
,,10 03,,,Credit,,Mall magale sevin@nvesparis banquepopulaire t RELEVE N 9,,6520684.64
,,10 02,,,Credit,,Mall magale sevin@nvesparis banquepopulaire t RELEVE N 9,,6521686.64
,,10 03,,,Credit,,Mall magale sevin@nvesparis banquepopulaire t RELEVE N 9,,6522689.64
,,"10 260,26",,,Credit,,Mall magale sevin@nvesparis banquepopulaire t RELEVE N 9,,7548715.64
,,02,,,Credit,,Mall magale sevin@nvesparis banquepopulaire t RELEVE N 9,,7548717.64
,,10 02,,,Credit,,Mall magale sevin@nvesparis banquepopulaire t RELEVE N 9,,7549719.64
,,"10 629,64",,,Credit,,Mall magale sevin@nvesparis banquepopulaire t RELEVE N 9,,8612683.64
,,0,,,Credit,,Mall magale sevin@nvesparis banquepopulaire t RELEVE N 9,,8612683.64
,,11,,,Credit,,Mall magale sevin@nvesparis banquepopulaire t RELEVE N 9,,8612694.64
,,75,,,Credit,,Mall magale sevin@nvesparis banquepopulaire t RELEVE N 9,,8612769.64
,,004,,,Credit,,Mall magale sevin@nvesparis banquepopulaire t RELEVE N 9,,8612773.64
,,151,,,Credit,,Mall magale sevin@nvesparis banquepopulaire t RELEVE N 9,,8612924.64
,,0,,,Credit,,Mall magale sevin@nvesparis banquepopulaire t RELEVE N 9,,8612924.64
29/11/2019,,10,,,Debit,,Mall magale sevin@nvesparis banquepopulaire tr RELEVE,BANQUE POPULAIRE +X,10.0
31/10/2019,,29,,,Debit,,Mall magale sevin@nvesparis banquepopulaire tr RELEVE,MAGALIE,39.0
,,11,,,Debit,,Mall magale sevin@nvesparis banquepopulaire tr RELEVE,N 10 AU,50.0
,,6,,,Debit,,Mall magale sevin@nvesparis banquepopulaire tr RELEVE,OUFAUBOURG DE CHARTRES,56.0
,,01,,,Debit,,Mall magale sevin@nvesparis banquepopulaire tr RELEVE,DoURON,57.0
,,98 34,,,Debit,,Mall magale sevin@nvesparis banquepopulaire tr RELEVE,Far:01,9891.0
,,01 80,,,Debit,,Mall magale sevin@nvesparis banquepopulaire tr RELEVE,Cyberplus Identhant,10071.0
,,36,,,Debit,,Mall magale sevin@nvesparis banquepopulaire tr RELEVE,TONALITE,10107.0
,,892 092,,,Debit,,Mall magale sevin@nvesparis banquepopulaire tr RELEVE,SERVCE,902199.0
,,0,,,Debit,,Mall magale sevin@nvesparis banquepopulaire tr RELEVE,PRix Appel,902199.0
,,6 11,,,Debit,,Mall magale sevin@nvesparis banquepopulaire tr RELEVE,LE MARCHE DE GARLANDE,902810.0
,,10,,,Debit,,Mall magale sevin@nvesparis banquepopulaire tr RELEVE,LE MARCHE DE GARLANDE,902820.0
,,859,,,Debit,,Mall magale sevin@nvesparis banquepopulaire tr RELEVE,DaTE,903679.0
,,8,,,Debit,,Mall magale sevin@nvesparis banquepopulaire tr RELEVE,DATE DaTE,903687.0
,,"398,37",,,Debit,,Mall magale sevin@nvesparis banquepopulaire tr RELEVE,UBELLEREFERENCE,943524.0
,,"42,17",,,Debit,,Mall magale sevin@nvesparis banquepopulaire tr RELEVE,DEBITEUR AU,947741.0
,,31,,,Debit,,Mall magale sevin@nvesparis banquepopulaire tr RELEVE,LLOY,947772.0
,,10,,,Debit,,Mall magale sevin@nvesparis banquepopulaire tr RELEVE,TPEELC,947782.0
,,01,,,Debit,,Mall magale sevin@nvesparis banquepopulaire tr RELEVE,MOIS,947783.0
,,11,,,Debit,,Mall magale sevin@nvesparis banquepopulaire tr RELEVE,TVA200,947794.0
,,35,,,Debit,,Mall magale sevin@nvesparis banquepopulaire tr RELEVE,REMISE,947829.0
,,"7,03",,,Debit,,Mall magale sevin@nvesparis banquepopulaire tr RELEVE,CoM,948532.0
,,04,,,Debit,,Mall magale sevin@nvesparis banquepopulaire tr RELEVE,REMISE,948536.0
,,11,,,Debit,,Mall magale sevin@nvesparis banquepopulaire tr RELEVE,REMISE C8 5142949015,948547.0
,,142,,,Debit,,Mall magale sevin@nvesparis banquepopulaire tr RELEVE,Cou,948689.0
,,04,,,Debit,,Mall magale sevin@nvesparis banquepopulaire tr RELEVE,PRELEVEMENT CMR000o78008o01 PRLV SEPAPROXIMY,948693.0
,,11,,,Debit,,Mall magale sevin@nvesparis banquepopulaire tr RELEVE,M8o010,948704.0
,,228,,,Debit,,Mall magale sevin@nvesparis banquepopulaire tr RELEVE,Se CoM 1,948932.0
,,1,,,Debit,,Mall magale sevin@nvesparis banquepopulaire tr RELEVE,REMISE,948933.0
,,04,,,Debit,,Mall magale sevin@nvesparis banquepopulaire tr RELEVE,ReMCHho,948937.0
,,11,,,Debit,,Mall magale sevin@nvesparis banquepopulaire tr RELEVE,CB*-*7366 EG1EOFG,948948.0
,,314,,,Debit,,Mall magale sevin@nvesparis banquepopulaire tr RELEVE,DUFER,949262.0
,,2,,,Debit,,Mall magale sevin@nvesparis banquepopulaire tr RELEVE,LARU,949264.0
,,04,,,Debit,,Mall magale sevin@nvesparis banquepopulaire tr RELEVE,Eg1EOFH,949268.0
,,11,,,Debit,,Mall magale sevin@nvesparis banquepopulaire tr RELEVE,Rem,949279.0
,,573,,,Debit,,Mall magale sevin@nvesparis banquepopulaire tr RELEVE,LARU,949852.0
,,04,,,Debit,,Mall magale sevin@nvesparis banquepopulaire tr RELEVE,CB;- 7366,949856.0
,,11,,,Debit,,Mall magale sevin@nvesparis banquepopulaire tr RELEVE,SAlEDELAS,949867.0
,,04,,,Debit,,Mall magale sevin@nvesparis banquepopulaire tr RELEVE,LARU,949871.0
,,11,,,Debit,,Mall magale sevin@nvesparis banquepopulaire tr RELEVE,E61EOFJ,949882.0
,,51,,,Debit,,Mall magale sevin@nvesparis banquepopulaire tr RELEVE,ChAtilLo,949933.0
,,04,,,Debit,,Mall magale sevin@nvesparis banquepopulaire tr RELEVE,Banque Populaire Rives,949937.0
,,11,,,Debit,,Mall magale sevin@nvesparis banquepopulaire tr RELEVE,Paris,949948.0
,,04,,,Debit,,Mall magale sevin@nvesparis banquepopulaire tr RELEVE,Aswna sousk,949952.0
,,11,,,Debit,,Mall magale sevin@nvesparis banquepopulaire tr RELEVE,Sko sai 11 ano fino,949963.0
,,189,,,Debit,,Mall magale sevin@nvesparis banquepopulaire tr RELEVE,Po ueleclamnion umua,950152.0
,,1,,,Debit,,Mall magale sevin@nvesparis banquepopulaire tr RELEVE,Yous pouZ(poulor,950153.0
,,01,,,Debit,,Mall magale sevin@nvesparis banquepopulaire tr RELEVE,Mos coah,950154.0
,,11,,,Debit,,Mall magale sevin@nvesparis banquepopulaire tr RELEVE,Pourlo,950165.0
,,6,,,Debit,,Mall magale sevin@nvesparis banquepopulaire tr RELEVE,Slteintna @ncoay,950171.0
,,04,,,Debit,,Mall magale sevin@nvesparis banquepopulaire tr RELEVE,Madaa CS,950175.0
,,11,,,Debit,,Mall magale sevin@nvesparis banquepopulaire tr RELEVE,,950186.0
,,04,,,Debit,,Mall magale sevin@nvesparis banquepopulaire tr RELEVE,,950190.0
,,11,,,Debit,,Mall magale sevin@nvesparis banquepopulaire tr RELEVE,,950201.0
,,04,,,Debit,,Mall magale sevin@nvesparis banquepopulaire tr RELEVE,,950205.0
,,11,,,Debit,,Mall magale sevin@nvesparis banquepopulaire tr RELEVE,,950216.0
,,04,,,Debit,,Mall magale sevin@nvesparis banquepopulaire tr RELEVE,,950220.0
,,11,,,Debit,,Mall magale sevin@nvesparis banquepopulaire tr RELEVE,,950231.0
,,04,,,Debit,,Mall magale sevin@nvesparis banquepopulaire tr RELEVE,,950235.0
,,11,,,Debit,,Mall magale sevin@nvesparis banquepopulaire tr RELEVE,,950246.0
,,01,,,Debit,,Mall magale sevin@nvesparis banquepopulaire tr RELEVE,,950247.0
,,11 01,,,Debit,,Mall magale sevin@nvesparis banquepopulaire tr RELEVE,,951348.0
,,11 09,,,Debit,,Mall magale sevin@nvesparis banquepopulaire tr RELEVE,,952457.0
,,11 04,,,Debit,,Mall magale sevin@nvesparis banquepopulaire tr RELEVE,,953561.0
,,"11 141,23",,,Debit,,Mall magale sevin@nvesparis banquepopulaire tr RELEVE,,2067684.0
,,04,,,Debit,,Mall magale sevin@nvesparis banquepopulaire tr RELEVE,,2067688.0
,,11 04,,,Debit,,Mall magale sevin@nvesparis banquepopulaire tr RELEVE,,2068792.0
,,"11 226,70",,,Debit,,Mall magale sevin@nvesparis banquepopulaire tr RELEVE,,3191462.0
,,11 04,,,Debit,,Mall magale sevin@nvesparis banquepopulaire tr RELEVE,,3192566.0
,,11,,,Debit,,Mall magale sevin@nvesparis banquepopulaire tr RELEVE,,3192577.0
,,04,,,Debit,,Mall magale sevin@nvesparis banquepopulaire tr RELEVE,,3192581.0
,,11 04,,,Debit,,Mall magale sevin@nvesparis banquepopulaire tr RELEVE,,3193685.0
,,11 569 77,,,Debit,,Mall magale sevin@nvesparis banquepopulaire tr RELEVE,,4350662.0
,,04,,,Debit,,Mall magale sevin@nvesparis banquepopulaire tr RELEVE,,4350666.0
,,11 04,,,Debit,,Mall magale sevin@nvesparis banquepopulaire tr RELEVE,,4351770.0
,,"11 218,74",,,Debit,,Mall magale sevin@nvesparis banquepopulaire tr RELEVE,,5473644.0
,,04,,,Debit,,Mall magale sevin@nvesparis banquepopulaire tr RELEVE,,5473648.0
,,11 04,,,Debit,,Mall magale sevin@nvesparis banquepopulaire tr RELEVE,,5474752.0
,,11 18,,,Debit,,Mall magale sevin@nvesparis banquepopulaire tr RELEVE,,5475870.0
,,54,,,Debit,,Mall magale sevin@nvesparis banquepopulaire tr RELEVE,,5475924.0
,,8,,,Debit,,Mall magale sevin@nvesparis banquepopulaire tr RELEVE,,5475932.0
,,8 04,,,Debit,,Mall magale sevin@nvesparis banquepopulaire tr RELEVE,,5476736.0
,,11 04,,,Debit,,Mall magale sevin@nvesparis banquepopulaire tr RELEVE,,5477840.0
,,"11 117,94",,,Debit,,Mall magale sevin@nvesparis banquepopulaire tr RELEVE,,6589634.0
,,04,,,Debit,,Mall magale sevin@nvesparis banquepopulaire tr RELEVE,,6589638.0
,,11 04,,,Debit,,Mall magale sevin@nvesparis banquepopulaire tr RELEVE,,6590742.0
,,"11 188,21",,,Debit,,Mall magale sevin@nvesparis banquepopulaire tr RELEVE,,7709563.0
,,01,,,Debit,,Mall magale sevin@nvesparis banquepopulaire tr RELEVE,,7709564.0
,,11 05,,,Debit,,Mall magale sevin@nvesparis banquepopulaire tr RELEVE,,7710669.0
,,"11 333,42",,,Debit,,Mall magale sevin@nvesparis banquepopulaire tr RELEVE,,8844011.0
,,04,,,Debit,,Mall magale sevin@nvesparis banquepopulaire tr RELEVE,,8844015.0
,,11 01,,,Debit,,Mall magale sevin@nvesparis banquepopulaire tr RELEVE,,8845116.0
,,11 04,,,Debit,,Mall magale sevin@nvesparis banquepopulaire tr RELEVE,,8846220.0
,,11 04,,,Debit,,Mall magale sevin@nvesparis banquepopulaire tr RELEVE,,8847324.0
,,"11 358,34",,,Debit,,Mall magale sevin@nvesparis banquepopulaire tr RELEVE,,9983158.0
,,"56,72",,,Debit,,Mall magale sevin@nvesparis banquepopulaire tr RELEVE,,9988830.0
,,04,,,Debit,,Mall magale sevin@nvesparis banquepopulaire tr RELEVE,,9988834.0
,,11 04,,,Debit,,Mall magale sevin@nvesparis banquepopulaire tr RELEVE,,9989938.0
,,11 65,,,Debit,,Mall magale sevin@nvesparis banquepopulaire tr RELEVE,,9991103.0
,,16 86,,,Debit,,Mall magale sevin@nvesparis banquepopulaire tr RELEVE,,9992789.0
,,11 01,,,Debit,,Mall magale sevin@nvesparis banquepopulaire tr RELEVE,,9993890.0
,,11 04,,,Debit,,Mall magale sevin@nvesparis banquepopulaire tr RELEVE,,9994994.0
,,11 04,,,Debit,,Mall magale sevin@nvesparis banquepopulaire tr RELEVE,,9996098.0
,,11 04,,,Debit,,Mall magale sevin@nvesparis banquepopulaire tr RELEVE,,9997202.0
,,"11 561,20",,,Debit,,Mall magale sevin@nvesparis banquepopulaire tr RELEVE,,11153322.0
,,0,,,Debit,,Mall magale sevin@nvesparis banquepopulaire tr RELEVE,,11153322.0
,,11,,,Debit,,Mall magale sevin@nvesparis banquepopulaire tr RELEVE,,11153333.0
,,75,,,Debit,,Mall magale sevin@nvesparis banquepopulaire tr RELEVE,,11153408.0
,,0,,,Debit,,Mall magale sevin@nvesparis banquepopulaire tr RELEVE,,11153408.0
21.02.2020,,21.02,,,Credit,,Banque Indicatif,LCL RELEVE DE COMPTE,21.02
28.02.2020,,28.02,,,Credit,,Banque Indicatif,D'IDENTITE,49.04
,,282,,,Credit,,Banque Indicatif,BICETRE,331.04
,,58,,,Credit,,Banque Indicatif,MONS,389.04
,,12,,,Credit,,Banque Indicatif,MONSIEUR AMOKRANE,401.04
,,50,,,Credit,,Banque Indicatif,BICETRE,451.04
,,01 46,,,Credit,,Banque Indicatif,Reférences bancaires nationales,597.04
,,70 13,,,Credit,,Banque Indicatif,Cle,7610.04
,,21,,,Credit,,Banque Indicatif,T 50 References bancaires internationales,7631.04
,,14,,,Credit,,Banque Indicatif,OOOO,7645.04
,,"39,50",,,Credit,,Banque Indicatif,7121 T5O,11595.04
,,"40,30",,,Credit,,Banque Indicatif,NICOLAS JULIEN,15625.04
,,20.02,,,Credit,,Banque Indicatif,votre Identifiant,15645.060000000001
,,"16 656,89",,,Credit,,Banque Indicatif,Internet wwW,1681334.06
,,25.02,,,Credit,,Banque Indicatif,Mobile,1681359.08
,,26.02,,,Credit,,Banque Indicatif,Mes Comptes Nous,1681385.1
,,27.02,,,Credit,,Banque Indicatif,Ier,1681412.12
,,28 02,,,Credit,,Banque Indicatif,ZEN PRO,1684214.12
,,25.02,,,Credit,,Banque Indicatif,ECRITURES DE LA PERIODE DATE,1684239.1400000001
,,20 27,,,Credit,,Banque Indicatif,VALEUR,1686266.1400000001
,,02.20,,,Credit,,Banque Indicatif,CREDIT 20.02 ANCIEN SOLDE 16,1686268.34
,,27.02,,,Credit,,Banque Indicatif,CHQ,1686295.36
,,"20 187,60",,,Credit,,Banque Indicatif,REM CHQ,3705055.3600000003
,,"483,00",,,Credit,,Banque Indicatif,OOOOOOO,3753355.3600000003
,,"359,48",,,Credit,,Banque Indicatif,995272 6916 ID Facture,3789303.3600000003
,,28.02,,,Credit,,Banque Indicatif,REF CLIENT iuOFUOApMk929952726916995217230413 ID CREANCIER FR47EDFOO10O7,3789331.3800000004
,,"20 265,67",,,Credit,,Banque Indicatif,CHQ,5815898.380000001
,,"812,75",,,Credit,,Banque Indicatif,TOTAUX,5897173.380000001
,,"17 139,89",,,Credit,,Banque Indicatif,SOLDE,7611162.380000001
,,28.02,,,Credit,,Banque Indicatif,,7611190.4
,,"16 327,14",,,Credit,,Banque Indicatif,,9243904.4
11.02.2020,,11.02,,,Credit,,LCL,Aoa7 RELEVE DE COMPTE,11.02
20.02.2020,,20.02,,,Credit,,LCL,D'IDENTITE,31.04
,,281,,,Credit,,LCL,BICETRE,312.04
,,58,,,Credit,,LCL,MONS,370.04
,,12,,,Credit,,LCL,MONSIEUR AMOKRANE,382.04
,,50,,,Credit,,LCL,BICETRE,432.04
,,10.02,,,Credit,,LCL,Cle,442.06
,,"20 170,26",,,Credit,,LCL,References,2017468.06
,,11 02,,,Credit,,LCL,FR85,2018570.06
,,14 02,,,Credit,,LCL,OOOO,2019972.06
,,20.02,,,Credit,,LCL,7121 T5O,2019992.08
,,828,,,Credit,,LCL,CREDIT 10.02 ANCIEN SOLDE,2020820.08
,,11.02,,,Credit,,LCL,CHQ,2020831.1
,,20 14,,,Credit,,LCL,CHQ,2022845.1
,,02 20,,,Credit,,LCL,DGFIP CREANCIER,2023065.1
,,20.02,,,Credit,,LCL,CLIENT 220940430700080378332 ID CREANCIER FR46ZZZ005002 REF MANDAT: ++315510958DGFIP2015OOIZCKIGINBAMA,2023085.12
,,20,,,Credit,,LCL,TOTAUX,2023105.12
,,"3 364,37",,,Credit,,LCL,SOLDE,2359542.12
,,"115,00",,,Credit,,LCL,Resolution,2371042.12
,,"34,00",,,Credit,,LCL,Dispositions generales de banque disponibles,2374442.12
,,"3 513,37",,,Credit,,LCL,,2725779.12
,,"20 170,26",,,Credit,,LCL,,4742805.12
,,20.02,,,Credit,,LCL,,4742825.14
,,"16 656,89",,,Credit,,LCL,,6408514.14
,,1,,,Credit,,LCL,,6408515.14
,,7,,,Unknown,,Banque Inconnue,cid:7)(cid:35)(cid:36,7.0
,,35,,,Unknown,,Banque Inconnue,cid:32)(cid:32)(cid:33)(cid:20)(cid:34)(cid:35)(cid:8)(cid:28)(cid:5)(cid:9)(cid:12)(cid:5)(cid:14)(cid:14)(cid:4)(cid:7)(cid:3)(cid:19,42.0
,,36,,,Unknown,,Banque Inconnue,cid:37)(cid:36)(cid:38)(cid:3)(cid:39)(cid:1)(cid:2)(cid:3)(cid:4)(cid:5)(cid:1)(cid:6)(cid:5)(cid:7)(cid:8)(cid:1)(cid:9)(cid:10)(cid:10)(cid:10)(cid:1)(cid:10)(cid:6)(cid:7)(cid:9)(cid:1)(cid:6)(cid:11)(cid:12)(cid:13)(cid:1)(cid:7)(cid:9)(cid:7)(cid:11)(cid:1)(cid:11)(cid:10)(cid:8,78.0
,,20,,,Unknown,,Banque Inconnue,,98.0
,,8,,,Unknown,,Banque Inconnue,,106.0
,,21,,,Unknown,,Banque Inconnue,,127.0
,,22,,,Unknown,,Banque Inconnue,,149.0
,,23,,,Unknown,,Banque Inconnue,,172.0
,,8,,,Unknown,,Banque Inconnue,,180.0
,,24,,,Unknown,,Banque Inconnue,,204.0
,,25,,,Unknown,,Banque Inconnue,,229.0
,,26,,,Unknown,,Banque Inconnue,,255.0
,,11,,,Unknown,,Banque Inconnue,,266.0
,,17,,,Unknown,,Banque Inconnue,,283.0
,,27,,,Unknown,,Banque Inconnue,,310.0
,,26,,,Unknown,,Banque Inconnue,,336.0
,,8,,,Unknown,,Banque Inconnue,,344.0
,,28,,,Unknown,,Banque Inconnue,,372.0
,,29,,,Unknown,,Banque Inconnue,,401.0
,,22,,,Unknown,,Banque Inconnue,,423.0
,,21,,,Unknown,,Banque Inconnue,,444.0
,,28,,,Unknown,,Banque Inconnue,,472.0
,,29,,,Unknown,,Banque Inconnue,,501.0
,,25,,,Unknown,,Banque Inconnue,,526.0
,,30,,,Unknown,,Banque Inconnue,,556.0
,,30,,,Unknown,,Banque Inconnue,,586.0
,,8,,,Unknown,,Banque Inconnue,,594.0
,,31,,,Unknown,,Banque Inconnue,,625.0
,,8,,,Unknown,,Banque Inconnue,,633.0
,,32,,,Unknown,,Banque Inconnue,,665.0
,,32,,,Unknown,,Banque Inconnue,,697.0
,,33,,,Unknown,,Banque Inconnue,,730.0
,,20,,,Unknown,,Banque Inconnue,,750.0
,,34,,,Unknown,,Banque Inconnue,,784.0
,,35,,,Unknown,,Banque Inconnue,,819.0
,,8,,,Unknown,,Banque Inconnue,,827.0
,,28,,,Unknown,,Banque Inconnue,,855.0
,,5,,,Unknown,,Banque Inconnue,,860.0
,,9,,,Unknown,,Banque Inconnue,,869.0
,,12,,,Unknown,,Banque Inconnue,,881.0
,,5,,,Unknown,,Banque Inconnue,,886.0
,,14,,,Unknown,,Banque Inconnue,,900.0
,,14,,,Unknown,,Banque Inconnue,,914.0
,,4,,,Unknown,,Banque Inconnue,,918.0
,,7,,,Unknown,,Banque Inconnue,,925.0
,,3,,,Unknown,,Banque Inconnue,,928.0
,,19,,,Unknown,,Banque Inconnue,,947.0
,,36,,,Unknown,,Banque Inconnue,,983.0
,,3,,,Unknown,,Banque Inconnue,,986.0
,,10,,,Unknown,,Banque Inconnue,,996.0
,,18,,,Unknown,,Banque Inconnue,,1014.0
,,13,,,Unknown,,Banque Inconnue,,1027.0
,,7,,,Unknown,,Banque Inconnue,,1034.0
,,37,,,Unknown,,Banque Inconnue,,1071.0
,,36,,,Unknown,,Banque Inconnue,,1107.0
,,38,,,Unknown,,Banque Inconnue,,1145.0
,,3,,,Unknown,,Banque Inconnue,,1148.0
,,39,,,Unknown,,Banque Inconnue,,1187.0
,,1,,,Unknown,,Banque Inconnue,,1188.0
,,2,,,Unknown,,Banque Inconnue,,1190.0
,,3,,,Unknown,,Banque Inconnue,,1193.0
,,4,,,Unknown,,Banque Inconnue,,1197.0
,,5,,,Unknown,,Banque Inconnue,,1202.0
,,1,,,Unknown,,Banque Inconnue,,1203.0
,,6,,,Unknown,,Banque Inconnue,,1209.0
,,5,,,Unknown,,Banque Inconnue,,1214.0
,,7,,,Unknown,,Banque Inconnue,,1221.0
,,8,,,Unknown,,Banque Inconnue,,1229.0
,,1,,,Unknown,,Banque Inconnue,,1230.0
,,9,,,Unknown,,Banque Inconnue,,1239.0
,,10,,,Unknown,,Banque Inconnue,,1249.0
,,10,,,Unknown,,Banque Inconnue,,1259.0
,,10,,,Unknown,,Banque Inconnue,,1269.0
,,1,,,Unknown,,Banque Inconnue,,1270.0
,,10,,,Unknown,,Banque Inconnue,,1280.0
,,6,,,Unknown,,Banque Inconnue,,1286.0
,,7,,,Unknown,,Banque Inconnue,,1293.0
,,9,,,Unknown,,Banque Inconnue,,1302.0
,,1,,,Unknown,,Banque Inconnue,,1303.0
,,6,,,Unknown,,Banque Inconnue,,1309.0
,,11,,,Unknown,,Banque Inconnue,,1320.0
,,12,,,Unknown,,Banque Inconnue,,1332.0
,,13,,,Unknown,,Banque Inconnue,,1345.0
,,1,,,Unknown,,Banque Inconnue,,1346.0
,,7,,,Unknown,,Banque Inconnue,,1353.0
,,9,,,Unknown,,Banque Inconnue,,1362.0
,,7,,,Unknown,,Banque Inconnue,,1369.0
,,11,,,Unknown,,Banque Inconnue,,1380.0
,,1,,,Unknown,,Banque Inconnue,,1381.0
,,11,,,Unknown,,Banque Inconnue,,1392.0
,,10,,,Unknown,,Banque Inconnue,,1402.0
,,8,,,Unknown,,Banque Inconnue,,1410.0
,,36,,,Unknown,,Banque Inconnue,,1446.0
,,37,,,Unknown,,Banque Inconnue,,1483.0
,,13,,,Unknown,,Banque Inconnue,,1496.0
,,39,,,Unknown,,Banque Inconnue,,1535.0
,,1,,,Unknown,,Banque Inconnue,,1536.0
,,14,,,Unknown,,Banque Inconnue,,1550.0
,,15,,,Unknown,,Banque Inconnue,,1565.0
,,16,,,Unknown,,Banque Inconnue,,1581.0
,,17,,,Unknown,,Banque Inconnue,,1598.0
,,2,,,Unknown,,Banque Inconnue,,1600.0
,,3,,,Unknown,,Banque Inconnue,,1603.0
,,18,,,Unknown,,Banque Inconnue,,1621.0
,,6,,,Unknown,,Banque Inconnue,,1627.0
,,19,,,Unknown,,Banque Inconnue,,1646.0
,,19,,,Unknown,,Banque Inconnue,,1665.0
,,19,,,Unknown,,Banque Inconnue,,1684.0
,,17,,,Unknown,,Banque Inconnue,,1701.0
,,5,,,Unknown,,Banque Inconnue,,1706.0
,,9,,,Unknown,,Banque Inconnue,,1715.0
,,16,,,Unknown,,Banque Inconnue,,1731.0
,,7,,,Unknown,,Banque Inconnue,,1738.0
,,19,,,Unknown,,Banque Inconnue,,1757.0
,,8,,,Unknown,,Banque Inconnue,,1765.0
,,12,,,Unknown,,Banque Inconnue,,1777.0
,,7,,,Unknown,,Banque Inconnue,,1784.0
,,19,,,Unknown,,Banque Inconnue,,1803.0
,,8,,,Unknown,,Banque Inconnue,,1811.0
,,13,,,Unknown,,Banque Inconnue,,1824.0
,,10,,,Unknown,,Banque Inconnue,,1834.0
,,3,,,Unknown,,Banque Inconnue,,1837.0
,,16,,,Unknown,,Banque Inconnue,,1853.0
,,7,,,Unknown,,Banque Inconnue,,1860.0
,,19,,,Unknown,,Banque Inconnue,,1879.0
,,8,,,Unknown,,Banque Inconnue,,1887.0
,,6,,,Unknown,,Banque Inconnue,,1893.0
,,7,,,Unknown,,Banque Inconnue,,1900.0
,,8,,,Unknown,,Banque Inconnue,,1908.0
,,37,,,Unknown,,Banque Inconnue,,1945.0
,,5,,,Unknown,,Banque Inconnue,,1950.0
,,16,,,Unknown,,Banque Inconnue,,1966.0
,,3,,,Unknown,,Banque Inconnue,,1969.0
,,7,,,Unknown,,Banque Inconnue,,1976.0
,,8,,,Unknown,,Banque Inconnue,,1984.0
,,13,,,Unknown,,Banque Inconnue,,1997.0
,,5,,,Unknown,,Banque Inconnue,,2002.0
,,14,,,Unknown,,Banque Inconnue,,2016.0
,,15,,,Unknown,,Banque Inconnue,,2031.0
,,16,,,Unknown,,Banque Inconnue,,2047.0
,,7,,,Unknown,,Banque Inconnue,,2054.0
,,8,,,Unknown,,Banque Inconnue,,2062.0
,,38,,,Unknown,,Banque Inconnue,,2100.0
,,5,,,Unknown,,Banque Inconnue,,2105.0
,,18,,,Unknown,,Banque Inconnue,,2123.0
,,16,,,Unknown,,Banque Inconnue,,2139.0
,,5,,,Unknown,,Banque Inconnue,,2144.0
,,8,,,Unknown,,Banque Inconnue,,2152.0
,,19,,,Unknown,,Banque Inconnue,,2171.0
,,5,,,Unknown,,Banque Inconnue,,2176.0
,,18,,,Unknown,,Banque Inconnue,,2194.0
,,16,,,Unknown,,Banque Inconnue,,2210.0
,,8,,,Unknown,,Banque Inconnue,,2218.0
,,13,,,Unknown,,Banque Inconnue,,2231.0
,,5,,,Unknown,,Banque Inconnue,,2236.0
,,14,,,Unknown,,Banque Inconnue,,2250.0
,,15,,,Unknown,,Banque Inconnue,,2265.0
,,10,,,Unknown,,Banque Inconnue,,2275.0
,,16,,,Unknown,,Banque Inconnue,,2291.0
,,4,,,Unknown,,Banque Inconnue,,2295.0
,,39,,,Unknown,,Banque Inconnue,,2334.0
,,12,,,Unknown,,Banque Inconnue,,2346.0
,,7,,,Unknown,,Banque Inconnue,,2353.0
,,19,,,Unknown,,Banque Inconnue,,2372.0
,,8,,,Unknown,,Banque Inconnue,,2380.0
,,10,,,Unknown,,Banque Inconnue,,2390.0
,,37,,,Unknown,,Banque Inconnue,,2427.0
,,7,,,Unknown,,Banque Inconnue,,2434.0
,,13,,,Unknown,,Banque Inconnue,,2447.0
,,8,,,Unknown,,Banque Inconnue,,2455.0
,,40,,,Unknown,,Banque Inconnue,,2495.0
,,15,,,Unknown,,Banque Inconnue,,2510.0
,,15,,,Unknown,,Banque Inconnue,,2525.0
,,12,,,Unknown,,Banque Inconnue,,2537.0
,,7,,,Unknown,,Banque Inconnue,,2544.0
,,8,,,Unknown,,Banque Inconnue,,2552.0
,,1,,,Unknown,,Banque Inconnue,,2553.0
,,10,,,Unknown,,Banque Inconnue,,2563.0
,,41,,,Unknown,,Banque Inconnue,,2604.0
,,8,,,Unknown,,Banque Inconnue,,2612.0
,,7,,,Unknown,,Banque Inconnue,,2619.0
,,16,,,Unknown,,Banque Inconnue,,2635.0
,,8,,,Unknown,,Banque Inconnue,,2643.0
,,42,,,Unknown,,Banque Inconnue,,2685.0
,,5,,,Unknown,,Banque Inconnue,,2690.0
,,5,,,Unknown,,Banque Inconnue,,2695.0
,,43,,,Unknown,,Banque Inconnue,,2738.0
,,12,,,Unknown,,Banque Inconnue,,2750.0
,,7,,,Unknown,,Banque Inconnue,,2757.0
,,8,,,Unknown,,Banque Inconnue,,2765.0
,,1,,,Unknown,,Banque Inconnue,,2766.0
,,10,,,Unknown,,Banque Inconnue,,2776.0
,,41,,,Unknown,,Banque Inconnue,,2817.0
,,44,,,Unknown,,Banque Inconnue,,2861.0
,,9,,,Unknown,,cid:16)(cid:17)(cid:16)(cid:27)(cid:28)(cid:1)(cid:29)(cid:30)(cid:28)(cid:28)(cid:31)(cid:29)(cid:27)(cid:32)(cid:33)(cid:31)(cid:1)(cid:2)(cid:3,cid:24)(cid:1)(cid:9)(cid:11)(cid:25)(cid:7)(cid:4)(cid:1)(cid:26,9.0
,,40,,,Unknown,,cid:16)(cid:17)(cid:16)(cid:27)(cid:28)(cid:1)(cid:29)(cid:30)(cid:28)(cid:28)(cid:31)(cid:29)(cid:27)(cid:32)(cid:33)(cid:31)(cid:1)(cid:2)(cid:3,,49.0
,,41,,,Unknown,,cid:16)(cid:17)(cid:16)(cid:27)(cid:28)(cid:1)(cid:29)(cid:30)(cid:28)(cid:28)(cid:31)(cid:29)(cid:27)(cid:32)(cid:33)(cid:31)(cid:1)(cid:2)(cid:3,,90.0
,,22,,,Unknown,,cid:16)(cid:17)(cid:16)(cid:27)(cid:28)(cid:1)(cid:29)(cid:30)(cid:28)(cid:28)(cid:31)(cid:29)(cid:27)(cid:32)(cid:33)(cid:31)(cid:1)(cid:2)(cid:3,,112.0
,,4,,,Unknown,,cid:16)(cid:17)(cid:16)(cid:27)(cid:28)(cid:1)(cid:29)(cid:30)(cid:28)(cid:28)(cid:31)(cid:29)(cid:27)(cid:32)(cid:33)(cid:31)(cid:1)(cid:2)(cid:3,,116.0
,,20,,,Unknown,,cid:16)(cid:17)(cid:16)(cid:27)(cid:28)(cid:1)(cid:29)(cid:30)(cid:28)(cid:28)(cid:31)(cid:29)(cid:27)(cid:32)(cid:33)(cid:31)(cid:1)(cid:2)(cid:3,,136.0
,,40,,,Unknown,,cid:16)(cid:17)(cid:16)(cid:27)(cid:28)(cid:1)(cid:29)(cid:30)(cid:28)(cid:28)(cid:31)(cid:29)(cid:27)(cid:32)(cid:33)(cid:31)(cid:1)(cid:2)(cid:3,,176.0
,,42,,,Unknown,,cid:16)(cid:17)(cid:16)(cid:27)(cid:28)(cid:1)(cid:29)(cid:30)(cid:28)(cid:28)(cid:31)(cid:29)(cid:27)(cid:32)(cid:33)(cid:31)(cid:1)(cid:2)(cid:3,,218.0
,,43,,,Unknown,,cid:16)(cid:17)(cid:16)(cid:27)(cid:28)(cid:1)(cid:29)(cid:30)(cid:28)(cid:28)(cid:31)(cid:29)(cid:27)(cid:32)(cid:33)(cid:31)(cid:1)(cid:2)(cid:3,,261.0
,,40,,,Unknown,,cid:16)(cid:17)(cid:16)(cid:27)(cid:28)(cid:1)(cid:29)(cid:30)(cid:28)(cid:28)(cid:31)(cid:29)(cid:27)(cid:32)(cid:33)(cid:31)(cid:1)(cid:2)(cid:3,,301.0
,,44,,,Unknown,,cid:16)(cid:17)(cid:16)(cid:27)(cid:28)(cid:1)(cid:29)(cid:30)(cid:28)(cid:28)(cid:31)(cid:29)(cid:27)(cid:32)(cid:33)(cid:31)(cid:1)(cid:2)(cid:3,,345.0
,,41,,,Unknown,,cid:16)(cid:17)(cid:16)(cid:27)(cid:28)(cid:1)(cid:29)(cid:30)(cid:28)(cid:28)(cid:31)(cid:29)(cid:27)(cid:32)(cid:33)(cid:31)(cid:1)(cid:2)(cid:3,,386.0
,,21,,,Unknown,,cid:16)(cid:17)(cid:16)(cid:27)(cid:28)(cid:1)(cid:29)(cid:30)(cid:28)(cid:28)(cid:31)(cid:29)(cid:27)(cid:32)(cid:33)(cid:31)(cid:1)(cid:2)(cid:3,,407.0
,,45,,,Unknown,,cid:16)(cid:17)(cid:16)(cid:27)(cid:28)(cid:1)(cid:29)(cid:30)(cid:28)(cid:28)(cid:31)(cid:29)(cid:27)(cid:32)(cid:33)(cid:31)(cid:1)(cid:2)(cid:3,,452.0
,,42,,,Unknown,,cid:16)(cid:17)(cid:16)(cid:27)(cid:28)(cid:1)(cid:29)(cid:30)(cid:28)(cid:28)(cid:31)(cid:29)(cid:27)(cid:32)(cid:33)(cid:31)(cid:1)(cid:2)(cid:3,,494.0
,,43,,,Unknown,,cid:16)(cid:17)(cid:16)(cid:27)(cid:28)(cid:1)(cid:29)(cid:30)(cid:28)(cid:28)(cid:31)(cid:29)(cid:27)(cid:32)(cid:33)(cid:31)(cid:1)(cid:2)(cid:3,,537.0
,,9,,,Unknown,,cid:16)(cid:17)(cid:16)(cid:27)(cid:28)(cid:1)(cid:29)(cid:30)(cid:28)(cid:28)(cid:31)(cid:29)(cid:27)(cid:32)(cid:33)(cid:31)(cid:1)(cid:2)(cid:3,,546.0
,,18,,,Unknown,,cid:16)(cid:17)(cid:16)(cid:27)(cid:28)(cid:1)(cid:29)(cid:30)(cid:28)(cid:28)(cid:31)(cid:29)(cid:27)(cid:32)(cid:33)(cid:31)(cid:1)(cid:2)(cid:3,,564.0
,,46,,,Unknown,,cid:16)(cid:17)(cid:16)(cid:27)(cid:28)(cid:1)(cid:29)(cid:30)(cid:28)(cid:28)(cid:31)(cid:29)(cid:27)(cid:32)(cid:33)(cid:31)(cid:1)(cid:2)(cid:3,,610.0
,,21,,,Unknown,,cid:16)(cid:17)(cid:16)(cid:27)(cid:28)(cid:1)(cid:29)(cid:30)(cid:28)(cid:28)(cid:31)(cid:29)(cid:27)(cid:32)(cid:33)(cid:31)(cid:1)(cid:2)(cid:3,,631.0
,,41,,,Unknown,,cid:16)(cid:17)(cid:16)(cid:27)(cid:28)(cid:1)(cid:29)(cid:30)(cid:28)(cid:28)(cid:31)(cid:29)(cid:27)(cid:32)(cid:33)(cid:31)(cid:1)(cid:2)(cid:3,,672.0
,,13,,,Unknown,,cid:16)(cid:17)(cid:16)(cid:27)(cid:28)(cid:1)(cid:29)(cid:30)(cid:28)(cid:28)(cid:31)(cid:29)(cid:27)(cid:32)(cid:33)(cid:31)(cid:1)(cid:2)(cid:3,,685.0
,,20,,,Unknown,,cid:16)(cid:17)(cid:16)(cid:27)(cid:28)(cid:1)(cid:29)(cid:30)(cid:28)(cid:28)(cid:31)(cid:29)(cid:27)(cid:32)(cid:33)(cid:31)(cid:1)(cid:2)(cid:3,,705.0
,,18,,,Unknown,,cid:16)(cid:17)(cid:16)(cid:27)(cid:28)(cid:1)(cid:29)(cid:30)(cid:28)(cid:28)(cid:31)(cid:29)(cid:27)(cid:32)(cid:33)(cid:31)(cid:1)(cid:2)(cid:3,,723.0
,,47,,,Unknown,,cid:16)(cid:17)(cid:16)(cid:27)(cid:28)(cid:1)(cid:29)(cid:30)(cid:28)(cid:28)(cid:31)(cid:29)(cid:27)(cid:32)(cid:33)(cid:31)(cid:1)(cid:2)(cid:3,,770.0
,,21,,,Unknown,,cid:16)(cid:17)(cid:16)(cid:27)(cid:28)(cid:1)(cid:29)(cid:30)(cid:28)(cid:28)(cid:31)(cid:29)(cid:27)(cid:32)(cid:33)(cid:31)(cid:1)(cid:2)(cid:3,,791.0
,,41,,,Unknown,,cid:16)(cid:17)(cid:16)(cid:27)(cid:28)(cid:1)(cid:29)(cid:30)(cid:28)(cid:28)(cid:31)(cid:29)(cid:27)(cid:32)(cid:33)(cid:31)(cid:1)(cid:2)(cid:3,,832.0
,,10,,,Unknown,,cid:16)(cid:17)(cid:16)(cid:27)(cid:28)(cid:1)(cid:29)(cid:30)(cid:28)(cid:28)(cid:31)(cid:29)(cid:27)(cid:32)(cid:33)(cid:31)(cid:1)(cid:2)(cid:3,,842.0
,,6,,,Unknown,,cid:16)(cid:17)(cid:16)(cid:27)(cid:28)(cid:1)(cid:29)(cid:30)(cid:28)(cid:28)(cid:31)(cid:29)(cid:27)(cid:32)(cid:33)(cid:31)(cid:1)(cid:2)(cid:3,,848.0
,,20,,,Unknown,,cid:16)(cid:17)(cid:16)(cid:27)(cid:28)(cid:1)(cid:29)(cid:30)(cid:28)(cid:28)(cid:31)(cid:29)(cid:27)(cid:32)(cid:33)(cid:31)(cid:1)(cid:2)(cid:3,,868.0
,,10,,,Unknown,,cid:16)(cid:17)(cid:16)(cid:27)(cid:28)(cid:1)(cid:29)(cid:30)(cid:28)(cid:28)(cid:31)(cid:29)(cid:27)(cid:32)(cid:33)(cid:31)(cid:1)(cid:2)(cid:3,,878.0
,,11,,,Unknown,,cid:16)(cid:17)(cid:16)(cid:27)(cid:28)(cid:1)(cid:29)(cid:30)(cid:28)(cid:28)(cid:31)(cid:29)(cid:27)(cid:32)(cid:33)(cid:31)(cid:1)(cid:2)(cid:3,,889.0
,,14,,,Unknown,,cid:16)(cid:17)(cid:16)(cid:27)(cid:28)(cid:1)(cid:29)(cid:30)(cid:28)(cid:28)(cid:31)(cid:29)(cid:27)(cid:32)(cid:33)(cid:31)(cid:1)(cid:2)(cid:3,,903.0
,,21,,,Unknown,,cid:16)(cid:17)(cid:16)(cid:27)(cid:28)(cid:1)(cid:29)(cid:30)(cid:28)(cid:28)(cid:31)(cid:29)(cid:27)(cid:32)(cid:33)(cid:31)(cid:1)(cid:2)(cid:3,,924.0
,,22,,,Unknown,,cid:16)(cid:17)(cid:16)(cid:27)(cid:28)(cid:1)(cid:29)(cid:30)(cid:28)(cid:28)(cid:31)(cid:29)(cid:27)(cid:32)(cid:33)(cid:31)(cid:1)(cid:2)(cid:3,,946.0
,,23,,,Unknown,,cid:16)(cid:17)(cid:16)(cid:27)(cid:28)(cid:1)(cid:29)(cid:30)(cid:28)(cid:28)(cid:31)(cid:29)(cid:27)(cid:32)(cid:33)(cid:31)(cid:1)(cid:2)(cid:3,,969.0
,,21,,,Unknown,,cid:16)(cid:17)(cid:16)(cid:27)(cid:28)(cid:1)(cid:29)(cid:30)(cid:28)(cid:28)(cid:31)(cid:29)(cid:27)(cid:32)(cid:33)(cid:31)(cid:1)(cid:2)(cid:3,,990.0
,,24,,,Unknown,,cid:16)(cid:17)(cid:16)(cid:27)(cid:28)(cid:1)(cid:29)(cid:30)(cid:28)(cid:28)(cid:31)(cid:29)(cid:27)(cid:32)(cid:33)(cid:31)(cid:1)(cid:2)(cid:3,,1014.0
,,1,,,Unknown,,cid:16)(cid:17)(cid:16)(cid:27)(cid:28)(cid:1)(cid:29)(cid:30)(cid:28)(cid:28)(cid:31)(cid:29)(cid:27)(cid:32)(cid:33)(cid:31)(cid:1)(cid:2)(cid:3,,1015.0
,,6,,,Unknown,,cid:16)(cid:17)(cid:16)(cid:27)(cid:28)(cid:1)(cid:29)(cid:30)(cid:28)(cid:28)(cid:31)(cid:29)(cid:27)(cid:32)(cid:33)(cid:31)(cid:1)(cid:2)(cid:3,,1021.0
,,9,,,Unknown,,cid:16)(cid:17)(cid:16)(cid:27)(cid:28)(cid:1)(cid:29)(cid:30)(cid:28)(cid:28)(cid:31)(cid:29)(cid:27)(cid:32)(cid:33)(cid:31)(cid:1)(cid:2)(cid:3,,1030.0
,,25,,,Unknown,,cid:16)(cid:17)(cid:16)(cid:27)(cid:28)(cid:1)(cid:29)(cid:30)(cid:28)(cid:28)(cid:31)(cid:29)(cid:27)(cid:32)(cid:33)(cid:31)(cid:1)(cid:2)(cid:3,,1055.0
,,10,,,Unknown,,cid:16)(cid:17)(cid:16)(cid:27)(cid:28)(cid:1)(cid:29)(cid:30)(cid:28)(cid:28)(cid:31)(cid:29)(cid:27)(cid:32)(cid:33)(cid:31)(cid:1)(cid:2)(cid:3,,1065.0
,,10,,,Unknown,,cid:16)(cid:17)(cid:16)(cid:27)(cid:28)(cid:1)(cid:29)(cid:30)(cid:28)(cid:28)(cid:31)(cid:29)(cid:27)(cid:32)(cid:33)(cid:31)(cid:1)(cid:2)(cid:3,,1075.0
,,1,,,Unknown,,cid:16)(cid:17)(cid:16)(cid:27)(cid:28)(cid:1)(cid:29)(cid:30)(cid:28)(cid:28)(cid:31)(cid:29)(cid:27)(cid:32)(cid:33)(cid:31)(cid:1)(cid:2)(cid:3,,1076.0
,,26,,,Unknown,,cid:16)(cid:17)(cid:16)(cid:27)(cid:28)(cid:1)(cid:29)(cid:30)(cid:28)(cid:28)(cid:31)(cid:29)(cid:27)(cid:32)(cid:33)(cid:31)(cid:1)(cid:2)(cid:3,,1102.0
,,16,,,Unknown,,cid:16)(cid:17)(cid:16)(cid:27)(cid:28)(cid:1)(cid:29)(cid:30)(cid:28)(cid:28)(cid:31)(cid:29)(cid:27)(cid:32)(cid:33)(cid:31)(cid:1)(cid:2)(cid:3,,1118.0
,,17,,,Unknown,,cid:16)(cid:17)(cid:16)(cid:27)(cid:28)(cid:1)(cid:29)(cid:30)(cid:28)(cid:28)(cid:31)(cid:29)(cid:27)(cid:32)(cid:33)(cid:31)(cid:1)(cid:2)(cid:3,,1135.0
,,16,,,Unknown,,cid:16)(cid:17)(cid:16)(cid:27)(cid:28)(cid:1)(cid:29)(cid:30)(cid:28)(cid:28)(cid:31)(cid:29)(cid:27)(cid:32)(cid:33)(cid:31)(cid:1)(cid:2)(cid:3,,1151.0
,,27,,,Unknown,,cid:16)(cid:17)(cid:16)(cid:27)(cid:28)(cid:1)(cid:29)(cid:30)(cid:28)(cid:28)(cid:31)(cid:29)(cid:27)(cid:32)(cid:33)(cid:31)(cid:1)(cid:2)(cid:3,,1178.0
,,28,,,Unknown,,cid:16)(cid:17)(cid:16)(cid:27)(cid:28)(cid:1)(cid:29)(cid:30)(cid:28)(cid:28)(cid:31)(cid:29)(cid:27)(cid:32)(cid:33)(cid:31)(cid:1)(cid:2)(cid:3,,1206.0
,,1,,,Unknown,,cid:16)(cid:17)(cid:16)(cid:27)(cid:28)(cid:1)(cid:29)(cid:30)(cid:28)(cid:28)(cid:31)(cid:29)(cid:27)(cid:32)(cid:33)(cid:31)(cid:1)(cid:2)(cid:3,,1207.0
,,29,,,Unknown,,cid:16)(cid:17)(cid:16)(cid:27)(cid:28)(cid:1)(cid:29)(cid:30)(cid:28)(cid:28)(cid:31)(cid:29)(cid:27)(cid:32)(cid:33)(cid:31)(cid:1)(cid:2)(cid:3,,1236.0
,,30,,,Unknown,,cid:16)(cid:17)(cid:16)(cid:27)(cid:28)(cid:1)(cid:29)(cid:30)(cid:28)(cid:28)(cid:31)(cid:29)(cid:27)(cid:32)(cid:33)(cid:31)(cid:1)(cid:2)(cid:3,,1266.0
,,28,,,Unknown,,cid:16)(cid:17)(cid:16)(cid:27)(cid:28)(cid:1)(cid:29)(cid:30)(cid:28)(cid:28)(cid:31)(cid:29)(cid:27)(cid:32)(cid:33)(cid:31)(cid:1)(cid:2)(cid:3,,1294.0
,,28,,,Unknown,,cid:16)(cid:17)(cid:16)(cid:27)(cid:28)(cid:1)(cid:29)(cid:30)(cid:28)(cid:28)(cid:31)(cid:29)(cid:27)(cid:32)(cid:33)(cid:31)(cid:1)(cid:2)(cid:3,,1322.0
,,31,,,Unknown,,cid:16)(cid:17)(cid:16)(cid:27)(cid:28)(cid:1)(cid:29)(cid:30)(cid:28)(cid:28)(cid:31)(cid:29)(cid:27)(cid:32)(cid:33)(cid:31)(cid:1)(cid:2)(cid:3,,1353.0
,,29,,,Unknown,,cid:16)(cid:17)(cid:16)(cid:27)(cid:28)(cid:1)(cid:29)(cid:30)(cid:28)(cid:28)(cid:31)(cid:29)(cid:27)(cid:32)(cid:33)(cid:31)(cid:1)(cid:2)(cid:3,,1382.0
,,27,,,Unknown,,cid:16)(cid:17)(cid:16)(cid:27)(cid:28)(cid:1)(cid:29)(cid:30)(cid:28)(cid:28)(cid:31)(cid:29)(cid:27)(cid:32)(cid:33)(cid:31)(cid:1)(cid:2)(cid:3,,1409.0
,,32,,,Unknown,,cid:16)(cid:17)(cid:16)(cid:27)(cid:28)(cid:1)(cid:29)(cid:30)(cid:28)(cid:28)(cid:31)(cid:29)(cid:27)(cid:32)(cid:33)(cid:31)(cid:1)(cid:2)(cid:3,,1441.0
,,33,,,Unknown,,cid:16)(cid:17)(cid:16)(cid:27)(cid:28)(cid:1)(cid:29)(cid:30)(cid:28)(cid:28)(cid:31)(cid:29)(cid:27)(cid:32)(cid:33)(cid:31)(cid:1)(cid:2)(cid:3,,1474.0
,,31,,,Unknown,,cid:16)(cid:17)(cid:16)(cid:27)(cid:28)(cid:1)(cid:29)(cid:30)(cid:28)(cid:28)(cid:31)(cid:29)(cid:27)(cid:32)(cid:33)(cid:31)(cid:1)(cid:2)(cid:3,,1505.0
,,1,,,Unknown,,cid:16)(cid:17)(cid:16)(cid:27)(cid:28)(cid:1)(cid:29)(cid:30)(cid:28)(cid:28)(cid:31)(cid:29)(cid:27)(cid:32)(cid:33)(cid:31)(cid:1)(cid:2)(cid:3,,1506.0
,,2,,,Unknown,,cid:16)(cid:17)(cid:16)(cid:27)(cid:28)(cid:1)(cid:29)(cid:30)(cid:28)(cid:28)(cid:31)(cid:29)(cid:27)(cid:32)(cid:33)(cid:31)(cid:1)(cid:2)(cid:3,,1508.0
,,3,,,Unknown,,cid:16)(cid:17)(cid:16)(cid:27)(cid:28)(cid:1)(cid:29)(cid:30)(cid:28)(cid:28)(cid:31)(cid:29)(cid:27)(cid:32)(cid:33)(cid:31)(cid:1)(cid:2)(cid:3,,1511.0
,,10,,,Unknown,,cid:16)(cid:17)(cid:16)(cid:27)(cid:28)(cid:1)(cid:29)(cid:30)(cid:28)(cid:28)(cid:31)(cid:29)(cid:27)(cid:32)(cid:33)(cid:31)(cid:1)(cid:2)(cid:3,,1521.0
,,6,,,Unknown,,cid:16)(cid:17)(cid:16)(cid:27)(cid:28)(cid:1)(cid:29)(cid:30)(cid:28)(cid:28)(cid:31)(cid:29)(cid:27)(cid:32)(cid:33)(cid:31)(cid:1)(cid:2)(cid:3,,1527.0
,,20,,,Unknown,,cid:16)(cid:17)(cid:16)(cid:27)(cid:28)(cid:1)(cid:29)(cid:30)(cid:28)(cid:28)(cid:31)(cid:29)(cid:27)(cid:32)(cid:33)(cid:31)(cid:1)(cid:2)(cid:3,,1547.0
,,10,,,Unknown,,cid:16)(cid:17)(cid:16)(cid:27)(cid:28)(cid:1)(cid:29)(cid:30)(cid:28)(cid:28)(cid:31)(cid:29)(cid:27)(cid:32)(cid:33)(cid:31)(cid:1)(cid:2)(cid:3,,1557.0
,,11,,,Unknown,,cid:16)(cid:17)(cid:16)(cid:27)(cid:28)(cid:1)(cid:29)(cid:30)(cid:28)(cid:28)(cid:31)(cid:29)(cid:27)(cid:32)(cid:33)(cid:31)(cid:1)(cid:2)(cid:3,,1568.0
,,24,,,Unknown,,cid:16)(cid:17)(cid:16)(cid:27)(cid:28)(cid:1)(cid:29)(cid:30)(cid:28)(cid:28)(cid:31)(cid:29)(cid:27)(cid:32)(cid:33)(cid:31)(cid:1)(cid:2)(cid:3,,1592.0
,,1,,,Unknown,,cid:16)(cid:17)(cid:16)(cid:27)(cid:28)(cid:1)(cid:29)(cid:30)(cid:28)(cid:28)(cid:31)(cid:29)(cid:27)(cid:32)(cid:33)(cid:31)(cid:1)(cid:2)(cid:3,,1593.0
,,8,,,Unknown,,cid:16)(cid:17)(cid:16)(cid:27)(cid:28)(cid:1)(cid:29)(cid:30)(cid:28)(cid:28)(cid:31)(cid:29)(cid:27)(cid:32)(cid:33)(cid:31)(cid:1)(cid:2)(cid:3,,1601.0
,,6,,,Unknown,,cid:16)(cid:17)(cid:16)(cid:27)(cid:28)(cid:1)(cid:29)(cid:30)(cid:28)(cid:28)(cid:31)(cid:29)(cid:27)(cid:32)(cid:33)(cid:31)(cid:1)(cid:2)(cid:3,,1607.0
,,25,,,Unknown,,cid:16)(cid:17)(cid:16)(cid:27)(cid:28)(cid:1)(cid:29)(cid:30)(cid:28)(cid:28)(cid:31)(cid:29)(cid:27)(cid:32)(cid:33)(cid:31)(cid:1)(cid:2)(cid:3,,1632.0
,,4,,,Unknown,,cid:16)(cid:17)(cid:16)(cid:27)(cid:28)(cid:1)(cid:29)(cid:30)(cid:28)(cid:28)(cid:31)(cid:29)(cid:27)(cid:32)(cid:33)(cid:31)(cid:1)(cid:2)(cid:3,,1636.0
,,10,,,Unknown,,cid:16)(cid:17)(cid:16)(cid:27)(cid:28)(cid:1)(cid:29)(cid:30)(cid:28)(cid:28)(cid:31)(cid:29)(cid:27)(cid:32)(cid:33)(cid:31)(cid:1)(cid:2)(cid:3,,1646.0
,,1,,,Unknown,,cid:16)(cid:17)(cid:16)(cid:27)(cid:28)(cid:1)(cid:29)(cid:30)(cid:28)(cid:28)(cid:31)(cid:29)(cid:27)(cid:32)(cid:33)(cid:31)(cid:1)(cid:2)(cid:3,,1647.0
,,26,,,Unknown,,cid:16)(cid:17)(cid:16)(cid:27)(cid:28)(cid:1)(cid:29)(cid:30)(cid:28)(cid:28)(cid:31)(cid:29)(cid:27)(cid:32)(cid:33)(cid:31)(cid:1)(cid:2)(cid:3,,1673.0
,,45,,,Unknown,,cid:16)(cid:17)(cid:16)(cid:27)(cid:28)(cid:1)(cid:29)(cid:30)(cid:28)(cid:28)(cid:31)(cid:29)(cid:27)(cid:32)(cid:33)(cid:31)(cid:1)(cid:2)(cid:3,,1718.0
,,10,,,Unknown,,cid:16)(cid:17)(cid:16)(cid:27)(cid:28)(cid:1)(cid:29)(cid:30)(cid:28)(cid:28)(cid:31)(cid:29)(cid:27)(cid:32)(cid:33)(cid:31)(cid:1)(cid:2)(cid:3,,1728.0
,,19,,,Unknown,,cid:16)(cid:17)(cid:16)(cid:27)(cid:28)(cid:1)(cid:29)(cid:30)(cid:28)(cid:28)(cid:31)(cid:29)(cid:27)(cid:32)(cid:33)(cid:31)(cid:1)(cid:2)(cid:3,,1747.0
,,16,,,Unknown,,cid:16)(cid:17)(cid:16)(cid:27)(cid:28)(cid:1)(cid:29)(cid:30)(cid:28)(cid:28)(cid:31)(cid:29)(cid:27)(cid:32)(cid:33)(cid:31)(cid:1)(cid:2)(cid:3,,1763.0
,,7,,,Unknown,,cid:16)(cid:17)(cid:16)(cid:27)(cid:28)(cid:1)(cid:29)(cid:30)(cid:28)(cid:28)(cid:31)(cid:29)(cid:27)(cid:32)(cid:33)(cid:31)(cid:1)(cid:2)(cid:3,,1770.0
,,3,,,Unknown,,cid:16)(cid:17)(cid:16)(cid:27)(cid:28)(cid:1)(cid:29)(cid:30)(cid:28)(cid:28)(cid:31)(cid:29)(cid:27)(cid:32)(cid:33)(cid:31)(cid:1)(cid:2)(cid:3,,1773.0
,,8,,,Unknown,,cid:16)(cid:17)(cid:16)(cid:27)(cid:28)(cid:1)(cid:29)(cid:30)(cid:28)(cid:28)(cid:31)(cid:29)(cid:27)(cid:32)(cid:33)(cid:31)(cid:1)(cid:2)(cid:3,,1781.0
,,28,,,Unknown,,cid:16)(cid:17)(cid:16)(cid:27)(cid:28)(cid:1)(cid:29)(cid:30)(cid:28)(cid:28)(cid:31)(cid:29)(cid:27)(cid:32)(cid:33)(cid:31)(cid:1)(cid:2)(cid:3,,1809.0
,,10,,,Unknown,,cid:16)(cid:17)(cid:16)(cid:27)(cid:28)(cid:1)(cid:29)(cid:30)(cid:28)(cid:28)(cid:31)(cid:29)(cid:27)(cid:32)(cid:33)(cid:31)(cid:1)(cid:2)(cid:3,,1819.0
,,3,,,Unknown,,cid:16)(cid:17)(cid:16)(cid:27)(cid:28)(cid:1)(cid:29)(cid:30)(cid:28)(cid:28)(cid:31)(cid:29)(cid:27)(cid:32)(cid:33)(cid:31)(cid:1)(cid:2)(cid:3,,1822.0
,,6,,,Unknown,,cid:16)(cid:17)(cid:16)(cid:27)(cid:28)(cid:1)(cid:29)(cid:30)(cid:28)(cid:28)(cid:31)(cid:29)(cid:27)(cid:32)(cid:33)(cid:31)(cid:1)(cid:2)(cid:3,,1828.0
,,8,,,Unknown,,cid:16)(cid:17)(cid:16)(cid:27)(cid:28)(cid:1)(cid:29)(cid:30)(cid:28)(cid:28)(cid:31)(cid:29)(cid:27)(cid:32)(cid:33)(cid:31)(cid:1)(cid:2)(cid:3,,1836.0
,,46,,,Unknown,,cid:16)(cid:17)(cid:16)(cid:27)(cid:28)(cid:1)(cid:29)(cid:30)(cid:28)(cid:28)(cid:31)(cid:29)(cid:27)(cid:32)(cid:33)(cid:31)(cid:1)(cid:2)(cid:3,,1882.0
,,46,,,Unknown,,cid:16)(cid:17)(cid:16)(cid:27)(cid:28)(cid:1)(cid:29)(cid:30)(cid:28)(cid:28)(cid:31)(cid:29)(cid:27)(cid:32)(cid:33)(cid:31)(cid:1)(cid:2)(cid:3,,1928.0
,,47,,,Unknown,,cid:16)(cid:17)(cid:16)(cid:27)(cid:28)(cid:1)(cid:29)(cid:30)(cid:28)(cid:28)(cid:31)(cid:29)(cid:27)(cid:32)(cid:33)(cid:31)(cid:1)(cid:2)(cid:3,,1975.0
,,32,,,Unknown,,cid:16)(cid:17)(cid:16)(cid:27)(cid:28)(cid:1)(cid:29)(cid:30)(cid:28)(cid:28)(cid:31)(cid:29)(cid:27)(cid:32)(cid:33)(cid:31)(cid:1)(cid:2)(cid:3,,2007.0
,,48,,,Unknown,,cid:16)(cid:17)(cid:16)(cid:27)(cid:28)(cid:1)(cid:29)(cid:30)(cid:28)(cid:28)(cid:31)(cid:29)(cid:27)(cid:32)(cid:33)(cid:31)(cid:1)(cid:2)(cid:3,,2055.0
,,49,,,Unknown,,cid:16)(cid:17)(cid:16)(cid:27)(cid:28)(cid:1)(cid:29)(cid:30)(cid:28)(cid:28)(cid:31)(cid:29)(cid:27)(cid:32)(cid:33)(cid:31)(cid:1)(cid:2)(cid:3,,2104.0
,,16,,,Unknown,,cid:16)(cid:17)(cid:16)(cid:27)(cid:28)(cid:1)(cid:29)(cid:30)(cid:28)(cid:28)(cid:31)(cid:29)(cid:27)(cid:32)(cid:33)(cid:31)(cid:1)(cid:2)(cid:3,,2120.0
,,31,,,Unknown,,cid:16)(cid:17)(cid:16)(cid:27)(cid:28)(cid:1)(cid:29)(cid:30)(cid:28)(cid:28)(cid:31)(cid:29)(cid:27)(cid:32)(cid:33)(cid:31)(cid:1)(cid:2)(cid:3,,2151.0
,,28,,,Unknown,,cid:16)(cid:17)(cid:16)(cid:27)(cid:28)(cid:1)(cid:29)(cid:30)(cid:28)(cid:28)(cid:31)(cid:29)(cid:27)(cid:32)(cid:33)(cid:31)(cid:1)(cid:2)(cid:3,,2179.0
,,1,,,Unknown,,cid:16)(cid:17)(cid:16)(cid:27)(cid:28)(cid:1)(cid:29)(cid:30)(cid:28)(cid:28)(cid:31)(cid:29)(cid:27)(cid:32)(cid:33)(cid:31)(cid:1)(cid:2)(cid:3,,2180.0
,,34,,,Unknown,,cid:16)(cid:17)(cid:16)(cid:27)(cid:28)(cid:1)(cid:29)(cid:30)(cid:28)(cid:28)(cid:31)(cid:29)(cid:27)(cid:32)(cid:33)(cid:31)(cid:1)(cid:2)(cid:3,,2214.0
,,1,,,Unknown,,cid:16)(cid:17)(cid:16)(cid:27)(cid:28)(cid:1)(cid:29)(cid:30)(cid:28)(cid:28)(cid:31)(cid:29)(cid:27)(cid:32)(cid:33)(cid:31)(cid:1)(cid:2)(cid:3,,2215.0
,,34,,,Unknown,,cid:16)(cid:17)(cid:16)(cid:27)(cid:28)(cid:1)(cid:29)(cid:30)(cid:28)(cid:28)(cid:31)(cid:29)(cid:27)(cid:32)(cid:33)(cid:31)(cid:1)(cid:2)(cid:3,,2249.0
,,31,,,Unknown,,cid:16)(cid:17)(cid:16)(cid:27)(cid:28)(cid:1)(cid:29)(cid:30)(cid:28)(cid:28)(cid:31)(cid:29)(cid:27)(cid:32)(cid:33)(cid:31)(cid:1)(cid:2)(cid:3,,2280.0
,,32,,,Unknown,,cid:16)(cid:17)(cid:16)(cid:27)(cid:28)(cid:1)(cid:29)(cid:30)(cid:28)(cid:28)(cid:31)(cid:29)(cid:27)(cid:32)(cid:33)(cid:31)(cid:1)(cid:2)(cid:3,,2312.0
,,33,,,Unknown,,cid:16)(cid:17)(cid:16)(cid:27)(cid:28)(cid:1)(cid:29)(cid:30)(cid:28)(cid:28)(cid:31)(cid:29)(cid:27)(cid:32)(cid:33)(cid:31)(cid:1)(cid:2)(cid:3,,2345.0
,,17,,,Unknown,,cid:16)(cid:17)(cid:16)(cid:27)(cid:28)(cid:1)(cid:29)(cid:30)(cid:28)(cid:28)(cid:31)(cid:29)(cid:27)(cid:32)(cid:33)(cid:31)(cid:1)(cid:2)(cid:3,,2362.0
,,15,,,Unknown,,cid:16)(cid:17)(cid:16)(cid:27)(cid:28)(cid:1)(cid:29)(cid:30)(cid:28)(cid:28)(cid:31)(cid:29)(cid:27)(cid:32)(cid:33)(cid:31)(cid:1)(cid:2)(cid:3,,2377.0
,,1,,,Unknown,,cid:16)(cid:17)(cid:16)(cid:27)(cid:28)(cid:1)(cid:29)(cid:30)(cid:28)(cid:28)(cid:31)(cid:29)(cid:27)(cid:32)(cid:33)(cid:31)(cid:1)(cid:2)(cid:3,,2378.0
,,28,,,Unknown,,cid:16)(cid:17)(cid:16)(cid:27)(cid:28)(cid:1)(cid:29)(cid:30)(cid:28)(cid:28)(cid:31)(cid:29)(cid:27)(cid:32)(cid:33)(cid:31)(cid:1)(cid:2)(cid:3,,2406.0
,,27,,,Unknown,,cid:16)(cid:17)(cid:16)(cid:27)(cid:28)(cid:1)(cid:29)(cid:30)(cid:28)(cid:28)(cid:31)(cid:29)(cid:27)(cid:32)(cid:33)(cid:31)(cid:1)(cid:2)(cid:3,,2433.0
,,1,,,Unknown,,cid:16)(cid:17)(cid:16)(cid:27)(cid:28)(cid:1)(cid:29)(cid:30)(cid:28)(cid:28)(cid:31)(cid:29)(cid:27)(cid:32)(cid:33)(cid:31)(cid:1)(cid:2)(cid:3,,2434.0
,,2,,,Unknown,,cid:16)(cid:17)(cid:16)(cid:27)(cid:28)(cid:1)(cid:29)(cid:30)(cid:28)(cid:28)(cid:31)(cid:29)(cid:27)(cid:32)(cid:33)(cid:31)(cid:1)(cid:2)(cid:3,,2436.0
,,17,,,Unknown,,cid:16)(cid:17)(cid:16)(cid:27)(cid:28)(cid:1)(cid:29)(cid:30)(cid:28)(cid:28)(cid:31)(cid:29)(cid:27)(cid:32)(cid:33)(cid:31)(cid:1)(cid:2)(cid:3,,2453.0
,,3,,,Unknown,,cid:16)(cid:17)(cid:16)(cid:27)(cid:28)(cid:1)(cid:29)(cid:30)(cid:28)(cid:28)(cid:31)(cid:29)(cid:27)(cid:32)(cid:33)(cid:31)(cid:1)(cid:2)(cid:3,,2456.0
,,1,,,Unknown,,cid:16)(cid:17)(cid:16)(cid:27)(cid:28)(cid:1)(cid:29)(cid:30)(cid:28)(cid:28)(cid:31)(cid:29)(cid:27)(cid:32)(cid:33)(cid:31)(cid:1)(cid:2)(cid:3,,2457.0
,,2,,,Unknown,,cid:16)(cid:17)(cid:16)(cid:27)(cid:28)(cid:1)(cid:29)(cid:30)(cid:28)(cid:28)(cid:31)(cid:29)(cid:27)(cid:32)(cid:33)(cid:31)(cid:1)(cid:2)(cid:3,,2459.0
,,3,,,Unknown,,cid:16)(cid:17)(cid:16)(cid:27)(cid:28)(cid:1)(cid:29)(cid:30)(cid:28)(cid:28)(cid:31)(cid:29)(cid:27)(cid:32)(cid:33)(cid:31)(cid:1)(cid:2)(cid:3,,2462.0
,,10,,,Unknown,,cid:16)(cid:17)(cid:16)(cid:27)(cid:28)(cid:1)(cid:29)(cid:30)(cid:28)(cid:28)(cid:31)(cid:29)(cid:27)(cid:32)(cid:33)(cid:31)(cid:1)(cid:2)(cid:3,,2472.0
,,6,,,Unknown,,cid:16)(cid:17)(cid:16)(cid:27)(cid:28)(cid:1)(cid:29)(cid:30)(cid:28)(cid:28)(cid:31)(cid:29)(cid:27)(cid:32)(cid:33)(cid:31)(cid:1)(cid:2)(cid:3,,2478.0
,,20,,,Unknown,,cid:16)(cid:17)(cid:16)(cid:27)(cid:28)(cid:1)(cid:29)(cid:30)(cid:28)(cid:28)(cid:31)(cid:29)(cid:27)(cid:32)(cid:33)(cid:31)(cid:1)(cid:2)(cid:3,,2498.0
,,10,,,Unknown,,cid:16)(cid:17)(cid:16)(cid:27)(cid:28)(cid:1)(cid:29)(cid:30)(cid:28)(cid:28)(cid:31)(cid:29)(cid:27)(cid:32)(cid:33)(cid:31)(cid:1)(cid:2)(cid:3,,2508.0
,,11,,,Unknown,,cid:16)(cid:17)(cid:16)(cid:27)(cid:28)(cid:1)(cid:29)(cid:30)(cid:28)(cid:28)(cid:31)(cid:29)(cid:27)(cid:32)(cid:33)(cid:31)(cid:1)(cid:2)(cid:3,,2519.0
,,24,,,Unknown,,cid:16)(cid:17)(cid:16)(cid:27)(cid:28)(cid:1)(cid:29)(cid:30)(cid:28)(cid:28)(cid:31)(cid:29)(cid:27)(cid:32)(cid:33)(cid:31)(cid:1)(cid:2)(cid:3,,2543.0
,,1,,,Unknown,,cid:16)(cid:17)(cid:16)(cid:27)(cid:28)(cid:1)(cid:29)(cid:30)(cid:28)(cid:28)(cid:31)(cid:29)(cid:27)(cid:32)(cid:33)(cid:31)(cid:1)(cid:2)(cid:3,,2544.0
,,9,,,Unknown,,cid:16)(cid:17)(cid:16)(cid:27)(cid:28)(cid:1)(cid:29)(cid:30)(cid:28)(cid:28)(cid:31)(cid:29)(cid:27)(cid:32)(cid:33)(cid:31)(cid:1)(cid:2)(cid:3,,2553.0
,,11,,,Unknown,,cid:16)(cid:17)(cid:16)(cid:27)(cid:28)(cid:1)(cid:29)(cid:30)(cid:28)(cid:28)(cid:31)(cid:29)(cid:27)(cid:32)(cid:33)(cid:31)(cid:1)(cid:2)(cid:3,,2564.0
,,25,,,Unknown,,cid:16)(cid:17)(cid:16)(cid:27)(cid:28)(cid:1)(cid:29)(cid:30)(cid:28)(cid:28)(cid:31)(cid:29)(cid:27)(cid:32)(cid:33)(cid:31)(cid:1)(cid:2)(cid:3,,2589.0
,,7,,,Unknown,,cid:16)(cid:17)(cid:16)(cid:27)(cid:28)(cid:1)(cid:29)(cid:30)(cid:28)(cid:28)(cid:31)(cid:29)(cid:27)(cid:32)(cid:33)(cid:31)(cid:1)(cid:2)(cid:3,,2596.0
,,4,,,Unknown,,cid:16)(cid:17)(cid:16)(cid:27)(cid:28)(cid:1)(cid:29)(cid:30)(cid:28)(cid:28)(cid:31)(cid:29)(cid:27)(cid:32)(cid:33)(cid:31)(cid:1)(cid:2)(cid:3,,2600.0
,,1,,,Unknown,,cid:16)(cid:17)(cid:16)(cid:27)(cid:28)(cid:1)(cid:29)(cid:30)(cid:28)(cid:28)(cid:31)(cid:29)(cid:27)(cid:32)(cid:33)(cid:31)(cid:1)(cid:2)(cid:3,,2601.0
,,26,,,Unknown,,cid:16)(cid:17)(cid:16)(cid:27)(cid:28)(cid:1)(cid:29)(cid:30)(cid:28)(cid:28)(cid:31)(cid:29)(cid:27)(cid:32)(cid:33)(cid:31)(cid:1)(cid:2)(cid:3,,2627.0
,,45,,,Unknown,,cid:16)(cid:17)(cid:16)(cid:27)(cid:28)(cid:1)(cid:29)(cid:30)(cid:28)(cid:28)(cid:31)(cid:29)(cid:27)(cid:32)(cid:33)(cid:31)(cid:1)(cid:2)(cid:3,,2672.0
,,10,,,Unknown,,cid:16)(cid:17)(cid:16)(cid:27)(cid:28)(cid:1)(cid:29)(cid:30)(cid:28)(cid:28)(cid:31)(cid:29)(cid:27)(cid:32)(cid:33)(cid:31)(cid:1)(cid:2)(cid:3,,2682.0
,,19,,,Unknown,,cid:16)(cid:17)(cid:16)(cid:27)(cid:28)(cid:1)(cid:29)(cid:30)(cid:28)(cid:28)(cid:31)(cid:29)(cid:27)(cid:32)(cid:33)(cid:31)(cid:1)(cid:2)(cid:3,,2701.0
,,16,,,Unknown,,cid:16)(cid:17)(cid:16)(cid:27)(cid:28)(cid:1)(cid:29)(cid:30)(cid:28)(cid:28)(cid:31)(cid:29)(cid:27)(cid:32)(cid:33)(cid:31)(cid:1)(cid:2)(cid:3,,2717.0
,,7,,,Unknown,,cid:16)(cid:17)(cid:16)(cid:27)(cid:28)(cid:1)(cid:29)(cid:30)(cid:28)(cid:28)(cid:31)(cid:29)(cid:27)(cid:32)(cid:33)(cid:31)(cid:1)(cid:2)(cid:3,,2724.0
,,3,,,Unknown,,cid:16)(cid:17)(cid:16)(cid:27)(cid:28)(cid:1)(cid:29)(cid:30)(cid:28)(cid:28)(cid:31)(cid:29)(cid:27)(cid:32)(cid:33)(cid:31)(cid:1)(cid:2)(cid:3,,2727.0
,,8,,,Unknown,,cid:16)(cid:17)(cid:16)(cid:27)(cid:28)(cid:1)(cid:29)(cid:30)(cid:28)(cid:28)(cid:31)(cid:29)(cid:27)(cid:32)(cid:33)(cid:31)(cid:1)(cid:2)(cid:3,,2735.0
,,28,,,Unknown,,cid:16)(cid:17)(cid:16)(cid:27)(cid:28)(cid:1)(cid:29)(cid:30)(cid:28)(cid:28)(cid:31)(cid:29)(cid:27)(cid:32)(cid:33)(cid:31)(cid:1)(cid:2)(cid:3,,2763.0
,,10,,,Unknown,,cid:16)(cid:17)(cid:16)(cid:27)(cid:28)(cid:1)(cid:29)(cid:30)(cid:28)(cid:28)(cid:31)(cid:29)(cid:27)(cid:32)(cid:33)(cid:31)(cid:1)(cid:2)(cid:3,,2773.0
,,3,,,Unknown,,cid:16)(cid:17)(cid:16)(cid:27)(cid:28)(cid:1)(cid:29)(cid:30)(cid:28)(cid:28)(cid:31)(cid:29)(cid:27)(cid:32)(cid:33)(cid:31)(cid:1)(cid:2)(cid:3,,2776.0
,,6,,,Unknown,,cid:16)(cid:17)(cid:16)(cid:27)(cid:28)(cid:1)(cid:29)(cid:30)(cid:28)(cid:28)(cid:31)(cid:29)(cid:27)(cid:32)(cid:33)(cid:31)(cid:1)(cid:2)(cid:3,,2782.0
,,8,,,Unknown,,cid:16)(cid:17)(cid:16)(cid:27)(cid:28)(cid:1)(cid:29)(cid:30)(cid:28)(cid:28)(cid:31)(cid:29)(cid:27)(cid:32)(cid:33)(cid:31)(cid:1)(cid:2)(cid:3,,2790.0
,,46,,,Unknown,,cid:16)(cid:17)(cid:16)(cid:27)(cid:28)(cid:1)(cid:29)(cid:30)(cid:28)(cid:28)(cid:31)(cid:29)(cid:27)(cid:32)(cid:33)(cid:31)(cid:1)(cid:2)(cid:3,,2836.0
,,46,,,Unknown,,cid:16)(cid:17)(cid:16)(cid:27)(cid:28)(cid:1)(cid:29)(cid:30)(cid:28)(cid:28)(cid:31)(cid:29)(cid:27)(cid:32)(cid:33)(cid:31)(cid:1)(cid:2)(cid:3,,2882.0
,,47,,,Unknown,,cid:16)(cid:17)(cid:16)(cid:27)(cid:28)(cid:1)(cid:29)(cid:30)(cid:28)(cid:28)(cid:31)(cid:29)(cid:27)(cid:32)(cid:33)(cid:31)(cid:1)(cid:2)(cid:3,,2929.0
,,32,,,Unknown,,cid:16)(cid:17)(cid:16)(cid:27)(cid:28)(cid:1)(cid:29)(cid:30)(cid:28)(cid:28)(cid:31)(cid:29)(cid:27)(cid:32)(cid:33)(cid:31)(cid:1)(cid:2)(cid:3,,2961.0
,,48,,,Unknown,,cid:16)(cid:17)(cid:16)(cid:27)(cid:28)(cid:1)(cid:29)(cid:30)(cid:28)(cid:28)(cid:31)(cid:29)(cid:27)(cid:32)(cid:33)(cid:31)(cid:1)(cid:2)(cid:3,,3009.0
,,49,,,Unknown,,cid:16)(cid:17)(cid:16)(cid:27)(cid:28)(cid:1)(cid:29)(cid:30)(cid:28)(cid:28)(cid:31)(cid:29)(cid:27)(cid:32)(cid:33)(cid:31)(cid:1)(cid:2)(cid:3,,3058.0
,,16,,,Unknown,,cid:16)(cid:17)(cid:16)(cid:27)(cid:28)(cid:1)(cid:29)(cid:30)(cid:28)(cid:28)(cid:31)(cid:29)(cid:27)(cid:32)(cid:33)(cid:31)(cid:1)(cid:2)(cid:3,,3074.0
,,17,,,Unknown,,cid:16)(cid:17)(cid:16)(cid:27)(cid:28)(cid:1)(cid:29)(cid:30)(cid:28)(cid:28)(cid:31)(cid:29)(cid:27)(cid:32)(cid:33)(cid:31)(cid:1)(cid:2)(cid:3,,3091.0
,,16,,,Unknown,,cid:16)(cid:17)(cid:16)(cid:27)(cid:28)(cid:1)(cid:29)(cid:30)(cid:28)(cid:28)(cid:31)(cid:29)(cid:27)(cid:32)(cid:33)(cid:31)(cid:1)(cid:2)(cid:3,,3107.0
,,27,,,Unknown,,cid:16)(cid:17)(cid:16)(cid:27)(cid:28)(cid:1)(cid:29)(cid:30)(cid:28)(cid:28)(cid:31)(cid:29)(cid:27)(cid:32)(cid:33)(cid:31)(cid:1)(cid:2)(cid:3,,3134.0
,,28,,,Unknown,,cid:16)(cid:17)(cid:16)(cid:27)(cid:28)(cid:1)(cid:29)(cid:30)(cid:28)(cid:28)(cid:31)(cid:29)(cid:27)(cid:32)(cid:33)(cid:31)(cid:1)(cid:2)(cid:3,,3162.0
,,1,,,Unknown,,cid:16)(cid:17)(cid:16)(cid:27)(cid:28)(cid:1)(cid:29)(cid:30)(cid:28)(cid:28)(cid:31)(cid:29)(cid:27)(cid:32)(cid:33)(cid:31)(cid:1)(cid:2)(cid:3,,3163.0
,,35,,,Unknown,,cid:16)(cid:17)(cid:16)(cid:27)(cid:28)(cid:1)(cid:29)(cid:30)(cid:28)(cid:28)(cid:31)(cid:29)(cid:27)(cid:32)(cid:33)(cid:31)(cid:1)(cid:2)(cid:3,,3198.0
,,17,,,Unknown,,cid:16)(cid:17)(cid:16)(cid:27)(cid:28)(cid:1)(cid:29)(cid:30)(cid:28)(cid:28)(cid:31)(cid:29)(cid:27)(cid:32)(cid:33)(cid:31)(cid:1)(cid:2)(cid:3,,3215.0
,,32,,,Unknown,,cid:16)(cid:17)(cid:16)(cid:27)(cid:28)(cid:1)(cid:29)(cid:30)(cid:28)(cid:28)(cid:31)(cid:29)(cid:27)(cid:32)(cid:33)(cid:31)(cid:1)(cid:2)(cid:3,,3247.0
,,28,,,Unknown,,cid:16)(cid:17)(cid:16)(cid:27)(cid:28)(cid:1)(cid:29)(cid:30)(cid:28)(cid:28)(cid:31)(cid:29)(cid:27)(cid:32)(cid:33)(cid:31)(cid:1)(cid:2)(cid:3,,3275.0
,,17,,,Unknown,,cid:16)(cid:17)(cid:16)(cid:27)(cid:28)(cid:1)(cid:29)(cid:30)(cid:28)(cid:28)(cid:31)(cid:29)(cid:27)(cid:32)(cid:33)(cid:31)(cid:1)(cid:2)(cid:3,,3292.0
,,34,,,Unknown,,cid:16)(cid:17)(cid:16)(cid:27)(cid:28)(cid:1)(cid:29)(cid:30)(cid:28)(cid:28)(cid:31)(cid:29)(cid:27)(cid:32)(cid:33)(cid:31)(cid:1)(cid:2)(cid:3,,3326.0
,,34,,,Unknown,,cid:16)(cid:17)(cid:16)(cid:27)(cid:28)(cid:1)(cid:29)(cid:30)(cid:28)(cid:28)(cid:31)(cid:29)(cid:27)(cid:32)(cid:33)(cid:31)(cid:1)(cid:2)(cid:3,,3360.0
,,30,,,Unknown,,cid:16)(cid:17)(cid:16)(cid:27)(cid:28)(cid:1)(cid:29)(cid:30)(cid:28)(cid:28)(cid:31)(cid:29)(cid:27)(cid:32)(cid:33)(cid:31)(cid:1)(cid:2)(cid:3,,3390.0
,,31,,,Unknown,,cid:16)(cid:17)(cid:16)(cid:27)(cid:28)(cid:1)(cid:29)(cid:30)(cid:28)(cid:28)(cid:31)(cid:29)(cid:27)(cid:32)(cid:33)(cid:31)(cid:1)(cid:2)(cid:3,,3421.0
,,3,,,Unknown,,cid:16)(cid:17)(cid:16)(cid:27)(cid:28)(cid:1)(cid:29)(cid:30)(cid:28)(cid:28)(cid:31)(cid:29)(cid:27)(cid:32)(cid:33)(cid:31)(cid:1)(cid:2)(cid:3,,3424.0
,,36,,,Unknown,,cid:16)(cid:17)(cid:16)(cid:27)(cid:28)(cid:1)(cid:29)(cid:30)(cid:28)(cid:28)(cid:31)(cid:29)(cid:27)(cid:32)(cid:33)(cid:31)(cid:1)(cid:2)(cid:3,,3460.0
,,1,,,Unknown,,cid:16)(cid:17)(cid:16)(cid:27)(cid:28)(cid:1)(cid:29)(cid:30)(cid:28)(cid:28)(cid:31)(cid:29)(cid:27)(cid:32)(cid:33)(cid:31)(cid:1)(cid:2)(cid:3,,3461.0
,,2,,,Unknown,,cid:16)(cid:17)(cid:16)(cid:27)(cid:28)(cid:1)(cid:29)(cid:30)(cid:28)(cid:28)(cid:31)(cid:29)(cid:27)(cid:32)(cid:33)(cid:31)(cid:1)(cid:2)(cid:3,,3463.0
,,3,,,Unknown,,cid:16)(cid:17)(cid:16)(cid:27)(cid:28)(cid:1)(cid:29)(cid:30)(cid:28)(cid:28)(cid:31)(cid:29)(cid:27)(cid:32)(cid:33)(cid:31)(cid:1)(cid:2)(cid:3,,3466.0
,,10,,,Unknown,,cid:16)(cid:17)(cid:16)(cid:27)(cid:28)(cid:1)(cid:29)(cid:30)(cid:28)(cid:28)(cid:31)(cid:29)(cid:27)(cid:32)(cid:33)(cid:31)(cid:1)(cid:2)(cid:3,,3476.0
,,11,,,Unknown,,cid:16)(cid:17)(cid:16)(cid:27)(cid:28)(cid:1)(cid:29)(cid:30)(cid:28)(cid:28)(cid:31)(cid:29)(cid:27)(cid:32)(cid:33)(cid:31)(cid:1)(cid:2)(cid:3,,3487.0
,,20,,,Unknown,,cid:16)(cid:17)(cid:16)(cid:27)(cid:28)(cid:1)(cid:29)(cid:30)(cid:28)(cid:28)(cid:31)(cid:29)(cid:27)(cid:32)(cid:33)(cid:31)(cid:1)(cid:2)(cid:3,,3507.0
,,10,,,Unknown,,cid:16)(cid:17)(cid:16)(cid:27)(cid:28)(cid:1)(cid:29)(cid:30)(cid:28)(cid:28)(cid:31)(cid:29)(cid:27)(cid:32)(cid:33)(cid:31)(cid:1)(cid:2)(cid:3,,3517.0
,,11,,,Unknown,,cid:16)(cid:17)(cid:16)(cid:27)(cid:28)(cid:1)(cid:29)(cid:30)(cid:28)(cid:28)(cid:31)(cid:29)(cid:27)(cid:32)(cid:33)(cid:31)(cid:1)(cid:2)(cid:3,,3528.0
,,24,,,Unknown,,cid:16)(cid:17)(cid:16)(cid:27)(cid:28)(cid:1)(cid:29)(cid:30)(cid:28)(cid:28)(cid:31)(cid:29)(cid:27)(cid:32)(cid:33)(cid:31)(cid:1)(cid:2)(cid:3,,3552.0
,,1,,,Unknown,,cid:16)(cid:17)(cid:16)(cid:27)(cid:28)(cid:1)(cid:29)(cid:30)(cid:28)(cid:28)(cid:31)(cid:29)(cid:27)(cid:32)(cid:33)(cid:31)(cid:1)(cid:2)(cid:3,,3553.0
,,13,,,Unknown,,cid:16)(cid:17)(cid:16)(cid:27)(cid:28)(cid:1)(cid:29)(cid:30)(cid:28)(cid:28)(cid:31)(cid:29)(cid:27)(cid:32)(cid:33)(cid:31)(cid:1)(cid:2)(cid:3,,3566.0
,,10,,,Unknown,,cid:16)(cid:17)(cid:16)(cid:27)(cid:28)(cid:1)(cid:29)(cid:30)(cid:28)(cid:28)(cid:31)(cid:29)(cid:27)(cid:32)(cid:33)(cid:31)(cid:1)(cid:2)(cid:3,,3576.0
,,25,,,Unknown,,cid:16)(cid:17)(cid:16)(cid:27)(cid:28)(cid:1)(cid:29)(cid:30)(cid:28)(cid:28)(cid:31)(cid:29)(cid:27)(cid:32)(cid:33)(cid:31)(cid:1)(cid:2)(cid:3,,3601.0
,,10,,,Unknown,,cid:16)(cid:17)(cid:16)(cid:27)(cid:28)(cid:1)(cid:29)(cid:30)(cid:28)(cid:28)(cid:31)(cid:29)(cid:27)(cid:32)(cid:33)(cid:31)(cid:1)(cid:2)(cid:3,,3611.0
,,13,,,Unknown,,cid:16)(cid:17)(cid:16)(cid:27)(cid:28)(cid:1)(cid:29)(cid:30)(cid:28)(cid:28)(cid:31)(cid:29)(cid:27)(cid:32)(cid:33)(cid:31)(cid:1)(cid:2)(cid:3,,3624.0
,,1,,,Unknown,,cid:16)(cid:17)(cid:16)(cid:27)(cid:28)(cid:1)(cid:29)(cid:30)(cid:28)(cid:28)(cid:31)(cid:29)(cid:27)(cid:32)(cid:33)(cid:31)(cid:1)(cid:2)(cid:3,,3625.0
,,26,,,Unknown,,cid:16)(cid:17)(cid:16)(cid:27)(cid:28)(cid:1)(cid:29)(cid:30)(cid:28)(cid:28)(cid:31)(cid:29)(cid:27)(cid:32)(cid:33)(cid:31)(cid:1)(cid:2)(cid:3,,3651.0
,,45,,,Unknown,,cid:16)(cid:17)(cid:16)(cid:27)(cid:28)(cid:1)(cid:29)(cid:30)(cid:28)(cid:28)(cid:31)(cid:29)(cid:27)(cid:32)(cid:33)(cid:31)(cid:1)(cid:2)(cid:3,,3696.0
,,10,,,Unknown,,cid:16)(cid:17)(cid:16)(cid:27)(cid:28)(cid:1)(cid:29)(cid:30)(cid:28)(cid:28)(cid:31)(cid:29)(cid:27)(cid:32)(cid:33)(cid:31)(cid:1)(cid:2)(cid:3,,3706.0
,,19,,,Unknown,,cid:16)(cid:17)(cid:16)(cid:27)(cid:28)(cid:1)(cid:29)(cid:30)(cid:28)(cid:28)(cid:31)(cid:29)(cid:27)(cid:32)(cid:33)(cid:31)(cid:1)(cid:2)(cid:3,,3725.0
,,16,,,Unknown,,cid:16)(cid:17)(cid:16)(cid:27)(cid:28)(cid:1)(cid:29)(cid:30)(cid:28)(cid:28)(cid:31)(cid:29)(cid:27)(cid:32)(cid:33)(cid:31)(cid:1)(cid:2)(cid:3,,3741.0
,,7,,,Unknown,,cid:16)(cid:17)(cid:16)(cid:27)(cid:28)(cid:1)(cid:29)(cid:30)(cid:28)(cid:28)(cid:31)(cid:29)(cid:27)(cid:32)(cid:33)(cid:31)(cid:1)(cid:2)(cid:3,,3748.0
,,3,,,Unknown,,cid:16)(cid:17)(cid:16)(cid:27)(cid:28)(cid:1)(cid:29)(cid:30)(cid:28)(cid:28)(cid:31)(cid:29)(cid:27)(cid:32)(cid:33)(cid:31)(cid:1)(cid:2)(cid:3,,3751.0
,,8,,,Unknown,,cid:16)(cid:17)(cid:16)(cid:27)(cid:28)(cid:1)(cid:29)(cid:30)(cid:28)(cid:28)(cid:31)(cid:29)(cid:27)(cid:32)(cid:33)(cid:31)(cid:1)(cid:2)(cid:3,,3759.0
,,28,,,Unknown,,cid:16)(cid:17)(cid:16)(cid:27)(cid:28)(cid:1)(cid:29)(cid:30)(cid:28)(cid:28)(cid:31)(cid:29)(cid:27)(cid:32)(cid:33)(cid:31)(cid:1)(cid:2)(cid:3,,3787.0
,,10,,,Unknown,,cid:16)(cid:17)(cid:16)(cid:27)(cid:28)(cid:1)(cid:29)(cid:30)(cid:28)(cid:28)(cid:31)(cid:29)(cid:27)(cid:32)(cid:33)(cid:31)(cid:1)(cid:2)(cid:3,,3797.0
,,3,,,Unknown,,cid:16)(cid:17)(cid:16)(cid:27)(cid:28)(cid:1)(cid:29)(cid:30)(cid:28)(cid:28)(cid:31)(cid:29)(cid:27)(cid:32)(cid:33)(cid:31)(cid:1)(cid:2)(cid:3,,3800.0
,,6,,,Unknown,,cid:16)(cid:17)(cid:16)(cid:27)(cid:28)(cid:1)(cid:29)(cid:30)(cid:28)(cid:28)(cid:31)(cid:29)(cid:27)(cid:32)(cid:33)(cid:31)(cid:1)(cid:2)(cid:3,,3806.0
,,8,,,Unknown,,cid:16)(cid:17)(cid:16)(cid:27)(cid:28)(cid:1)(cid:29)(cid:30)(cid:28)(cid:28)(cid:31)(cid:29)(cid:27)(cid:32)(cid:33)(cid:31)(cid:1)(cid:2)(cid:3,,3814.0
,,46,,,Unknown,,cid:16)(cid:17)(cid:16)(cid:27)(cid:28)(cid:1)(cid:29)(cid:30)(cid:28)(cid:28)(cid:31)(cid:29)(cid:27)(cid:32)(cid:33)(cid:31)(cid:1)(cid:2)(cid:3,,3860.0
,,46,,,Unknown,,cid:16)(cid:17)(cid:16)(cid:27)(cid:28)(cid:1)(cid:29)(cid:30)(cid:28)(cid:28)(cid:31)(cid:29)(cid:27)(cid:32)(cid:33)(cid:31)(cid:1)(cid:2)(cid:3,,3906.0
,,47,,,Unknown,,cid:16)(cid:17)(cid:16)(cid:27)(cid:28)(cid:1)(cid:29)(cid:30)(cid:28)(cid:28)(cid:31)(cid:29)(cid:27)(cid:32)(cid:33)(cid:31)(cid:1)(cid:2)(cid:3,,3953.0
,,32,,,Unknown,,cid:16)(cid:17)(cid:16)(cid:27)(cid:28)(cid:1)(cid:29)(cid:30)(cid:28)(cid:28)(cid:31)(cid:29)(cid:27)(cid:32)(cid:33)(cid:31)(cid:1)(cid:2)(cid:3,,3985.0
,,48,,,Unknown,,cid:16)(cid:17)(cid:16)(cid:27)(cid:28)(cid:1)(cid:29)(cid:30)(cid:28)(cid:28)(cid:31)(cid:29)(cid:27)(cid:32)(cid:33)(cid:31)(cid:1)(cid:2)(cid:3,,4033.0
,,49,,,Unknown,,cid:16)(cid:17)(cid:16)(cid:27)(cid:28)(cid:1)(cid:29)(cid:30)(cid:28)(cid:28)(cid:31)(cid:29)(cid:27)(cid:32)(cid:33)(cid:31)(cid:1)(cid:2)(cid:3,,4082.0
,,16,,,Unknown,,cid:16)(cid:17)(cid:16)(cid:27)(cid:28)(cid:1)(cid:29)(cid:30)(cid:28)(cid:28)(cid:31)(cid:29)(cid:27)(cid:32)(cid:33)(cid:31)(cid:1)(cid:2)(cid:3,,4098.0
,,17,,,Unknown,,cid:16)(cid:17)(cid:16)(cid:27)(cid:28)(cid:1)(cid:29)(cid:30)(cid:28)(cid:28)(cid:31)(cid:29)(cid:27)(cid:32)(cid:33)(cid:31)(cid:1)(cid:2)(cid:3,,4115.0
,,16,,,Unknown,,cid:16)(cid:17)(cid:16)(cid:27)(cid:28)(cid:1)(cid:29)(cid:30)(cid:28)(cid:28)(cid:31)(cid:29)(cid:27)(cid:32)(cid:33)(cid:31)(cid:1)(cid:2)(cid:3,,4131.0
,,27,,,Unknown,,cid:16)(cid:17)(cid:16)(cid:27)(cid:28)(cid:1)(cid:29)(cid:30)(cid:28)(cid:28)(cid:31)(cid:29)(cid:27)(cid:32)(cid:33)(cid:31)(cid:1)(cid:2)(cid:3,,4158.0
,,28,,,Unknown,,cid:16)(cid:17)(cid:16)(cid:27)(cid:28)(cid:1)(cid:29)(cid:30)(cid:28)(cid:28)(cid:31)(cid:29)(cid:27)(cid:32)(cid:33)(cid:31)(cid:1)(cid:2)(cid:3,,4186.0
,,1,,,Unknown,,cid:16)(cid:17)(cid:16)(cid:27)(cid:28)(cid:1)(cid:29)(cid:30)(cid:28)(cid:28)(cid:31)(cid:29)(cid:27)(cid:32)(cid:33)(cid:31)(cid:1)(cid:2)(cid:3,,4187.0
,,35,,,Unknown,,cid:16)(cid:17)(cid:16)(cid:27)(cid:28)(cid:1)(cid:29)(cid:30)(cid:28)(cid:28)(cid:31)(cid:29)(cid:27)(cid:32)(cid:33)(cid:31)(cid:1)(cid:2)(cid:3,,4222.0
,,17,,,Unknown,,cid:16)(cid:17)(cid:16)(cid:27)(cid:28)(cid:1)(cid:29)(cid:30)(cid:28)(cid:28)(cid:31)(cid:29)(cid:27)(cid:32)(cid:33)(cid:31)(cid:1)(cid:2)(cid:3,,4239.0
,,32,,,Unknown,,cid:16)(cid:17)(cid:16)(cid:27)(cid:28)(cid:1)(cid:29)(cid:30)(cid:28)(cid:28)(cid:31)(cid:29)(cid:27)(cid:32)(cid:33)(cid:31)(cid:1)(cid:2)(cid:3,,4271.0
,,28,,,Unknown,,cid:16)(cid:17)(cid:16)(cid:27)(cid:28)(cid:1)(cid:29)(cid:30)(cid:28)(cid:28)(cid:31)(cid:29)(cid:27)(cid:32)(cid:33)(cid:31)(cid:1)(cid:2)(cid:3,,4299.0
,,17,,,Unknown,,cid:16)(cid:17)(cid:16)(cid:27)(cid:28)(cid:1)(cid:29)(cid:30)(cid:28)(cid:28)(cid:31)(cid:29)(cid:27)(cid:32)(cid:33)(cid:31)(cid:1)(cid:2)(cid:3,,4316.0
,,34,,,Unknown,,cid:16)(cid:17)(cid:16)(cid:27)(cid:28)(cid:1)(cid:29)(cid:30)(cid:28)(cid:28)(cid:31)(cid:29)(cid:27)(cid:32)(cid:33)(cid:31)(cid:1)(cid:2)(cid:3,,4350.0
,,34,,,Unknown,,cid:16)(cid:17)(cid:16)(cid:27)(cid:28)(cid:1)(cid:29)(cid:30)(cid:28)(cid:28)(cid:31)(cid:29)(cid:27)(cid:32)(cid:33)(cid:31)(cid:1)(cid:2)(cid:3,,4384.0
,,30,,,Unknown,,cid:16)(cid:17)(cid:16)(cid:27)(cid:28)(cid:1)(cid:29)(cid:30)(cid:28)(cid:28)(cid:31)(cid:29)(cid:27)(cid:32)(cid:33)(cid:31)(cid:1)(cid:2)(cid:3,,4414.0
,,31,,,Unknown,,cid:16)(cid:17)(cid:16)(cid:27)(cid:28)(cid:1)(cid:29)(cid:30)(cid:28)(cid:28)(cid:31)(cid:29)(cid:27)(cid:32)(cid:33)(cid:31)(cid:1)(cid:2)(cid:3,,4445.0
,,3,,,Unknown,,cid:16)(cid:17)(cid:16)(cid:27)(cid:28)(cid:1)(cid:29)(cid:30)(cid:28)(cid:28)(cid:31)(cid:29)(cid:27)(cid:32)(cid:33)(cid:31)(cid:1)(cid:2)(cid:3,,4448.0
,,36,,,Unknown,,cid:16)(cid:17)(cid:16)(cid:27)(cid:28)(cid:1)(cid:29)(cid:30)(cid:28)(cid:28)(cid:31)(cid:29)(cid:27)(cid:32)(cid:33)(cid:31)(cid:1)(cid:2)(cid:3,,4484.0
,,1,,,Unknown,,cid:16)(cid:17)(cid:16)(cid:27)(cid:28)(cid:1)(cid:29)(cid:30)(cid:28)(cid:28)(cid:31)(cid:29)(cid:27)(cid:32)(cid:33)(cid:31)(cid:1)(cid:2)(cid:3,,4485.0
,,2,,,Unknown,,cid:16)(cid:17)(cid:16)(cid:27)(cid:28)(cid:1)(cid:29)(cid:30)(cid:28)(cid:28)(cid:31)(cid:29)(cid:27)(cid:32)(cid:33)(cid:31)(cid:1)(cid:2)(cid:3,,4487.0
,,3,,,Unknown,,cid:16)(cid:17)(cid:16)(cid:27)(cid:28)(cid:1)(cid:29)(cid:30)(cid:28)(cid:28)(cid:31)(cid:29)(cid:27)(cid:32)(cid:33)(cid:31)(cid:1)(cid:2)(cid:3,,4490.0
,,10,,,Unknown,,cid:16)(cid:17)(cid:16)(cid:27)(cid:28)(cid:1)(cid:29)(cid:30)(cid:28)(cid:28)(cid:31)(cid:29)(cid:27)(cid:32)(cid:33)(cid:31)(cid:1)(cid:2)(cid:3,,4500.0
,,11,,,Unknown,,cid:16)(cid:17)(cid:16)(cid:27)(cid:28)(cid:1)(cid:29)(cid:30)(cid:28)(cid:28)(cid:31)(cid:29)(cid:27)(cid:32)(cid:33)(cid:31)(cid:1)(cid:2)(cid:3,,4511.0
,,20,,,Unknown,,cid:16)(cid:17)(cid:16)(cid:27)(cid:28)(cid:1)(cid:29)(cid:30)(cid:28)(cid:28)(cid:31)(cid:29)(cid:27)(cid:32)(cid:33)(cid:31)(cid:1)(cid:2)(cid:3,,4531.0
,,10,,,Unknown,,cid:16)(cid:17)(cid:16)(cid:27)(cid:28)(cid:1)(cid:29)(cid:30)(cid:28)(cid:28)(cid:31)(cid:29)(cid:27)(cid:32)(cid:33)(cid:31)(cid:1)(cid:2)(cid:3,,4541.0
,,11,,,Unknown,,cid:16)(cid:17)(cid:16)(cid:27)(cid:28)(cid:1)(cid:29)(cid:30)(cid:28)(cid:28)(cid:31)(cid:29)(cid:27)(cid:32)(cid:33)(cid:31)(cid:1)(cid:2)(cid:3,,4552.0
,,24,,,Unknown,,cid:16)(cid:17)(cid:16)(cid:27)(cid:28)(cid:1)(cid:29)(cid:30)(cid:28)(cid:28)(cid:31)(cid:29)(cid:27)(cid:32)(cid:33)(cid:31)(cid:1)(cid:2)(cid:3,,4576.0
,,1,,,Unknown,,cid:16)(cid:17)(cid:16)(cid:27)(cid:28)(cid:1)(cid:29)(cid:30)(cid:28)(cid:28)(cid:31)(cid:29)(cid:27)(cid:32)(cid:33)(cid:31)(cid:1)(cid:2)(cid:3,,4577.0
,,4,,,Unknown,,cid:16)(cid:17)(cid:16)(cid:27)(cid:28)(cid:1)(cid:29)(cid:30)(cid:28)(cid:28)(cid:31)(cid:29)(cid:27)(cid:32)(cid:33)(cid:31)(cid:1)(cid:2)(cid:3,,4581.0
,,11,,,Unknown,,cid:16)(cid:17)(cid:16)(cid:27)(cid:28)(cid:1)(cid:29)(cid:30)(cid:28)(cid:28)(cid:31)(cid:29)(cid:27)(cid:32)(cid:33)(cid:31)(cid:1)(cid:2)(cid:3,,4592.0
,,25,,,Unknown,,cid:16)(cid:17)(cid:16)(cid:27)(cid:28)(cid:1)(cid:29)(cid:30)(cid:28)(cid:28)(cid:31)(cid:29)(cid:27)(cid:32)(cid:33)(cid:31)(cid:1)(cid:2)(cid:3,,4617.0
,,10,,,Unknown,,cid:16)(cid:17)(cid:16)(cid:27)(cid:28)(cid:1)(cid:29)(cid:30)(cid:28)(cid:28)(cid:31)(cid:29)(cid:27)(cid:32)(cid:33)(cid:31)(cid:1)(cid:2)(cid:3,,4627.0
,,10,,,Unknown,,cid:16)(cid:17)(cid:16)(cid:27)(cid:28)(cid:1)(cid:29)(cid:30)(cid:28)(cid:28)(cid:31)(cid:29)(cid:27)(cid:32)(cid:33)(cid:31)(cid:1)(cid:2)(cid:3,,4637.0
,,1,,,Unknown,,cid:16)(cid:17)(cid:16)(cid:27)(cid:28)(cid:1)(cid:29)(cid:30)(cid:28)(cid:28)(cid:31)(cid:29)(cid:27)(cid:32)(cid:33)(cid:31)(cid:1)(cid:2)(cid:3,,4638.0
,,26,,,Unknown,,cid:16)(cid:17)(cid:16)(cid:27)(cid:28)(cid:1)(cid:29)(cid:30)(cid:28)(cid:28)(cid:31)(cid:29)(cid:27)(cid:32)(cid:33)(cid:31)(cid:1)(cid:2)(cid:3,,4664.0
,,45,,,Unknown,,cid:16)(cid:17)(cid:16)(cid:27)(cid:28)(cid:1)(cid:29)(cid:30)(cid:28)(cid:28)(cid:31)(cid:29)(cid:27)(cid:32)(cid:33)(cid:31)(cid:1)(cid:2)(cid:3,,4709.0
,,10,,,Unknown,,cid:16)(cid:17)(cid:16)(cid:27)(cid:28)(cid:1)(cid:29)(cid:30)(cid:28)(cid:28)(cid:31)(cid:29)(cid:27)(cid:32)(cid:33)(cid:31)(cid:1)(cid:2)(cid:3,,4719.0
,,19,,,Unknown,,cid:16)(cid:17)(cid:16)(cid:27)(cid:28)(cid:1)(cid:29)(cid:30)(cid:28)(cid:28)(cid:31)(cid:29)(cid:27)(cid:32)(cid:33)(cid:31)(cid:1)(cid:2)(cid:3,,4738.0
,,16,,,Unknown,,cid:16)(cid:17)(cid:16)(cid:27)(cid:28)(cid:1)(cid:29)(cid:30)(cid:28)(cid:28)(cid:31)(cid:29)(cid:27)(cid:32)(cid:33)(cid:31)(cid:1)(cid:2)(cid:3,,4754.0
,,7,,,Unknown,,cid:16)(cid:17)(cid:16)(cid:27)(cid:28)(cid:1)(cid:29)(cid:30)(cid:28)(cid:28)(cid:31)(cid:29)(cid:27)(cid:32)(cid:33)(cid:31)(cid:1)(cid:2)(cid:3,,4761.0
,,3,,,Unknown,,cid:16)(cid:17)(cid:16)(cid:27)(cid:28)(cid:1)(cid:29)(cid:30)(cid:28)(cid:28)(cid:31)(cid:29)(cid:27)(cid:32)(cid:33)(cid:31)(cid:1)(cid:2)(cid:3,,4764.0
,,8,,,Unknown,,cid:16)(cid:17)(cid:16)(cid:27)(cid:28)(cid:1)(cid:29)(cid:30)(cid:28)(cid:28)(cid:31)(cid:29)(cid:27)(cid:32)(cid:33)(cid:31)(cid:1)(cid:2)(cid:3,,4772.0
,,28,,,Unknown,,cid:16)(cid:17)(cid:16)(cid:27)(cid:28)(cid:1)(cid:29)(cid:30)(cid:28)(cid:28)(cid:31)(cid:29)(cid:27)(cid:32)(cid:33)(cid:31)(cid:1)(cid:2)(cid:3,,4800.0
,,10,,,Unknown,,cid:16)(cid:17)(cid:16)(cid:27)(cid:28)(cid:1)(cid:29)(cid:30)(cid:28)(cid:28)(cid:31)(cid:29)(cid:27)(cid:32)(cid:33)(cid:31)(cid:1)(cid:2)(cid:3,,4810.0
,,3,,,Unknown,,cid:16)(cid:17)(cid:16)(cid:27)(cid:28)(cid:1)(cid:29)(cid:30)(cid:28)(cid:28)(cid:31)(cid:29)(cid:27)(cid:32)(cid:33)(cid:31)(cid:1)(cid:2)(cid:3,,4813.0
,,6,,,Unknown,,cid:16)(cid:17)(cid:16)(cid:27)(cid:28)(cid:1)(cid:29)(cid:30)(cid:28)(cid:28)(cid:31)(cid:29)(cid:27)(cid:32)(cid:33)(cid:31)(cid:1)(cid:2)(cid:3,,4819.0
,,8,,,Unknown,,cid:16)(cid:17)(cid:16)(cid:27)(cid:28)(cid:1)(cid:29)(cid:30)(cid:28)(cid:28)(cid:31)(cid:29)(cid:27)(cid:32)(cid:33)(cid:31)(cid:1)(cid:2)(cid:3,,4827.0
,,46,,,Unknown,,cid:16)(cid:17)(cid:16)(cid:27)(cid:28)(cid:1)(cid:29)(cid:30)(cid:28)(cid:28)(cid:31)(cid:29)(cid:27)(cid:32)(cid:33)(cid:31)(cid:1)(cid:2)(cid:3,,4873.0
,,46,,,Unknown,,cid:16)(cid:17)(cid:16)(cid:27)(cid:28)(cid:1)(cid:29)(cid:30)(cid:28)(cid:28)(cid:31)(cid:29)(cid:27)(cid:32)(cid:33)(cid:31)(cid:1)(cid:2)(cid:3,,4919.0
,,47,,,Unknown,,cid:16)(cid:17)(cid:16)(cid:27)(cid:28)(cid:1)(cid:29)(cid:30)(cid:28)(cid:28)(cid:31)(cid:29)(cid:27)(cid:32)(cid:33)(cid:31)(cid:1)(cid:2)(cid:3,,4966.0
,,32,,,Unknown,,cid:16)(cid:17)(cid:16)(cid:27)(cid:28)(cid:1)(cid:29)(cid:30)(cid:28)(cid:28)(cid:31)(cid:29)(cid:27)(cid:32)(cid:33)(cid:31)(cid:1)(cid:2)(cid:3,,4998.0
,,48,,,Unknown,,cid:16)(cid:17)(cid:16)(cid:27)(cid:28)(cid:1)(cid:29)(cid:30)(cid:28)(cid:28)(cid:31)(cid:29)(cid:27)(cid:32)(cid:33)(cid:31)(cid:1)(cid:2)(cid:3,,5046.0
,,49,,,Unknown,,cid:16)(cid:17)(cid:16)(cid:27)(cid:28)(cid:1)(cid:29)(cid:30)(cid:28)(cid:28)(cid:31)(cid:29)(cid:27)(cid:32)(cid:33)(cid:31)(cid:1)(cid:2)(cid:3,,5095.0
,,36,,,Unknown,,cid:16)(cid:17)(cid:16)(cid:27)(cid:28)(cid:1)(cid:29)(cid:30)(cid:28)(cid:28)(cid:31)(cid:29)(cid:27)(cid:32)(cid:33)(cid:31)(cid:1)(cid:2)(cid:3,,5131.0
,,27,,,Unknown,,cid:16)(cid:17)(cid:16)(cid:27)(cid:28)(cid:1)(cid:29)(cid:30)(cid:28)(cid:28)(cid:31)(cid:29)(cid:27)(cid:32)(cid:33)(cid:31)(cid:1)(cid:2)(cid:3,,5158.0
,,15,,,Unknown,,cid:16)(cid:17)(cid:16)(cid:27)(cid:28)(cid:1)(cid:29)(cid:30)(cid:28)(cid:28)(cid:31)(cid:29)(cid:27)(cid:32)(cid:33)(cid:31)(cid:1)(cid:2)(cid:3,,5173.0
,,31,,,Unknown,,cid:16)(cid:17)(cid:16)(cid:27)(cid:28)(cid:1)(cid:29)(cid:30)(cid:28)(cid:28)(cid:31)(cid:29)(cid:27)(cid:32)(cid:33)(cid:31)(cid:1)(cid:2)(cid:3,,5204.0
,,2,,,Unknown,,cid:16)(cid:17)(cid:16)(cid:27)(cid:28)(cid:1)(cid:29)(cid:30)(cid:28)(cid:28)(cid:31)(cid:29)(cid:27)(cid:32)(cid:33)(cid:31)(cid:1)(cid:2)(cid:3,,5206.0
,,1,,,Unknown,,cid:16)(cid:17)(cid:16)(cid:27)(cid:28)(cid:1)(cid:29)(cid:30)(cid:28)(cid:28)(cid:31)(cid:29)(cid:27)(cid:32)(cid:33)(cid:31)(cid:1)(cid:2)(cid:3,,5207.0
,,27,,,Unknown,,cid:16)(cid:17)(cid:16)(cid:27)(cid:28)(cid:1)(cid:29)(cid:30)(cid:28)(cid:28)(cid:31)(cid:29)(cid:27)(cid:32)(cid:33)(cid:31)(cid:1)(cid:2)(cid:3,,5234.0
,,32,,,Unknown,,cid:16)(cid:17)(cid:16)(cid:27)(cid:28)(cid:1)(cid:29)(cid:30)(cid:28)(cid:28)(cid:31)(cid:29)(cid:27)(cid:32)(cid:33)(cid:31)(cid:1)(cid:2)(cid:3,,5266.0
,,16,,,Unknown,,cid:16)(cid:17)(cid:16)(cid:27)(cid:28)(cid:1)(cid:29)(cid:30)(cid:28)(cid:28)(cid:31)(cid:29)(cid:27)(cid:32)(cid:33)(cid:31)(cid:1)(cid:2)(cid:3,,5282.0
,,17,,,Unknown,,cid:16)(cid:17)(cid:16)(cid:27)(cid:28)(cid:1)(cid:29)(cid:30)(cid:28)(cid:28)(cid:31)(cid:29)(cid:27)(cid:32)(cid:33)(cid:31)(cid:1)(cid:2)(cid:3,,5299.0
,,3,,,Unknown,,cid:16)(cid:17)(cid:16)(cid:27)(cid:28)(cid:1)(cid:29)(cid:30)(cid:28)(cid:28)(cid:31)(cid:29)(cid:27)(cid:32)(cid:33)(cid:31)(cid:1)(cid:2)(cid:3,,5302.0
,,17,,,Unknown,,cid:16)(cid:17)(cid:16)(cid:27)(cid:28)(cid:1)(cid:29)(cid:30)(cid:28)(cid:28)(cid:31)(cid:29)(cid:27)(cid:32)(cid:33)(cid:31)(cid:1)(cid:2)(cid:3,,5319.0
,,32,,,Unknown,,cid:16)(cid:17)(cid:16)(cid:27)(cid:28)(cid:1)(cid:29)(cid:30)(cid:28)(cid:28)(cid:31)(cid:29)(cid:27)(cid:32)(cid:33)(cid:31)(cid:1)(cid:2)(cid:3,,5351.0
,,16,,,Unknown,,cid:16)(cid:17)(cid:16)(cid:27)(cid:28)(cid:1)(cid:29)(cid:30)(cid:28)(cid:28)(cid:31)(cid:29)(cid:27)(cid:32)(cid:33)(cid:31)(cid:1)(cid:2)(cid:3,,5367.0
,,31,,,Unknown,,cid:16)(cid:17)(cid:16)(cid:27)(cid:28)(cid:1)(cid:29)(cid:30)(cid:28)(cid:28)(cid:31)(cid:29)(cid:27)(cid:32)(cid:33)(cid:31)(cid:1)(cid:2)(cid:3,,5398.0
,,1,,,Unknown,,cid:16)(cid:17)(cid:16)(cid:27)(cid:28)(cid:1)(cid:29)(cid:30)(cid:28)(cid:28)(cid:31)(cid:29)(cid:27)(cid:32)(cid:33)(cid:31)(cid:1)(cid:2)(cid:3,,5399.0
,,36,,,Unknown,,cid:16)(cid:17)(cid:16)(cid:27)(cid:28)(cid:1)(cid:29)(cid:30)(cid:28)(cid:28)(cid:31)(cid:29)(cid:27)(cid:32)(cid:33)(cid:31)(cid:1)(cid:2)(cid:3,,5435.0
,,31,,,Unknown,,cid:16)(cid:17)(cid:16)(cid:27)(cid:28)(cid:1)(cid:29)(cid:30)(cid:28)(cid:28)(cid:31)(cid:29)(cid:27)(cid:32)(cid:33)(cid:31)(cid:1)(cid:2)(cid:3,,5466.0
,,15,,,Unknown,,cid:16)(cid:17)(cid:16)(cid:27)(cid:28)(cid:1)(cid:29)(cid:30)(cid:28)(cid:28)(cid:31)(cid:29)(cid:27)(cid:32)(cid:33)(cid:31)(cid:1)(cid:2)(cid:3,,5481.0
,,28,,,Unknown,,cid:16)(cid:17)(cid:16)(cid:27)(cid:28)(cid:1)(cid:29)(cid:30)(cid:28)(cid:28)(cid:31)(cid:29)(cid:27)(cid:32)(cid:33)(cid:31)(cid:1)(cid:2)(cid:3,,5509.0
,,30,,,Unknown,,cid:16)(cid:17)(cid:16)(cid:27)(cid:28)(cid:1)(cid:29)(cid:30)(cid:28)(cid:28)(cid:31)(cid:29)(cid:27)(cid:32)(cid:33)(cid:31)(cid:1)(cid:2)(cid:3,,5539.0
,,36,,,Unknown,,cid:16)(cid:17)(cid:16)(cid:27)(cid:28)(cid:1)(cid:29)(cid:30)(cid:28)(cid:28)(cid:31)(cid:29)(cid:27)(cid:32)(cid:33)(cid:31)(cid:1)(cid:2)(cid:3,,5575.0
,,1,,,Unknown,,cid:16)(cid:17)(cid:16)(cid:27)(cid:28)(cid:1)(cid:29)(cid:30)(cid:28)(cid:28)(cid:31)(cid:29)(cid:27)(cid:32)(cid:33)(cid:31)(cid:1)(cid:2)(cid:3,,5576.0
,,35,,,Unknown,,cid:16)(cid:17)(cid:16)(cid:27)(cid:28)(cid:1)(cid:29)(cid:30)(cid:28)(cid:28)(cid:31)(cid:29)(cid:27)(cid:32)(cid:33)(cid:31)(cid:1)(cid:2)(cid:3,,5611.0
,,31,,,Unknown,,cid:16)(cid:17)(cid:16)(cid:27)(cid:28)(cid:1)(cid:29)(cid:30)(cid:28)(cid:28)(cid:31)(cid:29)(cid:27)(cid:32)(cid:33)(cid:31)(cid:1)(cid:2)(cid:3,,5642.0
,,33,,,Unknown,,cid:16)(cid:17)(cid:16)(cid:27)(cid:28)(cid:1)(cid:29)(cid:30)(cid:28)(cid:28)(cid:31)(cid:29)(cid:27)(cid:32)(cid:33)(cid:31)(cid:1)(cid:2)(cid:3,,5675.0
,,31,,,Unknown,,cid:16)(cid:17)(cid:16)(cid:27)(cid:28)(cid:1)(cid:29)(cid:30)(cid:28)(cid:28)(cid:31)(cid:29)(cid:27)(cid:32)(cid:33)(cid:31)(cid:1)(cid:2)(cid:3,,5706.0
,,19,,,Unknown,,cid:16)(cid:17)(cid:16)(cid:27)(cid:28)(cid:1)(cid:29)(cid:30)(cid:28)(cid:28)(cid:31)(cid:29)(cid:27)(cid:32)(cid:33)(cid:31)(cid:1)(cid:2)(cid:3,,5725.0
,,1,,,Unknown,,cid:16)(cid:17)(cid:16)(cid:27)(cid:28)(cid:1)(cid:29)(cid:30)(cid:28)(cid:28)(cid:31)(cid:29)(cid:27)(cid:32)(cid:33)(cid:31)(cid:1)(cid:2)(cid:3,,5726.0
,,2,,,Unknown,,cid:16)(cid:17)(cid:16)(cid:27)(cid:28)(cid:1)(cid:29)(cid:30)(cid:28)(cid:28)(cid:31)(cid:29)(cid:27)(cid:32)(cid:33)(cid:31)(cid:1)(cid:2)(cid:3,,5728.0
,,3,,,Unknown,,cid:16)(cid:17)(cid:16)(cid:27)(cid:28)(cid:1)(cid:29)(cid:30)(cid:28)(cid:28)(cid:31)(cid:29)(cid:27)(cid:32)(cid:33)(cid:31)(cid:1)(cid:2)(cid:3,,5731.0
,,10,,,Unknown,,cid:16)(cid:17)(cid:16)(cid:27)(cid:28)(cid:1)(cid:29)(cid:30)(cid:28)(cid:28)(cid:31)(cid:29)(cid:27)(cid:32)(cid:33)(cid:31)(cid:1)(cid:2)(cid:3,,5741.0
,,11,,,Unknown,,cid:16)(cid:17)(cid:16)(cid:27)(cid:28)(cid:1)(cid:29)(cid:30)(cid:28)(cid:28)(cid:31)(cid:29)(cid:27)(cid:32)(cid:33)(cid:31)(cid:1)(cid:2)(cid:3,,5752.0
,,20,,,Unknown,,cid:16)(cid:17)(cid:16)(cid:27)(cid:28)(cid:1)(cid:29)(cid:30)(cid:28)(cid:28)(cid:31)(cid:29)(cid:27)(cid:32)(cid:33)(cid:31)(cid:1)(cid:2)(cid:3,,5772.0
,,10,,,Unknown,,cid:16)(cid:17)(cid:16)(cid:27)(cid:28)(cid:1)(cid:29)(cid:30)(cid:28)(cid:28)(cid:31)(cid:29)(cid:27)(cid:32)(cid:33)(cid:31)(cid:1)(cid:2)(cid:3,,5782.0
,,11,,,Unknown,,cid:16)(cid:17)(cid:16)(cid:27)(cid:28)(cid:1)(cid:29)(cid:30)(cid:28)(cid:28)(cid:31)(cid:29)(cid:27)(cid:32)(cid:33)(cid:31)(cid:1)(cid:2)(cid:3,,5793.0
,,24,,,Unknown,,cid:16)(cid:17)(cid:16)(cid:27)(cid:28)(cid:1)(cid:29)(cid:30)(cid:28)(cid:28)(cid:31)(cid:29)(cid:27)(cid:32)(cid:33)(cid:31)(cid:1)(cid:2)(cid:3,,5817.0
,,1,,,Unknown,,cid:16)(cid:17)(cid:16)(cid:27)(cid:28)(cid:1)(cid:29)(cid:30)(cid:28)(cid:28)(cid:31)(cid:29)(cid:27)(cid:32)(cid:33)(cid:31)(cid:1)(cid:2)(cid:3,,5818.0
,,6,,,Unknown,,cid:16)(cid:17)(cid:16)(cid:27)(cid:28)(cid:1)(cid:29)(cid:30)(cid:28)(cid:28)(cid:31)(cid:29)(cid:27)(cid:32)(cid:33)(cid:31)(cid:1)(cid:2)(cid:3,,5824.0
,,25,,,Unknown,,cid:16)(cid:17)(cid:16)(cid:27)(cid:28)(cid:1)(cid:29)(cid:30)(cid:28)(cid:28)(cid:31)(cid:29)(cid:27)(cid:32)(cid:33)(cid:31)(cid:1)(cid:2)(cid:3,,5849.0
,,7,,,Unknown,,cid:16)(cid:17)(cid:16)(cid:27)(cid:28)(cid:1)(cid:29)(cid:30)(cid:28)(cid:28)(cid:31)(cid:29)(cid:27)(cid:32)(cid:33)(cid:31)(cid:1)(cid:2)(cid:3,,5856.0
,,10,,,Unknown,,cid:16)(cid:17)(cid:16)(cid:27)(cid:28)(cid:1)(cid:29)(cid:30)(cid:28)(cid:28)(cid:31)(cid:29)(cid:27)(cid:32)(cid:33)(cid:31)(cid:1)(cid:2)(cid:3,,5866.0
,,1,,,Unknown,,cid:16)(cid:17)(cid:16)(cid:27)(cid:28)(cid:1)(cid:29)(cid:30)(cid:28)(cid:28)(cid:31)(cid:29)(cid:27)(cid:32)(cid:33)(cid:31)(cid:1)(cid:2)(cid:3,,5867.0
,,26,,,Unknown,,cid:16)(cid:17)(cid:16)(cid:27)(cid:28)(cid:1)(cid:29)(cid:30)(cid:28)(cid:28)(cid:31)(cid:29)(cid:27)(cid:32)(cid:33)(cid:31)(cid:1)(cid:2)(cid:3,,5893.0
,,45,,,Unknown,,cid:16)(cid:17)(cid:16)(cid:27)(cid:28)(cid:1)(cid:29)(cid:30)(cid:28)(cid:28)(cid:31)(cid:29)(cid:27)(cid:32)(cid:33)(cid:31)(cid:1)(cid:2)(cid:3,,5938.0
,,10,,,Unknown,,cid:16)(cid:17)(cid:16)(cid:27)(cid:28)(cid:1)(cid:29)(cid:30)(cid:28)(cid:28)(cid:31)(cid:29)(cid:27)(cid:32)(cid:33)(cid:31)(cid:1)(cid:2)(cid:3,,5948.0
,,19,,,Unknown,,cid:16)(cid:17)(cid:16)(cid:27)(cid:28)(cid:1)(cid:29)(cid:30)(cid:28)(cid:28)(cid:31)(cid:29)(cid:27)(cid:32)(cid:33)(cid:31)(cid:1)(cid:2)(cid:3,,5967.0
,,16,,,Unknown,,cid:16)(cid:17)(cid:16)(cid:27)(cid:28)(cid:1)(cid:29)(cid:30)(cid:28)(cid:28)(cid:31)(cid:29)(cid:27)(cid:32)(cid:33)(cid:31)(cid:1)(cid:2)(cid:3,,5983.0
,,7,,,Unknown,,cid:16)(cid:17)(cid:16)(cid:27)(cid:28)(cid:1)(cid:29)(cid:30)(cid:28)(cid:28)(cid:31)(cid:29)(cid:27)(cid:32)(cid:33)(cid:31)(cid:1)(cid:2)(cid:3,,5990.0
,,3,,,Unknown,,cid:16)(cid:17)(cid:16)(cid:27)(cid:28)(cid:1)(cid:29)(cid:30)(cid:28)(cid:28)(cid:31)(cid:29)(cid:27)(cid:32)(cid:33)(cid:31)(cid:1)(cid:2)(cid:3,,5993.0
,,8,,,Unknown,,cid:16)(cid:17)(cid:16)(cid:27)(cid:28)(cid:1)(cid:29)(cid:30)(cid:28)(cid:28)(cid:31)(cid:29)(cid:27)(cid:32)(cid:33)(cid:31)(cid:1)(cid:2)(cid:3,,6001.0
,,28,,,Unknown,,cid:16)(cid:17)(cid:16)(cid:27)(cid:28)(cid:1)(cid:29)(cid:30)(cid:28)(cid:28)(cid:31)(cid:29)(cid:27)(cid:32)(cid:33)(cid:31)(cid:1)(cid:2)(cid:3,,6029.0
,,10,,,Unknown,,cid:16)(cid:17)(cid:16)(cid:27)(cid:28)(cid:1)(cid:29)(cid:30)(cid:28)(cid:28)(cid:31)(cid:29)(cid:27)(cid:32)(cid:33)(cid:31)(cid:1)(cid:2)(cid:3,,6039.0
,,3,,,Unknown,,cid:16)(cid:17)(cid:16)(cid:27)(cid:28)(cid:1)(cid:29)(cid:30)(cid:28)(cid:28)(cid:31)(cid:29)(cid:27)(cid:32)(cid:33)(cid:31)(cid:1)(cid:2)(cid:3,,6042.0
,,6,,,Unknown,,cid:16)(cid:17)(cid:16)(cid:27)(cid:28)(cid:1)(cid:29)(cid:30)(cid:28)(cid:28)(cid:31)(cid:29)(cid:27)(cid:32)(cid:33)(cid:31)(cid:1)(cid:2)(cid:3,,6048.0
,,8,,,Unknown,,cid:16)(cid:17)(cid:16)(cid:27)(cid:28)(cid:1)(cid:29)(cid:30)(cid:28)(cid:28)(cid:31)(cid:29)(cid:27)(cid:32)(cid:33)(cid:31)(cid:1)(cid:2)(cid:3,,6056.0
,,46,,,Unknown,,cid:16)(cid:17)(cid:16)(cid:27)(cid:28)(cid:1)(cid:29)(cid:30)(cid:28)(cid:28)(cid:31)(cid:29)(cid:27)(cid:32)(cid:33)(cid:31)(cid:1)(cid:2)(cid:3,,6102.0
,,46,,,Unknown,,cid:16)(cid:17)(cid:16)(cid:27)(cid:28)(cid:1)(cid:29)(cid:30)(cid:28)(cid:28)(cid:31)(cid:29)(cid:27)(cid:32)(cid:33)(cid:31)(cid:1)(cid:2)(cid:3,,6148.0
,,47,,,Unknown,,cid:16)(cid:17)(cid:16)(cid:27)(cid:28)(cid:1)(cid:29)(cid:30)(cid:28)(cid:28)(cid:31)(cid:29)(cid:27)(cid:32)(cid:33)(cid:31)(cid:1)(cid:2)(cid:3,,6195.0
,,32,,,Unknown,,cid:16)(cid:17)(cid:16)(cid:27)(cid:28)(cid:1)(cid:29)(cid:30)(cid:28)(cid:28)(cid:31)(cid:29)(cid:27)(cid:32)(cid:33)(cid:31)(cid:1)(cid:2)(cid:3,,6227.0
,,48,,,Unknown,,cid:16)(cid:17)(cid:16)(cid:27)(cid:28)(cid:1)(cid:29)(cid:30)(cid:28)(cid:28)(cid:31)(cid:29)(cid:27)(cid:32)(cid:33)(cid:31)(cid:1)(cid:2)(cid:3,,6275.0
,,49,,,Unknown,,cid:16)(cid:17)(cid:16)(cid:27)(cid:28)(cid:1)(cid:29)(cid:30)(cid:28)(cid:28)(cid:31)(cid:29)(cid:27)(cid:32)(cid:33)(cid:31)(cid:1)(cid:2)(cid:3,,6324.0
,,10,,,Unknown,,cid:10)(cid:13)(cid:20)(cid:10)(cid:11,cid:41)(cid:27)(cid:28)(cid:2)(cid:17)(cid:15,10.0
,,13,,,Unknown,,cid:10)(cid:13)(cid:20)(cid:10)(cid:11,cid:39)(cid:1)(cid:11)(cid:4)(cid:10)(cid:25)(cid:10)(cid:10)(cid:1)(cid:26,23.0
,,20,,,Unknown,,cid:10)(cid:13)(cid:20)(cid:10)(cid:11,cid:24)(cid:1)(cid:11)(cid:25)(cid:9)(cid:10)(cid:1)(cid:26,43.0
,,10,,,Unknown,,cid:10)(cid:13)(cid:20)(cid:10)(cid:11,cid:18)(cid:30)(cid:43)(cid:43)(cid:27)(cid:1)(cid:42)(cid:17)(cid:16)(cid:1)(cid:40)(cid:3)(cid:30)(cid:28)(cid:28)(cid:1)(cid:28)(cid:27)(cid:1)(cid:2)(cid:31)(cid:3)(cid:16)(cid:31)(cid:1)(cid:40)(cid:27)(cid:32)(cid:35)(cid:1)(cid:2)(cid:3,53.0
,,11,,,Unknown,,cid:10)(cid:13)(cid:20)(cid:10)(cid:11,cid:28)(cid:27)(cid:1)(cid:36)(cid:32)(cid:35)(cid:3)(cid:31)(cid:3)(cid:30)(cid:31)(cid:1)(cid:35)(cid:17)(cid:32)(cid:28)(cid:17)(cid:34)(cid:34)(cid:30)(cid:31)(cid:3)(cid:36)(cid:1)(cid:2)(cid:3,64.0
,,33,,,Unknown,,cid:10)(cid:13)(cid:20)(cid:10)(cid:11,cid:24)(cid:1)(cid:12)(cid:7)(cid:4)(cid:25)(cid:12)(cid:11)(cid:1)(cid:26,97.0
,,27,,,Unknown,,cid:10)(cid:13)(cid:20)(cid:10)(cid:11,cid:24)(cid:1)(cid:13)(cid:4)(cid:25)(cid:13)(cid:8)(cid:1)(cid:26,124.0
,,37,,,Unknown,,cid:10)(cid:13)(cid:20)(cid:10)(cid:11,,161.0
,,38,,,Unknown,,cid:10)(cid:13)(cid:20)(cid:10)(cid:11,,199.0
,,39,,,Unknown,,cid:10)(cid:13)(cid:20)(cid:10)(cid:11,,238.0
,,1,,,Unknown,,cid:10)(cid:13)(cid:20)(cid:10)(cid:11,,239.0
,,11,,,Unknown,,cid:10)(cid:13)(cid:20)(cid:10)(cid:11,,250.0
,,7,,,Unknown,,cid:10)(cid:13)(cid:20)(cid:10)(cid:11,,257.0
,,10,,,Unknown,,cid:10)(cid:13)(cid:20)(cid:10)(cid:11,,267.0
,,25,,,Unknown,,cid:10)(cid:13)(cid:20)(cid:10)(cid:11,,292.0
,,10,,,Unknown,,cid:10)(cid:13)(cid:20)(cid:10)(cid:11,,302.0
,,10,,,Unknown,,cid:10)(cid:13)(cid:20)(cid:10)(cid:11,,312.0
,,1,,,Unknown,,cid:10)(cid:13)(cid:20)(cid:10)(cid:11,,313.0
,,26,,,Unknown,,cid:10)(cid:13)(cid:20)(cid:10)(cid:11,,339.0
,,10,,,Unknown,,cid:10)(cid:13)(cid:20)(cid:10)(cid:11,,349.0
,,13,,,Unknown,,cid:10)(cid:13)(cid:20)(cid:10)(cid:11,,362.0
,,20,,,Unknown,,cid:10)(cid:13)(cid:20)(cid:10)(cid:11,,382.0
,,10,,,Unknown,,cid:10)(cid:13)(cid:20)(cid:10)(cid:11,,392.0
,,11,,,Unknown,,cid:10)(cid:13)(cid:20)(cid:10)(cid:11,,403.0
,,34,,,Unknown,,cid:10)(cid:13)(cid:20)(cid:10)(cid:11,,437.0
,,27,,,Unknown,,cid:10)(cid:13)(cid:20)(cid:10)(cid:11,,464.0
,,40,,,Unknown,,cid:10)(cid:13)(cid:20)(cid:10)(cid:11,,504.0
,,1,,,Unknown,,cid:10)(cid:13)(cid:20)(cid:10)(cid:11,,505.0
,,37,,,Unknown,,cid:10)(cid:13)(cid:20)(cid:10)(cid:11,,542.0
,,27,,,Unknown,,cid:10)(cid:13)(cid:20)(cid:10)(cid:11,,569.0
,,16,,,Unknown,,cid:10)(cid:13)(cid:20)(cid:10)(cid:11,,585.0
,,39,,,Unknown,,cid:10)(cid:13)(cid:20)(cid:10)(cid:11,,624.0
,,1,,,Unknown,,cid:10)(cid:13)(cid:20)(cid:10)(cid:11,,625.0
,,11,,,Unknown,,cid:10)(cid:13)(cid:20)(cid:10)(cid:11,,636.0
,,12,,,Unknown,,cid:10)(cid:13)(cid:20)(cid:10)(cid:11,,648.0
,,8,,,Unknown,,cid:10)(cid:13)(cid:20)(cid:10)(cid:11,,656.0
,,25,,,Unknown,,cid:10)(cid:13)(cid:20)(cid:10)(cid:11,,681.0
,,10,,,Unknown,,cid:10)(cid:13)(cid:20)(cid:10)(cid:11,,691.0
,,10,,,Unknown,,cid:10)(cid:13)(cid:20)(cid:10)(cid:11,,701.0
,,1,,,Unknown,,cid:10)(cid:13)(cid:20)(cid:10)(cid:11,,702.0
,,26,,,Unknown,,cid:10)(cid:13)(cid:20)(cid:10)(cid:11,,728.0
,,10,,,Unknown,,cid:10)(cid:13)(cid:20)(cid:10)(cid:11,,738.0
,,13,,,Unknown,,cid:10)(cid:13)(cid:20)(cid:10)(cid:11,,751.0
,,20,,,Unknown,,cid:10)(cid:13)(cid:20)(cid:10)(cid:11,,771.0
,,10,,,Unknown,,cid:10)(cid:13)(cid:20)(cid:10)(cid:11,,781.0
,,11,,,Unknown,,cid:10)(cid:13)(cid:20)(cid:10)(cid:11,,792.0
,,40,,,Unknown,,cid:10)(cid:13)(cid:20)(cid:10)(cid:11,,832.0
,,27,,,Unknown,,cid:10)(cid:13)(cid:20)(cid:10)(cid:11,,859.0
,,32,,,Unknown,,cid:10)(cid:13)(cid:20)(cid:10)(cid:11,,891.0
,,33,,,Unknown,,cid:10)(cid:13)(cid:20)(cid:10)(cid:11,,924.0
,,38,,,Unknown,,cid:10)(cid:13)(cid:20)(cid:10)(cid:11,,962.0
,,39,,,Unknown,,cid:10)(cid:13)(cid:20)(cid:10)(cid:11,,1001.0
,,1,,,Unknown,,cid:10)(cid:13)(cid:20)(cid:10)(cid:11,,1002.0
,,6,,,Unknown,,cid:10)(cid:13)(cid:20)(cid:10)(cid:11,,1008.0
,,8,,,Unknown,,cid:10)(cid:13)(cid:20)(cid:10)(cid:11,,1016.0
,,10,,,Unknown,,cid:10)(cid:13)(cid:20)(cid:10)(cid:11,,1026.0
,,25,,,Unknown,,cid:10)(cid:13)(cid:20)(cid:10)(cid:11,,1051.0
,,10,,,Unknown,,cid:10)(cid:13)(cid:20)(cid:10)(cid:11,,1061.0
,,10,,,Unknown,,cid:10)(cid:13)(cid:20)(cid:10)(cid:11,,1071.0
,,1,,,Unknown,,cid:10)(cid:13)(cid:20)(cid:10)(cid:11,,1072.0
,,26,,,Unknown,,cid:10)(cid:13)(cid:20)(cid:10)(cid:11,,1098.0
,,10,,,Unknown,,cid:10)(cid:13)(cid:20)(cid:10)(cid:11,,1108.0
,,13,,,Unknown,,cid:10)(cid:13)(cid:20)(cid:10)(cid:11,,1121.0
,,20,,,Unknown,,cid:10)(cid:13)(cid:20)(cid:10)(cid:11,,1141.0
,,10,,,Unknown,,cid:10)(cid:13)(cid:20)(cid:10)(cid:11,,1151.0
,,11,,,Unknown,,cid:10)(cid:13)(cid:20)(cid:10)(cid:11,,1162.0
,,36,,,Unknown,,cid:10)(cid:13)(cid:20)(cid:10)(cid:11,,1198.0
,,27,,,Unknown,,cid:10)(cid:13)(cid:20)(cid:10)(cid:11,,1225.0
,,28,,,Unknown,,cid:10)(cid:13)(cid:20)(cid:10)(cid:11,,1253.0
,,29,,,Unknown,,cid:10)(cid:13)(cid:20)(cid:10)(cid:11,,1282.0
,,30,,,Unknown,,cid:10)(cid:13)(cid:20)(cid:10)(cid:11,,1312.0
,,39,,,Unknown,,cid:10)(cid:13)(cid:20)(cid:10)(cid:11,,1351.0
,,1,,,Unknown,,cid:10)(cid:13)(cid:20)(cid:10)(cid:11,,1352.0
,,11,,,Unknown,,cid:10)(cid:13)(cid:20)(cid:10)(cid:11,,1363.0
,,12,,,Unknown,,cid:10)(cid:13)(cid:20)(cid:10)(cid:11,,1375.0
,,10,,,Unknown,,cid:10)(cid:13)(cid:20)(cid:10)(cid:11,,1385.0
,,25,,,Unknown,,cid:10)(cid:13)(cid:20)(cid:10)(cid:11,,1410.0
,,10,,,Unknown,,cid:10)(cid:13)(cid:20)(cid:10)(cid:11,,1420.0
,,10,,,Unknown,,cid:10)(cid:13)(cid:20)(cid:10)(cid:11,,1430.0
,,1,,,Unknown,,cid:10)(cid:13)(cid:20)(cid:10)(cid:11,,1431.0
,,26,,,Unknown,,cid:10)(cid:13)(cid:20)(cid:10)(cid:11,,1457.0
,,10,,,Unknown,,cid:10)(cid:13)(cid:20)(cid:10)(cid:11,,1467.0
,,13,,,Unknown,,cid:10)(cid:13)(cid:20)(cid:10)(cid:11,,1480.0
,,20,,,Unknown,,cid:10)(cid:13)(cid:20)(cid:10)(cid:11,,1500.0
,,10,,,Unknown,,cid:10)(cid:13)(cid:20)(cid:10)(cid:11,,1510.0
,,11,,,Unknown,,cid:10)(cid:13)(cid:20)(cid:10)(cid:11,,1521.0
,,41,,,Unknown,,cid:10)(cid:13)(cid:20)(cid:10)(cid:11,,1562.0
,,27,,,Unknown,,cid:10)(cid:13)(cid:20)(cid:10)(cid:11,,1589.0
,,28,,,Unknown,,cid:10)(cid:13)(cid:20)(cid:10)(cid:11,,1617.0
,,2,,,Unknown,,cid:10)(cid:13)(cid:20)(cid:10)(cid:11,,1619.0
,,17,,,Unknown,,cid:10)(cid:13)(cid:20)(cid:10)(cid:11,,1636.0
,,15,,,Unknown,,cid:10)(cid:13)(cid:20)(cid:10)(cid:11,,1651.0
,,39,,,Unknown,,cid:10)(cid:13)(cid:20)(cid:10)(cid:11,,1690.0
,,1,,,Unknown,,cid:10)(cid:13)(cid:20)(cid:10)(cid:11,,1691.0
,,11,,,Unknown,,cid:10)(cid:13)(cid:20)(cid:10)(cid:11,,1702.0
,,4,,,Unknown,,cid:10)(cid:13)(cid:20)(cid:10)(cid:11,,1706.0
,,10,,,Unknown,,cid:10)(cid:13)(cid:20)(cid:10)(cid:11,,1716.0
,,25,,,Unknown,,cid:10)(cid:13)(cid:20)(cid:10)(cid:11,,1741.0
,,10,,,Unknown,,cid:10)(cid:13)(cid:20)(cid:10)(cid:11,,1751.0
,,10,,,Unknown,,cid:10)(cid:13)(cid:20)(cid:10)(cid:11,,1761.0
,,1,,,Unknown,,cid:10)(cid:13)(cid:20)(cid:10)(cid:11,,1762.0
,,26,,,Unknown,,cid:10)(cid:13)(cid:20)(cid:10)(cid:11,,1788.0
,,10,,,Unknown,,cid:10)(cid:13)(cid:20)(cid:10)(cid:11,,1798.0
,,13,,,Unknown,,cid:10)(cid:13)(cid:20)(cid:10)(cid:11,,1811.0
,,20,,,Unknown,,cid:10)(cid:13)(cid:20)(cid:10)(cid:11,,1831.0
,,10,,,Unknown,,cid:10)(cid:13)(cid:20)(cid:10)(cid:11,,1841.0
,,11,,,Unknown,,cid:10)(cid:13)(cid:20)(cid:10)(cid:11,,1852.0
,,14,,,Unknown,,cid:10)(cid:13)(cid:20)(cid:10)(cid:11,,1866.0
,,21,,,Unknown,,cid:10)(cid:13)(cid:20)(cid:10)(cid:11,,1887.0
,,22,,,Unknown,,cid:10)(cid:13)(cid:20)(cid:10)(cid:11,,1909.0
,,23,,,Unknown,,cid:10)(cid:13)(cid:20)(cid:10)(cid:11,,1932.0
,,21,,,Unknown,,cid:10)(cid:13)(cid:20)(cid:10)(cid:11,,1953.0
,,24,,,Unknown,,cid:10)(cid:13)(cid:20)(cid:10)(cid:11,,1977.0
,,1,,,Unknown,,cid:10)(cid:13)(cid:20)(cid:10)(cid:11,,1978.0
,,11,,,Unknown,,cid:10)(cid:13)(cid:20)(cid:10)(cid:11,,1989.0
,,25,,,Unknown,,cid:10)(cid:13)(cid:20)(cid:10)(cid:11,,2014.0
,,12,,,Unknown,,cid:10)(cid:13)(cid:20)(cid:10)(cid:11,,2026.0
,,10,,,Unknown,,cid:10)(cid:13)(cid:20)(cid:10)(cid:11,,2036.0
,,1,,,Unknown,,cid:10)(cid:13)(cid:20)(cid:10)(cid:11,,2037.0
,,26,,,Unknown,,cid:10)(cid:13)(cid:20)(cid:10)(cid:11,,2063.0
,,10,,,Unknown,,cid:10)(cid:13)(cid:20)(cid:10)(cid:11,,2073.0
,,13,,,Unknown,,cid:10)(cid:13)(cid:20)(cid:10)(cid:11,,2086.0
,,20,,,Unknown,,cid:10)(cid:13)(cid:20)(cid:10)(cid:11,,2106.0
,,10,,,Unknown,,cid:10)(cid:13)(cid:20)(cid:10)(cid:11,,2116.0
,,11,,,Unknown,,cid:10)(cid:13)(cid:20)(cid:10)(cid:11,,2127.0
,,14,,,Unknown,,cid:10)(cid:13)(cid:20)(cid:10)(cid:11,,2141.0
,,21,,,Unknown,,cid:10)(cid:13)(cid:20)(cid:10)(cid:11,,2162.0
,,22,,,Unknown,,cid:10)(cid:13)(cid:20)(cid:10)(cid:11,,2184.0
,,23,,,Unknown,,cid:10)(cid:13)(cid:20)(cid:10)(cid:11,,2207.0
,,21,,,Unknown,,cid:10)(cid:13)(cid:20)(cid:10)(cid:11,,2228.0
,,24,,,Unknown,,cid:10)(cid:13)(cid:20)(cid:10)(cid:11,,2252.0
,,1,,,Unknown,,cid:10)(cid:13)(cid:20)(cid:10)(cid:11,,2253.0
,,11,,,Unknown,,cid:10)(cid:13)(cid:20)(cid:10)(cid:11,,2264.0
,,25,,,Unknown,,cid:10)(cid:13)(cid:20)(cid:10)(cid:11,,2289.0
,,12,,,Unknown,,cid:10)(cid:13)(cid:20)(cid:10)(cid:11,,2301.0
,,10,,,Unknown,,cid:10)(cid:13)(cid:20)(cid:10)(cid:11,,2311.0
,,1,,,Unknown,,cid:10)(cid:13)(cid:20)(cid:10)(cid:11,,2312.0
,,26,,,Unknown,,cid:10)(cid:13)(cid:20)(cid:10)(cid:11,,2338.0
,,10,,,Unknown,,cid:10)(cid:13)(cid:20)(cid:10)(cid:11,,2348.0
,,13,,,Unknown,,cid:10)(cid:13)(cid:20)(cid:10)(cid:11,,2361.0
,,20,,,Unknown,,cid:10)(cid:13)(cid:20)(cid:10)(cid:11,,2381.0
,,10,,,Unknown,,cid:10)(cid:13)(cid:20)(cid:10)(cid:11,,2391.0
,,11,,,Unknown,,cid:10)(cid:13)(cid:20)(cid:10)(cid:11,,2402.0
,,14,,,Unknown,,cid:10)(cid:13)(cid:20)(cid:10)(cid:11,,2416.0
,,21,,,Unknown,,cid:10)(cid:13)(cid:20)(cid:10)(cid:11,,2437.0
,,22,,,Unknown,,cid:10)(cid:13)(cid:20)(cid:10)(cid:11,,2459.0
,,23,,,Unknown,,cid:10)(cid:13)(cid:20)(cid:10)(cid:11,,2482.0
,,21,,,Unknown,,cid:10)(cid:13)(cid:20)(cid:10)(cid:11,,2503.0
,,24,,,Unknown,,cid:10)(cid:13)(cid:20)(cid:10)(cid:11,,2527.0
,,1,,,Unknown,,cid:10)(cid:13)(cid:20)(cid:10)(cid:11,,2528.0
,,11,,,Unknown,,cid:10)(cid:13)(cid:20)(cid:10)(cid:11,,2539.0
,,25,,,Unknown,,cid:10)(cid:13)(cid:20)(cid:10)(cid:11,,2564.0
,,12,,,Unknown,,cid:10)(cid:13)(cid:20)(cid:10)(cid:11,,2576.0
,,10,,,Unknown,,cid:10)(cid:13)(cid:20)(cid:10)(cid:11,,2586.0
,,1,,,Unknown,,cid:10)(cid:13)(cid:20)(cid:10)(cid:11,,2587.0
,,26,,,Unknown,,cid:10)(cid:13)(cid:20)(cid:10)(cid:11,,2613.0
,,10,,,Unknown,,cid:10)(cid:13)(cid:20)(cid:10)(cid:11,,2623.0
,,13,,,Unknown,,cid:10)(cid:13)(cid:20)(cid:10)(cid:11,,2636.0
,,20,,,Unknown,,cid:10)(cid:13)(cid:20)(cid:10)(cid:11,,2656.0
,,10,,,Unknown,,cid:10)(cid:13)(cid:20)(cid:10)(cid:11,,2666.0
,,11,,,Unknown,,cid:10)(cid:13)(cid:20)(cid:10)(cid:11,,2677.0
,,14,,,Unknown,,cid:10)(cid:13)(cid:20)(cid:10)(cid:11,,2691.0
,,21,,,Unknown,,cid:10)(cid:13)(cid:20)(cid:10)(cid:11,,2712.0
,,22,,,Unknown,,cid:10)(cid:13)(cid:20)(cid:10)(cid:11,,2734.0
,,23,,,Unknown,,cid:10)(cid:13)(cid:20)(cid:10)(cid:11,,2757.0
,,21,,,Unknown,,cid:10)(cid:13)(cid:20)(cid:10)(cid:11,,2778.0
,,24,,,Unknown,,cid:10)(cid:13)(cid:20)(cid:10)(cid:11,,2802.0
,,1,,,Unknown,,cid:10)(cid:13)(cid:20)(cid:10)(cid:11,,2803.0
,,11,,,Unknown,,cid:10)(cid:13)(cid:20)(cid:10)(cid:11,,2814.0
,,25,,,Unknown,,cid:10)(cid:13)(cid:20)(cid:10)(cid:11,,2839.0
,,12,,,Unknown,,cid:10)(cid:13)(cid:20)(cid:10)(cid:11,,2851.0
,,10,,,Unknown,,cid:10)(cid:13)(cid:20)(cid:10)(cid:11,,2861.0
,,1,,,Unknown,,cid:10)(cid:13)(cid:20)(cid:10)(cid:11,,2862.0
,,26,,,Unknown,,cid:10)(cid:13)(cid:20)(cid:10)(cid:11,,2888.0
,,10,,,Unknown,,cid:10)(cid:13)(cid:20)(cid:10)(cid:11,,2898.0
,,13,,,Unknown,,cid:10)(cid:13)(cid:20)(cid:10)(cid:11,,2911.0
,,20,,,Unknown,,cid:10)(cid:13)(cid:20)(cid:10)(cid:11,,2931.0
,,10,,,Unknown,,cid:10)(cid:13)(cid:20)(cid:10)(cid:11,,2941.0
,,11,,,Unknown,,cid:10)(cid:13)(cid:20)(cid:10)(cid:11,,2952.0
,,14,,,Unknown,,cid:10)(cid:13)(cid:20)(cid:10)(cid:11,,2966.0
,,21,,,Unknown,,cid:10)(cid:13)(cid:20)(cid:10)(cid:11,,2987.0
,,22,,,Unknown,,cid:10)(cid:13)(cid:20)(cid:10)(cid:11,,3009.0
,,23,,,Unknown,,cid:10)(cid:13)(cid:20)(cid:10)(cid:11,,3032.0
,,21,,,Unknown,,cid:10)(cid:13)(cid:20)(cid:10)(cid:11,,3053.0
,,24,,,Unknown,,cid:10)(cid:13)(cid:20)(cid:10)(cid:11,,3077.0
,,1,,,Unknown,,cid:10)(cid:13)(cid:20)(cid:10)(cid:11,,3078.0
,,11,,,Unknown,,cid:10)(cid:13)(cid:20)(cid:10)(cid:11,,3089.0
,,25,,,Unknown,,cid:10)(cid:13)(cid:20)(cid:10)(cid:11,,3114.0
,,12,,,Unknown,,cid:10)(cid:13)(cid:20)(cid:10)(cid:11,,3126.0
,,10,,,Unknown,,cid:10)(cid:13)(cid:20)(cid:10)(cid:11,,3136.0
,,1,,,Unknown,,cid:10)(cid:13)(cid:20)(cid:10)(cid:11,,3137.0
,,26,,,Unknown,,cid:10)(cid:13)(cid:20)(cid:10)(cid:11,,3163.0
,,35,,,Unknown,,cid:10)(cid:13)(cid:20)(cid:10)(cid:11,,3198.0
,,42,,,Unknown,,cid:10)(cid:13)(cid:20)(cid:10)(cid:11,,3240.0
,,28,,,Unknown,,cid:10)(cid:13)(cid:20)(cid:10)(cid:11,,3268.0
,,1,,,Unknown,,cid:10)(cid:13)(cid:20)(cid:10)(cid:11,,3269.0
,,28,,,Unknown,,cid:10)(cid:13)(cid:20)(cid:10)(cid:11,,3297.0
,,27,,,Unknown,,cid:10)(cid:13)(cid:20)(cid:10)(cid:11,,3324.0
,,29,,,Unknown,,cid:10)(cid:13)(cid:20)(cid:10)(cid:11,,3353.0
,,27,,,Unknown,,cid:10)(cid:13)(cid:20)(cid:10)(cid:11,,3380.0
,,40,,,Unknown,,cid:10)(cid:13)(cid:20)(cid:10)(cid:11,,3420.0
,,31,,,Unknown,,cid:10)(cid:13)(cid:20)(cid:10)(cid:11,,3451.0
,,36,,,Unknown,,cid:10)(cid:13)(cid:20)(cid:10)(cid:11,,3487.0
,,1,,,Unknown,,cid:10)(cid:13)(cid:20)(cid:10)(cid:11,,3488.0
,,37,,,Unknown,,cid:10)(cid:13)(cid:20)(cid:10)(cid:11,,3525.0
,,17,,,Unknown,,cid:10)(cid:13)(cid:20)(cid:10)(cid:11,,3542.0
,,30,,,Unknown,,cid:10)(cid:13)(cid:20)(cid:10)(cid:11,,3572.0
,,36,,,Unknown,,cid:10)(cid:13)(cid:20)(cid:10)(cid:11,,3608.0
,,36,,,Unknown,,cid:10)(cid:13)(cid:20)(cid:10)(cid:11,,3644.0
,,38,,,Unknown,,cid:10)(cid:13)(cid:20)(cid:10)(cid:11,,3682.0
,,1,,,Unknown,,cid:10)(cid:13)(cid:20)(cid:10)(cid:11,,3683.0
,,28,,,Unknown,,cid:10)(cid:13)(cid:20)(cid:10)(cid:11,,3711.0
,,31,,,Unknown,,cid:10)(cid:13)(cid:20)(cid:10)(cid:11,,3742.0
,,1,,,Unknown,,cid:10)(cid:13)(cid:20)(cid:10)(cid:11,,3743.0
,,35,,,Unknown,,cid:10)(cid:13)(cid:20)(cid:10)(cid:11,,3778.0
,,42,,,Unknown,,cid:10)(cid:13)(cid:20)(cid:10)(cid:11,,3820.0
,,27,,,Unknown,,cid:10)(cid:13)(cid:20)(cid:10)(cid:11,,3847.0
,,1,,,Unknown,,cid:10)(cid:13)(cid:20)(cid:10)(cid:11,,3848.0
,,2,,,Unknown,,cid:10)(cid:13)(cid:20)(cid:10)(cid:11,,3850.0
,,3,,,Unknown,,cid:10)(cid:13)(cid:20)(cid:10)(cid:11,,3853.0
,,10,,,Unknown,,cid:10)(cid:13)(cid:20)(cid:10)(cid:11,,3863.0
,,13,,,Unknown,,cid:10)(cid:13)(cid:20)(cid:10)(cid:11,,3876.0
,,20,,,Unknown,,cid:10)(cid:13)(cid:20)(cid:10)(cid:11,,3896.0
,,10,,,Unknown,,cid:10)(cid:13)(cid:20)(cid:10)(cid:11,,3906.0
,,11,,,Unknown,,cid:10)(cid:13)(cid:20)(cid:10)(cid:11,,3917.0
,,24,,,Unknown,,cid:10)(cid:13)(cid:20)(cid:10)(cid:11,,3941.0
,,1,,,Unknown,,cid:10)(cid:13)(cid:20)(cid:10)(cid:11,,3942.0
,,11,,,Unknown,,cid:10)(cid:13)(cid:20)(cid:10)(cid:11,,3953.0
,,10,,,Unknown,,cid:10)(cid:13)(cid:20)(cid:10)(cid:11,,3963.0
,,25,,,Unknown,,cid:10)(cid:13)(cid:20)(cid:10)(cid:11,,3988.0
,,10,,,Unknown,,cid:10)(cid:13)(cid:20)(cid:10)(cid:11,,3998.0
,,10,,,Unknown,,cid:10)(cid:13)(cid:20)(cid:10)(cid:11,,4008.0
,,1,,,Unknown,,cid:10)(cid:13)(cid:20)(cid:10)(cid:11,,4009.0
,,26,,,Unknown,,cid:10)(cid:13)(cid:20)(cid:10)(cid:11,,4035.0
,,45,,,Unknown,,cid:10)(cid:13)(cid:20)(cid:10)(cid:11,,4080.0
,,10,,,Unknown,,cid:10)(cid:13)(cid:20)(cid:10)(cid:11,,4090.0
,,19,,,Unknown,,cid:10)(cid:13)(cid:20)(cid:10)(cid:11,,4109.0
,,16,,,Unknown,,cid:10)(cid:13)(cid:20)(cid:10)(cid:11,,4125.0
,,7,,,Unknown,,cid:10)(cid:13)(cid:20)(cid:10)(cid:11,,4132.0
,,3,,,Unknown,,cid:10)(cid:13)(cid:20)(cid:10)(cid:11,,4135.0
,,8,,,Unknown,,cid:10)(cid:13)(cid:20)(cid:10)(cid:11,,4143.0
,,28,,,Unknown,,cid:10)(cid:13)(cid:20)(cid:10)(cid:11,,4171.0
,,10,,,Unknown,,cid:10)(cid:13)(cid:20)(cid:10)(cid:11,,4181.0
,,3,,,Unknown,,cid:10)(cid:13)(cid:20)(cid:10)(cid:11,,4184.0
,,6,,,Unknown,,cid:10)(cid:13)(cid:20)(cid:10)(cid:11,,4190.0
,,8,,,Unknown,,cid:10)(cid:13)(cid:20)(cid:10)(cid:11,,4198.0
,,46,,,Unknown,,cid:10)(cid:13)(cid:20)(cid:10)(cid:11,,4244.0
,,46,,,Unknown,,cid:10)(cid:13)(cid:20)(cid:10)(cid:11,,4290.0
,,47,,,Unknown,,cid:10)(cid:13)(cid:20)(cid:10)(cid:11,,4337.0
,,32,,,Unknown,,cid:10)(cid:13)(cid:20)(cid:10)(cid:11,,4369.0
,,48,,,Unknown,,cid:10)(cid:13)(cid:20)(cid:10)(cid:11,,4417.0
,,49,,,Unknown,,cid:10)(cid:13)(cid:20)(cid:10)(cid:11,,4466.0
,,27,,,Unknown,,cid:10)(cid:13)(cid:20)(cid:10)(cid:11,,4493.0
,,18,,,Unknown,,cid:10)(cid:13)(cid:20)(cid:10)(cid:11,,4511.0
,,3,,,Unknown,,cid:10)(cid:13)(cid:20)(cid:10)(cid:11,,4514.0
,,3,,,Unknown,,cid:10)(cid:13)(cid:20)(cid:10)(cid:11,,4517.0
,,1,,,Unknown,,cid:10)(cid:13)(cid:20)(cid:10)(cid:11,,4518.0
,,36,,,Unknown,,cid:10)(cid:13)(cid:20)(cid:10)(cid:11,,4554.0
,,16,,,Unknown,,cid:10)(cid:13)(cid:20)(cid:10)(cid:11,,4570.0
,,1,,,Unknown,,cid:10)(cid:13)(cid:20)(cid:10)(cid:11,,4571.0
,,27,,,Unknown,,cid:10)(cid:13)(cid:20)(cid:10)(cid:11,,4598.0
,,18,,,Unknown,,cid:10)(cid:13)(cid:20)(cid:10)(cid:11,,4616.0
,,17,,,Unknown,,cid:10)(cid:13)(cid:20)(cid:10)(cid:11,,4633.0
,,28,,,Unknown,,cid:10)(cid:13)(cid:20)(cid:10)(cid:11,,4661.0
,,28,,,Unknown,,cid:10)(cid:13)(cid:20)(cid:10)(cid:11,,4689.0
,,30,,,Unknown,,cid:10)(cid:13)(cid:20)(cid:10)(cid:11,,4719.0
,,15,,,Unknown,,cid:10)(cid:13)(cid:20)(cid:10)(cid:11,,4734.0
,,27,,,Unknown,,cid:10)(cid:13)(cid:20)(cid:10)(cid:11,,4761.0
,,30,,,Unknown,,cid:10)(cid:13)(cid:20)(cid:10)(cid:11,,4791.0
,,3,,,Unknown,,cid:10)(cid:13)(cid:20)(cid:10)(cid:11,,4794.0
,,1,,,Unknown,,cid:10)(cid:13)(cid:20)(cid:10)(cid:11,,4795.0
,,2,,,Unknown,,cid:10)(cid:13)(cid:20)(cid:10)(cid:11,,4797.0
,,3,,,Unknown,,cid:10)(cid:13)(cid:20)(cid:10)(cid:11,,4800.0
,,10,,,Unknown,,cid:10)(cid:13)(cid:20)(cid:10)(cid:11,,4810.0
,,13,,,Unknown,,cid:10)(cid:13)(cid:20)(cid:10)(cid:11,,4823.0
,,20,,,Unknown,,cid:10)(cid:13)(cid:20)(cid:10)(cid:11,,4843.0
,,10,,,Unknown,,cid:10)(cid:13)(cid:20)(cid:10)(cid:11,,4853.0
,,11,,,Unknown,,cid:10)(cid:13)(cid:20)(cid:10)(cid:11,,4864.0
,,24,,,Unknown,,cid:10)(cid:13)(cid:20)(cid:10)(cid:11,,4888.0
,,1,,,Unknown,,cid:10)(cid:13)(cid:20)(cid:10)(cid:11,,4889.0
,,11,,,Unknown,,cid:10)(cid:13)(cid:20)(cid:10)(cid:11,,4900.0
,,25,,,Unknown,,cid:10)(cid:13)(cid:20)(cid:10)(cid:11,,4925.0
,,9,,,Unknown,,cid:10)(cid:13)(cid:20)(cid:10)(cid:11,,4934.0
,,10,,,Unknown,,cid:10)(cid:13)(cid:20)(cid:10)(cid:11,,4944.0
,,1,,,Unknown,,cid:10)(cid:13)(cid:20)(cid:10)(cid:11,,4945.0
,,26,,,Unknown,,cid:10)(cid:13)(cid:20)(cid:10)(cid:11,,4971.0
,,45,,,Unknown,,cid:10)(cid:13)(cid:20)(cid:10)(cid:11,,5016.0
,,10,,,Unknown,,cid:10)(cid:13)(cid:20)(cid:10)(cid:11,,5026.0
,,19,,,Unknown,,cid:10)(cid:13)(cid:20)(cid:10)(cid:11,,5045.0
,,16,,,Unknown,,cid:10)(cid:13)(cid:20)(cid:10)(cid:11,,5061.0
,,7,,,Unknown,,cid:10)(cid:13)(cid:20)(cid:10)(cid:11,,5068.0
,,3,,,Unknown,,cid:10)(cid:13)(cid:20)(cid:10)(cid:11,,5071.0
,,8,,,Unknown,,cid:10)(cid:13)(cid:20)(cid:10)(cid:11,,5079.0
,,28,,,Unknown,,cid:10)(cid:13)(cid:20)(cid:10)(cid:11,,5107.0
,,10,,,Unknown,,cid:10)(cid:13)(cid:20)(cid:10)(cid:11,,5117.0
,,3,,,Unknown,,cid:10)(cid:13)(cid:20)(cid:10)(cid:11,,5120.0
,,6,,,Unknown,,cid:10)(cid:13)(cid:20)(cid:10)(cid:11,,5126.0
,,8,,,Unknown,,cid:10)(cid:13)(cid:20)(cid:10)(cid:11,,5134.0
,,46,,,Unknown,,cid:10)(cid:13)(cid:20)(cid:10)(cid:11,,5180.0
,,46,,,Unknown,,cid:10)(cid:13)(cid:20)(cid:10)(cid:11,,5226.0
,,47,,,Unknown,,cid:10)(cid:13)(cid:20)(cid:10)(cid:11,,5273.0
,,32,,,Unknown,,cid:10)(cid:13)(cid:20)(cid:10)(cid:11,,5305.0
,,48,,,Unknown,,cid:10)(cid:13)(cid:20)(cid:10)(cid:11,,5353.0
,,49,,,Unknown,,cid:10)(cid:13)(cid:20)(cid:10)(cid:11,,5402.0
,,18,,,Unknown,,cid:10)(cid:13)(cid:20)(cid:10)(cid:11,,5420.0
,,30,,,Unknown,,cid:10)(cid:13)(cid:20)(cid:10)(cid:11,,5450.0
,,43,,,Unknown,,cid:10)(cid:13)(cid:20)(cid:10)(cid:11,,5493.0
,,43,,,Unknown,,cid:10)(cid:13)(cid:20)(cid:10)(cid:11,,5536.0
,,27,,,Unknown,,cid:10)(cid:13)(cid:20)(cid:10)(cid:11,,5563.0
,,1,,,Unknown,,cid:10)(cid:13)(cid:20)(cid:10)(cid:11,,5564.0
,,42,,,Unknown,,cid:10)(cid:13)(cid:20)(cid:10)(cid:11,,5606.0
,,17,,,Unknown,,cid:10)(cid:13)(cid:20)(cid:10)(cid:11,,5623.0
,,16,,,Unknown,,cid:10)(cid:13)(cid:20)(cid:10)(cid:11,,5639.0
,,1,,,Unknown,,cid:10)(cid:13)(cid:20)(cid:10)(cid:11,,5640.0
,,40,,,Unknown,,cid:10)(cid:13)(cid:20)(cid:10)(cid:11,,5680.0
,,3,,,Unknown,,cid:10)(cid:13)(cid:20)(cid:10)(cid:11,,5683.0
,,30,,,Unknown,,cid:10)(cid:13)(cid:20)(cid:10)(cid:11,,5713.0
,,28,,,Unknown,,cid:10)(cid:13)(cid:20)(cid:10)(cid:11,,5741.0
,,28,,,Unknown,,cid:10)(cid:13)(cid:20)(cid:10)(cid:11,,5769.0
,,1,,,Unknown,,cid:10)(cid:13)(cid:20)(cid:10)(cid:11,,5770.0
,,28,,,Unknown,,cid:10)(cid:13)(cid:20)(cid:10)(cid:11,,5798.0
,,27,,,Unknown,,cid:10)(cid:13)(cid:20)(cid:10)(cid:11,,5825.0
,,1,,,Unknown,,cid:10)(cid:13)(cid:20)(cid:10)(cid:11,,5826.0
,,2,,,Unknown,,cid:10)(cid:13)(cid:20)(cid:10)(cid:11,,5828.0
,,31,,,Unknown,,cid:10)(cid:13)(cid:20)(cid:10)(cid:11,,5859.0
,,3,,,Unknown,,cid:10)(cid:13)(cid:20)(cid:10)(cid:11,,5862.0
,,16,,,Unknown,,cid:10)(cid:13)(cid:20)(cid:10)(cid:11,,5878.0
,,31,,,Unknown,,cid:10)(cid:13)(cid:20)(cid:10)(cid:11,,5909.0
,,1,,,Unknown,,cid:10)(cid:13)(cid:20)(cid:10)(cid:11,,5910.0
,,40,,,Unknown,,cid:10)(cid:13)(cid:20)(cid:10)(cid:11,,5950.0
,,27,,,Unknown,,cid:10)(cid:13)(cid:20)(cid:10)(cid:11,,5977.0
,,32,,,Unknown,,cid:10)(cid:13)(cid:20)(cid:10)(cid:11,,6009.0
,,35,,,Unknown,,cid:10)(cid:13)(cid:20)(cid:10)(cid:11,,6044.0
,,1,,,Unknown,,cid:10)(cid:13)(cid:20)(cid:10)(cid:11,,6045.0
,,2,,,Unknown,,cid:10)(cid:13)(cid:20)(cid:10)(cid:11,,6047.0
,,3,,,Unknown,,cid:10)(cid:13)(cid:20)(cid:10)(cid:11,,6050.0
,,10,,,Unknown,,cid:10)(cid:13)(cid:20)(cid:10)(cid:11,,6060.0
,,8,,,Unknown,,cid:10)(cid:13)(cid:20)(cid:10)(cid:11,,6068.0
,,20,,,Unknown,,cid:10)(cid:13)(cid:20)(cid:10)(cid:11,,6088.0
,,10,,,Unknown,,cid:10)(cid:13)(cid:20)(cid:10)(cid:11,,6098.0
,,11,,,Unknown,,cid:10)(cid:13)(cid:20)(cid:10)(cid:11,,6109.0
,,24,,,Unknown,,cid:10)(cid:13)(cid:20)(cid:10)(cid:11,,6133.0
,,1,,,Unknown,,cid:10)(cid:13)(cid:20)(cid:10)(cid:11,,6134.0
,,11,,,Unknown,,cid:10)(cid:13)(cid:20)(cid:10)(cid:11,,6145.0
,,6,,,Unknown,,cid:10)(cid:13)(cid:20)(cid:10)(cid:11,,6151.0
,,25,,,Unknown,,cid:10)(cid:13)(cid:20)(cid:10)(cid:11,,6176.0
,,10,,,Unknown,,cid:10)(cid:13)(cid:20)(cid:10)(cid:11,,6186.0
,,10,,,Unknown,,cid:10)(cid:13)(cid:20)(cid:10)(cid:11,,6196.0
,,1,,,Unknown,,cid:10)(cid:13)(cid:20)(cid:10)(cid:11,,6197.0
,,26,,,Unknown,,cid:10)(cid:13)(cid:20)(cid:10)(cid:11,,6223.0
,,45,,,Unknown,,cid:10)(cid:13)(cid:20)(cid:10)(cid:11,,6268.0
,,10,,,Unknown,,cid:10)(cid:13)(cid:20)(cid:10)(cid:11,,6278.0
,,19,,,Unknown,,cid:10)(cid:13)(cid:20)(cid:10)(cid:11,,6297.0
,,16,,,Unknown,,cid:10)(cid:13)(cid:20)(cid:10)(cid:11,,6313.0
,,7,,,Unknown,,cid:10)(cid:13)(cid:20)(cid:10)(cid:11,,6320.0
,,3,,,Unknown,,cid:10)(cid:13)(cid:20)(cid:10)(cid:11,,6323.0
,,8,,,Unknown,,cid:10)(cid:13)(cid:20)(cid:10)(cid:11,,6331.0
,,28,,,Unknown,,cid:10)(cid:13)(cid:20)(cid:10)(cid:11,,6359.0
,,10,,,Unknown,,cid:10)(cid:13)(cid:20)(cid:10)(cid:11,,6369.0
,,3,,,Unknown,,cid:10)(cid:13)(cid:20)(cid:10)(cid:11,,6372.0
,,6,,,Unknown,,cid:10)(cid:13)(cid:20)(cid:10)(cid:11,,6378.0
,,8,,,Unknown,,cid:10)(cid:13)(cid:20)(cid:10)(cid:11,,6386.0
,,46,,,Unknown,,cid:10)(cid:13)(cid:20)(cid:10)(cid:11,,6432.0
,,46,,,Unknown,,cid:10)(cid:13)(cid:20)(cid:10)(cid:11,,6478.0
,,47,,,Unknown,,cid:10)(cid:13)(cid:20)(cid:10)(cid:11,,6525.0
,,32,,,Unknown,,cid:10)(cid:13)(cid:20)(cid:10)(cid:11,,6557.0
,,48,,,Unknown,,cid:10)(cid:13)(cid:20)(cid:10)(cid:11,,6605.0
,,49,,,Unknown,,cid:10)(cid:13)(cid:20)(cid:10)(cid:11,,6654.0
,,28,,,Unknown,,cid:10)(cid:13)(cid:20)(cid:10)(cid:11,,6682.0
,,27,,,Unknown,,cid:10)(cid:13)(cid:20)(cid:10)(cid:11,,6709.0
,,1,,,Unknown,,cid:10)(cid:13)(cid:20)(cid:10)(cid:11,,6710.0
,,36,,,Unknown,,cid:10)(cid:13)(cid:20)(cid:10)(cid:11,,6746.0
,,32,,,Unknown,,cid:10)(cid:13)(cid:20)(cid:10)(cid:11,,6778.0
,,35,,,Unknown,,cid:10)(cid:13)(cid:20)(cid:10)(cid:11,,6813.0
,,3,,,Unknown,,cid:10)(cid:13)(cid:20)(cid:10)(cid:11,,6816.0
,,31,,,Unknown,,cid:10)(cid:13)(cid:20)(cid:10)(cid:11,,6847.0
,,3,,,Unknown,,cid:10)(cid:13)(cid:20)(cid:10)(cid:11,,6850.0
,,30,,,Unknown,,cid:10)(cid:13)(cid:20)(cid:10)(cid:11,,6880.0
,,31,,,Unknown,,cid:10)(cid:13)(cid:20)(cid:10)(cid:11,,6911.0
,,1,,,Unknown,,cid:10)(cid:13)(cid:20)(cid:10)(cid:11,,6912.0
,,35,,,Unknown,,cid:10)(cid:13)(cid:20)(cid:10)(cid:11,,6947.0
,,17,,,Unknown,,cid:10)(cid:13)(cid:20)(cid:10)(cid:11,,6964.0
,,32,,,Unknown,,cid:10)(cid:13)(cid:20)(cid:10)(cid:11,,6996.0
,,28,,,Unknown,,cid:10)(cid:13)(cid:20)(cid:10)(cid:11,,7024.0
,,17,,,Unknown,,cid:10)(cid:13)(cid:20)(cid:10)(cid:11,,7041.0
,,34,,,Unknown,,cid:10)(cid:13)(cid:20)(cid:10)(cid:11,,7075.0
,,34,,,Unknown,,cid:10)(cid:13)(cid:20)(cid:10)(cid:11,,7109.0
,,30,,,Unknown,,cid:10)(cid:13)(cid:20)(cid:10)(cid:11,,7139.0
,,31,,,Unknown,,cid:10)(cid:13)(cid:20)(cid:10)(cid:11,,7170.0
,,3,,,Unknown,,cid:10)(cid:13)(cid:20)(cid:10)(cid:11,,7173.0
,,36,,,Unknown,,cid:10)(cid:13)(cid:20)(cid:10)(cid:11,,7209.0
,,1,,,Unknown,,cid:10)(cid:13)(cid:20)(cid:10)(cid:11,,7210.0
,,2,,,Unknown,,cid:10)(cid:13)(cid:20)(cid:10)(cid:11,,7212.0
,,3,,,Unknown,,cid:10)(cid:13)(cid:20)(cid:10)(cid:11,,7215.0
,,10,,,Unknown,,cid:10)(cid:13)(cid:20)(cid:10)(cid:11,,7225.0
,,8,,,Unknown,,cid:10)(cid:13)(cid:20)(cid:10)(cid:11,,7233.0
,,20,,,Unknown,,cid:10)(cid:13)(cid:20)(cid:10)(cid:11,,7253.0
,,10,,,Unknown,,cid:10)(cid:13)(cid:20)(cid:10)(cid:11,,7263.0
,,11,,,Unknown,,cid:10)(cid:13)(cid:20)(cid:10)(cid:11,,7274.0
,,24,,,Unknown,,cid:10)(cid:13)(cid:20)(cid:10)(cid:11,,7298.0
,,1,,,Unknown,,cid:10)(cid:13)(cid:20)(cid:10)(cid:11,,7299.0
,,8,,,Unknown,,cid:10)(cid:13)(cid:20)(cid:10)(cid:11,,7307.0
,,5,,,Unknown,,cid:10)(cid:13)(cid:20)(cid:10)(cid:11,,7312.0
,,25,,,Unknown,,cid:10)(cid:13)(cid:20)(cid:10)(cid:11,,7337.0
,,11,,,Unknown,,cid:10)(cid:13)(cid:20)(cid:10)(cid:11,,7348.0
,,10,,,Unknown,,cid:10)(cid:13)(cid:20)(cid:10)(cid:11,,7358.0
,,1,,,Unknown,,cid:10)(cid:13)(cid:20)(cid:10)(cid:11,,7359.0
,,26,,,Unknown,,cid:10)(cid:13)(cid:20)(cid:10)(cid:11,,7385.0
,,45,,,Unknown,,cid:10)(cid:13)(cid:20)(cid:10)(cid:11,,7430.0
,,10,,,Unknown,,cid:10)(cid:13)(cid:20)(cid:10)(cid:11,,7440.0
,,19,,,Unknown,,cid:10)(cid:13)(cid:20)(cid:10)(cid:11,,7459.0
,,16,,,Unknown,,cid:10)(cid:13)(cid:20)(cid:10)(cid:11,,7475.0
,,7,,,Unknown,,cid:10)(cid:13)(cid:20)(cid:10)(cid:11,,7482.0
,,3,,,Unknown,,cid:10)(cid:13)(cid:20)(cid:10)(cid:11,,7485.0
,,8,,,Unknown,,cid:10)(cid:13)(cid:20)(cid:10)(cid:11,,7493.0
,,28,,,Unknown,,cid:10)(cid:13)(cid:20)(cid:10)(cid:11,,7521.0
,,10,,,Unknown,,cid:10)(cid:13)(cid:20)(cid:10)(cid:11,,7531.0
,,3,,,Unknown,,cid:10)(cid:13)(cid:20)(cid:10)(cid:11,,7534.0
,,6,,,Unknown,,cid:10)(cid:13)(cid:20)(cid:10)(cid:11,,7540.0
,,8,,,Unknown,,cid:10)(cid:13)(cid:20)(cid:10)(cid:11,,7548.0
,,46,,,Unknown,,cid:10)(cid:13)(cid:20)(cid:10)(cid:11,,7594.0
,,46,,,Unknown,,cid:10)(cid:13)(cid:20)(cid:10)(cid:11,,7640.0
,,47,,,Unknown,,cid:10)(cid:13)(cid:20)(cid:10)(cid:11,,7687.0
,,32,,,Unknown,,cid:10)(cid:13)(cid:20)(cid:10)(cid:11,,7719.0
,,48,,,Unknown,,cid:10)(cid:13)(cid:20)(cid:10)(cid:11,,7767.0
,,49,,,Unknown,,cid:10)(cid:13)(cid:20)(cid:10)(cid:11,,7816.0
,,36,,,Unknown,,cid:10)(cid:13)(cid:20)(cid:10)(cid:11,,7852.0
,,18,,,Unknown,,cid:10)(cid:13)(cid:20)(cid:10)(cid:11,,7870.0
,,31,,,Unknown,,cid:10)(cid:13)(cid:20)(cid:10)(cid:11,,7901.0
,,31,,,Unknown,,cid:10)(cid:13)(cid:20)(cid:10)(cid:11,,7932.0
,,33,,,Unknown,,cid:10)(cid:13)(cid:20)(cid:10)(cid:11,,7965.0
,,38,,,Unknown,,cid:10)(cid:13)(cid:20)(cid:10)(cid:11,,8003.0
,,10,,,Unknown,,cid:10)(cid:13)(cid:20)(cid:10)(cid:11,,8013.0
,,10,,,Unknown,,cid:10)(cid:13)(cid:20)(cid:10)(cid:11,,8023.0
,,10,,,Unknown,,cid:10)(cid:13)(cid:20)(cid:10)(cid:11,,8033.0
,,10,,,Unknown,,cid:10)(cid:13)(cid:20)(cid:10)(cid:11,,8043.0
,,10,,,Unknown,,cid:10)(cid:13)(cid:20)(cid:10)(cid:11,,8053.0
,,10,,,Unknown,,cid:10)(cid:13)(cid:20)(cid:10)(cid:11,,8063.0
,,11,,,Unknown,,cid:10)(cid:13)(cid:20)(cid:10)(cid:11,,8074.0
,,8,,,Unknown,,cid:10)(cid:13)(cid:20)(cid:10)(cid:11,,8082.0
,,5,,,Unknown,,cid:10)(cid:13)(cid:20)(cid:10)(cid:11,,8087.0
,,1,,,Unknown,,cid:10)(cid:13)(cid:20)(cid:10)(cid:11,,8088.0
,,35,,,Unknown,,cid:10)(cid:13)(cid:20)(cid:10)(cid:11,,8123.0
,,17,,,Unknown,,cid:10)(cid:13)(cid:20)(cid:10)(cid:11,,8140.0
,,32,,,Unknown,,cid:10)(cid:13)(cid:20)(cid:10)(cid:11,,8172.0
,,28,,,Unknown,,cid:10)(cid:13)(cid:20)(cid:10)(cid:11,,8200.0
,,17,,,Unknown,,cid:10)(cid:13)(cid:20)(cid:10)(cid:11,,8217.0
,,34,,,Unknown,,cid:10)(cid:13)(cid:20)(cid:10)(cid:11,,8251.0
,,34,,,Unknown,,cid:10)(cid:13)(cid:20)(cid:10)(cid:11,,8285.0
,,30,,,Unknown,,cid:10)(cid:13)(cid:20)(cid:10)(cid:11,,8315.0
,,31,,,Unknown,,cid:10)(cid:13)(cid:20)(cid:10)(cid:11,,8346.0
,,3,,,Unknown,,cid:10)(cid:13)(cid:20)(cid:10)(cid:11,,8349.0
,,36,,,Unknown,,cid:10)(cid:13)(cid:20)(cid:10)(cid:11,,8385.0
,,1,,,Unknown,,cid:10)(cid:13)(cid:20)(cid:10)(cid:11,,8386.0
,,2,,,Unknown,,cid:10)(cid:13)(cid:20)(cid:10)(cid:11,,8388.0
,,3,,,Unknown,,cid:10)(cid:13)(cid:20)(cid:10)(cid:11,,8391.0
,,10,,,Unknown,,cid:10)(cid:13)(cid:20)(cid:10)(cid:11,,8401.0
,,5,,,Unknown,,cid:10)(cid:13)(cid:20)(cid:10)(cid:11,,8406.0
,,20,,,Unknown,,cid:10)(cid:13)(cid:20)(cid:10)(cid:11,,8426.0
,,10,,,Unknown,,cid:10)(cid:13)(cid:20)(cid:10)(cid:11,,8436.0
,,11,,,Unknown,,cid:10)(cid:13)(cid:20)(cid:10)(cid:11,,8447.0
,,24,,,Unknown,,cid:10)(cid:13)(cid:20)(cid:10)(cid:11,,8471.0
,,1,,,Unknown,,cid:10)(cid:13)(cid:20)(cid:10)(cid:11,,8472.0
,,12,,,Unknown,,cid:10)(cid:13)(cid:20)(cid:10)(cid:11,,8484.0
,,7,,,Unknown,,cid:10)(cid:13)(cid:20)(cid:10)(cid:11,,8491.0
,,4,,,Unknown,,cid:10)(cid:13)(cid:20)(cid:10)(cid:11,,8495.0
,,25,,,Unknown,,cid:10)(cid:13)(cid:20)(cid:10)(cid:11,,8520.0
,,12,,,Unknown,,cid:10)(cid:13)(cid:20)(cid:10)(cid:11,,8532.0
,,11,,,Unknown,,cid:10)(cid:13)(cid:20)(cid:10)(cid:11,,8543.0
,,1,,,Unknown,,cid:10)(cid:13)(cid:20)(cid:10)(cid:11,,8544.0
,,26,,,Unknown,,cid:10)(cid:13)(cid:20)(cid:10)(cid:11,,8570.0
,,45,,,Unknown,,cid:10)(cid:13)(cid:20)(cid:10)(cid:11,,8615.0
,,10,,,Unknown,,cid:10)(cid:13)(cid:20)(cid:10)(cid:11,,8625.0
,,19,,,Unknown,,cid:10)(cid:13)(cid:20)(cid:10)(cid:11,,8644.0
,,16,,,Unknown,,cid:10)(cid:13)(cid:20)(cid:10)(cid:11,,8660.0
,,7,,,Unknown,,cid:10)(cid:13)(cid:20)(cid:10)(cid:11,,8667.0
,,3,,,Unknown,,cid:10)(cid:13)(cid:20)(cid:10)(cid:11,,8670.0
,,8,,,Unknown,,cid:10)(cid:13)(cid:20)(cid:10)(cid:11,,8678.0
,,28,,,Unknown,,cid:10)(cid:13)(cid:20)(cid:10)(cid:11,,8706.0
,,10,,,Unknown,,cid:10)(cid:13)(cid:20)(cid:10)(cid:11,,8716.0
,,3,,,Unknown,,cid:10)(cid:13)(cid:20)(cid:10)(cid:11,,8719.0
,,6,,,Unknown,,cid:10)(cid:13)(cid:20)(cid:10)(cid:11,,8725.0
,,8,,,Unknown,,cid:10)(cid:13)(cid:20)(cid:10)(cid:11,,8733.0
,,46,,,Unknown,,cid:10)(cid:13)(cid:20)(cid:10)(cid:11,,8779.0
,,46,,,Unknown,,cid:10)(cid:13)(cid:20)(cid:10)(cid:11,,8825.0
,,47,,,Unknown,,cid:10)(cid:13)(cid:20)(cid:10)(cid:11,,8872.0
,,32,,,Unknown,,cid:10)(cid:13)(cid:20)(cid:10)(cid:11,,8904.0
,,48,,,Unknown,,cid:10)(cid:13)(cid:20)(cid:10)(cid:11,,8952.0
,,49,,,Unknown,,cid:10)(cid:13)(cid:20)(cid:10)(cid:11,,9001.0
,,33,,,Unknown,,cid:10)(cid:13)(cid:20)(cid:10)(cid:11,,9034.0
,,31,,,Unknown,,cid:10)(cid:13)(cid:20)(cid:10)(cid:11,,9065.0
,,28,,,Unknown,,cid:10)(cid:13)(cid:20)(cid:10)(cid:11,,9093.0
,,30,,,Unknown,,cid:10)(cid:13)(cid:20)(cid:10)(cid:11,,9123.0
,,35,,,Unknown,,cid:10)(cid:13)(cid:20)(cid:10)(cid:11,,9158.0
,,31,,,Unknown,,cid:10)(cid:13)(cid:20)(cid:10)(cid:11,,9189.0
,,36,,,Unknown,,cid:10)(cid:13)(cid:20)(cid:10)(cid:11,,9225.0
,,1,,,Unknown,,cid:10)(cid:13)(cid:20)(cid:10)(cid:11,,9226.0
,,4,,,Unknown,,cid:10)(cid:13)(cid:20)(cid:10)(cid:11,,9230.0
,,4,,,Unknown,,cid:10)(cid:13)(cid:20)(cid:10)(cid:11,,9234.0
,,1,,,Unknown,,cid:10)(cid:13)(cid:20)(cid:10)(cid:11,,9235.0
,,35,,,Unknown,,cid:10)(cid:13)(cid:20)(cid:10)(cid:11,,9270.0
,,17,,,Unknown,,cid:10)(cid:13)(cid:20)(cid:10)(cid:11,,9287.0
,,32,,,Unknown,,cid:10)(cid:13)(cid:20)(cid:10)(cid:11,,9319.0
,,28,,,Unknown,,cid:10)(cid:13)(cid:20)(cid:10)(cid:11,,9347.0
,,17,,,Unknown,,cid:10)(cid:13)(cid:20)(cid:10)(cid:11,,9364.0
,,34,,,Unknown,,cid:10)(cid:13)(cid:20)(cid:10)(cid:11,,9398.0
,,34,,,Unknown,,cid:10)(cid:13)(cid:20)(cid:10)(cid:11,,9432.0
,,30,,,Unknown,,cid:10)(cid:13)(cid:20)(cid:10)(cid:11,,9462.0
,,31,,,Unknown,,cid:10)(cid:13)(cid:20)(cid:10)(cid:11,,9493.0
,,3,,,Unknown,,cid:10)(cid:13)(cid:20)(cid:10)(cid:11,,9496.0
,,36,,,Unknown,,cid:10)(cid:13)(cid:20)(cid:10)(cid:11,,9532.0
,,1,,,Unknown,,cid:10)(cid:13)(cid:20)(cid:10)(cid:11,,9533.0
,,2,,,Unknown,,cid:10)(cid:13)(cid:20)(cid:10)(cid:11,,9535.0
,,3,,,Unknown,,cid:10)(cid:13)(cid:20)(cid:10)(cid:11,,9538.0
,,10,,,Unknown,,cid:10)(cid:13)(cid:20)(cid:10)(cid:11,,9548.0
,,5,,,Unknown,,cid:10)(cid:13)(cid:20)(cid:10)(cid:11,,9553.0
,,20,,,Unknown,,cid:10)(cid:13)(cid:20)(cid:10)(cid:11,,9573.0
,,10,,,Unknown,,cid:10)(cid:13)(cid:20)(cid:10)(cid:11,,9583.0
,,11,,,Unknown,,cid:10)(cid:13)(cid:20)(cid:10)(cid:11,,9594.0
,,24,,,Unknown,,cid:10)(cid:13)(cid:20)(cid:10)(cid:11,,9618.0
,,1,,,Unknown,,cid:10)(cid:13)(cid:20)(cid:10)(cid:11,,9619.0
,,11,,,Unknown,,cid:10)(cid:13)(cid:20)(cid:10)(cid:11,,9630.0
,,8,,,Unknown,,cid:10)(cid:13)(cid:20)(cid:10)(cid:11,,9638.0
,,25,,,Unknown,,cid:10)(cid:13)(cid:20)(cid:10)(cid:11,,9663.0
,,10,,,Unknown,,cid:10)(cid:13)(cid:20)(cid:10)(cid:11,,9673.0
,,10,,,Unknown,,cid:10)(cid:13)(cid:20)(cid:10)(cid:11,,9683.0
,,1,,,Unknown,,cid:10)(cid:13)(cid:20)(cid:10)(cid:11,,9684.0
,,26,,,Unknown,,cid:10)(cid:13)(cid:20)(cid:10)(cid:11,,9710.0
,,45,,,Unknown,,cid:10)(cid:13)(cid:20)(cid:10)(cid:11,,9755.0
,,10,,,Unknown,,cid:10)(cid:13)(cid:20)(cid:10)(cid:11,,9765.0
,,19,,,Unknown,,cid:10)(cid:13)(cid:20)(cid:10)(cid:11,,9784.0
,,16,,,Unknown,,cid:10)(cid:13)(cid:20)(cid:10)(cid:11,,9800.0
,,7,,,Unknown,,cid:10)(cid:13)(cid:20)(cid:10)(cid:11,,9807.0
,,3,,,Unknown,,cid:10)(cid:13)(cid:20)(cid:10)(cid:11,,9810.0
,,8,,,Unknown,,cid:10)(cid:13)(cid:20)(cid:10)(cid:11,,9818.0
,,28,,,Unknown,,cid:10)(cid:13)(cid:20)(cid:10)(cid:11,,9846.0
,,10,,,Unknown,,cid:10)(cid:13)(cid:20)(cid:10)(cid:11,,9856.0
,,3,,,Unknown,,cid:10)(cid:13)(cid:20)(cid:10)(cid:11,,9859.0
,,6,,,Unknown,,cid:10)(cid:13)(cid:20)(cid:10)(cid:11,,9865.0
,,8,,,Unknown,,cid:10)(cid:13)(cid:20)(cid:10)(cid:11,,9873.0
,,46,,,Unknown,,cid:10)(cid:13)(cid:20)(cid:10)(cid:11,,9919.0
,,46,,,Unknown,,cid:10)(cid:13)(cid:20)(cid:10)(cid:11,,9965.0
,,47,,,Unknown,,cid:10)(cid:13)(cid:20)(cid:10)(cid:11,,10012.0
,,32,,,Unknown,,cid:10)(cid:13)(cid:20)(cid:10)(cid:11,,10044.0
,,48,,,Unknown,,cid:10)(cid:13)(cid:20)(cid:10)(cid:11,,10092.0
,,49,,,Unknown,,cid:10)(cid:13)(cid:20)(cid:10)(cid:11,,10141.0
,,34,,,Unknown,,cid:10)(cid:13)(cid:20)(cid:10)(cid:11,,10175.0
,,3,,,Unknown,,cid:10)(cid:13)(cid:20)(cid:10)(cid:11,,10178.0
,,1,,,Unknown,,cid:10)(cid:13)(cid:20)(cid:10)(cid:11,,10179.0
,,37,,,Unknown,,cid:10)(cid:13)(cid:20)(cid:10)(cid:11,,10216.0
,,3,,,Unknown,,cid:10)(cid:13)(cid:20)(cid:10)(cid:11,,10219.0
,,30,,,Unknown,,cid:10)(cid:13)(cid:20)(cid:10)(cid:11,,10249.0
,,35,,,Unknown,,cid:10)(cid:13)(cid:20)(cid:10)(cid:11,,10284.0
,,17,,,Unknown,,cid:10)(cid:13)(cid:20)(cid:10)(cid:11,,10301.0
,,28,,,Unknown,,cid:10)(cid:13)(cid:20)(cid:10)(cid:11,,10329.0
,,27,,,Unknown,,cid:10)(cid:13)(cid:20)(cid:10)(cid:11,,10356.0
,,40,,,Unknown,,cid:10)(cid:13)(cid:20)(cid:10)(cid:11,,10396.0
,,31,,,Unknown,,cid:10)(cid:13)(cid:20)(cid:10)(cid:11,,10427.0
,,1,,,Unknown,,cid:10)(cid:13)(cid:20)(cid:10)(cid:11,,10428.0
,,36,,,Unknown,,cid:10)(cid:13)(cid:20)(cid:10)(cid:11,,10464.0
,,31,,,Unknown,,cid:10)(cid:13)(cid:20)(cid:10)(cid:11,,10495.0
,,18,,,Unknown,,cid:10)(cid:13)(cid:20)(cid:10)(cid:11,,10513.0
,,16,,,Unknown,,cid:10)(cid:13)(cid:20)(cid:10)(cid:11,,10529.0
,,1,,,Unknown,,cid:10)(cid:13)(cid:20)(cid:10)(cid:11,,10530.0
,,36,,,Unknown,,cid:10)(cid:13)(cid:20)(cid:10)(cid:11,,10566.0
,,17,,,Unknown,,cid:10)(cid:13)(cid:20)(cid:10)(cid:11,,10583.0
,,3,,,Unknown,,cid:10)(cid:13)(cid:20)(cid:10)(cid:11,,10586.0
,,16,,,Unknown,,cid:10)(cid:13)(cid:20)(cid:10)(cid:11,,10602.0
,,36,,,Unknown,,cid:10)(cid:13)(cid:20)(cid:10)(cid:11,,10638.0
,,1,,,Unknown,,cid:10)(cid:13)(cid:20)(cid:10)(cid:11,,10639.0
,,2,,,Unknown,,cid:10)(cid:13)(cid:20)(cid:10)(cid:11,,10641.0
,,3,,,Unknown,,cid:10)(cid:13)(cid:20)(cid:10)(cid:11,,10644.0
,,10,,,Unknown,,cid:10)(cid:13)(cid:20)(cid:10)(cid:11,,10654.0
,,5,,,Unknown,,cid:10)(cid:13)(cid:20)(cid:10)(cid:11,,10659.0
,,20,,,Unknown,,cid:10)(cid:13)(cid:20)(cid:10)(cid:11,,10679.0
,,10,,,Unknown,,cid:10)(cid:13)(cid:20)(cid:10)(cid:11,,10689.0
,,11,,,Unknown,,cid:10)(cid:13)(cid:20)(cid:10)(cid:11,,10700.0
,,24,,,Unknown,,cid:10)(cid:13)(cid:20)(cid:10)(cid:11,,10724.0
,,1,,,Unknown,,cid:10)(cid:13)(cid:20)(cid:10)(cid:11,,10725.0
,,13,,,Unknown,,cid:10)(cid:13)(cid:20)(cid:10)(cid:11,,10738.0
,,4,,,Unknown,,cid:10)(cid:13)(cid:20)(cid:10)(cid:11,,10742.0
,,25,,,Unknown,,cid:10)(cid:13)(cid:20)(cid:10)(cid:11,,10767.0
,,13,,,Unknown,,cid:10)(cid:13)(cid:20)(cid:10)(cid:11,,10780.0
,,8,,,Unknown,,cid:10)(cid:13)(cid:20)(cid:10)(cid:11,,10788.0
,,1,,,Unknown,,cid:10)(cid:13)(cid:20)(cid:10)(cid:11,,10789.0
,,26,,,Unknown,,cid:10)(cid:13)(cid:20)(cid:10)(cid:11,,10815.0
,,45,,,Unknown,,cid:10)(cid:13)(cid:20)(cid:10)(cid:11,,10860.0
,,10,,,Unknown,,cid:10)(cid:13)(cid:20)(cid:10)(cid:11,,10870.0
,,19,,,Unknown,,cid:10)(cid:13)(cid:20)(cid:10)(cid:11,,10889.0
,,16,,,Unknown,,cid:10)(cid:13)(cid:20)(cid:10)(cid:11,,10905.0
,,7,,,Unknown,,cid:10)(cid:13)(cid:20)(cid:10)(cid:11,,10912.0
,,3,,,Unknown,,cid:10)(cid:13)(cid:20)(cid:10)(cid:11,,10915.0
,,8,,,Unknown,,cid:10)(cid:13)(cid:20)(cid:10)(cid:11,,10923.0
,,28,,,Unknown,,cid:10)(cid:13)(cid:20)(cid:10)(cid:11,,10951.0
,,10,,,Unknown,,cid:10)(cid:13)(cid:20)(cid:10)(cid:11,,10961.0
,,3,,,Unknown,,cid:10)(cid:13)(cid:20)(cid:10)(cid:11,,10964.0
,,6,,,Unknown,,cid:10)(cid:13)(cid:20)(cid:10)(cid:11,,10970.0
,,8,,,Unknown,,cid:10)(cid:13)(cid:20)(cid:10)(cid:11,,10978.0
,,46,,,Unknown,,cid:10)(cid:13)(cid:20)(cid:10)(cid:11,,11024.0
,,46,,,Unknown,,cid:10)(cid:13)(cid:20)(cid:10)(cid:11,,11070.0
,,47,,,Unknown,,cid:10)(cid:13)(cid:20)(cid:10)(cid:11,,11117.0
,,32,,,Unknown,,cid:10)(cid:13)(cid:20)(cid:10)(cid:11,,11149.0
,,48,,,Unknown,,cid:10)(cid:13)(cid:20)(cid:10)(cid:11,,11197.0
,,49,,,Unknown,,cid:10)(cid:13)(cid:20)(cid:10)(cid:11,,11246.0
,,16,,,Unknown,,cid:10)(cid:13)(cid:20)(cid:10)(cid:11,,11262.0
,,17,,,Unknown,,cid:10)(cid:13)(cid:20)(cid:10)(cid:11,,11279.0
,,16,,,Unknown,,cid:10)(cid:13)(cid:20)(cid:10)(cid:11,,11295.0
,,27,,,Unknown,,cid:10)(cid:13)(cid:20)(cid:10)(cid:11,,11322.0
,,28,,,Unknown,,cid:10)(cid:13)(cid:20)(cid:10)(cid:11,,11350.0
,,1,,,Unknown,,cid:10)(cid:13)(cid:20)(cid:10)(cid:11,,11351.0
,,35,,,Unknown,,cid:10)(cid:13)(cid:20)(cid:10)(cid:11,,11386.0
,,17,,,Unknown,,cid:10)(cid:13)(cid:20)(cid:10)(cid:11,,11403.0
,,32,,,Unknown,,cid:10)(cid:13)(cid:20)(cid:10)(cid:11,,11435.0
,,28,,,Unknown,,cid:10)(cid:13)(cid:20)(cid:10)(cid:11,,11463.0
,,17,,,Unknown,,cid:10)(cid:13)(cid:20)(cid:10)(cid:11,,11480.0
,,34,,,Unknown,,cid:10)(cid:13)(cid:20)(cid:10)(cid:11,,11514.0
,,34,,,Unknown,,cid:10)(cid:13)(cid:20)(cid:10)(cid:11,,11548.0
,,30,,,Unknown,,cid:10)(cid:13)(cid:20)(cid:10)(cid:11,,11578.0
,,31,,,Unknown,,cid:10)(cid:13)(cid:20)(cid:10)(cid:11,,11609.0
,,3,,,Unknown,,cid:10)(cid:13)(cid:20)(cid:10)(cid:11,,11612.0
,,36,,,Unknown,,cid:10)(cid:13)(cid:20)(cid:10)(cid:11,,11648.0
,,1,,,Unknown,,cid:10)(cid:13)(cid:20)(cid:10)(cid:11,,11649.0
,,2,,,Unknown,,cid:10)(cid:13)(cid:20)(cid:10)(cid:11,,11651.0
,,3,,,Unknown,,cid:10)(cid:13)(cid:20)(cid:10)(cid:11,,11654.0
,,10,,,Unknown,,cid:10)(cid:13)(cid:20)(cid:10)(cid:11,,11664.0
,,5,,,Unknown,,cid:10)(cid:13)(cid:20)(cid:10)(cid:11,,11669.0
,,20,,,Unknown,,cid:10)(cid:13)(cid:20)(cid:10)(cid:11,,11689.0
,,10,,,Unknown,,cid:10)(cid:13)(cid:20)(cid:10)(cid:11,,11699.0
,,11,,,Unknown,,cid:10)(cid:13)(cid:20)(cid:10)(cid:11,,11710.0
,,24,,,Unknown,,cid:10)(cid:13)(cid:20)(cid:10)(cid:11,,11734.0
,,1,,,Unknown,,cid:10)(cid:13)(cid:20)(cid:10)(cid:11,,11735.0
,,8,,,Unknown,,cid:10)(cid:13)(cid:20)(cid:10)(cid:11,,11743.0
,,10,,,Unknown,,cid:10)(cid:13)(cid:20)(cid:10)(cid:11,,11753.0
,,25,,,Unknown,,cid:10)(cid:13)(cid:20)(cid:10)(cid:11,,11778.0
,,10,,,Unknown,,cid:10)(cid:13)(cid:20)(cid:10)(cid:11,,11788.0
,,10,,,Unknown,,cid:10)(cid:13)(cid:20)(cid:10)(cid:11,,11798.0
,,1,,,Unknown,,cid:10)(cid:13)(cid:20)(cid:10)(cid:11,,11799.0
,,26,,,Unknown,,cid:10)(cid:13)(cid:20)(cid:10)(cid:11,,11825.0
,,45,,,Unknown,,cid:10)(cid:13)(cid:20)(cid:10)(cid:11,,11870.0
,,10,,,Unknown,,cid:10)(cid:13)(cid:20)(cid:10)(cid:11,,11880.0
,,19,,,Unknown,,cid:10)(cid:13)(cid:20)(cid:10)(cid:11,,11899.0
,,16,,,Unknown,,cid:10)(cid:13)(cid:20)(cid:10)(cid:11,,11915.0
,,7,,,Unknown,,cid:10)(cid:13)(cid:20)(cid:10)(cid:11,,11922.0
,,3,,,Unknown,,cid:10)(cid:13)(cid:20)(cid:10)(cid:11,,11925.0
,,8,,,Unknown,,cid:10)(cid:13)(cid:20)(cid:10)(cid:11,,11933.0
,,28,,,Unknown,,cid:10)(cid:13)(cid:20)(cid:10)(cid:11,,11961.0
,,10,,,Unknown,,cid:10)(cid:13)(cid:20)(cid:10)(cid:11,,11971.0
,,3,,,Unknown,,cid:10)(cid:13)(cid:20)(cid:10)(cid:11,,11974.0
,,6,,,Unknown,,cid:10)(cid:13)(cid:20)(cid:10)(cid:11,,11980.0
,,8,,,Unknown,,cid:10)(cid:13)(cid:20)(cid:10)(cid:11,,11988.0
,,46,,,Unknown,,cid:10)(cid:13)(cid:20)(cid:10)(cid:11,,12034.0
,,46,,,Unknown,,cid:10)(cid:13)(cid:20)(cid:10)(cid:11,,12080.0
,,47,,,Unknown,,cid:10)(cid:13)(cid:20)(cid:10)(cid:11,,12127.0
,,32,,,Unknown,,cid:10)(cid:13)(cid:20)(cid:10)(cid:11,,12159.0
,,48,,,Unknown,,cid:10)(cid:13)(cid:20)(cid:10)(cid:11,,12207.0
,,49,,,Unknown,,cid:10)(cid:13)(cid:20)(cid:10)(cid:11,,12256.0
,,28,,,Unknown,,cid:10)(cid:13)(cid:20)(cid:10)(cid:11,,12284.0
,,27,,,Unknown,,cid:10)(cid:13)(cid:20)(cid:10)(cid:11,,12311.0
,,1,,,Unknown,,cid:10)(cid:13)(cid:20)(cid:10)(cid:11,,12312.0
,,35,,,Unknown,,cid:10)(cid:13)(cid:20)(cid:10)(cid:11,,12347.0
,,30,,,Unknown,,cid:10)(cid:13)(cid:20)(cid:10)(cid:11,,12377.0
,,29,,,Unknown,,cid:10)(cid:13)(cid:20)(cid:10)(cid:11,,12406.0
,,31,,,Unknown,,cid:10)(cid:13)(cid:20)(cid:10)(cid:11,,12437.0
,,16,,,Unknown,,cid:10)(cid:13)(cid:20)(cid:10)(cid:11,,12453.0
,,16,,,Unknown,,cid:10)(cid:13)(cid:20)(cid:10)(cid:11,,12469.0
,,31,,,Unknown,,cid:10)(cid:13)(cid:20)(cid:10)(cid:11,,12500.0
,,1,,,Unknown,,cid:10)(cid:13)(cid:20)(cid:10)(cid:11,,12501.0
,,33,,,Unknown,,cid:10)(cid:13)(cid:20)(cid:10)(cid:11,,12534.0
,,31,,,Unknown,,cid:10)(cid:13)(cid:20)(cid:10)(cid:11,,12565.0
,,1,,,Unknown,,cid:10)(cid:13)(cid:20)(cid:10)(cid:11,,12566.0
,,28,,,Unknown,,cid:10)(cid:13)(cid:20)(cid:10)(cid:11,,12594.0
,,27,,,Unknown,,cid:10)(cid:13)(cid:20)(cid:10)(cid:11,,12621.0
,,1,,,Unknown,,cid:10)(cid:13)(cid:20)(cid:10)(cid:11,,12622.0
,,35,,,Unknown,,cid:10)(cid:13)(cid:20)(cid:10)(cid:11,,12657.0
,,3,,,Unknown,,cid:10)(cid:13)(cid:20)(cid:10)(cid:11,,12660.0
,,1,,,Unknown,,cid:10)(cid:13)(cid:20)(cid:10)(cid:11,,12661.0
,,44,,,Unknown,,cid:10)(cid:13)(cid:20)(cid:10)(cid:11,,12705.0
,,17,,,Unknown,,cid:10)(cid:13)(cid:20)(cid:10)(cid:11,,12722.0
,,32,,,Unknown,,cid:10)(cid:13)(cid:20)(cid:10)(cid:11,,12754.0
,,27,,,Unknown,,cid:10)(cid:13)(cid:20)(cid:10)(cid:11,,12781.0
,,3,,,Unknown,,cid:10)(cid:13)(cid:20)(cid:10)(cid:11,,12784.0
,,3,,,Unknown,,cid:10)(cid:13)(cid:20)(cid:10)(cid:11,,12787.0
,,31,,,Unknown,,cid:10)(cid:13)(cid:20)(cid:10)(cid:11,,12818.0
,,1,,,Unknown,,cid:10)(cid:13)(cid:20)(cid:10)(cid:11,,12819.0
,,2,,,Unknown,,cid:10)(cid:13)(cid:20)(cid:10)(cid:11,,12821.0
,,3,,,Unknown,,cid:10)(cid:13)(cid:20)(cid:10)(cid:11,,12824.0
,,10,,,Unknown,,cid:10)(cid:13)(cid:20)(cid:10)(cid:11,,12834.0
,,4,,,Unknown,,cid:10)(cid:13)(cid:20)(cid:10)(cid:11,,12838.0
,,20,,,Unknown,,cid:10)(cid:13)(cid:20)(cid:10)(cid:11,,12858.0
,,10,,,Unknown,,cid:10)(cid:13)(cid:20)(cid:10)(cid:11,,12868.0
,,11,,,Unknown,,cid:10)(cid:13)(cid:20)(cid:10)(cid:11,,12879.0
,,24,,,Unknown,,cid:10)(cid:13)(cid:20)(cid:10)(cid:11,,12903.0
,,1,,,Unknown,,cid:10)(cid:13)(cid:20)(cid:10)(cid:11,,12904.0
,,6,,,Unknown,,cid:10)(cid:13)(cid:20)(cid:10)(cid:11,,12910.0
,,8,,,Unknown,,cid:10)(cid:13)(cid:20)(cid:10)(cid:11,,12918.0
,,13,,,Unknown,,cid:10)(cid:13)(cid:20)(cid:10)(cid:11,,12931.0
,,25,,,Unknown,,cid:10)(cid:13)(cid:20)(cid:10)(cid:11,,12956.0
,,11,,,Unknown,,cid:10)(cid:13)(cid:20)(cid:10)(cid:11,,12967.0
,,10,,,Unknown,,cid:10)(cid:13)(cid:20)(cid:10)(cid:11,,12977.0
,,1,,,Unknown,,cid:10)(cid:13)(cid:20)(cid:10)(cid:11,,12978.0
,,26,,,Unknown,,cid:10)(cid:13)(cid:20)(cid:10)(cid:11,,13004.0
,,45,,,Unknown,,cid:10)(cid:13)(cid:20)(cid:10)(cid:11,,13049.0
,,10,,,Unknown,,cid:10)(cid:13)(cid:20)(cid:10)(cid:11,,13059.0
,,19,,,Unknown,,cid:10)(cid:13)(cid:20)(cid:10)(cid:11,,13078.0
,,16,,,Unknown,,cid:10)(cid:13)(cid:20)(cid:10)(cid:11,,13094.0
,,7,,,Unknown,,cid:10)(cid:13)(cid:20)(cid:10)(cid:11,,13101.0
,,3,,,Unknown,,cid:10)(cid:13)(cid:20)(cid:10)(cid:11,,13104.0
,,8,,,Unknown,,cid:10)(cid:13)(cid:20)(cid:10)(cid:11,,13112.0
,,28,,,Unknown,,cid:10)(cid:13)(cid:20)(cid:10)(cid:11,,13140.0
,,10,,,Unknown,,cid:10)(cid:13)(cid:20)(cid:10)(cid:11,,13150.0
,,3,,,Unknown,,cid:10)(cid:13)(cid:20)(cid:10)(cid:11,,13153.0
,,6,,,Unknown,,cid:10)(cid:13)(cid:20)(cid:10)(cid:11,,13159.0
,,8,,,Unknown,,cid:10)(cid:13)(cid:20)(cid:10)(cid:11,,13167.0
,,46,,,Unknown,,cid:10)(cid:13)(cid:20)(cid:10)(cid:11,,13213.0
,,46,,,Unknown,,cid:10)(cid:13)(cid:20)(cid:10)(cid:11,,13259.0
,,47,,,Unknown,,cid:10)(cid:13)(cid:20)(cid:10)(cid:11,,13306.0
,,32,,,Unknown,,cid:10)(cid:13)(cid:20)(cid:10)(cid:11,,13338.0
,,48,,,Unknown,,cid:10)(cid:13)(cid:20)(cid:10)(cid:11,,13386.0
,,49,,,Unknown,,cid:10)(cid:13)(cid:20)(cid:10)(cid:11,,13435.0
,,16,,,Unknown,,cid:10)(cid:9)(cid:20)(cid:10)(cid:11,cid:24)(cid:1)(cid:7)(cid:12)(cid:25)(cid:7)(cid:8)(cid:1)(cid:26,16.0
,,17,,,Unknown,,cid:10)(cid:9)(cid:20)(cid:10)(cid:11,cid:28)(cid:27)(cid:1)(cid:36)(cid:32)(cid:35)(cid:3)(cid:31)(cid:3)(cid:30)(cid:31)(cid:1)(cid:35)(cid:17)(cid:32)(cid:28)(cid:17)(cid:34)(cid:34)(cid:30)(cid:31)(cid:3)(cid:36)(cid:1)(cid:2)(cid:3,33.0
,,16,,,Unknown,,cid:10)(cid:9)(cid:20)(cid:10)(cid:11,,49.0
,,27,,,Unknown,,cid:10)(cid:9)(cid:20)(cid:10)(cid:11,,76.0
,,28,,,Unknown,,cid:10)(cid:9)(cid:20)(cid:10)(cid:11,,104.0
,,1,,,Unknown,,cid:10)(cid:9)(cid:20)(cid:10)(cid:11,,105.0
,,35,,,Unknown,,cid:10)(cid:9)(cid:20)(cid:10)(cid:11,,140.0
,,17,,,Unknown,,cid:10)(cid:9)(cid:20)(cid:10)(cid:11,,157.0
,,32,,,Unknown,,cid:10)(cid:9)(cid:20)(cid:10)(cid:11,,189.0
,,28,,,Unknown,,cid:10)(cid:9)(cid:20)(cid:10)(cid:11,,217.0
,,17,,,Unknown,,cid:10)(cid:9)(cid:20)(cid:10)(cid:11,,234.0
,,34,,,Unknown,,cid:10)(cid:9)(cid:20)(cid:10)(cid:11,,268.0
,,34,,,Unknown,,cid:10)(cid:9)(cid:20)(cid:10)(cid:11,,302.0
,,30,,,Unknown,,cid:10)(cid:9)(cid:20)(cid:10)(cid:11,,332.0
,,31,,,Unknown,,cid:10)(cid:9)(cid:20)(cid:10)(cid:11,,363.0
,,3,,,Unknown,,cid:10)(cid:9)(cid:20)(cid:10)(cid:11,,366.0
,,36,,,Unknown,,cid:10)(cid:9)(cid:20)(cid:10)(cid:11,,402.0
,,1,,,Unknown,,cid:10)(cid:9)(cid:20)(cid:10)(cid:11,,403.0
,,2,,,Unknown,,cid:10)(cid:9)(cid:20)(cid:10)(cid:11,,405.0
,,3,,,Unknown,,cid:10)(cid:9)(cid:20)(cid:10)(cid:11,,408.0
,,10,,,Unknown,,cid:10)(cid:9)(cid:20)(cid:10)(cid:11,,418.0
,,9,,,Unknown,,cid:10)(cid:9)(cid:20)(cid:10)(cid:11,,427.0
,,20,,,Unknown,,cid:10)(cid:9)(cid:20)(cid:10)(cid:11,,447.0
,,10,,,Unknown,,cid:10)(cid:9)(cid:20)(cid:10)(cid:11,,457.0
,,11,,,Unknown,,cid:10)(cid:9)(cid:20)(cid:10)(cid:11,,468.0
,,24,,,Unknown,,cid:10)(cid:9)(cid:20)(cid:10)(cid:11,,492.0
,,1,,,Unknown,,cid:10)(cid:9)(cid:20)(cid:10)(cid:11,,493.0
,,5,,,Unknown,,cid:10)(cid:9)(cid:20)(cid:10)(cid:11,,498.0
,,13,,,Unknown,,cid:10)(cid:9)(cid:20)(cid:10)(cid:11,,511.0
,,25,,,Unknown,,cid:10)(cid:9)(cid:20)(cid:10)(cid:11,,536.0
,,10,,,Unknown,,cid:10)(cid:9)(cid:20)(cid:10)(cid:11,,546.0
,,11,,,Unknown,,cid:10)(cid:9)(cid:20)(cid:10)(cid:11,,557.0
,,1,,,Unknown,,cid:10)(cid:9)(cid:20)(cid:10)(cid:11,,558.0
,,26,,,Unknown,,cid:10)(cid:9)(cid:20)(cid:10)(cid:11,,584.0
,,45,,,Unknown,,cid:10)(cid:9)(cid:20)(cid:10)(cid:11,,629.0
,,10,,,Unknown,,cid:10)(cid:9)(cid:20)(cid:10)(cid:11,,639.0
,,19,,,Unknown,,cid:10)(cid:9)(cid:20)(cid:10)(cid:11,,658.0
,,16,,,Unknown,,cid:10)(cid:9)(cid:20)(cid:10)(cid:11,,674.0
,,7,,,Unknown,,cid:10)(cid:9)(cid:20)(cid:10)(cid:11,,681.0
,,3,,,Unknown,,cid:10)(cid:9)(cid:20)(cid:10)(cid:11,,684.0
,,8,,,Unknown,,cid:10)(cid:9)(cid:20)(cid:10)(cid:11,,692.0
,,28,,,Unknown,,cid:10)(cid:9)(cid:20)(cid:10)(cid:11,,720.0
,,10,,,Unknown,,cid:10)(cid:9)(cid:20)(cid:10)(cid:11,,730.0
,,3,,,Unknown,,cid:10)(cid:9)(cid:20)(cid:10)(cid:11,,733.0
,,6,,,Unknown,,cid:10)(cid:9)(cid:20)(cid:10)(cid:11,,739.0
,,8,,,Unknown,,cid:10)(cid:9)(cid:20)(cid:10)(cid:11,,747.0
,,46,,,Unknown,,cid:10)(cid:9)(cid:20)(cid:10)(cid:11,,793.0
,,46,,,Unknown,,cid:10)(cid:9)(cid:20)(cid:10)(cid:11,,839.0
,,47,,,Unknown,,cid:10)(cid:9)(cid:20)(cid:10)(cid:11,,886.0
,,32,,,Unknown,,cid:10)(cid:9)(cid:20)(cid:10)(cid:11,,918.0
,,48,,,Unknown,,cid:10)(cid:9)(cid:20)(cid:10)(cid:11,,966.0
,,49,,,Unknown,,cid:10)(cid:9)(cid:20)(cid:10)(cid:11,,1015.0
,,16,,,Unknown,,cid:10)(cid:9)(cid:20)(cid:10)(cid:11,,1031.0
,,17,,,Unknown,,cid:10)(cid:9)(cid:20)(cid:10)(cid:11,,1048.0
,,16,,,Unknown,,cid:10)(cid:9)(cid:20)(cid:10)(cid:11,,1064.0
,,27,,,Unknown,,cid:10)(cid:9)(cid:20)(cid:10)(cid:11,,1091.0
,,28,,,Unknown,,cid:10)(cid:9)(cid:20)(cid:10)(cid:11,,1119.0
,,1,,,Unknown,,cid:10)(cid:9)(cid:20)(cid:10)(cid:11,,1120.0
,,35,,,Unknown,,cid:10)(cid:9)(cid:20)(cid:10)(cid:11,,1155.0
,,17,,,Unknown,,cid:10)(cid:9)(cid:20)(cid:10)(cid:11,,1172.0
,,32,,,Unknown,,cid:10)(cid:9)(cid:20)(cid:10)(cid:11,,1204.0
,,28,,,Unknown,,cid:10)(cid:9)(cid:20)(cid:10)(cid:11,,1232.0
,,17,,,Unknown,,cid:10)(cid:9)(cid:20)(cid:10)(cid:11,,1249.0
,,34,,,Unknown,,cid:10)(cid:9)(cid:20)(cid:10)(cid:11,,1283.0
,,34,,,Unknown,,cid:10)(cid:9)(cid:20)(cid:10)(cid:11,,1317.0
,,30,,,Unknown,,cid:10)(cid:9)(cid:20)(cid:10)(cid:11,,1347.0
,,31,,,Unknown,,cid:10)(cid:9)(cid:20)(cid:10)(cid:11,,1378.0
,,3,,,Unknown,,cid:10)(cid:9)(cid:20)(cid:10)(cid:11,,1381.0
,,36,,,Unknown,,cid:10)(cid:9)(cid:20)(cid:10)(cid:11,,1417.0
,,1,,,Unknown,,cid:10)(cid:9)(cid:20)(cid:10)(cid:11,,1418.0
,,2,,,Unknown,,cid:10)(cid:9)(cid:20)(cid:10)(cid:11,,1420.0
,,3,,,Unknown,,cid:10)(cid:9)(cid:20)(cid:10)(cid:11,,1423.0
,,6,,,Unknown,,cid:10)(cid:9)(cid:20)(cid:10)(cid:11,,1429.0
,,10,,,Unknown,,cid:10)(cid:9)(cid:20)(cid:10)(cid:11,,1439.0
,,20,,,Unknown,,cid:10)(cid:9)(cid:20)(cid:10)(cid:11,,1459.0
,,10,,,Unknown,,cid:10)(cid:9)(cid:20)(cid:10)(cid:11,,1469.0
,,11,,,Unknown,,cid:10)(cid:9)(cid:20)(cid:10)(cid:11,,1480.0
,,45,,,Unknown,,cid:10)(cid:9)(cid:20)(cid:10)(cid:11,,1525.0
,,10,,,Unknown,,cid:10)(cid:9)(cid:20)(cid:10)(cid:11,,1535.0
,,19,,,Unknown,,cid:10)(cid:9)(cid:20)(cid:10)(cid:11,,1554.0
,,16,,,Unknown,,cid:10)(cid:9)(cid:20)(cid:10)(cid:11,,1570.0
,,7,,,Unknown,,cid:10)(cid:9)(cid:20)(cid:10)(cid:11,,1577.0
,,3,,,Unknown,,cid:10)(cid:9)(cid:20)(cid:10)(cid:11,,1580.0
,,8,,,Unknown,,cid:10)(cid:9)(cid:20)(cid:10)(cid:11,,1588.0
,,28,,,Unknown,,cid:10)(cid:9)(cid:20)(cid:10)(cid:11,,1616.0
,,10,,,Unknown,,cid:10)(cid:9)(cid:20)(cid:10)(cid:11,,1626.0
,,3,,,Unknown,,cid:10)(cid:9)(cid:20)(cid:10)(cid:11,,1629.0
,,6,,,Unknown,,cid:10)(cid:9)(cid:20)(cid:10)(cid:11,,1635.0
,,8,,,Unknown,,cid:10)(cid:9)(cid:20)(cid:10)(cid:11,,1643.0
,,46,,,Unknown,,cid:10)(cid:9)(cid:20)(cid:10)(cid:11,,1689.0
,,46,,,Unknown,,cid:10)(cid:9)(cid:20)(cid:10)(cid:11,,1735.0
,,47,,,Unknown,,cid:10)(cid:9)(cid:20)(cid:10)(cid:11,,1782.0
,,32,,,Unknown,,cid:10)(cid:9)(cid:20)(cid:10)(cid:11,,1814.0
,,48,,,Unknown,,cid:10)(cid:9)(cid:20)(cid:10)(cid:11,,1862.0
,,49,,,Unknown,,cid:10)(cid:9)(cid:20)(cid:10)(cid:11,,1911.0
,,24,,,Unknown,,cid:10)(cid:9)(cid:20)(cid:10)(cid:11,,1935.0
,,1,,,Unknown,,cid:10)(cid:9)(cid:20)(cid:10)(cid:11,,1936.0
,,8,,,Unknown,,cid:10)(cid:9)(cid:20)(cid:10)(cid:11,,1944.0
,,10,,,Unknown,,cid:10)(cid:9)(cid:20)(cid:10)(cid:11,,1954.0
,,25,,,Unknown,,cid:10)(cid:9)(cid:20)(cid:10)(cid:11,,1979.0
,,10,,,Unknown,,cid:10)(cid:9)(cid:20)(cid:10)(cid:11,,1989.0
,,6,,,Unknown,,cid:10)(cid:9)(cid:20)(cid:10)(cid:11,,1995.0
,,1,,,Unknown,,cid:10)(cid:9)(cid:20)(cid:10)(cid:11,,1996.0
,,26,,,Unknown,,cid:10)(cid:9)(cid:20)(cid:10)(cid:11,,2022.0
,,16,,,Unknown,,cid:10)(cid:9)(cid:20)(cid:10)(cid:11,,2038.0
,,17,,,Unknown,,cid:10)(cid:9)(cid:20)(cid:10)(cid:11,,2055.0
,,16,,,Unknown,,cid:10)(cid:9)(cid:20)(cid:10)(cid:11,,2071.0
,,27,,,Unknown,,cid:10)(cid:9)(cid:20)(cid:10)(cid:11,,2098.0
,,28,,,Unknown,,cid:10)(cid:9)(cid:20)(cid:10)(cid:11,,2126.0
,,1,,,Unknown,,cid:10)(cid:9)(cid:20)(cid:10)(cid:11,,2127.0
,,35,,,Unknown,,cid:10)(cid:9)(cid:20)(cid:10)(cid:11,,2162.0
,,17,,,Unknown,,cid:10)(cid:9)(cid:20)(cid:10)(cid:11,,2179.0
,,32,,,Unknown,,cid:10)(cid:9)(cid:20)(cid:10)(cid:11,,2211.0
,,28,,,Unknown,,cid:10)(cid:9)(cid:20)(cid:10)(cid:11,,2239.0
,,17,,,Unknown,,cid:10)(cid:9)(cid:20)(cid:10)(cid:11,,2256.0
,,34,,,Unknown,,cid:10)(cid:9)(cid:20)(cid:10)(cid:11,,2290.0
,,34,,,Unknown,,cid:10)(cid:9)(cid:20)(cid:10)(cid:11,,2324.0
,,30,,,Unknown,,cid:10)(cid:9)(cid:20)(cid:10)(cid:11,,2354.0
,,31,,,Unknown,,cid:10)(cid:9)(cid:20)(cid:10)(cid:11,,2385.0
,,3,,,Unknown,,cid:10)(cid:9)(cid:20)(cid:10)(cid:11,,2388.0
,,36,,,Unknown,,cid:10)(cid:9)(cid:20)(cid:10)(cid:11,,2424.0
,,1,,,Unknown,,cid:10)(cid:9)(cid:20)(cid:10)(cid:11,,2425.0
,,2,,,Unknown,,cid:10)(cid:9)(cid:20)(cid:10)(cid:11,,2427.0
,,3,,,Unknown,,cid:10)(cid:9)(cid:20)(cid:10)(cid:11,,2430.0
,,6,,,Unknown,,cid:10)(cid:9)(cid:20)(cid:10)(cid:11,,2436.0
,,10,,,Unknown,,cid:10)(cid:9)(cid:20)(cid:10)(cid:11,,2446.0
,,20,,,Unknown,,cid:10)(cid:9)(cid:20)(cid:10)(cid:11,,2466.0
,,10,,,Unknown,,cid:10)(cid:9)(cid:20)(cid:10)(cid:11,,2476.0
,,11,,,Unknown,,cid:10)(cid:9)(cid:20)(cid:10)(cid:11,,2487.0
,,24,,,Unknown,,cid:10)(cid:9)(cid:20)(cid:10)(cid:11,,2511.0
,,1,,,Unknown,,cid:10)(cid:9)(cid:20)(cid:10)(cid:11,,2512.0
,,7,,,Unknown,,cid:10)(cid:9)(cid:20)(cid:10)(cid:11,,2519.0
,,12,,,Unknown,,cid:10)(cid:9)(cid:20)(cid:10)(cid:11,,2531.0
,,25,,,Unknown,,cid:10)(cid:9)(cid:20)(cid:10)(cid:11,,2556.0
,,7,,,Unknown,,cid:10)(cid:9)(cid:20)(cid:10)(cid:11,,2563.0
,,8,,,Unknown,,cid:10)(cid:9)(cid:20)(cid:10)(cid:11,,2571.0
,,1,,,Unknown,,cid:10)(cid:9)(cid:20)(cid:10)(cid:11,,2572.0
,,26,,,Unknown,,cid:10)(cid:9)(cid:20)(cid:10)(cid:11,,2598.0
,,45,,,Unknown,,cid:10)(cid:9)(cid:20)(cid:10)(cid:11,,2643.0
,,10,,,Unknown,,cid:10)(cid:9)(cid:20)(cid:10)(cid:11,,2653.0
,,19,,,Unknown,,cid:10)(cid:9)(cid:20)(cid:10)(cid:11,,2672.0
,,16,,,Unknown,,cid:10)(cid:9)(cid:20)(cid:10)(cid:11,,2688.0
,,7,,,Unknown,,cid:10)(cid:9)(cid:20)(cid:10)(cid:11,,2695.0
,,3,,,Unknown,,cid:10)(cid:9)(cid:20)(cid:10)(cid:11,,2698.0
,,8,,,Unknown,,cid:10)(cid:9)(cid:20)(cid:10)(cid:11,,2706.0
,,28,,,Unknown,,cid:10)(cid:9)(cid:20)(cid:10)(cid:11,,2734.0
,,10,,,Unknown,,cid:10)(cid:9)(cid:20)(cid:10)(cid:11,,2744.0
,,3,,,Unknown,,cid:10)(cid:9)(cid:20)(cid:10)(cid:11,,2747.0
,,6,,,Unknown,,cid:10)(cid:9)(cid:20)(cid:10)(cid:11,,2753.0
,,8,,,Unknown,,cid:10)(cid:9)(cid:20)(cid:10)(cid:11,,2761.0
,,46,,,Unknown,,cid:10)(cid:9)(cid:20)(cid:10)(cid:11,,2807.0
,,46,,,Unknown,,cid:10)(cid:9)(cid:20)(cid:10)(cid:11,,2853.0
,,47,,,Unknown,,cid:10)(cid:9)(cid:20)(cid:10)(cid:11,,2900.0
,,32,,,Unknown,,cid:10)(cid:9)(cid:20)(cid:10)(cid:11,,2932.0
,,48,,,Unknown,,cid:10)(cid:9)(cid:20)(cid:10)(cid:11,,2980.0
,,49,,,Unknown,,cid:10)(cid:9)(cid:20)(cid:10)(cid:11,,3029.0
,,18,,,Unknown,,cid:10)(cid:9)(cid:20)(cid:10)(cid:11,,3047.0
,,31,,,Unknown,,cid:10)(cid:9)(cid:20)(cid:10)(cid:11,,3078.0
,,43,,,Unknown,,cid:10)(cid:9)(cid:20)(cid:10)(cid:11,,3121.0
,,43,,,Unknown,,cid:10)(cid:9)(cid:20)(cid:10)(cid:11,,3164.0
,,31,,,Unknown,,cid:10)(cid:9)(cid:20)(cid:10)(cid:11,,3195.0
,,16,,,Unknown,,cid:10)(cid:9)(cid:20)(cid:10)(cid:11,,3211.0
,,16,,,Unknown,,cid:10)(cid:9)(cid:20)(cid:10)(cid:11,,3227.0
,,27,,,Unknown,,cid:10)(cid:9)(cid:20)(cid:10)(cid:11,,3254.0
,,1,,,Unknown,,cid:10)(cid:9)(cid:20)(cid:10)(cid:11,,3255.0
,,33,,,Unknown,,cid:10)(cid:9)(cid:20)(cid:10)(cid:11,,3288.0
,,31,,,Unknown,,cid:10)(cid:9)(cid:20)(cid:10)(cid:11,,3319.0
,,34,,,Unknown,,cid:10)(cid:9)(cid:20)(cid:10)(cid:11,,3353.0
,,31,,,Unknown,,cid:10)(cid:9)(cid:20)(cid:10)(cid:11,,3384.0
,,34,,,Unknown,,cid:10)(cid:9)(cid:20)(cid:10)(cid:11,,3418.0
,,31,,,Unknown,,cid:10)(cid:9)(cid:20)(cid:10)(cid:11,,3449.0
,,1,,,Unknown,,cid:10)(cid:9)(cid:20)(cid:10)(cid:11,,3450.0
,,28,,,Unknown,,cid:10)(cid:9)(cid:20)(cid:10)(cid:11,,3478.0
,,27,,,Unknown,,cid:10)(cid:9)(cid:20)(cid:10)(cid:11,,3505.0
,,1,,,Unknown,,cid:10)(cid:9)(cid:20)(cid:10)(cid:11,,3506.0
,,2,,,Unknown,,cid:10)(cid:9)(cid:20)(cid:10)(cid:11,,3508.0
,,31,,,Unknown,,cid:10)(cid:9)(cid:20)(cid:10)(cid:11,,3539.0
,,3,,,Unknown,,cid:10)(cid:9)(cid:20)(cid:10)(cid:11,,3542.0
,,16,,,Unknown,,cid:10)(cid:9)(cid:20)(cid:10)(cid:11,,3558.0
,,31,,,Unknown,,cid:10)(cid:9)(cid:20)(cid:10)(cid:11,,3589.0
,,1,,,Unknown,,cid:10)(cid:9)(cid:20)(cid:10)(cid:11,,3590.0
,,36,,,Unknown,,cid:10)(cid:9)(cid:20)(cid:10)(cid:11,,3626.0
,,17,,,Unknown,,cid:10)(cid:9)(cid:20)(cid:10)(cid:11,,3643.0
,,32,,,Unknown,,cid:10)(cid:9)(cid:20)(cid:10)(cid:11,,3675.0
,,36,,,Unknown,,cid:10)(cid:9)(cid:20)(cid:10)(cid:11,,3711.0
,,1,,,Unknown,,cid:10)(cid:9)(cid:20)(cid:10)(cid:11,,3712.0
,,2,,,Unknown,,cid:10)(cid:9)(cid:20)(cid:10)(cid:11,,3714.0
,,3,,,Unknown,,cid:10)(cid:9)(cid:20)(cid:10)(cid:11,,3717.0
,,6,,,Unknown,,cid:10)(cid:9)(cid:20)(cid:10)(cid:11,,3723.0
,,10,,,Unknown,,cid:10)(cid:9)(cid:20)(cid:10)(cid:11,,3733.0
,,20,,,Unknown,,cid:10)(cid:9)(cid:20)(cid:10)(cid:11,,3753.0
,,10,,,Unknown,,cid:10)(cid:9)(cid:20)(cid:10)(cid:11,,3763.0
,,11,,,Unknown,,cid:10)(cid:9)(cid:20)(cid:10)(cid:11,,3774.0
,,24,,,Unknown,,cid:10)(cid:9)(cid:20)(cid:10)(cid:11,,3798.0
,,1,,,Unknown,,cid:10)(cid:9)(cid:20)(cid:10)(cid:11,,3799.0
,,6,,,Unknown,,cid:10)(cid:9)(cid:20)(cid:10)(cid:11,,3805.0
,,8,,,Unknown,,cid:10)(cid:9)(cid:20)(cid:10)(cid:11,,3813.0
,,25,,,Unknown,,cid:10)(cid:9)(cid:20)(cid:10)(cid:11,,3838.0
,,11,,,Unknown,,cid:10)(cid:9)(cid:20)(cid:10)(cid:11,,3849.0
,,5,,,Unknown,,cid:10)(cid:9)(cid:20)(cid:10)(cid:11,,3854.0
,,1,,,Unknown,,cid:10)(cid:9)(cid:20)(cid:10)(cid:11,,3855.0
,,26,,,Unknown,,cid:10)(cid:9)(cid:20)(cid:10)(cid:11,,3881.0
,,45,,,Unknown,,cid:10)(cid:9)(cid:20)(cid:10)(cid:11,,3926.0
,,10,,,Unknown,,cid:10)(cid:9)(cid:20)(cid:10)(cid:11,,3936.0
,,19,,,Unknown,,cid:10)(cid:9)(cid:20)(cid:10)(cid:11,,3955.0
,,16,,,Unknown,,cid:10)(cid:9)(cid:20)(cid:10)(cid:11,,3971.0
,,7,,,Unknown,,cid:10)(cid:9)(cid:20)(cid:10)(cid:11,,3978.0
,,3,,,Unknown,,cid:10)(cid:9)(cid:20)(cid:10)(cid:11,,3981.0
,,8,,,Unknown,,cid:10)(cid:9)(cid:20)(cid:10)(cid:11,,3989.0
,,28,,,Unknown,,cid:10)(cid:9)(cid:20)(cid:10)(cid:11,,4017.0
,,10,,,Unknown,,cid:10)(cid:9)(cid:20)(cid:10)(cid:11,,4027.0
,,3,,,Unknown,,cid:10)(cid:9)(cid:20)(cid:10)(cid:11,,4030.0
,,6,,,Unknown,,cid:10)(cid:9)(cid:20)(cid:10)(cid:11,,4036.0
,,8,,,Unknown,,cid:10)(cid:9)(cid:20)(cid:10)(cid:11,,4044.0
,,46,,,Unknown,,cid:10)(cid:9)(cid:20)(cid:10)(cid:11,,4090.0
,,46,,,Unknown,,cid:10)(cid:9)(cid:20)(cid:10)(cid:11,,4136.0
,,47,,,Unknown,,cid:10)(cid:9)(cid:20)(cid:10)(cid:11,,4183.0
,,32,,,Unknown,,cid:10)(cid:9)(cid:20)(cid:10)(cid:11,,4215.0
,,48,,,Unknown,,cid:10)(cid:9)(cid:20)(cid:10)(cid:11,,4263.0
,,49,,,Unknown,,cid:10)(cid:9)(cid:20)(cid:10)(cid:11,,4312.0
,,16,,,Unknown,,cid:10)(cid:9)(cid:20)(cid:10)(cid:11,,4328.0
,,17,,,Unknown,,cid:10)(cid:9)(cid:20)(cid:10)(cid:11,,4345.0
,,16,,,Unknown,,cid:10)(cid:9)(cid:20)(cid:10)(cid:11,,4361.0
,,27,,,Unknown,,cid:10)(cid:9)(cid:20)(cid:10)(cid:11,,4388.0
,,28,,,Unknown,,cid:10)(cid:9)(cid:20)(cid:10)(cid:11,,4416.0
,,1,,,Unknown,,cid:10)(cid:9)(cid:20)(cid:10)(cid:11,,4417.0
,,28,,,Unknown,,cid:10)(cid:9)(cid:20)(cid:10)(cid:11,,4445.0
,,27,,,Unknown,,cid:10)(cid:9)(cid:20)(cid:10)(cid:11,,4472.0
,,1,,,Unknown,,cid:10)(cid:9)(cid:20)(cid:10)(cid:11,,4473.0
,,3,,,Unknown,,cid:10)(cid:9)(cid:20)(cid:10)(cid:11,,4476.0
,,17,,,Unknown,,cid:10)(cid:9)(cid:20)(cid:10)(cid:11,,4493.0
,,35,,,Unknown,,cid:10)(cid:9)(cid:20)(cid:10)(cid:11,,4528.0
,,42,,,Unknown,,cid:10)(cid:9)(cid:20)(cid:10)(cid:11,,4570.0
,,31,,,Unknown,,cid:10)(cid:9)(cid:20)(cid:10)(cid:11,,4601.0
,,16,,,Unknown,,cid:10)(cid:9)(cid:20)(cid:10)(cid:11,,4617.0
,,16,,,Unknown,,cid:10)(cid:9)(cid:20)(cid:10)(cid:11,,4633.0
,,31,,,Unknown,,cid:10)(cid:9)(cid:20)(cid:10)(cid:11,,4664.0
,,1,,,Unknown,,cid:10)(cid:9)(cid:20)(cid:10)(cid:11,,4665.0
,,2,,,Unknown,,cid:10)(cid:9)(cid:20)(cid:10)(cid:11,,4667.0
,,3,,,Unknown,,cid:10)(cid:9)(cid:20)(cid:10)(cid:11,,4670.0
,,6,,,Unknown,,cid:10)(cid:9)(cid:20)(cid:10)(cid:11,,4676.0
,,6,,,Unknown,,cid:10)(cid:9)(cid:20)(cid:10)(cid:11,,4682.0
,,20,,,Unknown,,cid:10)(cid:9)(cid:20)(cid:10)(cid:11,,4702.0
,,10,,,Unknown,,cid:10)(cid:9)(cid:20)(cid:10)(cid:11,,4712.0
,,11,,,Unknown,,cid:10)(cid:9)(cid:20)(cid:10)(cid:11,,4723.0
,,24,,,Unknown,,cid:10)(cid:9)(cid:20)(cid:10)(cid:11,,4747.0
,,1,,,Unknown,,cid:10)(cid:9)(cid:20)(cid:10)(cid:11,,4748.0
,,7,,,Unknown,,cid:10)(cid:9)(cid:20)(cid:10)(cid:11,,4755.0
,,10,,,Unknown,,cid:10)(cid:9)(cid:20)(cid:10)(cid:11,,4765.0
,,25,,,Unknown,,cid:10)(cid:9)(cid:20)(cid:10)(cid:11,,4790.0
,,13,,,Unknown,,cid:10)(cid:9)(cid:20)(cid:10)(cid:11,,4803.0
,,5,,,Unknown,,cid:10)(cid:9)(cid:20)(cid:10)(cid:11,,4808.0
,,1,,,Unknown,,cid:10)(cid:9)(cid:20)(cid:10)(cid:11,,4809.0
,,26,,,Unknown,,cid:10)(cid:9)(cid:20)(cid:10)(cid:11,,4835.0
,,45,,,Unknown,,cid:10)(cid:9)(cid:20)(cid:10)(cid:11,,4880.0
,,10,,,Unknown,,cid:10)(cid:9)(cid:20)(cid:10)(cid:11,,4890.0
,,19,,,Unknown,,cid:10)(cid:9)(cid:20)(cid:10)(cid:11,,4909.0
,,16,,,Unknown,,cid:10)(cid:9)(cid:20)(cid:10)(cid:11,,4925.0
,,7,,,Unknown,,cid:10)(cid:9)(cid:20)(cid:10)(cid:11,,4932.0
,,3,,,Unknown,,cid:10)(cid:9)(cid:20)(cid:10)(cid:11,,4935.0
,,8,,,Unknown,,cid:10)(cid:9)(cid:20)(cid:10)(cid:11,,4943.0
,,28,,,Unknown,,cid:10)(cid:9)(cid:20)(cid:10)(cid:11,,4971.0
,,10,,,Unknown,,cid:10)(cid:9)(cid:20)(cid:10)(cid:11,,4981.0
,,3,,,Unknown,,cid:10)(cid:9)(cid:20)(cid:10)(cid:11,,4984.0
,,6,,,Unknown,,cid:10)(cid:9)(cid:20)(cid:10)(cid:11,,4990.0
,,8,,,Unknown,,cid:10)(cid:9)(cid:20)(cid:10)(cid:11,,4998.0
,,46,,,Unknown,,cid:10)(cid:9)(cid:20)(cid:10)(cid:11,,5044.0
,,46,,,Unknown,,cid:10)(cid:9)(cid:20)(cid:10)(cid:11,,5090.0
,,47,,,Unknown,,cid:10)(cid:9)(cid:20)(cid:10)(cid:11,,5137.0
,,32,,,Unknown,,cid:10)(cid:9)(cid:20)(cid:10)(cid:11,,5169.0
,,48,,,Unknown,,cid:10)(cid:9)(cid:20)(cid:10)(cid:11,,5217.0
,,49,,,Unknown,,cid:10)(cid:9)(cid:20)(cid:10)(cid:11,,5266.0
,,28,,,Unknown,,cid:10)(cid:9)(cid:20)(cid:10)(cid:11,,5294.0
,,27,,,Unknown,,cid:10)(cid:9)(cid:20)(cid:10)(cid:11,,5321.0
,,1,,,Unknown,,cid:10)(cid:9)(cid:20)(cid:10)(cid:11,,5322.0
,,36,,,Unknown,,cid:10)(cid:9)(cid:20)(cid:10)(cid:11,,5358.0
,,32,,,Unknown,,cid:10)(cid:9)(cid:20)(cid:10)(cid:11,,5390.0
,,35,,,Unknown,,cid:10)(cid:9)(cid:20)(cid:10)(cid:11,,5425.0
,,3,,,Unknown,,cid:10)(cid:9)(cid:20)(cid:10)(cid:11,,5428.0
,,31,,,Unknown,,cid:10)(cid:9)(cid:20)(cid:10)(cid:11,,5459.0
,,3,,,Unknown,,cid:10)(cid:9)(cid:20)(cid:10)(cid:11,,5462.0
,,30,,,Unknown,,cid:10)(cid:9)(cid:20)(cid:10)(cid:11,,5492.0
,,31,,,Unknown,,cid:10)(cid:9)(cid:20)(cid:10)(cid:11,,5523.0
,,1,,,Unknown,,cid:10)(cid:9)(cid:20)(cid:10)(cid:11,,5524.0
,,35,,,Unknown,,cid:10)(cid:9)(cid:20)(cid:10)(cid:11,,5559.0
,,17,,,Unknown,,cid:10)(cid:9)(cid:20)(cid:10)(cid:11,,5576.0
,,32,,,Unknown,,cid:10)(cid:9)(cid:20)(cid:10)(cid:11,,5608.0
,,28,,,Unknown,,cid:10)(cid:9)(cid:20)(cid:10)(cid:11,,5636.0
,,17,,,Unknown,,cid:10)(cid:9)(cid:20)(cid:10)(cid:11,,5653.0
,,34,,,Unknown,,cid:10)(cid:9)(cid:20)(cid:10)(cid:11,,5687.0
,,34,,,Unknown,,cid:10)(cid:9)(cid:20)(cid:10)(cid:11,,5721.0
,,30,,,Unknown,,cid:10)(cid:9)(cid:20)(cid:10)(cid:11,,5751.0
,,31,,,Unknown,,cid:10)(cid:9)(cid:20)(cid:10)(cid:11,,5782.0
,,3,,,Unknown,,cid:10)(cid:9)(cid:20)(cid:10)(cid:11,,5785.0
,,36,,,Unknown,,cid:10)(cid:9)(cid:20)(cid:10)(cid:11,,5821.0
,,1,,,Unknown,,cid:10)(cid:9)(cid:20)(cid:10)(cid:11,,5822.0
,,2,,,Unknown,,cid:10)(cid:9)(cid:20)(cid:10)(cid:11,,5824.0
,,3,,,Unknown,,cid:10)(cid:9)(cid:20)(cid:10)(cid:11,,5827.0
,,6,,,Unknown,,cid:10)(cid:9)(cid:20)(cid:10)(cid:11,,5833.0
,,11,,,Unknown,,cid:10)(cid:9)(cid:20)(cid:10)(cid:11,,5844.0
,,20,,,Unknown,,cid:10)(cid:9)(cid:20)(cid:10)(cid:11,,5864.0
,,10,,,Unknown,,cid:10)(cid:9)(cid:20)(cid:10)(cid:11,,5874.0
,,11,,,Unknown,,cid:10)(cid:9)(cid:20)(cid:10)(cid:11,,5885.0
,,24,,,Unknown,,cid:10)(cid:9)(cid:20)(cid:10)(cid:11,,5909.0
,,1,,,Unknown,,cid:10)(cid:9)(cid:20)(cid:10)(cid:11,,5910.0
,,8,,,Unknown,,cid:10)(cid:9)(cid:20)(cid:10)(cid:11,,5918.0
,,6,,,Unknown,,cid:10)(cid:9)(cid:20)(cid:10)(cid:11,,5924.0
,,25,,,Unknown,,cid:10)(cid:9)(cid:20)(cid:10)(cid:11,,5949.0
,,10,,,Unknown,,cid:10)(cid:9)(cid:20)(cid:10)(cid:11,,5959.0
,,10,,,Unknown,,cid:10)(cid:9)(cid:20)(cid:10)(cid:11,,5969.0
,,1,,,Unknown,,cid:10)(cid:9)(cid:20)(cid:10)(cid:11,,5970.0
,,26,,,Unknown,,cid:10)(cid:9)(cid:20)(cid:10)(cid:11,,5996.0
,,45,,,Unknown,,cid:10)(cid:9)(cid:20)(cid:10)(cid:11,,6041.0
,,10,,,Unknown,,cid:10)(cid:9)(cid:20)(cid:10)(cid:11,,6051.0
,,19,,,Unknown,,cid:10)(cid:9)(cid:20)(cid:10)(cid:11,,6070.0
,,16,,,Unknown,,cid:10)(cid:9)(cid:20)(cid:10)(cid:11,,6086.0
,,7,,,Unknown,,cid:10)(cid:9)(cid:20)(cid:10)(cid:11,,6093.0
,,3,,,Unknown,,cid:10)(cid:9)(cid:20)(cid:10)(cid:11,,6096.0
,,8,,,Unknown,,cid:10)(cid:9)(cid:20)(cid:10)(cid:11,,6104.0
,,28,,,Unknown,,cid:10)(cid:9)(cid:20)(cid:10)(cid:11,,6132.0
,,10,,,Unknown,,cid:10)(cid:9)(cid:20)(cid:10)(cid:11,,6142.0
,,3,,,Unknown,,cid:10)(cid:9)(cid:20)(cid:10)(cid:11,,6145.0
,,6,,,Unknown,,cid:10)(cid:9)(cid:20)(cid:10)(cid:11,,6151.0
,,8,,,Unknown,,cid:10)(cid:9)(cid:20)(cid:10)(cid:11,,6159.0
,,46,,,Unknown,,cid:10)(cid:9)(cid:20)(cid:10)(cid:11,,6205.0
,,46,,,Unknown,,cid:10)(cid:9)(cid:20)(cid:10)(cid:11,,6251.0
,,47,,,Unknown,,cid:10)(cid:9)(cid:20)(cid:10)(cid:11,,6298.0
,,32,,,Unknown,,cid:10)(cid:9)(cid:20)(cid:10)(cid:11,,6330.0
,,48,,,Unknown,,cid:10)(cid:9)(cid:20)(cid:10)(cid:11,,6378.0
,,49,,,Unknown,,cid:10)(cid:9)(cid:20)(cid:10)(cid:11,,6427.0
,,36,,,Unknown,,cid:10)(cid:9)(cid:20)(cid:10)(cid:11,,6463.0
,,27,,,Unknown,,cid:10)(cid:9)(cid:20)(cid:10)(cid:11,,6490.0
,,15,,,Unknown,,cid:10)(cid:9)(cid:20)(cid:10)(cid:11,,6505.0
,,31,,,Unknown,,cid:10)(cid:9)(cid:20)(cid:10)(cid:11,,6536.0
,,2,,,Unknown,,cid:10)(cid:9)(cid:20)(cid:10)(cid:11,,6538.0
,,1,,,Unknown,,cid:10)(cid:9)(cid:20)(cid:10)(cid:11,,6539.0
,,36,,,Unknown,,cid:10)(cid:9)(cid:20)(cid:10)(cid:11,,6575.0
,,31,,,Unknown,,cid:10)(cid:9)(cid:20)(cid:10)(cid:11,,6606.0
,,15,,,Unknown,,cid:10)(cid:9)(cid:20)(cid:10)(cid:11,,6621.0
,,28,,,Unknown,,cid:10)(cid:9)(cid:20)(cid:10)(cid:11,,6649.0
,,30,,,Unknown,,cid:10)(cid:9)(cid:20)(cid:10)(cid:11,,6679.0
,,36,,,Unknown,,cid:10)(cid:9)(cid:20)(cid:10)(cid:11,,6715.0
,,1,,,Unknown,,cid:10)(cid:9)(cid:20)(cid:10)(cid:11,,6716.0
,,35,,,Unknown,,cid:10)(cid:9)(cid:20)(cid:10)(cid:11,,6751.0
,,31,,,Unknown,,cid:10)(cid:9)(cid:20)(cid:10)(cid:11,,6782.0
,,33,,,Unknown,,cid:10)(cid:9)(cid:20)(cid:10)(cid:11,,6815.0
,,31,,,Unknown,,cid:10)(cid:9)(cid:20)(cid:10)(cid:11,,6846.0
,,19,,,Unknown,,cid:10)(cid:9)(cid:20)(cid:10)(cid:11,,6865.0
,,1,,,Unknown,,cid:10)(cid:9)(cid:20)(cid:10)(cid:11,,6866.0
,,2,,,Unknown,,cid:10)(cid:9)(cid:20)(cid:10)(cid:11,,6868.0
,,3,,,Unknown,,cid:10)(cid:9)(cid:20)(cid:10)(cid:11,,6871.0
,,6,,,Unknown,,cid:10)(cid:9)(cid:20)(cid:10)(cid:11,,6877.0
,,11,,,Unknown,,cid:10)(cid:9)(cid:20)(cid:10)(cid:11,,6888.0
,,20,,,Unknown,,cid:10)(cid:9)(cid:20)(cid:10)(cid:11,,6908.0
,,10,,,Unknown,,cid:10)(cid:9)(cid:20)(cid:10)(cid:11,,6918.0
,,11,,,Unknown,,cid:10)(cid:9)(cid:20)(cid:10)(cid:11,,6929.0
,,24,,,Unknown,,cid:10)(cid:9)(cid:20)(cid:10)(cid:11,,6953.0
,,1,,,Unknown,,cid:10)(cid:9)(cid:20)(cid:10)(cid:11,,6954.0
,,6,,,Unknown,,cid:10)(cid:9)(cid:20)(cid:10)(cid:11,,6960.0
,,25,,,Unknown,,cid:10)(cid:9)(cid:20)(cid:10)(cid:11,,6985.0
,,7,,,Unknown,,cid:10)(cid:9)(cid:20)(cid:10)(cid:11,,6992.0
,,10,,,Unknown,,cid:10)(cid:9)(cid:20)(cid:10)(cid:11,,7002.0
,,1,,,Unknown,,cid:10)(cid:9)(cid:20)(cid:10)(cid:11,,7003.0
,,26,,,Unknown,,cid:10)(cid:9)(cid:20)(cid:10)(cid:11,,7029.0
,,45,,,Unknown,,cid:10)(cid:9)(cid:20)(cid:10)(cid:11,,7074.0
,,10,,,Unknown,,cid:10)(cid:9)(cid:20)(cid:10)(cid:11,,7084.0
,,19,,,Unknown,,cid:10)(cid:9)(cid:20)(cid:10)(cid:11,,7103.0
,,16,,,Unknown,,cid:10)(cid:9)(cid:20)(cid:10)(cid:11,,7119.0
,,7,,,Unknown,,cid:10)(cid:9)(cid:20)(cid:10)(cid:11,,7126.0
,,3,,,Unknown,,cid:10)(cid:9)(cid:20)(cid:10)(cid:11,,7129.0
,,8,,,Unknown,,cid:10)(cid:9)(cid:20)(cid:10)(cid:11,,7137.0
,,28,,,Unknown,,cid:10)(cid:9)(cid:20)(cid:10)(cid:11,,7165.0
,,10,,,Unknown,,cid:10)(cid:9)(cid:20)(cid:10)(cid:11,,7175.0
,,3,,,Unknown,,cid:10)(cid:9)(cid:20)(cid:10)(cid:11,,7178.0
,,6,,,Unknown,,cid:10)(cid:9)(cid:20)(cid:10)(cid:11,,7184.0
,,8,,,Unknown,,cid:10)(cid:9)(cid:20)(cid:10)(cid:11,,7192.0
,,46,,,Unknown,,cid:10)(cid:9)(cid:20)(cid:10)(cid:11,,7238.0
,,46,,,Unknown,,cid:10)(cid:9)(cid:20)(cid:10)(cid:11,,7284.0
,,47,,,Unknown,,cid:10)(cid:9)(cid:20)(cid:10)(cid:11,,7331.0
,,32,,,Unknown,,cid:10)(cid:9)(cid:20)(cid:10)(cid:11,,7363.0
,,48,,,Unknown,,cid:10)(cid:9)(cid:20)(cid:10)(cid:11,,7411.0
,,49,,,Unknown,,cid:10)(cid:9)(cid:20)(cid:10)(cid:11,,7460.0
,,35,,,Unknown,,cid:10)(cid:9)(cid:20)(cid:10)(cid:11,,7495.0
,,27,,,Unknown,,cid:10)(cid:9)(cid:20)(cid:10)(cid:11,,7522.0
,,3,,,Unknown,,cid:10)(cid:9)(cid:20)(cid:10)(cid:11,,7525.0
,,3,,,Unknown,,cid:10)(cid:9)(cid:20)(cid:10)(cid:11,,7528.0
,,31,,,Unknown,,cid:10)(cid:9)(cid:20)(cid:10)(cid:11,,7559.0
,,2,,,Unknown,,cid:10)(cid:9)(cid:20)(cid:10)(cid:11,,7561.0
,,17,,,Unknown,,cid:10)(cid:9)(cid:20)(cid:10)(cid:11,,7578.0
,,32,,,Unknown,,cid:10)(cid:9)(cid:20)(cid:10)(cid:11,,7610.0
,,3,,,Unknown,,cid:10)(cid:9)(cid:20)(cid:10)(cid:11,,7613.0
,,1,,,Unknown,,cid:10)(cid:9)(cid:20)(cid:10)(cid:11,,7614.0
,,34,,,Unknown,,cid:10)(cid:9)(cid:20)(cid:10)(cid:11,,7648.0
,,27,,,Unknown,,cid:10)(cid:9)(cid:20)(cid:10)(cid:11,,7675.0
,,3,,,Unknown,,cid:10)(cid:9)(cid:20)(cid:10)(cid:11,,7678.0
,,41,,,Unknown,,cid:10)(cid:9)(cid:20)(cid:10)(cid:11,,7719.0
,,31,,,Unknown,,cid:10)(cid:9)(cid:20)(cid:10)(cid:11,,7750.0
,,1,,,Unknown,,cid:10)(cid:9)(cid:20)(cid:10)(cid:11,,7751.0
,,3,,,Unknown,,cid:10)(cid:9)(cid:20)(cid:10)(cid:11,,7754.0
,,31,,,Unknown,,cid:10)(cid:9)(cid:20)(cid:10)(cid:11,,7785.0
,,37,,,Unknown,,cid:10)(cid:9)(cid:20)(cid:10)(cid:11,,7822.0
,,27,,,Unknown,,cid:10)(cid:9)(cid:20)(cid:10)(cid:11,,7849.0
,,30,,,Unknown,,cid:10)(cid:9)(cid:20)(cid:10)(cid:11,,7879.0
,,36,,,Unknown,,cid:10)(cid:9)(cid:20)(cid:10)(cid:11,,7915.0
,,1,,,Unknown,,cid:10)(cid:9)(cid:20)(cid:10)(cid:11,,7916.0
,,2,,,Unknown,,cid:10)(cid:9)(cid:20)(cid:10)(cid:11,,7918.0
,,3,,,Unknown,,cid:10)(cid:9)(cid:20)(cid:10)(cid:11,,7921.0
,,6,,,Unknown,,cid:10)(cid:9)(cid:20)(cid:10)(cid:11,,7927.0
,,8,,,Unknown,,cid:10)(cid:9)(cid:20)(cid:10)(cid:11,,7935.0
,,20,,,Unknown,,cid:10)(cid:9)(cid:20)(cid:10)(cid:11,,7955.0
,,10,,,Unknown,,cid:10)(cid:9)(cid:20)(cid:10)(cid:11,,7965.0
,,11,,,Unknown,,cid:10)(cid:9)(cid:20)(cid:10)(cid:11,,7976.0
,,24,,,Unknown,,cid:10)(cid:9)(cid:20)(cid:10)(cid:11,,8000.0
,,1,,,Unknown,,cid:10)(cid:9)(cid:20)(cid:10)(cid:11,,8001.0
,,11,,,Unknown,,cid:10)(cid:9)(cid:20)(cid:10)(cid:11,,8012.0
,,10,,,Unknown,,cid:10)(cid:9)(cid:20)(cid:10)(cid:11,,8022.0
,,25,,,Unknown,,cid:10)(cid:9)(cid:20)(cid:10)(cid:11,,8047.0
,,10,,,Unknown,,cid:10)(cid:9)(cid:20)(cid:10)(cid:11,,8057.0
,,6,,,Unknown,,cid:10)(cid:9)(cid:20)(cid:10)(cid:11,,8063.0
,,1,,,Unknown,,cid:10)(cid:9)(cid:20)(cid:10)(cid:11,,8064.0
,,26,,,Unknown,,cid:10)(cid:9)(cid:20)(cid:10)(cid:11,,8090.0
,,45,,,Unknown,,cid:10)(cid:9)(cid:20)(cid:10)(cid:11,,8135.0
,,10,,,Unknown,,cid:10)(cid:9)(cid:20)(cid:10)(cid:11,,8145.0
,,19,,,Unknown,,cid:10)(cid:9)(cid:20)(cid:10)(cid:11,,8164.0
,,16,,,Unknown,,cid:10)(cid:9)(cid:20)(cid:10)(cid:11,,8180.0
,,7,,,Unknown,,cid:10)(cid:9)(cid:20)(cid:10)(cid:11,,8187.0
,,3,,,Unknown,,cid:10)(cid:9)(cid:20)(cid:10)(cid:11,,8190.0
,,8,,,Unknown,,cid:10)(cid:9)(cid:20)(cid:10)(cid:11,,8198.0
,,28,,,Unknown,,cid:10)(cid:9)(cid:20)(cid:10)(cid:11,,8226.0
,,10,,,Unknown,,cid:10)(cid:9)(cid:20)(cid:10)(cid:11,,8236.0
,,3,,,Unknown,,cid:10)(cid:9)(cid:20)(cid:10)(cid:11,,8239.0
,,6,,,Unknown,,cid:10)(cid:9)(cid:20)(cid:10)(cid:11,,8245.0
,,8,,,Unknown,,cid:10)(cid:9)(cid:20)(cid:10)(cid:11,,8253.0
,,46,,,Unknown,,cid:10)(cid:9)(cid:20)(cid:10)(cid:11,,8299.0
,,46,,,Unknown,,cid:10)(cid:9)(cid:20)(cid:10)(cid:11,,8345.0
,,47,,,Unknown,,cid:10)(cid:9)(cid:20)(cid:10)(cid:11,,8392.0
,,32,,,Unknown,,cid:10)(cid:9)(cid:20)(cid:10)(cid:11,,8424.0
,,48,,,Unknown,,cid:10)(cid:9)(cid:20)(cid:10)(cid:11,,8472.0
,,49,,,Unknown,,cid:10)(cid:9)(cid:20)(cid:10)(cid:11,,8521.0
,,3,,,Unknown,,cid:10)(cid:9)(cid:20)(cid:10)(cid:11,,8524.0
,,31,,,Unknown,,cid:10)(cid:9)(cid:20)(cid:10)(cid:11,,8555.0
,,28,,,Unknown,,cid:10)(cid:9)(cid:20)(cid:10)(cid:11,,8583.0
,,45,,,Unknown,,cid:10)(cid:9)(cid:20)(cid:10)(cid:11,,8628.0
,,35,,,Unknown,,cid:10)(cid:9)(cid:20)(cid:10)(cid:11,,8663.0
,,17,,,Unknown,,cid:10)(cid:9)(cid:20)(cid:10)(cid:11,,8680.0
,,32,,,Unknown,,cid:10)(cid:9)(cid:20)(cid:10)(cid:11,,8712.0
,,28,,,Unknown,,cid:10)(cid:9)(cid:20)(cid:10)(cid:11,,8740.0
,,17,,,Unknown,,cid:10)(cid:9)(cid:20)(cid:10)(cid:11,,8757.0
,,34,,,Unknown,,cid:10)(cid:9)(cid:20)(cid:10)(cid:11,,8791.0
,,34,,,Unknown,,cid:10)(cid:9)(cid:20)(cid:10)(cid:11,,8825.0
,,30,,,Unknown,,cid:10)(cid:9)(cid:20)(cid:10)(cid:11,,8855.0
,,31,,,Unknown,,cid:10)(cid:9)(cid:20)(cid:10)(cid:11,,8886.0
,,3,,,Unknown,,cid:10)(cid:9)(cid:20)(cid:10)(cid:11,,8889.0
,,36,,,Unknown,,cid:10)(cid:9)(cid:20)(cid:10)(cid:11,,8925.0
,,1,,,Unknown,,cid:10)(cid:9)(cid:20)(cid:10)(cid:11,,8926.0
,,35,,,Unknown,,cid:10)(cid:9)(cid:20)(cid:10)(cid:11,,8961.0
,,17,,,Unknown,,cid:10)(cid:9)(cid:20)(cid:10)(cid:11,,8978.0
,,32,,,Unknown,,cid:10)(cid:9)(cid:20)(cid:10)(cid:11,,9010.0
,,28,,,Unknown,,cid:10)(cid:9)(cid:20)(cid:10)(cid:11,,9038.0
,,17,,,Unknown,,cid:10)(cid:9)(cid:20)(cid:10)(cid:11,,9055.0
,,34,,,Unknown,,cid:10)(cid:9)(cid:20)(cid:10)(cid:11,,9089.0
,,34,,,Unknown,,cid:10)(cid:9)(cid:20)(cid:10)(cid:11,,9123.0
,,30,,,Unknown,,cid:10)(cid:9)(cid:20)(cid:10)(cid:11,,9153.0
,,31,,,Unknown,,cid:10)(cid:9)(cid:20)(cid:10)(cid:11,,9184.0
,,3,,,Unknown,,cid:10)(cid:9)(cid:20)(cid:10)(cid:11,,9187.0
,,36,,,Unknown,,cid:10)(cid:9)(cid:20)(cid:10)(cid:11,,9223.0
,,1,,,Unknown,,cid:10)(cid:9)(cid:20)(cid:10)(cid:11,,9224.0
,,2,,,Unknown,,cid:10)(cid:9)(cid:20)(cid:10)(cid:11,,9226.0
,,3,,,Unknown,,cid:10)(cid:9)(cid:20)(cid:10)(cid:11,,9229.0
,,6,,,Unknown,,cid:10)(cid:9)(cid:20)(cid:10)(cid:11,,9235.0
,,5,,,Unknown,,cid:10)(cid:9)(cid:20)(cid:10)(cid:11,,9240.0
,,20,,,Unknown,,cid:10)(cid:9)(cid:20)(cid:10)(cid:11,,9260.0
,,10,,,Unknown,,cid:10)(cid:9)(cid:20)(cid:10)(cid:11,,9270.0
,,11,,,Unknown,,cid:10)(cid:9)(cid:20)(cid:10)(cid:11,,9281.0
,,24,,,Unknown,,cid:10)(cid:9)(cid:20)(cid:10)(cid:11,,9305.0
,,1,,,Unknown,,cid:10)(cid:9)(cid:20)(cid:10)(cid:11,,9306.0
,,12,,,Unknown,,cid:10)(cid:9)(cid:20)(cid:10)(cid:11,,9318.0
,,10,,,Unknown,,cid:10)(cid:9)(cid:20)(cid:10)(cid:11,,9328.0
,,25,,,Unknown,,cid:10)(cid:9)(cid:20)(cid:10)(cid:11,,9353.0
,,10,,,Unknown,,cid:10)(cid:9)(cid:20)(cid:10)(cid:11,,9363.0
,,6,,,Unknown,,cid:10)(cid:9)(cid:20)(cid:10)(cid:11,,9369.0
,,1,,,Unknown,,cid:10)(cid:9)(cid:20)(cid:10)(cid:11,,9370.0
,,26,,,Unknown,,cid:10)(cid:9)(cid:20)(cid:10)(cid:11,,9396.0
,,45,,,Unknown,,cid:10)(cid:9)(cid:20)(cid:10)(cid:11,,9441.0
,,10,,,Unknown,,cid:10)(cid:9)(cid:20)(cid:10)(cid:11,,9451.0
,,19,,,Unknown,,cid:10)(cid:9)(cid:20)(cid:10)(cid:11,,9470.0
,,16,,,Unknown,,cid:10)(cid:9)(cid:20)(cid:10)(cid:11,,9486.0
,,7,,,Unknown,,cid:10)(cid:9)(cid:20)(cid:10)(cid:11,,9493.0
,,3,,,Unknown,,cid:10)(cid:9)(cid:20)(cid:10)(cid:11,,9496.0
,,8,,,Unknown,,cid:10)(cid:9)(cid:20)(cid:10)(cid:11,,9504.0
,,28,,,Unknown,,cid:10)(cid:9)(cid:20)(cid:10)(cid:11,,9532.0
,,10,,,Unknown,,cid:10)(cid:9)(cid:20)(cid:10)(cid:11,,9542.0
,,3,,,Unknown,,cid:10)(cid:9)(cid:20)(cid:10)(cid:11,,9545.0
,,6,,,Unknown,,cid:10)(cid:9)(cid:20)(cid:10)(cid:11,,9551.0
,,8,,,Unknown,,cid:10)(cid:9)(cid:20)(cid:10)(cid:11,,9559.0
,,46,,,Unknown,,cid:10)(cid:9)(cid:20)(cid:10)(cid:11,,9605.0
,,46,,,Unknown,,cid:10)(cid:9)(cid:20)(cid:10)(cid:11,,9651.0
,,47,,,Unknown,,cid:10)(cid:9)(cid:20)(cid:10)(cid:11,,9698.0
,,32,,,Unknown,,cid:10)(cid:9)(cid:20)(cid:10)(cid:11,,9730.0
,,48,,,Unknown,,cid:10)(cid:9)(cid:20)(cid:10)(cid:11,,9778.0
,,49,,,Unknown,,cid:10)(cid:9)(cid:20)(cid:10)(cid:11,,9827.0
,,18,,,Unknown,,cid:10)(cid:9)(cid:20)(cid:10)(cid:11,,9845.0
,,31,,,Unknown,,cid:10)(cid:9)(cid:20)(cid:10)(cid:11,,9876.0
,,43,,,Unknown,,cid:10)(cid:9)(cid:20)(cid:10)(cid:11,,9919.0
,,43,,,Unknown,,cid:10)(cid:9)(cid:20)(cid:10)(cid:11,,9962.0
,,31,,,Unknown,,cid:10)(cid:9)(cid:20)(cid:10)(cid:11,,9993.0
,,16,,,Unknown,,cid:10)(cid:9)(cid:20)(cid:10)(cid:11,,10009.0
,,16,,,Unknown,,cid:10)(cid:9)(cid:20)(cid:10)(cid:11,,10025.0
,,27,,,Unknown,,cid:10)(cid:9)(cid:20)(cid:10)(cid:11,,10052.0
,,1,,,Unknown,,cid:10)(cid:9)(cid:20)(cid:10)(cid:11,,10053.0
,,33,,,Unknown,,cid:10)(cid:9)(cid:20)(cid:10)(cid:11,,10086.0
,,31,,,Unknown,,cid:10)(cid:9)(cid:20)(cid:10)(cid:11,,10117.0
,,34,,,Unknown,,cid:10)(cid:9)(cid:20)(cid:10)(cid:11,,10151.0
,,31,,,Unknown,,cid:10)(cid:9)(cid:20)(cid:10)(cid:11,,10182.0
,,34,,,Unknown,,cid:10)(cid:9)(cid:20)(cid:10)(cid:11,,10216.0
,,31,,,Unknown,,cid:10)(cid:9)(cid:20)(cid:10)(cid:11,,10247.0
,,1,,,Unknown,,cid:10)(cid:9)(cid:20)(cid:10)(cid:11,,10248.0
,,28,,,Unknown,,cid:10)(cid:9)(cid:20)(cid:10)(cid:11,,10276.0
,,27,,,Unknown,,cid:10)(cid:9)(cid:20)(cid:10)(cid:11,,10303.0
,,1,,,Unknown,,cid:10)(cid:9)(cid:20)(cid:10)(cid:11,,10304.0
,,2,,,Unknown,,cid:10)(cid:9)(cid:20)(cid:10)(cid:11,,10306.0
,,31,,,Unknown,,cid:10)(cid:9)(cid:20)(cid:10)(cid:11,,10337.0
,,3,,,Unknown,,cid:10)(cid:9)(cid:20)(cid:10)(cid:11,,10340.0
,,16,,,Unknown,,cid:10)(cid:9)(cid:20)(cid:10)(cid:11,,10356.0
,,31,,,Unknown,,cid:10)(cid:9)(cid:20)(cid:10)(cid:11,,10387.0
,,1,,,Unknown,,cid:10)(cid:9)(cid:20)(cid:10)(cid:11,,10388.0
,,36,,,Unknown,,cid:10)(cid:9)(cid:20)(cid:10)(cid:11,,10424.0
,,17,,,Unknown,,cid:10)(cid:9)(cid:20)(cid:10)(cid:11,,10441.0
,,32,,,Unknown,,cid:10)(cid:9)(cid:20)(cid:10)(cid:11,,10473.0
,,36,,,Unknown,,cid:10)(cid:9)(cid:20)(cid:10)(cid:11,,10509.0
,,1,,,Unknown,,cid:10)(cid:9)(cid:20)(cid:10)(cid:11,,10510.0
,,2,,,Unknown,,cid:10)(cid:9)(cid:20)(cid:10)(cid:11,,10512.0
,,3,,,Unknown,,cid:10)(cid:9)(cid:20)(cid:10)(cid:11,,10515.0
,,6,,,Unknown,,cid:10)(cid:9)(cid:20)(cid:10)(cid:11,,10521.0
,,7,,,Unknown,,cid:10)(cid:9)(cid:20)(cid:10)(cid:11,,10528.0
,,20,,,Unknown,,cid:10)(cid:9)(cid:20)(cid:10)(cid:11,,10548.0
,,10,,,Unknown,,cid:10)(cid:9)(cid:20)(cid:10)(cid:11,,10558.0
,,11,,,Unknown,,cid:10)(cid:9)(cid:20)(cid:10)(cid:11,,10569.0
,,24,,,Unknown,,cid:10)(cid:9)(cid:20)(cid:10)(cid:11,,10593.0
,,1,,,Unknown,,cid:10)(cid:9)(cid:20)(cid:10)(cid:11,,10594.0
,,8,,,Unknown,,cid:10)(cid:9)(cid:20)(cid:10)(cid:11,,10602.0
,,10,,,Unknown,,cid:10)(cid:9)(cid:20)(cid:10)(cid:11,,10612.0
,,25,,,Unknown,,cid:10)(cid:9)(cid:20)(cid:10)(cid:11,,10637.0
,,10,,,Unknown,,cid:10)(cid:9)(cid:20)(cid:10)(cid:11,,10647.0
,,10,,,Unknown,,cid:10)(cid:9)(cid:20)(cid:10)(cid:11,,10657.0
,,1,,,Unknown,,cid:10)(cid:9)(cid:20)(cid:10)(cid:11,,10658.0
,,26,,,Unknown,,cid:10)(cid:9)(cid:20)(cid:10)(cid:11,,10684.0
,,45,,,Unknown,,cid:10)(cid:9)(cid:20)(cid:10)(cid:11,,10729.0
,,10,,,Unknown,,cid:10)(cid:9)(cid:20)(cid:10)(cid:11,,10739.0
,,19,,,Unknown,,cid:10)(cid:9)(cid:20)(cid:10)(cid:11,,10758.0
,,16,,,Unknown,,cid:10)(cid:9)(cid:20)(cid:10)(cid:11,,10774.0
,,7,,,Unknown,,cid:10)(cid:9)(cid:20)(cid:10)(cid:11,,10781.0
,,3,,,Unknown,,cid:10)(cid:9)(cid:20)(cid:10)(cid:11,,10784.0
,,8,,,Unknown,,cid:10)(cid:9)(cid:20)(cid:10)(cid:11,,10792.0
,,28,,,Unknown,,cid:10)(cid:9)(cid:20)(cid:10)(cid:11,,10820.0
,,10,,,Unknown,,cid:10)(cid:9)(cid:20)(cid:10)(cid:11,,10830.0
,,3,,,Unknown,,cid:10)(cid:9)(cid:20)(cid:10)(cid:11,,10833.0
,,6,,,Unknown,,cid:10)(cid:9)(cid:20)(cid:10)(cid:11,,10839.0
,,8,,,Unknown,,cid:10)(cid:9)(cid:20)(cid:10)(cid:11,,10847.0
,,46,,,Unknown,,cid:10)(cid:9)(cid:20)(cid:10)(cid:11,,10893.0
,,46,,,Unknown,,cid:10)(cid:9)(cid:20)(cid:10)(cid:11,,10939.0
,,47,,,Unknown,,cid:10)(cid:9)(cid:20)(cid:10)(cid:11,,10986.0
,,32,,,Unknown,,cid:10)(cid:9)(cid:20)(cid:10)(cid:11,,11018.0
,,48,,,Unknown,,cid:10)(cid:9)(cid:20)(cid:10)(cid:11,,11066.0
,,49,,,Unknown,,cid:10)(cid:9)(cid:20)(cid:10)(cid:11,,11115.0
,2,,2,,Card,,Banque Inconnue,qonto,-2.0
,205,,205,,Card,,Banque Inconnue,EGB 2 RUE WINSTON CHURCHILL,-207.0
,1,,1,,Card,,Banque Inconnue,Coulommiers France,-208.0
,28,,28,,Card,,Banque Inconnue,IBAN,-236.0
,1,,1,,Card,,Banque Inconnue,QNTOFRPIXXX,-237.0
,"415,07",,"415,07",,Card,,Banque Inconnue,Qonto,-41744.0
,"1 195,00",,"1 195,00",,Card,,Banque Inconnue,Apple Pay,-161244.0
,"1 608,09",,"1 608,09",,Card,,Banque Inconnue,SYNTHÈSE DE VOTRE COMPTE,-322053.0
,28,,28,,Card,,Banque Inconnue,Solde,-322081.0
,"1,98",,"1,98",,Card,,Banque Inconnue,Solde,-322279.0
,01,,01,,Card,,Banque Inconnue,Qonto,-322280.0
,02,,02,,Card,,Banque Inconnue,VILLEVAUDE FR,-322282.0
,"18,00",,"18,00",,Card,,Banque Inconnue,SANEF AUTOROUTE,-324082.0
,01,,01,,Card,,Banque Inconnue,Qonto,-324083.0
,02 51,,02 51,,Card,,Banque Inconnue,,-324334.0
,70,,70,,Card,,Banque Inconnue,,-324404.0
,01,,01,,Card,,Banque Inconnue,,-324405.0
,02 82,,02 82,,Card,,Banque Inconnue,,-324687.0
,97,,97,,Card,,Banque Inconnue,,-324784.0
,02,,02,,Card,,Banque Inconnue,,-324786.0
,02 30,,02 30,,Card,,Banque Inconnue,,-325016.0
,03,,03,,Card,,Banque Inconnue,,-325019.0
,02,,02,,Card,,Banque Inconnue,,-325021.0
,02 72,,02 72,,Card,,Banque Inconnue,,-325293.0
,00,,00,,Card,,Banque Inconnue,,-325293.0
,02,,02,,Card,,Banque Inconnue,,-325295.0
,02,,02,,Card,,Banque Inconnue,,-325297.0
,"1,90",,"1,90",,Card,,Banque Inconnue,,-325487.0
,06,,06,,Card,,Banque Inconnue,,-325493.0
,60,,60,,Card,,Banque Inconnue,,-325553.0
,80,,80,,Card,,Banque Inconnue,,-325633.0
,1,,1,,Card,,Banque Inconnue,,-325634.0
,3,,3,,Card,,Banque Inconnue,,-325637.0
01/03/2022,97,,97,,Unknown,,"Crédit 2.952,73",SOCIETE GENERALE RELEVÉ DE COMPTE,-97.0
31/03/2022,01,,01,,Unknown,,"Crédit 2.952,73",Page 2/2 Date Valeur,-98.0
30/03/2022,03,,03,,Unknown,,"Crédit 2.952,73",FNAC STE GENNEVI,-101.0
30/03/2022,31,,31,,Unknown,,"Crédit 2.952,73",CARTE,-132.0
30/03/2022,03,,03,,Unknown,,"Crédit 2.952,73",SG,-135.0
30/03/2022,3,,3,,Unknown,,"Crédit 2.952,73",MORSANG,-138.0
30/03/2022,2,,2,,Unknown,,"Crédit 2.952,73",TOTAUX DES MOUVEMENTS,-140.0
30/03/2022,2,,2,,Unknown,,"Crédit 2.952,73",SOLDE AU,-142.0
31/03/2022,30,,30,,Unknown,,"Crédit 2.952,73",Opération,-172.0
31/03/2022,03,,03,,Unknown,,"Crédit 2.952,73",Résolution,-175.0
31/03/2022,30,,30,,Unknown,,"Crédit 2.952,73",PROGRAMME DE FIDÉLITÉ JAZZ DOUBLE,-205.0
31/03/2022,03,,03,,Unknown,,"Crédit 2.952,73",CB Visa Gold Business,-208.0
01/09/2021,29,,29,,Unknown,,"Crédit 2.952,73",Jazz Pro,-237.0
,03,,03,,Unknown,,"Crédit 2.952,73",CB Visa Gold Business,-240.0
,30,,30,,Unknown,,"Crédit 2.952,73",Jazz Pro,-270.0
,03,,03,,Unknown,,"Crédit 2.952,73","RCS Pais Siege Social 29,bd Haussmann",-273.0
,30,,30,,Unknown,,"Crédit 2.952,73",Paris,-303.0
,03,,03,,Unknown,,"Crédit 2.952,73",,-306.0
,29,,29,,Unknown,,"Crédit 2.952,73",,-335.0
,03,,03,,Unknown,,"Crédit 2.952,73",,-338.0
,30,,30,,Unknown,,"Crédit 2.952,73",,-368.0
,03,,03,,Unknown,,"Crédit 2.952,73",,-371.0
,30,,30,,Unknown,,"Crédit 2.952,73",,-401.0
,03,,03,,Unknown,,"Crédit 2.952,73",,-404.0
,29,,29,,Unknown,,"Crédit 2.952,73",,-433.0
,03,,03,,Unknown,,"Crédit 2.952,73",,-436.0
,31,,31,,Unknown,,"Crédit 2.952,73",,-467.0
,03,,03,,Unknown,,"Crédit 2.952,73",,-470.0
,31,,31,,Unknown,,"Crédit 2.952,73",,-501.0
,03,,03,,Unknown,,"Crédit 2.952,73",,-504.0
,30,,30,,Unknown,,"Crédit 2.952,73",,-534.0
,03,,03,,Unknown,,"Crédit 2.952,73",,-537.0
,"29,99",,"29,99",,Unknown,,"Crédit 2.952,73",,-3536.0
,"29,99",,"29,99",,Unknown,,"Crédit 2.952,73",,-6535.0
,"327,99",,"327,99",,Unknown,,"Crédit 2.952,73",,-39334.0
,"310,00",,"310,00",,Unknown,,"Crédit 2.952,73",,-70334.0
,"2.952,73",,"2.952,73",,Unknown,,"Crédit 2.952,73",,-70336.95273
,"10,28",,"10,28",,Unknown,,"Crédit 2.952,73",,-71364.95273
,31,,31,,Unknown,,"Crédit 2.952,73",,-71395.95273
,03,,03,,Unknown,,"Crédit 2.952,73",,-71398.95273
,"1.714,96",,"1.714,96",,Unknown,,"Crédit 2.952,73",,-71400.66769
,31,,31,,Unknown,,"Crédit 2.952,73",,-71431.66769
,03,,03,,Unknown,,"Crédit 2.952,73",,-71434.66769
,"4 832,19",,"4 832,19",,Unknown,,"Crédit 2.952,73",,-554653.66769
,01,,01,,Unknown,,"Crédit 2.952,73",,-554654.66769
,09,,09,,Unknown,,"Crédit 2.952,73",,-554663.66769
,15,,15,,Unknown,,"Crédit 2.952,73",,-554678.66769
,12,,12,,Unknown,,"Crédit 2.952,73",,-554690.66769
,35,,35,,Unknown,,"Crédit 2.952,73",,-554725.66769
,15 000,,15 000,,Unknown,,"Crédit 2.952,73",,-569725.66769
,12,,12,,Unknown,,"Crédit 2.952,73",,-569737.66769
,35,,35,,Unknown,,"Crédit 2.952,73",,-569772.66769
,7 500,,7 500,,Unknown,,"Crédit 2.952,73",,-577272.66769
,12,,12,,Unknown,,"Crédit 2.952,73",,-577284.66769
,25,,25,,Unknown,,"Crédit 2.952,73",,-577309.66769
,1 552 120 222,,1 552 120 222,,Unknown,,"Crédit 2.952,73",,-1552697531.66769
,29,,29,,Unknown,,"Crédit 2.952,73",,-1552697560.66769
,"046 405 540,00",,"046 405 540,00",,Unknown,,"Crédit 2.952,73",,-6193251560.66769
,002,,002,,Unknown,,"Crédit 2.952,73",,-6193251562.66769
,002,,002,,Unknown,,"Crédit 2.952,73",,-6193251564.66769
14/01/2019,1,,1,,POS,,MR,BANQUE POSTALE Releve,-1.0
11/01/2019,14,,14,,POS,,MR,GRAND TURC,-15.0
,01,,01,,POS,,MR,CARTE X1580 09/01/19 A 17h45,-16.0
,11 034 07,,11 034 07,,POS,,MR,CARTE X1580 10/01/19 A 10H39,-1103423.0
,028,,028,,POS,,MR,ReTRAIT,-1103451.0
,09,,09,,POS,,MR,CARTE X1580 10/01/19,-1103460.0
,01,,01,,POS,,MR,Planifiez vos dépenses,-1103461.0
,08.01,,08.01,,POS,,MR,Renseignez,-1103469.01
,19,,19,,POS,,MR,Conseiller,-1103488.01
,580 10,,580 10,,POS,,MR,Coût de connerion,-1161498.01
,01,,01,,POS,,MR,Prix dun appel local,-1161499.01
,09,,09,,POS,,MR,Service,-1161508.01
,01,,01,,POS,,MR,prix dun appel Frais,-1161509.01
,19,,19,,POS,,MR,Qu remboursés,-1161528.01
,10,,10,,POS,,MR,,-1161538.01
,01,,01,,POS,,MR,,-1161539.01
,09.01,,09.01,,POS,,MR,,-1161548.02
,19,,19,,POS,,MR,,-1161567.02
,580 11,,580 11,,POS,,MR,,-1219578.02
,01,,01,,POS,,MR,,-1219579.02
,10,,10,,POS,,MR,,-1219589.02
,01,,01,,POS,,MR,,-1219590.02
,19,,19,,POS,,MR,,-1219609.02
,11,,11,,POS,,MR,,-1219620.02
,01,,01,,POS,,MR,,-1219621.02
,10,,10,,POS,,MR,,-1219631.02
,01,,01,,POS,,MR,,-1219632.02
,19,,19,,POS,,MR,,-1219651.02
,0,,0,,POS,,MR,,-1219651.02
,"35,00",,"35,00",,POS,,MR,,-1223151.02
,"10,00",,"10,00",,POS,,MR,,-1224151.02
,"4,57",,"4,57",,POS,,MR,,-1224608.02
,"200,00",,"200,00",,POS,,MR,,-1244608.02
,"250,00",,"250,00",,POS,,MR,,-1269608.02
,"2 922,44",,"2 922,44",,POS,,MR,,-1561852.02
,"2 204,09",,"2 204,09",,POS,,MR,,-1782261.02
,11,,11,,POS,,MR,,-1782272.02
,01,,01,,POS,,MR,,-1782273.02
,"765,00",,"765,00",,POS,,MR,,-1858773.02
,1,,1,,POS,,MR,,-1858774.02
,2,,2,,POS,,MR,,-1858776.02
,3,,3,,POS,,MR,,-1858779.02
,4,,4,,POS,,MR,,-1858783.02
,"0,15",,"0,15",,POS,,MR,,-1858798.02
,2,,2,,POS,,MR,,-1858800.02
,2,,2,,POS,,MR,,-1858802.02
01/02/2022,97,,97,,Unknown,,Appli Pro,SOCIETE GENERALE RELEVÉ DE COMPTE,-97.0
28/02/2022,01,,01,,Unknown,,Appli Pro,Page 1/2 VOS CONTACTS Votre Banque,-98.0
31/01/2022,02,,02,,Unknown,,Appli Pro,Distance,-100.0
01/02/2022,28,,28,,Unknown,,Appli Pro,"0,3o€/min prix",-128.0
01/02/2022,02,,02,,Unknown,,Appli Pro,STE GENEV,-130.0
04/02/2022,2,,2,,Unknown,,Appli Pro,PerI,-132.0
04/02/2022,1,,1,,Unknown,,Appli Pro,ABCI,-133.0
04/02/2022,2,,2,,Unknown,,Appli Pro,STE GENEVIEVE DES BOIS,-135.0
04/02/2022,0,,0,,Unknown,,Appli Pro,dylan barbanchon@socgen com,-135.0
07/02/2022,01 60,,01 60,,Unknown,,Appli Pro,P5I RELEVÉ DES OPÉRATIONS Date Valeur,-295.0
07/02/2022,16 05,,16 05,,Unknown,,Appli Pro,CARTE,-1900.0
07/02/2022,48,,48,,Unknown,,Appli Pro,CARTE,-1948.0
07/02/2022,01 69,,01 69,,Unknown,,Appli Pro,GEANT CG328,-2117.0
07/02/2022,51 30,,51 30,,Unknown,,Appli Pro,CARTE,-7247.0
07/02/2022,83,,83,,Unknown,,Appli Pro,CBAM,-7330.0
10/02/2022,75,,75,,Unknown,,Appli Pro,BUREAUVALL,-7405.0
10/02/2022,15,,15,,Unknown,,Appli Pro,CARTE X8155,-7420.0
14/02/2022,01 60,,01 60,,Unknown,,Appli Pro,CARTE X8155,-7580.0
14/02/2022,16 87,,16 87,,Unknown,,Appli Pro,FNAC STE GENNEVI,-9267.0
15/02/2022,75,,75,,Unknown,,Appli Pro,CARTE X8155,-9342.0
15/02/2022,31,,31,,Unknown,,Appli Pro,CBAM,-9373.0
17/02/2022,01,,01,,Unknown,,Appli Pro,BUREAUVALL,-9374.0
16/02/2022,01,,01,,Unknown,,Appli Pro,CARTE,-9375.0
17/02/2022,02,,02,,Unknown,,Appli Pro,SG,-9377.0
16/02/2022,01,,01,,Unknown,,Appli Pro,CARTE,-9378.0
18/02/2022,02,,02,,Unknown,,Appli Pro,CARTE,-9380.0
18/02/2022,31,,31,,Unknown,,Appli Pro,RETRAIT,-9411.0
21/02/2022,01,,01,,Unknown,,Appli Pro,CIC SAINTE,-9412.0
21/02/2022,04,,04,,Unknown,,Appli Pro,NT,-9416.0
21/02/2022,02,,02,,Unknown,,Appli Pro,EUR TVA,-9418.0
21/02/2022,04,,04,,Unknown,,Appli Pro,EUR,-9422.0
21/02/2022,02,,02,,Unknown,,Appli Pro,NT,-9424.0
21/02/2022,03,,03,,Unknown,,Appli Pro,EUR,-9427.0
24/02/2022,02,,02,,Unknown,,Appli Pro,CARTE,-9429.0
24/02/2022,04,,04,,Unknown,,Appli Pro,CARTE X8155,-9433.0
25/02/2022,02,,02,,Unknown,,Appli Pro,SG,-9435.0
25/02/2022,04,,04,,Unknown,,Appli Pro,MORSANG SUR ORGE,-9439.0
01/03/2020,02,,02,,Unknown,,Appli Pro,CARTE X8155,-9441.0
,03,,03,,Unknown,,Appli Pro,CLEAN,-9444.0
,02,,02,,Unknown,,Appli Pro,CARTE X8155,-9446.0
,07,,07,,Unknown,,Appli Pro,NORAUTO,-9453.0
,02,,02,,Unknown,,Appli Pro,CARTE,-9455.0
,07,,07,,Unknown,,Appli Pro,CBAM,-9462.0
,02,,02,,Unknown,,Appli Pro,BUREAUVALL,-9464.0
,04,,04,,Unknown,,Appli Pro,CARTE,-9468.0
,02,,02,,Unknown,,Appli Pro,SG,-9470.0
,07,,07,,Unknown,,Appli Pro,MORSANG SUR ORGE 00915459 Débit Crédit,-9477.0
,02,,02,,Unknown,,Appli Pro,Paris,-9479.0
,07,,07,,Unknown,,Appli Pro,com 3 Le Mediateur,-9486.0
,02,,02,,Unknown,,Appli Pro,Charte de la Mediation Société Générale,-9488.0
,04,,04,,Unknown,,Appli Pro,Le Médlateur,-9492.0
,02,,02,,Unknown,,Appli Pro,Valmy,-9494.0
,07,,07,,Unknown,,Appli Pro,Paris,-9501.0
,02,,02,,Unknown,,Appli Pro,Mediateur www mediateur societegenerale fr,-9503.0
,07,,07,,Unknown,,Appli Pro,Médiateur,-9510.0
,02,,02,,Unknown,,Appli Pro,Sociole Genérale,-9512.0
,04,,04,,Unknown,,Appli Pro,RCS Pais,-9516.0
,02,,02,,Unknown,,Appli Pro,Eur Siège,-9518.0
,10,,10,,Unknown,,Appli Pro,Paris,-9528.0
,02,,02,,Unknown,,Appli Pro,VeRT,-9530.0
,10,,10,,Unknown,,Appli Pro,,-9540.0
,02,,02,,Unknown,,Appli Pro,,-9542.0
,09,,09,,Unknown,,Appli Pro,,-9551.0
,02,,02,,Unknown,,Appli Pro,,-9553.0
,14,,14,,Unknown,,Appli Pro,,-9567.0
,02,,02,,Unknown,,Appli Pro,,-9569.0
,14,,14,,Unknown,,Appli Pro,,-9583.0
,02,,02,,Unknown,,Appli Pro,,-9585.0
,12,,12,,Unknown,,Appli Pro,,-9597.0
,02,,02,,Unknown,,Appli Pro,,-9599.0
,15,,15,,Unknown,,Appli Pro,,-9614.0
,02,,02,,Unknown,,Appli Pro,,-9616.0
,15,,15,,Unknown,,Appli Pro,,-9631.0
,02,,02,,Unknown,,Appli Pro,,-9633.0
,12,,12,,Unknown,,Appli Pro,,-9645.0
,02,,02,,Unknown,,Appli Pro,,-9647.0
,17,,17,,Unknown,,Appli Pro,,-9664.0
,02,,02,,Unknown,,Appli Pro,,-9666.0
,16,,16,,Unknown,,Appli Pro,,-9682.0
,02,,02,,Unknown,,Appli Pro,,-9684.0
,25,,25,,Unknown,,Appli Pro,,-9709.0
,"7,13",,"7,13",,Unknown,,Appli Pro,,-10422.0
,"2,62",,"2,62",,Unknown,,Appli Pro,,-10684.0
,"20,00",,"20,00",,Unknown,,Appli Pro,,-12684.0
,"0,53",,"0,53",,Unknown,,Appli Pro,,-12737.0
,17,,17,,Unknown,,Appli Pro,,-12754.0
,02,,02,,Unknown,,Appli Pro,,-12756.0
,16,,16,,Unknown,,Appli Pro,,-12772.0
,02,,02,,Unknown,,Appli Pro,,-12774.0
,"28,57",,"28,57",,Unknown,,Appli Pro,,-15631.0
,"10,43",,"10,43",,Unknown,,Appli Pro,,-16674.0
,"20,00",,"20,00",,Unknown,,Appli Pro,,-18674.0
,"2,09",,"2,09",,Unknown,,Appli Pro,,-18883.0
,18,,18,,Unknown,,Appli Pro,,-18901.0
,02,,02,,Unknown,,Appli Pro,,-18903.0
,18,,18,,Unknown,,Appli Pro,,-18921.0
,02,,02,,Unknown,,Appli Pro,,-18923.0
,17,,17,,Unknown,,Appli Pro,,-18940.0
,02,,02,,Unknown,,Appli Pro,,-18942.0
,21,,21,,Unknown,,Appli Pro,,-18963.0
,02,,02,,Unknown,,Appli Pro,,-18965.0
,21,,21,,Unknown,,Appli Pro,,-18986.0
,02,,02,,Unknown,,Appli Pro,,-18988.0
,18,,18,,Unknown,,Appli Pro,,-19006.0
,02,,02,,Unknown,,Appli Pro,,-19008.0
,21,,21,,Unknown,,Appli Pro,,-19029.0
,02,,02,,Unknown,,Appli Pro,,-19031.0
,21,,21,,Unknown,,Appli Pro,,-19052.0
,02,,02,,Unknown,,Appli Pro,,-19054.0
,18,,18,,Unknown,,Appli Pro,,-19072.0
,02,,02,,Unknown,,Appli Pro,,-19074.0
,21,,21,,Unknown,,Appli Pro,,-19095.0
,02,,02,,Unknown,,Appli Pro,,-19097.0
,21,,21,,Unknown,,Appli Pro,,-19118.0
,02,,02,,Unknown,,Appli Pro,,-19120.0
,18,,18,,Unknown,,Appli Pro,,-19138.0
,02,,02,,Unknown,,Appli Pro,,-19140.0
,206 24,,206 24,,Unknown,,Appli Pro,,-39764.0
,02,,02,,Unknown,,Appli Pro,,-39766.0
,24,,24,,Unknown,,Appli Pro,,-39790.0
,02,,02,,Unknown,,Appli Pro,,-39792.0
,23,,23,,Unknown,,Appli Pro,,-39815.0
,02,,02,,Unknown,,Appli Pro,,-39817.0
,25,,25,,Unknown,,Appli Pro,,-39842.0
,02,,02,,Unknown,,Appli Pro,,-39844.0
,25,,25,,Unknown,,Appli Pro,,-39869.0
,02,,02,,Unknown,,Appli Pro,,-39871.0
,24,,24,,Unknown,,Appli Pro,,-39895.0
,02,,02,,Unknown,,Appli Pro,,-39897.0
,"6.784,10",,"6.784,10",,Unknown,,Appli Pro,,-39903.7841
,"524,83",,"524,83",,Unknown,,Appli Pro,,-92386.78409999999
,"38,82",,"38,82",,Unknown,,Appli Pro,,-96268.78409999999
,"96,49",,"96,49",,Unknown,,Appli Pro,,-105917.78409999999
,"8,00",,"8,00",,Unknown,,Appli Pro,,-106717.78409999999
,"12,99",,"12,99",,Unknown,,Appli Pro,,-108016.78409999999
,"94,94",,"94,94",,Unknown,,Appli Pro,,-117510.78409999999
,"310,00",,"310,00",,Unknown,,Appli Pro,,-148510.7841
,"127,54",,"127,54",,Unknown,,Appli Pro,,-161264.7841
,"190,00",,"190,00",,Unknown,,Appli Pro,,-180264.7841
,"10,28",,"10,28",,Unknown,,Appli Pro,,-181292.7841
,"41,09",,"41,09",,Unknown,,Appli Pro,,-185401.7841
,"18,99",,"18,99",,Unknown,,Appli Pro,,-187300.7841
,"150,00",,"150,00",,Unknown,,Appli Pro,,-202300.7841
,"20,00",,"20,00",,Unknown,,Appli Pro,,-204300.7841
,"159,95",,"159,95",,Unknown,,Appli Pro,,-220295.7841
,"205,33",,"205,33",,Unknown,,Appli Pro,,-240828.7841
,"120,00",,"120,00",,Unknown,,Appli Pro,,-252828.7841
,2,,2,,Unknown,,Appli Pro,,-252830.7841
,33,,33,,Unknown,,Appli Pro,,-252863.7841
,76 77,,76 77,,Unknown,,Appli Pro,,-260540.7841
,01,,01,,Unknown,,Appli Pro,,-260541.7841
,03,,03,,Unknown,,Appli Pro,,-260544.7841
,1,,1,,Unknown,,Appli Pro,,-260545.7841
,2,,2,,Unknown,,Appli Pro,,-260547.7841
,18,,18,,Unknown,,Appli Pro,,-260565.7841
,3,,3,,Unknown,,Appli Pro,,-260568.7841
,17,,17,,Unknown,,Appli Pro,,-260585.7841
,7,,7,,Unknown,,Appli Pro,,-260592.7841
,90,,90,,Unknown,,Appli Pro,,-260682.7841
,552 120 222,,552 120 222,,Unknown,,Appli Pro,,-552380904.7841
,"1 046 405 540,00",,"1 046 405 540,00",,Unknown,,Appli Pro,,-105192934904.7841
,29,,29,,Unknown,,Appli Pro,,-105192934933.7841
,1,,1,,Unknown,,Appli Pro,,-105192934934.7841
,001,,001,,Unknown,,Appli Pro,,-105192934935.7841
,002,,002,,Unknown,,Appli Pro,,-105192934937.7841
15/04/2019,4,,4,,Virement,,MR,BANQUE POSTALE Releve,-4.0
,15,,15,,Virement,,MR,MKT FR 25.03.19 CaRte,-19.0
,04,,04,,Virement,,MR,CARTE,-23.0
,11 034 07,,11 034 07,,Virement,,MR,RetRnit Dablabanquepostale,-1103430.0
,028,,028,,Virement,,MR,CartenumeRo,-1103458.0
,26,,26,,Virement,,MR,AchaT,-1103484.0
,03,,03,,Virement,,MR,Frere,-1103487.0
,25.03,,25.03,,Virement,,MR,ROUEN 26.03.19 CaRtenumeRo,-1103512.03
,19,,19,,Virement,,MR,AchaT,-1103531.03
,580 27,,580 27,,Virement,,MR,PALAI 26.03.19 CarienumeRo,-1161558.03
,03,,03,,Virement,,MR,ViREMENT,-1161561.03
,26,,26,,Virement,,MR,CARTE,-1161587.03
,03,,03,,Virement,,MR,ROUEN SI SEVERIROUEN,-1161590.03
,19,,19,,Virement,,MR,CARTE,-1161609.03
,27,,27,,Virement,,MR,RetRnit Dablabanquepostale,-1161636.03
,03,,03,,Virement,,MR,ACHAT,-1161639.03
,26,,26,,Virement,,MR,CARTE,-1161665.03
,03,,03,,Virement,,MR,BANQUE POSTALE,-1161668.03
,19,,19,,Virement,,MR,OMIO 27.03.19 EUR 18.50 CARIE NO,-1161687.03
,27,,27,,Virement,,MR,CB E LECLERC 28.03.19 EUR33.93,-1161714.03
,03,,03,,Virement,,MR,CaRtenuMERo,-1161717.03
,26.03,,26.03,,Virement,,MR,MKT FR,-1161743.06
,19,,19,,Virement,,MR,CB Sapn,-1161762.06
,580 27,,580 27,,Virement,,MR,VOIRE,-1219789.06
,03,,03,,Virement,,MR,VIREMENT DE SASU AB DRIVER,-1219792.06
,26.03,,26.03,,Virement,,MR,CARTE X1580,-1219818.09
,19,,19,,Virement,,MR,GeNNEVILUERS,-1219837.09
,580 27,,580 27,,Virement,,MR,CaRtenumERo,-1277864.09
,03,,03,,Virement,,MR,CARTE,-1277867.09
,26.03,,26.03,,Virement,,MR,,-1277893.12
,19,,19,,Virement,,MR,,-1277912.12
,580 27,,580 27,,Virement,,MR,,-1335939.12
,03,,03,,Virement,,MR,,-1335942.12
,26.03,,26.03,,Virement,,MR,,-1335968.1500000001
,19,,19,,Virement,,MR,,-1335987.1500000001
,580 27,,580 27,,Virement,,MR,,-1394014.1500000001
,03,,03,,Virement,,MR,,-1394017.1500000001
,26.03,,26.03,,Virement,,MR,,-1394043.1800000002
,19,,19,,Virement,,MR,,-1394062.1800000002
,580 28,,580 28,,Virement,,MR,,-1452090.1800000002
,03,,03,,Virement,,MR,,-1452093.1800000002
,28,,28,,Virement,,MR,,-1452121.1800000002
,03,,03,,Virement,,MR,,-1452124.1800000002
,27,,27,,Virement,,MR,,-1452151.1800000002
,03,,03,,Virement,,MR,,-1452154.1800000002
,19,,19,,Virement,,MR,,-1452173.1800000002
,28,,28,,Virement,,MR,,-1452201.1800000002
,03,,03,,Virement,,MR,,-1452204.1800000002
,27,,27,,Virement,,MR,,-1452231.1800000002
,03,,03,,Virement,,MR,,-1452234.1800000002
,19,,19,,Virement,,MR,,-1452253.1800000002
,28,,28,,Virement,,MR,,-1452281.1800000002
,03,,03,,Virement,,MR,,-1452284.1800000002
,27.03,,27.03,,Virement,,MR,,-1452311.2100000002
,19,,19,,Virement,,MR,,-1452330.2100000002
,580 28,,580 28,,Virement,,MR,,-1510358.2100000002
,03,,03,,Virement,,MR,,-1510361.2100000002
,27.03,,27.03,,Virement,,MR,,-1510388.2400000002
,19,,19,,Virement,,MR,,-1510407.2400000002
,580 28,,580 28,,Virement,,MR,,-1568435.2400000002
,03,,03,,Virement,,MR,,-1568438.2400000002
,27.03,,27.03,,Virement,,MR,,-1568465.2700000003
,19,,19,,Virement,,MR,,-1568484.2700000003
,580 28,,580 28,,Virement,,MR,,-1626512.2700000003
,03,,03,,Virement,,MR,,-1626515.2700000003
,26.03,,26.03,,Virement,,MR,,-1626541.3000000003
,19,,19,,Virement,,MR,,-1626560.3000000003
,19.50,,19.50,,Virement,,MR,,-1626579.8000000003
,580 29,,580 29,,Virement,,MR,,-1684608.8000000003
,03,,03,,Virement,,MR,,-1684611.8000000003
,28,,28,,Virement,,MR,,-1684639.8000000003
,03,,03,,Virement,,MR,,-1684642.8000000003
,19,,19,,Virement,,MR,,-1684661.8000000003
,29,,29,,Virement,,MR,,-1684690.8000000003
,03,,03,,Virement,,MR,,-1684693.8000000003
,29,,29,,Virement,,MR,,-1684722.8000000003
,03,,03,,Virement,,MR,,-1684725.8000000003
,19,,19,,Virement,,MR,,-1684744.8000000003
,29,,29,,Virement,,MR,,-1684773.8000000003
,03,,03,,Virement,,MR,,-1684776.8000000003
,27.03,,27.03,,Virement,,MR,,-1684803.8300000003
,19,,19,,Virement,,MR,,-1684822.8300000003
,18.50,,18.50,,Virement,,MR,,-1684841.3300000003
,580 29,,580 29,,Virement,,MR,,-1742870.3300000003
,03,,03,,Virement,,MR,,-1742873.3300000003
,28.03,,28.03,,Virement,,MR,,-1742901.3600000003
,19,,19,,Virement,,MR,,-1742920.3600000003
,93,,93,,Virement,,MR,,-1743013.3600000003
,580 29,,580 29,,Virement,,MR,,-1801042.3600000003
,03,,03,,Virement,,MR,,-1801045.3600000003
,28.03,,28.03,,Virement,,MR,,-1801073.3900000004
,19,,19,,Virement,,MR,,-1801092.3900000004
,580 01,,580 01,,Virement,,MR,,-1859093.3900000004
,04,,04,,Virement,,MR,,-1859097.3900000004
,29.03,,29.03,,Virement,,MR,,-1859126.4200000004
,19,,19,,Virement,,MR,,-1859145.4200000004
,580 01,,580 01,,Virement,,MR,,-1917146.4200000004
,04,,04,,Virement,,MR,,-1917150.4200000004
,31.03,,31.03,,Virement,,MR,,-1917181.4500000004
,19,,19,,Virement,,MR,,-1917200.4500000004
,580 02,,580 02,,Virement,,MR,,-1975202.4500000004
,04,,04,,Virement,,MR,,-1975206.4500000004
,31.03,,31.03,,Virement,,MR,,-1975237.4800000004
,19,,19,,Virement,,MR,,-1975256.4800000004
,580 02,,580 02,,Virement,,MR,,-2033258.4800000004
,04,,04,,Virement,,MR,,-2033262.4800000004
,03,,03,,Virement,,MR,,-2033265.4800000004
,04,,04,,Virement,,MR,,-2033269.4800000004
,03,,03,,Virement,,MR,,-2033272.4800000004
,04,,04,,Virement,,MR,,-2033276.4800000004
,02,,02,,Virement,,MR,,-2033278.4800000004
,04,,04,,Virement,,MR,,-2033282.4800000004
,19,,19,,Virement,,MR,,-2033301.4800000004
,03,,03,,Virement,,MR,,-2033304.4800000004
,04,,04,,Virement,,MR,,-2033308.4800000004
,02.04,,02.04,,Virement,,MR,,-2033310.5200000005
,19,,19,,Virement,,MR,,-2033329.5200000005
,580 03,,580 03,,Virement,,MR,,-2091332.5200000005
,04,,04,,Virement,,MR,,-2091336.5200000005
,02.04,,02.04,,Virement,,MR,,-2091338.5600000005
,19,,19,,Virement,,MR,,-2091357.5600000005
,580 04,,580 04,,Virement,,MR,,-2149361.5600000005
,04,,04,,Virement,,MR,,-2149365.5600000005
,02,,02,,Virement,,MR,,-2149367.5600000005
,04,,04,,Virement,,MR,,-2149371.5600000005
,19,,19,,Virement,,MR,,-2149390.5600000005
,0,,0,,Virement,,MR,,-2149390.5600000005
,"41,16",,"41,16",,Virement,,MR,,-2153506.5600000005
,"20,00",,"20,00",,Virement,,MR,,-2155506.5600000005
,"100,00",,"100,00",,Virement,,MR,,-2165506.5600000005
,"1,90",,"1,90",,Virement,,MR,,-2165696.5600000005
,"2,50",,"2,50",,Virement,,MR,,-2165946.5600000005
,"14,00",,"14,00",,Virement,,MR,,-2167346.5600000005
,"21,80",,"21,80",,Virement,,MR,,-2169526.5600000005
,"46,50",,"46,50",,Virement,,MR,,-2174176.5600000005
,"943,85",,"943,85",,Virement,,MR,,-2268561.5600000005
,"40,00",,"40,00",,Virement,,MR,,-2272561.5600000005
,"80,00",,"80,00",,Virement,,MR,,-2280561.5600000005
,"1,70",,"1,70",,Virement,,MR,,-2280731.5600000005
,"1,90",,"1,90",,Virement,,MR,,-2280921.5600000005
,"14,50",,"14,50",,Virement,,MR,,-2282371.5600000005
,"19,50",,"19,50",,Virement,,MR,,-2284321.5600000005
,"20,00",,"20,00",,Virement,,MR,,-2286321.5600000005
,"150,00",,"150,00",,Virement,,MR,,-2301321.5600000005
,"18,50",,"18,50",,Virement,,MR,,-2303171.5600000005
,"33,93",,"33,93",,Virement,,MR,,-2306564.5600000005
,"56,00",,"56,00",,Virement,,MR,,-2312164.5600000005
,"45,98",,"45,98",,Virement,,MR,,-2316762.5600000005
,"57,00",,"57,00",,Virement,,MR,,-2322462.5600000005
,"8,70",,"8,70",,Virement,,MR,,-2323332.5600000005
,"17,85",,"17,85",,Virement,,MR,,-2325117.5600000005
,"516,38",,"516,38",,Virement,,MR,,-2376755.5600000005
,"100,00",,"100,00",,Virement,,MR,,-2386755.5600000005
,"10,90",,"10,90",,Virement,,MR,,-2387845.5600000005
,"38,79",,"38,79",,Virement,,MR,,-2391724.5600000005
,"20,00",,"20,00",,Virement,,MR,,-2393724.5600000005
,3,,3,,Virement,,MR,,-2393727.5600000005
,4,,4,,Virement,,MR,,-2393731.5600000005
01/02/2022,97,,97,,Unknown,,Crédit,SOCIETE GENERALE RELEVÉ DE COMPTE,-97.0
28/02/2022,01,,01,,Unknown,,Crédit,O,-98.0
28/02/2022,02,,02,,Unknown,,Crédit,Page 2/2 Date Valeur,-100.0
28/02/2022,28,,28,,Unknown,,Crédit,CARTE,-128.0
28/02/2022,02,,02,,Unknown,,Crédit,TOTAUX DES MOUVEMENTS,-130.0
28/02/2022,2,,2,,Unknown,,Crédit,SOLDE AU,-132.0
01/09/2021,2,,2,,Unknown,,Crédit,Opération exonéree de commisslon,-134.0
,2,,2,,Unknown,,Crédit,Résolution,-136.0
,28,,28,,Unknown,,Crédit,PROGRAMME DE FIDÉLITÉ,-164.0
,02,,02,,Unknown,,Crédit,CB Visa Gold Business,-166.0
,28,,28,,Unknown,,Crédit,Jazz Pro,-194.0
,02,,02,,Unknown,,Crédit,CB Visa Gold Business,-196.0
,25,,25,,Unknown,,Crédit,Jazz Pro,-221.0
,02,,02,,Unknown,,Crédit,RCS,-223.0
,"18,00",,"18,00",,Unknown,,Crédit,Paris,-2023.0
,"2.136,97",,"2.136,97",,Unknown,,Crédit,,-2025.13697
,"10,28",,"10,28",,Unknown,,Crédit,,-3053.13697
,28,,28,,Unknown,,Crédit,,-3081.13697
,02,,02,,Unknown,,Crédit,,-3083.13697
,"4.657,41",,"4.657,41",,Unknown,,Crédit,,-3087.79438
,28,,28,,Unknown,,Crédit,,-3115.79438
,02,,02,,Unknown,,Crédit,,-3117.79438
,"2 710,55",,"2 710,55",,Unknown,,Crédit,,-274172.79438
,01,,01,,Unknown,,Crédit,,-274173.79438
,09,,09,,Unknown,,Crédit,,-274182.79438
,15 000,,15 000,,Unknown,,Crédit,,-289182.79438
,12,,12,,Unknown,,Crédit,,-289194.79438
,35,,35,,Unknown,,Crédit,,-289229.79438
,15 000,,15 000,,Unknown,,Crédit,,-304229.79438
,12,,12,,Unknown,,Crédit,,-304241.79438
,35,,35,,Unknown,,Crédit,,-304276.79438
,7 500,,7 500,,Unknown,,Crédit,,-311776.79438
,12,,12,,Unknown,,Crédit,,-311788.79438
,25,,25,,Unknown,,Crédit,,-311813.79438
,1 552 120 222,,1 552 120 222,,Unknown,,Crédit,,-1552432035.79438
,"1 046 405 540,00",,"1 046 405 540,00",,Unknown,,Crédit,,-106192986035.79437
,002,,002,,Unknown,,Crédit,,-106192986037.79437
,002,,002,,Unknown,,Crédit,,-106192986039.79437
01/01/2022,97,,97,,POS,,Appli Pro,SOCIETE GENERALE RELEVÉ DE COMPTE,-97.0
31/01/2022,01,,01,,POS,,Appli Pro,Page 1/2 VOS CONTACTS Votre Banque,-98.0
31/12/2021,01,,01,,POS,,Appli Pro,Distance,-99.0
05/01/2022,31,,31,,POS,,Appli Pro,internet,-130.0
05/01/2022,01,,01,,POS,,Appli Pro,professlonnels .socletegenerale,-131.0
06/01/2022,1,,1,,POS,,Appli Pro,"0,3o€/min prix",-132.0
05/01/2022,1,,1,,POS,,Appli Pro,STE GENEV,-133.0
10/01/2022,2,,2,,POS,,Appli Pro,STE GENEVIEVE DES BOIS,-135.0
10/01/2022,0,,0,,POS,,Appli Pro,dylan barbanchon@socgen com,-135.0
18/01/2022,01 60,,01 60,,POS,,Appli Pro,P5I RELEVÉ DES OPÉRATIONS Date Valeur,-295.0
17/01/2022,16 05,,16 05,,POS,,Appli Pro,CARTE X8155,-1900.0
18/01/2022,48,,48,,POS,,Appli Pro,SC-TAMIL NADU,-1948.0
17/01/2022,01 69,,01 69,,POS,,Appli Pro,QUIETIS PRO,-2117.0
31/01/2022,51 30,,51 30,,POS,,Appli Pro,NT,-7247.0
31/01/2022,83,,83,,POS,,Appli Pro,EUR,-7330.0
31/01/2022,75,,75,,POS,,Appli Pro,CARTE X8155 RETRAIT,-7405.0
31/01/2022,15,,15,,POS,,Appli Pro,BANQUE POSTALE,-7420.0
31/01/2022,01 60,,01 60,,POS,,Appli Pro,NT,-7580.0
01/03/2020,16 87,,16 87,,POS,,Appli Pro,EUR TVA,-9267.0
,75,,75,,POS,,Appli Pro,EUR,-9342.0
,31,,31,,POS,,Appli Pro,NT,-9373.0
,12,,12,,POS,,Appli Pro,EUR 31/01/2022 | 31/01/2022,-9385.0
,05,,05,,POS,,Appli Pro,RETRAIT,-9390.0
,01,,01,,POS,,Appli Pro,BANQUE POSTALE,-9391.0
,05,,05,,POS,,Appli Pro,TOTAUX DES MOUVEMENTS,-9396.0
,01,,01,,POS,,Appli Pro,SOLDE AU 31/01/2022,-9397.0
,04,,04,,POS,,Appli Pro,Opération,-9401.0
,01,,01,,POS,,Appli Pro,Résolution,-9402.0
,06,,06,,POS,,Appli Pro,Paris,-9408.0
,01,,01,,POS,,Appli Pro,clientele@socgen com 3 Le Mediateur,-9409.0
,05,,05,,POS,,Appli Pro,Charte de la Mediation,-9414.0
,01,,01,,POS,,Appli Pro,Le Méediateur,-9415.0
,25,,25,,POS,,Appli Pro,Valmy,-9440.0
,01,,01,,POS,,Appli Pro,Paris,-9441.0
,01,,01,,POS,,Appli Pro,Ir,-9442.0
,22,,22,,POS,,Appli Pro,Médiateur,-9464.0
,31,,31,,POS,,Appli Pro,Sociele Genéral,-9495.0
,12,,12,,POS,,Appli Pro,RCS Pais SA,-9507.0
,22,,22,,POS,,Appli Pro,Eur g8,-9529.0
,"46,50",,"46,50",,POS,,Appli Pro,Paris,-14179.0
,10,,10,,POS,,Appli Pro,,-14189.0
,01,,01,,POS,,Appli Pro,,-14190.0
,10,,10,,POS,,Appli Pro,,-14200.0
,01,,01,,POS,,Appli Pro,,-14201.0
,07,,07,,POS,,Appli Pro,,-14208.0
,01,,01,,POS,,Appli Pro,,-14209.0
,18,,18,,POS,,Appli Pro,,-14227.0
,01,,01,,POS,,Appli Pro,,-14228.0
,17,,17,,POS,,Appli Pro,,-14245.0
,01,,01,,POS,,Appli Pro,,-14246.0
,25,,25,,POS,,Appli Pro,,-14271.0
,"7,13",,"7,13",,POS,,Appli Pro,,-14984.0
,"2,62",,"2,62",,POS,,Appli Pro,,-15246.0
,"20,00",,"20,00",,POS,,Appli Pro,,-17246.0
,"0,53",,"0,53",,POS,,Appli Pro,,-17299.0
,18,,18,,POS,,Appli Pro,,-17317.0
,01,,01,,POS,,Appli Pro,,-17318.0
,17,,17,,POS,,Appli Pro,,-17335.0
,01,,01,,POS,,Appli Pro,,-17336.0
,"28,57",,"28,57",,POS,,Appli Pro,,-20193.0
,"10,43",,"10,43",,POS,,Appli Pro,,-21236.0
,"20,009",,"20,009",,POS,,Appli Pro,,-41245.0
,"2,09",,"2,09",,POS,,Appli Pro,,-41454.0
,31,,31,,POS,,Appli Pro,,-41485.0
,01,,01,,POS,,Appli Pro,,-41486.0
,31,,31,,POS,,Appli Pro,,-41517.0
,01,,01,,POS,,Appli Pro,,-41518.0
,29,,29,,POS,,Appli Pro,,-41547.0
,01,,01,,POS,,Appli Pro,,-41548.0
,31,,31,,POS,,Appli Pro,,-41579.0
,01,,01,,POS,,Appli Pro,,-41580.0
,31,,31,,POS,,Appli Pro,,-41611.0
,01,,01,,POS,,Appli Pro,,-41612.0
,29,,29,,POS,,Appli Pro,,-41641.0
,01,,01,,POS,,Appli Pro,,-41642.0
,"7.538,36",,"7.538,36",,POS,,Appli Pro,,-41649.53836
,"14,00",,"14,00",,POS,,Appli Pro,,-43049.53836
,"46,50",,"46,50",,POS,,Appli Pro,,-47699.53836
,"300,00",,"300,00",,POS,,Appli Pro,,-77699.53836
,"10,28",,"10,28",,POS,,Appli Pro,,-78727.53836
,"41,09",,"41,09",,POS,,Appli Pro,,-82836.53836
,"162,95",,"162,95",,POS,,Appli Pro,,-99131.53836
,"200,00",,"200,00",,POS,,Appli Pro,,-119131.53836
,"764,54",,"764,54",,POS,,Appli Pro,,-195585.53836
,"10,28",,"10,28",,POS,,Appli Pro,,-196613.53836
,31,,31,,POS,,Appli Pro,,-196644.53836
,01,,01,,POS,,Appli Pro,,-196645.53836
,"6.784,10",,"6.784,10",,POS,,Appli Pro,,-196652.32246
,33,,33,,POS,,Appli Pro,,-196685.32246
,76 77,,76 77,,POS,,Appli Pro,,-204362.32246
,01,,01,,POS,,Appli Pro,,-204363.32246
,03,,03,,POS,,Appli Pro,,-204366.32246
,2,,2,,POS,,Appli Pro,,-204368.32246
,18,,18,,POS,,Appli Pro,,-204386.32246
,3,,3,,POS,,Appli Pro,,-204389.32246
,17,,17,,POS,,Appli Pro,,-204406.32246
,7,,7,,POS,,Appli Pro,,-204413.32246
,90,,90,,POS,,Appli Pro,,-204503.32246
,552 120 222,,552 120 222,,POS,,Appli Pro,,-552324725.32246
,"066 714 367,50",,"066 714 367,50",,POS,,Appli Pro,,-7223761475.32246
,29,,29,,POS,,Appli Pro,,-7223761504.32246
,1,,1,,POS,,Appli Pro,,-7223761505.32246
,001,,001,,POS,,Appli Pro,,-7223761506.32246
,002,,002,,POS,,Appli Pro,,-7223761508.32246
01/05/2020,92,,92,,Unknown,,NAIS BEAUTE 15,SOCIETE GENERALE RELEVÉ DE COMPTE,-92.0
30/05/2020,01,,01,,Unknown,,NAIS BEAUTE 15,Page 1/4 VOS CONTACTS Votre Banque,-93.0
30/04/2020,05,,05,,Unknown,,NAIS BEAUTE 15,VILLENEUVE ST-GEORGES,-98.0
05/05/2020,30,,30,,Unknown,,NAIS BEAUTE 15,NE VAUT,-128.0
05/05/2020,05,,05,,Unknown,,NAIS BEAUTE 15,FACTURE P61,-133.0
15-03-2018,5,,5,,Unknown,,NAIS BEAUTE 15,opération SOLDE,-138.0
06/05/2020,1,,1,,Unknown,,NAIS BEAUTE 15,PRELEVEMENT EUROPEEN,-139.0
30/04/2020,4,,4,,Unknown,,NAIS BEAUTE 15,SOFTAVERA ID,-143.0
07/05/2020,0,,0,,Unknown,,NAIS BEAUTE 15,FR58ZZZ673989,-143.0
07/05/2020,15,,15,,Unknown,,NAIS BEAUTE 15,SDD,-158.0
07/05/2020,01 45,,01 45,,Unknown,,NAIS BEAUTE 15,FINT,-303.0
07/05/2020,10 10,,10 10,,Unknown,,NAIS BEAUTE 15,TAUX CONVENTIONNEL A,-1313.0
07/05/2020,10,,10,,Unknown,,NAIS BEAUTE 15,DATE DARRETE,-1323.0
07/05/2020,01 43,,01 43,,Unknown,,NAIS BEAUTE 15,CARTE,-1466.0
11/05/2020,89 87,,89 87,,Unknown,,NAIS BEAUTE 15,SG,-10453.0
11/05/2020,62,,62,,Unknown,,NAIS BEAUTE 15,LEBLANC MESNIL,-10515.0
12/05/2020,30,,30,,Unknown,,NAIS BEAUTE 15,CARTE XS999,-10545.0
12/05/2020,04,,04,,Unknown,,NAIS BEAUTE 15,SG,-10549.0
01/10/2015,05,,05,,Unknown,,NAIS BEAUTE 15,LE BLANC,-10554.0
,05,,05,,Unknown,,NAIS BEAUTE 15,MESNIL,-10559.0
,05,,05,,Unknown,,NAIS BEAUTE 15,PRELEVEMENT EUROPEEN 3618340896,-10564.0
,05,,05,,Unknown,,NAIS BEAUTE 15,Free Telecom ID,-10569.0
,15,,15,,Unknown,,NAIS BEAUTE 15,REF FHO 943138236,-10584.0
,03,,03,,Unknown,,NAIS BEAUTE 15,PRELEVEMENT,-10587.0
,06,,06,,Unknown,,NAIS BEAUTE 15,"Crédit 2,47",-10593.0
,05,,05,,Unknown,,NAIS BEAUTE 15,CT3883641801,-10598.0
,30,,30,,Unknown,,NAIS BEAUTE 15,"OOE COM 3,19E 322,81 suito",-10628.0
,04,,04,,Unknown,,NAIS BEAUTE 15,Insatisfaction Ou,-10632.0
,30,,30,,Unknown,,NAIS BEAUTE 15,YOUs pouvoz,-10662.0
,04,,04,,Unknown,,NAIS BEAUTE 15,Lagonce,-10666.0
,20,,20,,Unknown,,NAIS BEAUTE 15,Pans cedex 18 Tel 0142143169,-10686.0
,"2,21",,"2,21",,Unknown,,NAIS BEAUTE 15,Mediatour,-10907.0
,"0,26",,"0,26",,Unknown,,NAIS BEAUTE 15,Charte de la Mediation Societe Generale,-10933.0
,9,,9,,Unknown,,NAIS BEAUTE 15,Le Mediateur aupres de Societe Generale,-10942.0
,0,,0,,Unknown,,NAIS BEAUTE 15,Valmy 92987,-10942.0
,10,,10,,Unknown,,NAIS BEAUTE 15,Internet du Mediateur WW mediateur societegenerale,-10952.0
,0,,0,,Unknown,,NAIS BEAUTE 15,Mediateur,-10952.0
,07,,07,,Unknown,,NAIS BEAUTE 15,Sogete Geneale,-10959.0
,05,,05,,Unknown,,NAIS BEAUTE 15,Pans S ^gucaotaloe,-10964.0
,07,,07,,Unknown,,NAIS BEAUTE 15,S0e4 Scoe Soo,-10971.0
,05,,05,,Unknown,,NAIS BEAUTE 15,,-10976.0
,06,,06,,Unknown,,NAIS BEAUTE 15,,-10982.0
,05,,05,,Unknown,,NAIS BEAUTE 15,,-10987.0
,07,,07,,Unknown,,NAIS BEAUTE 15,,-10994.0
,05,,05,,Unknown,,NAIS BEAUTE 15,,-10999.0
,07,,07,,Unknown,,NAIS BEAUTE 15,,-11006.0
,05,,05,,Unknown,,NAIS BEAUTE 15,,-11011.0
,06,,06,,Unknown,,NAIS BEAUTE 15,,-11017.0
,05,,05,,Unknown,,NAIS BEAUTE 15,,-11022.0
,07,,07,,Unknown,,NAIS BEAUTE 15,,-11029.0
,05,,05,,Unknown,,NAIS BEAUTE 15,,-11034.0
,07,,07,,Unknown,,NAIS BEAUTE 15,,-11041.0
,05,,05,,Unknown,,NAIS BEAUTE 15,,-11046.0
,11,,11,,Unknown,,NAIS BEAUTE 15,,-11057.0
,05,,05,,Unknown,,NAIS BEAUTE 15,,-11062.0
,11,,11,,Unknown,,NAIS BEAUTE 15,,-11073.0
,05,,05,,Unknown,,NAIS BEAUTE 15,,-11078.0
,"436,52",,"436,52",,Unknown,,NAIS BEAUTE 15,,-54730.0
,"23,88",,"23,88",,Unknown,,NAIS BEAUTE 15,,-57118.0
,"2,47",,"2,47",,Unknown,,NAIS BEAUTE 15,,-57365.0
,"10,00",,"10,00",,Unknown,,NAIS BEAUTE 15,,-58365.0
,"50,00",,"50,00",,Unknown,,NAIS BEAUTE 15,,-63365.0
,"39,99",,"39,99",,Unknown,,NAIS BEAUTE 15,,-67364.0
,"138,00",,"138,00",,Unknown,,NAIS BEAUTE 15,,-81164.0
,12,,12,,Unknown,,NAIS BEAUTE 15,,-81176.0
,05,,05,,Unknown,,NAIS BEAUTE 15,,-81181.0
,12,,12,,Unknown,,NAIS BEAUTE 15,,-81193.0
,05,,05,,Unknown,,NAIS BEAUTE 15,,-81198.0
,12,,12,,Unknown,,NAIS BEAUTE 15,,-81210.0
,05,,05,,Unknown,,NAIS BEAUTE 15,,-81215.0
,326,,326,,Unknown,,NAIS BEAUTE 15,,-81541.0
,3,,3,,Unknown,,NAIS BEAUTE 15,,-81544.0
,"322,81",,"322,81",,Unknown,,NAIS BEAUTE 15,,-113825.0
,2,,2,,Unknown,,NAIS BEAUTE 15,,-113827.0
,33,,33,,Unknown,,NAIS BEAUTE 15,,-113860.0
,76 77,,76 77,,Unknown,,NAIS BEAUTE 15,,-121537.0
,01,,01,,Unknown,,NAIS BEAUTE 15,,-121538.0
,10,,10,,Unknown,,NAIS BEAUTE 15,,-121548.0
,18,,18,,Unknown,,NAIS BEAUTE 15,,-121566.0
,17,,17,,Unknown,,NAIS BEAUTE 15,,-121583.0
,90,,90,,Unknown,,NAIS BEAUTE 15,,-121673.0
,552 120 222,,552 120 222,,Unknown,,NAIS BEAUTE 15,,-552241895.0
,066,,066,,Unknown,,NAIS BEAUTE 15,,-552241961.0
,29,,29,,Unknown,,NAIS BEAUTE 15,,-552241990.0
,1,,1,,Unknown,,NAIS BEAUTE 15,,-552241991.0
30/11/2021,,10,,,Debit,,ReLEVE N' 10 AU 30/11/2021,BANQUE POPULAIRE #X BOURGOGNE,10.0
30/11/2021,,30,,,Debit,,ReLEVE N' 10 AU 30/11/2021,BiMATOO,40.0
01/11/2021,,11,,,Debit,,ReLEVE N' 10 AU 30/11/2021,PROMOGROS1021 VOTRE COMPTE,51.0
08/11/2021,,0,,,Debit,,ReLEVE N' 10 AU 30/11/2021,DaTE DETAIL DES VIREMENTS,51.0
08/11/2021,,11,,,Debit,,ReLEVE N' 10 AU 30/11/2021,PiCKUP,62.0
15/11/2021,,264 00,,,Debit,,ReLEVE N' 10 AU 30/11/2021,Activ Pickup Sept2o2,26462.0
18/11/2021,,10,,,Debit,,ReLEVE N' 10 AU 30/11/2021,Stichting Custooian Uber PaYMEnTS,26472.0
22/11/2021,,30,,,Debit,,ReLEVE N' 10 AU 30/11/2021,Poe,26502.0
29/11/2021,,11,,,Debit,,ReLEVE N' 10 AU 30/11/2021,Custodian Uber PaYmenTs LEBF93053E260238,26513.0
,,01,,,Debit,,ReLEVE N' 10 AU 30/11/2021,SvCS 006,26514.0
,,11,,,Debit,,ReLEVE N' 10 AU 30/11/2021,ASEDOOviRAZ8Q,26525.0
,,008,,,Debit,,ReLEVE N' 10 AU 30/11/2021,Zeolzetoibouosv,26533.0
,,08,,,Debit,,ReLEVE N' 10 AU 30/11/2021,Custodian Uber PaYMEnTS,26541.0
,,11,,,Debit,,ReLEVE N' 10 AU 30/11/2021,SVCS Do8,26552.0
,,523 70,,,Debit,,ReLEVE N' 10 AU 30/11/2021,StiChTING Custodian Uber PAYMENTS,78922.0
,,108 66,,,Debit,,ReLEVE N' 10 AU 30/11/2021,Poe,89788.0
,,08,,,Debit,,ReLEVE N' 10 AU 30/11/2021,Kukwov7svjgFPe,89796.0
,,11,,,Debit,,ReLEVE N' 10 AU 30/11/2021,Darls tertes enquou Rcgodezvous,89807.0
,,008,,,Debit,,ReLEVE N' 10 AU 30/11/2021,tormulare aintormaton communcue,89815.0
,,15,,,Debit,,ReLEVE N' 10 AU 30/11/2021,Oemande,89830.0
,,11,,,Debit,,ReLEVE N' 10 AU 30/11/2021,voverconseder Concemnant,89841.0
,,006,,,Debit,,ReLEVE N' 10 AU 30/11/2021,Asle Livrel de Developpement Durable,89847.0
,,594 16,,,Debit,,ReLEVE N' 10 AU 30/11/2021,Solidaire,149263.0
,,600 26,,,Debit,,ReLEVE N' 10 AU 30/11/2021,Qarantis partetl A,209289.0
,,2,,,Debit,,ReLEVE N' 10 AU 30/11/2021,Banquc,209291.0
,,18,,,Debit,,ReLEVE N' 10 AU 30/11/2021,Bourgogne,209309.0
,,11,,,Debit,,ReLEVE N' 10 AU 30/11/2021,Franche-Comte,209320.0
,,10,,,Debit,,ReLEVE N' 10 AU 30/11/2021,PagE,209330.0
,,84 22,,,Debit,,ReLEVE N' 10 AU 30/11/2021,DoUagoc,217752.0
,,11,,,Debit,,ReLEVE N' 10 AU 30/11/2021,Dion CoorVaeozVAi,217763.0
,,29,,,Debit,,ReLEVE N' 10 AU 30/11/2021,Sioe Soce Ba0,217792.0
,,11,,,Debit,,ReLEVE N' 10 AU 30/11/2021,CcP Dion,217803.0
,,008,,,Debit,,ReLEVE N' 10 AU 30/11/2021,,217811.0
,,84 00,,,Debit,,ReLEVE N' 10 AU 30/11/2021,,226211.0
,,356 41,,,Debit,,ReLEVE N' 10 AU 30/11/2021,,261852.0
,,"223,06",,,Debit,,ReLEVE N' 10 AU 30/11/2021,,284158.0
,,7,,,Debit,,ReLEVE N' 10 AU 30/11/2021,,284165.0
,,80,,,Debit,,ReLEVE N' 10 AU 30/11/2021,,284245.0
,,82 210,,,Debit,,ReLEVE N' 10 AU 30/11/2021,,366455.0
,,601,,,Debit,,ReLEVE N' 10 AU 30/11/2021,,367056.0
,,029 504,,,Debit,,ReLEVE N' 10 AU 30/11/2021,,396560.0
,,16,,,Debit,,ReLEVE N' 10 AU 30/11/2021,,396576.0
31/12/2021,,06,,,Debit,,Revise C8,VOTRE COMPTE COURANT N' 02421381795 Oaie CovpTA,6.0
,,12,,,Debit,,Revise C8,Remise C8,18.0
,,228,,,Debit,,Revise C8,BRUT 228,246.0
,,0,,,Debit,,Revise C8,Revise C8 5072120015,246.0
,,06,,,Debit,,Revise C8,Cou 0 Q6 N8000s,252.0
,,12,,,Debit,,Revise C8,BRUT 20,264.0
,,23,,,Debit,,Revise C8,Cou,287.0
,,0,,,Debit,,Revise C8,N80026 16337,287.0
,,06,,,Debit,,Revise C8,C8 5072121012,293.0
,,12,,,Debit,,Revise C8,Remise C8 5072120015,305.0
,,20 206,,,Debit,,Revise C8,Remise C8 5072121012,20511.0
,,06,,,Debit,,Revise C8,N80o33,20517.0
,,12,,,Debit,,Revise C8,Evi STICHTING CUSTODIAN,20529.0
,,200 026,,,Debit,,Revise C8,VetRo,220555.0
,,06,,,Debit,,Revise C8,PvSI,220561.0
,,12,,,Debit,,Revise C8,CoNSEIL Seavcedecenare,220573.0
,,0,,,Debit,,Revise C8,Revise C8 5072120015,220573.0
,,06,,,Debit,,Revise C8,C8 5072120015,220579.0
,,12,,,Debit,,Revise C8,C8 5072121012,220591.0
,,06,,,Debit,,Revise C8,Eurovirem SepA,220597.0
,,12,,,Debit,,Revise C8,C8 5072120015,220609.0
,,06,,,Debit,,Revise C8,Revise C8,220615.0
,,12,,,Debit,,Revise C8,Cov 0,220627.0
,,287,,,Debit,,Revise C8,Kannanaran,220914.0
,,06,,,Debit,,Revise C8,C8 5072121012,220920.0
,,12,,,Debit,,Revise C8,Revise C8 5072120015 BRUr,220932.0
,,205 06,,,Debit,,Revise C8,Cov 0 J96,241438.0
,,12,,,Debit,,Revise C8,N 11 AU 31/12/2021,241450.0
,,06,,,Debit,,Revise C8,CRedit,241456.0
,,12,,,Debit,,Revise C8,Daie Oaie,241468.0
,,07,,,Debit,,Revise C8,OAOOTWS,241475.0
,,12,,,Debit,,Revise C8,FMZ6CoF,241487.0
,,29,,,Debit,,Revise C8,FMYZ2i5,241516.0
,,0,,,Debit,,Revise C8,FoMPHUL,241516.0
,,07,,,Debit,,Revise C8,Franche-Comte,241523.0
,,12,,,Debit,,Revise C8,PAGE 2 Bout POPUARE BoUAGoCAE ach CovIE,241535.0
,,07,,,Debit,,Revise C8,Dion CoosW,241542.0
,,12,,,Debit,,Revise C8,Coa,241554.0
,,2 08,,,Debit,,Revise C8,Dio'0,241762.0
,,12,,,Debit,,Revise C8,Ccbofapoony,241774.0
,,08,,,Debit,,Revise C8,Covrng Acavence,241782.0
,,12,,,Debit,,Revise C8,,241794.0
,,06,,,Debit,,Revise C8,,241800.0
,,08,,,Debit,,Revise C8,,241808.0
,,12,,,Debit,,Revise C8,,241820.0
,,07,,,Debit,,Revise C8,,241827.0
,,08,,,Debit,,Revise C8,,241835.0
,,12,,,Debit,,Revise C8,,241847.0
,,6,,,Debit,,Revise C8,,241853.0
,,0 026,,,Debit,,Revise C8,,241879.0
,,08,,,Debit,,Revise C8,,241887.0
,,12,,,Debit,,Revise C8,,241899.0
,,106 706,,,Debit,,Revise C8,,348605.0
,,0,,,Debit,,Revise C8,,348605.0
,,08,,,Debit,,Revise C8,,348613.0
,,12,,,Debit,,Revise C8,,348625.0
,,09,,,Debit,,Revise C8,,348634.0
,,12,,,Debit,,Revise C8,,348646.0
,,0 166,,,Debit,,Revise C8,,348812.0
,,09,,,Debit,,Revise C8,,348821.0
,,12,,,Debit,,Revise C8,,348833.0
,,262 266,,,Debit,,Revise C8,,611099.0
,,10,,,Debit,,Revise C8,,611109.0
,,12,,,Debit,,Revise C8,,611121.0
,,121 376,,,Debit,,Revise C8,,732497.0
,,0,,,Debit,,Revise C8,,732497.0
,,11,,,Debit,,Revise C8,,732508.0
,,31,,,Debit,,Revise C8,,732539.0
,,12,,,Debit,,Revise C8,,732551.0
,,"228,67",,,Debit,,Revise C8,,755418.0
,,0,,,Debit,,Revise C8,,755418.0
,,06,,,Debit,,Revise C8,,755424.0
,,12 06,,,Debit,,Revise C8,,756630.0
,,12,,,Debit,,Revise C8,,756642.0
,,0,,,Debit,,Revise C8,,756642.0
,,06,,,Debit,,Revise C8,,756648.0
,,12 06,,,Debit,,Revise C8,,757854.0
,,12 23,,,Debit,,Revise C8,,759077.0
,,10,,,Debit,,Revise C8,,759087.0
,,06,,,Debit,,Revise C8,,759093.0
,,12 06,,,Debit,,Revise C8,,760299.0
,,12 20,,,Debit,,Revise C8,,761519.0
,,14,,,Debit,,Revise C8,,761533.0
,,06,,,Debit,,Revise C8,,761539.0
,,12 06,,,Debit,,Revise C8,,762745.0
,,12 206.92,,,Debit,,Revise C8,,774951.92
,,06,,,Debit,,Revise C8,,774957.92
,,12 06,,,Debit,,Revise C8,,776163.92
,,12,,,Debit,,Revise C8,,776175.92
,,5,,,Debit,,Revise C8,,776180.92
,,90,,,Debit,,Revise C8,,776270.92
,,06,,,Debit,,Revise C8,,776276.92
,,12 06,,,Debit,,Revise C8,,777482.92
,,"12 110,92",,,Debit,,Revise C8,,1988574.92
,,06,,,Debit,,Revise C8,,1988580.92
,,12 06,,,Debit,,Revise C8,,1989786.92
,,"12 883,62",,,Debit,,Revise C8,,3278148.92
,,06,,,Debit,,Revise C8,,3278154.92
,,12 06,,,Debit,,Revise C8,,3279360.92
,,12 287 11,,,Debit,,Revise C8,,4508071.92
,,06,,,Debit,,Revise C8,,4508077.92
,,12 06,,,Debit,,Revise C8,,4509283.92
,,"12 401,85",,,Debit,,Revise C8,,5749468.92
,,06,,,Debit,,Revise C8,,5749474.92
,,12,,,Debit,,Revise C8,,5749486.92
,,06,,,Debit,,Revise C8,,5749492.92
,,12 06,,,Debit,,Revise C8,,5750698.92
,,12 06,,,Debit,,Revise C8,,5751904.92
,,"12 840,15",,,Debit,,Revise C8,,7035919.92
,,264,,,Debit,,Revise C8,,7036183.92
,,06,,,Debit,,Revise C8,,7036189.92
,,12 06,,,Debit,,Revise C8,,7037395.92
,,12 39,,,Debit,,Revise C8,,7038634.92
,,23,,,Debit,,Revise C8,,7038657.92
,,07,,,Debit,,Revise C8,,7038664.92
,,12 07,,,Debit,,Revise C8,,7039871.92
,,12 14,,,Debit,,Revise C8,,7041085.92
,,75,,,Debit,,Revise C8,,7041160.92
,,07,,,Debit,,Revise C8,,7041167.92
,,12 07,,,Debit,,Revise C8,,7042374.92
,,12 134 34,,,Debit,,Revise C8,,8255808.92
,,08,,,Debit,,Revise C8,,8255816.92
,,12,,,Debit,,Revise C8,,8255828.92
,,07,,,Debit,,Revise C8,,8255835.92
,,12 08,,,Debit,,Revise C8,,8257043.92
,,"12 123,66",,,Debit,,Revise C8,,9469409.92
,,07,,,Debit,,Revise C8,,9469416.92
,,"12 114,67",,,Debit,,Revise C8,,10680883.92
,,07,,,Debit,,Revise C8,,10680890.92
,,12 07,,,Debit,,Revise C8,,10682097.92
,,12 21,,,Debit,,Revise C8,,10683318.92
,,54,,,Debit,,Revise C8,,10683372.92
,,08,,,Debit,,Revise C8,,10683380.92
,,12 08,,,Debit,,Revise C8,,10684588.92
,,12,,,Debit,,Revise C8,,10684600.92
,,"6,88",,,Debit,,Revise C8,,10685288.92
,,08,,,Debit,,Revise C8,,10685296.92
,,12 08,,,Debit,,Revise C8,,10686504.92
,,12 196.70,,,Debit,,Revise C8,,10698701.62
,,08,,,Debit,,Revise C8,,10698709.62
,,12 08,,,Debit,,Revise C8,,10699917.62
,,12,,,Debit,,Revise C8,,10699929.62
,,08,,,Debit,,Revise C8,,10699937.62
,,12 08,,,Debit,,Revise C8,,10701145.62
,,12 50,,,Debit,,Revise C8,,10702395.62
,,75,,,Debit,,Revise C8,,10702470.62
,,09,,,Debit,,Revise C8,,10702479.62
,,12 09,,,Debit,,Revise C8,,10703688.62
,,12 262 46,,,Debit,,Revise C8,,11929934.62
,,09,,,Debit,,Revise C8,,11929943.62
,,12 09,,,Debit,,Revise C8,,11931152.62
,,12 120,,,Debit,,Revise C8,,11943272.62
,,98,,,Debit,,Revise C8,,11943370.62
,,2,,,Debit,,Revise C8,,11943372.62
,,09 204,,,Debit,,Revise C8,,11952576.62
,,16 800,,,Debit,,Revise C8,,11969376.62
,,68 708,,,Debit,,Revise C8,,12038084.62
,,0,,,Debit,,Revise C8,,12038084.62
,,0 023,,,Debit,,Revise C8,,12038107.62
,,070 116,,,Debit,,Revise C8,,12108223.62
31/12/2021,,10,,,Debit,,VNAJ16303,BANQUE POPULAIRE BOURGOGNE FRANCHE,10.0
,,12,,,Debit,,VNAJ16303,Prlv SEPAAVIVA,22.0
,,10,,,Debit,,VNAJ16303,Remise,32.0
,,12,,,Debit,,VNAJ16303,C8 5072120015,44.0
,,11,,,Debit,,VNAJ16303,Cou 0,55.0
,,12,,,Debit,,VNAJ16303,Revise C8,67.0
,,17,,,Debit,,VNAJ16303,C8 5072120015,84.0
,,0,,,Debit,,VNAJ16303,Revise C8 5072121012 BRUr,84.0
,,11,,,Debit,,VNAJ16303,N800jo,95.0
,,12,,,Debit,,VNAJ16303,Remise C8 5072120015,107.0
,,13,,,Debit,,VNAJ16303,Boe Cou,120.0
,,12,,,Debit,,VNAJ16303,Revise C8,132.0
,,13,,,Debit,,VNAJ16303,N80oso,145.0
,,12,,,Debit,,VNAJ16303,Revise C8 5072120015 BRUr,157.0
,,315,,,Debit,,VNAJ16303,Cou 0 226 N8ooo2/197602,472.0
,,13,,,Debit,,VNAJ16303,Remise,485.0
,,12,,,Debit,,VNAJ16303,C8 5072120015,497.0
,,48,,,Debit,,VNAJ16303,N80oo,545.0
,,0 166,,,Debit,,VNAJ16303,Revise C8,711.0
,,13,,,Debit,,VNAJ16303,Revise C8 5072121012 BRUr,724.0
,,12,,,Debit,,VNAJ16303,Coy,736.0
,,338,,,Debit,,VNAJ16303,EviStiCHTING CUSTOOIAN,1074.0
,,13,,,Debit,,VNAJ16303,C8 270,1087.0
,,12,,,Debit,,VNAJ16303,Veiro OIVIRLAIO77,1099.0
,,68 506,,,Debit,,VNAJ16303,Cou 0,69605.0
,,0 226,,,Debit,,VNAJ16303,Depot AGEnCE,69831.0
,,13,,,Debit,,VNAJ16303,SouS Reservede Covpiage,69844.0
,,12,,,Debit,,VNAJ16303,Revise C8,69856.0
,,0 256,,,Debit,,VNAJ16303,BRUt,70112.0
,,13,,,Debit,,VNAJ16303,Cov 0oe,70125.0
,,12,,,Debit,,VNAJ16303,Mrne Qjnoisyle,70137.0
,,0 006,,,Debit,,VNAJ16303,RelVenoy,70143.0
,,13,,,Debit,,VNAJ16303,C8;4704,70156.0
,,12,,,Debit,,VNAJ16303,MARnE Qonoisyle,70168.0
,,102 456,,,Debit,,VNAJ16303,SARouxeluberomubervlliers,172624.0
,,006,,,Debit,,VNAJ16303,SARouxeL,172630.0
,,13,,,Debit,,VNAJ16303,"EvUnited PaRCEL ServiC U8956656020211101,2021-1130,112",172643.0
,,12,,,Debit,,VNAJ16303,C8 5072120015,172655.0
,,008,,,Debit,,VNAJ16303,COu,172663.0
,,212 13,,,Debit,,VNAJ16303,N8ooos171847,193876.0
,,12,,,Debit,,VNAJ16303,Valeur OAZZPSD,193888.0
,,270,,,Debit,,VNAJ16303,FYJOF?C,194158.0
,,13,,,Debit,,VNAJ16303,GO6YZCA,194171.0
,,12,,,Debit,,VNAJ16303,GO6YZCB,194183.0
,,14,,,Debit,,VNAJ16303,GO6YZCC,194197.0
,,12,,,Debit,,VNAJ16303,GO6YZCD,194209.0
,,0,,,Debit,,VNAJ16303,GO6YzCE,194209.0
,,14,,,Debit,,VNAJ16303,GO7GWYK,194223.0
,,12,,,Debit,,VNAJ16303,A,194235.0
,,14,,,Debit,,VNAJ16303,Banque Populaire,194249.0
,,12,,,Debit,,VNAJ16303,Franche-Comte,194261.0
,,14,,,Debit,,VNAJ16303,CoooNn Qiex IAnecor,194275.0
,,12,,,Debit,,VNAJ16303,Irenoli,194287.0
,,470,,,Debit,,VNAJ16303,Ccoal,194757.0
,,14,,,Debit,,VNAJ16303,Dpon,194771.0
,,12,,,Debit,,VNAJ16303,CCborRpcony,194783.0
,,14,,,Debit,,VNAJ16303,,194797.0
,,12,,,Debit,,VNAJ16303,,194809.0
,,14,,,Debit,,VNAJ16303,,194823.0
,,12,,,Debit,,VNAJ16303,,194835.0
,,14,,,Debit,,VNAJ16303,,194849.0
,,12,,,Debit,,VNAJ16303,,194861.0
,,470,,,Debit,,VNAJ16303,,195331.0
,,15,,,Debit,,VNAJ16303,,195346.0
,,12,,,Debit,,VNAJ16303,,195358.0
,,112,,,Debit,,VNAJ16303,,195470.0
,,15,,,Debit,,VNAJ16303,,195485.0
,,12,,,Debit,,VNAJ16303,,195497.0
,,20 866,,,Debit,,VNAJ16303,,216363.0
,,11,,,Debit,,VNAJ16303,,216374.0
,,31,,,Debit,,VNAJ16303,,216405.0
,,12,,,Debit,,VNAJ16303,,216417.0
,,67 09,,,Debit,,VNAJ16303,,223126.0
,,10,,,Debit,,VNAJ16303,,223136.0
,,12 10,,,Debit,,VNAJ16303,,224346.0
,,12,,,Debit,,VNAJ16303,,224358.0
,,10,,,Debit,,VNAJ16303,,224368.0
,,12 10,,,Debit,,VNAJ16303,,225578.0
,,"12 234,39",,,Debit,,VNAJ16303,,1449017.0
,,10,,,Debit,,VNAJ16303,,1449027.0
,,12 10,,,Debit,,VNAJ16303,,1450237.0
,,12 17,,,Debit,,VNAJ16303,,1451454.0
,,37,,,Debit,,VNAJ16303,,1451491.0
,,10,,,Debit,,VNAJ16303,,1451501.0
,,12 10,,,Debit,,VNAJ16303,,1452711.0
,,12 14,,,Debit,,VNAJ16303,,1453925.0
,,85,,,Debit,,VNAJ16303,,1454010.0
,,13,,,Debit,,VNAJ16303,,1454023.0
,,12 13,,,Debit,,VNAJ16303,,1455236.0
,,12 35,,,Debit,,VNAJ16303,,1456471.0
,,08,,,Debit,,VNAJ16303,,1456479.0
,,13,,,Debit,,VNAJ16303,,1456492.0
,,12 13,,,Debit,,VNAJ16303,,1457705.0
,,"12 315,19",,,Debit,,VNAJ16303,,2689224.0
,,13,,,Debit,,VNAJ16303,,2689237.0
,,12 13,,,Debit,,VNAJ16303,,2690450.0
,,12 48,,,Debit,,VNAJ16303,,2691698.0
,,64,,,Debit,,VNAJ16303,,2691762.0
,,0,,,Debit,,VNAJ16303,,2691762.0
,,13,,,Debit,,VNAJ16303,,2691775.0
,,12 13,,,Debit,,VNAJ16303,,2692988.0
,,"12 338,50",,,Debit,,VNAJ16303,,3926838.0
,,13,,,Debit,,VNAJ16303,,3926851.0
,,12 13,,,Debit,,VNAJ16303,,3928064.0
,,12 68,,,Debit,,VNAJ16303,,3929332.0
,,28,,,Debit,,VNAJ16303,,3929360.0
,,13,,,Debit,,VNAJ16303,,3929373.0
,,12 13,,,Debit,,VNAJ16303,,3930586.0
,,12 76,,,Debit,,VNAJ16303,,3931862.0
,,84,,,Debit,,VNAJ16303,,3931946.0
,,13,,,Debit,,VNAJ16303,,3931959.0
,,12 13,,,Debit,,VNAJ16303,,3933172.0
,,12,,,Debit,,VNAJ16303,,3933184.0
,,1 50,,,Debit,,VNAJ16303,,3933334.0
,,13,,,Debit,,VNAJ16303,,3933347.0
,,12 13,,,Debit,,VNAJ16303,,3934560.0
,,"12 192,45",,,Debit,,VNAJ16303,,5153805.0
,,13,,,Debit,,VNAJ16303,,5153818.0
,,12 13,,,Debit,,VNAJ16303,,5155031.0
,,"12 558,59",,,Debit,,VNAJ16303,,6410890.0
,,13,,,Debit,,VNAJ16303,,6410903.0
,,12,,,Debit,,VNAJ16303,,6410915.0
,,13,,,Debit,,VNAJ16303,,6410928.0
,,12,,,Debit,,VNAJ16303,,6410940.0
,,13,,,Debit,,VNAJ16303,,6410953.0
,,12 13,,,Debit,,VNAJ16303,,6412166.0
,,12 13,,,Debit,,VNAJ16303,,6413379.0
,,12 13,,,Debit,,VNAJ16303,,6414592.0
,,12 99,,,Debit,,VNAJ16303,,6415891.0
,,"66 204,43",,,Debit,,VNAJ16303,,13036334.0
,,24 27,,,Debit,,VNAJ16303,,13038761.0
,,14,,,Debit,,VNAJ16303,,13038775.0
,,12 14,,,Debit,,VNAJ16303,,13039989.0
,,12 600 00,,,Debit,,VNAJ16303,,14299989.0
,,14,,,Debit,,VNAJ16303,,14300003.0
,,12 14,,,Debit,,VNAJ16303,,14301217.0
,,"12 141,02",,,Debit,,VNAJ16303,,15515319.0
,,14,,,Debit,,VNAJ16303,,15515333.0
,,12,,,Debit,,VNAJ16303,,15515345.0
,,14,,,Debit,,VNAJ16303,,15515359.0
,,12,,,Debit,,VNAJ16303,,15515371.0
,,14,,,Debit,,VNAJ16303,,15515385.0
,,12,,,Debit,,VNAJ16303,,15515397.0
,,14,,,Debit,,VNAJ16303,,15515411.0
,,12,,,Debit,,VNAJ16303,,15515423.0
,,14,,,Debit,,VNAJ16303,,15515437.0
,,12,,,Debit,,VNAJ16303,,15515449.0
,,15,,,Debit,,VNAJ16303,,15515464.0
,,12 14,,,Debit,,VNAJ16303,,15516678.0
,,12 14,,,Debit,,VNAJ16303,,15517892.0
,,12 14,,,Debit,,VNAJ16303,,15519106.0
,,12 14,,,Debit,,VNAJ16303,,15520320.0
,,12 14,,,Debit,,VNAJ16303,,15521534.0
,,12 15,,,Debit,,VNAJ16303,,15522749.0
,,12 12,,,Debit,,VNAJ16303,,15523961.0
,,29 15,,,Debit,,VNAJ16303,,15526876.0
,,02 22,,,Debit,,VNAJ16303,,15527098.0
,,"00 167,70",,,Debit,,VNAJ16303,,15543868.0
,,"763,86",,,Debit,,VNAJ16303,,15620254.0
,,"112,80",,,Debit,,VNAJ16303,,15631534.0
,,14,,,Debit,,VNAJ16303,,15631548.0
,,12 14,,,Debit,,VNAJ16303,,15632762.0
,,12 28,,,Debit,,VNAJ16303,,15633990.0
,,79,,,Debit,,VNAJ16303,,15634069.0
,,3,,,Debit,,VNAJ16303,,15634072.0
,,0,,,Debit,,VNAJ16303,,15634072.0
,,80,,,Debit,,VNAJ16303,,15634152.0
,,0 023,,,Debit,,VNAJ16303,,15634175.0
,,816,,,Debit,,VNAJ16303,,15634991.0
03/01/2021,,40,,,Debit,,EPI SERVICE PRIMEUR,Titulaire(s,40.0
03/01/2021,,1,,,Debit,,EPI SERVICE PRIMEUR,Page 516 Crédit Mutuel,41.0
03/01/2021,,516,,,Debit,,EPI SERVICE PRIMEUR,Date Date de,557.0
04/01/2021,,04,,,Debit,,EPI SERVICE PRIMEUR,COMCARTES,561.0
04/01/2021,,01 04,,,Debit,,EPI SERVICE PRIMEUR,COMCARTES,665.0
04/01/2021,,01 04,,,Debit,,EPI SERVICE PRIMEUR,COM,769.0
05/01/2021,,01 04,,,Debit,,EPI SERVICE PRIMEUR,REMISE,873.0
04/01/2021,,01 04,,,Debit,,EPI SERVICE PRIMEUR,TPV N 0386405,977.0
04/01/2021,,01 03,,,Debit,,EPI SERVICE PRIMEUR,COMCARTES,1080.0
05/12/2020,,01,,,Debit,,EPI SERVICE PRIMEUR,COMCARTES,1081.0
05/01/2021,,64,,,Debit,,EPI SERVICE PRIMEUR,TPV N 0386405,1145.0
05/01/2021,,03,,,Debit,,EPI SERVICE PRIMEUR,TPV N,1148.0
05/01/2021,,01,,,Debit,,EPI SERVICE PRIMEUR,CARTE,1149.0
05/01/2021,,64,,,Debit,,EPI SERVICE PRIMEUR,SUPER U 35 RENNES,1213.0
05/01/2021,,03,,,Debit,,EPI SERVICE PRIMEUR,COMCARTES,1216.0
06/01/2021,,01,,,Debit,,EPI SERVICE PRIMEUR,COM,1217.0
06/01/2021,,01,,,Debit,,EPI SERVICE PRIMEUR,COM,1218.0
06/01/2021,,04,,,Debit,,EPI SERVICE PRIMEUR,COM,1222.0
06/01/2021,,01,,,Debit,,EPI SERVICE PRIMEUR,AUTOROUTES DU SUD DE LA FRANCE GLACP246730044741270,1223.0
06/01/2021,,04,,,Debit,,EPI SERVICE PRIMEUR,FR94ZZZOO7048,1227.0
06/01/2021,,01,,,Debit,,EPI SERVICE PRIMEUR,TPV N 0386405,1228.0
06/01/2021,,04,,,Debit,,EPI SERVICE PRIMEUR,TPV N 0386405,1232.0
06/01/2021,,01,,,Debit,,EPI SERVICE PRIMEUR,TPV N 0386405,1233.0
06/01/2021,,05,,,Debit,,EPI SERVICE PRIMEUR,TPV N,1238.0
06/01/2021,,01,,,Debit,,EPI SERVICE PRIMEUR,CARTE,1239.0
06/01/2021,,04,,,Debit,,EPI SERVICE PRIMEUR,CARTE,1243.0
07/01/2021,,01,,,Debit,,EPI SERVICE PRIMEUR,COMCARTES,1244.0
06/01/2021,,04,,,Debit,,EPI SERVICE PRIMEUR,COM,1248.0
06/01/2021,,01,,,Debit,,EPI SERVICE PRIMEUR,COM,1249.0
07/01/2021,,05,,,Debit,,EPI SERVICE PRIMEUR,COM,1254.0
07/01/2021,,12,,,Debit,,EPI SERVICE PRIMEUR,Suite AU VeRso,1266.0
07/01/2021,,05,,,Debit,,EPI SERVICE PRIMEUR,,1271.0
07/01/2021,,01,,,Debit,,EPI SERVICE PRIMEUR,,1272.0
07/01/2021,,01,,,Debit,,EPI SERVICE PRIMEUR,,1273.0
07/01/2021,,01,,,Debit,,EPI SERVICE PRIMEUR,,1274.0
,,05,,,Debit,,EPI SERVICE PRIMEUR,,1279.0
,,01,,,Debit,,EPI SERVICE PRIMEUR,,1280.0
,,64,,,Debit,,EPI SERVICE PRIMEUR,,1344.0
,,05,,,Debit,,EPI SERVICE PRIMEUR,,1349.0
,,01,,,Debit,,EPI SERVICE PRIMEUR,,1350.0
,,64,,,Debit,,EPI SERVICE PRIMEUR,,1414.0
,,05,,,Debit,,EPI SERVICE PRIMEUR,,1419.0
,,01,,,Debit,,EPI SERVICE PRIMEUR,,1420.0
,,05,,,Debit,,EPI SERVICE PRIMEUR,,1425.0
,,01,,,Debit,,EPI SERVICE PRIMEUR,,1426.0
,,06,,,Debit,,EPI SERVICE PRIMEUR,,1432.0
,,01,,,Debit,,EPI SERVICE PRIMEUR,,1433.0
,,06,,,Debit,,EPI SERVICE PRIMEUR,,1439.0
,,01,,,Debit,,EPI SERVICE PRIMEUR,,1440.0
,,06,,,Debit,,EPI SERVICE PRIMEUR,,1446.0
,,01,,,Debit,,EPI SERVICE PRIMEUR,,1447.0
,,05,,,Debit,,EPI SERVICE PRIMEUR,,1452.0
,,01,,,Debit,,EPI SERVICE PRIMEUR,,1453.0
,,35,,,Debit,,EPI SERVICE PRIMEUR,,1488.0
,,06,,,Debit,,EPI SERVICE PRIMEUR,,1494.0
,,01,,,Debit,,EPI SERVICE PRIMEUR,,1495.0
,,06,,,Debit,,EPI SERVICE PRIMEUR,,1501.0
,,01,,,Debit,,EPI SERVICE PRIMEUR,,1502.0
,,64,,,Debit,,EPI SERVICE PRIMEUR,,1566.0
,,06,,,Debit,,EPI SERVICE PRIMEUR,,1572.0
,,01,,,Debit,,EPI SERVICE PRIMEUR,,1573.0
,,01,,,Debit,,EPI SERVICE PRIMEUR,,1574.0
,,06,,,Debit,,EPI SERVICE PRIMEUR,,1580.0
,,01,,,Debit,,EPI SERVICE PRIMEUR,,1581.0
,,64,,,Debit,,EPI SERVICE PRIMEUR,,1645.0
,,06,,,Debit,,EPI SERVICE PRIMEUR,,1651.0
,,01,,,Debit,,EPI SERVICE PRIMEUR,,1652.0
,,01,,,Debit,,EPI SERVICE PRIMEUR,,1653.0
,,06,,,Debit,,EPI SERVICE PRIMEUR,,1659.0
,,01,,,Debit,,EPI SERVICE PRIMEUR,,1660.0
,,06,,,Debit,,EPI SERVICE PRIMEUR,,1666.0
,,01,,,Debit,,EPI SERVICE PRIMEUR,,1667.0
,,06,,,Debit,,EPI SERVICE PRIMEUR,,1673.0
,,01,,,Debit,,EPI SERVICE PRIMEUR,,1674.0
,,07,,,Debit,,EPI SERVICE PRIMEUR,,1681.0
,,01,,,Debit,,EPI SERVICE PRIMEUR,,1682.0
,,06,,,Debit,,EPI SERVICE PRIMEUR,,1688.0
,,01,,,Debit,,EPI SERVICE PRIMEUR,,1689.0
,,06,,,Debit,,EPI SERVICE PRIMEUR,,1695.0
,,01,,,Debit,,EPI SERVICE PRIMEUR,,1696.0
,,07,,,Debit,,EPI SERVICE PRIMEUR,,1703.0
,,01,,,Debit,,EPI SERVICE PRIMEUR,,1704.0
,,06,,,Debit,,EPI SERVICE PRIMEUR,,1710.0
,,01,,,Debit,,EPI SERVICE PRIMEUR,,1711.0
,,35,,,Debit,,EPI SERVICE PRIMEUR,,1746.0
,,07,,,Debit,,EPI SERVICE PRIMEUR,,1753.0
,,01,,,Debit,,EPI SERVICE PRIMEUR,,1754.0
,,06,,,Debit,,EPI SERVICE PRIMEUR,,1760.0
,,01,,,Debit,,EPI SERVICE PRIMEUR,,1761.0
,,75,,,Debit,,EPI SERVICE PRIMEUR,,1836.0
,,07,,,Debit,,EPI SERVICE PRIMEUR,,1843.0
,,01,,,Debit,,EPI SERVICE PRIMEUR,,1844.0
,,01,,,Debit,,EPI SERVICE PRIMEUR,,1845.0
,,07,,,Debit,,EPI SERVICE PRIMEUR,,1852.0
,,01,,,Debit,,EPI SERVICE PRIMEUR,,1853.0
,,64,,,Debit,,EPI SERVICE PRIMEUR,,1917.0
,,07,,,Debit,,EPI SERVICE PRIMEUR,,1924.0
,,01,,,Debit,,EPI SERVICE PRIMEUR,,1925.0
,,01,,,Debit,,EPI SERVICE PRIMEUR,,1926.0
,,07,,,Debit,,EPI SERVICE PRIMEUR,,1933.0
,,01,,,Debit,,EPI SERVICE PRIMEUR,,1934.0
,,64,,,Debit,,EPI SERVICE PRIMEUR,,1998.0
,,001,,,Debit,,EPI SERVICE PRIMEUR,,1999.0
,,"0,60",,,Debit,,EPI SERVICE PRIMEUR,,2059.0
,,0,,,Debit,,EPI SERVICE PRIMEUR,,2059.0
,,34 48,,,Debit,,EPI SERVICE PRIMEUR,,5507.0
,,"12 995,00",,,Debit,,EPI SERVICE PRIMEUR,,1305007.0
,,04,,,Debit,,EPI SERVICE PRIMEUR,,1305011.0
,,01 92,,,Debit,,EPI SERVICE PRIMEUR,,1305203.0
,,98 05,,,Debit,,EPI SERVICE PRIMEUR,,1315008.0
,,01 05,,,Debit,,EPI SERVICE PRIMEUR,,1315113.0
,,01 05,,,Debit,,EPI SERVICE PRIMEUR,,1315218.0
,,01 05,,,Debit,,EPI SERVICE PRIMEUR,,1315323.0
,,01 05,,,Debit,,EPI SERVICE PRIMEUR,,1315428.0
,,01 05,,,Debit,,EPI SERVICE PRIMEUR,,1315533.0
,,01 05,,,Debit,,EPI SERVICE PRIMEUR,,1315638.0
,,01 05,,,Debit,,EPI SERVICE PRIMEUR,,1315743.0
,,01,,,Debit,,EPI SERVICE PRIMEUR,,1315744.0
,,"5 380,00",,,Debit,,EPI SERVICE PRIMEUR,,1853744.0
,,"25,00",,,Debit,,EPI SERVICE PRIMEUR,,1856244.0
,,"72,40",,,Debit,,EPI SERVICE PRIMEUR,,1863484.0
,,"4 200,00",,,Debit,,EPI SERVICE PRIMEUR,,2283484.0
,,"29,50",,,Debit,,EPI SERVICE PRIMEUR,,2286434.0
,,0 31,,,Debit,,EPI SERVICE PRIMEUR,,2286465.0
,,"0,05",,,Debit,,EPI SERVICE PRIMEUR,,2286470.0
,,"329,51",,,Debit,,EPI SERVICE PRIMEUR,,2319421.0
,,05,,,Debit,,EPI SERVICE PRIMEUR,,2319426.0
,,"01 115,95",,,Debit,,EPI SERVICE PRIMEUR,,2431021.0
,,06,,,Debit,,EPI SERVICE PRIMEUR,,2431027.0
,,01 06,,,Debit,,EPI SERVICE PRIMEUR,,2431133.0
,,01 06,,,Debit,,EPI SERVICE PRIMEUR,,2431239.0
,,01 06,,,Debit,,EPI SERVICE PRIMEUR,,2431345.0
,,01 06,,,Debit,,EPI SERVICE PRIMEUR,,2431451.0
,,01 06,,,Debit,,EPI SERVICE PRIMEUR,,2431557.0
,,01 06,,,Debit,,EPI SERVICE PRIMEUR,,2431663.0
,,01 06,,,Debit,,EPI SERVICE PRIMEUR,,2431769.0
,,01 06,,,Debit,,EPI SERVICE PRIMEUR,,2431875.0
,,"01 230,00",,,Debit,,EPI SERVICE PRIMEUR,,2554875.0
,,"11,70",,,Debit,,EPI SERVICE PRIMEUR,,2556045.0
,,"219,24",,,Debit,,EPI SERVICE PRIMEUR,,2577969.0
,,"1,25",,,Debit,,EPI SERVICE PRIMEUR,,2578094.0
,,"0,02",,,Debit,,EPI SERVICE PRIMEUR,,2578096.0
,,"0,03",,,Debit,,EPI SERVICE PRIMEUR,,2578099.0
,,"0,57",,,Debit,,EPI SERVICE PRIMEUR,,2578156.0
,,0 47,,,Debit,,EPI SERVICE PRIMEUR,,2578203.0
,,1 00,,,Debit,,EPI SERVICE PRIMEUR,,2578303.0
,,07,,,Debit,,EPI SERVICE PRIMEUR,,2578310.0
,,01 07,,,Debit,,EPI SERVICE PRIMEUR,,2578417.0
,,01 07,,,Debit,,EPI SERVICE PRIMEUR,,2578524.0
,,01 07,,,Debit,,EPI SERVICE PRIMEUR,,2578631.0
,,01 07,,,Debit,,EPI SERVICE PRIMEUR,,2578738.0
,,01 07,,,Debit,,EPI SERVICE PRIMEUR,,2578845.0
,,01 07,,,Debit,,EPI SERVICE PRIMEUR,,2578952.0
,,01 07,,,Debit,,EPI SERVICE PRIMEUR,,2579059.0
,,01 07,,,Debit,,EPI SERVICE PRIMEUR,,2579166.0
,,01 07,,,Debit,,EPI SERVICE PRIMEUR,,2579273.0
,,01 07,,,Debit,,EPI SERVICE PRIMEUR,,2579380.0
,,01 21,,,Debit,,EPI SERVICE PRIMEUR,,2579501.0
,,"00 216,90",,,Debit,,EPI SERVICE PRIMEUR,,2601191.0
,,"17,30",,,Debit,,EPI SERVICE PRIMEUR,,2602921.0
,,"58,00",,,Debit,,EPI SERVICE PRIMEUR,,2608721.0
,,"8,00",,,Debit,,EPI SERVICE PRIMEUR,,2609521.0
,,1,,,Debit,,EPI SERVICE PRIMEUR,,2609522.0
,,0,,,Debit,,EPI SERVICE PRIMEUR,,2609522.0
,,1,,,Debit,,EPI SERVICE PRIMEUR,,2609523.0
,,"5 152,03",,,Debit,,EPI SERVICE PRIMEUR,,3124726.0
,,"35,00",,,Debit,,EPI SERVICE PRIMEUR,,3128226.0
,,"0,05",,,Debit,,EPI SERVICE PRIMEUR,,3128231.0
,,"0,91",,,Debit,,EPI SERVICE PRIMEUR,,3128322.0
,,"0,07",,,Debit,,EPI SERVICE PRIMEUR,,3128329.0
,,0 10,,,Debit,,EPI SERVICE PRIMEUR,,3128339.0
07/01/2021,,40,,,Unknown,,EPI SERVICE PRIMEUR,Titulaire(s,40.0
07/01/2021,,1,,,Unknown,,EPI SERVICE PRIMEUR,Page 616 Date Date,41.0
,,616,,,Unknown,,EPI SERVICE PRIMEUR,Operation Delont Cred,657.0
,,07,,,Unknown,,EPI SERVICE PRIMEUR,COM,664.0
,,01 07,,,Unknown,,EPI SERVICE PRIMEUR,COM,771.0
,,01 07,,,Unknown,,EPI SERVICE PRIMEUR,TOTAL DES OPÉRATIONS DU RELEVÉ,878.0
,,01,,,Unknown,,EPI SERVICE PRIMEUR,SOLDE,879.0
,,01,,,Unknown,,EPI SERVICE PRIMEUR,CRÉDITEUR AU 07 JANVIER,880.0
,,07,,,Unknown,,EPI SERVICE PRIMEUR,davas depots,887.0
,,01,,,Unknown,,EPI SERVICE PRIMEUR,FGDR,888.0
,,64,,,Unknown,,EPI SERVICE PRIMEUR,Credi Muuel,952.0
,,0 14,,,Unknown,,EPI SERVICE PRIMEUR,creda capial vanable,966.0
,,009,,,Unknown,,EPI SERVICE PRIMEUR,M ORIAS 07,975.0
,,19 233 86,,,Unknown,,EPI SERVICE PRIMEUR,Siege,1924361.0
,,"33 023,04",,,Unknown,,EPI SERVICE PRIMEUR,Releco Kerhuon Sren,5226665.0
,,07,,,Unknown,,EPI SERVICE PRIMEUR,RCS,5226672.0
,,"27 435,09",,,Unknown,,EPI SERVICE PRIMEUR,Elabussemnents Oe credi e apphcation,7970181.0
,,1,,,Unknown,,EPI SERVICE PRIMEUR,Qu Code monetare,7970182.0
,,4,,,Unknown,,EPI SERVICE PRIMEUR,hnancier,7970186.0
,,8,,,Unknown,,EPI SERVICE PRIMEUR,Reolementation Bancare,7970194.0
,,5,,,Unknown,,EPI SERVICE PRIMEUR,Millet,7970199.0
,,07 025 585,,,Unknown,,EPI SERVICE PRIMEUR,VOs depois,14995784.0
,,775 877 010,,,Unknown,,EPI SERVICE PRIMEUR,Uvque,790872794.0
,,312,,,Unknown,,EPI SERVICE PRIMEUR,Conservczle conhoenticuemen,790873106.0
,,90 05,,,Unknown,,EPI SERVICE PRIMEUR,Inlalion Oc Ouee,790882111.0
,,0,,,Unknown,,EPI SERVICE PRIMEUR,La bonne erecution dun contratetle tratement dune feclamation,790882111.0
,,0 800 00,,,Unknown,,EPI SERVICE PRIMEUR,Groupe Crede Muuel Nkea,790962111.0
,,30 92,,,Unknown,,EPI SERVICE PRIMEUR,Carse de CrediMuuel,790965203.0
,,,,,Unknown,,EPI SERVICE PRIMEUR,premernnerocueuin 0e lciconone,790965203.0
,,,,,Unknown,,EPI SERVICE PRIMEUR,Suae),790965203.0
,,,,,Unknown,,EPI SERVICE PRIMEUR,Brest,790965203.0
,,,,,Unknown,,EPI SERVICE PRIMEUR,Eman sugoeshionoemb,790965203.0
24/06/2021,40,,40,,Virement,,EPI SERVICE PRIMEUR,Titulaire(s,-40.0
24/06/2021,7,,7,,Virement,,EPI SERVICE PRIMEUR,Date Date de Valeur,-47.0
24/06/2021,6,,6,,Virement,,EPI SERVICE PRIMEUR,COM,-53.0
24/06/2021,10,,10,,Virement,,EPI SERVICE PRIMEUR,CARTES,-63.0
24/06/2021,24,,24,,Virement,,EPI SERVICE PRIMEUR,COM,-87.0
24/06/2021,06 24,,06 24,,Virement,,EPI SERVICE PRIMEUR,CARTES,-711.0
24/06/2021,06 24,,06 24,,Virement,,EPI SERVICE PRIMEUR,COM,-1335.0
24/06/2021,06 24,,06 24,,Virement,,EPI SERVICE PRIMEUR,CARTES 0386405,-1959.0
25/06/2021,06 24,,06 24,,Virement,,EPI SERVICE PRIMEUR,CHQ,-2583.0
24/06/2021,06 24,,06 24,,Virement,,EPI SERVICE PRIMEUR,REMISE,-3207.0
24/06/2021,06,,06,,Virement,,EPI SERVICE PRIMEUR,TPV,-3213.0
25/06/2021,01,,01,,Virement,,EPI SERVICE PRIMEUR,REMISE,-3214.0
25/06/2021,24,,24,,Virement,,EPI SERVICE PRIMEUR,TPV,-3238.0
25/06/2021,06,,06,,Virement,,EPI SERVICE PRIMEUR,REMISE,-3244.0
25/06/2021,64,,64,,Virement,,EPI SERVICE PRIMEUR,TPV,-3308.0
25/06/2021,24,,24,,Virement,,EPI SERVICE PRIMEUR,REMISE,-3332.0
25/06/2021,06,,06,,Virement,,EPI SERVICE PRIMEUR,TPV,-3338.0
25/06/2021,64,,64,,Virement,,EPI SERVICE PRIMEUR,REMISE,-3402.0
25/06/2021,24,,24,,Virement,,EPI SERVICE PRIMEUR,CARTE,-3426.0
25/06/2021,06,,06,,Virement,,EPI SERVICE PRIMEUR,FVIREMENT,-3432.0
25/06/2021,24,,24,,Virement,,EPI SERVICE PRIMEUR,CAS DUN VIREMENT,-3456.0
25/06/2021,06,,06,,Virement,,EPI SERVICE PRIMEUR,OCCASIONNEL,-3462.0
25/06/2021,24,,24,,Virement,,EPI SERVICE PRIMEUR,COM,-3486.0
28/06/2021,06,,06,,Virement,,EPI SERVICE PRIMEUR,CARTES,-3492.0
25/06/2021,24,,24,,Virement,,EPI SERVICE PRIMEUR,COM,-3516.0
25/06/2021,06,,06,,Virement,,EPI SERVICE PRIMEUR,CARTES,-3522.0
26/06/2021,24,,24,,Virement,,EPI SERVICE PRIMEUR,COM,-3546.0
26/06/2021,06,,06,,Virement,,EPI SERVICE PRIMEUR,CARTES 0386405,-3552.0
26/06/2021,25,,25,,Virement,,EPI SERVICE PRIMEUR,COM,-3577.0
26/06/2021,06,,06,,Virement,,EPI SERVICE PRIMEUR,CARTES,-3583.0
26/06/2021,24,,24,,Virement,,EPI SERVICE PRIMEUR,COM,-3607.0
26/06/2021,06,,06,,Virement,,EPI SERVICE PRIMEUR,CARTES,-3613.0
26/06/2021,24,,24,,Virement,,EPI SERVICE PRIMEUR,COM,-3637.0
28/06/2021,06,,06,,Virement,,EPI SERVICE PRIMEUR,CARTES,-3643.0
28/06/2021,25,,25,,Virement,,EPI SERVICE PRIMEUR,FR66ZZZ425331 B35M000000550,-3668.0
28/06/2021,06,,06,,Virement,,EPI SERVICE PRIMEUR,MO1,-3674.0
28/06/2021,25,,25,,Virement,,EPI SERVICE PRIMEUR,REMISE,-3699.0
28/06/2021,06,,06,,Virement,,EPI SERVICE PRIMEUR,REMISE,-3705.0
28/06/2021,24,,24,,Virement,,EPI SERVICE PRIMEUR,TPV,-3729.0
28/06/2021,06,,06,,Virement,,EPI SERVICE PRIMEUR,REMISE,-3735.0
28/06/2021,25,,25,,Virement,,EPI SERVICE PRIMEUR,REMISE,-3760.0
28/06/2021,06,,06,,Virement,,EPI SERVICE PRIMEUR,CARTE,-3766.0
28/06/2021,25,,25,,Virement,,EPI SERVICE PRIMEUR,METRO,-3791.0
28/06/2021,06,,06,,Virement,,EPI SERVICE PRIMEUR,COM,-3797.0
28/06/2021,64,,64,,Virement,,EPI SERVICE PRIMEUR,CARTES,-3861.0
28/06/2021,25,,25,,Virement,,EPI SERVICE PRIMEUR,COM,-3886.0
28/06/2021,06,,06,,Virement,,EPI SERVICE PRIMEUR,CARTES 0386405,-3892.0
28/06/2021,01,,01,,Virement,,EPI SERVICE PRIMEUR,COM,-3893.0
28/06/2021,25,,25,,Virement,,EPI SERVICE PRIMEUR,CARTES,-3918.0
,06,,06,,Virement,,EPI SERVICE PRIMEUR,COM,-3924.0
,64,,64,,Virement,,EPI SERVICE PRIMEUR,CARTES,-3988.0
,25,,25,,Virement,,EPI SERVICE PRIMEUR,COM,-4013.0
,06,,06,,Virement,,EPI SERVICE PRIMEUR,CARTES,-4019.0
,01,,01,,Virement,,EPI SERVICE PRIMEUR,COM,-4020.0
,25,,25,,Virement,,EPI SERVICE PRIMEUR,CARTES 0386405,-4045.0
,06,,06,,Virement,,EPI SERVICE PRIMEUR,TPV,-4051.0
,64,,64,,Virement,,EPI SERVICE PRIMEUR,TPV,-4115.0
,25,,25,,Virement,,EPI SERVICE PRIMEUR,TPV,-4140.0
,06,,06,,Virement,,EPI SERVICE PRIMEUR,TPV,-4146.0
,01,,01,,Virement,,EPI SERVICE PRIMEUR,TPV,-4147.0
,25,,25,,Virement,,EPI SERVICE PRIMEUR,CARTES,-4172.0
,06,,06,,Virement,,EPI SERVICE PRIMEUR,COM,-4178.0
,35,,35,,Virement,,EPI SERVICE PRIMEUR,CARTES,-4213.0
,82 25,,82 25,,Virement,,EPI SERVICE PRIMEUR,COM,-12438.0
,06,,06,,Virement,,EPI SERVICE PRIMEUR,CARTES 0386405 64 2706 28/06/2021 COM,-12444.0
,25,,25,,Virement,,EPI SERVICE PRIMEUR,CARTES 0386405,-12469.0
,06,,06,,Virement,,EPI SERVICE PRIMEUR,COM,-12475.0
,28,,28,,Virement,,EPI SERVICE PRIMEUR,CARTES,-12503.0
,06,,06,,Virement,,EPI SERVICE PRIMEUR,COM,-12509.0
,25,,25,,Virement,,EPI SERVICE PRIMEUR,CARTES,-12534.0
,06,,06,,Virement,,EPI SERVICE PRIMEUR,,-12540.0
,25,,25,,Virement,,EPI SERVICE PRIMEUR,,-12565.0
,06,,06,,Virement,,EPI SERVICE PRIMEUR,,-12571.0
,26,,26,,Virement,,EPI SERVICE PRIMEUR,,-12597.0
,06,,06,,Virement,,EPI SERVICE PRIMEUR,,-12603.0
,25,,25,,Virement,,EPI SERVICE PRIMEUR,,-12628.0
,06,,06,,Virement,,EPI SERVICE PRIMEUR,,-12634.0
,26,,26,,Virement,,EPI SERVICE PRIMEUR,,-12660.0
,06,,06,,Virement,,EPI SERVICE PRIMEUR,,-12666.0
,64,,64,,Virement,,EPI SERVICE PRIMEUR,,-12730.0
,26,,26,,Virement,,EPI SERVICE PRIMEUR,,-12756.0
,06,,06,,Virement,,EPI SERVICE PRIMEUR,,-12762.0
,64,,64,,Virement,,EPI SERVICE PRIMEUR,,-12826.0
,26,,26,,Virement,,EPI SERVICE PRIMEUR,,-12852.0
,06,,06,,Virement,,EPI SERVICE PRIMEUR,,-12858.0
,01,,01,,Virement,,EPI SERVICE PRIMEUR,,-12859.0
,26,,26,,Virement,,EPI SERVICE PRIMEUR,,-12885.0
,06,,06,,Virement,,EPI SERVICE PRIMEUR,,-12891.0
,64,,64,,Virement,,EPI SERVICE PRIMEUR,,-12955.0
,26,,26,,Virement,,EPI SERVICE PRIMEUR,,-12981.0
,06,,06,,Virement,,EPI SERVICE PRIMEUR,,-12987.0
,01,,01,,Virement,,EPI SERVICE PRIMEUR,,-12988.0
,26,,26,,Virement,,EPI SERVICE PRIMEUR,,-13014.0
,06,,06,,Virement,,EPI SERVICE PRIMEUR,,-13020.0
,64,,64,,Virement,,EPI SERVICE PRIMEUR,,-13084.0
,28,,28,,Virement,,EPI SERVICE PRIMEUR,,-13112.0
,06,,06,,Virement,,EPI SERVICE PRIMEUR,,-13118.0
,28,,28,,Virement,,EPI SERVICE PRIMEUR,,-13146.0
,06,,06,,Virement,,EPI SERVICE PRIMEUR,,-13152.0
,28,,28,,Virement,,EPI SERVICE PRIMEUR,,-13180.0
,06,,06,,Virement,,EPI SERVICE PRIMEUR,,-13186.0
,28,,28,,Virement,,EPI SERVICE PRIMEUR,,-13214.0
,06,,06,,Virement,,EPI SERVICE PRIMEUR,,-13220.0
,28,,28,,Virement,,EPI SERVICE PRIMEUR,,-13248.0
,06,,06,,Virement,,EPI SERVICE PRIMEUR,,-13254.0
,28,,28,,Virement,,EPI SERVICE PRIMEUR,,-13282.0
,06,,06,,Virement,,EPI SERVICE PRIMEUR,,-13288.0
,28,,28,,Virement,,EPI SERVICE PRIMEUR,,-13316.0
,06,,06,,Virement,,EPI SERVICE PRIMEUR,,-13322.0
,28,,28,,Virement,,EPI SERVICE PRIMEUR,,-13350.0
,06,,06,,Virement,,EPI SERVICE PRIMEUR,,-13356.0
,28,,28,,Virement,,EPI SERVICE PRIMEUR,,-13384.0
,06,,06,,Virement,,EPI SERVICE PRIMEUR,,-13390.0
,26,,26,,Virement,,EPI SERVICE PRIMEUR,,-13416.0
,06,,06,,Virement,,EPI SERVICE PRIMEUR,,-13422.0
,28,,28,,Virement,,EPI SERVICE PRIMEUR,,-13450.0
,06,,06,,Virement,,EPI SERVICE PRIMEUR,,-13456.0
,26,,26,,Virement,,EPI SERVICE PRIMEUR,,-13482.0
,06,,06,,Virement,,EPI SERVICE PRIMEUR,,-13488.0
,28,,28,,Virement,,EPI SERVICE PRIMEUR,,-13516.0
,06,,06,,Virement,,EPI SERVICE PRIMEUR,,-13522.0
,64,,64,,Virement,,EPI SERVICE PRIMEUR,,-13586.0
,28,,28,,Virement,,EPI SERVICE PRIMEUR,,-13614.0
,06,,06,,Virement,,EPI SERVICE PRIMEUR,,-13620.0
,01,,01,,Virement,,EPI SERVICE PRIMEUR,,-13621.0
,28,,28,,Virement,,EPI SERVICE PRIMEUR,,-13649.0
,06,,06,,Virement,,EPI SERVICE PRIMEUR,,-13655.0
,64,,64,,Virement,,EPI SERVICE PRIMEUR,,-13719.0
,28,,28,,Virement,,EPI SERVICE PRIMEUR,,-13747.0
,06,,06,,Virement,,EPI SERVICE PRIMEUR,,-13753.0
,01,,01,,Virement,,EPI SERVICE PRIMEUR,,-13754.0
,28,,28,,Virement,,EPI SERVICE PRIMEUR,,-13782.0
,06,,06,,Virement,,EPI SERVICE PRIMEUR,,-13788.0
,64,,64,,Virement,,EPI SERVICE PRIMEUR,,-13852.0
,28,,28,,Virement,,EPI SERVICE PRIMEUR,,-13880.0
,06,,06,,Virement,,EPI SERVICE PRIMEUR,,-13886.0
,01,,01,,Virement,,EPI SERVICE PRIMEUR,,-13887.0
,"0,46",,"0,46",,Virement,,EPI SERVICE PRIMEUR,,-13933.0
,"0,57",,"0,57",,Virement,,EPI SERVICE PRIMEUR,,-13990.0
,"0,03",,"0,03",,Virement,,EPI SERVICE PRIMEUR,,-13993.0
,"328,00",,"328,00",,Virement,,EPI SERVICE PRIMEUR,,-46793.0
,"323,09",,"323,09",,Virement,,EPI SERVICE PRIMEUR,,-79102.0
,24,,24,,Virement,,EPI SERVICE PRIMEUR,,-79126.0
,06 25,,06 25,,Virement,,EPI SERVICE PRIMEUR,,-79751.0
,06 25,,06 25,,Virement,,EPI SERVICE PRIMEUR,,-80376.0
,06 25,,06 25,,Virement,,EPI SERVICE PRIMEUR,,-81001.0
,06 25,,06 25,,Virement,,EPI SERVICE PRIMEUR,,-81626.0
,06 25,,06 25,,Virement,,EPI SERVICE PRIMEUR,,-82251.0
,06 25,,06 25,,Virement,,EPI SERVICE PRIMEUR,,-82876.0
,06 25,,06 25,,Virement,,EPI SERVICE PRIMEUR,,-83501.0
,06 25,,06 25,,Virement,,EPI SERVICE PRIMEUR,,-84126.0
,"06 596,87",,"06 596,87",,Virement,,EPI SERVICE PRIMEUR,,-743813.0
,"67,80",,"67,80",,Virement,,EPI SERVICE PRIMEUR,,-750593.0
,"384,35",,"384,35",,Virement,,EPI SERVICE PRIMEUR,,-789028.0
,"431,25",,"431,25",,Virement,,EPI SERVICE PRIMEUR,,-832153.0
,"45,50",,"45,50",,Virement,,EPI SERVICE PRIMEUR,,-836703.0
,"112,90",,"112,90",,Virement,,EPI SERVICE PRIMEUR,,-847993.0
,"15,00",,"15,00",,Virement,,EPI SERVICE PRIMEUR,,-849493.0
,"150,00",,"150,00",,Virement,,EPI SERVICE PRIMEUR,,-864493.0
,"3,85",,"3,85",,Virement,,EPI SERVICE PRIMEUR,,-864878.0
,25,,25,,Virement,,EPI SERVICE PRIMEUR,,-864903.0
,06 25,,06 25,,Virement,,EPI SERVICE PRIMEUR,,-865528.0
,06 25,,06 25,,Virement,,EPI SERVICE PRIMEUR,,-866153.0
,06 25,,06 25,,Virement,,EPI SERVICE PRIMEUR,,-866778.0
,06 25,,06 25,,Virement,,EPI SERVICE PRIMEUR,,-867403.0
,06 25,,06 25,,Virement,,EPI SERVICE PRIMEUR,,-868028.0
,06 25,,06 25,,Virement,,EPI SERVICE PRIMEUR,,-868653.0
,06,,06,,Virement,,EPI SERVICE PRIMEUR,,-868659.0
,"0,64",,"0,64",,Virement,,EPI SERVICE PRIMEUR,,-868723.0
,"0,08",,"0,08",,Virement,,EPI SERVICE PRIMEUR,,-868731.0
,"1,92",,"1,92",,Virement,,EPI SERVICE PRIMEUR,,-868923.0
,"1,53",,"1,53",,Virement,,EPI SERVICE PRIMEUR,,-869076.0
,"0,29",,"0,29",,Virement,,EPI SERVICE PRIMEUR,,-869105.0
,"0,31",,"0,31",,Virement,,EPI SERVICE PRIMEUR,,-869136.0
,"300,00",,"300,00",,Virement,,EPI SERVICE PRIMEUR,,-899136.0
,26,,26,,Virement,,EPI SERVICE PRIMEUR,,-899162.0
,06 26,,06 26,,Virement,,EPI SERVICE PRIMEUR,,-899788.0
,06 26,,06 26,,Virement,,EPI SERVICE PRIMEUR,,-900414.0
,06 26,,06 26,,Virement,,EPI SERVICE PRIMEUR,,-901040.0
,06 26,,06 26,,Virement,,EPI SERVICE PRIMEUR,,-901666.0
,06 26,,06 26,,Virement,,EPI SERVICE PRIMEUR,,-902292.0
,06 26,,06 26,,Virement,,EPI SERVICE PRIMEUR,,-902918.0
,06 26,,06 26,,Virement,,EPI SERVICE PRIMEUR,,-903544.0
,06 26,,06 26,,Virement,,EPI SERVICE PRIMEUR,,-904170.0
,06 26,,06 26,,Virement,,EPI SERVICE PRIMEUR,,-904796.0
,06 26,,06 26,,Virement,,EPI SERVICE PRIMEUR,,-905422.0
,06 26,,06 26,,Virement,,EPI SERVICE PRIMEUR,,-906048.0
,06 28,,06 28,,Virement,,EPI SERVICE PRIMEUR,,-906676.0
,06 28,,06 28,,Virement,,EPI SERVICE PRIMEUR,,-907304.0
,06 28,,06 28,,Virement,,EPI SERVICE PRIMEUR,,-907932.0
,06 28,,06 28,,Virement,,EPI SERVICE PRIMEUR,,-908560.0
,06 28,,06 28,,Virement,,EPI SERVICE PRIMEUR,,-909188.0
,06 28,,06 28,,Virement,,EPI SERVICE PRIMEUR,,-909816.0
,06 28,,06 28,,Virement,,EPI SERVICE PRIMEUR,,-910444.0
,06 28,,06 28,,Virement,,EPI SERVICE PRIMEUR,,-911072.0
,06 28,,06 28,,Virement,,EPI SERVICE PRIMEUR,,-911700.0
,06 28,,06 28,,Virement,,EPI SERVICE PRIMEUR,,-912328.0
,06 28,,06 28,,Virement,,EPI SERVICE PRIMEUR,,-912956.0
,06 28,,06 28,,Virement,,EPI SERVICE PRIMEUR,,-913584.0
,06 28,,06 28,,Virement,,EPI SERVICE PRIMEUR,,-914212.0
,06 28,,06 28,,Virement,,EPI SERVICE PRIMEUR,,-914840.0
,06 28,,06 28,,Virement,,EPI SERVICE PRIMEUR,,-915468.0
,06 28,,06 28,,Virement,,EPI SERVICE PRIMEUR,,-916096.0
,06 20,,06 20,,Virement,,EPI SERVICE PRIMEUR,,-916716.0
,"50 323,60",,"50 323,60",,Virement,,EPI SERVICE PRIMEUR,,-5949076.0
,"207,10",,"207,10",,Virement,,EPI SERVICE PRIMEUR,,-5969786.0
,"48,80",,"48,80",,Virement,,EPI SERVICE PRIMEUR,,-5974666.0
,"17,20",,"17,20",,Virement,,EPI SERVICE PRIMEUR,,-5976386.0
,"400,70",,"400,70",,Virement,,EPI SERVICE PRIMEUR,,-6016456.0
,"0,08",,"0,08",,Virement,,EPI SERVICE PRIMEUR,,-6016464.0
,"1,61",,"1,61",,Virement,,EPI SERVICE PRIMEUR,,-6016625.0
,"0,93",,"0,93",,Virement,,EPI SERVICE PRIMEUR,,-6016718.0
,"0,27",,"0,27",,Virement,,EPI SERVICE PRIMEUR,,-6016745.0
,"0,01",,"0,01",,Virement,,EPI SERVICE PRIMEUR,,-6016746.0
,"0,07",,"0,07",,Virement,,EPI SERVICE PRIMEUR,,-6016753.0
,"91,50",,"91,50",,Virement,,EPI SERVICE PRIMEUR,,-6025903.0
,"786,60",,"786,60",,Virement,,EPI SERVICE PRIMEUR,,-6104563.0
,"299,00",,"299,00",,Virement,,EPI SERVICE PRIMEUR,,-6134463.0
,"68,00",,"68,00",,Virement,,EPI SERVICE PRIMEUR,,-6141263.0
,"252,30",,"252,30",,Virement,,EPI SERVICE PRIMEUR,,-6166493.0
,"168,10",,"168,10",,Virement,,EPI SERVICE PRIMEUR,,-6183303.0
,"844,11",,"844,11",,Virement,,EPI SERVICE PRIMEUR,,-6267714.0
,"35,19",,"35,19",,Virement,,EPI SERVICE PRIMEUR,,-6271233.0
,1,,1,,Virement,,EPI SERVICE PRIMEUR,,-6271234.0
,"84,35",,"84,35",,Virement,,EPI SERVICE PRIMEUR,,-6279669.0
,"101,90",,"101,90",,Virement,,EPI SERVICE PRIMEUR,,-6289859.0
,"0,72",,"0,72",,Virement,,EPI SERVICE PRIMEUR,,-6289931.0
,"0,09",,"0,09",,Virement,,EPI SERVICE PRIMEUR,,-6289940.0
,"4,24",,"4,24",,Virement,,EPI SERVICE PRIMEUR,,-6290364.0
,"1,21",,"1,21",,Virement,,EPI SERVICE PRIMEUR,,-6290485.0
,"1,04",,"1,04",,Virement,,EPI SERVICE PRIMEUR,,-6290589.0
,"0,28",,"0,28",,Virement,,EPI SERVICE PRIMEUR,,-6290617.0
,,1,,,Unknown,,Banque Inconnue,cid:22)(cid:23)(cid:24,1.0
,,2,,,Unknown,,Banque Inconnue,cid:43)(cid:2)(cid:37)(cid:17)(cid:2)(cid:18)(cid:18)(cid:18)(cid:19)(cid:18)(cid:18)(cid:2)(cid:44,3.0
,,3,,,Unknown,,Banque Inconnue,cid:25)(cid:24)(cid:26)(cid:27)(cid:28)(cid:2)(cid:28)(cid:3)(cid:16)(cid:32)(cid:2)(cid:17)(cid:32)(cid:33)(cid:34)(cid:2)(cid:35)(cid:18)(cid:18)(cid:18)(cid:2)(cid:18)(cid:17)(cid:33)(cid:35)(cid:2)(cid:17)(cid:1)(cid:36)(cid:37)(cid:2)(cid:33)(cid:35)(cid:33)(cid:1)(cid:2)(cid:1)(cid:18)(cid:34,6.0
,,2,,,Unknown,,Banque Inconnue,cid:24)(cid:25)(cid:29)(cid:28)(cid:2)(cid:38)(cid:8)(cid:10)(cid:11)(cid:28)(cid:3)(cid:39)(cid:17)(cid:40)(cid:40)(cid:40,8.0
,,4,,,Unknown,,Banque Inconnue,,12.0
,,5,,,Unknown,,Banque Inconnue,,17.0
,,6,,,Unknown,,Banque Inconnue,,23.0
,,7,,,Unknown,,Banque Inconnue,,30.0
,,8,,,Unknown,,Banque Inconnue,,38.0
,,9,,,Unknown,,Banque Inconnue,,47.0
,,10,,,Unknown,,Banque Inconnue,,57.0
,,11,,,Unknown,,Banque Inconnue,,68.0
,,9,,,Unknown,,Banque Inconnue,,77.0
,,12,,,Unknown,,Banque Inconnue,,89.0
,,13,,,Unknown,,Banque Inconnue,,102.0
,,2,,,Unknown,,Banque Inconnue,,104.0
,,6,,,Unknown,,Banque Inconnue,,110.0
,,14,,,Unknown,,Banque Inconnue,,124.0
,,15,,,Unknown,,Banque Inconnue,,139.0
,,7,,,Unknown,,Banque Inconnue,,146.0
,,16,,,Unknown,,Banque Inconnue,,162.0
,,17,,,Unknown,,Banque Inconnue,,179.0
,,18,,,Unknown,,Banque Inconnue,,197.0
,,16,,,Unknown,,Banque Inconnue,,213.0
,,19,,,Unknown,,Banque Inconnue,,232.0
,,18,,,Unknown,,Banque Inconnue,,250.0
,,20,,,Unknown,,Banque Inconnue,,270.0
,,16,,,Unknown,,Banque Inconnue,,286.0
,,20,,,Unknown,,Banque Inconnue,,306.0
,,17,,,Unknown,,Banque Inconnue,,323.0
,,7,,,Unknown,,Banque Inconnue,,330.0
,,9,,,Unknown,,Banque Inconnue,,339.0
,,15,,,Unknown,,Banque Inconnue,,354.0
,,7,,,Unknown,,Banque Inconnue,,361.0
,,21,,,Unknown,,Banque Inconnue,,382.0
,,17,,,Unknown,,Banque Inconnue,,399.0
,,18,,,Unknown,,Banque Inconnue,,417.0
,,16,,,Unknown,,Banque Inconnue,,433.0
,,19,,,Unknown,,Banque Inconnue,,452.0
,,18,,,Unknown,,Banque Inconnue,,470.0
,,20,,,Unknown,,Banque Inconnue,,490.0
,,16,,,Unknown,,Banque Inconnue,,506.0
,,20,,,Unknown,,Banque Inconnue,,526.0
,,17,,,Unknown,,Banque Inconnue,,543.0
,,22,,,Unknown,,Banque Inconnue,,565.0
,,23,,,Unknown,,Banque Inconnue,,588.0
,,24,,,Unknown,,Banque Inconnue,,612.0
,,30,,,Unknown,,Banque Inconnue,,642.0
,,31,,,Unknown,,Banque Inconnue,,673.0
,,3,,,Unknown,,Banque Inconnue,,676.0
,,32,,,Unknown,,Banque Inconnue,,708.0
,,2,,,Unknown,,Banque Inconnue,,710.0
,,7,,,Unknown,,Banque Inconnue,,717.0
,,9,,,Unknown,,Banque Inconnue,,726.0
,,15,,,Unknown,,Banque Inconnue,,741.0
,,7,,,Unknown,,Banque Inconnue,,748.0
,,16,,,Unknown,,Banque Inconnue,,764.0
,,17,,,Unknown,,Banque Inconnue,,781.0
,,18,,,Unknown,,Banque Inconnue,,799.0
,,16,,,Unknown,,Banque Inconnue,,815.0
,,19,,,Unknown,,Banque Inconnue,,834.0
,,33,,,Unknown,,Banque Inconnue,,867.0
,,7,,,Unknown,,Banque Inconnue,,874.0
,,17,,,Unknown,,Banque Inconnue,,891.0
,,16,,,Unknown,,Banque Inconnue,,907.0
,,21,,,Unknown,,Banque Inconnue,,928.0
,,34,,,Unknown,,Banque Inconnue,,962.0
,,35,,,Unknown,,Banque Inconnue,,997.0
,,20,,,Unknown,,Banque Inconnue,,1017.0
,,7,,,Unknown,,Banque Inconnue,,1024.0
,,36,,,Unknown,,Banque Inconnue,,1060.0
,,1,,,Unknown,,Banque Inconnue,,1061.0
,,2,,,Unknown,,Banque Inconnue,,1063.0
,,3,,,Unknown,,Banque Inconnue,,1066.0
,,4,,,Unknown,,Banque Inconnue,,1070.0
,,5,,,Unknown,,Banque Inconnue,,1075.0
,,2,,,Unknown,,Banque Inconnue,,1077.0
,,6,,,Unknown,,Banque Inconnue,,1083.0
,,7,,,Unknown,,Banque Inconnue,,1090.0
,,8,,,Unknown,,Banque Inconnue,,1098.0
,,9,,,Unknown,,Banque Inconnue,,1107.0
,,10,,,Unknown,,Banque Inconnue,,1117.0
,,11,,,Unknown,,Banque Inconnue,,1128.0
,,8,,,Unknown,,Banque Inconnue,,1136.0
,,2,,,Unknown,,Banque Inconnue,,1138.0
,,12,,,Unknown,,Banque Inconnue,,1150.0
,,13,,,Unknown,,Banque Inconnue,,1163.0
,,4,,,Unknown,,Banque Inconnue,,1167.0
,,3,,,Unknown,,Banque Inconnue,,1170.0
,,12,,,Unknown,,Banque Inconnue,,1182.0
,,13,,,Unknown,,Banque Inconnue,,1195.0
,,7,,,Unknown,,Banque Inconnue,,1202.0
,,14,,,Unknown,,Banque Inconnue,,1216.0
,,14,,,Unknown,,Banque Inconnue,,1230.0
,,2,,,Unknown,,Banque Inconnue,,1232.0
,,15,,,Unknown,,Banque Inconnue,,1247.0
,,2,,,Unknown,,Banque Inconnue,,1249.0
,,5,,,Unknown,,Banque Inconnue,,1254.0
,,30,,,Unknown,,Banque Inconnue,,1284.0
,,41,,,Unknown,,Banque Inconnue,,1325.0
,,26,,,Unknown,,Banque Inconnue,,1351.0
,,42,,,Unknown,,Banque Inconnue,,1393.0
,,25,,,Unknown,,Banque Inconnue,,1418.0
,,27,,,Unknown,,Banque Inconnue,,1445.0
,,43,,,Unknown,,Banque Inconnue,,1488.0
,,2,,,Unknown,,Banque Inconnue,,1490.0
,,37,,,Unknown,,Banque Inconnue,,1527.0
,,17,,,Unknown,,Banque Inconnue,,1544.0
,,2,,,Unknown,,Banque Inconnue,,1546.0
,,18,,,Unknown,,Banque Inconnue,,1564.0
,,18,,,Unknown,,Banque Inconnue,,1582.0
,,18,,,Unknown,,Banque Inconnue,,1600.0
,,19,,,Unknown,,Banque Inconnue,,1619.0
,,18,,,Unknown,,Banque Inconnue,,1637.0
,,18,,,Unknown,,Banque Inconnue,,1655.0
,,2,,,Unknown,,Banque Inconnue,,1657.0
,,44,,,Unknown,,Banque Inconnue,,1701.0
,,16,,,Unknown,,Banque Inconnue,,1717.0
,,16,,,Unknown,,Banque Inconnue,,1733.0
,,17,,,Unknown,,Banque Inconnue,,1750.0
,,1,,,Unknown,,Banque Inconnue,,1751.0
,,18,,,Unknown,,Banque Inconnue,,1769.0
,,19,,,Unknown,,Banque Inconnue,,1788.0
,,2,,,Unknown,,Banque Inconnue,,1790.0
,,12,,,Unknown,,Banque Inconnue,,1802.0
,,20,,,Unknown,,Banque Inconnue,,1822.0
,,21,,,Unknown,,Banque Inconnue,,1843.0
,,22,,,Unknown,,Banque Inconnue,,1865.0
,,20,,,Unknown,,Banque Inconnue,,1885.0
,,23,,,Unknown,,Banque Inconnue,,1908.0
,,23,,,Unknown,,Banque Inconnue,,1931.0
,,24,,,Unknown,,Banque Inconnue,,1955.0
,,25,,,Unknown,,Banque Inconnue,,1980.0
,,26,,,Unknown,,Banque Inconnue,,2006.0
,,27,,,Unknown,,Banque Inconnue,,2033.0
,,19,,,Unknown,,Banque Inconnue,,2052.0
,,2,,,Unknown,,Banque Inconnue,,2054.0
,,28,,,Unknown,,Banque Inconnue,,2082.0
,,26,,,Unknown,,Banque Inconnue,,2108.0
,,29,,,Unknown,,Banque Inconnue,,2137.0
,,30,,,Unknown,,Banque Inconnue,,2167.0
,,31,,,Unknown,,Banque Inconnue,,2198.0
,,25,,,Unknown,,Banque Inconnue,,2223.0
,,9,,,Unknown,,Banque Inconnue,,2232.0
,,20,,,Unknown,,Banque Inconnue,,2252.0
,,26,,,Unknown,,Banque Inconnue,,2278.0
,,41,,,Unknown,,Banque Inconnue,,2319.0
,,24,,,Unknown,,Banque Inconnue,,2343.0
,,25,,,Unknown,,Banque Inconnue,,2368.0
,,27,,,Unknown,,Banque Inconnue,,2395.0
,,15,,,Unknown,,Banque Inconnue,,2410.0
,,2,,,Unknown,,Banque Inconnue,,2412.0
,,37,,,Unknown,,Banque Inconnue,,2449.0
,,18,,,Unknown,,Banque Inconnue,,2467.0
,,2,,,Unknown,,Banque Inconnue,,2469.0
,,18,,,Unknown,,Banque Inconnue,,2487.0
,,36,,,Unknown,,Banque Inconnue,,2523.0
,,35,,,Unknown,,Banque Inconnue,,2558.0
,,19,,,Unknown,,Banque Inconnue,,2577.0
,,37,,,Unknown,,Banque Inconnue,,2614.0
,,16,,,Unknown,,Banque Inconnue,,2630.0
,,2,,,Unknown,,Banque Inconnue,,2632.0
,,44,,,Unknown,,Banque Inconnue,,2676.0
,,25,,,Unknown,,Banque Inconnue,,2701.0
,,24,,,Unknown,,Banque Inconnue,,2725.0
,,26,,,Unknown,,Banque Inconnue,,2751.0
,,27,,,Unknown,,Banque Inconnue,,2778.0
,,28,,,Unknown,,Banque Inconnue,,2806.0
,,2,,,Unknown,,Banque Inconnue,,2808.0
,,28,,,Unknown,,Banque Inconnue,,2836.0
,,3,,,Unknown,,Banque Inconnue,,2839.0
,,16,,,Unknown,,Banque Inconnue,,2855.0
,,32,,,Unknown,,Banque Inconnue,,2887.0
,,2,,,Unknown,,Banque Inconnue,,2889.0
,,17,,,Unknown,,Banque Inconnue,,2906.0
,,32,,,Unknown,,Banque Inconnue,,2938.0
,,33,,,Unknown,,Banque Inconnue,,2971.0
,,34,,,Unknown,,Banque Inconnue,,3005.0
,,2,,,Unknown,,Banque Inconnue,,3007.0
,,35,,,Unknown,,Banque Inconnue,,3042.0
,,18,,,Unknown,,Banque Inconnue,,3060.0
,,18,,,Unknown,,Banque Inconnue,,3078.0
,,18,,,Unknown,,Banque Inconnue,,3096.0
,,2,,,Unknown,,Banque Inconnue,,3098.0
,,18,,,Unknown,,Banque Inconnue,,3116.0
,,17,,,Unknown,,Banque Inconnue,,3133.0
,,33,,,Unknown,,Banque Inconnue,,3166.0
,,35,,,Unknown,,Banque Inconnue,,3201.0
,,2,,,Unknown,,Banque Inconnue,,3203.0
,,17,,,Unknown,,Banque Inconnue,,3220.0
,,1,,,Unknown,,Banque Inconnue,,3221.0
,,36,,,Unknown,,Banque Inconnue,,3257.0
,,37,,,Unknown,,Banque Inconnue,,3294.0
,,2,,,Unknown,,Banque Inconnue,,3296.0
,,33,,,Unknown,,Banque Inconnue,,3329.0
,,35,,,Unknown,,Banque Inconnue,,3364.0
,,33,,,Unknown,,Banque Inconnue,,3397.0
,,1,,,Unknown,,Banque Inconnue,,3398.0
,,2,,,Unknown,,Banque Inconnue,,3400.0
,,1,,,Unknown,,Banque Inconnue,,3401.0
,,18,,,Unknown,,Banque Inconnue,,3419.0
,,34,,,Unknown,,Banque Inconnue,,3453.0
,,24,,,Unknown,,Banque Inconnue,,3477.0
,,25,,,Unknown,,Banque Inconnue,,3502.0
,,29,,,Unknown,,Banque Inconnue,,3531.0
,,28,,,Unknown,,Banque Inconnue,,3559.0
,,2,,,Unknown,,Banque Inconnue,,3561.0
,,38,,,Unknown,,Banque Inconnue,,3599.0
,,8,,,Unknown,,Banque Inconnue,,3607.0
,,10,,,Unknown,,Banque Inconnue,,3617.0
,,11,,,Unknown,,Banque Inconnue,,3628.0
,,28,,,Unknown,,Banque Inconnue,,3656.0
,,3,,,Unknown,,Banque Inconnue,,3659.0
,,39,,,Unknown,,Banque Inconnue,,3698.0
,,17,,,Unknown,,Banque Inconnue,,3715.0
,,40,,,Unknown,,Banque Inconnue,,3755.0
,,40,,,Unknown,,Banque Inconnue,,3795.0
,,40,,,Unknown,,Banque Inconnue,,3835.0
,,30,,,Unknown,,Banque Inconnue,,3865.0
,,31,,,Unknown,,Banque Inconnue,,3896.0
,,3,,,Unknown,,Banque Inconnue,,3899.0
,,32,,,Unknown,,Banque Inconnue,,3931.0
,,2,,,Unknown,,Banque Inconnue,,3933.0
,,7,,,Unknown,,Banque Inconnue,,3940.0
,,9,,,Unknown,,Banque Inconnue,,3949.0
,,15,,,Unknown,,Banque Inconnue,,3964.0
,,7,,,Unknown,,Banque Inconnue,,3971.0
,,21,,,Unknown,,Banque Inconnue,,3992.0
,,17,,,Unknown,,Banque Inconnue,,4009.0
,,18,,,Unknown,,Banque Inconnue,,4027.0
,,16,,,Unknown,,Banque Inconnue,,4043.0
,,19,,,Unknown,,Banque Inconnue,,4062.0
,,33,,,Unknown,,Banque Inconnue,,4095.0
,,7,,,Unknown,,Banque Inconnue,,4102.0
,,17,,,Unknown,,Banque Inconnue,,4119.0
,,7,,,Unknown,,Banque Inconnue,,4126.0
,,16,,,Unknown,,Banque Inconnue,,4142.0
,,37,,,Unknown,,Banque Inconnue,,4179.0
,,37,,,Unknown,,Banque Inconnue,,4216.0
,,34,,,Unknown,,Banque Inconnue,,4250.0
,,37,,,Unknown,,Banque Inconnue,,4287.0
,,37,,,Unknown,,Banque Inconnue,,4324.0
,,7,,,Unknown,,Banque Inconnue,,4331.0
,,36,,,Unknown,,Banque Inconnue,,4367.0
,,14,,,Unknown,,cid:50)(cid:46)(cid:12)(cid:2)(cid:7)(cid:8)(cid:10)(cid:5)(cid:3)(cid:48)(cid:46)(cid:3)(cid:12)(cid:13)(cid:5)(cid:2)(cid:14)(cid:46)(cid:2)(cid:28)(cid:5)(cid:3)(cid:10)(cid:5)(cid:2)(cid:64)(cid:46)(cid:4)(cid:12)(cid:2)(cid:28)(cid:3,cid:12)(cid:20)(cid:30)(cid:41)(cid:26)(cid:29)(cid:41)(cid:2)(cid:46)(cid:10)(cid:1)(cid:37)(cid:37)(cid:1)(cid:34)(cid:16)(cid:2)(cid:15)(cid:2)(cid:18)(cid:32)(cid:18)(cid:16)(cid:1)(cid:18)(cid:1)(cid:17)(cid:18)(cid:18)(cid:16)(cid:35)(cid:33)(cid:18)(cid:34,14.0
,,9,,,Unknown,,cid:50)(cid:46)(cid:12)(cid:2)(cid:7)(cid:8)(cid:10)(cid:5)(cid:3)(cid:48)(cid:46)(cid:3)(cid:12)(cid:13)(cid:5)(cid:2)(cid:14)(cid:46)(cid:2)(cid:28)(cid:5)(cid:3)(cid:10)(cid:5)(cid:2)(cid:64)(cid:46)(cid:4)(cid:12)(cid:2)(cid:28)(cid:3,cid:18)(cid:35)(cid:45)(cid:18)(cid:16,23.0
,,38,,,Unknown,,cid:50)(cid:46)(cid:12)(cid:2)(cid:7)(cid:8)(cid:10)(cid:5)(cid:3)(cid:48)(cid:46)(cid:3)(cid:12)(cid:13)(cid:5)(cid:2)(cid:14)(cid:46)(cid:2)(cid:28)(cid:5)(cid:3)(cid:10)(cid:5)(cid:2)(cid:64)(cid:46)(cid:4)(cid:12)(cid:2)(cid:28)(cid:3,cid:9)(cid:41)(cid:29)(cid:41)(cid:24)(cid:20)(cid:30)(cid:2)(cid:46)(cid:62)(cid:24)(cid:29)(cid:2)(cid:66)(cid:46)(cid:4)(cid:50)(cid:11)(cid:49)(cid:2)(cid:5)(cid:8)(cid:2)(cid:47)(cid:3)(cid:7)(cid:2)(cid:28)(cid:3,61.0
,,2,,,Unknown,,cid:50)(cid:46)(cid:12)(cid:2)(cid:7)(cid:8)(cid:10)(cid:5)(cid:3)(cid:48)(cid:46)(cid:3)(cid:12)(cid:13)(cid:5)(cid:2)(cid:14)(cid:46)(cid:2)(cid:28)(cid:5)(cid:3)(cid:10)(cid:5)(cid:2)(cid:64)(cid:46)(cid:4)(cid:12)(cid:2)(cid:28)(cid:3,cid:15)(cid:2)(cid:37)(cid:18)(cid:19)(cid:37)(cid:33)(cid:2)(cid:44,63.0
,,7,,,Unknown,,cid:50)(cid:46)(cid:12)(cid:2)(cid:7)(cid:8)(cid:10)(cid:5)(cid:3)(cid:48)(cid:46)(cid:3)(cid:12)(cid:13)(cid:5)(cid:2)(cid:14)(cid:46)(cid:2)(cid:28)(cid:5)(cid:3)(cid:10)(cid:5)(cid:2)(cid:64)(cid:46)(cid:4)(cid:12)(cid:2)(cid:28)(cid:3,cid:18)(cid:35)(cid:45)(cid:18)(cid:16,70.0
,,32,,,Unknown,,cid:50)(cid:46)(cid:12)(cid:2)(cid:7)(cid:8)(cid:10)(cid:5)(cid:3)(cid:48)(cid:46)(cid:3)(cid:12)(cid:13)(cid:5)(cid:2)(cid:14)(cid:46)(cid:2)(cid:28)(cid:5)(cid:3)(cid:10)(cid:5)(cid:2)(cid:64)(cid:46)(cid:4)(cid:12)(cid:2)(cid:28)(cid:3,cid:14)(cid:5)(cid:12)(cid:14)(cid:5)(cid:3)(cid:12)(cid:2)(cid:12)(cid:11)(cid:4)(cid:14)(cid:11)(cid:48)(cid:48)(cid:7)(cid:5)(cid:3)(cid:2)(cid:28)(cid:3,102.0
,,2,,,Unknown,,cid:50)(cid:46)(cid:12)(cid:2)(cid:7)(cid:8)(cid:10)(cid:5)(cid:3)(cid:48)(cid:46)(cid:3)(cid:12)(cid:13)(cid:5)(cid:2)(cid:14)(cid:46)(cid:2)(cid:28)(cid:5)(cid:3)(cid:10)(cid:5)(cid:2)(cid:64)(cid:46)(cid:4)(cid:12)(cid:2)(cid:28)(cid:3,,104.0
,,7,,,Unknown,,cid:50)(cid:46)(cid:12)(cid:2)(cid:7)(cid:8)(cid:10)(cid:5)(cid:3)(cid:48)(cid:46)(cid:3)(cid:12)(cid:13)(cid:5)(cid:2)(cid:14)(cid:46)(cid:2)(cid:28)(cid:5)(cid:3)(cid:10)(cid:5)(cid:2)(cid:64)(cid:46)(cid:4)(cid:12)(cid:2)(cid:28)(cid:3,,111.0
,,4,,,Unknown,,cid:50)(cid:46)(cid:12)(cid:2)(cid:7)(cid:8)(cid:10)(cid:5)(cid:3)(cid:48)(cid:46)(cid:3)(cid:12)(cid:13)(cid:5)(cid:2)(cid:14)(cid:46)(cid:2)(cid:28)(cid:5)(cid:3)(cid:10)(cid:5)(cid:2)(cid:64)(cid:46)(cid:4)(cid:12)(cid:2)(cid:28)(cid:3,,115.0
,,9,,,Unknown,,cid:50)(cid:46)(cid:12)(cid:2)(cid:7)(cid:8)(cid:10)(cid:5)(cid:3)(cid:48)(cid:46)(cid:3)(cid:12)(cid:13)(cid:5)(cid:2)(cid:14)(cid:46)(cid:2)(cid:28)(cid:5)(cid:3)(cid:10)(cid:5)(cid:2)(cid:64)(cid:46)(cid:4)(cid:12)(cid:2)(cid:28)(cid:3,,124.0
,,3,,,Unknown,,cid:50)(cid:46)(cid:12)(cid:2)(cid:7)(cid:8)(cid:10)(cid:5)(cid:3)(cid:48)(cid:46)(cid:3)(cid:12)(cid:13)(cid:5)(cid:2)(cid:14)(cid:46)(cid:2)(cid:28)(cid:5)(cid:3)(cid:10)(cid:5)(cid:2)(cid:64)(cid:46)(cid:4)(cid:12)(cid:2)(cid:28)(cid:3,,127.0
,,2,,,Unknown,,cid:50)(cid:46)(cid:12)(cid:2)(cid:7)(cid:8)(cid:10)(cid:5)(cid:3)(cid:48)(cid:46)(cid:3)(cid:12)(cid:13)(cid:5)(cid:2)(cid:14)(cid:46)(cid:2)(cid:28)(cid:5)(cid:3)(cid:10)(cid:5)(cid:2)(cid:64)(cid:46)(cid:4)(cid:12)(cid:2)(cid:28)(cid:3,,129.0
,,15,,,Unknown,,cid:50)(cid:46)(cid:12)(cid:2)(cid:7)(cid:8)(cid:10)(cid:5)(cid:3)(cid:48)(cid:46)(cid:3)(cid:12)(cid:13)(cid:5)(cid:2)(cid:14)(cid:46)(cid:2)(cid:28)(cid:5)(cid:3)(cid:10)(cid:5)(cid:2)(cid:64)(cid:46)(cid:4)(cid:12)(cid:2)(cid:28)(cid:3,,144.0
,,13,,,Unknown,,cid:50)(cid:46)(cid:12)(cid:2)(cid:7)(cid:8)(cid:10)(cid:5)(cid:3)(cid:48)(cid:46)(cid:3)(cid:12)(cid:13)(cid:5)(cid:2)(cid:14)(cid:46)(cid:2)(cid:28)(cid:5)(cid:3)(cid:10)(cid:5)(cid:2)(cid:64)(cid:46)(cid:4)(cid:12)(cid:2)(cid:28)(cid:3,,157.0
,,39,,,Unknown,,cid:50)(cid:46)(cid:12)(cid:2)(cid:7)(cid:8)(cid:10)(cid:5)(cid:3)(cid:48)(cid:46)(cid:3)(cid:12)(cid:13)(cid:5)(cid:2)(cid:14)(cid:46)(cid:2)(cid:28)(cid:5)(cid:3)(cid:10)(cid:5)(cid:2)(cid:64)(cid:46)(cid:4)(cid:12)(cid:2)(cid:28)(cid:3,,196.0
,,13,,,Unknown,,cid:50)(cid:46)(cid:12)(cid:2)(cid:7)(cid:8)(cid:10)(cid:5)(cid:3)(cid:48)(cid:46)(cid:3)(cid:12)(cid:13)(cid:5)(cid:2)(cid:14)(cid:46)(cid:2)(cid:28)(cid:5)(cid:3)(cid:10)(cid:5)(cid:2)(cid:64)(cid:46)(cid:4)(cid:12)(cid:2)(cid:28)(cid:3,,209.0
,,9,,,Unknown,,cid:50)(cid:46)(cid:12)(cid:2)(cid:7)(cid:8)(cid:10)(cid:5)(cid:3)(cid:48)(cid:46)(cid:3)(cid:12)(cid:13)(cid:5)(cid:2)(cid:14)(cid:46)(cid:2)(cid:28)(cid:5)(cid:3)(cid:10)(cid:5)(cid:2)(cid:64)(cid:46)(cid:4)(cid:12)(cid:2)(cid:28)(cid:3,,218.0
,,10,,,Unknown,,cid:50)(cid:46)(cid:12)(cid:2)(cid:7)(cid:8)(cid:10)(cid:5)(cid:3)(cid:48)(cid:46)(cid:3)(cid:12)(cid:13)(cid:5)(cid:2)(cid:14)(cid:46)(cid:2)(cid:28)(cid:5)(cid:3)(cid:10)(cid:5)(cid:2)(cid:64)(cid:46)(cid:4)(cid:12)(cid:2)(cid:28)(cid:3,,228.0
,,6,,,Unknown,,cid:50)(cid:46)(cid:12)(cid:2)(cid:7)(cid:8)(cid:10)(cid:5)(cid:3)(cid:48)(cid:46)(cid:3)(cid:12)(cid:13)(cid:5)(cid:2)(cid:14)(cid:46)(cid:2)(cid:28)(cid:5)(cid:3)(cid:10)(cid:5)(cid:2)(cid:64)(cid:46)(cid:4)(cid:12)(cid:2)(cid:28)(cid:3,,234.0
,,9,,,Unknown,,cid:50)(cid:46)(cid:12)(cid:2)(cid:7)(cid:8)(cid:10)(cid:5)(cid:3)(cid:48)(cid:46)(cid:3)(cid:12)(cid:13)(cid:5)(cid:2)(cid:14)(cid:46)(cid:2)(cid:28)(cid:5)(cid:3)(cid:10)(cid:5)(cid:2)(cid:64)(cid:46)(cid:4)(cid:12)(cid:2)(cid:28)(cid:3,,243.0
,,11,,,Unknown,,cid:50)(cid:46)(cid:12)(cid:2)(cid:7)(cid:8)(cid:10)(cid:5)(cid:3)(cid:48)(cid:46)(cid:3)(cid:12)(cid:13)(cid:5)(cid:2)(cid:14)(cid:46)(cid:2)(cid:28)(cid:5)(cid:3)(cid:10)(cid:5)(cid:2)(cid:64)(cid:46)(cid:4)(cid:12)(cid:2)(cid:28)(cid:3,,254.0
,,38,,,Unknown,,cid:50)(cid:46)(cid:12)(cid:2)(cid:7)(cid:8)(cid:10)(cid:5)(cid:3)(cid:48)(cid:46)(cid:3)(cid:12)(cid:13)(cid:5)(cid:2)(cid:14)(cid:46)(cid:2)(cid:28)(cid:5)(cid:3)(cid:10)(cid:5)(cid:2)(cid:64)(cid:46)(cid:4)(cid:12)(cid:2)(cid:28)(cid:3,,292.0
,,12,,,Unknown,,cid:50)(cid:46)(cid:12)(cid:2)(cid:7)(cid:8)(cid:10)(cid:5)(cid:3)(cid:48)(cid:46)(cid:3)(cid:12)(cid:13)(cid:5)(cid:2)(cid:14)(cid:46)(cid:2)(cid:28)(cid:5)(cid:3)(cid:10)(cid:5)(cid:2)(cid:64)(cid:46)(cid:4)(cid:12)(cid:2)(cid:28)(cid:3,,304.0
,,31,,,Unknown,,cid:50)(cid:46)(cid:12)(cid:2)(cid:7)(cid:8)(cid:10)(cid:5)(cid:3)(cid:48)(cid:46)(cid:3)(cid:12)(cid:13)(cid:5)(cid:2)(cid:14)(cid:46)(cid:2)(cid:28)(cid:5)(cid:3)(cid:10)(cid:5)(cid:2)(cid:64)(cid:46)(cid:4)(cid:12)(cid:2)(cid:28)(cid:3,,335.0
,,10,,,Unknown,,cid:50)(cid:46)(cid:12)(cid:2)(cid:7)(cid:8)(cid:10)(cid:5)(cid:3)(cid:48)(cid:46)(cid:3)(cid:12)(cid:13)(cid:5)(cid:2)(cid:14)(cid:46)(cid:2)(cid:28)(cid:5)(cid:3)(cid:10)(cid:5)(cid:2)(cid:64)(cid:46)(cid:4)(cid:12)(cid:2)(cid:28)(cid:3,,345.0
,,6,,,Unknown,,cid:50)(cid:46)(cid:12)(cid:2)(cid:7)(cid:8)(cid:10)(cid:5)(cid:3)(cid:48)(cid:46)(cid:3)(cid:12)(cid:13)(cid:5)(cid:2)(cid:14)(cid:46)(cid:2)(cid:28)(cid:5)(cid:3)(cid:10)(cid:5)(cid:2)(cid:64)(cid:46)(cid:4)(cid:12)(cid:2)(cid:28)(cid:3,,351.0
,,14,,,Unknown,,cid:50)(cid:46)(cid:12)(cid:2)(cid:7)(cid:8)(cid:10)(cid:5)(cid:3)(cid:48)(cid:46)(cid:3)(cid:12)(cid:13)(cid:5)(cid:2)(cid:14)(cid:46)(cid:2)(cid:28)(cid:5)(cid:3)(cid:10)(cid:5)(cid:2)(cid:64)(cid:46)(cid:4)(cid:12)(cid:2)(cid:28)(cid:3,,365.0
,,5,,,Unknown,,cid:50)(cid:46)(cid:12)(cid:2)(cid:7)(cid:8)(cid:10)(cid:5)(cid:3)(cid:48)(cid:46)(cid:3)(cid:12)(cid:13)(cid:5)(cid:2)(cid:14)(cid:46)(cid:2)(cid:28)(cid:5)(cid:3)(cid:10)(cid:5)(cid:2)(cid:64)(cid:46)(cid:4)(cid:12)(cid:2)(cid:28)(cid:3,,370.0
,,8,,,Unknown,,cid:50)(cid:46)(cid:12)(cid:2)(cid:7)(cid:8)(cid:10)(cid:5)(cid:3)(cid:48)(cid:46)(cid:3)(cid:12)(cid:13)(cid:5)(cid:2)(cid:14)(cid:46)(cid:2)(cid:28)(cid:5)(cid:3)(cid:10)(cid:5)(cid:2)(cid:64)(cid:46)(cid:4)(cid:12)(cid:2)(cid:28)(cid:3,,378.0
,,12,,,Unknown,,cid:50)(cid:46)(cid:12)(cid:2)(cid:7)(cid:8)(cid:10)(cid:5)(cid:3)(cid:48)(cid:46)(cid:3)(cid:12)(cid:13)(cid:5)(cid:2)(cid:14)(cid:46)(cid:2)(cid:28)(cid:5)(cid:3)(cid:10)(cid:5)(cid:2)(cid:64)(cid:46)(cid:4)(cid:12)(cid:2)(cid:28)(cid:3,,390.0
,,38,,,Unknown,,cid:50)(cid:46)(cid:12)(cid:2)(cid:7)(cid:8)(cid:10)(cid:5)(cid:3)(cid:48)(cid:46)(cid:3)(cid:12)(cid:13)(cid:5)(cid:2)(cid:14)(cid:46)(cid:2)(cid:28)(cid:5)(cid:3)(cid:10)(cid:5)(cid:2)(cid:64)(cid:46)(cid:4)(cid:12)(cid:2)(cid:28)(cid:3,,428.0
,,29,,,Unknown,,cid:50)(cid:46)(cid:12)(cid:2)(cid:7)(cid:8)(cid:10)(cid:5)(cid:3)(cid:48)(cid:46)(cid:3)(cid:12)(cid:13)(cid:5)(cid:2)(cid:14)(cid:46)(cid:2)(cid:28)(cid:5)(cid:3)(cid:10)(cid:5)(cid:2)(cid:64)(cid:46)(cid:4)(cid:12)(cid:2)(cid:28)(cid:3,,457.0
,,13,,,Unknown,,cid:50)(cid:46)(cid:12)(cid:2)(cid:7)(cid:8)(cid:10)(cid:5)(cid:3)(cid:48)(cid:46)(cid:3)(cid:12)(cid:13)(cid:5)(cid:2)(cid:14)(cid:46)(cid:2)(cid:28)(cid:5)(cid:3)(cid:10)(cid:5)(cid:2)(cid:64)(cid:46)(cid:4)(cid:12)(cid:2)(cid:28)(cid:3,,470.0
,,5,,,Unknown,,cid:50)(cid:46)(cid:12)(cid:2)(cid:7)(cid:8)(cid:10)(cid:5)(cid:3)(cid:48)(cid:46)(cid:3)(cid:12)(cid:13)(cid:5)(cid:2)(cid:14)(cid:46)(cid:2)(cid:28)(cid:5)(cid:3)(cid:10)(cid:5)(cid:2)(cid:64)(cid:46)(cid:4)(cid:12)(cid:2)(cid:28)(cid:3,,475.0
,,32,,,Unknown,,cid:50)(cid:46)(cid:12)(cid:2)(cid:7)(cid:8)(cid:10)(cid:5)(cid:3)(cid:48)(cid:46)(cid:3)(cid:12)(cid:13)(cid:5)(cid:2)(cid:14)(cid:46)(cid:2)(cid:28)(cid:5)(cid:3)(cid:10)(cid:5)(cid:2)(cid:64)(cid:46)(cid:4)(cid:12)(cid:2)(cid:28)(cid:3,,507.0
,,12,,,Unknown,,cid:50)(cid:46)(cid:12)(cid:2)(cid:7)(cid:8)(cid:10)(cid:5)(cid:3)(cid:48)(cid:46)(cid:3)(cid:12)(cid:13)(cid:5)(cid:2)(cid:14)(cid:46)(cid:2)(cid:28)(cid:5)(cid:3)(cid:10)(cid:5)(cid:2)(cid:64)(cid:46)(cid:4)(cid:12)(cid:2)(cid:28)(cid:3,,519.0
,,38,,,Unknown,,cid:50)(cid:46)(cid:12)(cid:2)(cid:7)(cid:8)(cid:10)(cid:5)(cid:3)(cid:48)(cid:46)(cid:3)(cid:12)(cid:13)(cid:5)(cid:2)(cid:14)(cid:46)(cid:2)(cid:28)(cid:5)(cid:3)(cid:10)(cid:5)(cid:2)(cid:64)(cid:46)(cid:4)(cid:12)(cid:2)(cid:28)(cid:3,,557.0
,,18,,,Unknown,,cid:50)(cid:46)(cid:12)(cid:2)(cid:7)(cid:8)(cid:10)(cid:5)(cid:3)(cid:48)(cid:46)(cid:3)(cid:12)(cid:13)(cid:5)(cid:2)(cid:14)(cid:46)(cid:2)(cid:28)(cid:5)(cid:3)(cid:10)(cid:5)(cid:2)(cid:64)(cid:46)(cid:4)(cid:12)(cid:2)(cid:28)(cid:3,,575.0
,,1,,,Unknown,,cid:50)(cid:46)(cid:12)(cid:2)(cid:7)(cid:8)(cid:10)(cid:5)(cid:3)(cid:48)(cid:46)(cid:3)(cid:12)(cid:13)(cid:5)(cid:2)(cid:14)(cid:46)(cid:2)(cid:28)(cid:5)(cid:3)(cid:10)(cid:5)(cid:2)(cid:64)(cid:46)(cid:4)(cid:12)(cid:2)(cid:28)(cid:3,,576.0
,,45,,,Unknown,,cid:50)(cid:46)(cid:12)(cid:2)(cid:7)(cid:8)(cid:10)(cid:5)(cid:3)(cid:48)(cid:46)(cid:3)(cid:12)(cid:13)(cid:5)(cid:2)(cid:14)(cid:46)(cid:2)(cid:28)(cid:5)(cid:3)(cid:10)(cid:5)(cid:2)(cid:64)(cid:46)(cid:4)(cid:12)(cid:2)(cid:28)(cid:3,,621.0
,,18,,,Unknown,,cid:50)(cid:46)(cid:12)(cid:2)(cid:7)(cid:8)(cid:10)(cid:5)(cid:3)(cid:48)(cid:46)(cid:3)(cid:12)(cid:13)(cid:5)(cid:2)(cid:14)(cid:46)(cid:2)(cid:28)(cid:5)(cid:3)(cid:10)(cid:5)(cid:2)(cid:64)(cid:46)(cid:4)(cid:12)(cid:2)(cid:28)(cid:3,,639.0
,,16,,,Unknown,,cid:50)(cid:46)(cid:12)(cid:2)(cid:7)(cid:8)(cid:10)(cid:5)(cid:3)(cid:48)(cid:46)(cid:3)(cid:12)(cid:13)(cid:5)(cid:2)(cid:14)(cid:46)(cid:2)(cid:28)(cid:5)(cid:3)(cid:10)(cid:5)(cid:2)(cid:64)(cid:46)(cid:4)(cid:12)(cid:2)(cid:28)(cid:3,,655.0
,,5,,,Unknown,,cid:50)(cid:46)(cid:12)(cid:2)(cid:7)(cid:8)(cid:10)(cid:5)(cid:3)(cid:48)(cid:46)(cid:3)(cid:12)(cid:13)(cid:5)(cid:2)(cid:14)(cid:46)(cid:2)(cid:28)(cid:5)(cid:3)(cid:10)(cid:5)(cid:2)(cid:64)(cid:46)(cid:4)(cid:12)(cid:2)(cid:28)(cid:3,,660.0
,,10,,,Unknown,,cid:50)(cid:46)(cid:12)(cid:2)(cid:7)(cid:8)(cid:10)(cid:5)(cid:3)(cid:48)(cid:46)(cid:3)(cid:12)(cid:13)(cid:5)(cid:2)(cid:14)(cid:46)(cid:2)(cid:28)(cid:5)(cid:3)(cid:10)(cid:5)(cid:2)(cid:64)(cid:46)(cid:4)(cid:12)(cid:2)(cid:28)(cid:3,,670.0
,,46,,,Unknown,,cid:50)(cid:46)(cid:12)(cid:2)(cid:7)(cid:8)(cid:10)(cid:5)(cid:3)(cid:48)(cid:46)(cid:3)(cid:12)(cid:13)(cid:5)(cid:2)(cid:14)(cid:46)(cid:2)(cid:28)(cid:5)(cid:3)(cid:10)(cid:5)(cid:2)(cid:64)(cid:46)(cid:4)(cid:12)(cid:2)(cid:28)(cid:3,,716.0
,,47,,,Unknown,,cid:50)(cid:46)(cid:12)(cid:2)(cid:7)(cid:8)(cid:10)(cid:5)(cid:3)(cid:48)(cid:46)(cid:3)(cid:12)(cid:13)(cid:5)(cid:2)(cid:14)(cid:46)(cid:2)(cid:28)(cid:5)(cid:3)(cid:10)(cid:5)(cid:2)(cid:64)(cid:46)(cid:4)(cid:12)(cid:2)(cid:28)(cid:3,,763.0
,,14,,,Unknown,,cid:50)(cid:46)(cid:12)(cid:2)(cid:7)(cid:8)(cid:10)(cid:5)(cid:3)(cid:48)(cid:46)(cid:3)(cid:12)(cid:13)(cid:5)(cid:2)(cid:14)(cid:46)(cid:2)(cid:28)(cid:5)(cid:3)(cid:10)(cid:5)(cid:2)(cid:64)(cid:46)(cid:4)(cid:12)(cid:2)(cid:28)(cid:3,,777.0
,,7,,,Unknown,,cid:50)(cid:46)(cid:12)(cid:2)(cid:7)(cid:8)(cid:10)(cid:5)(cid:3)(cid:48)(cid:46)(cid:3)(cid:12)(cid:13)(cid:5)(cid:2)(cid:14)(cid:46)(cid:2)(cid:28)(cid:5)(cid:3)(cid:10)(cid:5)(cid:2)(cid:64)(cid:46)(cid:4)(cid:12)(cid:2)(cid:28)(cid:3,,784.0
,,9,,,Unknown,,cid:50)(cid:46)(cid:12)(cid:2)(cid:7)(cid:8)(cid:10)(cid:5)(cid:3)(cid:48)(cid:46)(cid:3)(cid:12)(cid:13)(cid:5)(cid:2)(cid:14)(cid:46)(cid:2)(cid:28)(cid:5)(cid:3)(cid:10)(cid:5)(cid:2)(cid:64)(cid:46)(cid:4)(cid:12)(cid:2)(cid:28)(cid:3,,793.0
,,9,,,Unknown,,cid:50)(cid:46)(cid:12)(cid:2)(cid:7)(cid:8)(cid:10)(cid:5)(cid:3)(cid:48)(cid:46)(cid:3)(cid:12)(cid:13)(cid:5)(cid:2)(cid:14)(cid:46)(cid:2)(cid:28)(cid:5)(cid:3)(cid:10)(cid:5)(cid:2)(cid:64)(cid:46)(cid:4)(cid:12)(cid:2)(cid:28)(cid:3,,802.0
,,5,,,Unknown,,cid:50)(cid:46)(cid:12)(cid:2)(cid:7)(cid:8)(cid:10)(cid:5)(cid:3)(cid:48)(cid:46)(cid:3)(cid:12)(cid:13)(cid:5)(cid:2)(cid:14)(cid:46)(cid:2)(cid:28)(cid:5)(cid:3)(cid:10)(cid:5)(cid:2)(cid:64)(cid:46)(cid:4)(cid:12)(cid:2)(cid:28)(cid:3,,807.0
,,48,,,Unknown,,cid:50)(cid:46)(cid:12)(cid:2)(cid:7)(cid:8)(cid:10)(cid:5)(cid:3)(cid:48)(cid:46)(cid:3)(cid:12)(cid:13)(cid:5)(cid:2)(cid:14)(cid:46)(cid:2)(cid:28)(cid:5)(cid:3)(cid:10)(cid:5)(cid:2)(cid:64)(cid:46)(cid:4)(cid:12)(cid:2)(cid:28)(cid:3,,855.0
,,5,,,Unknown,,cid:50)(cid:46)(cid:12)(cid:2)(cid:7)(cid:8)(cid:10)(cid:5)(cid:3)(cid:48)(cid:46)(cid:3)(cid:12)(cid:13)(cid:5)(cid:2)(cid:14)(cid:46)(cid:2)(cid:28)(cid:5)(cid:3)(cid:10)(cid:5)(cid:2)(cid:64)(cid:46)(cid:4)(cid:12)(cid:2)(cid:28)(cid:3,,860.0
,,8,,,Unknown,,cid:50)(cid:46)(cid:12)(cid:2)(cid:7)(cid:8)(cid:10)(cid:5)(cid:3)(cid:48)(cid:46)(cid:3)(cid:12)(cid:13)(cid:5)(cid:2)(cid:14)(cid:46)(cid:2)(cid:28)(cid:5)(cid:3)(cid:10)(cid:5)(cid:2)(cid:64)(cid:46)(cid:4)(cid:12)(cid:2)(cid:28)(cid:3,,868.0
,,10,,,Unknown,,cid:50)(cid:46)(cid:12)(cid:2)(cid:7)(cid:8)(cid:10)(cid:5)(cid:3)(cid:48)(cid:46)(cid:3)(cid:12)(cid:13)(cid:5)(cid:2)(cid:14)(cid:46)(cid:2)(cid:28)(cid:5)(cid:3)(cid:10)(cid:5)(cid:2)(cid:64)(cid:46)(cid:4)(cid:12)(cid:2)(cid:28)(cid:3,,878.0
,,2,,,Unknown,,cid:50)(cid:46)(cid:12)(cid:2)(cid:7)(cid:8)(cid:10)(cid:5)(cid:3)(cid:48)(cid:46)(cid:3)(cid:12)(cid:13)(cid:5)(cid:2)(cid:14)(cid:46)(cid:2)(cid:28)(cid:5)(cid:3)(cid:10)(cid:5)(cid:2)(cid:64)(cid:46)(cid:4)(cid:12)(cid:2)(cid:28)(cid:3,,880.0
,,10,,,Unknown,,cid:50)(cid:46)(cid:12)(cid:2)(cid:7)(cid:8)(cid:10)(cid:5)(cid:3)(cid:48)(cid:46)(cid:3)(cid:12)(cid:13)(cid:5)(cid:2)(cid:14)(cid:46)(cid:2)(cid:28)(cid:5)(cid:3)(cid:10)(cid:5)(cid:2)(cid:64)(cid:46)(cid:4)(cid:12)(cid:2)(cid:28)(cid:3,,890.0
,,11,,,Unknown,,cid:50)(cid:46)(cid:12)(cid:2)(cid:7)(cid:8)(cid:10)(cid:5)(cid:3)(cid:48)(cid:46)(cid:3)(cid:12)(cid:13)(cid:5)(cid:2)(cid:14)(cid:46)(cid:2)(cid:28)(cid:5)(cid:3)(cid:10)(cid:5)(cid:2)(cid:64)(cid:46)(cid:4)(cid:12)(cid:2)(cid:28)(cid:3,,901.0
,,8,,,Unknown,,cid:50)(cid:46)(cid:12)(cid:2)(cid:7)(cid:8)(cid:10)(cid:5)(cid:3)(cid:48)(cid:46)(cid:3)(cid:12)(cid:13)(cid:5)(cid:2)(cid:14)(cid:46)(cid:2)(cid:28)(cid:5)(cid:3)(cid:10)(cid:5)(cid:2)(cid:64)(cid:46)(cid:4)(cid:12)(cid:2)(cid:28)(cid:3,,909.0
,,49,,,Unknown,,cid:50)(cid:46)(cid:12)(cid:2)(cid:7)(cid:8)(cid:10)(cid:5)(cid:3)(cid:48)(cid:46)(cid:3)(cid:12)(cid:13)(cid:5)(cid:2)(cid:14)(cid:46)(cid:2)(cid:28)(cid:5)(cid:3)(cid:10)(cid:5)(cid:2)(cid:64)(cid:46)(cid:4)(cid:12)(cid:2)(cid:28)(cid:3,,958.0
,,2,,,Unknown,,cid:50)(cid:46)(cid:12)(cid:2)(cid:7)(cid:8)(cid:10)(cid:5)(cid:3)(cid:48)(cid:46)(cid:3)(cid:12)(cid:13)(cid:5)(cid:2)(cid:14)(cid:46)(cid:2)(cid:28)(cid:5)(cid:3)(cid:10)(cid:5)(cid:2)(cid:64)(cid:46)(cid:4)(cid:12)(cid:2)(cid:28)(cid:3,,960.0
,,13,,,Unknown,,cid:50)(cid:46)(cid:12)(cid:2)(cid:7)(cid:8)(cid:10)(cid:5)(cid:3)(cid:48)(cid:46)(cid:3)(cid:12)(cid:13)(cid:5)(cid:2)(cid:14)(cid:46)(cid:2)(cid:28)(cid:5)(cid:3)(cid:10)(cid:5)(cid:2)(cid:64)(cid:46)(cid:4)(cid:12)(cid:2)(cid:28)(cid:3,,973.0
,,5,,,Unknown,,cid:50)(cid:46)(cid:12)(cid:2)(cid:7)(cid:8)(cid:10)(cid:5)(cid:3)(cid:48)(cid:46)(cid:3)(cid:12)(cid:13)(cid:5)(cid:2)(cid:14)(cid:46)(cid:2)(cid:28)(cid:5)(cid:3)(cid:10)(cid:5)(cid:2)(cid:64)(cid:46)(cid:4)(cid:12)(cid:2)(cid:28)(cid:3,,978.0
,,8,,,Unknown,,cid:50)(cid:46)(cid:12)(cid:2)(cid:7)(cid:8)(cid:10)(cid:5)(cid:3)(cid:48)(cid:46)(cid:3)(cid:12)(cid:13)(cid:5)(cid:2)(cid:14)(cid:46)(cid:2)(cid:28)(cid:5)(cid:3)(cid:10)(cid:5)(cid:2)(cid:64)(cid:46)(cid:4)(cid:12)(cid:2)(cid:28)(cid:3,,986.0
,,3,,,Unknown,,cid:50)(cid:46)(cid:12)(cid:2)(cid:7)(cid:8)(cid:10)(cid:5)(cid:3)(cid:48)(cid:46)(cid:3)(cid:12)(cid:13)(cid:5)(cid:2)(cid:14)(cid:46)(cid:2)(cid:28)(cid:5)(cid:3)(cid:10)(cid:5)(cid:2)(cid:64)(cid:46)(cid:4)(cid:12)(cid:2)(cid:28)(cid:3,,989.0
,,49,,,Unknown,,cid:50)(cid:46)(cid:12)(cid:2)(cid:7)(cid:8)(cid:10)(cid:5)(cid:3)(cid:48)(cid:46)(cid:3)(cid:12)(cid:13)(cid:5)(cid:2)(cid:14)(cid:46)(cid:2)(cid:28)(cid:5)(cid:3)(cid:10)(cid:5)(cid:2)(cid:64)(cid:46)(cid:4)(cid:12)(cid:2)(cid:28)(cid:3,,1038.0
,,43,,,Unknown,,cid:50)(cid:46)(cid:12)(cid:2)(cid:7)(cid:8)(cid:10)(cid:5)(cid:3)(cid:48)(cid:46)(cid:3)(cid:12)(cid:13)(cid:5)(cid:2)(cid:14)(cid:46)(cid:2)(cid:28)(cid:5)(cid:3)(cid:10)(cid:5)(cid:2)(cid:64)(cid:46)(cid:4)(cid:12)(cid:2)(cid:28)(cid:3,,1081.0
,,2,,,Unknown,,cid:50)(cid:46)(cid:12)(cid:2)(cid:7)(cid:8)(cid:10)(cid:5)(cid:3)(cid:48)(cid:46)(cid:3)(cid:12)(cid:13)(cid:5)(cid:2)(cid:14)(cid:46)(cid:2)(cid:28)(cid:5)(cid:3)(cid:10)(cid:5)(cid:2)(cid:64)(cid:46)(cid:4)(cid:12)(cid:2)(cid:28)(cid:3,,1083.0
,,37,,,Unknown,,cid:50)(cid:46)(cid:12)(cid:2)(cid:7)(cid:8)(cid:10)(cid:5)(cid:3)(cid:48)(cid:46)(cid:3)(cid:12)(cid:13)(cid:5)(cid:2)(cid:14)(cid:46)(cid:2)(cid:28)(cid:5)(cid:3)(cid:10)(cid:5)(cid:2)(cid:64)(cid:46)(cid:4)(cid:12)(cid:2)(cid:28)(cid:3,,1120.0
,,18,,,Unknown,,cid:50)(cid:46)(cid:12)(cid:2)(cid:7)(cid:8)(cid:10)(cid:5)(cid:3)(cid:48)(cid:46)(cid:3)(cid:12)(cid:13)(cid:5)(cid:2)(cid:14)(cid:46)(cid:2)(cid:28)(cid:5)(cid:3)(cid:10)(cid:5)(cid:2)(cid:64)(cid:46)(cid:4)(cid:12)(cid:2)(cid:28)(cid:3,,1138.0
,,2,,,Unknown,,cid:50)(cid:46)(cid:12)(cid:2)(cid:7)(cid:8)(cid:10)(cid:5)(cid:3)(cid:48)(cid:46)(cid:3)(cid:12)(cid:13)(cid:5)(cid:2)(cid:14)(cid:46)(cid:2)(cid:28)(cid:5)(cid:3)(cid:10)(cid:5)(cid:2)(cid:64)(cid:46)(cid:4)(cid:12)(cid:2)(cid:28)(cid:3,,1140.0
,,18,,,Unknown,,cid:50)(cid:46)(cid:12)(cid:2)(cid:7)(cid:8)(cid:10)(cid:5)(cid:3)(cid:48)(cid:46)(cid:3)(cid:12)(cid:13)(cid:5)(cid:2)(cid:14)(cid:46)(cid:2)(cid:28)(cid:5)(cid:3)(cid:10)(cid:5)(cid:2)(cid:64)(cid:46)(cid:4)(cid:12)(cid:2)(cid:28)(cid:3,,1158.0
,,18,,,Unknown,,cid:50)(cid:46)(cid:12)(cid:2)(cid:7)(cid:8)(cid:10)(cid:5)(cid:3)(cid:48)(cid:46)(cid:3)(cid:12)(cid:13)(cid:5)(cid:2)(cid:14)(cid:46)(cid:2)(cid:28)(cid:5)(cid:3)(cid:10)(cid:5)(cid:2)(cid:64)(cid:46)(cid:4)(cid:12)(cid:2)(cid:28)(cid:3,,1176.0
,,18,,,Unknown,,cid:50)(cid:46)(cid:12)(cid:2)(cid:7)(cid:8)(cid:10)(cid:5)(cid:3)(cid:48)(cid:46)(cid:3)(cid:12)(cid:13)(cid:5)(cid:2)(cid:14)(cid:46)(cid:2)(cid:28)(cid:5)(cid:3)(cid:10)(cid:5)(cid:2)(cid:64)(cid:46)(cid:4)(cid:12)(cid:2)(cid:28)(cid:3,,1194.0
,,19,,,Unknown,,cid:50)(cid:46)(cid:12)(cid:2)(cid:7)(cid:8)(cid:10)(cid:5)(cid:3)(cid:48)(cid:46)(cid:3)(cid:12)(cid:13)(cid:5)(cid:2)(cid:14)(cid:46)(cid:2)(cid:28)(cid:5)(cid:3)(cid:10)(cid:5)(cid:2)(cid:64)(cid:46)(cid:4)(cid:12)(cid:2)(cid:28)(cid:3,,1213.0
,,18,,,Unknown,,cid:50)(cid:46)(cid:12)(cid:2)(cid:7)(cid:8)(cid:10)(cid:5)(cid:3)(cid:48)(cid:46)(cid:3)(cid:12)(cid:13)(cid:5)(cid:2)(cid:14)(cid:46)(cid:2)(cid:28)(cid:5)(cid:3)(cid:10)(cid:5)(cid:2)(cid:64)(cid:46)(cid:4)(cid:12)(cid:2)(cid:28)(cid:3,,1231.0
,,18,,,Unknown,,cid:50)(cid:46)(cid:12)(cid:2)(cid:7)(cid:8)(cid:10)(cid:5)(cid:3)(cid:48)(cid:46)(cid:3)(cid:12)(cid:13)(cid:5)(cid:2)(cid:14)(cid:46)(cid:2)(cid:28)(cid:5)(cid:3)(cid:10)(cid:5)(cid:2)(cid:64)(cid:46)(cid:4)(cid:12)(cid:2)(cid:28)(cid:3,,1249.0
,,2,,,Unknown,,cid:50)(cid:46)(cid:12)(cid:2)(cid:7)(cid:8)(cid:10)(cid:5)(cid:3)(cid:48)(cid:46)(cid:3)(cid:12)(cid:13)(cid:5)(cid:2)(cid:14)(cid:46)(cid:2)(cid:28)(cid:5)(cid:3)(cid:10)(cid:5)(cid:2)(cid:64)(cid:46)(cid:4)(cid:12)(cid:2)(cid:28)(cid:3,,1251.0
,,44,,,Unknown,,cid:50)(cid:46)(cid:12)(cid:2)(cid:7)(cid:8)(cid:10)(cid:5)(cid:3)(cid:48)(cid:46)(cid:3)(cid:12)(cid:13)(cid:5)(cid:2)(cid:14)(cid:46)(cid:2)(cid:28)(cid:5)(cid:3)(cid:10)(cid:5)(cid:2)(cid:64)(cid:46)(cid:4)(cid:12)(cid:2)(cid:28)(cid:3,,1295.0
,,50,,,Unknown,,cid:50)(cid:46)(cid:12)(cid:2)(cid:7)(cid:8)(cid:10)(cid:5)(cid:3)(cid:48)(cid:46)(cid:3)(cid:12)(cid:13)(cid:5)(cid:2)(cid:14)(cid:46)(cid:2)(cid:28)(cid:5)(cid:3)(cid:10)(cid:5)(cid:2)(cid:64)(cid:46)(cid:4)(cid:12)(cid:2)(cid:28)(cid:3,,1345.0
,,42,,,Unknown,,cid:50)(cid:46)(cid:12)(cid:2)(cid:7)(cid:8)(cid:10)(cid:5)(cid:3)(cid:48)(cid:46)(cid:3)(cid:12)(cid:13)(cid:5)(cid:2)(cid:14)(cid:46)(cid:2)(cid:28)(cid:5)(cid:3)(cid:10)(cid:5)(cid:2)(cid:64)(cid:46)(cid:4)(cid:12)(cid:2)(cid:28)(cid:3,,1387.0
,,51,,,Unknown,,cid:50)(cid:46)(cid:12)(cid:2)(cid:7)(cid:8)(cid:10)(cid:5)(cid:3)(cid:48)(cid:46)(cid:3)(cid:12)(cid:13)(cid:5)(cid:2)(cid:14)(cid:46)(cid:2)(cid:28)(cid:5)(cid:3)(cid:10)(cid:5)(cid:2)(cid:64)(cid:46)(cid:4)(cid:12)(cid:2)(cid:28)(cid:3,,1438.0
,,52,,,Unknown,,cid:50)(cid:46)(cid:12)(cid:2)(cid:7)(cid:8)(cid:10)(cid:5)(cid:3)(cid:48)(cid:46)(cid:3)(cid:12)(cid:13)(cid:5)(cid:2)(cid:14)(cid:46)(cid:2)(cid:28)(cid:5)(cid:3)(cid:10)(cid:5)(cid:2)(cid:64)(cid:46)(cid:4)(cid:12)(cid:2)(cid:28)(cid:3,,1490.0
,,41,,,Unknown,,cid:50)(cid:46)(cid:12)(cid:2)(cid:7)(cid:8)(cid:10)(cid:5)(cid:3)(cid:48)(cid:46)(cid:3)(cid:12)(cid:13)(cid:5)(cid:2)(cid:14)(cid:46)(cid:2)(cid:28)(cid:5)(cid:3)(cid:10)(cid:5)(cid:2)(cid:64)(cid:46)(cid:4)(cid:12)(cid:2)(cid:28)(cid:3,,1531.0
,,2,,,Unknown,,cid:50)(cid:46)(cid:12)(cid:2)(cid:7)(cid:8)(cid:10)(cid:5)(cid:3)(cid:48)(cid:46)(cid:3)(cid:12)(cid:13)(cid:5)(cid:2)(cid:14)(cid:46)(cid:2)(cid:28)(cid:5)(cid:3)(cid:10)(cid:5)(cid:2)(cid:64)(cid:46)(cid:4)(cid:12)(cid:2)(cid:28)(cid:3,,1533.0
,,53,,,Unknown,,cid:50)(cid:46)(cid:12)(cid:2)(cid:7)(cid:8)(cid:10)(cid:5)(cid:3)(cid:48)(cid:46)(cid:3)(cid:12)(cid:13)(cid:5)(cid:2)(cid:14)(cid:46)(cid:2)(cid:28)(cid:5)(cid:3)(cid:10)(cid:5)(cid:2)(cid:64)(cid:46)(cid:4)(cid:12)(cid:2)(cid:28)(cid:3,,1586.0
,,25,,,Unknown,,cid:50)(cid:46)(cid:12)(cid:2)(cid:7)(cid:8)(cid:10)(cid:5)(cid:3)(cid:48)(cid:46)(cid:3)(cid:12)(cid:13)(cid:5)(cid:2)(cid:14)(cid:46)(cid:2)(cid:28)(cid:5)(cid:3)(cid:10)(cid:5)(cid:2)(cid:64)(cid:46)(cid:4)(cid:12)(cid:2)(cid:28)(cid:3,,1611.0
,,2,,,Unknown,,cid:50)(cid:46)(cid:12)(cid:2)(cid:7)(cid:8)(cid:10)(cid:5)(cid:3)(cid:48)(cid:46)(cid:3)(cid:12)(cid:13)(cid:5)(cid:2)(cid:14)(cid:46)(cid:2)(cid:28)(cid:5)(cid:3)(cid:10)(cid:5)(cid:2)(cid:64)(cid:46)(cid:4)(cid:12)(cid:2)(cid:28)(cid:3,,1613.0
,,31,,,Unknown,,cid:50)(cid:46)(cid:12)(cid:2)(cid:7)(cid:8)(cid:10)(cid:5)(cid:3)(cid:48)(cid:46)(cid:3)(cid:12)(cid:13)(cid:5)(cid:2)(cid:14)(cid:46)(cid:2)(cid:28)(cid:5)(cid:3)(cid:10)(cid:5)(cid:2)(cid:64)(cid:46)(cid:4)(cid:12)(cid:2)(cid:28)(cid:3,,1644.0
,,54,,,Unknown,,cid:50)(cid:46)(cid:12)(cid:2)(cid:7)(cid:8)(cid:10)(cid:5)(cid:3)(cid:48)(cid:46)(cid:3)(cid:12)(cid:13)(cid:5)(cid:2)(cid:14)(cid:46)(cid:2)(cid:28)(cid:5)(cid:3)(cid:10)(cid:5)(cid:2)(cid:64)(cid:46)(cid:4)(cid:12)(cid:2)(cid:28)(cid:3,,1698.0
,,55,,,Unknown,,cid:50)(cid:46)(cid:12)(cid:2)(cid:7)(cid:8)(cid:10)(cid:5)(cid:3)(cid:48)(cid:46)(cid:3)(cid:12)(cid:13)(cid:5)(cid:2)(cid:14)(cid:46)(cid:2)(cid:28)(cid:5)(cid:3)(cid:10)(cid:5)(cid:2)(cid:64)(cid:46)(cid:4)(cid:12)(cid:2)(cid:28)(cid:3,,1753.0
,,56,,,Unknown,,cid:50)(cid:46)(cid:12)(cid:2)(cid:7)(cid:8)(cid:10)(cid:5)(cid:3)(cid:48)(cid:46)(cid:3)(cid:12)(cid:13)(cid:5)(cid:2)(cid:14)(cid:46)(cid:2)(cid:28)(cid:5)(cid:3)(cid:10)(cid:5)(cid:2)(cid:64)(cid:46)(cid:4)(cid:12)(cid:2)(cid:28)(cid:3,,1809.0
,,21,,,Unknown,,cid:50)(cid:46)(cid:12)(cid:2)(cid:7)(cid:8)(cid:10)(cid:5)(cid:3)(cid:48)(cid:46)(cid:3)(cid:12)(cid:13)(cid:5)(cid:2)(cid:14)(cid:46)(cid:2)(cid:28)(cid:5)(cid:3)(cid:10)(cid:5)(cid:2)(cid:64)(cid:46)(cid:4)(cid:12)(cid:2)(cid:28)(cid:3,,1830.0
,,25,,,Unknown,,cid:50)(cid:46)(cid:12)(cid:2)(cid:7)(cid:8)(cid:10)(cid:5)(cid:3)(cid:48)(cid:46)(cid:3)(cid:12)(cid:13)(cid:5)(cid:2)(cid:14)(cid:46)(cid:2)(cid:28)(cid:5)(cid:3)(cid:10)(cid:5)(cid:2)(cid:64)(cid:46)(cid:4)(cid:12)(cid:2)(cid:28)(cid:3,,1855.0
,,18,,,Unknown,,cid:50)(cid:46)(cid:12)(cid:2)(cid:7)(cid:8)(cid:10)(cid:5)(cid:3)(cid:48)(cid:46)(cid:3)(cid:12)(cid:13)(cid:5)(cid:2)(cid:14)(cid:46)(cid:2)(cid:28)(cid:5)(cid:3)(cid:10)(cid:5)(cid:2)(cid:64)(cid:46)(cid:4)(cid:12)(cid:2)(cid:28)(cid:3,,1873.0
,,1,,,Unknown,,cid:50)(cid:46)(cid:12)(cid:2)(cid:7)(cid:8)(cid:10)(cid:5)(cid:3)(cid:48)(cid:46)(cid:3)(cid:12)(cid:13)(cid:5)(cid:2)(cid:14)(cid:46)(cid:2)(cid:28)(cid:5)(cid:3)(cid:10)(cid:5)(cid:2)(cid:64)(cid:46)(cid:4)(cid:12)(cid:2)(cid:28)(cid:3,,1874.0
,,45,,,Unknown,,cid:50)(cid:46)(cid:12)(cid:2)(cid:7)(cid:8)(cid:10)(cid:5)(cid:3)(cid:48)(cid:46)(cid:3)(cid:12)(cid:13)(cid:5)(cid:2)(cid:14)(cid:46)(cid:2)(cid:28)(cid:5)(cid:3)(cid:10)(cid:5)(cid:2)(cid:64)(cid:46)(cid:4)(cid:12)(cid:2)(cid:28)(cid:3,,1919.0
,,18,,,Unknown,,cid:50)(cid:46)(cid:12)(cid:2)(cid:7)(cid:8)(cid:10)(cid:5)(cid:3)(cid:48)(cid:46)(cid:3)(cid:12)(cid:13)(cid:5)(cid:2)(cid:14)(cid:46)(cid:2)(cid:28)(cid:5)(cid:3)(cid:10)(cid:5)(cid:2)(cid:64)(cid:46)(cid:4)(cid:12)(cid:2)(cid:28)(cid:3,,1937.0
,,16,,,Unknown,,cid:50)(cid:46)(cid:12)(cid:2)(cid:7)(cid:8)(cid:10)(cid:5)(cid:3)(cid:48)(cid:46)(cid:3)(cid:12)(cid:13)(cid:5)(cid:2)(cid:14)(cid:46)(cid:2)(cid:28)(cid:5)(cid:3)(cid:10)(cid:5)(cid:2)(cid:64)(cid:46)(cid:4)(cid:12)(cid:2)(cid:28)(cid:3,,1953.0
,,38,,,Unknown,,cid:50)(cid:46)(cid:12)(cid:2)(cid:7)(cid:8)(cid:10)(cid:5)(cid:3)(cid:48)(cid:46)(cid:3)(cid:12)(cid:13)(cid:5)(cid:2)(cid:14)(cid:46)(cid:2)(cid:28)(cid:5)(cid:3)(cid:10)(cid:5)(cid:2)(cid:64)(cid:46)(cid:4)(cid:12)(cid:2)(cid:28)(cid:3,,1991.0
,,20,,,Unknown,,cid:50)(cid:46)(cid:12)(cid:2)(cid:7)(cid:8)(cid:10)(cid:5)(cid:3)(cid:48)(cid:46)(cid:3)(cid:12)(cid:13)(cid:5)(cid:2)(cid:14)(cid:46)(cid:2)(cid:28)(cid:5)(cid:3)(cid:10)(cid:5)(cid:2)(cid:64)(cid:46)(cid:4)(cid:12)(cid:2)(cid:28)(cid:3,,2011.0
,,30,,,Unknown,,cid:50)(cid:46)(cid:12)(cid:2)(cid:7)(cid:8)(cid:10)(cid:5)(cid:3)(cid:48)(cid:46)(cid:3)(cid:12)(cid:13)(cid:5)(cid:2)(cid:14)(cid:46)(cid:2)(cid:28)(cid:5)(cid:3)(cid:10)(cid:5)(cid:2)(cid:64)(cid:46)(cid:4)(cid:12)(cid:2)(cid:28)(cid:3,,2041.0
,,41,,,Unknown,,cid:50)(cid:46)(cid:12)(cid:2)(cid:7)(cid:8)(cid:10)(cid:5)(cid:3)(cid:48)(cid:46)(cid:3)(cid:12)(cid:13)(cid:5)(cid:2)(cid:14)(cid:46)(cid:2)(cid:28)(cid:5)(cid:3)(cid:10)(cid:5)(cid:2)(cid:64)(cid:46)(cid:4)(cid:12)(cid:2)(cid:28)(cid:3,,2082.0
,,20,,,Unknown,,cid:50)(cid:46)(cid:12)(cid:2)(cid:7)(cid:8)(cid:10)(cid:5)(cid:3)(cid:48)(cid:46)(cid:3)(cid:12)(cid:13)(cid:5)(cid:2)(cid:14)(cid:46)(cid:2)(cid:28)(cid:5)(cid:3)(cid:10)(cid:5)(cid:2)(cid:64)(cid:46)(cid:4)(cid:12)(cid:2)(cid:28)(cid:3,,2102.0
,,15,,,Unknown,,cid:50)(cid:46)(cid:12)(cid:2)(cid:7)(cid:8)(cid:10)(cid:5)(cid:3)(cid:48)(cid:46)(cid:3)(cid:12)(cid:13)(cid:5)(cid:2)(cid:14)(cid:46)(cid:2)(cid:28)(cid:5)(cid:3)(cid:10)(cid:5)(cid:2)(cid:64)(cid:46)(cid:4)(cid:12)(cid:2)(cid:28)(cid:3,,2117.0
,,2,,,Unknown,,cid:50)(cid:46)(cid:12)(cid:2)(cid:7)(cid:8)(cid:10)(cid:5)(cid:3)(cid:48)(cid:46)(cid:3)(cid:12)(cid:13)(cid:5)(cid:2)(cid:14)(cid:46)(cid:2)(cid:28)(cid:5)(cid:3)(cid:10)(cid:5)(cid:2)(cid:64)(cid:46)(cid:4)(cid:12)(cid:2)(cid:28)(cid:3,,2119.0
,,36,,,Unknown,,cid:50)(cid:46)(cid:12)(cid:2)(cid:7)(cid:8)(cid:10)(cid:5)(cid:3)(cid:48)(cid:46)(cid:3)(cid:12)(cid:13)(cid:5)(cid:2)(cid:14)(cid:46)(cid:2)(cid:28)(cid:5)(cid:3)(cid:10)(cid:5)(cid:2)(cid:64)(cid:46)(cid:4)(cid:12)(cid:2)(cid:28)(cid:3,,2155.0
,,1,,,Unknown,,cid:50)(cid:46)(cid:12)(cid:2)(cid:7)(cid:8)(cid:10)(cid:5)(cid:3)(cid:48)(cid:46)(cid:3)(cid:12)(cid:13)(cid:5)(cid:2)(cid:14)(cid:46)(cid:2)(cid:28)(cid:5)(cid:3)(cid:10)(cid:5)(cid:2)(cid:64)(cid:46)(cid:4)(cid:12)(cid:2)(cid:28)(cid:3,,2156.0
,,19,,,Unknown,,cid:50)(cid:46)(cid:12)(cid:2)(cid:7)(cid:8)(cid:10)(cid:5)(cid:3)(cid:48)(cid:46)(cid:3)(cid:12)(cid:13)(cid:5)(cid:2)(cid:14)(cid:46)(cid:2)(cid:28)(cid:5)(cid:3)(cid:10)(cid:5)(cid:2)(cid:64)(cid:46)(cid:4)(cid:12)(cid:2)(cid:28)(cid:3,,2175.0
,,18,,,Unknown,,cid:50)(cid:46)(cid:12)(cid:2)(cid:7)(cid:8)(cid:10)(cid:5)(cid:3)(cid:48)(cid:46)(cid:3)(cid:12)(cid:13)(cid:5)(cid:2)(cid:14)(cid:46)(cid:2)(cid:28)(cid:5)(cid:3)(cid:10)(cid:5)(cid:2)(cid:64)(cid:46)(cid:4)(cid:12)(cid:2)(cid:28)(cid:3,,2193.0
,,18,,,Unknown,,cid:50)(cid:46)(cid:12)(cid:2)(cid:7)(cid:8)(cid:10)(cid:5)(cid:3)(cid:48)(cid:46)(cid:3)(cid:12)(cid:13)(cid:5)(cid:2)(cid:14)(cid:46)(cid:2)(cid:28)(cid:5)(cid:3)(cid:10)(cid:5)(cid:2)(cid:64)(cid:46)(cid:4)(cid:12)(cid:2)(cid:28)(cid:3,,2211.0
,,2,,,Unknown,,cid:50)(cid:46)(cid:12)(cid:2)(cid:7)(cid:8)(cid:10)(cid:5)(cid:3)(cid:48)(cid:46)(cid:3)(cid:12)(cid:13)(cid:5)(cid:2)(cid:14)(cid:46)(cid:2)(cid:28)(cid:5)(cid:3)(cid:10)(cid:5)(cid:2)(cid:64)(cid:46)(cid:4)(cid:12)(cid:2)(cid:28)(cid:3,,2213.0
,,44,,,Unknown,,cid:50)(cid:46)(cid:12)(cid:2)(cid:7)(cid:8)(cid:10)(cid:5)(cid:3)(cid:48)(cid:46)(cid:3)(cid:12)(cid:13)(cid:5)(cid:2)(cid:14)(cid:46)(cid:2)(cid:28)(cid:5)(cid:3)(cid:10)(cid:5)(cid:2)(cid:64)(cid:46)(cid:4)(cid:12)(cid:2)(cid:28)(cid:3,,2257.0
,,46,,,Unknown,,cid:50)(cid:46)(cid:12)(cid:2)(cid:7)(cid:8)(cid:10)(cid:5)(cid:3)(cid:48)(cid:46)(cid:3)(cid:12)(cid:13)(cid:5)(cid:2)(cid:14)(cid:46)(cid:2)(cid:28)(cid:5)(cid:3)(cid:10)(cid:5)(cid:2)(cid:64)(cid:46)(cid:4)(cid:12)(cid:2)(cid:28)(cid:3,,2303.0
,,57,,,Unknown,,cid:50)(cid:46)(cid:12)(cid:2)(cid:7)(cid:8)(cid:10)(cid:5)(cid:3)(cid:48)(cid:46)(cid:3)(cid:12)(cid:13)(cid:5)(cid:2)(cid:14)(cid:46)(cid:2)(cid:28)(cid:5)(cid:3)(cid:10)(cid:5)(cid:2)(cid:64)(cid:46)(cid:4)(cid:12)(cid:2)(cid:28)(cid:3,,2360.0
,,20,,,Unknown,,cid:50)(cid:46)(cid:12)(cid:2)(cid:7)(cid:8)(cid:10)(cid:5)(cid:3)(cid:48)(cid:46)(cid:3)(cid:12)(cid:13)(cid:5)(cid:2)(cid:14)(cid:46)(cid:2)(cid:28)(cid:5)(cid:3)(cid:10)(cid:5)(cid:2)(cid:64)(cid:46)(cid:4)(cid:12)(cid:2)(cid:28)(cid:3,,2380.0
,,30,,,Unknown,,cid:50)(cid:46)(cid:12)(cid:2)(cid:7)(cid:8)(cid:10)(cid:5)(cid:3)(cid:48)(cid:46)(cid:3)(cid:12)(cid:13)(cid:5)(cid:2)(cid:14)(cid:46)(cid:2)(cid:28)(cid:5)(cid:3)(cid:10)(cid:5)(cid:2)(cid:64)(cid:46)(cid:4)(cid:12)(cid:2)(cid:28)(cid:3,,2410.0
,,30,,,Unknown,,cid:50)(cid:46)(cid:12)(cid:2)(cid:7)(cid:8)(cid:10)(cid:5)(cid:3)(cid:48)(cid:46)(cid:3)(cid:12)(cid:13)(cid:5)(cid:2)(cid:14)(cid:46)(cid:2)(cid:28)(cid:5)(cid:3)(cid:10)(cid:5)(cid:2)(cid:64)(cid:46)(cid:4)(cid:12)(cid:2)(cid:28)(cid:3,,2440.0
,,25,,,Unknown,,cid:50)(cid:46)(cid:12)(cid:2)(cid:7)(cid:8)(cid:10)(cid:5)(cid:3)(cid:48)(cid:46)(cid:3)(cid:12)(cid:13)(cid:5)(cid:2)(cid:14)(cid:46)(cid:2)(cid:28)(cid:5)(cid:3)(cid:10)(cid:5)(cid:2)(cid:64)(cid:46)(cid:4)(cid:12)(cid:2)(cid:28)(cid:3,,2465.0
,,23,,,Unknown,,cid:50)(cid:46)(cid:12)(cid:2)(cid:7)(cid:8)(cid:10)(cid:5)(cid:3)(cid:48)(cid:46)(cid:3)(cid:12)(cid:13)(cid:5)(cid:2)(cid:14)(cid:46)(cid:2)(cid:28)(cid:5)(cid:3)(cid:10)(cid:5)(cid:2)(cid:64)(cid:46)(cid:4)(cid:12)(cid:2)(cid:28)(cid:3,,2488.0
,,25,,,Unknown,,cid:50)(cid:46)(cid:12)(cid:2)(cid:7)(cid:8)(cid:10)(cid:5)(cid:3)(cid:48)(cid:46)(cid:3)(cid:12)(cid:13)(cid:5)(cid:2)(cid:14)(cid:46)(cid:2)(cid:28)(cid:5)(cid:3)(cid:10)(cid:5)(cid:2)(cid:64)(cid:46)(cid:4)(cid:12)(cid:2)(cid:28)(cid:3,,2513.0
,,30,,,Unknown,,cid:50)(cid:46)(cid:12)(cid:2)(cid:7)(cid:8)(cid:10)(cid:5)(cid:3)(cid:48)(cid:46)(cid:3)(cid:12)(cid:13)(cid:5)(cid:2)(cid:14)(cid:46)(cid:2)(cid:28)(cid:5)(cid:3)(cid:10)(cid:5)(cid:2)(cid:64)(cid:46)(cid:4)(cid:12)(cid:2)(cid:28)(cid:3,,2543.0
,,41,,,Unknown,,cid:50)(cid:46)(cid:12)(cid:2)(cid:7)(cid:8)(cid:10)(cid:5)(cid:3)(cid:48)(cid:46)(cid:3)(cid:12)(cid:13)(cid:5)(cid:2)(cid:14)(cid:46)(cid:2)(cid:28)(cid:5)(cid:3)(cid:10)(cid:5)(cid:2)(cid:64)(cid:46)(cid:4)(cid:12)(cid:2)(cid:28)(cid:3,,2584.0
,,2,,,Unknown,,cid:50)(cid:46)(cid:12)(cid:2)(cid:7)(cid:8)(cid:10)(cid:5)(cid:3)(cid:48)(cid:46)(cid:3)(cid:12)(cid:13)(cid:5)(cid:2)(cid:14)(cid:46)(cid:2)(cid:28)(cid:5)(cid:3)(cid:10)(cid:5)(cid:2)(cid:64)(cid:46)(cid:4)(cid:12)(cid:2)(cid:28)(cid:3,,2586.0
,,45,,,Unknown,,cid:50)(cid:46)(cid:12)(cid:2)(cid:7)(cid:8)(cid:10)(cid:5)(cid:3)(cid:48)(cid:46)(cid:3)(cid:12)(cid:13)(cid:5)(cid:2)(cid:14)(cid:46)(cid:2)(cid:28)(cid:5)(cid:3)(cid:10)(cid:5)(cid:2)(cid:64)(cid:46)(cid:4)(cid:12)(cid:2)(cid:28)(cid:3,,2631.0
,,2,,,Unknown,,cid:50)(cid:46)(cid:12)(cid:2)(cid:7)(cid:8)(cid:10)(cid:5)(cid:3)(cid:48)(cid:46)(cid:3)(cid:12)(cid:13)(cid:5)(cid:2)(cid:14)(cid:46)(cid:2)(cid:28)(cid:5)(cid:3)(cid:10)(cid:5)(cid:2)(cid:64)(cid:46)(cid:4)(cid:12)(cid:2)(cid:28)(cid:3,,2633.0
,,28,,,Unknown,,cid:50)(cid:46)(cid:12)(cid:2)(cid:7)(cid:8)(cid:10)(cid:5)(cid:3)(cid:48)(cid:46)(cid:3)(cid:12)(cid:13)(cid:5)(cid:2)(cid:14)(cid:46)(cid:2)(cid:28)(cid:5)(cid:3)(cid:10)(cid:5)(cid:2)(cid:64)(cid:46)(cid:4)(cid:12)(cid:2)(cid:28)(cid:3,,2661.0
,,26,,,Unknown,,cid:50)(cid:46)(cid:12)(cid:2)(cid:7)(cid:8)(cid:10)(cid:5)(cid:3)(cid:48)(cid:46)(cid:3)(cid:12)(cid:13)(cid:5)(cid:2)(cid:14)(cid:46)(cid:2)(cid:28)(cid:5)(cid:3)(cid:10)(cid:5)(cid:2)(cid:64)(cid:46)(cid:4)(cid:12)(cid:2)(cid:28)(cid:3,,2687.0
,,29,,,Unknown,,cid:50)(cid:46)(cid:12)(cid:2)(cid:7)(cid:8)(cid:10)(cid:5)(cid:3)(cid:48)(cid:46)(cid:3)(cid:12)(cid:13)(cid:5)(cid:2)(cid:14)(cid:46)(cid:2)(cid:28)(cid:5)(cid:3)(cid:10)(cid:5)(cid:2)(cid:64)(cid:46)(cid:4)(cid:12)(cid:2)(cid:28)(cid:3,,2716.0
,,24,,,Unknown,,cid:50)(cid:46)(cid:12)(cid:2)(cid:7)(cid:8)(cid:10)(cid:5)(cid:3)(cid:48)(cid:46)(cid:3)(cid:12)(cid:13)(cid:5)(cid:2)(cid:14)(cid:46)(cid:2)(cid:28)(cid:5)(cid:3)(cid:10)(cid:5)(cid:2)(cid:64)(cid:46)(cid:4)(cid:12)(cid:2)(cid:28)(cid:3,,2740.0
,,27,,,Unknown,,cid:50)(cid:46)(cid:12)(cid:2)(cid:7)(cid:8)(cid:10)(cid:5)(cid:3)(cid:48)(cid:46)(cid:3)(cid:12)(cid:13)(cid:5)(cid:2)(cid:14)(cid:46)(cid:2)(cid:28)(cid:5)(cid:3)(cid:10)(cid:5)(cid:2)(cid:64)(cid:46)(cid:4)(cid:12)(cid:2)(cid:28)(cid:3,,2767.0
,,2,,,Unknown,,cid:50)(cid:46)(cid:12)(cid:2)(cid:7)(cid:8)(cid:10)(cid:5)(cid:3)(cid:48)(cid:46)(cid:3)(cid:12)(cid:13)(cid:5)(cid:2)(cid:14)(cid:46)(cid:2)(cid:28)(cid:5)(cid:3)(cid:10)(cid:5)(cid:2)(cid:64)(cid:46)(cid:4)(cid:12)(cid:2)(cid:28)(cid:3,,2769.0
,,29,,,Unknown,,cid:50)(cid:46)(cid:12)(cid:2)(cid:7)(cid:8)(cid:10)(cid:5)(cid:3)(cid:48)(cid:46)(cid:3)(cid:12)(cid:13)(cid:5)(cid:2)(cid:14)(cid:46)(cid:2)(cid:28)(cid:5)(cid:3)(cid:10)(cid:5)(cid:2)(cid:64)(cid:46)(cid:4)(cid:12)(cid:2)(cid:28)(cid:3,,2798.0
,,53,,,Unknown,,cid:50)(cid:46)(cid:12)(cid:2)(cid:7)(cid:8)(cid:10)(cid:5)(cid:3)(cid:48)(cid:46)(cid:3)(cid:12)(cid:13)(cid:5)(cid:2)(cid:14)(cid:46)(cid:2)(cid:28)(cid:5)(cid:3)(cid:10)(cid:5)(cid:2)(cid:64)(cid:46)(cid:4)(cid:12)(cid:2)(cid:28)(cid:3,,2851.0
,,53,,,Unknown,,cid:50)(cid:46)(cid:12)(cid:2)(cid:7)(cid:8)(cid:10)(cid:5)(cid:3)(cid:48)(cid:46)(cid:3)(cid:12)(cid:13)(cid:5)(cid:2)(cid:14)(cid:46)(cid:2)(cid:28)(cid:5)(cid:3)(cid:10)(cid:5)(cid:2)(cid:64)(cid:46)(cid:4)(cid:12)(cid:2)(cid:28)(cid:3,,2904.0
,,24,,,Unknown,,cid:50)(cid:46)(cid:12)(cid:2)(cid:7)(cid:8)(cid:10)(cid:5)(cid:3)(cid:48)(cid:46)(cid:3)(cid:12)(cid:13)(cid:5)(cid:2)(cid:14)(cid:46)(cid:2)(cid:28)(cid:5)(cid:3)(cid:10)(cid:5)(cid:2)(cid:64)(cid:46)(cid:4)(cid:12)(cid:2)(cid:28)(cid:3,,2928.0
,,41,,,Unknown,,cid:50)(cid:46)(cid:12)(cid:2)(cid:7)(cid:8)(cid:10)(cid:5)(cid:3)(cid:48)(cid:46)(cid:3)(cid:12)(cid:13)(cid:5)(cid:2)(cid:14)(cid:46)(cid:2)(cid:28)(cid:5)(cid:3)(cid:10)(cid:5)(cid:2)(cid:64)(cid:46)(cid:4)(cid:12)(cid:2)(cid:28)(cid:3,,2969.0
,,24,,,Unknown,,cid:50)(cid:46)(cid:12)(cid:2)(cid:7)(cid:8)(cid:10)(cid:5)(cid:3)(cid:48)(cid:46)(cid:3)(cid:12)(cid:13)(cid:5)(cid:2)(cid:14)(cid:46)(cid:2)(cid:28)(cid:5)(cid:3)(cid:10)(cid:5)(cid:2)(cid:64)(cid:46)(cid:4)(cid:12)(cid:2)(cid:28)(cid:3,,2993.0
,,20,,,Unknown,,cid:50)(cid:46)(cid:12)(cid:2)(cid:7)(cid:8)(cid:10)(cid:5)(cid:3)(cid:48)(cid:46)(cid:3)(cid:12)(cid:13)(cid:5)(cid:2)(cid:14)(cid:46)(cid:2)(cid:28)(cid:5)(cid:3)(cid:10)(cid:5)(cid:2)(cid:64)(cid:46)(cid:4)(cid:12)(cid:2)(cid:28)(cid:3,,3013.0
,,30,,,Unknown,,cid:50)(cid:46)(cid:12)(cid:2)(cid:7)(cid:8)(cid:10)(cid:5)(cid:3)(cid:48)(cid:46)(cid:3)(cid:12)(cid:13)(cid:5)(cid:2)(cid:14)(cid:46)(cid:2)(cid:28)(cid:5)(cid:3)(cid:10)(cid:5)(cid:2)(cid:64)(cid:46)(cid:4)(cid:12)(cid:2)(cid:28)(cid:3,,3043.0
,,30,,,Unknown,,cid:50)(cid:46)(cid:12)(cid:2)(cid:7)(cid:8)(cid:10)(cid:5)(cid:3)(cid:48)(cid:46)(cid:3)(cid:12)(cid:13)(cid:5)(cid:2)(cid:14)(cid:46)(cid:2)(cid:28)(cid:5)(cid:3)(cid:10)(cid:5)(cid:2)(cid:64)(cid:46)(cid:4)(cid:12)(cid:2)(cid:28)(cid:3,,3073.0
,,25,,,Unknown,,cid:50)(cid:46)(cid:12)(cid:2)(cid:7)(cid:8)(cid:10)(cid:5)(cid:3)(cid:48)(cid:46)(cid:3)(cid:12)(cid:13)(cid:5)(cid:2)(cid:14)(cid:46)(cid:2)(cid:28)(cid:5)(cid:3)(cid:10)(cid:5)(cid:2)(cid:64)(cid:46)(cid:4)(cid:12)(cid:2)(cid:28)(cid:3,,3098.0
,,22,,,Unknown,,cid:50)(cid:46)(cid:12)(cid:2)(cid:7)(cid:8)(cid:10)(cid:5)(cid:3)(cid:48)(cid:46)(cid:3)(cid:12)(cid:13)(cid:5)(cid:2)(cid:14)(cid:46)(cid:2)(cid:28)(cid:5)(cid:3)(cid:10)(cid:5)(cid:2)(cid:64)(cid:46)(cid:4)(cid:12)(cid:2)(cid:28)(cid:3,,3120.0
,,27,,,Unknown,,cid:50)(cid:46)(cid:12)(cid:2)(cid:7)(cid:8)(cid:10)(cid:5)(cid:3)(cid:48)(cid:46)(cid:3)(cid:12)(cid:13)(cid:5)(cid:2)(cid:14)(cid:46)(cid:2)(cid:28)(cid:5)(cid:3)(cid:10)(cid:5)(cid:2)(cid:64)(cid:46)(cid:4)(cid:12)(cid:2)(cid:28)(cid:3,,3147.0
,,18,,,Unknown,,cid:50)(cid:46)(cid:12)(cid:2)(cid:7)(cid:8)(cid:10)(cid:5)(cid:3)(cid:48)(cid:46)(cid:3)(cid:12)(cid:13)(cid:5)(cid:2)(cid:14)(cid:46)(cid:2)(cid:28)(cid:5)(cid:3)(cid:10)(cid:5)(cid:2)(cid:64)(cid:46)(cid:4)(cid:12)(cid:2)(cid:28)(cid:3,,3165.0
,,1,,,Unknown,,cid:50)(cid:46)(cid:12)(cid:2)(cid:7)(cid:8)(cid:10)(cid:5)(cid:3)(cid:48)(cid:46)(cid:3)(cid:12)(cid:13)(cid:5)(cid:2)(cid:14)(cid:46)(cid:2)(cid:28)(cid:5)(cid:3)(cid:10)(cid:5)(cid:2)(cid:64)(cid:46)(cid:4)(cid:12)(cid:2)(cid:28)(cid:3,,3166.0
,,45,,,Unknown,,cid:50)(cid:46)(cid:12)(cid:2)(cid:7)(cid:8)(cid:10)(cid:5)(cid:3)(cid:48)(cid:46)(cid:3)(cid:12)(cid:13)(cid:5)(cid:2)(cid:14)(cid:46)(cid:2)(cid:28)(cid:5)(cid:3)(cid:10)(cid:5)(cid:2)(cid:64)(cid:46)(cid:4)(cid:12)(cid:2)(cid:28)(cid:3,,3211.0
,,18,,,Unknown,,cid:50)(cid:46)(cid:12)(cid:2)(cid:7)(cid:8)(cid:10)(cid:5)(cid:3)(cid:48)(cid:46)(cid:3)(cid:12)(cid:13)(cid:5)(cid:2)(cid:14)(cid:46)(cid:2)(cid:28)(cid:5)(cid:3)(cid:10)(cid:5)(cid:2)(cid:64)(cid:46)(cid:4)(cid:12)(cid:2)(cid:28)(cid:3,,3229.0
,,16,,,Unknown,,cid:50)(cid:46)(cid:12)(cid:2)(cid:7)(cid:8)(cid:10)(cid:5)(cid:3)(cid:48)(cid:46)(cid:3)(cid:12)(cid:13)(cid:5)(cid:2)(cid:14)(cid:46)(cid:2)(cid:28)(cid:5)(cid:3)(cid:10)(cid:5)(cid:2)(cid:64)(cid:46)(cid:4)(cid:12)(cid:2)(cid:28)(cid:3,,3245.0
,,38,,,Unknown,,cid:50)(cid:46)(cid:12)(cid:2)(cid:7)(cid:8)(cid:10)(cid:5)(cid:3)(cid:48)(cid:46)(cid:3)(cid:12)(cid:13)(cid:5)(cid:2)(cid:14)(cid:46)(cid:2)(cid:28)(cid:5)(cid:3)(cid:10)(cid:5)(cid:2)(cid:64)(cid:46)(cid:4)(cid:12)(cid:2)(cid:28)(cid:3,,3283.0
,,20,,,Unknown,,cid:50)(cid:46)(cid:12)(cid:2)(cid:7)(cid:8)(cid:10)(cid:5)(cid:3)(cid:48)(cid:46)(cid:3)(cid:12)(cid:13)(cid:5)(cid:2)(cid:14)(cid:46)(cid:2)(cid:28)(cid:5)(cid:3)(cid:10)(cid:5)(cid:2)(cid:64)(cid:46)(cid:4)(cid:12)(cid:2)(cid:28)(cid:3,,3303.0
,,30,,,Unknown,,cid:50)(cid:46)(cid:12)(cid:2)(cid:7)(cid:8)(cid:10)(cid:5)(cid:3)(cid:48)(cid:46)(cid:3)(cid:12)(cid:13)(cid:5)(cid:2)(cid:14)(cid:46)(cid:2)(cid:28)(cid:5)(cid:3)(cid:10)(cid:5)(cid:2)(cid:64)(cid:46)(cid:4)(cid:12)(cid:2)(cid:28)(cid:3,,3333.0
,,41,,,Unknown,,cid:50)(cid:46)(cid:12)(cid:2)(cid:7)(cid:8)(cid:10)(cid:5)(cid:3)(cid:48)(cid:46)(cid:3)(cid:12)(cid:13)(cid:5)(cid:2)(cid:14)(cid:46)(cid:2)(cid:28)(cid:5)(cid:3)(cid:10)(cid:5)(cid:2)(cid:64)(cid:46)(cid:4)(cid:12)(cid:2)(cid:28)(cid:3,,3374.0
,,20,,,Unknown,,cid:50)(cid:46)(cid:12)(cid:2)(cid:7)(cid:8)(cid:10)(cid:5)(cid:3)(cid:48)(cid:46)(cid:3)(cid:12)(cid:13)(cid:5)(cid:2)(cid:14)(cid:46)(cid:2)(cid:28)(cid:5)(cid:3)(cid:10)(cid:5)(cid:2)(cid:64)(cid:46)(cid:4)(cid:12)(cid:2)(cid:28)(cid:3,,3394.0
,,15,,,Unknown,,cid:50)(cid:46)(cid:12)(cid:2)(cid:7)(cid:8)(cid:10)(cid:5)(cid:3)(cid:48)(cid:46)(cid:3)(cid:12)(cid:13)(cid:5)(cid:2)(cid:14)(cid:46)(cid:2)(cid:28)(cid:5)(cid:3)(cid:10)(cid:5)(cid:2)(cid:64)(cid:46)(cid:4)(cid:12)(cid:2)(cid:28)(cid:3,,3409.0
,,2,,,Unknown,,cid:50)(cid:46)(cid:12)(cid:2)(cid:7)(cid:8)(cid:10)(cid:5)(cid:3)(cid:48)(cid:46)(cid:3)(cid:12)(cid:13)(cid:5)(cid:2)(cid:14)(cid:46)(cid:2)(cid:28)(cid:5)(cid:3)(cid:10)(cid:5)(cid:2)(cid:64)(cid:46)(cid:4)(cid:12)(cid:2)(cid:28)(cid:3,,3411.0
,,1,,,Unknown,,cid:50)(cid:46)(cid:12)(cid:2)(cid:7)(cid:8)(cid:10)(cid:5)(cid:3)(cid:48)(cid:46)(cid:3)(cid:12)(cid:13)(cid:5)(cid:2)(cid:14)(cid:46)(cid:2)(cid:28)(cid:5)(cid:3)(cid:10)(cid:5)(cid:2)(cid:64)(cid:46)(cid:4)(cid:12)(cid:2)(cid:28)(cid:3,,3412.0
,,19,,,Unknown,,cid:50)(cid:46)(cid:12)(cid:2)(cid:7)(cid:8)(cid:10)(cid:5)(cid:3)(cid:48)(cid:46)(cid:3)(cid:12)(cid:13)(cid:5)(cid:2)(cid:14)(cid:46)(cid:2)(cid:28)(cid:5)(cid:3)(cid:10)(cid:5)(cid:2)(cid:64)(cid:46)(cid:4)(cid:12)(cid:2)(cid:28)(cid:3,,3431.0
,,36,,,Unknown,,cid:50)(cid:46)(cid:12)(cid:2)(cid:7)(cid:8)(cid:10)(cid:5)(cid:3)(cid:48)(cid:46)(cid:3)(cid:12)(cid:13)(cid:5)(cid:2)(cid:14)(cid:46)(cid:2)(cid:28)(cid:5)(cid:3)(cid:10)(cid:5)(cid:2)(cid:64)(cid:46)(cid:4)(cid:12)(cid:2)(cid:28)(cid:3,,3467.0
,,18,,,Unknown,,cid:50)(cid:46)(cid:12)(cid:2)(cid:7)(cid:8)(cid:10)(cid:5)(cid:3)(cid:48)(cid:46)(cid:3)(cid:12)(cid:13)(cid:5)(cid:2)(cid:14)(cid:46)(cid:2)(cid:28)(cid:5)(cid:3)(cid:10)(cid:5)(cid:2)(cid:64)(cid:46)(cid:4)(cid:12)(cid:2)(cid:28)(cid:3,,3485.0
,,2,,,Unknown,,cid:50)(cid:46)(cid:12)(cid:2)(cid:7)(cid:8)(cid:10)(cid:5)(cid:3)(cid:48)(cid:46)(cid:3)(cid:12)(cid:13)(cid:5)(cid:2)(cid:14)(cid:46)(cid:2)(cid:28)(cid:5)(cid:3)(cid:10)(cid:5)(cid:2)(cid:64)(cid:46)(cid:4)(cid:12)(cid:2)(cid:28)(cid:3,,3487.0
,,44,,,Unknown,,cid:50)(cid:46)(cid:12)(cid:2)(cid:7)(cid:8)(cid:10)(cid:5)(cid:3)(cid:48)(cid:46)(cid:3)(cid:12)(cid:13)(cid:5)(cid:2)(cid:14)(cid:46)(cid:2)(cid:28)(cid:5)(cid:3)(cid:10)(cid:5)(cid:2)(cid:64)(cid:46)(cid:4)(cid:12)(cid:2)(cid:28)(cid:3,,3531.0
,,46,,,Unknown,,cid:50)(cid:46)(cid:12)(cid:2)(cid:7)(cid:8)(cid:10)(cid:5)(cid:3)(cid:48)(cid:46)(cid:3)(cid:12)(cid:13)(cid:5)(cid:2)(cid:14)(cid:46)(cid:2)(cid:28)(cid:5)(cid:3)(cid:10)(cid:5)(cid:2)(cid:64)(cid:46)(cid:4)(cid:12)(cid:2)(cid:28)(cid:3,,3577.0
,,57,,,Unknown,,cid:50)(cid:46)(cid:12)(cid:2)(cid:7)(cid:8)(cid:10)(cid:5)(cid:3)(cid:48)(cid:46)(cid:3)(cid:12)(cid:13)(cid:5)(cid:2)(cid:14)(cid:46)(cid:2)(cid:28)(cid:5)(cid:3)(cid:10)(cid:5)(cid:2)(cid:64)(cid:46)(cid:4)(cid:12)(cid:2)(cid:28)(cid:3,,3634.0
,,20,,,Unknown,,cid:50)(cid:46)(cid:12)(cid:2)(cid:7)(cid:8)(cid:10)(cid:5)(cid:3)(cid:48)(cid:46)(cid:3)(cid:12)(cid:13)(cid:5)(cid:2)(cid:14)(cid:46)(cid:2)(cid:28)(cid:5)(cid:3)(cid:10)(cid:5)(cid:2)(cid:64)(cid:46)(cid:4)(cid:12)(cid:2)(cid:28)(cid:3,,3654.0
,,30,,,Unknown,,cid:50)(cid:46)(cid:12)(cid:2)(cid:7)(cid:8)(cid:10)(cid:5)(cid:3)(cid:48)(cid:46)(cid:3)(cid:12)(cid:13)(cid:5)(cid:2)(cid:14)(cid:46)(cid:2)(cid:28)(cid:5)(cid:3)(cid:10)(cid:5)(cid:2)(cid:64)(cid:46)(cid:4)(cid:12)(cid:2)(cid:28)(cid:3,,3684.0
,,30,,,Unknown,,cid:50)(cid:46)(cid:12)(cid:2)(cid:7)(cid:8)(cid:10)(cid:5)(cid:3)(cid:48)(cid:46)(cid:3)(cid:12)(cid:13)(cid:5)(cid:2)(cid:14)(cid:46)(cid:2)(cid:28)(cid:5)(cid:3)(cid:10)(cid:5)(cid:2)(cid:64)(cid:46)(cid:4)(cid:12)(cid:2)(cid:28)(cid:3,,3714.0
,,25,,,Unknown,,cid:50)(cid:46)(cid:12)(cid:2)(cid:7)(cid:8)(cid:10)(cid:5)(cid:3)(cid:48)(cid:46)(cid:3)(cid:12)(cid:13)(cid:5)(cid:2)(cid:14)(cid:46)(cid:2)(cid:28)(cid:5)(cid:3)(cid:10)(cid:5)(cid:2)(cid:64)(cid:46)(cid:4)(cid:12)(cid:2)(cid:28)(cid:3,,3739.0
,,23,,,Unknown,,cid:50)(cid:46)(cid:12)(cid:2)(cid:7)(cid:8)(cid:10)(cid:5)(cid:3)(cid:48)(cid:46)(cid:3)(cid:12)(cid:13)(cid:5)(cid:2)(cid:14)(cid:46)(cid:2)(cid:28)(cid:5)(cid:3)(cid:10)(cid:5)(cid:2)(cid:64)(cid:46)(cid:4)(cid:12)(cid:2)(cid:28)(cid:3,,3762.0
,,25,,,Unknown,,cid:50)(cid:46)(cid:12)(cid:2)(cid:7)(cid:8)(cid:10)(cid:5)(cid:3)(cid:48)(cid:46)(cid:3)(cid:12)(cid:13)(cid:5)(cid:2)(cid:14)(cid:46)(cid:2)(cid:28)(cid:5)(cid:3)(cid:10)(cid:5)(cid:2)(cid:64)(cid:46)(cid:4)(cid:12)(cid:2)(cid:28)(cid:3,,3787.0
,,30,,,Unknown,,cid:50)(cid:46)(cid:12)(cid:2)(cid:7)(cid:8)(cid:10)(cid:5)(cid:3)(cid:48)(cid:46)(cid:3)(cid:12)(cid:13)(cid:5)(cid:2)(cid:14)(cid:46)(cid:2)(cid:28)(cid:5)(cid:3)(cid:10)(cid:5)(cid:2)(cid:64)(cid:46)(cid:4)(cid:12)(cid:2)(cid:28)(cid:3,,3817.0
,,41,,,Unknown,,cid:50)(cid:46)(cid:12)(cid:2)(cid:7)(cid:8)(cid:10)(cid:5)(cid:3)(cid:48)(cid:46)(cid:3)(cid:12)(cid:13)(cid:5)(cid:2)(cid:14)(cid:46)(cid:2)(cid:28)(cid:5)(cid:3)(cid:10)(cid:5)(cid:2)(cid:64)(cid:46)(cid:4)(cid:12)(cid:2)(cid:28)(cid:3,,3858.0
,,2,,,Unknown,,cid:50)(cid:46)(cid:12)(cid:2)(cid:7)(cid:8)(cid:10)(cid:5)(cid:3)(cid:48)(cid:46)(cid:3)(cid:12)(cid:13)(cid:5)(cid:2)(cid:14)(cid:46)(cid:2)(cid:28)(cid:5)(cid:3)(cid:10)(cid:5)(cid:2)(cid:64)(cid:46)(cid:4)(cid:12)(cid:2)(cid:28)(cid:3,,3860.0
,,45,,,Unknown,,cid:50)(cid:46)(cid:12)(cid:2)(cid:7)(cid:8)(cid:10)(cid:5)(cid:3)(cid:48)(cid:46)(cid:3)(cid:12)(cid:13)(cid:5)(cid:2)(cid:14)(cid:46)(cid:2)(cid:28)(cid:5)(cid:3)(cid:10)(cid:5)(cid:2)(cid:64)(cid:46)(cid:4)(cid:12)(cid:2)(cid:28)(cid:3,,3905.0
,,2,,,Unknown,,cid:50)(cid:46)(cid:12)(cid:2)(cid:7)(cid:8)(cid:10)(cid:5)(cid:3)(cid:48)(cid:46)(cid:3)(cid:12)(cid:13)(cid:5)(cid:2)(cid:14)(cid:46)(cid:2)(cid:28)(cid:5)(cid:3)(cid:10)(cid:5)(cid:2)(cid:64)(cid:46)(cid:4)(cid:12)(cid:2)(cid:28)(cid:3,,3907.0
,,28,,,Unknown,,cid:50)(cid:46)(cid:12)(cid:2)(cid:7)(cid:8)(cid:10)(cid:5)(cid:3)(cid:48)(cid:46)(cid:3)(cid:12)(cid:13)(cid:5)(cid:2)(cid:14)(cid:46)(cid:2)(cid:28)(cid:5)(cid:3)(cid:10)(cid:5)(cid:2)(cid:64)(cid:46)(cid:4)(cid:12)(cid:2)(cid:28)(cid:3,,3935.0
,,26,,,Unknown,,cid:50)(cid:46)(cid:12)(cid:2)(cid:7)(cid:8)(cid:10)(cid:5)(cid:3)(cid:48)(cid:46)(cid:3)(cid:12)(cid:13)(cid:5)(cid:2)(cid:14)(cid:46)(cid:2)(cid:28)(cid:5)(cid:3)(cid:10)(cid:5)(cid:2)(cid:64)(cid:46)(cid:4)(cid:12)(cid:2)(cid:28)(cid:3,,3961.0
,,29,,,Unknown,,cid:50)(cid:46)(cid:12)(cid:2)(cid:7)(cid:8)(cid:10)(cid:5)(cid:3)(cid:48)(cid:46)(cid:3)(cid:12)(cid:13)(cid:5)(cid:2)(cid:14)(cid:46)(cid:2)(cid:28)(cid:5)(cid:3)(cid:10)(cid:5)(cid:2)(cid:64)(cid:46)(cid:4)(cid:12)(cid:2)(cid:28)(cid:3,,3990.0
,,24,,,Unknown,,cid:50)(cid:46)(cid:12)(cid:2)(cid:7)(cid:8)(cid:10)(cid:5)(cid:3)(cid:48)(cid:46)(cid:3)(cid:12)(cid:13)(cid:5)(cid:2)(cid:14)(cid:46)(cid:2)(cid:28)(cid:5)(cid:3)(cid:10)(cid:5)(cid:2)(cid:64)(cid:46)(cid:4)(cid:12)(cid:2)(cid:28)(cid:3,,4014.0
,,27,,,Unknown,,cid:50)(cid:46)(cid:12)(cid:2)(cid:7)(cid:8)(cid:10)(cid:5)(cid:3)(cid:48)(cid:46)(cid:3)(cid:12)(cid:13)(cid:5)(cid:2)(cid:14)(cid:46)(cid:2)(cid:28)(cid:5)(cid:3)(cid:10)(cid:5)(cid:2)(cid:64)(cid:46)(cid:4)(cid:12)(cid:2)(cid:28)(cid:3,,4041.0
,,2,,,Unknown,,cid:50)(cid:46)(cid:12)(cid:2)(cid:7)(cid:8)(cid:10)(cid:5)(cid:3)(cid:48)(cid:46)(cid:3)(cid:12)(cid:13)(cid:5)(cid:2)(cid:14)(cid:46)(cid:2)(cid:28)(cid:5)(cid:3)(cid:10)(cid:5)(cid:2)(cid:64)(cid:46)(cid:4)(cid:12)(cid:2)(cid:28)(cid:3,,4043.0
,,29,,,Unknown,,cid:50)(cid:46)(cid:12)(cid:2)(cid:7)(cid:8)(cid:10)(cid:5)(cid:3)(cid:48)(cid:46)(cid:3)(cid:12)(cid:13)(cid:5)(cid:2)(cid:14)(cid:46)(cid:2)(cid:28)(cid:5)(cid:3)(cid:10)(cid:5)(cid:2)(cid:64)(cid:46)(cid:4)(cid:12)(cid:2)(cid:28)(cid:3,,4072.0
,,53,,,Unknown,,cid:50)(cid:46)(cid:12)(cid:2)(cid:7)(cid:8)(cid:10)(cid:5)(cid:3)(cid:48)(cid:46)(cid:3)(cid:12)(cid:13)(cid:5)(cid:2)(cid:14)(cid:46)(cid:2)(cid:28)(cid:5)(cid:3)(cid:10)(cid:5)(cid:2)(cid:64)(cid:46)(cid:4)(cid:12)(cid:2)(cid:28)(cid:3,,4125.0
,,53,,,Unknown,,cid:50)(cid:46)(cid:12)(cid:2)(cid:7)(cid:8)(cid:10)(cid:5)(cid:3)(cid:48)(cid:46)(cid:3)(cid:12)(cid:13)(cid:5)(cid:2)(cid:14)(cid:46)(cid:2)(cid:28)(cid:5)(cid:3)(cid:10)(cid:5)(cid:2)(cid:64)(cid:46)(cid:4)(cid:12)(cid:2)(cid:28)(cid:3,,4178.0
,,24,,,Unknown,,cid:50)(cid:46)(cid:12)(cid:2)(cid:7)(cid:8)(cid:10)(cid:5)(cid:3)(cid:48)(cid:46)(cid:3)(cid:12)(cid:13)(cid:5)(cid:2)(cid:14)(cid:46)(cid:2)(cid:28)(cid:5)(cid:3)(cid:10)(cid:5)(cid:2)(cid:64)(cid:46)(cid:4)(cid:12)(cid:2)(cid:28)(cid:3,,4202.0
,,41,,,Unknown,,cid:50)(cid:46)(cid:12)(cid:2)(cid:7)(cid:8)(cid:10)(cid:5)(cid:3)(cid:48)(cid:46)(cid:3)(cid:12)(cid:13)(cid:5)(cid:2)(cid:14)(cid:46)(cid:2)(cid:28)(cid:5)(cid:3)(cid:10)(cid:5)(cid:2)(cid:64)(cid:46)(cid:4)(cid:12)(cid:2)(cid:28)(cid:3,,4243.0
,,24,,,Unknown,,cid:50)(cid:46)(cid:12)(cid:2)(cid:7)(cid:8)(cid:10)(cid:5)(cid:3)(cid:48)(cid:46)(cid:3)(cid:12)(cid:13)(cid:5)(cid:2)(cid:14)(cid:46)(cid:2)(cid:28)(cid:5)(cid:3)(cid:10)(cid:5)(cid:2)(cid:64)(cid:46)(cid:4)(cid:12)(cid:2)(cid:28)(cid:3,,4267.0
,,20,,,Unknown,,cid:50)(cid:46)(cid:12)(cid:2)(cid:7)(cid:8)(cid:10)(cid:5)(cid:3)(cid:48)(cid:46)(cid:3)(cid:12)(cid:13)(cid:5)(cid:2)(cid:14)(cid:46)(cid:2)(cid:28)(cid:5)(cid:3)(cid:10)(cid:5)(cid:2)(cid:64)(cid:46)(cid:4)(cid:12)(cid:2)(cid:28)(cid:3,,4287.0
,,30,,,Unknown,,cid:50)(cid:46)(cid:12)(cid:2)(cid:7)(cid:8)(cid:10)(cid:5)(cid:3)(cid:48)(cid:46)(cid:3)(cid:12)(cid:13)(cid:5)(cid:2)(cid:14)(cid:46)(cid:2)(cid:28)(cid:5)(cid:3)(cid:10)(cid:5)(cid:2)(cid:64)(cid:46)(cid:4)(cid:12)(cid:2)(cid:28)(cid:3,,4317.0
,,30,,,Unknown,,cid:50)(cid:46)(cid:12)(cid:2)(cid:7)(cid:8)(cid:10)(cid:5)(cid:3)(cid:48)(cid:46)(cid:3)(cid:12)(cid:13)(cid:5)(cid:2)(cid:14)(cid:46)(cid:2)(cid:28)(cid:5)(cid:3)(cid:10)(cid:5)(cid:2)(cid:64)(cid:46)(cid:4)(cid:12)(cid:2)(cid:28)(cid:3,,4347.0
,,25,,,Unknown,,cid:50)(cid:46)(cid:12)(cid:2)(cid:7)(cid:8)(cid:10)(cid:5)(cid:3)(cid:48)(cid:46)(cid:3)(cid:12)(cid:13)(cid:5)(cid:2)(cid:14)(cid:46)(cid:2)(cid:28)(cid:5)(cid:3)(cid:10)(cid:5)(cid:2)(cid:64)(cid:46)(cid:4)(cid:12)(cid:2)(cid:28)(cid:3,,4372.0
,,22,,,Unknown,,cid:50)(cid:46)(cid:12)(cid:2)(cid:7)(cid:8)(cid:10)(cid:5)(cid:3)(cid:48)(cid:46)(cid:3)(cid:12)(cid:13)(cid:5)(cid:2)(cid:14)(cid:46)(cid:2)(cid:28)(cid:5)(cid:3)(cid:10)(cid:5)(cid:2)(cid:64)(cid:46)(cid:4)(cid:12)(cid:2)(cid:28)(cid:3,,4394.0
,,27,,,Unknown,,cid:50)(cid:46)(cid:12)(cid:2)(cid:7)(cid:8)(cid:10)(cid:5)(cid:3)(cid:48)(cid:46)(cid:3)(cid:12)(cid:13)(cid:5)(cid:2)(cid:14)(cid:46)(cid:2)(cid:28)(cid:5)(cid:3)(cid:10)(cid:5)(cid:2)(cid:64)(cid:46)(cid:4)(cid:12)(cid:2)(cid:28)(cid:3,,4421.0
,,18,,,Unknown,,cid:50)(cid:46)(cid:12)(cid:2)(cid:7)(cid:8)(cid:10)(cid:5)(cid:3)(cid:48)(cid:46)(cid:3)(cid:12)(cid:13)(cid:5)(cid:2)(cid:14)(cid:46)(cid:2)(cid:28)(cid:5)(cid:3)(cid:10)(cid:5)(cid:2)(cid:64)(cid:46)(cid:4)(cid:12)(cid:2)(cid:28)(cid:3,,4439.0
,,34,,,Unknown,,cid:50)(cid:46)(cid:12)(cid:2)(cid:7)(cid:8)(cid:10)(cid:5)(cid:3)(cid:48)(cid:46)(cid:3)(cid:12)(cid:13)(cid:5)(cid:2)(cid:14)(cid:46)(cid:2)(cid:28)(cid:5)(cid:3)(cid:10)(cid:5)(cid:2)(cid:64)(cid:46)(cid:4)(cid:12)(cid:2)(cid:28)(cid:3,,4473.0
,,45,,,Unknown,,cid:50)(cid:46)(cid:12)(cid:2)(cid:7)(cid:8)(cid:10)(cid:5)(cid:3)(cid:48)(cid:46)(cid:3)(cid:12)(cid:13)(cid:5)(cid:2)(cid:14)(cid:46)(cid:2)(cid:28)(cid:5)(cid:3)(cid:10)(cid:5)(cid:2)(cid:64)(cid:46)(cid:4)(cid:12)(cid:2)(cid:28)(cid:3,,4518.0
,,18,,,Unknown,,cid:50)(cid:46)(cid:12)(cid:2)(cid:7)(cid:8)(cid:10)(cid:5)(cid:3)(cid:48)(cid:46)(cid:3)(cid:12)(cid:13)(cid:5)(cid:2)(cid:14)(cid:46)(cid:2)(cid:28)(cid:5)(cid:3)(cid:10)(cid:5)(cid:2)(cid:64)(cid:46)(cid:4)(cid:12)(cid:2)(cid:28)(cid:3,,4536.0
,,16,,,Unknown,,cid:50)(cid:46)(cid:12)(cid:2)(cid:7)(cid:8)(cid:10)(cid:5)(cid:3)(cid:48)(cid:46)(cid:3)(cid:12)(cid:13)(cid:5)(cid:2)(cid:14)(cid:46)(cid:2)(cid:28)(cid:5)(cid:3)(cid:10)(cid:5)(cid:2)(cid:64)(cid:46)(cid:4)(cid:12)(cid:2)(cid:28)(cid:3,,4552.0
,,23,,,Unknown,,cid:50)(cid:46)(cid:12)(cid:2)(cid:7)(cid:8)(cid:10)(cid:5)(cid:3)(cid:48)(cid:46)(cid:3)(cid:12)(cid:13)(cid:5)(cid:2)(cid:14)(cid:46)(cid:2)(cid:28)(cid:5)(cid:3)(cid:10)(cid:5)(cid:2)(cid:64)(cid:46)(cid:4)(cid:12)(cid:2)(cid:28)(cid:3,,4575.0
,,29,,,Unknown,,cid:50)(cid:46)(cid:12)(cid:2)(cid:7)(cid:8)(cid:10)(cid:5)(cid:3)(cid:48)(cid:46)(cid:3)(cid:12)(cid:13)(cid:5)(cid:2)(cid:14)(cid:46)(cid:2)(cid:28)(cid:5)(cid:3)(cid:10)(cid:5)(cid:2)(cid:64)(cid:46)(cid:4)(cid:12)(cid:2)(cid:28)(cid:3,,4604.0
,,22,,,Unknown,,cid:50)(cid:46)(cid:12)(cid:2)(cid:7)(cid:8)(cid:10)(cid:5)(cid:3)(cid:48)(cid:46)(cid:3)(cid:12)(cid:13)(cid:5)(cid:2)(cid:14)(cid:46)(cid:2)(cid:28)(cid:5)(cid:3)(cid:10)(cid:5)(cid:2)(cid:64)(cid:46)(cid:4)(cid:12)(cid:2)(cid:28)(cid:3,,4626.0
,,25,,,Unknown,,cid:50)(cid:46)(cid:12)(cid:2)(cid:7)(cid:8)(cid:10)(cid:5)(cid:3)(cid:48)(cid:46)(cid:3)(cid:12)(cid:13)(cid:5)(cid:2)(cid:14)(cid:46)(cid:2)(cid:28)(cid:5)(cid:3)(cid:10)(cid:5)(cid:2)(cid:64)(cid:46)(cid:4)(cid:12)(cid:2)(cid:28)(cid:3,,4651.0
,,41,,,Unknown,,cid:50)(cid:46)(cid:12)(cid:2)(cid:7)(cid:8)(cid:10)(cid:5)(cid:3)(cid:48)(cid:46)(cid:3)(cid:12)(cid:13)(cid:5)(cid:2)(cid:14)(cid:46)(cid:2)(cid:28)(cid:5)(cid:3)(cid:10)(cid:5)(cid:2)(cid:64)(cid:46)(cid:4)(cid:12)(cid:2)(cid:28)(cid:3,,4692.0
,,29,,,Unknown,,cid:50)(cid:46)(cid:12)(cid:2)(cid:7)(cid:8)(cid:10)(cid:5)(cid:3)(cid:48)(cid:46)(cid:3)(cid:12)(cid:13)(cid:5)(cid:2)(cid:14)(cid:46)(cid:2)(cid:28)(cid:5)(cid:3)(cid:10)(cid:5)(cid:2)(cid:64)(cid:46)(cid:4)(cid:12)(cid:2)(cid:28)(cid:3,,4721.0
,,2,,,Unknown,,cid:50)(cid:46)(cid:12)(cid:2)(cid:7)(cid:8)(cid:10)(cid:5)(cid:3)(cid:48)(cid:46)(cid:3)(cid:12)(cid:13)(cid:5)(cid:2)(cid:14)(cid:46)(cid:2)(cid:28)(cid:5)(cid:3)(cid:10)(cid:5)(cid:2)(cid:64)(cid:46)(cid:4)(cid:12)(cid:2)(cid:28)(cid:3,,4723.0
,,29,,,Unknown,,cid:50)(cid:46)(cid:12)(cid:2)(cid:7)(cid:8)(cid:10)(cid:5)(cid:3)(cid:48)(cid:46)(cid:3)(cid:12)(cid:13)(cid:5)(cid:2)(cid:14)(cid:46)(cid:2)(cid:28)(cid:5)(cid:3)(cid:10)(cid:5)(cid:2)(cid:64)(cid:46)(cid:4)(cid:12)(cid:2)(cid:28)(cid:3,,4752.0
,,26,,,Unknown,,cid:50)(cid:46)(cid:12)(cid:2)(cid:7)(cid:8)(cid:10)(cid:5)(cid:3)(cid:48)(cid:46)(cid:3)(cid:12)(cid:13)(cid:5)(cid:2)(cid:14)(cid:46)(cid:2)(cid:28)(cid:5)(cid:3)(cid:10)(cid:5)(cid:2)(cid:64)(cid:46)(cid:4)(cid:12)(cid:2)(cid:28)(cid:3,,4778.0
,,27,,,Unknown,,cid:50)(cid:46)(cid:12)(cid:2)(cid:7)(cid:8)(cid:10)(cid:5)(cid:3)(cid:48)(cid:46)(cid:3)(cid:12)(cid:13)(cid:5)(cid:2)(cid:14)(cid:46)(cid:2)(cid:28)(cid:5)(cid:3)(cid:10)(cid:5)(cid:2)(cid:64)(cid:46)(cid:4)(cid:12)(cid:2)(cid:28)(cid:3,,4805.0
,,24,,,Unknown,,cid:50)(cid:46)(cid:12)(cid:2)(cid:7)(cid:8)(cid:10)(cid:5)(cid:3)(cid:48)(cid:46)(cid:3)(cid:12)(cid:13)(cid:5)(cid:2)(cid:14)(cid:46)(cid:2)(cid:28)(cid:5)(cid:3)(cid:10)(cid:5)(cid:2)(cid:64)(cid:46)(cid:4)(cid:12)(cid:2)(cid:28)(cid:3,,4829.0
,,23,,,Unknown,,cid:50)(cid:46)(cid:12)(cid:2)(cid:7)(cid:8)(cid:10)(cid:5)(cid:3)(cid:48)(cid:46)(cid:3)(cid:12)(cid:13)(cid:5)(cid:2)(cid:14)(cid:46)(cid:2)(cid:28)(cid:5)(cid:3)(cid:10)(cid:5)(cid:2)(cid:64)(cid:46)(cid:4)(cid:12)(cid:2)(cid:28)(cid:3,,4852.0
,,15,,,Unknown,,cid:50)(cid:46)(cid:12)(cid:2)(cid:7)(cid:8)(cid:10)(cid:5)(cid:3)(cid:48)(cid:46)(cid:3)(cid:12)(cid:13)(cid:5)(cid:2)(cid:14)(cid:46)(cid:2)(cid:28)(cid:5)(cid:3)(cid:10)(cid:5)(cid:2)(cid:64)(cid:46)(cid:4)(cid:12)(cid:2)(cid:28)(cid:3,,4867.0
,,2,,,Unknown,,cid:50)(cid:46)(cid:12)(cid:2)(cid:7)(cid:8)(cid:10)(cid:5)(cid:3)(cid:48)(cid:46)(cid:3)(cid:12)(cid:13)(cid:5)(cid:2)(cid:14)(cid:46)(cid:2)(cid:28)(cid:5)(cid:3)(cid:10)(cid:5)(cid:2)(cid:64)(cid:46)(cid:4)(cid:12)(cid:2)(cid:28)(cid:3,,4869.0
,,1,,,Unknown,,cid:50)(cid:46)(cid:12)(cid:2)(cid:7)(cid:8)(cid:10)(cid:5)(cid:3)(cid:48)(cid:46)(cid:3)(cid:12)(cid:13)(cid:5)(cid:2)(cid:14)(cid:46)(cid:2)(cid:28)(cid:5)(cid:3)(cid:10)(cid:5)(cid:2)(cid:64)(cid:46)(cid:4)(cid:12)(cid:2)(cid:28)(cid:3,,4870.0
,,18,,,Unknown,,cid:50)(cid:46)(cid:12)(cid:2)(cid:7)(cid:8)(cid:10)(cid:5)(cid:3)(cid:48)(cid:46)(cid:3)(cid:12)(cid:13)(cid:5)(cid:2)(cid:14)(cid:46)(cid:2)(cid:28)(cid:5)(cid:3)(cid:10)(cid:5)(cid:2)(cid:64)(cid:46)(cid:4)(cid:12)(cid:2)(cid:28)(cid:3,,4888.0
,,2,,,Unknown,,cid:50)(cid:46)(cid:12)(cid:2)(cid:7)(cid:8)(cid:10)(cid:5)(cid:3)(cid:48)(cid:46)(cid:3)(cid:12)(cid:13)(cid:5)(cid:2)(cid:14)(cid:46)(cid:2)(cid:28)(cid:5)(cid:3)(cid:10)(cid:5)(cid:2)(cid:64)(cid:46)(cid:4)(cid:12)(cid:2)(cid:28)(cid:3,,4890.0
,,18,,,Unknown,,cid:50)(cid:46)(cid:12)(cid:2)(cid:7)(cid:8)(cid:10)(cid:5)(cid:3)(cid:48)(cid:46)(cid:3)(cid:12)(cid:13)(cid:5)(cid:2)(cid:14)(cid:46)(cid:2)(cid:28)(cid:5)(cid:3)(cid:10)(cid:5)(cid:2)(cid:64)(cid:46)(cid:4)(cid:12)(cid:2)(cid:28)(cid:3,,4908.0
,,18,,,Unknown,,cid:50)(cid:46)(cid:12)(cid:2)(cid:7)(cid:8)(cid:10)(cid:5)(cid:3)(cid:48)(cid:46)(cid:3)(cid:12)(cid:13)(cid:5)(cid:2)(cid:14)(cid:46)(cid:2)(cid:28)(cid:5)(cid:3)(cid:10)(cid:5)(cid:2)(cid:64)(cid:46)(cid:4)(cid:12)(cid:2)(cid:28)(cid:3,,4926.0
,,18,,,Unknown,,cid:50)(cid:46)(cid:12)(cid:2)(cid:7)(cid:8)(cid:10)(cid:5)(cid:3)(cid:48)(cid:46)(cid:3)(cid:12)(cid:13)(cid:5)(cid:2)(cid:14)(cid:46)(cid:2)(cid:28)(cid:5)(cid:3)(cid:10)(cid:5)(cid:2)(cid:64)(cid:46)(cid:4)(cid:12)(cid:2)(cid:28)(cid:3,,4944.0
,,19,,,Unknown,,cid:50)(cid:46)(cid:12)(cid:2)(cid:7)(cid:8)(cid:10)(cid:5)(cid:3)(cid:48)(cid:46)(cid:3)(cid:12)(cid:13)(cid:5)(cid:2)(cid:14)(cid:46)(cid:2)(cid:28)(cid:5)(cid:3)(cid:10)(cid:5)(cid:2)(cid:64)(cid:46)(cid:4)(cid:12)(cid:2)(cid:28)(cid:3,,4963.0
,,18,,,Unknown,,cid:50)(cid:46)(cid:12)(cid:2)(cid:7)(cid:8)(cid:10)(cid:5)(cid:3)(cid:48)(cid:46)(cid:3)(cid:12)(cid:13)(cid:5)(cid:2)(cid:14)(cid:46)(cid:2)(cid:28)(cid:5)(cid:3)(cid:10)(cid:5)(cid:2)(cid:64)(cid:46)(cid:4)(cid:12)(cid:2)(cid:28)(cid:3,,4981.0
,,18,,,Unknown,,cid:50)(cid:46)(cid:12)(cid:2)(cid:7)(cid:8)(cid:10)(cid:5)(cid:3)(cid:48)(cid:46)(cid:3)(cid:12)(cid:13)(cid:5)(cid:2)(cid:14)(cid:46)(cid:2)(cid:28)(cid:5)(cid:3)(cid:10)(cid:5)(cid:2)(cid:64)(cid:46)(cid:4)(cid:12)(cid:2)(cid:28)(cid:3,,4999.0
,,2,,,Unknown,,cid:50)(cid:46)(cid:12)(cid:2)(cid:7)(cid:8)(cid:10)(cid:5)(cid:3)(cid:48)(cid:46)(cid:3)(cid:12)(cid:13)(cid:5)(cid:2)(cid:14)(cid:46)(cid:2)(cid:28)(cid:5)(cid:3)(cid:10)(cid:5)(cid:2)(cid:64)(cid:46)(cid:4)(cid:12)(cid:2)(cid:28)(cid:3,,5001.0
,,44,,,Unknown,,cid:50)(cid:46)(cid:12)(cid:2)(cid:7)(cid:8)(cid:10)(cid:5)(cid:3)(cid:48)(cid:46)(cid:3)(cid:12)(cid:13)(cid:5)(cid:2)(cid:14)(cid:46)(cid:2)(cid:28)(cid:5)(cid:3)(cid:10)(cid:5)(cid:2)(cid:64)(cid:46)(cid:4)(cid:12)(cid:2)(cid:28)(cid:3,,5045.0
,,51,,,Unknown,,cid:50)(cid:46)(cid:12)(cid:2)(cid:7)(cid:8)(cid:10)(cid:5)(cid:3)(cid:48)(cid:46)(cid:3)(cid:12)(cid:13)(cid:5)(cid:2)(cid:14)(cid:46)(cid:2)(cid:28)(cid:5)(cid:3)(cid:10)(cid:5)(cid:2)(cid:64)(cid:46)(cid:4)(cid:12)(cid:2)(cid:28)(cid:3,,5096.0
,,29,,,Unknown,,cid:50)(cid:46)(cid:12)(cid:2)(cid:7)(cid:8)(cid:10)(cid:5)(cid:3)(cid:48)(cid:46)(cid:3)(cid:12)(cid:13)(cid:5)(cid:2)(cid:14)(cid:46)(cid:2)(cid:28)(cid:5)(cid:3)(cid:10)(cid:5)(cid:2)(cid:64)(cid:46)(cid:4)(cid:12)(cid:2)(cid:28)(cid:3,,5125.0
,,24,,,Unknown,,cid:50)(cid:46)(cid:12)(cid:2)(cid:7)(cid:8)(cid:10)(cid:5)(cid:3)(cid:48)(cid:46)(cid:3)(cid:12)(cid:13)(cid:5)(cid:2)(cid:14)(cid:46)(cid:2)(cid:28)(cid:5)(cid:3)(cid:10)(cid:5)(cid:2)(cid:64)(cid:46)(cid:4)(cid:12)(cid:2)(cid:28)(cid:3,,5149.0
,,25,,,Unknown,,cid:50)(cid:46)(cid:12)(cid:2)(cid:7)(cid:8)(cid:10)(cid:5)(cid:3)(cid:48)(cid:46)(cid:3)(cid:12)(cid:13)(cid:5)(cid:2)(cid:14)(cid:46)(cid:2)(cid:28)(cid:5)(cid:3)(cid:10)(cid:5)(cid:2)(cid:64)(cid:46)(cid:4)(cid:12)(cid:2)(cid:28)(cid:3,,5174.0
,,23,,,Unknown,,cid:50)(cid:46)(cid:12)(cid:2)(cid:7)(cid:8)(cid:10)(cid:5)(cid:3)(cid:48)(cid:46)(cid:3)(cid:12)(cid:13)(cid:5)(cid:2)(cid:14)(cid:46)(cid:2)(cid:28)(cid:5)(cid:3)(cid:10)(cid:5)(cid:2)(cid:64)(cid:46)(cid:4)(cid:12)(cid:2)(cid:28)(cid:3,,5197.0
,,25,,,Unknown,,cid:50)(cid:46)(cid:12)(cid:2)(cid:7)(cid:8)(cid:10)(cid:5)(cid:3)(cid:48)(cid:46)(cid:3)(cid:12)(cid:13)(cid:5)(cid:2)(cid:14)(cid:46)(cid:2)(cid:28)(cid:5)(cid:3)(cid:10)(cid:5)(cid:2)(cid:64)(cid:46)(cid:4)(cid:12)(cid:2)(cid:28)(cid:3,,5222.0
,,30,,,Unknown,,cid:50)(cid:46)(cid:12)(cid:2)(cid:7)(cid:8)(cid:10)(cid:5)(cid:3)(cid:48)(cid:46)(cid:3)(cid:12)(cid:13)(cid:5)(cid:2)(cid:14)(cid:46)(cid:2)(cid:28)(cid:5)(cid:3)(cid:10)(cid:5)(cid:2)(cid:64)(cid:46)(cid:4)(cid:12)(cid:2)(cid:28)(cid:3,,5252.0
,,41,,,Unknown,,cid:50)(cid:46)(cid:12)(cid:2)(cid:7)(cid:8)(cid:10)(cid:5)(cid:3)(cid:48)(cid:46)(cid:3)(cid:12)(cid:13)(cid:5)(cid:2)(cid:14)(cid:46)(cid:2)(cid:28)(cid:5)(cid:3)(cid:10)(cid:5)(cid:2)(cid:64)(cid:46)(cid:4)(cid:12)(cid:2)(cid:28)(cid:3,,5293.0
,,18,,,Unknown,,cid:50)(cid:46)(cid:12)(cid:2)(cid:7)(cid:8)(cid:10)(cid:5)(cid:3)(cid:48)(cid:46)(cid:3)(cid:12)(cid:13)(cid:5)(cid:2)(cid:14)(cid:46)(cid:2)(cid:28)(cid:5)(cid:3)(cid:10)(cid:5)(cid:2)(cid:64)(cid:46)(cid:4)(cid:12)(cid:2)(cid:28)(cid:3,,5311.0
,,34,,,Unknown,,cid:50)(cid:46)(cid:12)(cid:2)(cid:7)(cid:8)(cid:10)(cid:5)(cid:3)(cid:48)(cid:46)(cid:3)(cid:12)(cid:13)(cid:5)(cid:2)(cid:14)(cid:46)(cid:2)(cid:28)(cid:5)(cid:3)(cid:10)(cid:5)(cid:2)(cid:64)(cid:46)(cid:4)(cid:12)(cid:2)(cid:28)(cid:3,,5345.0
,,45,,,Unknown,,cid:50)(cid:46)(cid:12)(cid:2)(cid:7)(cid:8)(cid:10)(cid:5)(cid:3)(cid:48)(cid:46)(cid:3)(cid:12)(cid:13)(cid:5)(cid:2)(cid:14)(cid:46)(cid:2)(cid:28)(cid:5)(cid:3)(cid:10)(cid:5)(cid:2)(cid:64)(cid:46)(cid:4)(cid:12)(cid:2)(cid:28)(cid:3,,5390.0
,,18,,,Unknown,,cid:50)(cid:46)(cid:12)(cid:2)(cid:7)(cid:8)(cid:10)(cid:5)(cid:3)(cid:48)(cid:46)(cid:3)(cid:12)(cid:13)(cid:5)(cid:2)(cid:14)(cid:46)(cid:2)(cid:28)(cid:5)(cid:3)(cid:10)(cid:5)(cid:2)(cid:64)(cid:46)(cid:4)(cid:12)(cid:2)(cid:28)(cid:3,,5408.0
,,16,,,Unknown,,cid:50)(cid:46)(cid:12)(cid:2)(cid:7)(cid:8)(cid:10)(cid:5)(cid:3)(cid:48)(cid:46)(cid:3)(cid:12)(cid:13)(cid:5)(cid:2)(cid:14)(cid:46)(cid:2)(cid:28)(cid:5)(cid:3)(cid:10)(cid:5)(cid:2)(cid:64)(cid:46)(cid:4)(cid:12)(cid:2)(cid:28)(cid:3,,5424.0
,,57,,,Unknown,,cid:50)(cid:46)(cid:12)(cid:2)(cid:7)(cid:8)(cid:10)(cid:5)(cid:3)(cid:48)(cid:46)(cid:3)(cid:12)(cid:13)(cid:5)(cid:2)(cid:14)(cid:46)(cid:2)(cid:28)(cid:5)(cid:3)(cid:10)(cid:5)(cid:2)(cid:64)(cid:46)(cid:4)(cid:12)(cid:2)(cid:28)(cid:3,,5481.0
,,24,,,Unknown,,cid:50)(cid:46)(cid:12)(cid:2)(cid:7)(cid:8)(cid:10)(cid:5)(cid:3)(cid:48)(cid:46)(cid:3)(cid:12)(cid:13)(cid:5)(cid:2)(cid:14)(cid:46)(cid:2)(cid:28)(cid:5)(cid:3)(cid:10)(cid:5)(cid:2)(cid:64)(cid:46)(cid:4)(cid:12)(cid:2)(cid:28)(cid:3,,5505.0
,,30,,,Unknown,,cid:50)(cid:46)(cid:12)(cid:2)(cid:7)(cid:8)(cid:10)(cid:5)(cid:3)(cid:48)(cid:46)(cid:3)(cid:12)(cid:13)(cid:5)(cid:2)(cid:14)(cid:46)(cid:2)(cid:28)(cid:5)(cid:3)(cid:10)(cid:5)(cid:2)(cid:64)(cid:46)(cid:4)(cid:12)(cid:2)(cid:28)(cid:3,,5535.0
,,24,,,Unknown,,cid:50)(cid:46)(cid:12)(cid:2)(cid:7)(cid:8)(cid:10)(cid:5)(cid:3)(cid:48)(cid:46)(cid:3)(cid:12)(cid:13)(cid:5)(cid:2)(cid:14)(cid:46)(cid:2)(cid:28)(cid:5)(cid:3)(cid:10)(cid:5)(cid:2)(cid:64)(cid:46)(cid:4)(cid:12)(cid:2)(cid:28)(cid:3,,5559.0
,,15,,,Unknown,,cid:50)(cid:46)(cid:12)(cid:2)(cid:7)(cid:8)(cid:10)(cid:5)(cid:3)(cid:48)(cid:46)(cid:3)(cid:12)(cid:13)(cid:5)(cid:2)(cid:14)(cid:46)(cid:2)(cid:28)(cid:5)(cid:3)(cid:10)(cid:5)(cid:2)(cid:64)(cid:46)(cid:4)(cid:12)(cid:2)(cid:28)(cid:3,,5574.0
,,2,,,Unknown,,cid:50)(cid:46)(cid:12)(cid:2)(cid:7)(cid:8)(cid:10)(cid:5)(cid:3)(cid:48)(cid:46)(cid:3)(cid:12)(cid:13)(cid:5)(cid:2)(cid:14)(cid:46)(cid:2)(cid:28)(cid:5)(cid:3)(cid:10)(cid:5)(cid:2)(cid:64)(cid:46)(cid:4)(cid:12)(cid:2)(cid:28)(cid:3,,5576.0
,,36,,,Unknown,,cid:50)(cid:46)(cid:12)(cid:2)(cid:7)(cid:8)(cid:10)(cid:5)(cid:3)(cid:48)(cid:46)(cid:3)(cid:12)(cid:13)(cid:5)(cid:2)(cid:14)(cid:46)(cid:2)(cid:28)(cid:5)(cid:3)(cid:10)(cid:5)(cid:2)(cid:64)(cid:46)(cid:4)(cid:12)(cid:2)(cid:28)(cid:3,,5612.0
,,2,,,Unknown,,cid:50)(cid:46)(cid:12)(cid:2)(cid:7)(cid:8)(cid:10)(cid:5)(cid:3)(cid:48)(cid:46)(cid:3)(cid:12)(cid:13)(cid:5)(cid:2)(cid:14)(cid:46)(cid:2)(cid:28)(cid:5)(cid:3)(cid:10)(cid:5)(cid:2)(cid:64)(cid:46)(cid:4)(cid:12)(cid:2)(cid:28)(cid:3,,5614.0
,,18,,,Unknown,,cid:50)(cid:46)(cid:12)(cid:2)(cid:7)(cid:8)(cid:10)(cid:5)(cid:3)(cid:48)(cid:46)(cid:3)(cid:12)(cid:13)(cid:5)(cid:2)(cid:14)(cid:46)(cid:2)(cid:28)(cid:5)(cid:3)(cid:10)(cid:5)(cid:2)(cid:64)(cid:46)(cid:4)(cid:12)(cid:2)(cid:28)(cid:3,,5632.0
,,18,,,Unknown,,cid:50)(cid:46)(cid:12)(cid:2)(cid:7)(cid:8)(cid:10)(cid:5)(cid:3)(cid:48)(cid:46)(cid:3)(cid:12)(cid:13)(cid:5)(cid:2)(cid:14)(cid:46)(cid:2)(cid:28)(cid:5)(cid:3)(cid:10)(cid:5)(cid:2)(cid:64)(cid:46)(cid:4)(cid:12)(cid:2)(cid:28)(cid:3,,5650.0
,,18,,,Unknown,,cid:50)(cid:46)(cid:12)(cid:2)(cid:7)(cid:8)(cid:10)(cid:5)(cid:3)(cid:48)(cid:46)(cid:3)(cid:12)(cid:13)(cid:5)(cid:2)(cid:14)(cid:46)(cid:2)(cid:28)(cid:5)(cid:3)(cid:10)(cid:5)(cid:2)(cid:64)(cid:46)(cid:4)(cid:12)(cid:2)(cid:28)(cid:3,,5668.0
,,19,,,Unknown,,cid:50)(cid:46)(cid:12)(cid:2)(cid:7)(cid:8)(cid:10)(cid:5)(cid:3)(cid:48)(cid:46)(cid:3)(cid:12)(cid:13)(cid:5)(cid:2)(cid:14)(cid:46)(cid:2)(cid:28)(cid:5)(cid:3)(cid:10)(cid:5)(cid:2)(cid:64)(cid:46)(cid:4)(cid:12)(cid:2)(cid:28)(cid:3,,5687.0
,,18,,,Unknown,,cid:50)(cid:46)(cid:12)(cid:2)(cid:7)(cid:8)(cid:10)(cid:5)(cid:3)(cid:48)(cid:46)(cid:3)(cid:12)(cid:13)(cid:5)(cid:2)(cid:14)(cid:46)(cid:2)(cid:28)(cid:5)(cid:3)(cid:10)(cid:5)(cid:2)(cid:64)(cid:46)(cid:4)(cid:12)(cid:2)(cid:28)(cid:3,,5705.0
,,18,,,Unknown,,cid:50)(cid:46)(cid:12)(cid:2)(cid:7)(cid:8)(cid:10)(cid:5)(cid:3)(cid:48)(cid:46)(cid:3)(cid:12)(cid:13)(cid:5)(cid:2)(cid:14)(cid:46)(cid:2)(cid:28)(cid:5)(cid:3)(cid:10)(cid:5)(cid:2)(cid:64)(cid:46)(cid:4)(cid:12)(cid:2)(cid:28)(cid:3,,5723.0
,,2,,,Unknown,,cid:50)(cid:46)(cid:12)(cid:2)(cid:7)(cid:8)(cid:10)(cid:5)(cid:3)(cid:48)(cid:46)(cid:3)(cid:12)(cid:13)(cid:5)(cid:2)(cid:14)(cid:46)(cid:2)(cid:28)(cid:5)(cid:3)(cid:10)(cid:5)(cid:2)(cid:64)(cid:46)(cid:4)(cid:12)(cid:2)(cid:28)(cid:3,,5725.0
,,44,,,Unknown,,cid:50)(cid:46)(cid:12)(cid:2)(cid:7)(cid:8)(cid:10)(cid:5)(cid:3)(cid:48)(cid:46)(cid:3)(cid:12)(cid:13)(cid:5)(cid:2)(cid:14)(cid:46)(cid:2)(cid:28)(cid:5)(cid:3)(cid:10)(cid:5)(cid:2)(cid:64)(cid:46)(cid:4)(cid:12)(cid:2)(cid:28)(cid:3,,5769.0
,,51,,,Unknown,,cid:50)(cid:46)(cid:12)(cid:2)(cid:7)(cid:8)(cid:10)(cid:5)(cid:3)(cid:48)(cid:46)(cid:3)(cid:12)(cid:13)(cid:5)(cid:2)(cid:14)(cid:46)(cid:2)(cid:28)(cid:5)(cid:3)(cid:10)(cid:5)(cid:2)(cid:64)(cid:46)(cid:4)(cid:12)(cid:2)(cid:28)(cid:3,,5820.0
,,29,,,Unknown,,cid:50)(cid:46)(cid:12)(cid:2)(cid:7)(cid:8)(cid:10)(cid:5)(cid:3)(cid:48)(cid:46)(cid:3)(cid:12)(cid:13)(cid:5)(cid:2)(cid:14)(cid:46)(cid:2)(cid:28)(cid:5)(cid:3)(cid:10)(cid:5)(cid:2)(cid:64)(cid:46)(cid:4)(cid:12)(cid:2)(cid:28)(cid:3,,5849.0
,,24,,,Unknown,,cid:50)(cid:46)(cid:12)(cid:2)(cid:7)(cid:8)(cid:10)(cid:5)(cid:3)(cid:48)(cid:46)(cid:3)(cid:12)(cid:13)(cid:5)(cid:2)(cid:14)(cid:46)(cid:2)(cid:28)(cid:5)(cid:3)(cid:10)(cid:5)(cid:2)(cid:64)(cid:46)(cid:4)(cid:12)(cid:2)(cid:28)(cid:3,,5873.0
,,25,,,Unknown,,cid:50)(cid:46)(cid:12)(cid:2)(cid:7)(cid:8)(cid:10)(cid:5)(cid:3)(cid:48)(cid:46)(cid:3)(cid:12)(cid:13)(cid:5)(cid:2)(cid:14)(cid:46)(cid:2)(cid:28)(cid:5)(cid:3)(cid:10)(cid:5)(cid:2)(cid:64)(cid:46)(cid:4)(cid:12)(cid:2)(cid:28)(cid:3,,5898.0
,,23,,,Unknown,,cid:50)(cid:46)(cid:12)(cid:2)(cid:7)(cid:8)(cid:10)(cid:5)(cid:3)(cid:48)(cid:46)(cid:3)(cid:12)(cid:13)(cid:5)(cid:2)(cid:14)(cid:46)(cid:2)(cid:28)(cid:5)(cid:3)(cid:10)(cid:5)(cid:2)(cid:64)(cid:46)(cid:4)(cid:12)(cid:2)(cid:28)(cid:3,,5921.0
,,25,,,Unknown,,cid:50)(cid:46)(cid:12)(cid:2)(cid:7)(cid:8)(cid:10)(cid:5)(cid:3)(cid:48)(cid:46)(cid:3)(cid:12)(cid:13)(cid:5)(cid:2)(cid:14)(cid:46)(cid:2)(cid:28)(cid:5)(cid:3)(cid:10)(cid:5)(cid:2)(cid:64)(cid:46)(cid:4)(cid:12)(cid:2)(cid:28)(cid:3,,5946.0
,,30,,,Unknown,,cid:50)(cid:46)(cid:12)(cid:2)(cid:7)(cid:8)(cid:10)(cid:5)(cid:3)(cid:48)(cid:46)(cid:3)(cid:12)(cid:13)(cid:5)(cid:2)(cid:14)(cid:46)(cid:2)(cid:28)(cid:5)(cid:3)(cid:10)(cid:5)(cid:2)(cid:64)(cid:46)(cid:4)(cid:12)(cid:2)(cid:28)(cid:3,,5976.0
,,41,,,Unknown,,cid:50)(cid:46)(cid:12)(cid:2)(cid:7)(cid:8)(cid:10)(cid:5)(cid:3)(cid:48)(cid:46)(cid:3)(cid:12)(cid:13)(cid:5)(cid:2)(cid:14)(cid:46)(cid:2)(cid:28)(cid:5)(cid:3)(cid:10)(cid:5)(cid:2)(cid:64)(cid:46)(cid:4)(cid:12)(cid:2)(cid:28)(cid:3,,6017.0
,,18,,,Unknown,,cid:50)(cid:46)(cid:12)(cid:2)(cid:7)(cid:8)(cid:10)(cid:5)(cid:3)(cid:48)(cid:46)(cid:3)(cid:12)(cid:13)(cid:5)(cid:2)(cid:14)(cid:46)(cid:2)(cid:28)(cid:5)(cid:3)(cid:10)(cid:5)(cid:2)(cid:64)(cid:46)(cid:4)(cid:12)(cid:2)(cid:28)(cid:3,,6035.0
,,34,,,Unknown,,cid:50)(cid:46)(cid:12)(cid:2)(cid:7)(cid:8)(cid:10)(cid:5)(cid:3)(cid:48)(cid:46)(cid:3)(cid:12)(cid:13)(cid:5)(cid:2)(cid:14)(cid:46)(cid:2)(cid:28)(cid:5)(cid:3)(cid:10)(cid:5)(cid:2)(cid:64)(cid:46)(cid:4)(cid:12)(cid:2)(cid:28)(cid:3,,6069.0
,,45,,,Unknown,,cid:50)(cid:46)(cid:12)(cid:2)(cid:7)(cid:8)(cid:10)(cid:5)(cid:3)(cid:48)(cid:46)(cid:3)(cid:12)(cid:13)(cid:5)(cid:2)(cid:14)(cid:46)(cid:2)(cid:28)(cid:5)(cid:3)(cid:10)(cid:5)(cid:2)(cid:64)(cid:46)(cid:4)(cid:12)(cid:2)(cid:28)(cid:3,,6114.0
,,18,,,Unknown,,cid:50)(cid:46)(cid:12)(cid:2)(cid:7)(cid:8)(cid:10)(cid:5)(cid:3)(cid:48)(cid:46)(cid:3)(cid:12)(cid:13)(cid:5)(cid:2)(cid:14)(cid:46)(cid:2)(cid:28)(cid:5)(cid:3)(cid:10)(cid:5)(cid:2)(cid:64)(cid:46)(cid:4)(cid:12)(cid:2)(cid:28)(cid:3,,6132.0
,,16,,,Unknown,,cid:50)(cid:46)(cid:12)(cid:2)(cid:7)(cid:8)(cid:10)(cid:5)(cid:3)(cid:48)(cid:46)(cid:3)(cid:12)(cid:13)(cid:5)(cid:2)(cid:14)(cid:46)(cid:2)(cid:28)(cid:5)(cid:3)(cid:10)(cid:5)(cid:2)(cid:64)(cid:46)(cid:4)(cid:12)(cid:2)(cid:28)(cid:3,,6148.0
,,10,,,Unknown,,cid:50)(cid:46)(cid:12)(cid:2)(cid:7)(cid:8)(cid:10)(cid:5)(cid:3)(cid:48)(cid:46)(cid:3)(cid:12)(cid:13)(cid:5)(cid:2)(cid:14)(cid:46)(cid:2)(cid:28)(cid:5)(cid:3)(cid:10)(cid:5)(cid:2)(cid:64)(cid:46)(cid:4)(cid:12)(cid:2)(cid:28)(cid:3,,6158.0
,,11,,,Unknown,,cid:50)(cid:46)(cid:12)(cid:2)(cid:7)(cid:8)(cid:10)(cid:5)(cid:3)(cid:48)(cid:46)(cid:3)(cid:12)(cid:13)(cid:5)(cid:2)(cid:14)(cid:46)(cid:2)(cid:28)(cid:5)(cid:3)(cid:10)(cid:5)(cid:2)(cid:64)(cid:46)(cid:4)(cid:12)(cid:2)(cid:28)(cid:3,,6169.0
,,10,,,Unknown,,cid:50)(cid:46)(cid:12)(cid:2)(cid:7)(cid:8)(cid:10)(cid:5)(cid:3)(cid:48)(cid:46)(cid:3)(cid:12)(cid:13)(cid:5)(cid:2)(cid:14)(cid:46)(cid:2)(cid:28)(cid:5)(cid:3)(cid:10)(cid:5)(cid:2)(cid:64)(cid:46)(cid:4)(cid:12)(cid:2)(cid:28)(cid:3,,6179.0
,,46,,,Unknown,,cid:50)(cid:46)(cid:12)(cid:2)(cid:7)(cid:8)(cid:10)(cid:5)(cid:3)(cid:48)(cid:46)(cid:3)(cid:12)(cid:13)(cid:5)(cid:2)(cid:14)(cid:46)(cid:2)(cid:28)(cid:5)(cid:3)(cid:10)(cid:5)(cid:2)(cid:64)(cid:46)(cid:4)(cid:12)(cid:2)(cid:28)(cid:3,,6225.0
,,14,,,Unknown,,cid:50)(cid:46)(cid:12)(cid:2)(cid:7)(cid:8)(cid:10)(cid:5)(cid:3)(cid:48)(cid:46)(cid:3)(cid:12)(cid:13)(cid:5)(cid:2)(cid:14)(cid:46)(cid:2)(cid:28)(cid:5)(cid:3)(cid:10)(cid:5)(cid:2)(cid:64)(cid:46)(cid:4)(cid:12)(cid:2)(cid:28)(cid:3,,6239.0
,,2,,,Unknown,,cid:50)(cid:46)(cid:12)(cid:2)(cid:7)(cid:8)(cid:10)(cid:5)(cid:3)(cid:48)(cid:46)(cid:3)(cid:12)(cid:13)(cid:5)(cid:2)(cid:14)(cid:46)(cid:2)(cid:28)(cid:5)(cid:3)(cid:10)(cid:5)(cid:2)(cid:64)(cid:46)(cid:4)(cid:12)(cid:2)(cid:28)(cid:3,,6241.0
,,12,,,Unknown,,cid:50)(cid:46)(cid:12)(cid:2)(cid:7)(cid:8)(cid:10)(cid:5)(cid:3)(cid:48)(cid:46)(cid:3)(cid:12)(cid:13)(cid:5)(cid:2)(cid:14)(cid:46)(cid:2)(cid:28)(cid:5)(cid:3)(cid:10)(cid:5)(cid:2)(cid:64)(cid:46)(cid:4)(cid:12)(cid:2)(cid:28)(cid:3,,6253.0
,,11,,,Unknown,,cid:50)(cid:46)(cid:12)(cid:2)(cid:7)(cid:8)(cid:10)(cid:5)(cid:3)(cid:48)(cid:46)(cid:3)(cid:12)(cid:13)(cid:5)(cid:2)(cid:14)(cid:46)(cid:2)(cid:28)(cid:5)(cid:3)(cid:10)(cid:5)(cid:2)(cid:64)(cid:46)(cid:4)(cid:12)(cid:2)(cid:28)(cid:3,,6264.0
,,4,,,Unknown,,cid:50)(cid:46)(cid:12)(cid:2)(cid:7)(cid:8)(cid:10)(cid:5)(cid:3)(cid:48)(cid:46)(cid:3)(cid:12)(cid:13)(cid:5)(cid:2)(cid:14)(cid:46)(cid:2)(cid:28)(cid:5)(cid:3)(cid:10)(cid:5)(cid:2)(cid:64)(cid:46)(cid:4)(cid:12)(cid:2)(cid:28)(cid:3,,6268.0
,,14,,,Unknown,,cid:50)(cid:46)(cid:12)(cid:2)(cid:7)(cid:8)(cid:10)(cid:5)(cid:3)(cid:48)(cid:46)(cid:3)(cid:12)(cid:13)(cid:5)(cid:2)(cid:14)(cid:46)(cid:2)(cid:28)(cid:5)(cid:3)(cid:10)(cid:5)(cid:2)(cid:64)(cid:46)(cid:4)(cid:12)(cid:2)(cid:28)(cid:3,,6282.0
,,11,,,Unknown,,cid:50)(cid:46)(cid:12)(cid:2)(cid:7)(cid:8)(cid:10)(cid:5)(cid:3)(cid:48)(cid:46)(cid:3)(cid:12)(cid:13)(cid:5)(cid:2)(cid:14)(cid:46)(cid:2)(cid:28)(cid:5)(cid:3)(cid:10)(cid:5)(cid:2)(cid:64)(cid:46)(cid:4)(cid:12)(cid:2)(cid:28)(cid:3,,6293.0
,,48,,,Unknown,,cid:50)(cid:46)(cid:12)(cid:2)(cid:7)(cid:8)(cid:10)(cid:5)(cid:3)(cid:48)(cid:46)(cid:3)(cid:12)(cid:13)(cid:5)(cid:2)(cid:14)(cid:46)(cid:2)(cid:28)(cid:5)(cid:3)(cid:10)(cid:5)(cid:2)(cid:64)(cid:46)(cid:4)(cid:12)(cid:2)(cid:28)(cid:3,,6341.0
,,48,,,Unknown,,cid:50)(cid:46)(cid:12)(cid:2)(cid:7)(cid:8)(cid:10)(cid:5)(cid:3)(cid:48)(cid:46)(cid:3)(cid:12)(cid:13)(cid:5)(cid:2)(cid:14)(cid:46)(cid:2)(cid:28)(cid:5)(cid:3)(cid:10)(cid:5)(cid:2)(cid:64)(cid:46)(cid:4)(cid:12)(cid:2)(cid:28)(cid:3,,6389.0
,,7,,,Unknown,,cid:50)(cid:46)(cid:12)(cid:2)(cid:7)(cid:8)(cid:10)(cid:5)(cid:3)(cid:48)(cid:46)(cid:3)(cid:12)(cid:13)(cid:5)(cid:2)(cid:14)(cid:46)(cid:2)(cid:28)(cid:5)(cid:3)(cid:10)(cid:5)(cid:2)(cid:64)(cid:46)(cid:4)(cid:12)(cid:2)(cid:28)(cid:3,,6396.0
,,5,,,Unknown,,cid:50)(cid:46)(cid:12)(cid:2)(cid:7)(cid:8)(cid:10)(cid:5)(cid:3)(cid:48)(cid:46)(cid:3)(cid:12)(cid:13)(cid:5)(cid:2)(cid:14)(cid:46)(cid:2)(cid:28)(cid:5)(cid:3)(cid:10)(cid:5)(cid:2)(cid:64)(cid:46)(cid:4)(cid:12)(cid:2)(cid:28)(cid:3,,6401.0
,,3,,,Unknown,,cid:50)(cid:46)(cid:12)(cid:2)(cid:7)(cid:8)(cid:10)(cid:5)(cid:3)(cid:48)(cid:46)(cid:3)(cid:12)(cid:13)(cid:5)(cid:2)(cid:14)(cid:46)(cid:2)(cid:28)(cid:5)(cid:3)(cid:10)(cid:5)(cid:2)(cid:64)(cid:46)(cid:4)(cid:12)(cid:2)(cid:28)(cid:3,,6404.0
,,9,,,Unknown,,cid:50)(cid:46)(cid:12)(cid:2)(cid:7)(cid:8)(cid:10)(cid:5)(cid:3)(cid:48)(cid:46)(cid:3)(cid:12)(cid:13)(cid:5)(cid:2)(cid:14)(cid:46)(cid:2)(cid:28)(cid:5)(cid:3)(cid:10)(cid:5)(cid:2)(cid:64)(cid:46)(cid:4)(cid:12)(cid:2)(cid:28)(cid:3,,6413.0
,,2,,,Unknown,,cid:50)(cid:46)(cid:12)(cid:2)(cid:7)(cid:8)(cid:10)(cid:5)(cid:3)(cid:48)(cid:46)(cid:3)(cid:12)(cid:13)(cid:5)(cid:2)(cid:14)(cid:46)(cid:2)(cid:28)(cid:5)(cid:3)(cid:10)(cid:5)(cid:2)(cid:64)(cid:46)(cid:4)(cid:12)(cid:2)(cid:28)(cid:3,,6415.0
,,28,,,Unknown,,cid:50)(cid:46)(cid:12)(cid:2)(cid:7)(cid:8)(cid:10)(cid:5)(cid:3)(cid:48)(cid:46)(cid:3)(cid:12)(cid:13)(cid:5)(cid:2)(cid:14)(cid:46)(cid:2)(cid:28)(cid:5)(cid:3)(cid:10)(cid:5)(cid:2)(cid:64)(cid:46)(cid:4)(cid:12)(cid:2)(cid:28)(cid:3,,6443.0
,,3,,,Unknown,,cid:50)(cid:46)(cid:12)(cid:2)(cid:7)(cid:8)(cid:10)(cid:5)(cid:3)(cid:48)(cid:46)(cid:3)(cid:12)(cid:13)(cid:5)(cid:2)(cid:14)(cid:46)(cid:2)(cid:28)(cid:5)(cid:3)(cid:10)(cid:5)(cid:2)(cid:64)(cid:46)(cid:4)(cid:12)(cid:2)(cid:28)(cid:3,,6446.0
,,15,,,Unknown,,cid:50)(cid:46)(cid:12)(cid:2)(cid:7)(cid:8)(cid:10)(cid:5)(cid:3)(cid:48)(cid:46)(cid:3)(cid:12)(cid:13)(cid:5)(cid:2)(cid:14)(cid:46)(cid:2)(cid:28)(cid:5)(cid:3)(cid:10)(cid:5)(cid:2)(cid:64)(cid:46)(cid:4)(cid:12)(cid:2)(cid:28)(cid:3,,6461.0
,,2,,,Unknown,,cid:50)(cid:46)(cid:12)(cid:2)(cid:7)(cid:8)(cid:10)(cid:5)(cid:3)(cid:48)(cid:46)(cid:3)(cid:12)(cid:13)(cid:5)(cid:2)(cid:14)(cid:46)(cid:2)(cid:28)(cid:5)(cid:3)(cid:10)(cid:5)(cid:2)(cid:64)(cid:46)(cid:4)(cid:12)(cid:2)(cid:28)(cid:3,,6463.0
,,34,,,Unknown,,cid:50)(cid:46)(cid:12)(cid:2)(cid:7)(cid:8)(cid:10)(cid:5)(cid:3)(cid:48)(cid:46)(cid:3)(cid:12)(cid:13)(cid:5)(cid:2)(cid:14)(cid:46)(cid:2)(cid:28)(cid:5)(cid:3)(cid:10)(cid:5)(cid:2)(cid:64)(cid:46)(cid:4)(cid:12)(cid:2)(cid:28)(cid:3,,6497.0
,,18,,,Unknown,,cid:50)(cid:46)(cid:12)(cid:2)(cid:7)(cid:8)(cid:10)(cid:5)(cid:3)(cid:48)(cid:46)(cid:3)(cid:12)(cid:13)(cid:5)(cid:2)(cid:14)(cid:46)(cid:2)(cid:28)(cid:5)(cid:3)(cid:10)(cid:5)(cid:2)(cid:64)(cid:46)(cid:4)(cid:12)(cid:2)(cid:28)(cid:3,,6515.0
,,19,,,Unknown,,cid:50)(cid:46)(cid:12)(cid:2)(cid:7)(cid:8)(cid:10)(cid:5)(cid:3)(cid:48)(cid:46)(cid:3)(cid:12)(cid:13)(cid:5)(cid:2)(cid:14)(cid:46)(cid:2)(cid:28)(cid:5)(cid:3)(cid:10)(cid:5)(cid:2)(cid:64)(cid:46)(cid:4)(cid:12)(cid:2)(cid:28)(cid:3,,6534.0
,,17,,,Unknown,,cid:50)(cid:46)(cid:12)(cid:2)(cid:7)(cid:8)(cid:10)(cid:5)(cid:3)(cid:48)(cid:46)(cid:3)(cid:12)(cid:13)(cid:5)(cid:2)(cid:14)(cid:46)(cid:2)(cid:28)(cid:5)(cid:3)(cid:10)(cid:5)(cid:2)(cid:64)(cid:46)(cid:4)(cid:12)(cid:2)(cid:28)(cid:3,,6551.0
,,18,,,Unknown,,cid:50)(cid:46)(cid:12)(cid:2)(cid:7)(cid:8)(cid:10)(cid:5)(cid:3)(cid:48)(cid:46)(cid:3)(cid:12)(cid:13)(cid:5)(cid:2)(cid:14)(cid:46)(cid:2)(cid:28)(cid:5)(cid:3)(cid:10)(cid:5)(cid:2)(cid:64)(cid:46)(cid:4)(cid:12)(cid:2)(cid:28)(cid:3,,6569.0
,,2,,,Unknown,,cid:50)(cid:46)(cid:12)(cid:2)(cid:7)(cid:8)(cid:10)(cid:5)(cid:3)(cid:48)(cid:46)(cid:3)(cid:12)(cid:13)(cid:5)(cid:2)(cid:14)(cid:46)(cid:2)(cid:28)(cid:5)(cid:3)(cid:10)(cid:5)(cid:2)(cid:64)(cid:46)(cid:4)(cid:12)(cid:2)(cid:28)(cid:3,,6571.0
,,44,,,Unknown,,cid:50)(cid:46)(cid:12)(cid:2)(cid:7)(cid:8)(cid:10)(cid:5)(cid:3)(cid:48)(cid:46)(cid:3)(cid:12)(cid:13)(cid:5)(cid:2)(cid:14)(cid:46)(cid:2)(cid:28)(cid:5)(cid:3)(cid:10)(cid:5)(cid:2)(cid:64)(cid:46)(cid:4)(cid:12)(cid:2)(cid:28)(cid:3,,6615.0
,,12,,,Unknown,,cid:50)(cid:46)(cid:12)(cid:2)(cid:7)(cid:8)(cid:10)(cid:5)(cid:3)(cid:48)(cid:46)(cid:3)(cid:12)(cid:13)(cid:5)(cid:2)(cid:14)(cid:46)(cid:2)(cid:28)(cid:5)(cid:3)(cid:10)(cid:5)(cid:2)(cid:64)(cid:46)(cid:4)(cid:12)(cid:2)(cid:28)(cid:3,,6627.0
,,29,,,Unknown,,cid:50)(cid:46)(cid:12)(cid:2)(cid:7)(cid:8)(cid:10)(cid:5)(cid:3)(cid:48)(cid:46)(cid:3)(cid:12)(cid:13)(cid:5)(cid:2)(cid:14)(cid:46)(cid:2)(cid:28)(cid:5)(cid:3)(cid:10)(cid:5)(cid:2)(cid:64)(cid:46)(cid:4)(cid:12)(cid:2)(cid:28)(cid:3,,6656.0
,,26,,,Unknown,,cid:50)(cid:46)(cid:12)(cid:2)(cid:7)(cid:8)(cid:10)(cid:5)(cid:3)(cid:48)(cid:46)(cid:3)(cid:12)(cid:13)(cid:5)(cid:2)(cid:14)(cid:46)(cid:2)(cid:28)(cid:5)(cid:3)(cid:10)(cid:5)(cid:2)(cid:64)(cid:46)(cid:4)(cid:12)(cid:2)(cid:28)(cid:3,,6682.0
,,41,,,Unknown,,cid:50)(cid:46)(cid:12)(cid:2)(cid:7)(cid:8)(cid:10)(cid:5)(cid:3)(cid:48)(cid:46)(cid:3)(cid:12)(cid:13)(cid:5)(cid:2)(cid:14)(cid:46)(cid:2)(cid:28)(cid:5)(cid:3)(cid:10)(cid:5)(cid:2)(cid:64)(cid:46)(cid:4)(cid:12)(cid:2)(cid:28)(cid:3,,6723.0
,,25,,,Unknown,,cid:50)(cid:46)(cid:12)(cid:2)(cid:7)(cid:8)(cid:10)(cid:5)(cid:3)(cid:48)(cid:46)(cid:3)(cid:12)(cid:13)(cid:5)(cid:2)(cid:14)(cid:46)(cid:2)(cid:28)(cid:5)(cid:3)(cid:10)(cid:5)(cid:2)(cid:64)(cid:46)(cid:4)(cid:12)(cid:2)(cid:28)(cid:3,,6748.0
,,2,,,Unknown,,cid:50)(cid:46)(cid:12)(cid:2)(cid:7)(cid:8)(cid:10)(cid:5)(cid:3)(cid:48)(cid:46)(cid:3)(cid:12)(cid:13)(cid:5)(cid:2)(cid:14)(cid:46)(cid:2)(cid:28)(cid:5)(cid:3)(cid:10)(cid:5)(cid:2)(cid:64)(cid:46)(cid:4)(cid:12)(cid:2)(cid:28)(cid:3,,6750.0
,,58,,,Unknown,,cid:50)(cid:46)(cid:12)(cid:2)(cid:7)(cid:8)(cid:10)(cid:5)(cid:3)(cid:48)(cid:46)(cid:3)(cid:12)(cid:13)(cid:5)(cid:2)(cid:14)(cid:46)(cid:2)(cid:28)(cid:5)(cid:3)(cid:10)(cid:5)(cid:2)(cid:64)(cid:46)(cid:4)(cid:12)(cid:2)(cid:28)(cid:3,,6808.0
,,58,,,Unknown,,cid:50)(cid:46)(cid:12)(cid:2)(cid:7)(cid:8)(cid:10)(cid:5)(cid:3)(cid:48)(cid:46)(cid:3)(cid:12)(cid:13)(cid:5)(cid:2)(cid:14)(cid:46)(cid:2)(cid:28)(cid:5)(cid:3)(cid:10)(cid:5)(cid:2)(cid:64)(cid:46)(cid:4)(cid:12)(cid:2)(cid:28)(cid:3,,6866.0
,,18,,,Unknown,,cid:50)(cid:46)(cid:12)(cid:2)(cid:7)(cid:8)(cid:10)(cid:5)(cid:3)(cid:48)(cid:46)(cid:3)(cid:12)(cid:13)(cid:5)(cid:2)(cid:14)(cid:46)(cid:2)(cid:28)(cid:5)(cid:3)(cid:10)(cid:5)(cid:2)(cid:64)(cid:46)(cid:4)(cid:12)(cid:2)(cid:28)(cid:3,,6884.0
,,1,,,Unknown,,cid:50)(cid:46)(cid:12)(cid:2)(cid:7)(cid:8)(cid:10)(cid:5)(cid:3)(cid:48)(cid:46)(cid:3)(cid:12)(cid:13)(cid:5)(cid:2)(cid:14)(cid:46)(cid:2)(cid:28)(cid:5)(cid:3)(cid:10)(cid:5)(cid:2)(cid:64)(cid:46)(cid:4)(cid:12)(cid:2)(cid:28)(cid:3,,6885.0
,,1,,,Unknown,,cid:50)(cid:46)(cid:12)(cid:2)(cid:7)(cid:8)(cid:10)(cid:5)(cid:3)(cid:48)(cid:46)(cid:3)(cid:12)(cid:13)(cid:5)(cid:2)(cid:14)(cid:46)(cid:2)(cid:28)(cid:5)(cid:3)(cid:10)(cid:5)(cid:2)(cid:64)(cid:46)(cid:4)(cid:12)(cid:2)(cid:28)(cid:3,,6886.0
,,37,,,Unknown,,cid:50)(cid:46)(cid:12)(cid:2)(cid:7)(cid:8)(cid:10)(cid:5)(cid:3)(cid:48)(cid:46)(cid:3)(cid:12)(cid:13)(cid:5)(cid:2)(cid:14)(cid:46)(cid:2)(cid:28)(cid:5)(cid:3)(cid:10)(cid:5)(cid:2)(cid:64)(cid:46)(cid:4)(cid:12)(cid:2)(cid:28)(cid:3,,6923.0
,,18,,,Unknown,,cid:50)(cid:46)(cid:12)(cid:2)(cid:7)(cid:8)(cid:10)(cid:5)(cid:3)(cid:48)(cid:46)(cid:3)(cid:12)(cid:13)(cid:5)(cid:2)(cid:14)(cid:46)(cid:2)(cid:28)(cid:5)(cid:3)(cid:10)(cid:5)(cid:2)(cid:64)(cid:46)(cid:4)(cid:12)(cid:2)(cid:28)(cid:3,,6941.0
,,34,,,Unknown,,cid:50)(cid:46)(cid:12)(cid:2)(cid:7)(cid:8)(cid:10)(cid:5)(cid:3)(cid:48)(cid:46)(cid:3)(cid:12)(cid:13)(cid:5)(cid:2)(cid:14)(cid:46)(cid:2)(cid:28)(cid:5)(cid:3)(cid:10)(cid:5)(cid:2)(cid:64)(cid:46)(cid:4)(cid:12)(cid:2)(cid:28)(cid:3,,6975.0
,,45,,,Unknown,,cid:50)(cid:46)(cid:12)(cid:2)(cid:7)(cid:8)(cid:10)(cid:5)(cid:3)(cid:48)(cid:46)(cid:3)(cid:12)(cid:13)(cid:5)(cid:2)(cid:14)(cid:46)(cid:2)(cid:28)(cid:5)(cid:3)(cid:10)(cid:5)(cid:2)(cid:64)(cid:46)(cid:4)(cid:12)(cid:2)(cid:28)(cid:3,,7020.0
,,18,,,Unknown,,cid:50)(cid:46)(cid:12)(cid:2)(cid:7)(cid:8)(cid:10)(cid:5)(cid:3)(cid:48)(cid:46)(cid:3)(cid:12)(cid:13)(cid:5)(cid:2)(cid:14)(cid:46)(cid:2)(cid:28)(cid:5)(cid:3)(cid:10)(cid:5)(cid:2)(cid:64)(cid:46)(cid:4)(cid:12)(cid:2)(cid:28)(cid:3,,7038.0
,,16,,,Unknown,,cid:50)(cid:46)(cid:12)(cid:2)(cid:7)(cid:8)(cid:10)(cid:5)(cid:3)(cid:48)(cid:46)(cid:3)(cid:12)(cid:13)(cid:5)(cid:2)(cid:14)(cid:46)(cid:2)(cid:28)(cid:5)(cid:3)(cid:10)(cid:5)(cid:2)(cid:64)(cid:46)(cid:4)(cid:12)(cid:2)(cid:28)(cid:3,,7054.0
,,10,,,Unknown,,cid:50)(cid:46)(cid:12)(cid:2)(cid:7)(cid:8)(cid:10)(cid:5)(cid:3)(cid:48)(cid:46)(cid:3)(cid:12)(cid:13)(cid:5)(cid:2)(cid:14)(cid:46)(cid:2)(cid:28)(cid:5)(cid:3)(cid:10)(cid:5)(cid:2)(cid:64)(cid:46)(cid:4)(cid:12)(cid:2)(cid:28)(cid:3,,7064.0
,,11,,,Unknown,,cid:50)(cid:46)(cid:12)(cid:2)(cid:7)(cid:8)(cid:10)(cid:5)(cid:3)(cid:48)(cid:46)(cid:3)(cid:12)(cid:13)(cid:5)(cid:2)(cid:14)(cid:46)(cid:2)(cid:28)(cid:5)(cid:3)(cid:10)(cid:5)(cid:2)(cid:64)(cid:46)(cid:4)(cid:12)(cid:2)(cid:28)(cid:3,,7075.0
,,10,,,Unknown,,cid:50)(cid:46)(cid:12)(cid:2)(cid:7)(cid:8)(cid:10)(cid:5)(cid:3)(cid:48)(cid:46)(cid:3)(cid:12)(cid:13)(cid:5)(cid:2)(cid:14)(cid:46)(cid:2)(cid:28)(cid:5)(cid:3)(cid:10)(cid:5)(cid:2)(cid:64)(cid:46)(cid:4)(cid:12)(cid:2)(cid:28)(cid:3,,7085.0
,,46,,,Unknown,,cid:50)(cid:46)(cid:12)(cid:2)(cid:7)(cid:8)(cid:10)(cid:5)(cid:3)(cid:48)(cid:46)(cid:3)(cid:12)(cid:13)(cid:5)(cid:2)(cid:14)(cid:46)(cid:2)(cid:28)(cid:5)(cid:3)(cid:10)(cid:5)(cid:2)(cid:64)(cid:46)(cid:4)(cid:12)(cid:2)(cid:28)(cid:3,,7131.0
,,14,,,Unknown,,cid:50)(cid:46)(cid:12)(cid:2)(cid:7)(cid:8)(cid:10)(cid:5)(cid:3)(cid:48)(cid:46)(cid:3)(cid:12)(cid:13)(cid:5)(cid:2)(cid:14)(cid:46)(cid:2)(cid:28)(cid:5)(cid:3)(cid:10)(cid:5)(cid:2)(cid:64)(cid:46)(cid:4)(cid:12)(cid:2)(cid:28)(cid:3,,7145.0
,,2,,,Unknown,,cid:50)(cid:46)(cid:12)(cid:2)(cid:7)(cid:8)(cid:10)(cid:5)(cid:3)(cid:48)(cid:46)(cid:3)(cid:12)(cid:13)(cid:5)(cid:2)(cid:14)(cid:46)(cid:2)(cid:28)(cid:5)(cid:3)(cid:10)(cid:5)(cid:2)(cid:64)(cid:46)(cid:4)(cid:12)(cid:2)(cid:28)(cid:3,,7147.0
,,12,,,Unknown,,cid:50)(cid:46)(cid:12)(cid:2)(cid:7)(cid:8)(cid:10)(cid:5)(cid:3)(cid:48)(cid:46)(cid:3)(cid:12)(cid:13)(cid:5)(cid:2)(cid:14)(cid:46)(cid:2)(cid:28)(cid:5)(cid:3)(cid:10)(cid:5)(cid:2)(cid:64)(cid:46)(cid:4)(cid:12)(cid:2)(cid:28)(cid:3,,7159.0
,,11,,,Unknown,,cid:50)(cid:46)(cid:12)(cid:2)(cid:7)(cid:8)(cid:10)(cid:5)(cid:3)(cid:48)(cid:46)(cid:3)(cid:12)(cid:13)(cid:5)(cid:2)(cid:14)(cid:46)(cid:2)(cid:28)(cid:5)(cid:3)(cid:10)(cid:5)(cid:2)(cid:64)(cid:46)(cid:4)(cid:12)(cid:2)(cid:28)(cid:3,,7170.0
,,4,,,Unknown,,cid:50)(cid:46)(cid:12)(cid:2)(cid:7)(cid:8)(cid:10)(cid:5)(cid:3)(cid:48)(cid:46)(cid:3)(cid:12)(cid:13)(cid:5)(cid:2)(cid:14)(cid:46)(cid:2)(cid:28)(cid:5)(cid:3)(cid:10)(cid:5)(cid:2)(cid:64)(cid:46)(cid:4)(cid:12)(cid:2)(cid:28)(cid:3,,7174.0
,,14,,,Unknown,,cid:50)(cid:46)(cid:12)(cid:2)(cid:7)(cid:8)(cid:10)(cid:5)(cid:3)(cid:48)(cid:46)(cid:3)(cid:12)(cid:13)(cid:5)(cid:2)(cid:14)(cid:46)(cid:2)(cid:28)(cid:5)(cid:3)(cid:10)(cid:5)(cid:2)(cid:64)(cid:46)(cid:4)(cid:12)(cid:2)(cid:28)(cid:3,,7188.0
,,11,,,Unknown,,cid:50)(cid:46)(cid:12)(cid:2)(cid:7)(cid:8)(cid:10)(cid:5)(cid:3)(cid:48)(cid:46)(cid:3)(cid:12)(cid:13)(cid:5)(cid:2)(cid:14)(cid:46)(cid:2)(cid:28)(cid:5)(cid:3)(cid:10)(cid:5)(cid:2)(cid:64)(cid:46)(cid:4)(cid:12)(cid:2)(cid:28)(cid:3,,7199.0
,,48,,,Unknown,,cid:50)(cid:46)(cid:12)(cid:2)(cid:7)(cid:8)(cid:10)(cid:5)(cid:3)(cid:48)(cid:46)(cid:3)(cid:12)(cid:13)(cid:5)(cid:2)(cid:14)(cid:46)(cid:2)(cid:28)(cid:5)(cid:3)(cid:10)(cid:5)(cid:2)(cid:64)(cid:46)(cid:4)(cid:12)(cid:2)(cid:28)(cid:3,,7247.0
,,48,,,Unknown,,cid:50)(cid:46)(cid:12)(cid:2)(cid:7)(cid:8)(cid:10)(cid:5)(cid:3)(cid:48)(cid:46)(cid:3)(cid:12)(cid:13)(cid:5)(cid:2)(cid:14)(cid:46)(cid:2)(cid:28)(cid:5)(cid:3)(cid:10)(cid:5)(cid:2)(cid:64)(cid:46)(cid:4)(cid:12)(cid:2)(cid:28)(cid:3,,7295.0
,,7,,,Unknown,,cid:50)(cid:46)(cid:12)(cid:2)(cid:7)(cid:8)(cid:10)(cid:5)(cid:3)(cid:48)(cid:46)(cid:3)(cid:12)(cid:13)(cid:5)(cid:2)(cid:14)(cid:46)(cid:2)(cid:28)(cid:5)(cid:3)(cid:10)(cid:5)(cid:2)(cid:64)(cid:46)(cid:4)(cid:12)(cid:2)(cid:28)(cid:3,,7302.0
,,5,,,Unknown,,cid:50)(cid:46)(cid:12)(cid:2)(cid:7)(cid:8)(cid:10)(cid:5)(cid:3)(cid:48)(cid:46)(cid:3)(cid:12)(cid:13)(cid:5)(cid:2)(cid:14)(cid:46)(cid:2)(cid:28)(cid:5)(cid:3)(cid:10)(cid:5)(cid:2)(cid:64)(cid:46)(cid:4)(cid:12)(cid:2)(cid:28)(cid:3,,7307.0
,,3,,,Unknown,,cid:50)(cid:46)(cid:12)(cid:2)(cid:7)(cid:8)(cid:10)(cid:5)(cid:3)(cid:48)(cid:46)(cid:3)(cid:12)(cid:13)(cid:5)(cid:2)(cid:14)(cid:46)(cid:2)(cid:28)(cid:5)(cid:3)(cid:10)(cid:5)(cid:2)(cid:64)(cid:46)(cid:4)(cid:12)(cid:2)(cid:28)(cid:3,,7310.0
,,9,,,Unknown,,cid:50)(cid:46)(cid:12)(cid:2)(cid:7)(cid:8)(cid:10)(cid:5)(cid:3)(cid:48)(cid:46)(cid:3)(cid:12)(cid:13)(cid:5)(cid:2)(cid:14)(cid:46)(cid:2)(cid:28)(cid:5)(cid:3)(cid:10)(cid:5)(cid:2)(cid:64)(cid:46)(cid:4)(cid:12)(cid:2)(cid:28)(cid:3,,7319.0
,,2,,,Unknown,,cid:50)(cid:46)(cid:12)(cid:2)(cid:7)(cid:8)(cid:10)(cid:5)(cid:3)(cid:48)(cid:46)(cid:3)(cid:12)(cid:13)(cid:5)(cid:2)(cid:14)(cid:46)(cid:2)(cid:28)(cid:5)(cid:3)(cid:10)(cid:5)(cid:2)(cid:64)(cid:46)(cid:4)(cid:12)(cid:2)(cid:28)(cid:3,,7321.0
,,28,,,Unknown,,cid:50)(cid:46)(cid:12)(cid:2)(cid:7)(cid:8)(cid:10)(cid:5)(cid:3)(cid:48)(cid:46)(cid:3)(cid:12)(cid:13)(cid:5)(cid:2)(cid:14)(cid:46)(cid:2)(cid:28)(cid:5)(cid:3)(cid:10)(cid:5)(cid:2)(cid:64)(cid:46)(cid:4)(cid:12)(cid:2)(cid:28)(cid:3,,7349.0
,,3,,,Unknown,,cid:50)(cid:46)(cid:12)(cid:2)(cid:7)(cid:8)(cid:10)(cid:5)(cid:3)(cid:48)(cid:46)(cid:3)(cid:12)(cid:13)(cid:5)(cid:2)(cid:14)(cid:46)(cid:2)(cid:28)(cid:5)(cid:3)(cid:10)(cid:5)(cid:2)(cid:64)(cid:46)(cid:4)(cid:12)(cid:2)(cid:28)(cid:3,,7352.0
,,15,,,Unknown,,cid:50)(cid:46)(cid:12)(cid:2)(cid:7)(cid:8)(cid:10)(cid:5)(cid:3)(cid:48)(cid:46)(cid:3)(cid:12)(cid:13)(cid:5)(cid:2)(cid:14)(cid:46)(cid:2)(cid:28)(cid:5)(cid:3)(cid:10)(cid:5)(cid:2)(cid:64)(cid:46)(cid:4)(cid:12)(cid:2)(cid:28)(cid:3,,7367.0
,,2,,,Unknown,,cid:50)(cid:46)(cid:12)(cid:2)(cid:7)(cid:8)(cid:10)(cid:5)(cid:3)(cid:48)(cid:46)(cid:3)(cid:12)(cid:13)(cid:5)(cid:2)(cid:14)(cid:46)(cid:2)(cid:28)(cid:5)(cid:3)(cid:10)(cid:5)(cid:2)(cid:64)(cid:46)(cid:4)(cid:12)(cid:2)(cid:28)(cid:3,,7369.0
,,34,,,Unknown,,cid:50)(cid:46)(cid:12)(cid:2)(cid:7)(cid:8)(cid:10)(cid:5)(cid:3)(cid:48)(cid:46)(cid:3)(cid:12)(cid:13)(cid:5)(cid:2)(cid:14)(cid:46)(cid:2)(cid:28)(cid:5)(cid:3)(cid:10)(cid:5)(cid:2)(cid:64)(cid:46)(cid:4)(cid:12)(cid:2)(cid:28)(cid:3,,7403.0
,,18,,,Unknown,,cid:50)(cid:46)(cid:12)(cid:2)(cid:7)(cid:8)(cid:10)(cid:5)(cid:3)(cid:48)(cid:46)(cid:3)(cid:12)(cid:13)(cid:5)(cid:2)(cid:14)(cid:46)(cid:2)(cid:28)(cid:5)(cid:3)(cid:10)(cid:5)(cid:2)(cid:64)(cid:46)(cid:4)(cid:12)(cid:2)(cid:28)(cid:3,,7421.0
,,19,,,Unknown,,cid:50)(cid:46)(cid:12)(cid:2)(cid:7)(cid:8)(cid:10)(cid:5)(cid:3)(cid:48)(cid:46)(cid:3)(cid:12)(cid:13)(cid:5)(cid:2)(cid:14)(cid:46)(cid:2)(cid:28)(cid:5)(cid:3)(cid:10)(cid:5)(cid:2)(cid:64)(cid:46)(cid:4)(cid:12)(cid:2)(cid:28)(cid:3,,7440.0
,,18,,,Unknown,,cid:50)(cid:46)(cid:12)(cid:2)(cid:7)(cid:8)(cid:10)(cid:5)(cid:3)(cid:48)(cid:46)(cid:3)(cid:12)(cid:13)(cid:5)(cid:2)(cid:14)(cid:46)(cid:2)(cid:28)(cid:5)(cid:3)(cid:10)(cid:5)(cid:2)(cid:64)(cid:46)(cid:4)(cid:12)(cid:2)(cid:28)(cid:3,,7458.0
,,17,,,Unknown,,cid:50)(cid:46)(cid:12)(cid:2)(cid:7)(cid:8)(cid:10)(cid:5)(cid:3)(cid:48)(cid:46)(cid:3)(cid:12)(cid:13)(cid:5)(cid:2)(cid:14)(cid:46)(cid:2)(cid:28)(cid:5)(cid:3)(cid:10)(cid:5)(cid:2)(cid:64)(cid:46)(cid:4)(cid:12)(cid:2)(cid:28)(cid:3,,7475.0
,,2,,,Unknown,,cid:50)(cid:46)(cid:12)(cid:2)(cid:7)(cid:8)(cid:10)(cid:5)(cid:3)(cid:48)(cid:46)(cid:3)(cid:12)(cid:13)(cid:5)(cid:2)(cid:14)(cid:46)(cid:2)(cid:28)(cid:5)(cid:3)(cid:10)(cid:5)(cid:2)(cid:64)(cid:46)(cid:4)(cid:12)(cid:2)(cid:28)(cid:3,,7477.0
,,44,,,Unknown,,cid:50)(cid:46)(cid:12)(cid:2)(cid:7)(cid:8)(cid:10)(cid:5)(cid:3)(cid:48)(cid:46)(cid:3)(cid:12)(cid:13)(cid:5)(cid:2)(cid:14)(cid:46)(cid:2)(cid:28)(cid:5)(cid:3)(cid:10)(cid:5)(cid:2)(cid:64)(cid:46)(cid:4)(cid:12)(cid:2)(cid:28)(cid:3,,7521.0
,,12,,,Unknown,,cid:50)(cid:46)(cid:12)(cid:2)(cid:7)(cid:8)(cid:10)(cid:5)(cid:3)(cid:48)(cid:46)(cid:3)(cid:12)(cid:13)(cid:5)(cid:2)(cid:14)(cid:46)(cid:2)(cid:28)(cid:5)(cid:3)(cid:10)(cid:5)(cid:2)(cid:64)(cid:46)(cid:4)(cid:12)(cid:2)(cid:28)(cid:3,,7533.0
,,29,,,Unknown,,cid:50)(cid:46)(cid:12)(cid:2)(cid:7)(cid:8)(cid:10)(cid:5)(cid:3)(cid:48)(cid:46)(cid:3)(cid:12)(cid:13)(cid:5)(cid:2)(cid:14)(cid:46)(cid:2)(cid:28)(cid:5)(cid:3)(cid:10)(cid:5)(cid:2)(cid:64)(cid:46)(cid:4)(cid:12)(cid:2)(cid:28)(cid:3,,7562.0
,,26,,,Unknown,,cid:50)(cid:46)(cid:12)(cid:2)(cid:7)(cid:8)(cid:10)(cid:5)(cid:3)(cid:48)(cid:46)(cid:3)(cid:12)(cid:13)(cid:5)(cid:2)(cid:14)(cid:46)(cid:2)(cid:28)(cid:5)(cid:3)(cid:10)(cid:5)(cid:2)(cid:64)(cid:46)(cid:4)(cid:12)(cid:2)(cid:28)(cid:3,,7588.0
,,41,,,Unknown,,cid:50)(cid:46)(cid:12)(cid:2)(cid:7)(cid:8)(cid:10)(cid:5)(cid:3)(cid:48)(cid:46)(cid:3)(cid:12)(cid:13)(cid:5)(cid:2)(cid:14)(cid:46)(cid:2)(cid:28)(cid:5)(cid:3)(cid:10)(cid:5)(cid:2)(cid:64)(cid:46)(cid:4)(cid:12)(cid:2)(cid:28)(cid:3,,7629.0
,,25,,,Unknown,,cid:50)(cid:46)(cid:12)(cid:2)(cid:7)(cid:8)(cid:10)(cid:5)(cid:3)(cid:48)(cid:46)(cid:3)(cid:12)(cid:13)(cid:5)(cid:2)(cid:14)(cid:46)(cid:2)(cid:28)(cid:5)(cid:3)(cid:10)(cid:5)(cid:2)(cid:64)(cid:46)(cid:4)(cid:12)(cid:2)(cid:28)(cid:3,,7654.0
,,2,,,Unknown,,cid:50)(cid:46)(cid:12)(cid:2)(cid:7)(cid:8)(cid:10)(cid:5)(cid:3)(cid:48)(cid:46)(cid:3)(cid:12)(cid:13)(cid:5)(cid:2)(cid:14)(cid:46)(cid:2)(cid:28)(cid:5)(cid:3)(cid:10)(cid:5)(cid:2)(cid:64)(cid:46)(cid:4)(cid:12)(cid:2)(cid:28)(cid:3,,7656.0
,,58,,,Unknown,,cid:50)(cid:46)(cid:12)(cid:2)(cid:7)(cid:8)(cid:10)(cid:5)(cid:3)(cid:48)(cid:46)(cid:3)(cid:12)(cid:13)(cid:5)(cid:2)(cid:14)(cid:46)(cid:2)(cid:28)(cid:5)(cid:3)(cid:10)(cid:5)(cid:2)(cid:64)(cid:46)(cid:4)(cid:12)(cid:2)(cid:28)(cid:3,,7714.0
,,58,,,Unknown,,cid:50)(cid:46)(cid:12)(cid:2)(cid:7)(cid:8)(cid:10)(cid:5)(cid:3)(cid:48)(cid:46)(cid:3)(cid:12)(cid:13)(cid:5)(cid:2)(cid:14)(cid:46)(cid:2)(cid:28)(cid:5)(cid:3)(cid:10)(cid:5)(cid:2)(cid:64)(cid:46)(cid:4)(cid:12)(cid:2)(cid:28)(cid:3,,7772.0
,,18,,,Unknown,,cid:50)(cid:46)(cid:12)(cid:2)(cid:7)(cid:8)(cid:10)(cid:5)(cid:3)(cid:48)(cid:46)(cid:3)(cid:12)(cid:13)(cid:5)(cid:2)(cid:14)(cid:46)(cid:2)(cid:28)(cid:5)(cid:3)(cid:10)(cid:5)(cid:2)(cid:64)(cid:46)(cid:4)(cid:12)(cid:2)(cid:28)(cid:3,,7790.0
,,1,,,Unknown,,cid:50)(cid:46)(cid:12)(cid:2)(cid:7)(cid:8)(cid:10)(cid:5)(cid:3)(cid:48)(cid:46)(cid:3)(cid:12)(cid:13)(cid:5)(cid:2)(cid:14)(cid:46)(cid:2)(cid:28)(cid:5)(cid:3)(cid:10)(cid:5)(cid:2)(cid:64)(cid:46)(cid:4)(cid:12)(cid:2)(cid:28)(cid:3,,7791.0
,,1,,,Unknown,,cid:50)(cid:46)(cid:12)(cid:2)(cid:7)(cid:8)(cid:10)(cid:5)(cid:3)(cid:48)(cid:46)(cid:3)(cid:12)(cid:13)(cid:5)(cid:2)(cid:14)(cid:46)(cid:2)(cid:28)(cid:5)(cid:3)(cid:10)(cid:5)(cid:2)(cid:64)(cid:46)(cid:4)(cid:12)(cid:2)(cid:28)(cid:3,,7792.0
,,37,,,Unknown,,cid:50)(cid:46)(cid:12)(cid:2)(cid:7)(cid:8)(cid:10)(cid:5)(cid:3)(cid:48)(cid:46)(cid:3)(cid:12)(cid:13)(cid:5)(cid:2)(cid:14)(cid:46)(cid:2)(cid:28)(cid:5)(cid:3)(cid:10)(cid:5)(cid:2)(cid:64)(cid:46)(cid:4)(cid:12)(cid:2)(cid:28)(cid:3,,7829.0
,,18,,,Unknown,,cid:50)(cid:46)(cid:12)(cid:2)(cid:7)(cid:8)(cid:10)(cid:5)(cid:3)(cid:48)(cid:46)(cid:3)(cid:12)(cid:13)(cid:5)(cid:2)(cid:14)(cid:46)(cid:2)(cid:28)(cid:5)(cid:3)(cid:10)(cid:5)(cid:2)(cid:64)(cid:46)(cid:4)(cid:12)(cid:2)(cid:28)(cid:3,,7847.0
,,32,,,Unknown,,cid:50)(cid:46)(cid:12)(cid:2)(cid:7)(cid:8)(cid:10)(cid:5)(cid:3)(cid:48)(cid:46)(cid:3)(cid:12)(cid:13)(cid:5)(cid:2)(cid:14)(cid:46)(cid:2)(cid:28)(cid:5)(cid:3)(cid:10)(cid:5)(cid:2)(cid:64)(cid:46)(cid:4)(cid:12)(cid:2)(cid:28)(cid:3,,7879.0
,,45,,,Unknown,,cid:50)(cid:46)(cid:12)(cid:2)(cid:7)(cid:8)(cid:10)(cid:5)(cid:3)(cid:48)(cid:46)(cid:3)(cid:12)(cid:13)(cid:5)(cid:2)(cid:14)(cid:46)(cid:2)(cid:28)(cid:5)(cid:3)(cid:10)(cid:5)(cid:2)(cid:64)(cid:46)(cid:4)(cid:12)(cid:2)(cid:28)(cid:3,,7924.0
,,18,,,Unknown,,cid:50)(cid:46)(cid:12)(cid:2)(cid:7)(cid:8)(cid:10)(cid:5)(cid:3)(cid:48)(cid:46)(cid:3)(cid:12)(cid:13)(cid:5)(cid:2)(cid:14)(cid:46)(cid:2)(cid:28)(cid:5)(cid:3)(cid:10)(cid:5)(cid:2)(cid:64)(cid:46)(cid:4)(cid:12)(cid:2)(cid:28)(cid:3,,7942.0
,,16,,,Unknown,,cid:50)(cid:46)(cid:12)(cid:2)(cid:7)(cid:8)(cid:10)(cid:5)(cid:3)(cid:48)(cid:46)(cid:3)(cid:12)(cid:13)(cid:5)(cid:2)(cid:14)(cid:46)(cid:2)(cid:28)(cid:5)(cid:3)(cid:10)(cid:5)(cid:2)(cid:64)(cid:46)(cid:4)(cid:12)(cid:2)(cid:28)(cid:3,,7958.0
,,27,,,Unknown,,cid:50)(cid:46)(cid:12)(cid:2)(cid:7)(cid:8)(cid:10)(cid:5)(cid:3)(cid:48)(cid:46)(cid:3)(cid:12)(cid:13)(cid:5)(cid:2)(cid:14)(cid:46)(cid:2)(cid:28)(cid:5)(cid:3)(cid:10)(cid:5)(cid:2)(cid:64)(cid:46)(cid:4)(cid:12)(cid:2)(cid:28)(cid:3,,7985.0
,,31,,,Unknown,,cid:50)(cid:46)(cid:12)(cid:2)(cid:7)(cid:8)(cid:10)(cid:5)(cid:3)(cid:48)(cid:46)(cid:3)(cid:12)(cid:13)(cid:5)(cid:2)(cid:14)(cid:46)(cid:2)(cid:28)(cid:5)(cid:3)(cid:10)(cid:5)(cid:2)(cid:64)(cid:46)(cid:4)(cid:12)(cid:2)(cid:28)(cid:3,,8016.0
,,24,,,Unknown,,cid:50)(cid:46)(cid:12)(cid:2)(cid:7)(cid:8)(cid:10)(cid:5)(cid:3)(cid:48)(cid:46)(cid:3)(cid:12)(cid:13)(cid:5)(cid:2)(cid:14)(cid:46)(cid:2)(cid:28)(cid:5)(cid:3)(cid:10)(cid:5)(cid:2)(cid:64)(cid:46)(cid:4)(cid:12)(cid:2)(cid:28)(cid:3,,8040.0
,,2,,,Unknown,,cid:50)(cid:46)(cid:12)(cid:2)(cid:7)(cid:8)(cid:10)(cid:5)(cid:3)(cid:48)(cid:46)(cid:3)(cid:12)(cid:13)(cid:5)(cid:2)(cid:14)(cid:46)(cid:2)(cid:28)(cid:5)(cid:3)(cid:10)(cid:5)(cid:2)(cid:64)(cid:46)(cid:4)(cid:12)(cid:2)(cid:28)(cid:3,,8042.0
,,31,,,Unknown,,cid:50)(cid:46)(cid:12)(cid:2)(cid:7)(cid:8)(cid:10)(cid:5)(cid:3)(cid:48)(cid:46)(cid:3)(cid:12)(cid:13)(cid:5)(cid:2)(cid:14)(cid:46)(cid:2)(cid:28)(cid:5)(cid:3)(cid:10)(cid:5)(cid:2)(cid:64)(cid:46)(cid:4)(cid:12)(cid:2)(cid:28)(cid:3,,8073.0
,,30,,,Unknown,,cid:50)(cid:46)(cid:12)(cid:2)(cid:7)(cid:8)(cid:10)(cid:5)(cid:3)(cid:48)(cid:46)(cid:3)(cid:12)(cid:13)(cid:5)(cid:2)(cid:14)(cid:46)(cid:2)(cid:28)(cid:5)(cid:3)(cid:10)(cid:5)(cid:2)(cid:64)(cid:46)(cid:4)(cid:12)(cid:2)(cid:28)(cid:3,,8103.0
,,51,,,Unknown,,cid:50)(cid:46)(cid:12)(cid:2)(cid:7)(cid:8)(cid:10)(cid:5)(cid:3)(cid:48)(cid:46)(cid:3)(cid:12)(cid:13)(cid:5)(cid:2)(cid:14)(cid:46)(cid:2)(cid:28)(cid:5)(cid:3)(cid:10)(cid:5)(cid:2)(cid:64)(cid:46)(cid:4)(cid:12)(cid:2)(cid:28)(cid:3,,8154.0
,,27,,,Unknown,,cid:50)(cid:46)(cid:12)(cid:2)(cid:7)(cid:8)(cid:10)(cid:5)(cid:3)(cid:48)(cid:46)(cid:3)(cid:12)(cid:13)(cid:5)(cid:2)(cid:14)(cid:46)(cid:2)(cid:28)(cid:5)(cid:3)(cid:10)(cid:5)(cid:2)(cid:64)(cid:46)(cid:4)(cid:12)(cid:2)(cid:28)(cid:3,,8181.0
,,15,,,Unknown,,cid:50)(cid:46)(cid:12)(cid:2)(cid:7)(cid:8)(cid:10)(cid:5)(cid:3)(cid:48)(cid:46)(cid:3)(cid:12)(cid:13)(cid:5)(cid:2)(cid:14)(cid:46)(cid:2)(cid:28)(cid:5)(cid:3)(cid:10)(cid:5)(cid:2)(cid:64)(cid:46)(cid:4)(cid:12)(cid:2)(cid:28)(cid:3,,8196.0
,,2,,,Unknown,,cid:50)(cid:46)(cid:12)(cid:2)(cid:7)(cid:8)(cid:10)(cid:5)(cid:3)(cid:48)(cid:46)(cid:3)(cid:12)(cid:13)(cid:5)(cid:2)(cid:14)(cid:46)(cid:2)(cid:28)(cid:5)(cid:3)(cid:10)(cid:5)(cid:2)(cid:64)(cid:46)(cid:4)(cid:12)(cid:2)(cid:28)(cid:3,,8198.0
,,17,,,Unknown,,cid:50)(cid:46)(cid:12)(cid:2)(cid:7)(cid:8)(cid:10)(cid:5)(cid:3)(cid:48)(cid:46)(cid:3)(cid:12)(cid:13)(cid:5)(cid:2)(cid:14)(cid:46)(cid:2)(cid:28)(cid:5)(cid:3)(cid:10)(cid:5)(cid:2)(cid:64)(cid:46)(cid:4)(cid:12)(cid:2)(cid:28)(cid:3,,8215.0
,,2,,,Unknown,,cid:50)(cid:46)(cid:12)(cid:2)(cid:7)(cid:8)(cid:10)(cid:5)(cid:3)(cid:48)(cid:46)(cid:3)(cid:12)(cid:13)(cid:5)(cid:2)(cid:14)(cid:46)(cid:2)(cid:28)(cid:5)(cid:3)(cid:10)(cid:5)(cid:2)(cid:64)(cid:46)(cid:4)(cid:12)(cid:2)(cid:28)(cid:3,,8217.0
,,32,,,Unknown,,cid:50)(cid:46)(cid:12)(cid:2)(cid:7)(cid:8)(cid:10)(cid:5)(cid:3)(cid:48)(cid:46)(cid:3)(cid:12)(cid:13)(cid:5)(cid:2)(cid:14)(cid:46)(cid:2)(cid:28)(cid:5)(cid:3)(cid:10)(cid:5)(cid:2)(cid:64)(cid:46)(cid:4)(cid:12)(cid:2)(cid:28)(cid:3,,8249.0
,,35,,,Unknown,,cid:50)(cid:46)(cid:12)(cid:2)(cid:7)(cid:8)(cid:10)(cid:5)(cid:3)(cid:48)(cid:46)(cid:3)(cid:12)(cid:13)(cid:5)(cid:2)(cid:14)(cid:46)(cid:2)(cid:28)(cid:5)(cid:3)(cid:10)(cid:5)(cid:2)(cid:64)(cid:46)(cid:4)(cid:12)(cid:2)(cid:28)(cid:3,,8284.0
,,18,,,Unknown,,cid:50)(cid:46)(cid:12)(cid:2)(cid:7)(cid:8)(cid:10)(cid:5)(cid:3)(cid:48)(cid:46)(cid:3)(cid:12)(cid:13)(cid:5)(cid:2)(cid:14)(cid:46)(cid:2)(cid:28)(cid:5)(cid:3)(cid:10)(cid:5)(cid:2)(cid:64)(cid:46)(cid:4)(cid:12)(cid:2)(cid:28)(cid:3,,8302.0
,,19,,,Unknown,,cid:50)(cid:46)(cid:12)(cid:2)(cid:7)(cid:8)(cid:10)(cid:5)(cid:3)(cid:48)(cid:46)(cid:3)(cid:12)(cid:13)(cid:5)(cid:2)(cid:14)(cid:46)(cid:2)(cid:28)(cid:5)(cid:3)(cid:10)(cid:5)(cid:2)(cid:64)(cid:46)(cid:4)(cid:12)(cid:2)(cid:28)(cid:3,,8321.0
,,18,,,Unknown,,cid:50)(cid:46)(cid:12)(cid:2)(cid:7)(cid:8)(cid:10)(cid:5)(cid:3)(cid:48)(cid:46)(cid:3)(cid:12)(cid:13)(cid:5)(cid:2)(cid:14)(cid:46)(cid:2)(cid:28)(cid:5)(cid:3)(cid:10)(cid:5)(cid:2)(cid:64)(cid:46)(cid:4)(cid:12)(cid:2)(cid:28)(cid:3,,8339.0
,,18,,,Unknown,,cid:50)(cid:46)(cid:12)(cid:2)(cid:7)(cid:8)(cid:10)(cid:5)(cid:3)(cid:48)(cid:46)(cid:3)(cid:12)(cid:13)(cid:5)(cid:2)(cid:14)(cid:46)(cid:2)(cid:28)(cid:5)(cid:3)(cid:10)(cid:5)(cid:2)(cid:64)(cid:46)(cid:4)(cid:12)(cid:2)(cid:28)(cid:3,,8357.0
,,2,,,Unknown,,cid:50)(cid:46)(cid:12)(cid:2)(cid:7)(cid:8)(cid:10)(cid:5)(cid:3)(cid:48)(cid:46)(cid:3)(cid:12)(cid:13)(cid:5)(cid:2)(cid:14)(cid:46)(cid:2)(cid:28)(cid:5)(cid:3)(cid:10)(cid:5)(cid:2)(cid:64)(cid:46)(cid:4)(cid:12)(cid:2)(cid:28)(cid:3,,8359.0
,,44,,,Unknown,,cid:50)(cid:46)(cid:12)(cid:2)(cid:7)(cid:8)(cid:10)(cid:5)(cid:3)(cid:48)(cid:46)(cid:3)(cid:12)(cid:13)(cid:5)(cid:2)(cid:14)(cid:46)(cid:2)(cid:28)(cid:5)(cid:3)(cid:10)(cid:5)(cid:2)(cid:64)(cid:46)(cid:4)(cid:12)(cid:2)(cid:28)(cid:3,,8403.0
,,51,,,Unknown,,cid:50)(cid:46)(cid:12)(cid:2)(cid:7)(cid:8)(cid:10)(cid:5)(cid:3)(cid:48)(cid:46)(cid:3)(cid:12)(cid:13)(cid:5)(cid:2)(cid:14)(cid:46)(cid:2)(cid:28)(cid:5)(cid:3)(cid:10)(cid:5)(cid:2)(cid:64)(cid:46)(cid:4)(cid:12)(cid:2)(cid:28)(cid:3,,8454.0
,,29,,,Unknown,,cid:50)(cid:46)(cid:12)(cid:2)(cid:7)(cid:8)(cid:10)(cid:5)(cid:3)(cid:48)(cid:46)(cid:3)(cid:12)(cid:13)(cid:5)(cid:2)(cid:14)(cid:46)(cid:2)(cid:28)(cid:5)(cid:3)(cid:10)(cid:5)(cid:2)(cid:64)(cid:46)(cid:4)(cid:12)(cid:2)(cid:28)(cid:3,,8483.0
,,24,,,Unknown,,cid:50)(cid:46)(cid:12)(cid:2)(cid:7)(cid:8)(cid:10)(cid:5)(cid:3)(cid:48)(cid:46)(cid:3)(cid:12)(cid:13)(cid:5)(cid:2)(cid:14)(cid:46)(cid:2)(cid:28)(cid:5)(cid:3)(cid:10)(cid:5)(cid:2)(cid:64)(cid:46)(cid:4)(cid:12)(cid:2)(cid:28)(cid:3,,8507.0
,,25,,,Unknown,,cid:50)(cid:46)(cid:12)(cid:2)(cid:7)(cid:8)(cid:10)(cid:5)(cid:3)(cid:48)(cid:46)(cid:3)(cid:12)(cid:13)(cid:5)(cid:2)(cid:14)(cid:46)(cid:2)(cid:28)(cid:5)(cid:3)(cid:10)(cid:5)(cid:2)(cid:64)(cid:46)(cid:4)(cid:12)(cid:2)(cid:28)(cid:3,,8532.0
,,23,,,Unknown,,cid:50)(cid:46)(cid:12)(cid:2)(cid:7)(cid:8)(cid:10)(cid:5)(cid:3)(cid:48)(cid:46)(cid:3)(cid:12)(cid:13)(cid:5)(cid:2)(cid:14)(cid:46)(cid:2)(cid:28)(cid:5)(cid:3)(cid:10)(cid:5)(cid:2)(cid:64)(cid:46)(cid:4)(cid:12)(cid:2)(cid:28)(cid:3,,8555.0
,,25,,,Unknown,,cid:50)(cid:46)(cid:12)(cid:2)(cid:7)(cid:8)(cid:10)(cid:5)(cid:3)(cid:48)(cid:46)(cid:3)(cid:12)(cid:13)(cid:5)(cid:2)(cid:14)(cid:46)(cid:2)(cid:28)(cid:5)(cid:3)(cid:10)(cid:5)(cid:2)(cid:64)(cid:46)(cid:4)(cid:12)(cid:2)(cid:28)(cid:3,,8580.0
,,30,,,Unknown,,cid:50)(cid:46)(cid:12)(cid:2)(cid:7)(cid:8)(cid:10)(cid:5)(cid:3)(cid:48)(cid:46)(cid:3)(cid:12)(cid:13)(cid:5)(cid:2)(cid:14)(cid:46)(cid:2)(cid:28)(cid:5)(cid:3)(cid:10)(cid:5)(cid:2)(cid:64)(cid:46)(cid:4)(cid:12)(cid:2)(cid:28)(cid:3,,8610.0
,,41,,,Unknown,,cid:50)(cid:46)(cid:12)(cid:2)(cid:7)(cid:8)(cid:10)(cid:5)(cid:3)(cid:48)(cid:46)(cid:3)(cid:12)(cid:13)(cid:5)(cid:2)(cid:14)(cid:46)(cid:2)(cid:28)(cid:5)(cid:3)(cid:10)(cid:5)(cid:2)(cid:64)(cid:46)(cid:4)(cid:12)(cid:2)(cid:28)(cid:3,,8651.0
,,2,,,Unknown,,cid:50)(cid:46)(cid:12)(cid:2)(cid:7)(cid:8)(cid:10)(cid:5)(cid:3)(cid:48)(cid:46)(cid:3)(cid:12)(cid:13)(cid:5)(cid:2)(cid:14)(cid:46)(cid:2)(cid:28)(cid:5)(cid:3)(cid:10)(cid:5)(cid:2)(cid:64)(cid:46)(cid:4)(cid:12)(cid:2)(cid:28)(cid:3,,8653.0
,,22,,,Unknown,,cid:50)(cid:46)(cid:12)(cid:2)(cid:7)(cid:8)(cid:10)(cid:5)(cid:3)(cid:48)(cid:46)(cid:3)(cid:12)(cid:13)(cid:5)(cid:2)(cid:14)(cid:46)(cid:2)(cid:28)(cid:5)(cid:3)(cid:10)(cid:5)(cid:2)(cid:64)(cid:46)(cid:4)(cid:12)(cid:2)(cid:28)(cid:3,,8675.0
,,20,,,Unknown,,cid:50)(cid:46)(cid:12)(cid:2)(cid:7)(cid:8)(cid:10)(cid:5)(cid:3)(cid:48)(cid:46)(cid:3)(cid:12)(cid:13)(cid:5)(cid:2)(cid:14)(cid:46)(cid:2)(cid:28)(cid:5)(cid:3)(cid:10)(cid:5)(cid:2)(cid:64)(cid:46)(cid:4)(cid:12)(cid:2)(cid:28)(cid:3,,8695.0
,,59,,,Unknown,,cid:50)(cid:46)(cid:12)(cid:2)(cid:7)(cid:8)(cid:10)(cid:5)(cid:3)(cid:48)(cid:46)(cid:3)(cid:12)(cid:13)(cid:5)(cid:2)(cid:14)(cid:46)(cid:2)(cid:28)(cid:5)(cid:3)(cid:10)(cid:5)(cid:2)(cid:64)(cid:46)(cid:4)(cid:12)(cid:2)(cid:28)(cid:3,,8754.0
,,25,,,Unknown,,cid:50)(cid:46)(cid:12)(cid:2)(cid:7)(cid:8)(cid:10)(cid:5)(cid:3)(cid:48)(cid:46)(cid:3)(cid:12)(cid:13)(cid:5)(cid:2)(cid:14)(cid:46)(cid:2)(cid:28)(cid:5)(cid:3)(cid:10)(cid:5)(cid:2)(cid:64)(cid:46)(cid:4)(cid:12)(cid:2)(cid:28)(cid:3,,8779.0
,,26,,,Unknown,,cid:50)(cid:46)(cid:12)(cid:2)(cid:7)(cid:8)(cid:10)(cid:5)(cid:3)(cid:48)(cid:46)(cid:3)(cid:12)(cid:13)(cid:5)(cid:2)(cid:14)(cid:46)(cid:2)(cid:28)(cid:5)(cid:3)(cid:10)(cid:5)(cid:2)(cid:64)(cid:46)(cid:4)(cid:12)(cid:2)(cid:28)(cid:3,,8805.0
,,2,,,Unknown,,cid:50)(cid:46)(cid:12)(cid:2)(cid:7)(cid:8)(cid:10)(cid:5)(cid:3)(cid:48)(cid:46)(cid:3)(cid:12)(cid:13)(cid:5)(cid:2)(cid:14)(cid:46)(cid:2)(cid:28)(cid:5)(cid:3)(cid:10)(cid:5)(cid:2)(cid:64)(cid:46)(cid:4)(cid:12)(cid:2)(cid:28)(cid:3,,8807.0
,,60,,,Unknown,,cid:50)(cid:46)(cid:12)(cid:2)(cid:7)(cid:8)(cid:10)(cid:5)(cid:3)(cid:48)(cid:46)(cid:3)(cid:12)(cid:13)(cid:5)(cid:2)(cid:14)(cid:46)(cid:2)(cid:28)(cid:5)(cid:3)(cid:10)(cid:5)(cid:2)(cid:64)(cid:46)(cid:4)(cid:12)(cid:2)(cid:28)(cid:3,,8867.0
,,21,,,Unknown,,cid:50)(cid:46)(cid:12)(cid:2)(cid:7)(cid:8)(cid:10)(cid:5)(cid:3)(cid:48)(cid:46)(cid:3)(cid:12)(cid:13)(cid:5)(cid:2)(cid:14)(cid:46)(cid:2)(cid:28)(cid:5)(cid:3)(cid:10)(cid:5)(cid:2)(cid:64)(cid:46)(cid:4)(cid:12)(cid:2)(cid:28)(cid:3,,8888.0
,,24,,,Unknown,,cid:50)(cid:46)(cid:12)(cid:2)(cid:7)(cid:8)(cid:10)(cid:5)(cid:3)(cid:48)(cid:46)(cid:3)(cid:12)(cid:13)(cid:5)(cid:2)(cid:14)(cid:46)(cid:2)(cid:28)(cid:5)(cid:3)(cid:10)(cid:5)(cid:2)(cid:64)(cid:46)(cid:4)(cid:12)(cid:2)(cid:28)(cid:3,,8912.0
,,30,,,Unknown,,cid:50)(cid:46)(cid:12)(cid:2)(cid:7)(cid:8)(cid:10)(cid:5)(cid:3)(cid:48)(cid:46)(cid:3)(cid:12)(cid:13)(cid:5)(cid:2)(cid:14)(cid:46)(cid:2)(cid:28)(cid:5)(cid:3)(cid:10)(cid:5)(cid:2)(cid:64)(cid:46)(cid:4)(cid:12)(cid:2)(cid:28)(cid:3,,8942.0
,,18,,,Unknown,,cid:50)(cid:46)(cid:12)(cid:2)(cid:7)(cid:8)(cid:10)(cid:5)(cid:3)(cid:48)(cid:46)(cid:3)(cid:12)(cid:13)(cid:5)(cid:2)(cid:14)(cid:46)(cid:2)(cid:28)(cid:5)(cid:3)(cid:10)(cid:5)(cid:2)(cid:64)(cid:46)(cid:4)(cid:12)(cid:2)(cid:28)(cid:3,,8960.0
,,32,,,Unknown,,cid:50)(cid:46)(cid:12)(cid:2)(cid:7)(cid:8)(cid:10)(cid:5)(cid:3)(cid:48)(cid:46)(cid:3)(cid:12)(cid:13)(cid:5)(cid:2)(cid:14)(cid:46)(cid:2)(cid:28)(cid:5)(cid:3)(cid:10)(cid:5)(cid:2)(cid:64)(cid:46)(cid:4)(cid:12)(cid:2)(cid:28)(cid:3,,8992.0
,,45,,,Unknown,,cid:50)(cid:46)(cid:12)(cid:2)(cid:7)(cid:8)(cid:10)(cid:5)(cid:3)(cid:48)(cid:46)(cid:3)(cid:12)(cid:13)(cid:5)(cid:2)(cid:14)(cid:46)(cid:2)(cid:28)(cid:5)(cid:3)(cid:10)(cid:5)(cid:2)(cid:64)(cid:46)(cid:4)(cid:12)(cid:2)(cid:28)(cid:3,,9037.0
,,18,,,Unknown,,cid:50)(cid:46)(cid:12)(cid:2)(cid:7)(cid:8)(cid:10)(cid:5)(cid:3)(cid:48)(cid:46)(cid:3)(cid:12)(cid:13)(cid:5)(cid:2)(cid:14)(cid:46)(cid:2)(cid:28)(cid:5)(cid:3)(cid:10)(cid:5)(cid:2)(cid:64)(cid:46)(cid:4)(cid:12)(cid:2)(cid:28)(cid:3,,9055.0
,,16,,,Unknown,,cid:50)(cid:46)(cid:12)(cid:2)(cid:7)(cid:8)(cid:10)(cid:5)(cid:3)(cid:48)(cid:46)(cid:3)(cid:12)(cid:13)(cid:5)(cid:2)(cid:14)(cid:46)(cid:2)(cid:28)(cid:5)(cid:3)(cid:10)(cid:5)(cid:2)(cid:64)(cid:46)(cid:4)(cid:12)(cid:2)(cid:28)(cid:3,,9071.0
,,61,,,Unknown,,cid:50)(cid:46)(cid:12)(cid:2)(cid:7)(cid:8)(cid:10)(cid:5)(cid:3)(cid:48)(cid:46)(cid:3)(cid:12)(cid:13)(cid:5)(cid:2)(cid:14)(cid:46)(cid:2)(cid:28)(cid:5)(cid:3)(cid:10)(cid:5)(cid:2)(cid:64)(cid:46)(cid:4)(cid:12)(cid:2)(cid:28)(cid:3,,9132.0
,,29,,,Unknown,,cid:50)(cid:46)(cid:12)(cid:2)(cid:7)(cid:8)(cid:10)(cid:5)(cid:3)(cid:48)(cid:46)(cid:3)(cid:12)(cid:13)(cid:5)(cid:2)(cid:14)(cid:46)(cid:2)(cid:28)(cid:5)(cid:3)(cid:10)(cid:5)(cid:2)(cid:64)(cid:46)(cid:4)(cid:12)(cid:2)(cid:28)(cid:3,,9161.0
,,62,,,Unknown,,cid:50)(cid:46)(cid:12)(cid:2)(cid:7)(cid:8)(cid:10)(cid:5)(cid:3)(cid:48)(cid:46)(cid:3)(cid:12)(cid:13)(cid:5)(cid:2)(cid:14)(cid:46)(cid:2)(cid:28)(cid:5)(cid:3)(cid:10)(cid:5)(cid:2)(cid:64)(cid:46)(cid:4)(cid:12)(cid:2)(cid:28)(cid:3,,9223.0
,,24,,,Unknown,,cid:50)(cid:46)(cid:12)(cid:2)(cid:7)(cid:8)(cid:10)(cid:5)(cid:3)(cid:48)(cid:46)(cid:3)(cid:12)(cid:13)(cid:5)(cid:2)(cid:14)(cid:46)(cid:2)(cid:28)(cid:5)(cid:3)(cid:10)(cid:5)(cid:2)(cid:64)(cid:46)(cid:4)(cid:12)(cid:2)(cid:28)(cid:3,,9247.0
,,25,,,Unknown,,cid:50)(cid:46)(cid:12)(cid:2)(cid:7)(cid:8)(cid:10)(cid:5)(cid:3)(cid:48)(cid:46)(cid:3)(cid:12)(cid:13)(cid:5)(cid:2)(cid:14)(cid:46)(cid:2)(cid:28)(cid:5)(cid:3)(cid:10)(cid:5)(cid:2)(cid:64)(cid:46)(cid:4)(cid:12)(cid:2)(cid:28)(cid:3,,9272.0
,,26,,,Unknown,,cid:50)(cid:46)(cid:12)(cid:2)(cid:7)(cid:8)(cid:10)(cid:5)(cid:3)(cid:48)(cid:46)(cid:3)(cid:12)(cid:13)(cid:5)(cid:2)(cid:14)(cid:46)(cid:2)(cid:28)(cid:5)(cid:3)(cid:10)(cid:5)(cid:2)(cid:64)(cid:46)(cid:4)(cid:12)(cid:2)(cid:28)(cid:3,,9298.0
,,2,,,Unknown,,cid:50)(cid:46)(cid:12)(cid:2)(cid:7)(cid:8)(cid:10)(cid:5)(cid:3)(cid:48)(cid:46)(cid:3)(cid:12)(cid:13)(cid:5)(cid:2)(cid:14)(cid:46)(cid:2)(cid:28)(cid:5)(cid:3)(cid:10)(cid:5)(cid:2)(cid:64)(cid:46)(cid:4)(cid:12)(cid:2)(cid:28)(cid:3,,9300.0
,,63,,,Unknown,,cid:50)(cid:46)(cid:12)(cid:2)(cid:7)(cid:8)(cid:10)(cid:5)(cid:3)(cid:48)(cid:46)(cid:3)(cid:12)(cid:13)(cid:5)(cid:2)(cid:14)(cid:46)(cid:2)(cid:28)(cid:5)(cid:3)(cid:10)(cid:5)(cid:2)(cid:64)(cid:46)(cid:4)(cid:12)(cid:2)(cid:28)(cid:3,,9363.0
,,24,,,Unknown,,cid:50)(cid:46)(cid:12)(cid:2)(cid:7)(cid:8)(cid:10)(cid:5)(cid:3)(cid:48)(cid:46)(cid:3)(cid:12)(cid:13)(cid:5)(cid:2)(cid:14)(cid:46)(cid:2)(cid:28)(cid:5)(cid:3)(cid:10)(cid:5)(cid:2)(cid:64)(cid:46)(cid:4)(cid:12)(cid:2)(cid:28)(cid:3,,9387.0
,,26,,,Unknown,,cid:50)(cid:46)(cid:12)(cid:2)(cid:7)(cid:8)(cid:10)(cid:5)(cid:3)(cid:48)(cid:46)(cid:3)(cid:12)(cid:13)(cid:5)(cid:2)(cid:14)(cid:46)(cid:2)(cid:28)(cid:5)(cid:3)(cid:10)(cid:5)(cid:2)(cid:64)(cid:46)(cid:4)(cid:12)(cid:2)(cid:28)(cid:3,,9413.0
,,29,,,Unknown,,cid:50)(cid:46)(cid:12)(cid:2)(cid:7)(cid:8)(cid:10)(cid:5)(cid:3)(cid:48)(cid:46)(cid:3)(cid:12)(cid:13)(cid:5)(cid:2)(cid:14)(cid:46)(cid:2)(cid:28)(cid:5)(cid:3)(cid:10)(cid:5)(cid:2)(cid:64)(cid:46)(cid:4)(cid:12)(cid:2)(cid:28)(cid:3,,9442.0
,,21,,,Unknown,,cid:50)(cid:46)(cid:12)(cid:2)(cid:7)(cid:8)(cid:10)(cid:5)(cid:3)(cid:48)(cid:46)(cid:3)(cid:12)(cid:13)(cid:5)(cid:2)(cid:14)(cid:46)(cid:2)(cid:28)(cid:5)(cid:3)(cid:10)(cid:5)(cid:2)(cid:64)(cid:46)(cid:4)(cid:12)(cid:2)(cid:28)(cid:3,,9463.0
,,53,,,Unknown,,cid:50)(cid:46)(cid:12)(cid:2)(cid:7)(cid:8)(cid:10)(cid:5)(cid:3)(cid:48)(cid:46)(cid:3)(cid:12)(cid:13)(cid:5)(cid:2)(cid:14)(cid:46)(cid:2)(cid:28)(cid:5)(cid:3)(cid:10)(cid:5)(cid:2)(cid:64)(cid:46)(cid:4)(cid:12)(cid:2)(cid:28)(cid:3,,9516.0
,,15,,,Unknown,,cid:50)(cid:46)(cid:12)(cid:2)(cid:7)(cid:8)(cid:10)(cid:5)(cid:3)(cid:48)(cid:46)(cid:3)(cid:12)(cid:13)(cid:5)(cid:2)(cid:14)(cid:46)(cid:2)(cid:28)(cid:5)(cid:3)(cid:10)(cid:5)(cid:2)(cid:64)(cid:46)(cid:4)(cid:12)(cid:2)(cid:28)(cid:3,,9531.0
,,2,,,Unknown,,cid:50)(cid:46)(cid:12)(cid:2)(cid:7)(cid:8)(cid:10)(cid:5)(cid:3)(cid:48)(cid:46)(cid:3)(cid:12)(cid:13)(cid:5)(cid:2)(cid:14)(cid:46)(cid:2)(cid:28)(cid:5)(cid:3)(cid:10)(cid:5)(cid:2)(cid:64)(cid:46)(cid:4)(cid:12)(cid:2)(cid:28)(cid:3,,9533.0
,,17,,,Unknown,,cid:50)(cid:46)(cid:12)(cid:2)(cid:7)(cid:8)(cid:10)(cid:5)(cid:3)(cid:48)(cid:46)(cid:3)(cid:12)(cid:13)(cid:5)(cid:2)(cid:14)(cid:46)(cid:2)(cid:28)(cid:5)(cid:3)(cid:10)(cid:5)(cid:2)(cid:64)(cid:46)(cid:4)(cid:12)(cid:2)(cid:28)(cid:3,,9550.0
,,2,,,Unknown,,cid:50)(cid:46)(cid:12)(cid:2)(cid:7)(cid:8)(cid:10)(cid:5)(cid:3)(cid:48)(cid:46)(cid:3)(cid:12)(cid:13)(cid:5)(cid:2)(cid:14)(cid:46)(cid:2)(cid:28)(cid:5)(cid:3)(cid:10)(cid:5)(cid:2)(cid:64)(cid:46)(cid:4)(cid:12)(cid:2)(cid:28)(cid:3,,9552.0
,,18,,,Unknown,,cid:50)(cid:46)(cid:12)(cid:2)(cid:7)(cid:8)(cid:10)(cid:5)(cid:3)(cid:48)(cid:46)(cid:3)(cid:12)(cid:13)(cid:5)(cid:2)(cid:14)(cid:46)(cid:2)(cid:28)(cid:5)(cid:3)(cid:10)(cid:5)(cid:2)(cid:64)(cid:46)(cid:4)(cid:12)(cid:2)(cid:28)(cid:3,,9570.0
,,18,,,Unknown,,cid:50)(cid:46)(cid:12)(cid:2)(cid:7)(cid:8)(cid:10)(cid:5)(cid:3)(cid:48)(cid:46)(cid:3)(cid:12)(cid:13)(cid:5)(cid:2)(cid:14)(cid:46)(cid:2)(cid:28)(cid:5)(cid:3)(cid:10)(cid:5)(cid:2)(cid:64)(cid:46)(cid:4)(cid:12)(cid:2)(cid:28)(cid:3,,9588.0
,,18,,,Unknown,,cid:50)(cid:46)(cid:12)(cid:2)(cid:7)(cid:8)(cid:10)(cid:5)(cid:3)(cid:48)(cid:46)(cid:3)(cid:12)(cid:13)(cid:5)(cid:2)(cid:14)(cid:46)(cid:2)(cid:28)(cid:5)(cid:3)(cid:10)(cid:5)(cid:2)(cid:64)(cid:46)(cid:4)(cid:12)(cid:2)(cid:28)(cid:3,,9606.0
,,19,,,Unknown,,cid:50)(cid:46)(cid:12)(cid:2)(cid:7)(cid:8)(cid:10)(cid:5)(cid:3)(cid:48)(cid:46)(cid:3)(cid:12)(cid:13)(cid:5)(cid:2)(cid:14)(cid:46)(cid:2)(cid:28)(cid:5)(cid:3)(cid:10)(cid:5)(cid:2)(cid:64)(cid:46)(cid:4)(cid:12)(cid:2)(cid:28)(cid:3,,9625.0
,,18,,,Unknown,,cid:50)(cid:46)(cid:12)(cid:2)(cid:7)(cid:8)(cid:10)(cid:5)(cid:3)(cid:48)(cid:46)(cid:3)(cid:12)(cid:13)(cid:5)(cid:2)(cid:14)(cid:46)(cid:2)(cid:28)(cid:5)(cid:3)(cid:10)(cid:5)(cid:2)(cid:64)(cid:46)(cid:4)(cid:12)(cid:2)(cid:28)(cid:3,,9643.0
,,18,,,Unknown,,cid:50)(cid:46)(cid:12)(cid:2)(cid:7)(cid:8)(cid:10)(cid:5)(cid:3)(cid:48)(cid:46)(cid:3)(cid:12)(cid:13)(cid:5)(cid:2)(cid:14)(cid:46)(cid:2)(cid:28)(cid:5)(cid:3)(cid:10)(cid:5)(cid:2)(cid:64)(cid:46)(cid:4)(cid:12)(cid:2)(cid:28)(cid:3,,9661.0
,,2,,,Unknown,,cid:50)(cid:46)(cid:12)(cid:2)(cid:7)(cid:8)(cid:10)(cid:5)(cid:3)(cid:48)(cid:46)(cid:3)(cid:12)(cid:13)(cid:5)(cid:2)(cid:14)(cid:46)(cid:2)(cid:28)(cid:5)(cid:3)(cid:10)(cid:5)(cid:2)(cid:64)(cid:46)(cid:4)(cid:12)(cid:2)(cid:28)(cid:3,,9663.0
,,44,,,Unknown,,cid:50)(cid:46)(cid:12)(cid:2)(cid:7)(cid:8)(cid:10)(cid:5)(cid:3)(cid:48)(cid:46)(cid:3)(cid:12)(cid:13)(cid:5)(cid:2)(cid:14)(cid:46)(cid:2)(cid:28)(cid:5)(cid:3)(cid:10)(cid:5)(cid:2)(cid:64)(cid:46)(cid:4)(cid:12)(cid:2)(cid:28)(cid:3,,9707.0
,,29,,,Unknown,,cid:50)(cid:46)(cid:12)(cid:2)(cid:7)(cid:8)(cid:10)(cid:5)(cid:3)(cid:48)(cid:46)(cid:3)(cid:12)(cid:13)(cid:5)(cid:2)(cid:14)(cid:46)(cid:2)(cid:28)(cid:5)(cid:3)(cid:10)(cid:5)(cid:2)(cid:64)(cid:46)(cid:4)(cid:12)(cid:2)(cid:28)(cid:3,,9736.0
,,31,,,Unknown,,cid:50)(cid:46)(cid:12)(cid:2)(cid:7)(cid:8)(cid:10)(cid:5)(cid:3)(cid:48)(cid:46)(cid:3)(cid:12)(cid:13)(cid:5)(cid:2)(cid:14)(cid:46)(cid:2)(cid:28)(cid:5)(cid:3)(cid:10)(cid:5)(cid:2)(cid:64)(cid:46)(cid:4)(cid:12)(cid:2)(cid:28)(cid:3,,9767.0
,,54,,,Unknown,,cid:50)(cid:46)(cid:12)(cid:2)(cid:7)(cid:8)(cid:10)(cid:5)(cid:3)(cid:48)(cid:46)(cid:3)(cid:12)(cid:13)(cid:5)(cid:2)(cid:14)(cid:46)(cid:2)(cid:28)(cid:5)(cid:3)(cid:10)(cid:5)(cid:2)(cid:64)(cid:46)(cid:4)(cid:12)(cid:2)(cid:28)(cid:3,,9821.0
,,29,,,Unknown,,cid:50)(cid:46)(cid:12)(cid:2)(cid:7)(cid:8)(cid:10)(cid:5)(cid:3)(cid:48)(cid:46)(cid:3)(cid:12)(cid:13)(cid:5)(cid:2)(cid:14)(cid:46)(cid:2)(cid:28)(cid:5)(cid:3)(cid:10)(cid:5)(cid:2)(cid:64)(cid:46)(cid:4)(cid:12)(cid:2)(cid:28)(cid:3,,9850.0
,,41,,,Unknown,,cid:50)(cid:46)(cid:12)(cid:2)(cid:7)(cid:8)(cid:10)(cid:5)(cid:3)(cid:48)(cid:46)(cid:3)(cid:12)(cid:13)(cid:5)(cid:2)(cid:14)(cid:46)(cid:2)(cid:28)(cid:5)(cid:3)(cid:10)(cid:5)(cid:2)(cid:64)(cid:46)(cid:4)(cid:12)(cid:2)(cid:28)(cid:3,,9891.0
,,2,,,Unknown,,cid:50)(cid:46)(cid:12)(cid:2)(cid:7)(cid:8)(cid:10)(cid:5)(cid:3)(cid:48)(cid:46)(cid:3)(cid:12)(cid:13)(cid:5)(cid:2)(cid:14)(cid:46)(cid:2)(cid:28)(cid:5)(cid:3)(cid:10)(cid:5)(cid:2)(cid:64)(cid:46)(cid:4)(cid:12)(cid:2)(cid:28)(cid:3,,9893.0
,,51,,,Unknown,,cid:50)(cid:46)(cid:12)(cid:2)(cid:7)(cid:8)(cid:10)(cid:5)(cid:3)(cid:48)(cid:46)(cid:3)(cid:12)(cid:13)(cid:5)(cid:2)(cid:14)(cid:46)(cid:2)(cid:28)(cid:5)(cid:3)(cid:10)(cid:5)(cid:2)(cid:64)(cid:46)(cid:4)(cid:12)(cid:2)(cid:28)(cid:3,,9944.0
,,25,,,Unknown,,cid:50)(cid:46)(cid:12)(cid:2)(cid:7)(cid:8)(cid:10)(cid:5)(cid:3)(cid:48)(cid:46)(cid:3)(cid:12)(cid:13)(cid:5)(cid:2)(cid:14)(cid:46)(cid:2)(cid:28)(cid:5)(cid:3)(cid:10)(cid:5)(cid:2)(cid:64)(cid:46)(cid:4)(cid:12)(cid:2)(cid:28)(cid:3,,9969.0
,,22,,,Unknown,,cid:50)(cid:46)(cid:12)(cid:2)(cid:7)(cid:8)(cid:10)(cid:5)(cid:3)(cid:48)(cid:46)(cid:3)(cid:12)(cid:13)(cid:5)(cid:2)(cid:14)(cid:46)(cid:2)(cid:28)(cid:5)(cid:3)(cid:10)(cid:5)(cid:2)(cid:64)(cid:46)(cid:4)(cid:12)(cid:2)(cid:28)(cid:3,,9991.0
,,22,,,Unknown,,cid:50)(cid:46)(cid:12)(cid:2)(cid:7)(cid:8)(cid:10)(cid:5)(cid:3)(cid:48)(cid:46)(cid:3)(cid:12)(cid:13)(cid:5)(cid:2)(cid:14)(cid:46)(cid:2)(cid:28)(cid:5)(cid:3)(cid:10)(cid:5)(cid:2)(cid:64)(cid:46)(cid:4)(cid:12)(cid:2)(cid:28)(cid:3,,10013.0
,,25,,,Unknown,,cid:50)(cid:46)(cid:12)(cid:2)(cid:7)(cid:8)(cid:10)(cid:5)(cid:3)(cid:48)(cid:46)(cid:3)(cid:12)(cid:13)(cid:5)(cid:2)(cid:14)(cid:46)(cid:2)(cid:28)(cid:5)(cid:3)(cid:10)(cid:5)(cid:2)(cid:64)(cid:46)(cid:4)(cid:12)(cid:2)(cid:28)(cid:3,,10038.0
,,18,,,Unknown,,cid:50)(cid:46)(cid:12)(cid:2)(cid:7)(cid:8)(cid:10)(cid:5)(cid:3)(cid:48)(cid:46)(cid:3)(cid:12)(cid:13)(cid:5)(cid:2)(cid:14)(cid:46)(cid:2)(cid:28)(cid:5)(cid:3)(cid:10)(cid:5)(cid:2)(cid:64)(cid:46)(cid:4)(cid:12)(cid:2)(cid:28)(cid:3,,10056.0
,,32,,,Unknown,,cid:50)(cid:46)(cid:12)(cid:2)(cid:7)(cid:8)(cid:10)(cid:5)(cid:3)(cid:48)(cid:46)(cid:3)(cid:12)(cid:13)(cid:5)(cid:2)(cid:14)(cid:46)(cid:2)(cid:28)(cid:5)(cid:3)(cid:10)(cid:5)(cid:2)(cid:64)(cid:46)(cid:4)(cid:12)(cid:2)(cid:28)(cid:3,,10088.0
,,45,,,Unknown,,cid:50)(cid:46)(cid:12)(cid:2)(cid:7)(cid:8)(cid:10)(cid:5)(cid:3)(cid:48)(cid:46)(cid:3)(cid:12)(cid:13)(cid:5)(cid:2)(cid:14)(cid:46)(cid:2)(cid:28)(cid:5)(cid:3)(cid:10)(cid:5)(cid:2)(cid:64)(cid:46)(cid:4)(cid:12)(cid:2)(cid:28)(cid:3,,10133.0
,,18,,,Unknown,,cid:50)(cid:46)(cid:12)(cid:2)(cid:7)(cid:8)(cid:10)(cid:5)(cid:3)(cid:48)(cid:46)(cid:3)(cid:12)(cid:13)(cid:5)(cid:2)(cid:14)(cid:46)(cid:2)(cid:28)(cid:5)(cid:3)(cid:10)(cid:5)(cid:2)(cid:64)(cid:46)(cid:4)(cid:12)(cid:2)(cid:28)(cid:3,,10151.0
,,16,,,Unknown,,cid:50)(cid:46)(cid:12)(cid:2)(cid:7)(cid:8)(cid:10)(cid:5)(cid:3)(cid:48)(cid:46)(cid:3)(cid:12)(cid:13)(cid:5)(cid:2)(cid:14)(cid:46)(cid:2)(cid:28)(cid:5)(cid:3)(cid:10)(cid:5)(cid:2)(cid:64)(cid:46)(cid:4)(cid:12)(cid:2)(cid:28)(cid:3,,10167.0
,,50,,,Unknown,,cid:50)(cid:46)(cid:12)(cid:2)(cid:7)(cid:8)(cid:10)(cid:5)(cid:3)(cid:48)(cid:46)(cid:3)(cid:12)(cid:13)(cid:5)(cid:2)(cid:14)(cid:46)(cid:2)(cid:28)(cid:5)(cid:3)(cid:10)(cid:5)(cid:2)(cid:64)(cid:46)(cid:4)(cid:12)(cid:2)(cid:28)(cid:3,,10217.0
,,46,,,Unknown,,cid:50)(cid:46)(cid:12)(cid:2)(cid:7)(cid:8)(cid:10)(cid:5)(cid:3)(cid:48)(cid:46)(cid:3)(cid:12)(cid:13)(cid:5)(cid:2)(cid:14)(cid:46)(cid:2)(cid:28)(cid:5)(cid:3)(cid:10)(cid:5)(cid:2)(cid:64)(cid:46)(cid:4)(cid:12)(cid:2)(cid:28)(cid:3,,10263.0
,,12,,,Unknown,,cid:50)(cid:46)(cid:12)(cid:2)(cid:7)(cid:8)(cid:10)(cid:5)(cid:3)(cid:48)(cid:46)(cid:3)(cid:12)(cid:13)(cid:5)(cid:2)(cid:14)(cid:46)(cid:2)(cid:28)(cid:5)(cid:3)(cid:10)(cid:5)(cid:2)(cid:64)(cid:46)(cid:4)(cid:12)(cid:2)(cid:28)(cid:3,,10275.0
,,2,,,Unknown,,cid:50)(cid:46)(cid:12)(cid:2)(cid:7)(cid:8)(cid:10)(cid:5)(cid:3)(cid:48)(cid:46)(cid:3)(cid:12)(cid:13)(cid:5)(cid:2)(cid:14)(cid:46)(cid:2)(cid:28)(cid:5)(cid:3)(cid:10)(cid:5)(cid:2)(cid:64)(cid:46)(cid:4)(cid:12)(cid:2)(cid:28)(cid:3,,10277.0
,,7,,,Unknown,,cid:50)(cid:46)(cid:12)(cid:2)(cid:7)(cid:8)(cid:10)(cid:5)(cid:3)(cid:48)(cid:46)(cid:3)(cid:12)(cid:13)(cid:5)(cid:2)(cid:14)(cid:46)(cid:2)(cid:28)(cid:5)(cid:3)(cid:10)(cid:5)(cid:2)(cid:64)(cid:46)(cid:4)(cid:12)(cid:2)(cid:28)(cid:3,,10284.0
,,8,,,Unknown,,cid:50)(cid:46)(cid:12)(cid:2)(cid:7)(cid:8)(cid:10)(cid:5)(cid:3)(cid:48)(cid:46)(cid:3)(cid:12)(cid:13)(cid:5)(cid:2)(cid:14)(cid:46)(cid:2)(cid:28)(cid:5)(cid:3)(cid:10)(cid:5)(cid:2)(cid:64)(cid:46)(cid:4)(cid:12)(cid:2)(cid:28)(cid:3,,10292.0
,,10,,,Unknown,,cid:50)(cid:46)(cid:12)(cid:2)(cid:7)(cid:8)(cid:10)(cid:5)(cid:3)(cid:48)(cid:46)(cid:3)(cid:12)(cid:13)(cid:5)(cid:2)(cid:14)(cid:46)(cid:2)(cid:28)(cid:5)(cid:3)(cid:10)(cid:5)(cid:2)(cid:64)(cid:46)(cid:4)(cid:12)(cid:2)(cid:28)(cid:3,,10302.0
,,5,,,Unknown,,cid:50)(cid:46)(cid:12)(cid:2)(cid:7)(cid:8)(cid:10)(cid:5)(cid:3)(cid:48)(cid:46)(cid:3)(cid:12)(cid:13)(cid:5)(cid:2)(cid:14)(cid:46)(cid:2)(cid:28)(cid:5)(cid:3)(cid:10)(cid:5)(cid:2)(cid:64)(cid:46)(cid:4)(cid:12)(cid:2)(cid:28)(cid:3,,10307.0
,,3,,,Unknown,,cid:50)(cid:46)(cid:12)(cid:2)(cid:7)(cid:8)(cid:10)(cid:5)(cid:3)(cid:48)(cid:46)(cid:3)(cid:12)(cid:13)(cid:5)(cid:2)(cid:14)(cid:46)(cid:2)(cid:28)(cid:5)(cid:3)(cid:10)(cid:5)(cid:2)(cid:64)(cid:46)(cid:4)(cid:12)(cid:2)(cid:28)(cid:3,,10310.0
,,48,,,Unknown,,cid:50)(cid:46)(cid:12)(cid:2)(cid:7)(cid:8)(cid:10)(cid:5)(cid:3)(cid:48)(cid:46)(cid:3)(cid:12)(cid:13)(cid:5)(cid:2)(cid:14)(cid:46)(cid:2)(cid:28)(cid:5)(cid:3)(cid:10)(cid:5)(cid:2)(cid:64)(cid:46)(cid:4)(cid:12)(cid:2)(cid:28)(cid:3,,10358.0
,,46,,,Unknown,,cid:50)(cid:46)(cid:12)(cid:2)(cid:7)(cid:8)(cid:10)(cid:5)(cid:3)(cid:48)(cid:46)(cid:3)(cid:12)(cid:13)(cid:5)(cid:2)(cid:14)(cid:46)(cid:2)(cid:28)(cid:5)(cid:3)(cid:10)(cid:5)(cid:2)(cid:64)(cid:46)(cid:4)(cid:12)(cid:2)(cid:28)(cid:3,,10404.0
,,3,,,Unknown,,cid:50)(cid:46)(cid:12)(cid:2)(cid:7)(cid:8)(cid:10)(cid:5)(cid:3)(cid:48)(cid:46)(cid:3)(cid:12)(cid:13)(cid:5)(cid:2)(cid:14)(cid:46)(cid:2)(cid:28)(cid:5)(cid:3)(cid:10)(cid:5)(cid:2)(cid:64)(cid:46)(cid:4)(cid:12)(cid:2)(cid:28)(cid:3,,10407.0
,,12,,,Unknown,,cid:50)(cid:46)(cid:12)(cid:2)(cid:7)(cid:8)(cid:10)(cid:5)(cid:3)(cid:48)(cid:46)(cid:3)(cid:12)(cid:13)(cid:5)(cid:2)(cid:14)(cid:46)(cid:2)(cid:28)(cid:5)(cid:3)(cid:10)(cid:5)(cid:2)(cid:64)(cid:46)(cid:4)(cid:12)(cid:2)(cid:28)(cid:3,,10419.0
,,13,,,Unknown,,cid:50)(cid:46)(cid:12)(cid:2)(cid:7)(cid:8)(cid:10)(cid:5)(cid:3)(cid:48)(cid:46)(cid:3)(cid:12)(cid:13)(cid:5)(cid:2)(cid:14)(cid:46)(cid:2)(cid:28)(cid:5)(cid:3)(cid:10)(cid:5)(cid:2)(cid:64)(cid:46)(cid:4)(cid:12)(cid:2)(cid:28)(cid:3,,10432.0
,,5,,,Unknown,,cid:50)(cid:46)(cid:12)(cid:2)(cid:7)(cid:8)(cid:10)(cid:5)(cid:3)(cid:48)(cid:46)(cid:3)(cid:12)(cid:13)(cid:5)(cid:2)(cid:14)(cid:46)(cid:2)(cid:28)(cid:5)(cid:3)(cid:10)(cid:5)(cid:2)(cid:64)(cid:46)(cid:4)(cid:12)(cid:2)(cid:28)(cid:3,,10437.0
,,2,,,Unknown,,cid:50)(cid:46)(cid:12)(cid:2)(cid:7)(cid:8)(cid:10)(cid:5)(cid:3)(cid:48)(cid:46)(cid:3)(cid:12)(cid:13)(cid:5)(cid:2)(cid:14)(cid:46)(cid:2)(cid:28)(cid:5)(cid:3)(cid:10)(cid:5)(cid:2)(cid:64)(cid:46)(cid:4)(cid:12)(cid:2)(cid:28)(cid:3,,10439.0
,,14,,,Unknown,,cid:50)(cid:46)(cid:12)(cid:2)(cid:7)(cid:8)(cid:10)(cid:5)(cid:3)(cid:48)(cid:46)(cid:3)(cid:12)(cid:13)(cid:5)(cid:2)(cid:14)(cid:46)(cid:2)(cid:28)(cid:5)(cid:3)(cid:10)(cid:5)(cid:2)(cid:64)(cid:46)(cid:4)(cid:12)(cid:2)(cid:28)(cid:3,,10453.0
,,46,,,Unknown,,cid:50)(cid:46)(cid:12)(cid:2)(cid:7)(cid:8)(cid:10)(cid:5)(cid:3)(cid:48)(cid:46)(cid:3)(cid:12)(cid:13)(cid:5)(cid:2)(cid:14)(cid:46)(cid:2)(cid:28)(cid:5)(cid:3)(cid:10)(cid:5)(cid:2)(cid:64)(cid:46)(cid:4)(cid:12)(cid:2)(cid:28)(cid:3,,10499.0
,,2,,,Unknown,,cid:50)(cid:46)(cid:12)(cid:2)(cid:7)(cid:8)(cid:10)(cid:5)(cid:3)(cid:48)(cid:46)(cid:3)(cid:12)(cid:13)(cid:5)(cid:2)(cid:14)(cid:46)(cid:2)(cid:28)(cid:5)(cid:3)(cid:10)(cid:5)(cid:2)(cid:64)(cid:46)(cid:4)(cid:12)(cid:2)(cid:28)(cid:3,,10501.0
,,28,,,Unknown,,cid:50)(cid:46)(cid:12)(cid:2)(cid:7)(cid:8)(cid:10)(cid:5)(cid:3)(cid:48)(cid:46)(cid:3)(cid:12)(cid:13)(cid:5)(cid:2)(cid:14)(cid:46)(cid:2)(cid:28)(cid:5)(cid:3)(cid:10)(cid:5)(cid:2)(cid:64)(cid:46)(cid:4)(cid:12)(cid:2)(cid:28)(cid:3,,10529.0
,,5,,,Unknown,,cid:50)(cid:46)(cid:12)(cid:2)(cid:7)(cid:8)(cid:10)(cid:5)(cid:3)(cid:48)(cid:46)(cid:3)(cid:12)(cid:13)(cid:5)(cid:2)(cid:14)(cid:46)(cid:2)(cid:28)(cid:5)(cid:3)(cid:10)(cid:5)(cid:2)(cid:64)(cid:46)(cid:4)(cid:12)(cid:2)(cid:28)(cid:3,,10534.0
,,3,,,Unknown,,cid:50)(cid:46)(cid:12)(cid:2)(cid:7)(cid:8)(cid:10)(cid:5)(cid:3)(cid:48)(cid:46)(cid:3)(cid:12)(cid:13)(cid:5)(cid:2)(cid:14)(cid:46)(cid:2)(cid:28)(cid:5)(cid:3)(cid:10)(cid:5)(cid:2)(cid:64)(cid:46)(cid:4)(cid:12)(cid:2)(cid:28)(cid:3,,10537.0
,,10,,,Unknown,,cid:50)(cid:46)(cid:12)(cid:2)(cid:7)(cid:8)(cid:10)(cid:5)(cid:3)(cid:48)(cid:46)(cid:3)(cid:12)(cid:13)(cid:5)(cid:2)(cid:14)(cid:46)(cid:2)(cid:28)(cid:5)(cid:3)(cid:10)(cid:5)(cid:2)(cid:64)(cid:46)(cid:4)(cid:12)(cid:2)(cid:28)(cid:3,,10547.0
,,5,,,Unknown,,cid:50)(cid:46)(cid:12)(cid:2)(cid:7)(cid:8)(cid:10)(cid:5)(cid:3)(cid:48)(cid:46)(cid:3)(cid:12)(cid:13)(cid:5)(cid:2)(cid:14)(cid:46)(cid:2)(cid:28)(cid:5)(cid:3)(cid:10)(cid:5)(cid:2)(cid:64)(cid:46)(cid:4)(cid:12)(cid:2)(cid:28)(cid:3,,10552.0
,,2,,,Unknown,,cid:50)(cid:46)(cid:12)(cid:2)(cid:7)(cid:8)(cid:10)(cid:5)(cid:3)(cid:48)(cid:46)(cid:3)(cid:12)(cid:13)(cid:5)(cid:2)(cid:14)(cid:46)(cid:2)(cid:28)(cid:5)(cid:3)(cid:10)(cid:5)(cid:2)(cid:64)(cid:46)(cid:4)(cid:12)(cid:2)(cid:28)(cid:3,,10554.0
,,64,,,Unknown,,cid:50)(cid:46)(cid:12)(cid:2)(cid:7)(cid:8)(cid:10)(cid:5)(cid:3)(cid:48)(cid:46)(cid:3)(cid:12)(cid:13)(cid:5)(cid:2)(cid:14)(cid:46)(cid:2)(cid:28)(cid:5)(cid:3)(cid:10)(cid:5)(cid:2)(cid:64)(cid:46)(cid:4)(cid:12)(cid:2)(cid:28)(cid:3,,10618.0
,,46,,,Unknown,,cid:50)(cid:46)(cid:12)(cid:2)(cid:7)(cid:8)(cid:10)(cid:5)(cid:3)(cid:48)(cid:46)(cid:3)(cid:12)(cid:13)(cid:5)(cid:2)(cid:14)(cid:46)(cid:2)(cid:28)(cid:5)(cid:3)(cid:10)(cid:5)(cid:2)(cid:64)(cid:46)(cid:4)(cid:12)(cid:2)(cid:28)(cid:3,,10664.0
,,4,,,Unknown,,cid:50)(cid:46)(cid:12)(cid:2)(cid:7)(cid:8)(cid:10)(cid:5)(cid:3)(cid:48)(cid:46)(cid:3)(cid:12)(cid:13)(cid:5)(cid:2)(cid:14)(cid:46)(cid:2)(cid:28)(cid:5)(cid:3)(cid:10)(cid:5)(cid:2)(cid:64)(cid:46)(cid:4)(cid:12)(cid:2)(cid:28)(cid:3,,10668.0
,,12,,,Unknown,,cid:50)(cid:46)(cid:12)(cid:2)(cid:7)(cid:8)(cid:10)(cid:5)(cid:3)(cid:48)(cid:46)(cid:3)(cid:12)(cid:13)(cid:5)(cid:2)(cid:14)(cid:46)(cid:2)(cid:28)(cid:5)(cid:3)(cid:10)(cid:5)(cid:2)(cid:64)(cid:46)(cid:4)(cid:12)(cid:2)(cid:28)(cid:3,,10680.0
,,2,,,Unknown,,cid:50)(cid:46)(cid:12)(cid:2)(cid:7)(cid:8)(cid:10)(cid:5)(cid:3)(cid:48)(cid:46)(cid:3)(cid:12)(cid:13)(cid:5)(cid:2)(cid:14)(cid:46)(cid:2)(cid:28)(cid:5)(cid:3)(cid:10)(cid:5)(cid:2)(cid:64)(cid:46)(cid:4)(cid:12)(cid:2)(cid:28)(cid:3,,10682.0
,,28,,,Unknown,,cid:50)(cid:46)(cid:12)(cid:2)(cid:7)(cid:8)(cid:10)(cid:5)(cid:3)(cid:48)(cid:46)(cid:3)(cid:12)(cid:13)(cid:5)(cid:2)(cid:14)(cid:46)(cid:2)(cid:28)(cid:5)(cid:3)(cid:10)(cid:5)(cid:2)(cid:64)(cid:46)(cid:4)(cid:12)(cid:2)(cid:28)(cid:3,,10710.0
,,3,,,Unknown,,cid:50)(cid:46)(cid:12)(cid:2)(cid:7)(cid:8)(cid:10)(cid:5)(cid:3)(cid:48)(cid:46)(cid:3)(cid:12)(cid:13)(cid:5)(cid:2)(cid:14)(cid:46)(cid:2)(cid:28)(cid:5)(cid:3)(cid:10)(cid:5)(cid:2)(cid:64)(cid:46)(cid:4)(cid:12)(cid:2)(cid:28)(cid:3,,10713.0
,,15,,,Unknown,,cid:50)(cid:46)(cid:12)(cid:2)(cid:7)(cid:8)(cid:10)(cid:5)(cid:3)(cid:48)(cid:46)(cid:3)(cid:12)(cid:13)(cid:5)(cid:2)(cid:14)(cid:46)(cid:2)(cid:28)(cid:5)(cid:3)(cid:10)(cid:5)(cid:2)(cid:64)(cid:46)(cid:4)(cid:12)(cid:2)(cid:28)(cid:3,,10728.0
,,2,,,Unknown,,cid:50)(cid:46)(cid:12)(cid:2)(cid:7)(cid:8)(cid:10)(cid:5)(cid:3)(cid:48)(cid:46)(cid:3)(cid:12)(cid:13)(cid:5)(cid:2)(cid:14)(cid:46)(cid:2)(cid:28)(cid:5)(cid:3)(cid:10)(cid:5)(cid:2)(cid:64)(cid:46)(cid:4)(cid:12)(cid:2)(cid:28)(cid:3,,10730.0
,,35,,,Unknown,,cid:50)(cid:46)(cid:12)(cid:2)(cid:7)(cid:8)(cid:10)(cid:5)(cid:3)(cid:48)(cid:46)(cid:3)(cid:12)(cid:13)(cid:5)(cid:2)(cid:14)(cid:46)(cid:2)(cid:28)(cid:5)(cid:3)(cid:10)(cid:5)(cid:2)(cid:64)(cid:46)(cid:4)(cid:12)(cid:2)(cid:28)(cid:3,,10765.0
,,18,,,Unknown,,cid:50)(cid:46)(cid:12)(cid:2)(cid:7)(cid:8)(cid:10)(cid:5)(cid:3)(cid:48)(cid:46)(cid:3)(cid:12)(cid:13)(cid:5)(cid:2)(cid:14)(cid:46)(cid:2)(cid:28)(cid:5)(cid:3)(cid:10)(cid:5)(cid:2)(cid:64)(cid:46)(cid:4)(cid:12)(cid:2)(cid:28)(cid:3,,10783.0
,,19,,,Unknown,,cid:50)(cid:46)(cid:12)(cid:2)(cid:7)(cid:8)(cid:10)(cid:5)(cid:3)(cid:48)(cid:46)(cid:3)(cid:12)(cid:13)(cid:5)(cid:2)(cid:14)(cid:46)(cid:2)(cid:28)(cid:5)(cid:3)(cid:10)(cid:5)(cid:2)(cid:64)(cid:46)(cid:4)(cid:12)(cid:2)(cid:28)(cid:3,,10802.0
,,18,,,Unknown,,cid:50)(cid:46)(cid:12)(cid:2)(cid:7)(cid:8)(cid:10)(cid:5)(cid:3)(cid:48)(cid:46)(cid:3)(cid:12)(cid:13)(cid:5)(cid:2)(cid:14)(cid:46)(cid:2)(cid:28)(cid:5)(cid:3)(cid:10)(cid:5)(cid:2)(cid:64)(cid:46)(cid:4)(cid:12)(cid:2)(cid:28)(cid:3,,10820.0
,,18,,,Unknown,,cid:50)(cid:46)(cid:12)(cid:2)(cid:7)(cid:8)(cid:10)(cid:5)(cid:3)(cid:48)(cid:46)(cid:3)(cid:12)(cid:13)(cid:5)(cid:2)(cid:14)(cid:46)(cid:2)(cid:28)(cid:5)(cid:3)(cid:10)(cid:5)(cid:2)(cid:64)(cid:46)(cid:4)(cid:12)(cid:2)(cid:28)(cid:3,,10838.0
,,2,,,Unknown,,cid:50)(cid:46)(cid:12)(cid:2)(cid:7)(cid:8)(cid:10)(cid:5)(cid:3)(cid:48)(cid:46)(cid:3)(cid:12)(cid:13)(cid:5)(cid:2)(cid:14)(cid:46)(cid:2)(cid:28)(cid:5)(cid:3)(cid:10)(cid:5)(cid:2)(cid:64)(cid:46)(cid:4)(cid:12)(cid:2)(cid:28)(cid:3,,10840.0
,,44,,,Unknown,,cid:50)(cid:46)(cid:12)(cid:2)(cid:7)(cid:8)(cid:10)(cid:5)(cid:3)(cid:48)(cid:46)(cid:3)(cid:12)(cid:13)(cid:5)(cid:2)(cid:14)(cid:46)(cid:2)(cid:28)(cid:5)(cid:3)(cid:10)(cid:5)(cid:2)(cid:64)(cid:46)(cid:4)(cid:12)(cid:2)(cid:28)(cid:3,,10884.0
,,12,,,Unknown,,cid:50)(cid:46)(cid:12)(cid:2)(cid:7)(cid:8)(cid:10)(cid:5)(cid:3)(cid:48)(cid:46)(cid:3)(cid:12)(cid:13)(cid:5)(cid:2)(cid:14)(cid:46)(cid:2)(cid:28)(cid:5)(cid:3)(cid:10)(cid:5)(cid:2)(cid:64)(cid:46)(cid:4)(cid:12)(cid:2)(cid:28)(cid:3,,10896.0
,,29,,,Unknown,,cid:50)(cid:46)(cid:12)(cid:2)(cid:7)(cid:8)(cid:10)(cid:5)(cid:3)(cid:48)(cid:46)(cid:3)(cid:12)(cid:13)(cid:5)(cid:2)(cid:14)(cid:46)(cid:2)(cid:28)(cid:5)(cid:3)(cid:10)(cid:5)(cid:2)(cid:64)(cid:46)(cid:4)(cid:12)(cid:2)(cid:28)(cid:3,,10925.0
,,26,,,Unknown,,cid:50)(cid:46)(cid:12)(cid:2)(cid:7)(cid:8)(cid:10)(cid:5)(cid:3)(cid:48)(cid:46)(cid:3)(cid:12)(cid:13)(cid:5)(cid:2)(cid:14)(cid:46)(cid:2)(cid:28)(cid:5)(cid:3)(cid:10)(cid:5)(cid:2)(cid:64)(cid:46)(cid:4)(cid:12)(cid:2)(cid:28)(cid:3,,10951.0
,,41,,,Unknown,,cid:50)(cid:46)(cid:12)(cid:2)(cid:7)(cid:8)(cid:10)(cid:5)(cid:3)(cid:48)(cid:46)(cid:3)(cid:12)(cid:13)(cid:5)(cid:2)(cid:14)(cid:46)(cid:2)(cid:28)(cid:5)(cid:3)(cid:10)(cid:5)(cid:2)(cid:64)(cid:46)(cid:4)(cid:12)(cid:2)(cid:28)(cid:3,,10992.0
,,25,,,Unknown,,cid:50)(cid:46)(cid:12)(cid:2)(cid:7)(cid:8)(cid:10)(cid:5)(cid:3)(cid:48)(cid:46)(cid:3)(cid:12)(cid:13)(cid:5)(cid:2)(cid:14)(cid:46)(cid:2)(cid:28)(cid:5)(cid:3)(cid:10)(cid:5)(cid:2)(cid:64)(cid:46)(cid:4)(cid:12)(cid:2)(cid:28)(cid:3,,11017.0
,,2,,,Unknown,,cid:50)(cid:46)(cid:12)(cid:2)(cid:7)(cid:8)(cid:10)(cid:5)(cid:3)(cid:48)(cid:46)(cid:3)(cid:12)(cid:13)(cid:5)(cid:2)(cid:14)(cid:46)(cid:2)(cid:28)(cid:5)(cid:3)(cid:10)(cid:5)(cid:2)(cid:64)(cid:46)(cid:4)(cid:12)(cid:2)(cid:28)(cid:3,,11019.0
,,58,,,Unknown,,cid:50)(cid:46)(cid:12)(cid:2)(cid:7)(cid:8)(cid:10)(cid:5)(cid:3)(cid:48)(cid:46)(cid:3)(cid:12)(cid:13)(cid:5)(cid:2)(cid:14)(cid:46)(cid:2)(cid:28)(cid:5)(cid:3)(cid:10)(cid:5)(cid:2)(cid:64)(cid:46)(cid:4)(cid:12)(cid:2)(cid:28)(cid:3,,11077.0
,,58,,,Unknown,,cid:50)(cid:46)(cid:12)(cid:2)(cid:7)(cid:8)(cid:10)(cid:5)(cid:3)(cid:48)(cid:46)(cid:3)(cid:12)(cid:13)(cid:5)(cid:2)(cid:14)(cid:46)(cid:2)(cid:28)(cid:5)(cid:3)(cid:10)(cid:5)(cid:2)(cid:64)(cid:46)(cid:4)(cid:12)(cid:2)(cid:28)(cid:3,,11135.0
,,18,,,Unknown,,cid:50)(cid:46)(cid:12)(cid:2)(cid:7)(cid:8)(cid:10)(cid:5)(cid:3)(cid:48)(cid:46)(cid:3)(cid:12)(cid:13)(cid:5)(cid:2)(cid:14)(cid:46)(cid:2)(cid:28)(cid:5)(cid:3)(cid:10)(cid:5)(cid:2)(cid:64)(cid:46)(cid:4)(cid:12)(cid:2)(cid:28)(cid:3,,11153.0
,,1,,,Unknown,,cid:50)(cid:46)(cid:12)(cid:2)(cid:7)(cid:8)(cid:10)(cid:5)(cid:3)(cid:48)(cid:46)(cid:3)(cid:12)(cid:13)(cid:5)(cid:2)(cid:14)(cid:46)(cid:2)(cid:28)(cid:5)(cid:3)(cid:10)(cid:5)(cid:2)(cid:64)(cid:46)(cid:4)(cid:12)(cid:2)(cid:28)(cid:3,,11154.0
,,1,,,Unknown,,cid:50)(cid:46)(cid:12)(cid:2)(cid:7)(cid:8)(cid:10)(cid:5)(cid:3)(cid:48)(cid:46)(cid:3)(cid:12)(cid:13)(cid:5)(cid:2)(cid:14)(cid:46)(cid:2)(cid:28)(cid:5)(cid:3)(cid:10)(cid:5)(cid:2)(cid:64)(cid:46)(cid:4)(cid:12)(cid:2)(cid:28)(cid:3,,11155.0
,,37,,,Unknown,,cid:50)(cid:46)(cid:12)(cid:2)(cid:7)(cid:8)(cid:10)(cid:5)(cid:3)(cid:48)(cid:46)(cid:3)(cid:12)(cid:13)(cid:5)(cid:2)(cid:14)(cid:46)(cid:2)(cid:28)(cid:5)(cid:3)(cid:10)(cid:5)(cid:2)(cid:64)(cid:46)(cid:4)(cid:12)(cid:2)(cid:28)(cid:3,,11192.0
,,18,,,Unknown,,cid:50)(cid:46)(cid:12)(cid:2)(cid:7)(cid:8)(cid:10)(cid:5)(cid:3)(cid:48)(cid:46)(cid:3)(cid:12)(cid:13)(cid:5)(cid:2)(cid:14)(cid:46)(cid:2)(cid:28)(cid:5)(cid:3)(cid:10)(cid:5)(cid:2)(cid:64)(cid:46)(cid:4)(cid:12)(cid:2)(cid:28)(cid:3,,11210.0
,,32,,,Unknown,,cid:50)(cid:46)(cid:12)(cid:2)(cid:7)(cid:8)(cid:10)(cid:5)(cid:3)(cid:48)(cid:46)(cid:3)(cid:12)(cid:13)(cid:5)(cid:2)(cid:14)(cid:46)(cid:2)(cid:28)(cid:5)(cid:3)(cid:10)(cid:5)(cid:2)(cid:64)(cid:46)(cid:4)(cid:12)(cid:2)(cid:28)(cid:3,,11242.0
,,45,,,Unknown,,cid:50)(cid:46)(cid:12)(cid:2)(cid:7)(cid:8)(cid:10)(cid:5)(cid:3)(cid:48)(cid:46)(cid:3)(cid:12)(cid:13)(cid:5)(cid:2)(cid:14)(cid:46)(cid:2)(cid:28)(cid:5)(cid:3)(cid:10)(cid:5)(cid:2)(cid:64)(cid:46)(cid:4)(cid:12)(cid:2)(cid:28)(cid:3,,11287.0
,,18,,,Unknown,,cid:50)(cid:46)(cid:12)(cid:2)(cid:7)(cid:8)(cid:10)(cid:5)(cid:3)(cid:48)(cid:46)(cid:3)(cid:12)(cid:13)(cid:5)(cid:2)(cid:14)(cid:46)(cid:2)(cid:28)(cid:5)(cid:3)(cid:10)(cid:5)(cid:2)(cid:64)(cid:46)(cid:4)(cid:12)(cid:2)(cid:28)(cid:3,,11305.0
,,16,,,Unknown,,cid:50)(cid:46)(cid:12)(cid:2)(cid:7)(cid:8)(cid:10)(cid:5)(cid:3)(cid:48)(cid:46)(cid:3)(cid:12)(cid:13)(cid:5)(cid:2)(cid:14)(cid:46)(cid:2)(cid:28)(cid:5)(cid:3)(cid:10)(cid:5)(cid:2)(cid:64)(cid:46)(cid:4)(cid:12)(cid:2)(cid:28)(cid:3,,11321.0
,,65,,,Unknown,,cid:50)(cid:46)(cid:12)(cid:2)(cid:7)(cid:8)(cid:10)(cid:5)(cid:3)(cid:48)(cid:46)(cid:3)(cid:12)(cid:13)(cid:5)(cid:2)(cid:14)(cid:46)(cid:2)(cid:28)(cid:5)(cid:3)(cid:10)(cid:5)(cid:2)(cid:64)(cid:46)(cid:4)(cid:12)(cid:2)(cid:28)(cid:3,,11386.0
,,28,,,Unknown,,cid:50)(cid:46)(cid:12)(cid:2)(cid:7)(cid:8)(cid:10)(cid:5)(cid:3)(cid:48)(cid:46)(cid:3)(cid:12)(cid:13)(cid:5)(cid:2)(cid:14)(cid:46)(cid:2)(cid:28)(cid:5)(cid:3)(cid:10)(cid:5)(cid:2)(cid:64)(cid:46)(cid:4)(cid:12)(cid:2)(cid:28)(cid:3,,11414.0
,,12,,,Unknown,,cid:50)(cid:46)(cid:12)(cid:2)(cid:7)(cid:8)(cid:10)(cid:5)(cid:3)(cid:48)(cid:46)(cid:3)(cid:12)(cid:13)(cid:5)(cid:2)(cid:14)(cid:46)(cid:2)(cid:28)(cid:5)(cid:3)(cid:10)(cid:5)(cid:2)(cid:64)(cid:46)(cid:4)(cid:12)(cid:2)(cid:28)(cid:3,,11426.0
,,2,,,Unknown,,cid:50)(cid:46)(cid:12)(cid:2)(cid:7)(cid:8)(cid:10)(cid:5)(cid:3)(cid:48)(cid:46)(cid:3)(cid:12)(cid:13)(cid:5)(cid:2)(cid:14)(cid:46)(cid:2)(cid:28)(cid:5)(cid:3)(cid:10)(cid:5)(cid:2)(cid:64)(cid:46)(cid:4)(cid:12)(cid:2)(cid:28)(cid:3,,11428.0
,,48,,,Unknown,,cid:50)(cid:46)(cid:12)(cid:2)(cid:7)(cid:8)(cid:10)(cid:5)(cid:3)(cid:48)(cid:46)(cid:3)(cid:12)(cid:13)(cid:5)(cid:2)(cid:14)(cid:46)(cid:2)(cid:28)(cid:5)(cid:3)(cid:10)(cid:5)(cid:2)(cid:64)(cid:46)(cid:4)(cid:12)(cid:2)(cid:28)(cid:3,,11476.0
,,5,,,Unknown,,cid:50)(cid:46)(cid:12)(cid:2)(cid:7)(cid:8)(cid:10)(cid:5)(cid:3)(cid:48)(cid:46)(cid:3)(cid:12)(cid:13)(cid:5)(cid:2)(cid:14)(cid:46)(cid:2)(cid:28)(cid:5)(cid:3)(cid:10)(cid:5)(cid:2)(cid:64)(cid:46)(cid:4)(cid:12)(cid:2)(cid:28)(cid:3,,11481.0
,,46,,,Unknown,,cid:50)(cid:46)(cid:12)(cid:2)(cid:7)(cid:8)(cid:10)(cid:5)(cid:3)(cid:48)(cid:46)(cid:3)(cid:12)(cid:13)(cid:5)(cid:2)(cid:14)(cid:46)(cid:2)(cid:28)(cid:5)(cid:3)(cid:10)(cid:5)(cid:2)(cid:64)(cid:46)(cid:4)(cid:12)(cid:2)(cid:28)(cid:3,,11527.0
,,4,,,Unknown,,cid:50)(cid:46)(cid:12)(cid:2)(cid:7)(cid:8)(cid:10)(cid:5)(cid:3)(cid:48)(cid:46)(cid:3)(cid:12)(cid:13)(cid:5)(cid:2)(cid:14)(cid:46)(cid:2)(cid:28)(cid:5)(cid:3)(cid:10)(cid:5)(cid:2)(cid:64)(cid:46)(cid:4)(cid:12)(cid:2)(cid:28)(cid:3,,11531.0
,,40,,,Unknown,,cid:50)(cid:46)(cid:12)(cid:2)(cid:7)(cid:8)(cid:10)(cid:5)(cid:3)(cid:48)(cid:46)(cid:3)(cid:12)(cid:13)(cid:5)(cid:2)(cid:14)(cid:46)(cid:2)(cid:28)(cid:5)(cid:3)(cid:10)(cid:5)(cid:2)(cid:64)(cid:46)(cid:4)(cid:12)(cid:2)(cid:28)(cid:3,,11571.0
,,2,,,Unknown,,cid:50)(cid:46)(cid:12)(cid:2)(cid:7)(cid:8)(cid:10)(cid:5)(cid:3)(cid:48)(cid:46)(cid:3)(cid:12)(cid:13)(cid:5)(cid:2)(cid:14)(cid:46)(cid:2)(cid:28)(cid:5)(cid:3)(cid:10)(cid:5)(cid:2)(cid:64)(cid:46)(cid:4)(cid:12)(cid:2)(cid:28)(cid:3,,11573.0
,,48,,,Unknown,,cid:50)(cid:46)(cid:12)(cid:2)(cid:7)(cid:8)(cid:10)(cid:5)(cid:3)(cid:48)(cid:46)(cid:3)(cid:12)(cid:13)(cid:5)(cid:2)(cid:14)(cid:46)(cid:2)(cid:28)(cid:5)(cid:3)(cid:10)(cid:5)(cid:2)(cid:64)(cid:46)(cid:4)(cid:12)(cid:2)(cid:28)(cid:3,,11621.0
,,5,,,Unknown,,cid:50)(cid:46)(cid:12)(cid:2)(cid:7)(cid:8)(cid:10)(cid:5)(cid:3)(cid:48)(cid:46)(cid:3)(cid:12)(cid:13)(cid:5)(cid:2)(cid:14)(cid:46)(cid:2)(cid:28)(cid:5)(cid:3)(cid:10)(cid:5)(cid:2)(cid:64)(cid:46)(cid:4)(cid:12)(cid:2)(cid:28)(cid:3,,11626.0
,,46,,,Unknown,,cid:50)(cid:46)(cid:12)(cid:2)(cid:7)(cid:8)(cid:10)(cid:5)(cid:3)(cid:48)(cid:46)(cid:3)(cid:12)(cid:13)(cid:5)(cid:2)(cid:14)(cid:46)(cid:2)(cid:28)(cid:5)(cid:3)(cid:10)(cid:5)(cid:2)(cid:64)(cid:46)(cid:4)(cid:12)(cid:2)(cid:28)(cid:3,,11672.0
,,4,,,Unknown,,cid:50)(cid:46)(cid:12)(cid:2)(cid:7)(cid:8)(cid:10)(cid:5)(cid:3)(cid:48)(cid:46)(cid:3)(cid:12)(cid:13)(cid:5)(cid:2)(cid:14)(cid:46)(cid:2)(cid:28)(cid:5)(cid:3)(cid:10)(cid:5)(cid:2)(cid:64)(cid:46)(cid:4)(cid:12)(cid:2)(cid:28)(cid:3,,11676.0
,,40,,,Unknown,,cid:50)(cid:46)(cid:12)(cid:2)(cid:7)(cid:8)(cid:10)(cid:5)(cid:3)(cid:48)(cid:46)(cid:3)(cid:12)(cid:13)(cid:5)(cid:2)(cid:14)(cid:46)(cid:2)(cid:28)(cid:5)(cid:3)(cid:10)(cid:5)(cid:2)(cid:64)(cid:46)(cid:4)(cid:12)(cid:2)(cid:28)(cid:3,,11716.0
,,2,,,Unknown,,cid:50)(cid:46)(cid:12)(cid:2)(cid:7)(cid:8)(cid:10)(cid:5)(cid:3)(cid:48)(cid:46)(cid:3)(cid:12)(cid:13)(cid:5)(cid:2)(cid:14)(cid:46)(cid:2)(cid:28)(cid:5)(cid:3)(cid:10)(cid:5)(cid:2)(cid:64)(cid:46)(cid:4)(cid:12)(cid:2)(cid:28)(cid:3,,11718.0
,,28,,,Unknown,,cid:50)(cid:46)(cid:12)(cid:2)(cid:7)(cid:8)(cid:10)(cid:5)(cid:3)(cid:48)(cid:46)(cid:3)(cid:12)(cid:13)(cid:5)(cid:2)(cid:14)(cid:46)(cid:2)(cid:28)(cid:5)(cid:3)(cid:10)(cid:5)(cid:2)(cid:64)(cid:46)(cid:4)(cid:12)(cid:2)(cid:28)(cid:3,,11746.0
,,3,,,Unknown,,cid:50)(cid:46)(cid:12)(cid:2)(cid:7)(cid:8)(cid:10)(cid:5)(cid:3)(cid:48)(cid:46)(cid:3)(cid:12)(cid:13)(cid:5)(cid:2)(cid:14)(cid:46)(cid:2)(cid:28)(cid:5)(cid:3)(cid:10)(cid:5)(cid:2)(cid:64)(cid:46)(cid:4)(cid:12)(cid:2)(cid:28)(cid:3,,11749.0
,,15,,,Unknown,,cid:50)(cid:46)(cid:12)(cid:2)(cid:7)(cid:8)(cid:10)(cid:5)(cid:3)(cid:48)(cid:46)(cid:3)(cid:12)(cid:13)(cid:5)(cid:2)(cid:14)(cid:46)(cid:2)(cid:28)(cid:5)(cid:3)(cid:10)(cid:5)(cid:2)(cid:64)(cid:46)(cid:4)(cid:12)(cid:2)(cid:28)(cid:3,,11764.0
,,2,,,Unknown,,cid:50)(cid:46)(cid:12)(cid:2)(cid:7)(cid:8)(cid:10)(cid:5)(cid:3)(cid:48)(cid:46)(cid:3)(cid:12)(cid:13)(cid:5)(cid:2)(cid:14)(cid:46)(cid:2)(cid:28)(cid:5)(cid:3)(cid:10)(cid:5)(cid:2)(cid:64)(cid:46)(cid:4)(cid:12)(cid:2)(cid:28)(cid:3,,11766.0
,,17,,,Unknown,,cid:50)(cid:46)(cid:12)(cid:2)(cid:7)(cid:8)(cid:10)(cid:5)(cid:3)(cid:48)(cid:46)(cid:3)(cid:12)(cid:13)(cid:5)(cid:2)(cid:14)(cid:46)(cid:2)(cid:28)(cid:5)(cid:3)(cid:10)(cid:5)(cid:2)(cid:64)(cid:46)(cid:4)(cid:12)(cid:2)(cid:28)(cid:3,,11783.0
,,1,,,Unknown,,cid:50)(cid:46)(cid:12)(cid:2)(cid:7)(cid:8)(cid:10)(cid:5)(cid:3)(cid:48)(cid:46)(cid:3)(cid:12)(cid:13)(cid:5)(cid:2)(cid:14)(cid:46)(cid:2)(cid:28)(cid:5)(cid:3)(cid:10)(cid:5)(cid:2)(cid:64)(cid:46)(cid:4)(cid:12)(cid:2)(cid:28)(cid:3,,11784.0
,,37,,,Unknown,,cid:50)(cid:46)(cid:12)(cid:2)(cid:7)(cid:8)(cid:10)(cid:5)(cid:3)(cid:48)(cid:46)(cid:3)(cid:12)(cid:13)(cid:5)(cid:2)(cid:14)(cid:46)(cid:2)(cid:28)(cid:5)(cid:3)(cid:10)(cid:5)(cid:2)(cid:64)(cid:46)(cid:4)(cid:12)(cid:2)(cid:28)(cid:3,,11821.0
,,19,,,Unknown,,cid:50)(cid:46)(cid:12)(cid:2)(cid:7)(cid:8)(cid:10)(cid:5)(cid:3)(cid:48)(cid:46)(cid:3)(cid:12)(cid:13)(cid:5)(cid:2)(cid:14)(cid:46)(cid:2)(cid:28)(cid:5)(cid:3)(cid:10)(cid:5)(cid:2)(cid:64)(cid:46)(cid:4)(cid:12)(cid:2)(cid:28)(cid:3,,11840.0
,,32,,,Unknown,,cid:50)(cid:46)(cid:12)(cid:2)(cid:7)(cid:8)(cid:10)(cid:5)(cid:3)(cid:48)(cid:46)(cid:3)(cid:12)(cid:13)(cid:5)(cid:2)(cid:14)(cid:46)(cid:2)(cid:28)(cid:5)(cid:3)(cid:10)(cid:5)(cid:2)(cid:64)(cid:46)(cid:4)(cid:12)(cid:2)(cid:28)(cid:3,,11872.0
,,34,,,Unknown,,cid:50)(cid:46)(cid:12)(cid:2)(cid:7)(cid:8)(cid:10)(cid:5)(cid:3)(cid:48)(cid:46)(cid:3)(cid:12)(cid:13)(cid:5)(cid:2)(cid:14)(cid:46)(cid:2)(cid:28)(cid:5)(cid:3)(cid:10)(cid:5)(cid:2)(cid:64)(cid:46)(cid:4)(cid:12)(cid:2)(cid:28)(cid:3,,11906.0
,,2,,,Unknown,,cid:50)(cid:46)(cid:12)(cid:2)(cid:7)(cid:8)(cid:10)(cid:5)(cid:3)(cid:48)(cid:46)(cid:3)(cid:12)(cid:13)(cid:5)(cid:2)(cid:14)(cid:46)(cid:2)(cid:28)(cid:5)(cid:3)(cid:10)(cid:5)(cid:2)(cid:64)(cid:46)(cid:4)(cid:12)(cid:2)(cid:28)(cid:3,,11908.0
,,44,,,Unknown,,cid:50)(cid:46)(cid:12)(cid:2)(cid:7)(cid:8)(cid:10)(cid:5)(cid:3)(cid:48)(cid:46)(cid:3)(cid:12)(cid:13)(cid:5)(cid:2)(cid:14)(cid:46)(cid:2)(cid:28)(cid:5)(cid:3)(cid:10)(cid:5)(cid:2)(cid:64)(cid:46)(cid:4)(cid:12)(cid:2)(cid:28)(cid:3,,11952.0
,,12,,,Unknown,,cid:50)(cid:46)(cid:12)(cid:2)(cid:7)(cid:8)(cid:10)(cid:5)(cid:3)(cid:48)(cid:46)(cid:3)(cid:12)(cid:13)(cid:5)(cid:2)(cid:14)(cid:46)(cid:2)(cid:28)(cid:5)(cid:3)(cid:10)(cid:5)(cid:2)(cid:64)(cid:46)(cid:4)(cid:12)(cid:2)(cid:28)(cid:3,,11964.0
,,29,,,Unknown,,cid:50)(cid:46)(cid:12)(cid:2)(cid:7)(cid:8)(cid:10)(cid:5)(cid:3)(cid:48)(cid:46)(cid:3)(cid:12)(cid:13)(cid:5)(cid:2)(cid:14)(cid:46)(cid:2)(cid:28)(cid:5)(cid:3)(cid:10)(cid:5)(cid:2)(cid:64)(cid:46)(cid:4)(cid:12)(cid:2)(cid:28)(cid:3,,11993.0
,,26,,,Unknown,,cid:50)(cid:46)(cid:12)(cid:2)(cid:7)(cid:8)(cid:10)(cid:5)(cid:3)(cid:48)(cid:46)(cid:3)(cid:12)(cid:13)(cid:5)(cid:2)(cid:14)(cid:46)(cid:2)(cid:28)(cid:5)(cid:3)(cid:10)(cid:5)(cid:2)(cid:64)(cid:46)(cid:4)(cid:12)(cid:2)(cid:28)(cid:3,,12019.0
,,41,,,Unknown,,cid:50)(cid:46)(cid:12)(cid:2)(cid:7)(cid:8)(cid:10)(cid:5)(cid:3)(cid:48)(cid:46)(cid:3)(cid:12)(cid:13)(cid:5)(cid:2)(cid:14)(cid:46)(cid:2)(cid:28)(cid:5)(cid:3)(cid:10)(cid:5)(cid:2)(cid:64)(cid:46)(cid:4)(cid:12)(cid:2)(cid:28)(cid:3,,12060.0
,,25,,,Unknown,,cid:50)(cid:46)(cid:12)(cid:2)(cid:7)(cid:8)(cid:10)(cid:5)(cid:3)(cid:48)(cid:46)(cid:3)(cid:12)(cid:13)(cid:5)(cid:2)(cid:14)(cid:46)(cid:2)(cid:28)(cid:5)(cid:3)(cid:10)(cid:5)(cid:2)(cid:64)(cid:46)(cid:4)(cid:12)(cid:2)(cid:28)(cid:3,,12085.0
,,2,,,Unknown,,cid:50)(cid:46)(cid:12)(cid:2)(cid:7)(cid:8)(cid:10)(cid:5)(cid:3)(cid:48)(cid:46)(cid:3)(cid:12)(cid:13)(cid:5)(cid:2)(cid:14)(cid:46)(cid:2)(cid:28)(cid:5)(cid:3)(cid:10)(cid:5)(cid:2)(cid:64)(cid:46)(cid:4)(cid:12)(cid:2)(cid:28)(cid:3,,12087.0
,,58,,,Unknown,,cid:50)(cid:46)(cid:12)(cid:2)(cid:7)(cid:8)(cid:10)(cid:5)(cid:3)(cid:48)(cid:46)(cid:3)(cid:12)(cid:13)(cid:5)(cid:2)(cid:14)(cid:46)(cid:2)(cid:28)(cid:5)(cid:3)(cid:10)(cid:5)(cid:2)(cid:64)(cid:46)(cid:4)(cid:12)(cid:2)(cid:28)(cid:3,,12145.0
,,58,,,Unknown,,cid:50)(cid:46)(cid:12)(cid:2)(cid:7)(cid:8)(cid:10)(cid:5)(cid:3)(cid:48)(cid:46)(cid:3)(cid:12)(cid:13)(cid:5)(cid:2)(cid:14)(cid:46)(cid:2)(cid:28)(cid:5)(cid:3)(cid:10)(cid:5)(cid:2)(cid:64)(cid:46)(cid:4)(cid:12)(cid:2)(cid:28)(cid:3,,12203.0
,,18,,,Unknown,,cid:50)(cid:46)(cid:12)(cid:2)(cid:7)(cid:8)(cid:10)(cid:5)(cid:3)(cid:48)(cid:46)(cid:3)(cid:12)(cid:13)(cid:5)(cid:2)(cid:14)(cid:46)(cid:2)(cid:28)(cid:5)(cid:3)(cid:10)(cid:5)(cid:2)(cid:64)(cid:46)(cid:4)(cid:12)(cid:2)(cid:28)(cid:3,,12221.0
,,1,,,Unknown,,cid:50)(cid:46)(cid:12)(cid:2)(cid:7)(cid:8)(cid:10)(cid:5)(cid:3)(cid:48)(cid:46)(cid:3)(cid:12)(cid:13)(cid:5)(cid:2)(cid:14)(cid:46)(cid:2)(cid:28)(cid:5)(cid:3)(cid:10)(cid:5)(cid:2)(cid:64)(cid:46)(cid:4)(cid:12)(cid:2)(cid:28)(cid:3,,12222.0
,,1,,,Unknown,,cid:50)(cid:46)(cid:12)(cid:2)(cid:7)(cid:8)(cid:10)(cid:5)(cid:3)(cid:48)(cid:46)(cid:3)(cid:12)(cid:13)(cid:5)(cid:2)(cid:14)(cid:46)(cid:2)(cid:28)(cid:5)(cid:3)(cid:10)(cid:5)(cid:2)(cid:64)(cid:46)(cid:4)(cid:12)(cid:2)(cid:28)(cid:3,,12223.0
,,37,,,Unknown,,cid:50)(cid:46)(cid:12)(cid:2)(cid:7)(cid:8)(cid:10)(cid:5)(cid:3)(cid:48)(cid:46)(cid:3)(cid:12)(cid:13)(cid:5)(cid:2)(cid:14)(cid:46)(cid:2)(cid:28)(cid:5)(cid:3)(cid:10)(cid:5)(cid:2)(cid:64)(cid:46)(cid:4)(cid:12)(cid:2)(cid:28)(cid:3,,12260.0
,,18,,,Unknown,,cid:50)(cid:46)(cid:12)(cid:2)(cid:7)(cid:8)(cid:10)(cid:5)(cid:3)(cid:48)(cid:46)(cid:3)(cid:12)(cid:13)(cid:5)(cid:2)(cid:14)(cid:46)(cid:2)(cid:28)(cid:5)(cid:3)(cid:10)(cid:5)(cid:2)(cid:64)(cid:46)(cid:4)(cid:12)(cid:2)(cid:28)(cid:3,,12278.0
,,32,,,Unknown,,cid:50)(cid:46)(cid:12)(cid:2)(cid:7)(cid:8)(cid:10)(cid:5)(cid:3)(cid:48)(cid:46)(cid:3)(cid:12)(cid:13)(cid:5)(cid:2)(cid:14)(cid:46)(cid:2)(cid:28)(cid:5)(cid:3)(cid:10)(cid:5)(cid:2)(cid:64)(cid:46)(cid:4)(cid:12)(cid:2)(cid:28)(cid:3,,12310.0
,,45,,,Unknown,,cid:50)(cid:46)(cid:12)(cid:2)(cid:7)(cid:8)(cid:10)(cid:5)(cid:3)(cid:48)(cid:46)(cid:3)(cid:12)(cid:13)(cid:5)(cid:2)(cid:14)(cid:46)(cid:2)(cid:28)(cid:5)(cid:3)(cid:10)(cid:5)(cid:2)(cid:64)(cid:46)(cid:4)(cid:12)(cid:2)(cid:28)(cid:3,,12355.0
,,18,,,Unknown,,cid:50)(cid:46)(cid:12)(cid:2)(cid:7)(cid:8)(cid:10)(cid:5)(cid:3)(cid:48)(cid:46)(cid:3)(cid:12)(cid:13)(cid:5)(cid:2)(cid:14)(cid:46)(cid:2)(cid:28)(cid:5)(cid:3)(cid:10)(cid:5)(cid:2)(cid:64)(cid:46)(cid:4)(cid:12)(cid:2)(cid:28)(cid:3,,12373.0
,,16,,,Unknown,,cid:50)(cid:46)(cid:12)(cid:2)(cid:7)(cid:8)(cid:10)(cid:5)(cid:3)(cid:48)(cid:46)(cid:3)(cid:12)(cid:13)(cid:5)(cid:2)(cid:14)(cid:46)(cid:2)(cid:28)(cid:5)(cid:3)(cid:10)(cid:5)(cid:2)(cid:64)(cid:46)(cid:4)(cid:12)(cid:2)(cid:28)(cid:3,,12389.0
,,14,,,Unknown,,cid:50)(cid:46)(cid:12)(cid:2)(cid:7)(cid:8)(cid:10)(cid:5)(cid:3)(cid:48)(cid:46)(cid:3)(cid:12)(cid:13)(cid:5)(cid:2)(cid:14)(cid:46)(cid:2)(cid:28)(cid:5)(cid:3)(cid:10)(cid:5)(cid:2)(cid:64)(cid:46)(cid:4)(cid:12)(cid:2)(cid:28)(cid:3,,12403.0
,,7,,,Unknown,,cid:50)(cid:46)(cid:12)(cid:2)(cid:7)(cid:8)(cid:10)(cid:5)(cid:3)(cid:48)(cid:46)(cid:3)(cid:12)(cid:13)(cid:5)(cid:2)(cid:14)(cid:46)(cid:2)(cid:28)(cid:5)(cid:3)(cid:10)(cid:5)(cid:2)(cid:64)(cid:46)(cid:4)(cid:12)(cid:2)(cid:28)(cid:3,,12410.0
,,8,,,Unknown,,cid:50)(cid:46)(cid:12)(cid:2)(cid:7)(cid:8)(cid:10)(cid:5)(cid:3)(cid:48)(cid:46)(cid:3)(cid:12)(cid:13)(cid:5)(cid:2)(cid:14)(cid:46)(cid:2)(cid:28)(cid:5)(cid:3)(cid:10)(cid:5)(cid:2)(cid:64)(cid:46)(cid:4)(cid:12)(cid:2)(cid:28)(cid:3,,12418.0
,,11,,,Unknown,,cid:50)(cid:46)(cid:12)(cid:2)(cid:7)(cid:8)(cid:10)(cid:5)(cid:3)(cid:48)(cid:46)(cid:3)(cid:12)(cid:13)(cid:5)(cid:2)(cid:14)(cid:46)(cid:2)(cid:28)(cid:5)(cid:3)(cid:10)(cid:5)(cid:2)(cid:64)(cid:46)(cid:4)(cid:12)(cid:2)(cid:28)(cid:3,,12429.0
,,8,,,Unknown,,cid:50)(cid:46)(cid:12)(cid:2)(cid:7)(cid:8)(cid:10)(cid:5)(cid:3)(cid:48)(cid:46)(cid:3)(cid:12)(cid:13)(cid:5)(cid:2)(cid:14)(cid:46)(cid:2)(cid:28)(cid:5)(cid:3)(cid:10)(cid:5)(cid:2)(cid:64)(cid:46)(cid:4)(cid:12)(cid:2)(cid:28)(cid:3,,12437.0
,,2,,,Unknown,,cid:50)(cid:46)(cid:12)(cid:2)(cid:7)(cid:8)(cid:10)(cid:5)(cid:3)(cid:48)(cid:46)(cid:3)(cid:12)(cid:13)(cid:5)(cid:2)(cid:14)(cid:46)(cid:2)(cid:28)(cid:5)(cid:3)(cid:10)(cid:5)(cid:2)(cid:64)(cid:46)(cid:4)(cid:12)(cid:2)(cid:28)(cid:3,,12439.0
,,39,,,Unknown,,cid:50)(cid:46)(cid:12)(cid:2)(cid:7)(cid:8)(cid:10)(cid:5)(cid:3)(cid:48)(cid:46)(cid:3)(cid:12)(cid:13)(cid:5)(cid:2)(cid:14)(cid:46)(cid:2)(cid:28)(cid:5)(cid:3)(cid:10)(cid:5)(cid:2)(cid:64)(cid:46)(cid:4)(cid:12)(cid:2)(cid:28)(cid:3,,12478.0
,,3,,,Unknown,,cid:50)(cid:46)(cid:12)(cid:2)(cid:7)(cid:8)(cid:10)(cid:5)(cid:3)(cid:48)(cid:46)(cid:3)(cid:12)(cid:13)(cid:5)(cid:2)(cid:14)(cid:46)(cid:2)(cid:28)(cid:5)(cid:3)(cid:10)(cid:5)(cid:2)(cid:64)(cid:46)(cid:4)(cid:12)(cid:2)(cid:28)(cid:3,,12481.0
,,11,,,Unknown,,cid:50)(cid:46)(cid:12)(cid:2)(cid:7)(cid:8)(cid:10)(cid:5)(cid:3)(cid:48)(cid:46)(cid:3)(cid:12)(cid:13)(cid:5)(cid:2)(cid:14)(cid:46)(cid:2)(cid:28)(cid:5)(cid:3)(cid:10)(cid:5)(cid:2)(cid:64)(cid:46)(cid:4)(cid:12)(cid:2)(cid:28)(cid:3,,12492.0
,,66,,,Unknown,,cid:50)(cid:46)(cid:12)(cid:2)(cid:7)(cid:8)(cid:10)(cid:5)(cid:3)(cid:48)(cid:46)(cid:3)(cid:12)(cid:13)(cid:5)(cid:2)(cid:14)(cid:46)(cid:2)(cid:28)(cid:5)(cid:3)(cid:10)(cid:5)(cid:2)(cid:64)(cid:46)(cid:4)(cid:12)(cid:2)(cid:28)(cid:3,,12558.0
,,7,,,Unknown,,cid:50)(cid:46)(cid:12)(cid:2)(cid:7)(cid:8)(cid:10)(cid:5)(cid:3)(cid:48)(cid:46)(cid:3)(cid:12)(cid:13)(cid:5)(cid:2)(cid:14)(cid:46)(cid:2)(cid:28)(cid:5)(cid:3)(cid:10)(cid:5)(cid:2)(cid:64)(cid:46)(cid:4)(cid:12)(cid:2)(cid:28)(cid:3,,12565.0
,,8,,,Unknown,,cid:50)(cid:46)(cid:12)(cid:2)(cid:7)(cid:8)(cid:10)(cid:5)(cid:3)(cid:48)(cid:46)(cid:3)(cid:12)(cid:13)(cid:5)(cid:2)(cid:14)(cid:46)(cid:2)(cid:28)(cid:5)(cid:3)(cid:10)(cid:5)(cid:2)(cid:64)(cid:46)(cid:4)(cid:12)(cid:2)(cid:28)(cid:3,,12573.0
,,9,,,Unknown,,cid:50)(cid:46)(cid:12)(cid:2)(cid:7)(cid:8)(cid:10)(cid:5)(cid:3)(cid:48)(cid:46)(cid:3)(cid:12)(cid:13)(cid:5)(cid:2)(cid:14)(cid:46)(cid:2)(cid:28)(cid:5)(cid:3)(cid:10)(cid:5)(cid:2)(cid:64)(cid:46)(cid:4)(cid:12)(cid:2)(cid:28)(cid:3,,12582.0
,,2,,,Unknown,,cid:50)(cid:46)(cid:12)(cid:2)(cid:7)(cid:8)(cid:10)(cid:5)(cid:3)(cid:48)(cid:46)(cid:3)(cid:12)(cid:13)(cid:5)(cid:2)(cid:14)(cid:46)(cid:2)(cid:28)(cid:5)(cid:3)(cid:10)(cid:5)(cid:2)(cid:64)(cid:46)(cid:4)(cid:12)(cid:2)(cid:28)(cid:3,,12584.0
,,28,,,Unknown,,cid:50)(cid:46)(cid:12)(cid:2)(cid:7)(cid:8)(cid:10)(cid:5)(cid:3)(cid:48)(cid:46)(cid:3)(cid:12)(cid:13)(cid:5)(cid:2)(cid:14)(cid:46)(cid:2)(cid:28)(cid:5)(cid:3)(cid:10)(cid:5)(cid:2)(cid:64)(cid:46)(cid:4)(cid:12)(cid:2)(cid:28)(cid:3,,12612.0
,,3,,,Unknown,,cid:50)(cid:46)(cid:12)(cid:2)(cid:7)(cid:8)(cid:10)(cid:5)(cid:3)(cid:48)(cid:46)(cid:3)(cid:12)(cid:13)(cid:5)(cid:2)(cid:14)(cid:46)(cid:2)(cid:28)(cid:5)(cid:3)(cid:10)(cid:5)(cid:2)(cid:64)(cid:46)(cid:4)(cid:12)(cid:2)(cid:28)(cid:3,,12615.0
,,15,,,Unknown,,cid:50)(cid:46)(cid:12)(cid:2)(cid:7)(cid:8)(cid:10)(cid:5)(cid:3)(cid:48)(cid:46)(cid:3)(cid:12)(cid:13)(cid:5)(cid:2)(cid:14)(cid:46)(cid:2)(cid:28)(cid:5)(cid:3)(cid:10)(cid:5)(cid:2)(cid:64)(cid:46)(cid:4)(cid:12)(cid:2)(cid:28)(cid:3,,12630.0
,,2,,,Unknown,,cid:50)(cid:46)(cid:12)(cid:2)(cid:7)(cid:8)(cid:10)(cid:5)(cid:3)(cid:48)(cid:46)(cid:3)(cid:12)(cid:13)(cid:5)(cid:2)(cid:14)(cid:46)(cid:2)(cid:28)(cid:5)(cid:3)(cid:10)(cid:5)(cid:2)(cid:64)(cid:46)(cid:4)(cid:12)(cid:2)(cid:28)(cid:3,,12632.0
,,17,,,Unknown,,cid:50)(cid:46)(cid:12)(cid:2)(cid:7)(cid:8)(cid:10)(cid:5)(cid:3)(cid:48)(cid:46)(cid:3)(cid:12)(cid:13)(cid:5)(cid:2)(cid:14)(cid:46)(cid:2)(cid:28)(cid:5)(cid:3)(cid:10)(cid:5)(cid:2)(cid:64)(cid:46)(cid:4)(cid:12)(cid:2)(cid:28)(cid:3,,12649.0
,,1,,,Unknown,,cid:50)(cid:46)(cid:12)(cid:2)(cid:7)(cid:8)(cid:10)(cid:5)(cid:3)(cid:48)(cid:46)(cid:3)(cid:12)(cid:13)(cid:5)(cid:2)(cid:14)(cid:46)(cid:2)(cid:28)(cid:5)(cid:3)(cid:10)(cid:5)(cid:2)(cid:64)(cid:46)(cid:4)(cid:12)(cid:2)(cid:28)(cid:3,,12650.0
,,19,,,Unknown,,cid:50)(cid:46)(cid:12)(cid:2)(cid:7)(cid:8)(cid:10)(cid:5)(cid:3)(cid:48)(cid:46)(cid:3)(cid:12)(cid:13)(cid:5)(cid:2)(cid:14)(cid:46)(cid:2)(cid:28)(cid:5)(cid:3)(cid:10)(cid:5)(cid:2)(cid:64)(cid:46)(cid:4)(cid:12)(cid:2)(cid:28)(cid:3,,12669.0
,,18,,,Unknown,,cid:50)(cid:46)(cid:12)(cid:2)(cid:7)(cid:8)(cid:10)(cid:5)(cid:3)(cid:48)(cid:46)(cid:3)(cid:12)(cid:13)(cid:5)(cid:2)(cid:14)(cid:46)(cid:2)(cid:28)(cid:5)(cid:3)(cid:10)(cid:5)(cid:2)(cid:64)(cid:46)(cid:4)(cid:12)(cid:2)(cid:28)(cid:3,,12687.0
,,18,,,Unknown,,cid:50)(cid:46)(cid:12)(cid:2)(cid:7)(cid:8)(cid:10)(cid:5)(cid:3)(cid:48)(cid:46)(cid:3)(cid:12)(cid:13)(cid:5)(cid:2)(cid:14)(cid:46)(cid:2)(cid:28)(cid:5)(cid:3)(cid:10)(cid:5)(cid:2)(cid:64)(cid:46)(cid:4)(cid:12)(cid:2)(cid:28)(cid:3,,12705.0
,,2,,,Unknown,,cid:50)(cid:46)(cid:12)(cid:2)(cid:7)(cid:8)(cid:10)(cid:5)(cid:3)(cid:48)(cid:46)(cid:3)(cid:12)(cid:13)(cid:5)(cid:2)(cid:14)(cid:46)(cid:2)(cid:28)(cid:5)(cid:3)(cid:10)(cid:5)(cid:2)(cid:64)(cid:46)(cid:4)(cid:12)(cid:2)(cid:28)(cid:3,,12707.0
,,44,,,Unknown,,cid:50)(cid:46)(cid:12)(cid:2)(cid:7)(cid:8)(cid:10)(cid:5)(cid:3)(cid:48)(cid:46)(cid:3)(cid:12)(cid:13)(cid:5)(cid:2)(cid:14)(cid:46)(cid:2)(cid:28)(cid:5)(cid:3)(cid:10)(cid:5)(cid:2)(cid:64)(cid:46)(cid:4)(cid:12)(cid:2)(cid:28)(cid:3,,12751.0
,,12,,,Unknown,,cid:50)(cid:46)(cid:12)(cid:2)(cid:7)(cid:8)(cid:10)(cid:5)(cid:3)(cid:48)(cid:46)(cid:3)(cid:12)(cid:13)(cid:5)(cid:2)(cid:14)(cid:46)(cid:2)(cid:28)(cid:5)(cid:3)(cid:10)(cid:5)(cid:2)(cid:64)(cid:46)(cid:4)(cid:12)(cid:2)(cid:28)(cid:3,,12763.0
,,29,,,Unknown,,cid:50)(cid:46)(cid:12)(cid:2)(cid:7)(cid:8)(cid:10)(cid:5)(cid:3)(cid:48)(cid:46)(cid:3)(cid:12)(cid:13)(cid:5)(cid:2)(cid:14)(cid:46)(cid:2)(cid:28)(cid:5)(cid:3)(cid:10)(cid:5)(cid:2)(cid:64)(cid:46)(cid:4)(cid:12)(cid:2)(cid:28)(cid:3,,12792.0
,,26,,,Unknown,,cid:50)(cid:46)(cid:12)(cid:2)(cid:7)(cid:8)(cid:10)(cid:5)(cid:3)(cid:48)(cid:46)(cid:3)(cid:12)(cid:13)(cid:5)(cid:2)(cid:14)(cid:46)(cid:2)(cid:28)(cid:5)(cid:3)(cid:10)(cid:5)(cid:2)(cid:64)(cid:46)(cid:4)(cid:12)(cid:2)(cid:28)(cid:3,,12818.0
,,41,,,Unknown,,cid:50)(cid:46)(cid:12)(cid:2)(cid:7)(cid:8)(cid:10)(cid:5)(cid:3)(cid:48)(cid:46)(cid:3)(cid:12)(cid:13)(cid:5)(cid:2)(cid:14)(cid:46)(cid:2)(cid:28)(cid:5)(cid:3)(cid:10)(cid:5)(cid:2)(cid:64)(cid:46)(cid:4)(cid:12)(cid:2)(cid:28)(cid:3,,12859.0
,,25,,,Unknown,,cid:50)(cid:46)(cid:12)(cid:2)(cid:7)(cid:8)(cid:10)(cid:5)(cid:3)(cid:48)(cid:46)(cid:3)(cid:12)(cid:13)(cid:5)(cid:2)(cid:14)(cid:46)(cid:2)(cid:28)(cid:5)(cid:3)(cid:10)(cid:5)(cid:2)(cid:64)(cid:46)(cid:4)(cid:12)(cid:2)(cid:28)(cid:3,,12884.0
,,2,,,Unknown,,cid:50)(cid:46)(cid:12)(cid:2)(cid:7)(cid:8)(cid:10)(cid:5)(cid:3)(cid:48)(cid:46)(cid:3)(cid:12)(cid:13)(cid:5)(cid:2)(cid:14)(cid:46)(cid:2)(cid:28)(cid:5)(cid:3)(cid:10)(cid:5)(cid:2)(cid:64)(cid:46)(cid:4)(cid:12)(cid:2)(cid:28)(cid:3,,12886.0
,,58,,,Unknown,,cid:50)(cid:46)(cid:12)(cid:2)(cid:7)(cid:8)(cid:10)(cid:5)(cid:3)(cid:48)(cid:46)(cid:3)(cid:12)(cid:13)(cid:5)(cid:2)(cid:14)(cid:46)(cid:2)(cid:28)(cid:5)(cid:3)(cid:10)(cid:5)(cid:2)(cid:64)(cid:46)(cid:4)(cid:12)(cid:2)(cid:28)(cid:3,,12944.0
,,58,,,Unknown,,cid:50)(cid:46)(cid:12)(cid:2)(cid:7)(cid:8)(cid:10)(cid:5)(cid:3)(cid:48)(cid:46)(cid:3)(cid:12)(cid:13)(cid:5)(cid:2)(cid:14)(cid:46)(cid:2)(cid:28)(cid:5)(cid:3)(cid:10)(cid:5)(cid:2)(cid:64)(cid:46)(cid:4)(cid:12)(cid:2)(cid:28)(cid:3,,13002.0
,,18,,,Unknown,,cid:50)(cid:46)(cid:12)(cid:2)(cid:7)(cid:8)(cid:10)(cid:5)(cid:3)(cid:48)(cid:46)(cid:3)(cid:12)(cid:13)(cid:5)(cid:2)(cid:14)(cid:46)(cid:2)(cid:28)(cid:5)(cid:3)(cid:10)(cid:5)(cid:2)(cid:64)(cid:46)(cid:4)(cid:12)(cid:2)(cid:28)(cid:3,,13020.0
,,1,,,Unknown,,cid:50)(cid:46)(cid:12)(cid:2)(cid:7)(cid:8)(cid:10)(cid:5)(cid:3)(cid:48)(cid:46)(cid:3)(cid:12)(cid:13)(cid:5)(cid:2)(cid:14)(cid:46)(cid:2)(cid:28)(cid:5)(cid:3)(cid:10)(cid:5)(cid:2)(cid:64)(cid:46)(cid:4)(cid:12)(cid:2)(cid:28)(cid:3,,13021.0
,,1,,,Unknown,,cid:50)(cid:46)(cid:12)(cid:2)(cid:7)(cid:8)(cid:10)(cid:5)(cid:3)(cid:48)(cid:46)(cid:3)(cid:12)(cid:13)(cid:5)(cid:2)(cid:14)(cid:46)(cid:2)(cid:28)(cid:5)(cid:3)(cid:10)(cid:5)(cid:2)(cid:64)(cid:46)(cid:4)(cid:12)(cid:2)(cid:28)(cid:3,,13022.0
,,37,,,Unknown,,cid:50)(cid:46)(cid:12)(cid:2)(cid:7)(cid:8)(cid:10)(cid:5)(cid:3)(cid:48)(cid:46)(cid:3)(cid:12)(cid:13)(cid:5)(cid:2)(cid:14)(cid:46)(cid:2)(cid:28)(cid:5)(cid:3)(cid:10)(cid:5)(cid:2)(cid:64)(cid:46)(cid:4)(cid:12)(cid:2)(cid:28)(cid:3,,13059.0
,,18,,,Unknown,,cid:50)(cid:46)(cid:12)(cid:2)(cid:7)(cid:8)(cid:10)(cid:5)(cid:3)(cid:48)(cid:46)(cid:3)(cid:12)(cid:13)(cid:5)(cid:2)(cid:14)(cid:46)(cid:2)(cid:28)(cid:5)(cid:3)(cid:10)(cid:5)(cid:2)(cid:64)(cid:46)(cid:4)(cid:12)(cid:2)(cid:28)(cid:3,,13077.0
,,16,,,Unknown,,cid:50)(cid:46)(cid:12)(cid:2)(cid:7)(cid:8)(cid:10)(cid:5)(cid:3)(cid:48)(cid:46)(cid:3)(cid:12)(cid:13)(cid:5)(cid:2)(cid:14)(cid:46)(cid:2)(cid:28)(cid:5)(cid:3)(cid:10)(cid:5)(cid:2)(cid:64)(cid:46)(cid:4)(cid:12)(cid:2)(cid:28)(cid:3,,13093.0
,,45,,,Unknown,,cid:50)(cid:46)(cid:12)(cid:2)(cid:7)(cid:8)(cid:10)(cid:5)(cid:3)(cid:48)(cid:46)(cid:3)(cid:12)(cid:13)(cid:5)(cid:2)(cid:14)(cid:46)(cid:2)(cid:28)(cid:5)(cid:3)(cid:10)(cid:5)(cid:2)(cid:64)(cid:46)(cid:4)(cid:12)(cid:2)(cid:28)(cid:3,,13138.0
,,18,,,Unknown,,cid:50)(cid:46)(cid:12)(cid:2)(cid:7)(cid:8)(cid:10)(cid:5)(cid:3)(cid:48)(cid:46)(cid:3)(cid:12)(cid:13)(cid:5)(cid:2)(cid:14)(cid:46)(cid:2)(cid:28)(cid:5)(cid:3)(cid:10)(cid:5)(cid:2)(cid:64)(cid:46)(cid:4)(cid:12)(cid:2)(cid:28)(cid:3,,13156.0
,,16,,,Unknown,,cid:50)(cid:46)(cid:12)(cid:2)(cid:7)(cid:8)(cid:10)(cid:5)(cid:3)(cid:48)(cid:46)(cid:3)(cid:12)(cid:13)(cid:5)(cid:2)(cid:14)(cid:46)(cid:2)(cid:28)(cid:5)(cid:3)(cid:10)(cid:5)(cid:2)(cid:64)(cid:46)(cid:4)(cid:12)(cid:2)(cid:28)(cid:3,,13172.0
,,64,,,Unknown,,cid:50)(cid:46)(cid:12)(cid:2)(cid:7)(cid:8)(cid:10)(cid:5)(cid:3)(cid:48)(cid:46)(cid:3)(cid:12)(cid:13)(cid:5)(cid:2)(cid:14)(cid:46)(cid:2)(cid:28)(cid:5)(cid:3)(cid:10)(cid:5)(cid:2)(cid:64)(cid:46)(cid:4)(cid:12)(cid:2)(cid:28)(cid:3,,13236.0
,,5,,,Unknown,,cid:50)(cid:46)(cid:12)(cid:2)(cid:7)(cid:8)(cid:10)(cid:5)(cid:3)(cid:48)(cid:46)(cid:3)(cid:12)(cid:13)(cid:5)(cid:2)(cid:14)(cid:46)(cid:2)(cid:28)(cid:5)(cid:3)(cid:10)(cid:5)(cid:2)(cid:64)(cid:46)(cid:4)(cid:12)(cid:2)(cid:28)(cid:3,,13241.0
,,8,,,Unknown,,cid:50)(cid:46)(cid:12)(cid:2)(cid:7)(cid:8)(cid:10)(cid:5)(cid:3)(cid:48)(cid:46)(cid:3)(cid:12)(cid:13)(cid:5)(cid:2)(cid:14)(cid:46)(cid:2)(cid:28)(cid:5)(cid:3)(cid:10)(cid:5)(cid:2)(cid:64)(cid:46)(cid:4)(cid:12)(cid:2)(cid:28)(cid:3,,13249.0
,,5,,,Unknown,,cid:50)(cid:46)(cid:12)(cid:2)(cid:7)(cid:8)(cid:10)(cid:5)(cid:3)(cid:48)(cid:46)(cid:3)(cid:12)(cid:13)(cid:5)(cid:2)(cid:14)(cid:46)(cid:2)(cid:28)(cid:5)(cid:3)(cid:10)(cid:5)(cid:2)(cid:64)(cid:46)(cid:4)(cid:12)(cid:2)(cid:28)(cid:3,,13254.0
,,3,,,Unknown,,cid:50)(cid:46)(cid:12)(cid:2)(cid:7)(cid:8)(cid:10)(cid:5)(cid:3)(cid:48)(cid:46)(cid:3)(cid:12)(cid:13)(cid:5)(cid:2)(cid:14)(cid:46)(cid:2)(cid:28)(cid:5)(cid:3)(cid:10)(cid:5)(cid:2)(cid:64)(cid:46)(cid:4)(cid:12)(cid:2)(cid:28)(cid:3,,13257.0
,,46,,,Unknown,,cid:50)(cid:46)(cid:12)(cid:2)(cid:7)(cid:8)(cid:10)(cid:5)(cid:3)(cid:48)(cid:46)(cid:3)(cid:12)(cid:13)(cid:5)(cid:2)(cid:14)(cid:46)(cid:2)(cid:28)(cid:5)(cid:3)(cid:10)(cid:5)(cid:2)(cid:64)(cid:46)(cid:4)(cid:12)(cid:2)(cid:28)(cid:3,,13303.0
,,14,,,Unknown,,cid:50)(cid:46)(cid:12)(cid:2)(cid:7)(cid:8)(cid:10)(cid:5)(cid:3)(cid:48)(cid:46)(cid:3)(cid:12)(cid:13)(cid:5)(cid:2)(cid:14)(cid:46)(cid:2)(cid:28)(cid:5)(cid:3)(cid:10)(cid:5)(cid:2)(cid:64)(cid:46)(cid:4)(cid:12)(cid:2)(cid:28)(cid:3,,13317.0
,,7,,,Unknown,,cid:50)(cid:46)(cid:12)(cid:2)(cid:7)(cid:8)(cid:10)(cid:5)(cid:3)(cid:48)(cid:46)(cid:3)(cid:12)(cid:13)(cid:5)(cid:2)(cid:14)(cid:46)(cid:2)(cid:28)(cid:5)(cid:3)(cid:10)(cid:5)(cid:2)(cid:64)(cid:46)(cid:4)(cid:12)(cid:2)(cid:28)(cid:3,,13324.0
,,2,,,Unknown,,cid:50)(cid:46)(cid:12)(cid:2)(cid:7)(cid:8)(cid:10)(cid:5)(cid:3)(cid:48)(cid:46)(cid:3)(cid:12)(cid:13)(cid:5)(cid:2)(cid:14)(cid:46)(cid:2)(cid:28)(cid:5)(cid:3)(cid:10)(cid:5)(cid:2)(cid:64)(cid:46)(cid:4)(cid:12)(cid:2)(cid:28)(cid:3,,13326.0
,,7,,,Unknown,,cid:50)(cid:46)(cid:12)(cid:2)(cid:7)(cid:8)(cid:10)(cid:5)(cid:3)(cid:48)(cid:46)(cid:3)(cid:12)(cid:13)(cid:5)(cid:2)(cid:14)(cid:46)(cid:2)(cid:28)(cid:5)(cid:3)(cid:10)(cid:5)(cid:2)(cid:64)(cid:46)(cid:4)(cid:12)(cid:2)(cid:28)(cid:3,,13333.0
,,46,,,Unknown,,cid:50)(cid:46)(cid:12)(cid:2)(cid:7)(cid:8)(cid:10)(cid:5)(cid:3)(cid:48)(cid:46)(cid:3)(cid:12)(cid:13)(cid:5)(cid:2)(cid:14)(cid:46)(cid:2)(cid:28)(cid:5)(cid:3)(cid:10)(cid:5)(cid:2)(cid:64)(cid:46)(cid:4)(cid:12)(cid:2)(cid:28)(cid:3,,13379.0
,,3,,,Unknown,,cid:50)(cid:46)(cid:12)(cid:2)(cid:7)(cid:8)(cid:10)(cid:5)(cid:3)(cid:48)(cid:46)(cid:3)(cid:12)(cid:13)(cid:5)(cid:2)(cid:14)(cid:46)(cid:2)(cid:28)(cid:5)(cid:3)(cid:10)(cid:5)(cid:2)(cid:64)(cid:46)(cid:4)(cid:12)(cid:2)(cid:28)(cid:3,,13382.0
,,50,,,Unknown,,cid:50)(cid:46)(cid:12)(cid:2)(cid:7)(cid:8)(cid:10)(cid:5)(cid:3)(cid:48)(cid:46)(cid:3)(cid:12)(cid:13)(cid:5)(cid:2)(cid:14)(cid:46)(cid:2)(cid:28)(cid:5)(cid:3)(cid:10)(cid:5)(cid:2)(cid:64)(cid:46)(cid:4)(cid:12)(cid:2)(cid:28)(cid:3,,13432.0
,,2,,,Unknown,,cid:50)(cid:46)(cid:12)(cid:2)(cid:7)(cid:8)(cid:10)(cid:5)(cid:3)(cid:48)(cid:46)(cid:3)(cid:12)(cid:13)(cid:5)(cid:2)(cid:14)(cid:46)(cid:2)(cid:28)(cid:5)(cid:3)(cid:10)(cid:5)(cid:2)(cid:64)(cid:46)(cid:4)(cid:12)(cid:2)(cid:28)(cid:3,,13434.0
,,9,,,Unknown,,cid:50)(cid:46)(cid:12)(cid:2)(cid:7)(cid:8)(cid:10)(cid:5)(cid:3)(cid:48)(cid:46)(cid:3)(cid:12)(cid:13)(cid:5)(cid:2)(cid:14)(cid:46)(cid:2)(cid:28)(cid:5)(cid:3)(cid:10)(cid:5)(cid:2)(cid:64)(cid:46)(cid:4)(cid:12)(cid:2)(cid:28)(cid:3,,13443.0
,,46,,,Unknown,,cid:50)(cid:46)(cid:12)(cid:2)(cid:7)(cid:8)(cid:10)(cid:5)(cid:3)(cid:48)(cid:46)(cid:3)(cid:12)(cid:13)(cid:5)(cid:2)(cid:14)(cid:46)(cid:2)(cid:28)(cid:5)(cid:3)(cid:10)(cid:5)(cid:2)(cid:64)(cid:46)(cid:4)(cid:12)(cid:2)(cid:28)(cid:3,,13489.0
,,15,,,Unknown,,cid:50)(cid:46)(cid:12)(cid:2)(cid:7)(cid:8)(cid:10)(cid:5)(cid:3)(cid:48)(cid:46)(cid:3)(cid:12)(cid:13)(cid:5)(cid:2)(cid:14)(cid:46)(cid:2)(cid:28)(cid:5)(cid:3)(cid:10)(cid:5)(cid:2)(cid:64)(cid:46)(cid:4)(cid:12)(cid:2)(cid:28)(cid:3,,13504.0
,,2,,,Unknown,,cid:50)(cid:46)(cid:12)(cid:2)(cid:7)(cid:8)(cid:10)(cid:5)(cid:3)(cid:48)(cid:46)(cid:3)(cid:12)(cid:13)(cid:5)(cid:2)(cid:14)(cid:46)(cid:2)(cid:28)(cid:5)(cid:3)(cid:10)(cid:5)(cid:2)(cid:64)(cid:46)(cid:4)(cid:12)(cid:2)(cid:28)(cid:3,,13506.0
,,1,,,Unknown,,cid:50)(cid:46)(cid:12)(cid:2)(cid:7)(cid:8)(cid:10)(cid:5)(cid:3)(cid:48)(cid:46)(cid:3)(cid:12)(cid:13)(cid:5)(cid:2)(cid:14)(cid:46)(cid:2)(cid:28)(cid:5)(cid:3)(cid:10)(cid:5)(cid:2)(cid:64)(cid:46)(cid:4)(cid:12)(cid:2)(cid:28)(cid:3,,13507.0
,,37,,,Unknown,,cid:50)(cid:46)(cid:12)(cid:2)(cid:7)(cid:8)(cid:10)(cid:5)(cid:3)(cid:48)(cid:46)(cid:3)(cid:12)(cid:13)(cid:5)(cid:2)(cid:14)(cid:46)(cid:2)(cid:28)(cid:5)(cid:3)(cid:10)(cid:5)(cid:2)(cid:64)(cid:46)(cid:4)(cid:12)(cid:2)(cid:28)(cid:3,,13544.0
,,36,,,Unknown,,cid:50)(cid:46)(cid:12)(cid:2)(cid:7)(cid:8)(cid:10)(cid:5)(cid:3)(cid:48)(cid:46)(cid:3)(cid:12)(cid:13)(cid:5)(cid:2)(cid:14)(cid:46)(cid:2)(cid:28)(cid:5)(cid:3)(cid:10)(cid:5)(cid:2)(cid:64)(cid:46)(cid:4)(cid:12)(cid:2)(cid:28)(cid:3,,13580.0
,,19,,,Unknown,,cid:50)(cid:46)(cid:12)(cid:2)(cid:7)(cid:8)(cid:10)(cid:5)(cid:3)(cid:48)(cid:46)(cid:3)(cid:12)(cid:13)(cid:5)(cid:2)(cid:14)(cid:46)(cid:2)(cid:28)(cid:5)(cid:3)(cid:10)(cid:5)(cid:2)(cid:64)(cid:46)(cid:4)(cid:12)(cid:2)(cid:28)(cid:3,,13599.0
,,32,,,Unknown,,cid:50)(cid:46)(cid:12)(cid:2)(cid:7)(cid:8)(cid:10)(cid:5)(cid:3)(cid:48)(cid:46)(cid:3)(cid:12)(cid:13)(cid:5)(cid:2)(cid:14)(cid:46)(cid:2)(cid:28)(cid:5)(cid:3)(cid:10)(cid:5)(cid:2)(cid:64)(cid:46)(cid:4)(cid:12)(cid:2)(cid:28)(cid:3,,13631.0
,,36,,,Unknown,,cid:50)(cid:46)(cid:12)(cid:2)(cid:7)(cid:8)(cid:10)(cid:5)(cid:3)(cid:48)(cid:46)(cid:3)(cid:12)(cid:13)(cid:5)(cid:2)(cid:14)(cid:46)(cid:2)(cid:28)(cid:5)(cid:3)(cid:10)(cid:5)(cid:2)(cid:64)(cid:46)(cid:4)(cid:12)(cid:2)(cid:28)(cid:3,,13667.0
,,2,,,Unknown,,cid:50)(cid:46)(cid:12)(cid:2)(cid:7)(cid:8)(cid:10)(cid:5)(cid:3)(cid:48)(cid:46)(cid:3)(cid:12)(cid:13)(cid:5)(cid:2)(cid:14)(cid:46)(cid:2)(cid:28)(cid:5)(cid:3)(cid:10)(cid:5)(cid:2)(cid:64)(cid:46)(cid:4)(cid:12)(cid:2)(cid:28)(cid:3,,13669.0
,,44,,,Unknown,,cid:50)(cid:46)(cid:12)(cid:2)(cid:7)(cid:8)(cid:10)(cid:5)(cid:3)(cid:48)(cid:46)(cid:3)(cid:12)(cid:13)(cid:5)(cid:2)(cid:14)(cid:46)(cid:2)(cid:28)(cid:5)(cid:3)(cid:10)(cid:5)(cid:2)(cid:64)(cid:46)(cid:4)(cid:12)(cid:2)(cid:28)(cid:3,,13713.0
,,12,,,Unknown,,cid:50)(cid:46)(cid:12)(cid:2)(cid:7)(cid:8)(cid:10)(cid:5)(cid:3)(cid:48)(cid:46)(cid:3)(cid:12)(cid:13)(cid:5)(cid:2)(cid:14)(cid:46)(cid:2)(cid:28)(cid:5)(cid:3)(cid:10)(cid:5)(cid:2)(cid:64)(cid:46)(cid:4)(cid:12)(cid:2)(cid:28)(cid:3,,13725.0
,,20,,,Unknown,,cid:50)(cid:46)(cid:12)(cid:2)(cid:7)(cid:8)(cid:10)(cid:5)(cid:3)(cid:48)(cid:46)(cid:3)(cid:12)(cid:13)(cid:5)(cid:2)(cid:14)(cid:46)(cid:2)(cid:28)(cid:5)(cid:3)(cid:10)(cid:5)(cid:2)(cid:64)(cid:46)(cid:4)(cid:12)(cid:2)(cid:28)(cid:3,,13745.0
,,30,,,Unknown,,cid:50)(cid:46)(cid:12)(cid:2)(cid:7)(cid:8)(cid:10)(cid:5)(cid:3)(cid:48)(cid:46)(cid:3)(cid:12)(cid:13)(cid:5)(cid:2)(cid:14)(cid:46)(cid:2)(cid:28)(cid:5)(cid:3)(cid:10)(cid:5)(cid:2)(cid:64)(cid:46)(cid:4)(cid:12)(cid:2)(cid:28)(cid:3,,13775.0
,,41,,,Unknown,,cid:50)(cid:46)(cid:12)(cid:2)(cid:7)(cid:8)(cid:10)(cid:5)(cid:3)(cid:48)(cid:46)(cid:3)(cid:12)(cid:13)(cid:5)(cid:2)(cid:14)(cid:46)(cid:2)(cid:28)(cid:5)(cid:3)(cid:10)(cid:5)(cid:2)(cid:64)(cid:46)(cid:4)(cid:12)(cid:2)(cid:28)(cid:3,,13816.0
,,26,,,Unknown,,cid:50)(cid:46)(cid:12)(cid:2)(cid:7)(cid:8)(cid:10)(cid:5)(cid:3)(cid:48)(cid:46)(cid:3)(cid:12)(cid:13)(cid:5)(cid:2)(cid:14)(cid:46)(cid:2)(cid:28)(cid:5)(cid:3)(cid:10)(cid:5)(cid:2)(cid:64)(cid:46)(cid:4)(cid:12)(cid:2)(cid:28)(cid:3,,13842.0
,,29,,,Unknown,,cid:50)(cid:46)(cid:12)(cid:2)(cid:7)(cid:8)(cid:10)(cid:5)(cid:3)(cid:48)(cid:46)(cid:3)(cid:12)(cid:13)(cid:5)(cid:2)(cid:14)(cid:46)(cid:2)(cid:28)(cid:5)(cid:3)(cid:10)(cid:5)(cid:2)(cid:64)(cid:46)(cid:4)(cid:12)(cid:2)(cid:28)(cid:3,,13871.0
,,41,,,Unknown,,cid:50)(cid:46)(cid:12)(cid:2)(cid:7)(cid:8)(cid:10)(cid:5)(cid:3)(cid:48)(cid:46)(cid:3)(cid:12)(cid:13)(cid:5)(cid:2)(cid:14)(cid:46)(cid:2)(cid:28)(cid:5)(cid:3)(cid:10)(cid:5)(cid:2)(cid:64)(cid:46)(cid:4)(cid:12)(cid:2)(cid:28)(cid:3,,13912.0
,,2,,,Unknown,,cid:50)(cid:46)(cid:12)(cid:2)(cid:7)(cid:8)(cid:10)(cid:5)(cid:3)(cid:48)(cid:46)(cid:3)(cid:12)(cid:13)(cid:5)(cid:2)(cid:14)(cid:46)(cid:2)(cid:28)(cid:5)(cid:3)(cid:10)(cid:5)(cid:2)(cid:64)(cid:46)(cid:4)(cid:12)(cid:2)(cid:28)(cid:3,,13914.0
,,46,,,Unknown,,cid:50)(cid:46)(cid:12)(cid:2)(cid:7)(cid:8)(cid:10)(cid:5)(cid:3)(cid:48)(cid:46)(cid:3)(cid:12)(cid:13)(cid:5)(cid:2)(cid:14)(cid:46)(cid:2)(cid:28)(cid:5)(cid:3)(cid:10)(cid:5)(cid:2)(cid:64)(cid:46)(cid:4)(cid:12)(cid:2)(cid:28)(cid:3,,13960.0
,,10,,,Unknown,,cid:50)(cid:46)(cid:12)(cid:2)(cid:7)(cid:8)(cid:10)(cid:5)(cid:3)(cid:48)(cid:46)(cid:3)(cid:12)(cid:13)(cid:5)(cid:2)(cid:14)(cid:46)(cid:2)(cid:28)(cid:5)(cid:3)(cid:10)(cid:5)(cid:2)(cid:64)(cid:46)(cid:4)(cid:12)(cid:2)(cid:28)(cid:3,,13970.0
,,1,,,Unknown,,cid:50)(cid:46)(cid:12)(cid:2)(cid:7)(cid:8)(cid:10)(cid:5)(cid:3)(cid:48)(cid:46)(cid:3)(cid:12)(cid:13)(cid:5)(cid:2)(cid:14)(cid:46)(cid:2)(cid:28)(cid:5)(cid:3)(cid:10)(cid:5)(cid:2)(cid:64)(cid:46)(cid:4)(cid:12)(cid:2)(cid:28)(cid:3,,13971.0
,,37,,,Unknown,,cid:50)(cid:46)(cid:12)(cid:2)(cid:7)(cid:8)(cid:10)(cid:5)(cid:3)(cid:48)(cid:46)(cid:3)(cid:12)(cid:13)(cid:5)(cid:2)(cid:14)(cid:46)(cid:2)(cid:28)(cid:5)(cid:3)(cid:10)(cid:5)(cid:2)(cid:64)(cid:46)(cid:4)(cid:12)(cid:2)(cid:28)(cid:3,,14008.0
,,37,,,Unknown,,cid:50)(cid:46)(cid:12)(cid:2)(cid:7)(cid:8)(cid:10)(cid:5)(cid:3)(cid:48)(cid:46)(cid:3)(cid:12)(cid:13)(cid:5)(cid:2)(cid:14)(cid:46)(cid:2)(cid:28)(cid:5)(cid:3)(cid:10)(cid:5)(cid:2)(cid:64)(cid:46)(cid:4)(cid:12)(cid:2)(cid:28)(cid:3,,14045.0
,,1,,,Unknown,,cid:50)(cid:46)(cid:12)(cid:2)(cid:7)(cid:8)(cid:10)(cid:5)(cid:3)(cid:48)(cid:46)(cid:3)(cid:12)(cid:13)(cid:5)(cid:2)(cid:14)(cid:46)(cid:2)(cid:28)(cid:5)(cid:3)(cid:10)(cid:5)(cid:2)(cid:64)(cid:46)(cid:4)(cid:12)(cid:2)(cid:28)(cid:3,,14046.0
,,34,,,Unknown,,cid:50)(cid:46)(cid:12)(cid:2)(cid:7)(cid:8)(cid:10)(cid:5)(cid:3)(cid:48)(cid:46)(cid:3)(cid:12)(cid:13)(cid:5)(cid:2)(cid:14)(cid:46)(cid:2)(cid:28)(cid:5)(cid:3)(cid:10)(cid:5)(cid:2)(cid:64)(cid:46)(cid:4)(cid:12)(cid:2)(cid:28)(cid:3,,14080.0
,,16,,,Unknown,,cid:50)(cid:46)(cid:12)(cid:2)(cid:7)(cid:8)(cid:10)(cid:5)(cid:3)(cid:48)(cid:46)(cid:3)(cid:12)(cid:13)(cid:5)(cid:2)(cid:14)(cid:46)(cid:2)(cid:28)(cid:5)(cid:3)(cid:10)(cid:5)(cid:2)(cid:64)(cid:46)(cid:4)(cid:12)(cid:2)(cid:28)(cid:3,,14096.0
,,2,,,Unknown,,cid:50)(cid:46)(cid:12)(cid:2)(cid:7)(cid:8)(cid:10)(cid:5)(cid:3)(cid:48)(cid:46)(cid:3)(cid:12)(cid:13)(cid:5)(cid:2)(cid:14)(cid:46)(cid:2)(cid:28)(cid:5)(cid:3)(cid:10)(cid:5)(cid:2)(cid:64)(cid:46)(cid:4)(cid:12)(cid:2)(cid:28)(cid:3,,14098.0
,,15,,,Unknown,,cid:50)(cid:46)(cid:12)(cid:2)(cid:7)(cid:8)(cid:10)(cid:5)(cid:3)(cid:48)(cid:46)(cid:3)(cid:12)(cid:13)(cid:5)(cid:2)(cid:14)(cid:46)(cid:2)(cid:28)(cid:5)(cid:3)(cid:10)(cid:5)(cid:2)(cid:64)(cid:46)(cid:4)(cid:12)(cid:2)(cid:28)(cid:3,,14113.0
,,2,,,Unknown,,cid:50)(cid:46)(cid:12)(cid:2)(cid:7)(cid:8)(cid:10)(cid:5)(cid:3)(cid:48)(cid:46)(cid:3)(cid:12)(cid:13)(cid:5)(cid:2)(cid:14)(cid:46)(cid:2)(cid:28)(cid:5)(cid:3)(cid:10)(cid:5)(cid:2)(cid:64)(cid:46)(cid:4)(cid:12)(cid:2)(cid:28)(cid:3,,14115.0
,,18,,,Unknown,,cid:50)(cid:46)(cid:12)(cid:2)(cid:7)(cid:8)(cid:10)(cid:5)(cid:3)(cid:48)(cid:46)(cid:3)(cid:12)(cid:13)(cid:5)(cid:2)(cid:14)(cid:46)(cid:2)(cid:28)(cid:5)(cid:3)(cid:10)(cid:5)(cid:2)(cid:64)(cid:46)(cid:4)(cid:12)(cid:2)(cid:28)(cid:3,,14133.0
,,32,,,Unknown,,cid:50)(cid:46)(cid:12)(cid:2)(cid:7)(cid:8)(cid:10)(cid:5)(cid:3)(cid:48)(cid:46)(cid:3)(cid:12)(cid:13)(cid:5)(cid:2)(cid:14)(cid:46)(cid:2)(cid:28)(cid:5)(cid:3)(cid:10)(cid:5)(cid:2)(cid:64)(cid:46)(cid:4)(cid:12)(cid:2)(cid:28)(cid:3,,14165.0
,,18,,,Unknown,,cid:50)(cid:46)(cid:12)(cid:2)(cid:7)(cid:8)(cid:10)(cid:5)(cid:3)(cid:48)(cid:46)(cid:3)(cid:12)(cid:13)(cid:5)(cid:2)(cid:14)(cid:46)(cid:2)(cid:28)(cid:5)(cid:3)(cid:10)(cid:5)(cid:2)(cid:64)(cid:46)(cid:4)(cid:12)(cid:2)(cid:28)(cid:3,,14183.0
,,16,,,Unknown,,cid:50)(cid:46)(cid:12)(cid:2)(cid:7)(cid:8)(cid:10)(cid:5)(cid:3)(cid:48)(cid:46)(cid:3)(cid:12)(cid:13)(cid:5)(cid:2)(cid:14)(cid:46)(cid:2)(cid:28)(cid:5)(cid:3)(cid:10)(cid:5)(cid:2)(cid:64)(cid:46)(cid:4)(cid:12)(cid:2)(cid:28)(cid:3,,14199.0
,,1,,,Unknown,,cid:50)(cid:46)(cid:12)(cid:2)(cid:7)(cid:8)(cid:10)(cid:5)(cid:3)(cid:48)(cid:46)(cid:3)(cid:12)(cid:13)(cid:5)(cid:2)(cid:14)(cid:46)(cid:2)(cid:28)(cid:5)(cid:3)(cid:10)(cid:5)(cid:2)(cid:64)(cid:46)(cid:4)(cid:12)(cid:2)(cid:28)(cid:3,,14200.0
,,18,,,Unknown,,cid:50)(cid:46)(cid:12)(cid:2)(cid:7)(cid:8)(cid:10)(cid:5)(cid:3)(cid:48)(cid:46)(cid:3)(cid:12)(cid:13)(cid:5)(cid:2)(cid:14)(cid:46)(cid:2)(cid:28)(cid:5)(cid:3)(cid:10)(cid:5)(cid:2)(cid:64)(cid:46)(cid:4)(cid:12)(cid:2)(cid:28)(cid:3,,14218.0
,,1,,,Unknown,,cid:50)(cid:46)(cid:12)(cid:2)(cid:7)(cid:8)(cid:10)(cid:5)(cid:3)(cid:48)(cid:46)(cid:3)(cid:12)(cid:13)(cid:5)(cid:2)(cid:14)(cid:46)(cid:2)(cid:28)(cid:5)(cid:3)(cid:10)(cid:5)(cid:2)(cid:64)(cid:46)(cid:4)(cid:12)(cid:2)(cid:28)(cid:3,,14219.0
,,17,,,Unknown,,cid:50)(cid:46)(cid:12)(cid:2)(cid:7)(cid:8)(cid:10)(cid:5)(cid:3)(cid:48)(cid:46)(cid:3)(cid:12)(cid:13)(cid:5)(cid:2)(cid:14)(cid:46)(cid:2)(cid:28)(cid:5)(cid:3)(cid:10)(cid:5)(cid:2)(cid:64)(cid:46)(cid:4)(cid:12)(cid:2)(cid:28)(cid:3,,14236.0
,,18,,,Unknown,,cid:50)(cid:46)(cid:12)(cid:2)(cid:7)(cid:8)(cid:10)(cid:5)(cid:3)(cid:48)(cid:46)(cid:3)(cid:12)(cid:13)(cid:5)(cid:2)(cid:14)(cid:46)(cid:2)(cid:28)(cid:5)(cid:3)(cid:10)(cid:5)(cid:2)(cid:64)(cid:46)(cid:4)(cid:12)(cid:2)(cid:28)(cid:3,,14254.0
,,18,,,Unknown,,cid:50)(cid:46)(cid:12)(cid:2)(cid:7)(cid:8)(cid:10)(cid:5)(cid:3)(cid:48)(cid:46)(cid:3)(cid:12)(cid:13)(cid:5)(cid:2)(cid:14)(cid:46)(cid:2)(cid:28)(cid:5)(cid:3)(cid:10)(cid:5)(cid:2)(cid:64)(cid:46)(cid:4)(cid:12)(cid:2)(cid:28)(cid:3,,14272.0
,,16,,,Unknown,,cid:50)(cid:46)(cid:12)(cid:2)(cid:7)(cid:8)(cid:10)(cid:5)(cid:3)(cid:48)(cid:46)(cid:3)(cid:12)(cid:13)(cid:5)(cid:2)(cid:14)(cid:46)(cid:2)(cid:28)(cid:5)(cid:3)(cid:10)(cid:5)(cid:2)(cid:64)(cid:46)(cid:4)(cid:12)(cid:2)(cid:28)(cid:3,,14288.0
,,35,,,Unknown,,cid:50)(cid:46)(cid:12)(cid:2)(cid:7)(cid:8)(cid:10)(cid:5)(cid:3)(cid:48)(cid:46)(cid:3)(cid:12)(cid:13)(cid:5)(cid:2)(cid:14)(cid:46)(cid:2)(cid:28)(cid:5)(cid:3)(cid:10)(cid:5)(cid:2)(cid:64)(cid:46)(cid:4)(cid:12)(cid:2)(cid:28)(cid:3,,14323.0
,,33,,,Unknown,,cid:50)(cid:46)(cid:12)(cid:2)(cid:7)(cid:8)(cid:10)(cid:5)(cid:3)(cid:48)(cid:46)(cid:3)(cid:12)(cid:13)(cid:5)(cid:2)(cid:14)(cid:46)(cid:2)(cid:28)(cid:5)(cid:3)(cid:10)(cid:5)(cid:2)(cid:64)(cid:46)(cid:4)(cid:12)(cid:2)(cid:28)(cid:3,,14356.0
,,18,,,Unknown,,cid:50)(cid:46)(cid:12)(cid:2)(cid:7)(cid:8)(cid:10)(cid:5)(cid:3)(cid:48)(cid:46)(cid:3)(cid:12)(cid:13)(cid:5)(cid:2)(cid:14)(cid:46)(cid:2)(cid:28)(cid:5)(cid:3)(cid:10)(cid:5)(cid:2)(cid:64)(cid:46)(cid:4)(cid:12)(cid:2)(cid:28)(cid:3,,14374.0
,,34,,,Unknown,,cid:50)(cid:46)(cid:12)(cid:2)(cid:7)(cid:8)(cid:10)(cid:5)(cid:3)(cid:48)(cid:46)(cid:3)(cid:12)(cid:13)(cid:5)(cid:2)(cid:14)(cid:46)(cid:2)(cid:28)(cid:5)(cid:3)(cid:10)(cid:5)(cid:2)(cid:64)(cid:46)(cid:4)(cid:12)(cid:2)(cid:28)(cid:3,,14408.0
,,18,,,Unknown,,cid:50)(cid:46)(cid:12)(cid:2)(cid:7)(cid:8)(cid:10)(cid:5)(cid:3)(cid:48)(cid:46)(cid:3)(cid:12)(cid:13)(cid:5)(cid:2)(cid:14)(cid:46)(cid:2)(cid:28)(cid:5)(cid:3)(cid:10)(cid:5)(cid:2)(cid:64)(cid:46)(cid:4)(cid:12)(cid:2)(cid:28)(cid:3,,14426.0
,,35,,,Unknown,,cid:50)(cid:46)(cid:12)(cid:2)(cid:7)(cid:8)(cid:10)(cid:5)(cid:3)(cid:48)(cid:46)(cid:3)(cid:12)(cid:13)(cid:5)(cid:2)(cid:14)(cid:46)(cid:2)(cid:28)(cid:5)(cid:3)(cid:10)(cid:5)(cid:2)(cid:64)(cid:46)(cid:4)(cid:12)(cid:2)(cid:28)(cid:3,,14461.0
,,45,,,Unknown,,cid:50)(cid:46)(cid:12)(cid:2)(cid:7)(cid:8)(cid:10)(cid:5)(cid:3)(cid:48)(cid:46)(cid:3)(cid:12)(cid:13)(cid:5)(cid:2)(cid:14)(cid:46)(cid:2)(cid:28)(cid:5)(cid:3)(cid:10)(cid:5)(cid:2)(cid:64)(cid:46)(cid:4)(cid:12)(cid:2)(cid:28)(cid:3,,14506.0
,,18,,,Unknown,,cid:50)(cid:46)(cid:12)(cid:2)(cid:7)(cid:8)(cid:10)(cid:5)(cid:3)(cid:48)(cid:46)(cid:3)(cid:12)(cid:13)(cid:5)(cid:2)(cid:14)(cid:46)(cid:2)(cid:28)(cid:5)(cid:3)(cid:10)(cid:5)(cid:2)(cid:64)(cid:46)(cid:4)(cid:12)(cid:2)(cid:28)(cid:3,,14524.0
,,16,,,Unknown,,cid:50)(cid:46)(cid:12)(cid:2)(cid:7)(cid:8)(cid:10)(cid:5)(cid:3)(cid:48)(cid:46)(cid:3)(cid:12)(cid:13)(cid:5)(cid:2)(cid:14)(cid:46)(cid:2)(cid:28)(cid:5)(cid:3)(cid:10)(cid:5)(cid:2)(cid:64)(cid:46)(cid:4)(cid:12)(cid:2)(cid:28)(cid:3,,14540.0
,,9,,,Unknown,,cid:50)(cid:46)(cid:12)(cid:2)(cid:7)(cid:8)(cid:10)(cid:5)(cid:3)(cid:48)(cid:46)(cid:3)(cid:12)(cid:13)(cid:5)(cid:2)(cid:14)(cid:46)(cid:2)(cid:28)(cid:5)(cid:3)(cid:10)(cid:5)(cid:2)(cid:64)(cid:46)(cid:4)(cid:12)(cid:2)(cid:28)(cid:3,,14549.0
,,41,,,Unknown,,cid:50)(cid:46)(cid:12)(cid:2)(cid:7)(cid:8)(cid:10)(cid:5)(cid:3)(cid:48)(cid:46)(cid:3)(cid:12)(cid:13)(cid:5)(cid:2)(cid:14)(cid:46)(cid:2)(cid:28)(cid:5)(cid:3)(cid:10)(cid:5)(cid:2)(cid:64)(cid:46)(cid:4)(cid:12)(cid:2)(cid:28)(cid:3,,14590.0
,,29,,,Unknown,,cid:50)(cid:46)(cid:12)(cid:2)(cid:7)(cid:8)(cid:10)(cid:5)(cid:3)(cid:48)(cid:46)(cid:3)(cid:12)(cid:13)(cid:5)(cid:2)(cid:14)(cid:46)(cid:2)(cid:28)(cid:5)(cid:3)(cid:10)(cid:5)(cid:2)(cid:64)(cid:46)(cid:4)(cid:12)(cid:2)(cid:28)(cid:3,,14619.0
,,41,,,Unknown,,cid:50)(cid:46)(cid:12)(cid:2)(cid:7)(cid:8)(cid:10)(cid:5)(cid:3)(cid:48)(cid:46)(cid:3)(cid:12)(cid:13)(cid:5)(cid:2)(cid:14)(cid:46)(cid:2)(cid:28)(cid:5)(cid:3)(cid:10)(cid:5)(cid:2)(cid:64)(cid:46)(cid:4)(cid:12)(cid:2)(cid:28)(cid:3,,14660.0
,,24,,,Unknown,,cid:50)(cid:46)(cid:12)(cid:2)(cid:7)(cid:8)(cid:10)(cid:5)(cid:3)(cid:48)(cid:46)(cid:3)(cid:12)(cid:13)(cid:5)(cid:2)(cid:14)(cid:46)(cid:2)(cid:28)(cid:5)(cid:3)(cid:10)(cid:5)(cid:2)(cid:64)(cid:46)(cid:4)(cid:12)(cid:2)(cid:28)(cid:3,,14684.0
,,20,,,Unknown,,cid:50)(cid:46)(cid:12)(cid:2)(cid:7)(cid:8)(cid:10)(cid:5)(cid:3)(cid:48)(cid:46)(cid:3)(cid:12)(cid:13)(cid:5)(cid:2)(cid:14)(cid:46)(cid:2)(cid:28)(cid:5)(cid:3)(cid:10)(cid:5)(cid:2)(cid:64)(cid:46)(cid:4)(cid:12)(cid:2)(cid:28)(cid:3,,14704.0
,,30,,,Unknown,,cid:50)(cid:46)(cid:12)(cid:2)(cid:7)(cid:8)(cid:10)(cid:5)(cid:3)(cid:48)(cid:46)(cid:3)(cid:12)(cid:13)(cid:5)(cid:2)(cid:14)(cid:46)(cid:2)(cid:28)(cid:5)(cid:3)(cid:10)(cid:5)(cid:2)(cid:64)(cid:46)(cid:4)(cid:12)(cid:2)(cid:28)(cid:3,,14734.0
,,2,,,Unknown,,cid:50)(cid:46)(cid:12)(cid:2)(cid:7)(cid:8)(cid:10)(cid:5)(cid:3)(cid:48)(cid:46)(cid:3)(cid:12)(cid:13)(cid:5)(cid:2)(cid:14)(cid:46)(cid:2)(cid:28)(cid:5)(cid:3)(cid:10)(cid:5)(cid:2)(cid:64)(cid:46)(cid:4)(cid:12)(cid:2)(cid:28)(cid:3,,14736.0
,,46,,,Unknown,,cid:50)(cid:46)(cid:12)(cid:2)(cid:7)(cid:8)(cid:10)(cid:5)(cid:3)(cid:48)(cid:46)(cid:3)(cid:12)(cid:13)(cid:5)(cid:2)(cid:14)(cid:46)(cid:2)(cid:28)(cid:5)(cid:3)(cid:10)(cid:5)(cid:2)(cid:64)(cid:46)(cid:4)(cid:12)(cid:2)(cid:28)(cid:3,,14782.0
,,62,,,Unknown,,cid:50)(cid:46)(cid:12)(cid:2)(cid:7)(cid:8)(cid:10)(cid:5)(cid:3)(cid:48)(cid:46)(cid:3)(cid:12)(cid:13)(cid:5)(cid:2)(cid:14)(cid:46)(cid:2)(cid:28)(cid:5)(cid:3)(cid:10)(cid:5)(cid:2)(cid:64)(cid:46)(cid:4)(cid:12)(cid:2)(cid:28)(cid:3,,14844.0
,,24,,,Unknown,,cid:50)(cid:46)(cid:12)(cid:2)(cid:7)(cid:8)(cid:10)(cid:5)(cid:3)(cid:48)(cid:46)(cid:3)(cid:12)(cid:13)(cid:5)(cid:2)(cid:14)(cid:46)(cid:2)(cid:28)(cid:5)(cid:3)(cid:10)(cid:5)(cid:2)(cid:64)(cid:46)(cid:4)(cid:12)(cid:2)(cid:28)(cid:3,,14868.0
,,29,,,Unknown,,cid:50)(cid:46)(cid:12)(cid:2)(cid:7)(cid:8)(cid:10)(cid:5)(cid:3)(cid:48)(cid:46)(cid:3)(cid:12)(cid:13)(cid:5)(cid:2)(cid:14)(cid:46)(cid:2)(cid:28)(cid:5)(cid:3)(cid:10)(cid:5)(cid:2)(cid:64)(cid:46)(cid:4)(cid:12)(cid:2)(cid:28)(cid:3,,14897.0
,,2,,,Unknown,,cid:50)(cid:46)(cid:12)(cid:2)(cid:7)(cid:8)(cid:10)(cid:5)(cid:3)(cid:48)(cid:46)(cid:3)(cid:12)(cid:13)(cid:5)(cid:2)(cid:14)(cid:46)(cid:2)(cid:28)(cid:5)(cid:3)(cid:10)(cid:5)(cid:2)(cid:64)(cid:46)(cid:4)(cid:12)(cid:2)(cid:28)(cid:3,,14899.0
,,66,,,Unknown,,cid:50)(cid:46)(cid:12)(cid:2)(cid:7)(cid:8)(cid:10)(cid:5)(cid:3)(cid:48)(cid:46)(cid:3)(cid:12)(cid:13)(cid:5)(cid:2)(cid:14)(cid:46)(cid:2)(cid:28)(cid:5)(cid:3)(cid:10)(cid:5)(cid:2)(cid:64)(cid:46)(cid:4)(cid:12)(cid:2)(cid:28)(cid:3,,14965.0
,,46,,,Unknown,,cid:50)(cid:46)(cid:12)(cid:2)(cid:7)(cid:8)(cid:10)(cid:5)(cid:3)(cid:48)(cid:46)(cid:3)(cid:12)(cid:13)(cid:5)(cid:2)(cid:14)(cid:46)(cid:2)(cid:28)(cid:5)(cid:3)(cid:10)(cid:5)(cid:2)(cid:64)(cid:46)(cid:4)(cid:12)(cid:2)(cid:28)(cid:3,,15011.0
,,4,,,Unknown,,cid:50)(cid:46)(cid:12)(cid:2)(cid:7)(cid:8)(cid:10)(cid:5)(cid:3)(cid:48)(cid:46)(cid:3)(cid:12)(cid:13)(cid:5)(cid:2)(cid:14)(cid:46)(cid:2)(cid:28)(cid:5)(cid:3)(cid:10)(cid:5)(cid:2)(cid:64)(cid:46)(cid:4)(cid:12)(cid:2)(cid:28)(cid:3,,15015.0
,,50,,,Unknown,,cid:50)(cid:46)(cid:12)(cid:2)(cid:7)(cid:8)(cid:10)(cid:5)(cid:3)(cid:48)(cid:46)(cid:3)(cid:12)(cid:13)(cid:5)(cid:2)(cid:14)(cid:46)(cid:2)(cid:28)(cid:5)(cid:3)(cid:10)(cid:5)(cid:2)(cid:64)(cid:46)(cid:4)(cid:12)(cid:2)(cid:28)(cid:3,,15065.0
,,11,,,Unknown,,cid:50)(cid:46)(cid:12)(cid:2)(cid:7)(cid:8)(cid:10)(cid:5)(cid:3)(cid:48)(cid:46)(cid:3)(cid:12)(cid:13)(cid:5)(cid:2)(cid:14)(cid:46)(cid:2)(cid:28)(cid:5)(cid:3)(cid:10)(cid:5)(cid:2)(cid:64)(cid:46)(cid:4)(cid:12)(cid:2)(cid:28)(cid:3,,15076.0
,,49,,,Unknown,,cid:50)(cid:46)(cid:12)(cid:2)(cid:7)(cid:8)(cid:10)(cid:5)(cid:3)(cid:48)(cid:46)(cid:3)(cid:12)(cid:13)(cid:5)(cid:2)(cid:14)(cid:46)(cid:2)(cid:28)(cid:5)(cid:3)(cid:10)(cid:5)(cid:2)(cid:64)(cid:46)(cid:4)(cid:12)(cid:2)(cid:28)(cid:3,,15125.0
,,2,,,Unknown,,cid:50)(cid:46)(cid:12)(cid:2)(cid:7)(cid:8)(cid:10)(cid:5)(cid:3)(cid:48)(cid:46)(cid:3)(cid:12)(cid:13)(cid:5)(cid:2)(cid:14)(cid:46)(cid:2)(cid:28)(cid:5)(cid:3)(cid:10)(cid:5)(cid:2)(cid:64)(cid:46)(cid:4)(cid:12)(cid:2)(cid:28)(cid:3,,15127.0
,,5,,,Unknown,,cid:50)(cid:46)(cid:12)(cid:2)(cid:7)(cid:8)(cid:10)(cid:5)(cid:3)(cid:48)(cid:46)(cid:3)(cid:12)(cid:13)(cid:5)(cid:2)(cid:14)(cid:46)(cid:2)(cid:28)(cid:5)(cid:3)(cid:10)(cid:5)(cid:2)(cid:64)(cid:46)(cid:4)(cid:12)(cid:2)(cid:28)(cid:3,,15132.0
,,8,,,Unknown,,cid:50)(cid:46)(cid:12)(cid:2)(cid:7)(cid:8)(cid:10)(cid:5)(cid:3)(cid:48)(cid:46)(cid:3)(cid:12)(cid:13)(cid:5)(cid:2)(cid:14)(cid:46)(cid:2)(cid:28)(cid:5)(cid:3)(cid:10)(cid:5)(cid:2)(cid:64)(cid:46)(cid:4)(cid:12)(cid:2)(cid:28)(cid:3,,15140.0
,,2,,,Unknown,,cid:50)(cid:46)(cid:12)(cid:2)(cid:7)(cid:8)(cid:10)(cid:5)(cid:3)(cid:48)(cid:46)(cid:3)(cid:12)(cid:13)(cid:5)(cid:2)(cid:14)(cid:46)(cid:2)(cid:28)(cid:5)(cid:3)(cid:10)(cid:5)(cid:2)(cid:64)(cid:46)(cid:4)(cid:12)(cid:2)(cid:28)(cid:3,,15142.0
,,47,,,Unknown,,cid:50)(cid:46)(cid:12)(cid:2)(cid:7)(cid:8)(cid:10)(cid:5)(cid:3)(cid:48)(cid:46)(cid:3)(cid:12)(cid:13)(cid:5)(cid:2)(cid:14)(cid:46)(cid:2)(cid:28)(cid:5)(cid:3)(cid:10)(cid:5)(cid:2)(cid:64)(cid:46)(cid:4)(cid:12)(cid:2)(cid:28)(cid:3,,15189.0
,,3,,,Unknown,,cid:50)(cid:46)(cid:12)(cid:2)(cid:7)(cid:8)(cid:10)(cid:5)(cid:3)(cid:48)(cid:46)(cid:3)(cid:12)(cid:13)(cid:5)(cid:2)(cid:14)(cid:46)(cid:2)(cid:28)(cid:5)(cid:3)(cid:10)(cid:5)(cid:2)(cid:64)(cid:46)(cid:4)(cid:12)(cid:2)(cid:28)(cid:3,,15192.0
,,7,,,Unknown,,cid:50)(cid:46)(cid:12)(cid:2)(cid:7)(cid:8)(cid:10)(cid:5)(cid:3)(cid:48)(cid:46)(cid:3)(cid:12)(cid:13)(cid:5)(cid:2)(cid:14)(cid:46)(cid:2)(cid:28)(cid:5)(cid:3)(cid:10)(cid:5)(cid:2)(cid:64)(cid:46)(cid:4)(cid:12)(cid:2)(cid:28)(cid:3,,15199.0
,,2,,,Unknown,,cid:50)(cid:46)(cid:12)(cid:2)(cid:7)(cid:8)(cid:10)(cid:5)(cid:3)(cid:48)(cid:46)(cid:3)(cid:12)(cid:13)(cid:5)(cid:2)(cid:14)(cid:46)(cid:2)(cid:28)(cid:5)(cid:3)(cid:10)(cid:5)(cid:2)(cid:64)(cid:46)(cid:4)(cid:12)(cid:2)(cid:28)(cid:3,,15201.0
,,28,,,Unknown,,cid:50)(cid:46)(cid:12)(cid:2)(cid:7)(cid:8)(cid:10)(cid:5)(cid:3)(cid:48)(cid:46)(cid:3)(cid:12)(cid:13)(cid:5)(cid:2)(cid:14)(cid:46)(cid:2)(cid:28)(cid:5)(cid:3)(cid:10)(cid:5)(cid:2)(cid:64)(cid:46)(cid:4)(cid:12)(cid:2)(cid:28)(cid:3,,15229.0
,,3,,,Unknown,,cid:50)(cid:46)(cid:12)(cid:2)(cid:7)(cid:8)(cid:10)(cid:5)(cid:3)(cid:48)(cid:46)(cid:3)(cid:12)(cid:13)(cid:5)(cid:2)(cid:14)(cid:46)(cid:2)(cid:28)(cid:5)(cid:3)(cid:10)(cid:5)(cid:2)(cid:64)(cid:46)(cid:4)(cid:12)(cid:2)(cid:28)(cid:3,,15232.0
,,15,,,Unknown,,cid:50)(cid:46)(cid:12)(cid:2)(cid:7)(cid:8)(cid:10)(cid:5)(cid:3)(cid:48)(cid:46)(cid:3)(cid:12)(cid:13)(cid:5)(cid:2)(cid:14)(cid:46)(cid:2)(cid:28)(cid:5)(cid:3)(cid:10)(cid:5)(cid:2)(cid:64)(cid:46)(cid:4)(cid:12)(cid:2)(cid:28)(cid:3,,15247.0
,,2,,,Unknown,,cid:50)(cid:46)(cid:12)(cid:2)(cid:7)(cid:8)(cid:10)(cid:5)(cid:3)(cid:48)(cid:46)(cid:3)(cid:12)(cid:13)(cid:5)(cid:2)(cid:14)(cid:46)(cid:2)(cid:28)(cid:5)(cid:3)(cid:10)(cid:5)(cid:2)(cid:64)(cid:46)(cid:4)(cid:12)(cid:2)(cid:28)(cid:3,,15249.0
,,37,,,Unknown,,cid:50)(cid:46)(cid:12)(cid:2)(cid:7)(cid:8)(cid:10)(cid:5)(cid:3)(cid:48)(cid:46)(cid:3)(cid:12)(cid:13)(cid:5)(cid:2)(cid:14)(cid:46)(cid:2)(cid:28)(cid:5)(cid:3)(cid:10)(cid:5)(cid:2)(cid:64)(cid:46)(cid:4)(cid:12)(cid:2)(cid:28)(cid:3,,15286.0
,,18,,,Unknown,,cid:50)(cid:46)(cid:12)(cid:2)(cid:7)(cid:8)(cid:10)(cid:5)(cid:3)(cid:48)(cid:46)(cid:3)(cid:12)(cid:13)(cid:5)(cid:2)(cid:14)(cid:46)(cid:2)(cid:28)(cid:5)(cid:3)(cid:10)(cid:5)(cid:2)(cid:64)(cid:46)(cid:4)(cid:12)(cid:2)(cid:28)(cid:3,,15304.0
,,19,,,Unknown,,cid:50)(cid:46)(cid:12)(cid:2)(cid:7)(cid:8)(cid:10)(cid:5)(cid:3)(cid:48)(cid:46)(cid:3)(cid:12)(cid:13)(cid:5)(cid:2)(cid:14)(cid:46)(cid:2)(cid:28)(cid:5)(cid:3)(cid:10)(cid:5)(cid:2)(cid:64)(cid:46)(cid:4)(cid:12)(cid:2)(cid:28)(cid:3,,15323.0
,,37,,,Unknown,,cid:50)(cid:46)(cid:12)(cid:2)(cid:7)(cid:8)(cid:10)(cid:5)(cid:3)(cid:48)(cid:46)(cid:3)(cid:12)(cid:13)(cid:5)(cid:2)(cid:14)(cid:46)(cid:2)(cid:28)(cid:5)(cid:3)(cid:10)(cid:5)(cid:2)(cid:64)(cid:46)(cid:4)(cid:12)(cid:2)(cid:28)(cid:3,,15360.0
,,33,,,Unknown,,cid:50)(cid:46)(cid:12)(cid:2)(cid:7)(cid:8)(cid:10)(cid:5)(cid:3)(cid:48)(cid:46)(cid:3)(cid:12)(cid:13)(cid:5)(cid:2)(cid:14)(cid:46)(cid:2)(cid:28)(cid:5)(cid:3)(cid:10)(cid:5)(cid:2)(cid:64)(cid:46)(cid:4)(cid:12)(cid:2)(cid:28)(cid:3,,15393.0
,,2,,,Unknown,,cid:50)(cid:46)(cid:12)(cid:2)(cid:7)(cid:8)(cid:10)(cid:5)(cid:3)(cid:48)(cid:46)(cid:3)(cid:12)(cid:13)(cid:5)(cid:2)(cid:14)(cid:46)(cid:2)(cid:28)(cid:5)(cid:3)(cid:10)(cid:5)(cid:2)(cid:64)(cid:46)(cid:4)(cid:12)(cid:2)(cid:28)(cid:3,,15395.0
,,44,,,Unknown,,cid:50)(cid:46)(cid:12)(cid:2)(cid:7)(cid:8)(cid:10)(cid:5)(cid:3)(cid:48)(cid:46)(cid:3)(cid:12)(cid:13)(cid:5)(cid:2)(cid:14)(cid:46)(cid:2)(cid:28)(cid:5)(cid:3)(cid:10)(cid:5)(cid:2)(cid:64)(cid:46)(cid:4)(cid:12)(cid:2)(cid:28)(cid:3,,15439.0
,,12,,,Unknown,,cid:50)(cid:46)(cid:12)(cid:2)(cid:7)(cid:8)(cid:10)(cid:5)(cid:3)(cid:48)(cid:46)(cid:3)(cid:12)(cid:13)(cid:5)(cid:2)(cid:14)(cid:46)(cid:2)(cid:28)(cid:5)(cid:3)(cid:10)(cid:5)(cid:2)(cid:64)(cid:46)(cid:4)(cid:12)(cid:2)(cid:28)(cid:3,,15451.0
,,29,,,Unknown,,cid:50)(cid:46)(cid:12)(cid:2)(cid:7)(cid:8)(cid:10)(cid:5)(cid:3)(cid:48)(cid:46)(cid:3)(cid:12)(cid:13)(cid:5)(cid:2)(cid:14)(cid:46)(cid:2)(cid:28)(cid:5)(cid:3)(cid:10)(cid:5)(cid:2)(cid:64)(cid:46)(cid:4)(cid:12)(cid:2)(cid:28)(cid:3,,15480.0
,,26,,,Unknown,,cid:50)(cid:46)(cid:12)(cid:2)(cid:7)(cid:8)(cid:10)(cid:5)(cid:3)(cid:48)(cid:46)(cid:3)(cid:12)(cid:13)(cid:5)(cid:2)(cid:14)(cid:46)(cid:2)(cid:28)(cid:5)(cid:3)(cid:10)(cid:5)(cid:2)(cid:64)(cid:46)(cid:4)(cid:12)(cid:2)(cid:28)(cid:3,,15506.0
,,41,,,Unknown,,cid:50)(cid:46)(cid:12)(cid:2)(cid:7)(cid:8)(cid:10)(cid:5)(cid:3)(cid:48)(cid:46)(cid:3)(cid:12)(cid:13)(cid:5)(cid:2)(cid:14)(cid:46)(cid:2)(cid:28)(cid:5)(cid:3)(cid:10)(cid:5)(cid:2)(cid:64)(cid:46)(cid:4)(cid:12)(cid:2)(cid:28)(cid:3,,15547.0
,,25,,,Unknown,,cid:50)(cid:46)(cid:12)(cid:2)(cid:7)(cid:8)(cid:10)(cid:5)(cid:3)(cid:48)(cid:46)(cid:3)(cid:12)(cid:13)(cid:5)(cid:2)(cid:14)(cid:46)(cid:2)(cid:28)(cid:5)(cid:3)(cid:10)(cid:5)(cid:2)(cid:64)(cid:46)(cid:4)(cid:12)(cid:2)(cid:28)(cid:3,,15572.0
,,2,,,Unknown,,cid:50)(cid:46)(cid:12)(cid:2)(cid:7)(cid:8)(cid:10)(cid:5)(cid:3)(cid:48)(cid:46)(cid:3)(cid:12)(cid:13)(cid:5)(cid:2)(cid:14)(cid:46)(cid:2)(cid:28)(cid:5)(cid:3)(cid:10)(cid:5)(cid:2)(cid:64)(cid:46)(cid:4)(cid:12)(cid:2)(cid:28)(cid:3,,15574.0
,,58,,,Unknown,,cid:50)(cid:46)(cid:12)(cid:2)(cid:7)(cid:8)(cid:10)(cid:5)(cid:3)(cid:48)(cid:46)(cid:3)(cid:12)(cid:13)(cid:5)(cid:2)(cid:14)(cid:46)(cid:2)(cid:28)(cid:5)(cid:3)(cid:10)(cid:5)(cid:2)(cid:64)(cid:46)(cid:4)(cid:12)(cid:2)(cid:28)(cid:3,,15632.0
,,58,,,Unknown,,cid:50)(cid:46)(cid:12)(cid:2)(cid:7)(cid:8)(cid:10)(cid:5)(cid:3)(cid:48)(cid:46)(cid:3)(cid:12)(cid:13)(cid:5)(cid:2)(cid:14)(cid:46)(cid:2)(cid:28)(cid:5)(cid:3)(cid:10)(cid:5)(cid:2)(cid:64)(cid:46)(cid:4)(cid:12)(cid:2)(cid:28)(cid:3,,15690.0
,,18,,,Unknown,,cid:50)(cid:46)(cid:12)(cid:2)(cid:7)(cid:8)(cid:10)(cid:5)(cid:3)(cid:48)(cid:46)(cid:3)(cid:12)(cid:13)(cid:5)(cid:2)(cid:14)(cid:46)(cid:2)(cid:28)(cid:5)(cid:3)(cid:10)(cid:5)(cid:2)(cid:64)(cid:46)(cid:4)(cid:12)(cid:2)(cid:28)(cid:3,,15708.0
,,1,,,Unknown,,cid:50)(cid:46)(cid:12)(cid:2)(cid:7)(cid:8)(cid:10)(cid:5)(cid:3)(cid:48)(cid:46)(cid:3)(cid:12)(cid:13)(cid:5)(cid:2)(cid:14)(cid:46)(cid:2)(cid:28)(cid:5)(cid:3)(cid:10)(cid:5)(cid:2)(cid:64)(cid:46)(cid:4)(cid:12)(cid:2)(cid:28)(cid:3,,15709.0
,,1,,,Unknown,,cid:50)(cid:46)(cid:12)(cid:2)(cid:7)(cid:8)(cid:10)(cid:5)(cid:3)(cid:48)(cid:46)(cid:3)(cid:12)(cid:13)(cid:5)(cid:2)(cid:14)(cid:46)(cid:2)(cid:28)(cid:5)(cid:3)(cid:10)(cid:5)(cid:2)(cid:64)(cid:46)(cid:4)(cid:12)(cid:2)(cid:28)(cid:3,,15710.0
,,37,,,Unknown,,cid:50)(cid:46)(cid:12)(cid:2)(cid:7)(cid:8)(cid:10)(cid:5)(cid:3)(cid:48)(cid:46)(cid:3)(cid:12)(cid:13)(cid:5)(cid:2)(cid:14)(cid:46)(cid:2)(cid:28)(cid:5)(cid:3)(cid:10)(cid:5)(cid:2)(cid:64)(cid:46)(cid:4)(cid:12)(cid:2)(cid:28)(cid:3,,15747.0
,,18,,,Unknown,,cid:50)(cid:46)(cid:12)(cid:2)(cid:7)(cid:8)(cid:10)(cid:5)(cid:3)(cid:48)(cid:46)(cid:3)(cid:12)(cid:13)(cid:5)(cid:2)(cid:14)(cid:46)(cid:2)(cid:28)(cid:5)(cid:3)(cid:10)(cid:5)(cid:2)(cid:64)(cid:46)(cid:4)(cid:12)(cid:2)(cid:28)(cid:3,,15765.0
,,35,,,Unknown,,cid:50)(cid:46)(cid:12)(cid:2)(cid:7)(cid:8)(cid:10)(cid:5)(cid:3)(cid:48)(cid:46)(cid:3)(cid:12)(cid:13)(cid:5)(cid:2)(cid:14)(cid:46)(cid:2)(cid:28)(cid:5)(cid:3)(cid:10)(cid:5)(cid:2)(cid:64)(cid:46)(cid:4)(cid:12)(cid:2)(cid:28)(cid:3,,15800.0
,,45,,,Unknown,,cid:50)(cid:46)(cid:12)(cid:2)(cid:7)(cid:8)(cid:10)(cid:5)(cid:3)(cid:48)(cid:46)(cid:3)(cid:12)(cid:13)(cid:5)(cid:2)(cid:14)(cid:46)(cid:2)(cid:28)(cid:5)(cid:3)(cid:10)(cid:5)(cid:2)(cid:64)(cid:46)(cid:4)(cid:12)(cid:2)(cid:28)(cid:3,,15845.0
,,18,,,Unknown,,cid:50)(cid:46)(cid:12)(cid:2)(cid:7)(cid:8)(cid:10)(cid:5)(cid:3)(cid:48)(cid:46)(cid:3)(cid:12)(cid:13)(cid:5)(cid:2)(cid:14)(cid:46)(cid:2)(cid:28)(cid:5)(cid:3)(cid:10)(cid:5)(cid:2)(cid:64)(cid:46)(cid:4)(cid:12)(cid:2)(cid:28)(cid:3,,15863.0
,,16,,,Unknown,,cid:50)(cid:46)(cid:12)(cid:2)(cid:7)(cid:8)(cid:10)(cid:5)(cid:3)(cid:48)(cid:46)(cid:3)(cid:12)(cid:13)(cid:5)(cid:2)(cid:14)(cid:46)(cid:2)(cid:28)(cid:5)(cid:3)(cid:10)(cid:5)(cid:2)(cid:64)(cid:46)(cid:4)(cid:12)(cid:2)(cid:28)(cid:3,,15879.0
,,9,,,Unknown,,cid:50)(cid:46)(cid:12)(cid:2)(cid:7)(cid:8)(cid:10)(cid:5)(cid:3)(cid:48)(cid:46)(cid:3)(cid:12)(cid:13)(cid:5)(cid:2)(cid:14)(cid:46)(cid:2)(cid:28)(cid:5)(cid:3)(cid:10)(cid:5)(cid:2)(cid:64)(cid:46)(cid:4)(cid:12)(cid:2)(cid:28)(cid:3,,15888.0
,,10,,,Unknown,,cid:50)(cid:46)(cid:12)(cid:2)(cid:7)(cid:8)(cid:10)(cid:5)(cid:3)(cid:48)(cid:46)(cid:3)(cid:12)(cid:13)(cid:5)(cid:2)(cid:14)(cid:46)(cid:2)(cid:28)(cid:5)(cid:3)(cid:10)(cid:5)(cid:2)(cid:64)(cid:46)(cid:4)(cid:12)(cid:2)(cid:28)(cid:3,,15898.0
,,46,,,Unknown,,cid:50)(cid:46)(cid:12)(cid:2)(cid:7)(cid:8)(cid:10)(cid:5)(cid:3)(cid:48)(cid:46)(cid:3)(cid:12)(cid:13)(cid:5)(cid:2)(cid:14)(cid:46)(cid:2)(cid:28)(cid:5)(cid:3)(cid:10)(cid:5)(cid:2)(cid:64)(cid:46)(cid:4)(cid:12)(cid:2)(cid:28)(cid:3,,15944.0
,,10,,,Unknown,,cid:50)(cid:46)(cid:12)(cid:2)(cid:7)(cid:8)(cid:10)(cid:5)(cid:3)(cid:48)(cid:46)(cid:3)(cid:12)(cid:13)(cid:5)(cid:2)(cid:14)(cid:46)(cid:2)(cid:28)(cid:5)(cid:3)(cid:10)(cid:5)(cid:2)(cid:64)(cid:46)(cid:4)(cid:12)(cid:2)(cid:28)(cid:3,,15954.0
,,7,,,Unknown,,cid:50)(cid:46)(cid:12)(cid:2)(cid:7)(cid:8)(cid:10)(cid:5)(cid:3)(cid:48)(cid:46)(cid:3)(cid:12)(cid:13)(cid:5)(cid:2)(cid:14)(cid:46)(cid:2)(cid:28)(cid:5)(cid:3)(cid:10)(cid:5)(cid:2)(cid:64)(cid:46)(cid:4)(cid:12)(cid:2)(cid:28)(cid:3,,15961.0
,,11,,,Unknown,,cid:50)(cid:46)(cid:12)(cid:2)(cid:7)(cid:8)(cid:10)(cid:5)(cid:3)(cid:48)(cid:46)(cid:3)(cid:12)(cid:13)(cid:5)(cid:2)(cid:14)(cid:46)(cid:2)(cid:28)(cid:5)(cid:3)(cid:10)(cid:5)(cid:2)(cid:64)(cid:46)(cid:4)(cid:12)(cid:2)(cid:28)(cid:3,,15972.0
,,8,,,Unknown,,cid:50)(cid:46)(cid:12)(cid:2)(cid:7)(cid:8)(cid:10)(cid:5)(cid:3)(cid:48)(cid:46)(cid:3)(cid:12)(cid:13)(cid:5)(cid:2)(cid:14)(cid:46)(cid:2)(cid:28)(cid:5)(cid:3)(cid:10)(cid:5)(cid:2)(cid:64)(cid:46)(cid:4)(cid:12)(cid:2)(cid:28)(cid:3,,15980.0
,,2,,,Unknown,,cid:50)(cid:46)(cid:12)(cid:2)(cid:7)(cid:8)(cid:10)(cid:5)(cid:3)(cid:48)(cid:46)(cid:3)(cid:12)(cid:13)(cid:5)(cid:2)(cid:14)(cid:46)(cid:2)(cid:28)(cid:5)(cid:3)(cid:10)(cid:5)(cid:2)(cid:64)(cid:46)(cid:4)(cid:12)(cid:2)(cid:28)(cid:3,,15982.0
,,46,,,Unknown,,cid:50)(cid:46)(cid:12)(cid:2)(cid:7)(cid:8)(cid:10)(cid:5)(cid:3)(cid:48)(cid:46)(cid:3)(cid:12)(cid:13)(cid:5)(cid:2)(cid:14)(cid:46)(cid:2)(cid:28)(cid:5)(cid:3)(cid:10)(cid:5)(cid:2)(cid:64)(cid:46)(cid:4)(cid:12)(cid:2)(cid:28)(cid:3,,16028.0
,,66,,,Unknown,,cid:50)(cid:46)(cid:12)(cid:2)(cid:7)(cid:8)(cid:10)(cid:5)(cid:3)(cid:48)(cid:46)(cid:3)(cid:12)(cid:13)(cid:5)(cid:2)(cid:14)(cid:46)(cid:2)(cid:28)(cid:5)(cid:3)(cid:10)(cid:5)(cid:2)(cid:64)(cid:46)(cid:4)(cid:12)(cid:2)(cid:28)(cid:3,,16094.0
,,7,,,Unknown,,cid:50)(cid:46)(cid:12)(cid:2)(cid:7)(cid:8)(cid:10)(cid:5)(cid:3)(cid:48)(cid:46)(cid:3)(cid:12)(cid:13)(cid:5)(cid:2)(cid:14)(cid:46)(cid:2)(cid:28)(cid:5)(cid:3)(cid:10)(cid:5)(cid:2)(cid:64)(cid:46)(cid:4)(cid:12)(cid:2)(cid:28)(cid:3,,16101.0
,,46,,,Unknown,,cid:50)(cid:46)(cid:12)(cid:2)(cid:7)(cid:8)(cid:10)(cid:5)(cid:3)(cid:48)(cid:46)(cid:3)(cid:12)(cid:13)(cid:5)(cid:2)(cid:14)(cid:46)(cid:2)(cid:28)(cid:5)(cid:3)(cid:10)(cid:5)(cid:2)(cid:64)(cid:46)(cid:4)(cid:12)(cid:2)(cid:28)(cid:3,,16147.0
,,2,,,Unknown,,cid:50)(cid:46)(cid:12)(cid:2)(cid:7)(cid:8)(cid:10)(cid:5)(cid:3)(cid:48)(cid:46)(cid:3)(cid:12)(cid:13)(cid:5)(cid:2)(cid:14)(cid:46)(cid:2)(cid:28)(cid:5)(cid:3)(cid:10)(cid:5)(cid:2)(cid:64)(cid:46)(cid:4)(cid:12)(cid:2)(cid:28)(cid:3,,16149.0
,,66,,,Unknown,,cid:50)(cid:46)(cid:12)(cid:2)(cid:7)(cid:8)(cid:10)(cid:5)(cid:3)(cid:48)(cid:46)(cid:3)(cid:12)(cid:13)(cid:5)(cid:2)(cid:14)(cid:46)(cid:2)(cid:28)(cid:5)(cid:3)(cid:10)(cid:5)(cid:2)(cid:64)(cid:46)(cid:4)(cid:12)(cid:2)(cid:28)(cid:3,,16215.0
,,46,,,Unknown,,cid:50)(cid:46)(cid:12)(cid:2)(cid:7)(cid:8)(cid:10)(cid:5)(cid:3)(cid:48)(cid:46)(cid:3)(cid:12)(cid:13)(cid:5)(cid:2)(cid:14)(cid:46)(cid:2)(cid:28)(cid:5)(cid:3)(cid:10)(cid:5)(cid:2)(cid:64)(cid:46)(cid:4)(cid:12)(cid:2)(cid:28)(cid:3,,16261.0
,,4,,,Unknown,,cid:50)(cid:46)(cid:12)(cid:2)(cid:7)(cid:8)(cid:10)(cid:5)(cid:3)(cid:48)(cid:46)(cid:3)(cid:12)(cid:13)(cid:5)(cid:2)(cid:14)(cid:46)(cid:2)(cid:28)(cid:5)(cid:3)(cid:10)(cid:5)(cid:2)(cid:64)(cid:46)(cid:4)(cid:12)(cid:2)(cid:28)(cid:3,,16265.0
,,50,,,Unknown,,cid:50)(cid:46)(cid:12)(cid:2)(cid:7)(cid:8)(cid:10)(cid:5)(cid:3)(cid:48)(cid:46)(cid:3)(cid:12)(cid:13)(cid:5)(cid:2)(cid:14)(cid:46)(cid:2)(cid:28)(cid:5)(cid:3)(cid:10)(cid:5)(cid:2)(cid:64)(cid:46)(cid:4)(cid:12)(cid:2)(cid:28)(cid:3,,16315.0
,,11,,,Unknown,,cid:50)(cid:46)(cid:12)(cid:2)(cid:7)(cid:8)(cid:10)(cid:5)(cid:3)(cid:48)(cid:46)(cid:3)(cid:12)(cid:13)(cid:5)(cid:2)(cid:14)(cid:46)(cid:2)(cid:28)(cid:5)(cid:3)(cid:10)(cid:5)(cid:2)(cid:64)(cid:46)(cid:4)(cid:12)(cid:2)(cid:28)(cid:3,,16326.0
,,49,,,Unknown,,cid:50)(cid:46)(cid:12)(cid:2)(cid:7)(cid:8)(cid:10)(cid:5)(cid:3)(cid:48)(cid:46)(cid:3)(cid:12)(cid:13)(cid:5)(cid:2)(cid:14)(cid:46)(cid:2)(cid:28)(cid:5)(cid:3)(cid:10)(cid:5)(cid:2)(cid:64)(cid:46)(cid:4)(cid:12)(cid:2)(cid:28)(cid:3,,16375.0
,,2,,,Unknown,,cid:50)(cid:46)(cid:12)(cid:2)(cid:7)(cid:8)(cid:10)(cid:5)(cid:3)(cid:48)(cid:46)(cid:3)(cid:12)(cid:13)(cid:5)(cid:2)(cid:14)(cid:46)(cid:2)(cid:28)(cid:5)(cid:3)(cid:10)(cid:5)(cid:2)(cid:64)(cid:46)(cid:4)(cid:12)(cid:2)(cid:28)(cid:3,,16377.0
,,5,,,Unknown,,cid:50)(cid:46)(cid:12)(cid:2)(cid:7)(cid:8)(cid:10)(cid:5)(cid:3)(cid:48)(cid:46)(cid:3)(cid:12)(cid:13)(cid:5)(cid:2)(cid:14)(cid:46)(cid:2)(cid:28)(cid:5)(cid:3)(cid:10)(cid:5)(cid:2)(cid:64)(cid:46)(cid:4)(cid:12)(cid:2)(cid:28)(cid:3,,16382.0
,,8,,,Unknown,,cid:50)(cid:46)(cid:12)(cid:2)(cid:7)(cid:8)(cid:10)(cid:5)(cid:3)(cid:48)(cid:46)(cid:3)(cid:12)(cid:13)(cid:5)(cid:2)(cid:14)(cid:46)(cid:2)(cid:28)(cid:5)(cid:3)(cid:10)(cid:5)(cid:2)(cid:64)(cid:46)(cid:4)(cid:12)(cid:2)(cid:28)(cid:3,,16390.0
,,2,,,Unknown,,cid:50)(cid:46)(cid:12)(cid:2)(cid:7)(cid:8)(cid:10)(cid:5)(cid:3)(cid:48)(cid:46)(cid:3)(cid:12)(cid:13)(cid:5)(cid:2)(cid:14)(cid:46)(cid:2)(cid:28)(cid:5)(cid:3)(cid:10)(cid:5)(cid:2)(cid:64)(cid:46)(cid:4)(cid:12)(cid:2)(cid:28)(cid:3,,16392.0
,,47,,,Unknown,,cid:50)(cid:46)(cid:12)(cid:2)(cid:7)(cid:8)(cid:10)(cid:5)(cid:3)(cid:48)(cid:46)(cid:3)(cid:12)(cid:13)(cid:5)(cid:2)(cid:14)(cid:46)(cid:2)(cid:28)(cid:5)(cid:3)(cid:10)(cid:5)(cid:2)(cid:64)(cid:46)(cid:4)(cid:12)(cid:2)(cid:28)(cid:3,,16439.0
,,3,,,Unknown,,cid:50)(cid:46)(cid:12)(cid:2)(cid:7)(cid:8)(cid:10)(cid:5)(cid:3)(cid:48)(cid:46)(cid:3)(cid:12)(cid:13)(cid:5)(cid:2)(cid:14)(cid:46)(cid:2)(cid:28)(cid:5)(cid:3)(cid:10)(cid:5)(cid:2)(cid:64)(cid:46)(cid:4)(cid:12)(cid:2)(cid:28)(cid:3,,16442.0
,,7,,,Unknown,,cid:50)(cid:46)(cid:12)(cid:2)(cid:7)(cid:8)(cid:10)(cid:5)(cid:3)(cid:48)(cid:46)(cid:3)(cid:12)(cid:13)(cid:5)(cid:2)(cid:14)(cid:46)(cid:2)(cid:28)(cid:5)(cid:3)(cid:10)(cid:5)(cid:2)(cid:64)(cid:46)(cid:4)(cid:12)(cid:2)(cid:28)(cid:3,,16449.0
,,2,,,Unknown,,cid:50)(cid:46)(cid:12)(cid:2)(cid:7)(cid:8)(cid:10)(cid:5)(cid:3)(cid:48)(cid:46)(cid:3)(cid:12)(cid:13)(cid:5)(cid:2)(cid:14)(cid:46)(cid:2)(cid:28)(cid:5)(cid:3)(cid:10)(cid:5)(cid:2)(cid:64)(cid:46)(cid:4)(cid:12)(cid:2)(cid:28)(cid:3,,16451.0
,,28,,,Unknown,,cid:50)(cid:46)(cid:12)(cid:2)(cid:7)(cid:8)(cid:10)(cid:5)(cid:3)(cid:48)(cid:46)(cid:3)(cid:12)(cid:13)(cid:5)(cid:2)(cid:14)(cid:46)(cid:2)(cid:28)(cid:5)(cid:3)(cid:10)(cid:5)(cid:2)(cid:64)(cid:46)(cid:4)(cid:12)(cid:2)(cid:28)(cid:3,,16479.0
,,3,,,Unknown,,cid:50)(cid:46)(cid:12)(cid:2)(cid:7)(cid:8)(cid:10)(cid:5)(cid:3)(cid:48)(cid:46)(cid:3)(cid:12)(cid:13)(cid:5)(cid:2)(cid:14)(cid:46)(cid:2)(cid:28)(cid:5)(cid:3)(cid:10)(cid:5)(cid:2)(cid:64)(cid:46)(cid:4)(cid:12)(cid:2)(cid:28)(cid:3,,16482.0
,,15,,,Unknown,,cid:50)(cid:46)(cid:12)(cid:2)(cid:7)(cid:8)(cid:10)(cid:5)(cid:3)(cid:48)(cid:46)(cid:3)(cid:12)(cid:13)(cid:5)(cid:2)(cid:14)(cid:46)(cid:2)(cid:28)(cid:5)(cid:3)(cid:10)(cid:5)(cid:2)(cid:64)(cid:46)(cid:4)(cid:12)(cid:2)(cid:28)(cid:3,,16497.0
,,2,,,Unknown,,cid:50)(cid:46)(cid:12)(cid:2)(cid:7)(cid:8)(cid:10)(cid:5)(cid:3)(cid:48)(cid:46)(cid:3)(cid:12)(cid:13)(cid:5)(cid:2)(cid:14)(cid:46)(cid:2)(cid:28)(cid:5)(cid:3)(cid:10)(cid:5)(cid:2)(cid:64)(cid:46)(cid:4)(cid:12)(cid:2)(cid:28)(cid:3,,16499.0
,,37,,,Unknown,,cid:50)(cid:46)(cid:12)(cid:2)(cid:7)(cid:8)(cid:10)(cid:5)(cid:3)(cid:48)(cid:46)(cid:3)(cid:12)(cid:13)(cid:5)(cid:2)(cid:14)(cid:46)(cid:2)(cid:28)(cid:5)(cid:3)(cid:10)(cid:5)(cid:2)(cid:64)(cid:46)(cid:4)(cid:12)(cid:2)(cid:28)(cid:3,,16536.0
,,18,,,Unknown,,cid:50)(cid:46)(cid:12)(cid:2)(cid:7)(cid:8)(cid:10)(cid:5)(cid:3)(cid:48)(cid:46)(cid:3)(cid:12)(cid:13)(cid:5)(cid:2)(cid:14)(cid:46)(cid:2)(cid:28)(cid:5)(cid:3)(cid:10)(cid:5)(cid:2)(cid:64)(cid:46)(cid:4)(cid:12)(cid:2)(cid:28)(cid:3,,16554.0
,,19,,,Unknown,,cid:50)(cid:46)(cid:12)(cid:2)(cid:7)(cid:8)(cid:10)(cid:5)(cid:3)(cid:48)(cid:46)(cid:3)(cid:12)(cid:13)(cid:5)(cid:2)(cid:14)(cid:46)(cid:2)(cid:28)(cid:5)(cid:3)(cid:10)(cid:5)(cid:2)(cid:64)(cid:46)(cid:4)(cid:12)(cid:2)(cid:28)(cid:3,,16573.0
,,18,,,Unknown,,cid:50)(cid:46)(cid:12)(cid:2)(cid:7)(cid:8)(cid:10)(cid:5)(cid:3)(cid:48)(cid:46)(cid:3)(cid:12)(cid:13)(cid:5)(cid:2)(cid:14)(cid:46)(cid:2)(cid:28)(cid:5)(cid:3)(cid:10)(cid:5)(cid:2)(cid:64)(cid:46)(cid:4)(cid:12)(cid:2)(cid:28)(cid:3,,16591.0
,,18,,,Unknown,,cid:50)(cid:46)(cid:12)(cid:2)(cid:7)(cid:8)(cid:10)(cid:5)(cid:3)(cid:48)(cid:46)(cid:3)(cid:12)(cid:13)(cid:5)(cid:2)(cid:14)(cid:46)(cid:2)(cid:28)(cid:5)(cid:3)(cid:10)(cid:5)(cid:2)(cid:64)(cid:46)(cid:4)(cid:12)(cid:2)(cid:28)(cid:3,,16609.0
,,2,,,Unknown,,cid:50)(cid:46)(cid:12)(cid:2)(cid:7)(cid:8)(cid:10)(cid:5)(cid:3)(cid:48)(cid:46)(cid:3)(cid:12)(cid:13)(cid:5)(cid:2)(cid:14)(cid:46)(cid:2)(cid:28)(cid:5)(cid:3)(cid:10)(cid:5)(cid:2)(cid:64)(cid:46)(cid:4)(cid:12)(cid:2)(cid:28)(cid:3,,16611.0
,,44,,,Unknown,,cid:50)(cid:46)(cid:12)(cid:2)(cid:7)(cid:8)(cid:10)(cid:5)(cid:3)(cid:48)(cid:46)(cid:3)(cid:12)(cid:13)(cid:5)(cid:2)(cid:14)(cid:46)(cid:2)(cid:28)(cid:5)(cid:3)(cid:10)(cid:5)(cid:2)(cid:64)(cid:46)(cid:4)(cid:12)(cid:2)(cid:28)(cid:3,,16655.0
,,12,,,Unknown,,cid:50)(cid:46)(cid:12)(cid:2)(cid:7)(cid:8)(cid:10)(cid:5)(cid:3)(cid:48)(cid:46)(cid:3)(cid:12)(cid:13)(cid:5)(cid:2)(cid:14)(cid:46)(cid:2)(cid:28)(cid:5)(cid:3)(cid:10)(cid:5)(cid:2)(cid:64)(cid:46)(cid:4)(cid:12)(cid:2)(cid:28)(cid:3,,16667.0
,,29,,,Unknown,,cid:50)(cid:46)(cid:12)(cid:2)(cid:7)(cid:8)(cid:10)(cid:5)(cid:3)(cid:48)(cid:46)(cid:3)(cid:12)(cid:13)(cid:5)(cid:2)(cid:14)(cid:46)(cid:2)(cid:28)(cid:5)(cid:3)(cid:10)(cid:5)(cid:2)(cid:64)(cid:46)(cid:4)(cid:12)(cid:2)(cid:28)(cid:3,,16696.0
,,26,,,Unknown,,cid:50)(cid:46)(cid:12)(cid:2)(cid:7)(cid:8)(cid:10)(cid:5)(cid:3)(cid:48)(cid:46)(cid:3)(cid:12)(cid:13)(cid:5)(cid:2)(cid:14)(cid:46)(cid:2)(cid:28)(cid:5)(cid:3)(cid:10)(cid:5)(cid:2)(cid:64)(cid:46)(cid:4)(cid:12)(cid:2)(cid:28)(cid:3,,16722.0
,,41,,,Unknown,,cid:50)(cid:46)(cid:12)(cid:2)(cid:7)(cid:8)(cid:10)(cid:5)(cid:3)(cid:48)(cid:46)(cid:3)(cid:12)(cid:13)(cid:5)(cid:2)(cid:14)(cid:46)(cid:2)(cid:28)(cid:5)(cid:3)(cid:10)(cid:5)(cid:2)(cid:64)(cid:46)(cid:4)(cid:12)(cid:2)(cid:28)(cid:3,,16763.0
,,25,,,Unknown,,cid:50)(cid:46)(cid:12)(cid:2)(cid:7)(cid:8)(cid:10)(cid:5)(cid:3)(cid:48)(cid:46)(cid:3)(cid:12)(cid:13)(cid:5)(cid:2)(cid:14)(cid:46)(cid:2)(cid:28)(cid:5)(cid:3)(cid:10)(cid:5)(cid:2)(cid:64)(cid:46)(cid:4)(cid:12)(cid:2)(cid:28)(cid:3,,16788.0
,,2,,,Unknown,,cid:50)(cid:46)(cid:12)(cid:2)(cid:7)(cid:8)(cid:10)(cid:5)(cid:3)(cid:48)(cid:46)(cid:3)(cid:12)(cid:13)(cid:5)(cid:2)(cid:14)(cid:46)(cid:2)(cid:28)(cid:5)(cid:3)(cid:10)(cid:5)(cid:2)(cid:64)(cid:46)(cid:4)(cid:12)(cid:2)(cid:28)(cid:3,,16790.0
,,58,,,Unknown,,cid:50)(cid:46)(cid:12)(cid:2)(cid:7)(cid:8)(cid:10)(cid:5)(cid:3)(cid:48)(cid:46)(cid:3)(cid:12)(cid:13)(cid:5)(cid:2)(cid:14)(cid:46)(cid:2)(cid:28)(cid:5)(cid:3)(cid:10)(cid:5)(cid:2)(cid:64)(cid:46)(cid:4)(cid:12)(cid:2)(cid:28)(cid:3,,16848.0
,,58,,,Unknown,,cid:50)(cid:46)(cid:12)(cid:2)(cid:7)(cid:8)(cid:10)(cid:5)(cid:3)(cid:48)(cid:46)(cid:3)(cid:12)(cid:13)(cid:5)(cid:2)(cid:14)(cid:46)(cid:2)(cid:28)(cid:5)(cid:3)(cid:10)(cid:5)(cid:2)(cid:64)(cid:46)(cid:4)(cid:12)(cid:2)(cid:28)(cid:3,,16906.0
,,18,,,Unknown,,cid:50)(cid:46)(cid:12)(cid:2)(cid:7)(cid:8)(cid:10)(cid:5)(cid:3)(cid:48)(cid:46)(cid:3)(cid:12)(cid:13)(cid:5)(cid:2)(cid:14)(cid:46)(cid:2)(cid:28)(cid:5)(cid:3)(cid:10)(cid:5)(cid:2)(cid:64)(cid:46)(cid:4)(cid:12)(cid:2)(cid:28)(cid:3,,16924.0
,,1,,,Unknown,,cid:50)(cid:46)(cid:12)(cid:2)(cid:7)(cid:8)(cid:10)(cid:5)(cid:3)(cid:48)(cid:46)(cid:3)(cid:12)(cid:13)(cid:5)(cid:2)(cid:14)(cid:46)(cid:2)(cid:28)(cid:5)(cid:3)(cid:10)(cid:5)(cid:2)(cid:64)(cid:46)(cid:4)(cid:12)(cid:2)(cid:28)(cid:3,,16925.0
,,1,,,Unknown,,cid:50)(cid:46)(cid:12)(cid:2)(cid:7)(cid:8)(cid:10)(cid:5)(cid:3)(cid:48)(cid:46)(cid:3)(cid:12)(cid:13)(cid:5)(cid:2)(cid:14)(cid:46)(cid:2)(cid:28)(cid:5)(cid:3)(cid:10)(cid:5)(cid:2)(cid:64)(cid:46)(cid:4)(cid:12)(cid:2)(cid:28)(cid:3,,16926.0
,,37,,,Unknown,,cid:50)(cid:46)(cid:12)(cid:2)(cid:7)(cid:8)(cid:10)(cid:5)(cid:3)(cid:48)(cid:46)(cid:3)(cid:12)(cid:13)(cid:5)(cid:2)(cid:14)(cid:46)(cid:2)(cid:28)(cid:5)(cid:3)(cid:10)(cid:5)(cid:2)(cid:64)(cid:46)(cid:4)(cid:12)(cid:2)(cid:28)(cid:3,,16963.0
,,18,,,Unknown,,cid:50)(cid:46)(cid:12)(cid:2)(cid:7)(cid:8)(cid:10)(cid:5)(cid:3)(cid:48)(cid:46)(cid:3)(cid:12)(cid:13)(cid:5)(cid:2)(cid:14)(cid:46)(cid:2)(cid:28)(cid:5)(cid:3)(cid:10)(cid:5)(cid:2)(cid:64)(cid:46)(cid:4)(cid:12)(cid:2)(cid:28)(cid:3,,16981.0
,,33,,,Unknown,,cid:50)(cid:46)(cid:12)(cid:2)(cid:7)(cid:8)(cid:10)(cid:5)(cid:3)(cid:48)(cid:46)(cid:3)(cid:12)(cid:13)(cid:5)(cid:2)(cid:14)(cid:46)(cid:2)(cid:28)(cid:5)(cid:3)(cid:10)(cid:5)(cid:2)(cid:64)(cid:46)(cid:4)(cid:12)(cid:2)(cid:28)(cid:3,,17014.0
,,45,,,Unknown,,cid:50)(cid:46)(cid:12)(cid:2)(cid:7)(cid:8)(cid:10)(cid:5)(cid:3)(cid:48)(cid:46)(cid:3)(cid:12)(cid:13)(cid:5)(cid:2)(cid:14)(cid:46)(cid:2)(cid:28)(cid:5)(cid:3)(cid:10)(cid:5)(cid:2)(cid:64)(cid:46)(cid:4)(cid:12)(cid:2)(cid:28)(cid:3,,17059.0
,,18,,,Unknown,,cid:50)(cid:46)(cid:12)(cid:2)(cid:7)(cid:8)(cid:10)(cid:5)(cid:3)(cid:48)(cid:46)(cid:3)(cid:12)(cid:13)(cid:5)(cid:2)(cid:14)(cid:46)(cid:2)(cid:28)(cid:5)(cid:3)(cid:10)(cid:5)(cid:2)(cid:64)(cid:46)(cid:4)(cid:12)(cid:2)(cid:28)(cid:3,,17077.0
,,16,,,Unknown,,cid:50)(cid:46)(cid:12)(cid:2)(cid:7)(cid:8)(cid:10)(cid:5)(cid:3)(cid:48)(cid:46)(cid:3)(cid:12)(cid:13)(cid:5)(cid:2)(cid:14)(cid:46)(cid:2)(cid:28)(cid:5)(cid:3)(cid:10)(cid:5)(cid:2)(cid:64)(cid:46)(cid:4)(cid:12)(cid:2)(cid:28)(cid:3,,17093.0
,,64,,,Unknown,,cid:50)(cid:46)(cid:12)(cid:2)(cid:7)(cid:8)(cid:10)(cid:5)(cid:3)(cid:48)(cid:46)(cid:3)(cid:12)(cid:13)(cid:5)(cid:2)(cid:14)(cid:46)(cid:2)(cid:28)(cid:5)(cid:3)(cid:10)(cid:5)(cid:2)(cid:64)(cid:46)(cid:4)(cid:12)(cid:2)(cid:28)(cid:3,,17157.0
,,3,,,Unknown,,cid:50)(cid:46)(cid:12)(cid:2)(cid:7)(cid:8)(cid:10)(cid:5)(cid:3)(cid:48)(cid:46)(cid:3)(cid:12)(cid:13)(cid:5)(cid:2)(cid:14)(cid:46)(cid:2)(cid:28)(cid:5)(cid:3)(cid:10)(cid:5)(cid:2)(cid:64)(cid:46)(cid:4)(cid:12)(cid:2)(cid:28)(cid:3,,17160.0
,,11,,,Unknown,,cid:50)(cid:46)(cid:12)(cid:2)(cid:7)(cid:8)(cid:10)(cid:5)(cid:3)(cid:48)(cid:46)(cid:3)(cid:12)(cid:13)(cid:5)(cid:2)(cid:14)(cid:46)(cid:2)(cid:28)(cid:5)(cid:3)(cid:10)(cid:5)(cid:2)(cid:64)(cid:46)(cid:4)(cid:12)(cid:2)(cid:28)(cid:3,,17171.0
,,4,,,Unknown,,cid:50)(cid:46)(cid:12)(cid:2)(cid:7)(cid:8)(cid:10)(cid:5)(cid:3)(cid:48)(cid:46)(cid:3)(cid:12)(cid:13)(cid:5)(cid:2)(cid:14)(cid:46)(cid:2)(cid:28)(cid:5)(cid:3)(cid:10)(cid:5)(cid:2)(cid:64)(cid:46)(cid:4)(cid:12)(cid:2)(cid:28)(cid:3,,17175.0
,,39,,,Unknown,,cid:50)(cid:46)(cid:12)(cid:2)(cid:7)(cid:8)(cid:10)(cid:5)(cid:3)(cid:48)(cid:46)(cid:3)(cid:12)(cid:13)(cid:5)(cid:2)(cid:14)(cid:46)(cid:2)(cid:28)(cid:5)(cid:3)(cid:10)(cid:5)(cid:2)(cid:64)(cid:46)(cid:4)(cid:12)(cid:2)(cid:28)(cid:3,,17214.0
,,46,,,Unknown,,cid:50)(cid:46)(cid:12)(cid:2)(cid:7)(cid:8)(cid:10)(cid:5)(cid:3)(cid:48)(cid:46)(cid:3)(cid:12)(cid:13)(cid:5)(cid:2)(cid:14)(cid:46)(cid:2)(cid:28)(cid:5)(cid:3)(cid:10)(cid:5)(cid:2)(cid:64)(cid:46)(cid:4)(cid:12)(cid:2)(cid:28)(cid:3,,17260.0
,,48,,,Unknown,,cid:50)(cid:46)(cid:12)(cid:2)(cid:7)(cid:8)(cid:10)(cid:5)(cid:3)(cid:48)(cid:46)(cid:3)(cid:12)(cid:13)(cid:5)(cid:2)(cid:14)(cid:46)(cid:2)(cid:28)(cid:5)(cid:3)(cid:10)(cid:5)(cid:2)(cid:64)(cid:46)(cid:4)(cid:12)(cid:2)(cid:28)(cid:3,,17308.0
,,46,,,Unknown,,cid:50)(cid:46)(cid:12)(cid:2)(cid:7)(cid:8)(cid:10)(cid:5)(cid:3)(cid:48)(cid:46)(cid:3)(cid:12)(cid:13)(cid:5)(cid:2)(cid:14)(cid:46)(cid:2)(cid:28)(cid:5)(cid:3)(cid:10)(cid:5)(cid:2)(cid:64)(cid:46)(cid:4)(cid:12)(cid:2)(cid:28)(cid:3,,17354.0
,,2,,,Unknown,,cid:50)(cid:46)(cid:12)(cid:2)(cid:7)(cid:8)(cid:10)(cid:5)(cid:3)(cid:48)(cid:46)(cid:3)(cid:12)(cid:13)(cid:5)(cid:2)(cid:14)(cid:46)(cid:2)(cid:28)(cid:5)(cid:3)(cid:10)(cid:5)(cid:2)(cid:64)(cid:46)(cid:4)(cid:12)(cid:2)(cid:28)(cid:3,,17356.0
,,36,,,Unknown,,cid:50)(cid:46)(cid:12)(cid:2)(cid:7)(cid:8)(cid:10)(cid:5)(cid:3)(cid:48)(cid:46)(cid:3)(cid:12)(cid:13)(cid:5)(cid:2)(cid:14)(cid:46)(cid:2)(cid:28)(cid:5)(cid:3)(cid:10)(cid:5)(cid:2)(cid:64)(cid:46)(cid:4)(cid:12)(cid:2)(cid:28)(cid:3,,17392.0
,,18,,,Unknown,,cid:50)(cid:46)(cid:12)(cid:2)(cid:7)(cid:8)(cid:10)(cid:5)(cid:3)(cid:48)(cid:46)(cid:3)(cid:12)(cid:13)(cid:5)(cid:2)(cid:14)(cid:46)(cid:2)(cid:28)(cid:5)(cid:3)(cid:10)(cid:5)(cid:2)(cid:64)(cid:46)(cid:4)(cid:12)(cid:2)(cid:28)(cid:3,,17410.0
,,17,,,Unknown,,cid:50)(cid:46)(cid:12)(cid:2)(cid:7)(cid:8)(cid:10)(cid:5)(cid:3)(cid:48)(cid:46)(cid:3)(cid:12)(cid:13)(cid:5)(cid:2)(cid:14)(cid:46)(cid:2)(cid:28)(cid:5)(cid:3)(cid:10)(cid:5)(cid:2)(cid:64)(cid:46)(cid:4)(cid:12)(cid:2)(cid:28)(cid:3,,17427.0
,,37,,,Unknown,,cid:50)(cid:46)(cid:12)(cid:2)(cid:7)(cid:8)(cid:10)(cid:5)(cid:3)(cid:48)(cid:46)(cid:3)(cid:12)(cid:13)(cid:5)(cid:2)(cid:14)(cid:46)(cid:2)(cid:28)(cid:5)(cid:3)(cid:10)(cid:5)(cid:2)(cid:64)(cid:46)(cid:4)(cid:12)(cid:2)(cid:28)(cid:3,,17464.0
,,16,,,Unknown,,cid:50)(cid:46)(cid:12)(cid:2)(cid:7)(cid:8)(cid:10)(cid:5)(cid:3)(cid:48)(cid:46)(cid:3)(cid:12)(cid:13)(cid:5)(cid:2)(cid:14)(cid:46)(cid:2)(cid:28)(cid:5)(cid:3)(cid:10)(cid:5)(cid:2)(cid:64)(cid:46)(cid:4)(cid:12)(cid:2)(cid:28)(cid:3,,17480.0
,,36,,,Unknown,,cid:50)(cid:46)(cid:12)(cid:2)(cid:7)(cid:8)(cid:10)(cid:5)(cid:3)(cid:48)(cid:46)(cid:3)(cid:12)(cid:13)(cid:5)(cid:2)(cid:14)(cid:46)(cid:2)(cid:28)(cid:5)(cid:3)(cid:10)(cid:5)(cid:2)(cid:64)(cid:46)(cid:4)(cid:12)(cid:2)(cid:28)(cid:3,,17516.0
,,15,,,Unknown,,cid:50)(cid:46)(cid:12)(cid:2)(cid:7)(cid:8)(cid:10)(cid:5)(cid:3)(cid:48)(cid:46)(cid:3)(cid:12)(cid:13)(cid:5)(cid:2)(cid:14)(cid:46)(cid:2)(cid:28)(cid:5)(cid:3)(cid:10)(cid:5)(cid:2)(cid:64)(cid:46)(cid:4)(cid:12)(cid:2)(cid:28)(cid:3,,17531.0
,,2,,,Unknown,,cid:50)(cid:46)(cid:12)(cid:2)(cid:7)(cid:8)(cid:10)(cid:5)(cid:3)(cid:48)(cid:46)(cid:3)(cid:12)(cid:13)(cid:5)(cid:2)(cid:14)(cid:46)(cid:2)(cid:28)(cid:5)(cid:3)(cid:10)(cid:5)(cid:2)(cid:64)(cid:46)(cid:4)(cid:12)(cid:2)(cid:28)(cid:3,,17533.0
,,1,,,Unknown,,cid:50)(cid:46)(cid:12)(cid:2)(cid:7)(cid:8)(cid:10)(cid:5)(cid:3)(cid:48)(cid:46)(cid:3)(cid:12)(cid:13)(cid:5)(cid:2)(cid:14)(cid:46)(cid:2)(cid:28)(cid:5)(cid:3)(cid:10)(cid:5)(cid:2)(cid:64)(cid:46)(cid:4)(cid:12)(cid:2)(cid:28)(cid:3,,17534.0
,,33,,,Unknown,,cid:50)(cid:46)(cid:12)(cid:2)(cid:7)(cid:8)(cid:10)(cid:5)(cid:3)(cid:48)(cid:46)(cid:3)(cid:12)(cid:13)(cid:5)(cid:2)(cid:14)(cid:46)(cid:2)(cid:28)(cid:5)(cid:3)(cid:10)(cid:5)(cid:2)(cid:64)(cid:46)(cid:4)(cid:12)(cid:2)(cid:28)(cid:3,,17567.0
,,19,,,Unknown,,cid:50)(cid:46)(cid:12)(cid:2)(cid:7)(cid:8)(cid:10)(cid:5)(cid:3)(cid:48)(cid:46)(cid:3)(cid:12)(cid:13)(cid:5)(cid:2)(cid:14)(cid:46)(cid:2)(cid:28)(cid:5)(cid:3)(cid:10)(cid:5)(cid:2)(cid:64)(cid:46)(cid:4)(cid:12)(cid:2)(cid:28)(cid:3,,17586.0
,,33,,,Unknown,,cid:50)(cid:46)(cid:12)(cid:2)(cid:7)(cid:8)(cid:10)(cid:5)(cid:3)(cid:48)(cid:46)(cid:3)(cid:12)(cid:13)(cid:5)(cid:2)(cid:14)(cid:46)(cid:2)(cid:28)(cid:5)(cid:3)(cid:10)(cid:5)(cid:2)(cid:64)(cid:46)(cid:4)(cid:12)(cid:2)(cid:28)(cid:3,,17619.0
,,33,,,Unknown,,cid:50)(cid:46)(cid:12)(cid:2)(cid:7)(cid:8)(cid:10)(cid:5)(cid:3)(cid:48)(cid:46)(cid:3)(cid:12)(cid:13)(cid:5)(cid:2)(cid:14)(cid:46)(cid:2)(cid:28)(cid:5)(cid:3)(cid:10)(cid:5)(cid:2)(cid:64)(cid:46)(cid:4)(cid:12)(cid:2)(cid:28)(cid:3,,17652.0
,,2,,,Unknown,,cid:50)(cid:46)(cid:12)(cid:2)(cid:7)(cid:8)(cid:10)(cid:5)(cid:3)(cid:48)(cid:46)(cid:3)(cid:12)(cid:13)(cid:5)(cid:2)(cid:14)(cid:46)(cid:2)(cid:28)(cid:5)(cid:3)(cid:10)(cid:5)(cid:2)(cid:64)(cid:46)(cid:4)(cid:12)(cid:2)(cid:28)(cid:3,,17654.0
,,44,,,Unknown,,cid:50)(cid:46)(cid:12)(cid:2)(cid:7)(cid:8)(cid:10)(cid:5)(cid:3)(cid:48)(cid:46)(cid:3)(cid:12)(cid:13)(cid:5)(cid:2)(cid:14)(cid:46)(cid:2)(cid:28)(cid:5)(cid:3)(cid:10)(cid:5)(cid:2)(cid:64)(cid:46)(cid:4)(cid:12)(cid:2)(cid:28)(cid:3,,17698.0
,,39,,,Unknown,,cid:50)(cid:46)(cid:12)(cid:2)(cid:7)(cid:8)(cid:10)(cid:5)(cid:3)(cid:48)(cid:46)(cid:3)(cid:12)(cid:13)(cid:5)(cid:2)(cid:14)(cid:46)(cid:2)(cid:28)(cid:5)(cid:3)(cid:10)(cid:5)(cid:2)(cid:64)(cid:46)(cid:4)(cid:12)(cid:2)(cid:28)(cid:3,,17737.0
,,18,,,Unknown,,cid:50)(cid:46)(cid:12)(cid:2)(cid:7)(cid:8)(cid:10)(cid:5)(cid:3)(cid:48)(cid:46)(cid:3)(cid:12)(cid:13)(cid:5)(cid:2)(cid:14)(cid:46)(cid:2)(cid:28)(cid:5)(cid:3)(cid:10)(cid:5)(cid:2)(cid:64)(cid:46)(cid:4)(cid:12)(cid:2)(cid:28)(cid:3,,17755.0
,,16,,,Unknown,,cid:50)(cid:46)(cid:12)(cid:2)(cid:7)(cid:8)(cid:10)(cid:5)(cid:3)(cid:48)(cid:46)(cid:3)(cid:12)(cid:13)(cid:5)(cid:2)(cid:14)(cid:46)(cid:2)(cid:28)(cid:5)(cid:3)(cid:10)(cid:5)(cid:2)(cid:64)(cid:46)(cid:4)(cid:12)(cid:2)(cid:28)(cid:3,,17771.0
,,1,,,Unknown,,cid:50)(cid:46)(cid:12)(cid:2)(cid:7)(cid:8)(cid:10)(cid:5)(cid:3)(cid:48)(cid:46)(cid:3)(cid:12)(cid:13)(cid:5)(cid:2)(cid:14)(cid:46)(cid:2)(cid:28)(cid:5)(cid:3)(cid:10)(cid:5)(cid:2)(cid:64)(cid:46)(cid:4)(cid:12)(cid:2)(cid:28)(cid:3,,17772.0
,,32,,,Unknown,,cid:50)(cid:46)(cid:12)(cid:2)(cid:7)(cid:8)(cid:10)(cid:5)(cid:3)(cid:48)(cid:46)(cid:3)(cid:12)(cid:13)(cid:5)(cid:2)(cid:14)(cid:46)(cid:2)(cid:28)(cid:5)(cid:3)(cid:10)(cid:5)(cid:2)(cid:64)(cid:46)(cid:4)(cid:12)(cid:2)(cid:28)(cid:3,,17804.0
,,32,,,Unknown,,cid:50)(cid:46)(cid:12)(cid:2)(cid:7)(cid:8)(cid:10)(cid:5)(cid:3)(cid:48)(cid:46)(cid:3)(cid:12)(cid:13)(cid:5)(cid:2)(cid:14)(cid:46)(cid:2)(cid:28)(cid:5)(cid:3)(cid:10)(cid:5)(cid:2)(cid:64)(cid:46)(cid:4)(cid:12)(cid:2)(cid:28)(cid:3,,17836.0
,,1,,,Unknown,,cid:50)(cid:46)(cid:12)(cid:2)(cid:7)(cid:8)(cid:10)(cid:5)(cid:3)(cid:48)(cid:46)(cid:3)(cid:12)(cid:13)(cid:5)(cid:2)(cid:14)(cid:46)(cid:2)(cid:28)(cid:5)(cid:3)(cid:10)(cid:5)(cid:2)(cid:64)(cid:46)(cid:4)(cid:12)(cid:2)(cid:28)(cid:3,,17837.0
,,33,,,Unknown,,cid:50)(cid:46)(cid:12)(cid:2)(cid:7)(cid:8)(cid:10)(cid:5)(cid:3)(cid:48)(cid:46)(cid:3)(cid:12)(cid:13)(cid:5)(cid:2)(cid:14)(cid:46)(cid:2)(cid:28)(cid:5)(cid:3)(cid:10)(cid:5)(cid:2)(cid:64)(cid:46)(cid:4)(cid:12)(cid:2)(cid:28)(cid:3,,17870.0
,,32,,,Unknown,,cid:50)(cid:46)(cid:12)(cid:2)(cid:7)(cid:8)(cid:10)(cid:5)(cid:3)(cid:48)(cid:46)(cid:3)(cid:12)(cid:13)(cid:5)(cid:2)(cid:14)(cid:46)(cid:2)(cid:28)(cid:5)(cid:3)(cid:10)(cid:5)(cid:2)(cid:64)(cid:46)(cid:4)(cid:12)(cid:2)(cid:28)(cid:3,,17902.0
,,18,,,Unknown,,cid:50)(cid:46)(cid:12)(cid:2)(cid:7)(cid:8)(cid:10)(cid:5)(cid:3)(cid:48)(cid:46)(cid:3)(cid:12)(cid:13)(cid:5)(cid:2)(cid:14)(cid:46)(cid:2)(cid:28)(cid:5)(cid:3)(cid:10)(cid:5)(cid:2)(cid:64)(cid:46)(cid:4)(cid:12)(cid:2)(cid:28)(cid:3,,17920.0
,,2,,,Unknown,,cid:50)(cid:46)(cid:12)(cid:2)(cid:7)(cid:8)(cid:10)(cid:5)(cid:3)(cid:48)(cid:46)(cid:3)(cid:12)(cid:13)(cid:5)(cid:2)(cid:14)(cid:46)(cid:2)(cid:28)(cid:5)(cid:3)(cid:10)(cid:5)(cid:2)(cid:64)(cid:46)(cid:4)(cid:12)(cid:2)(cid:28)(cid:3,,17922.0
,,17,,,Unknown,,cid:50)(cid:46)(cid:12)(cid:2)(cid:7)(cid:8)(cid:10)(cid:5)(cid:3)(cid:48)(cid:46)(cid:3)(cid:12)(cid:13)(cid:5)(cid:2)(cid:14)(cid:46)(cid:2)(cid:28)(cid:5)(cid:3)(cid:10)(cid:5)(cid:2)(cid:64)(cid:46)(cid:4)(cid:12)(cid:2)(cid:28)(cid:3,,17939.0
,,35,,,Unknown,,cid:50)(cid:46)(cid:12)(cid:2)(cid:7)(cid:8)(cid:10)(cid:5)(cid:3)(cid:48)(cid:46)(cid:3)(cid:12)(cid:13)(cid:5)(cid:2)(cid:14)(cid:46)(cid:2)(cid:28)(cid:5)(cid:3)(cid:10)(cid:5)(cid:2)(cid:64)(cid:46)(cid:4)(cid:12)(cid:2)(cid:28)(cid:3,,17974.0
,,37,,,Unknown,,cid:50)(cid:46)(cid:12)(cid:2)(cid:7)(cid:8)(cid:10)(cid:5)(cid:3)(cid:48)(cid:46)(cid:3)(cid:12)(cid:13)(cid:5)(cid:2)(cid:14)(cid:46)(cid:2)(cid:28)(cid:5)(cid:3)(cid:10)(cid:5)(cid:2)(cid:64)(cid:46)(cid:4)(cid:12)(cid:2)(cid:28)(cid:3,,18011.0
,,36,,,Unknown,,cid:50)(cid:46)(cid:12)(cid:2)(cid:7)(cid:8)(cid:10)(cid:5)(cid:3)(cid:48)(cid:46)(cid:3)(cid:12)(cid:13)(cid:5)(cid:2)(cid:14)(cid:46)(cid:2)(cid:28)(cid:5)(cid:3)(cid:10)(cid:5)(cid:2)(cid:64)(cid:46)(cid:4)(cid:12)(cid:2)(cid:28)(cid:3,,18047.0
,,16,,,Unknown,,cid:50)(cid:46)(cid:12)(cid:2)(cid:7)(cid:8)(cid:10)(cid:5)(cid:3)(cid:48)(cid:46)(cid:3)(cid:12)(cid:13)(cid:5)(cid:2)(cid:14)(cid:46)(cid:2)(cid:28)(cid:5)(cid:3)(cid:10)(cid:5)(cid:2)(cid:64)(cid:46)(cid:4)(cid:12)(cid:2)(cid:28)(cid:3,,18063.0
,,36,,,Unknown,,cid:50)(cid:46)(cid:12)(cid:2)(cid:7)(cid:8)(cid:10)(cid:5)(cid:3)(cid:48)(cid:46)(cid:3)(cid:12)(cid:13)(cid:5)(cid:2)(cid:14)(cid:46)(cid:2)(cid:28)(cid:5)(cid:3)(cid:10)(cid:5)(cid:2)(cid:64)(cid:46)(cid:4)(cid:12)(cid:2)(cid:28)(cid:3,,18099.0
,,32,,,Unknown,,cid:50)(cid:46)(cid:12)(cid:2)(cid:7)(cid:8)(cid:10)(cid:5)(cid:3)(cid:48)(cid:46)(cid:3)(cid:12)(cid:13)(cid:5)(cid:2)(cid:14)(cid:46)(cid:2)(cid:28)(cid:5)(cid:3)(cid:10)(cid:5)(cid:2)(cid:64)(cid:46)(cid:4)(cid:12)(cid:2)(cid:28)(cid:3,,18131.0
,,18,,,Unknown,,cid:50)(cid:46)(cid:12)(cid:2)(cid:7)(cid:8)(cid:10)(cid:5)(cid:3)(cid:48)(cid:46)(cid:3)(cid:12)(cid:13)(cid:5)(cid:2)(cid:14)(cid:46)(cid:2)(cid:28)(cid:5)(cid:3)(cid:10)(cid:5)(cid:2)(cid:64)(cid:46)(cid:4)(cid:12)(cid:2)(cid:28)(cid:3,,18149.0
,,18,,,Unknown,,cid:50)(cid:46)(cid:12)(cid:2)(cid:7)(cid:8)(cid:10)(cid:5)(cid:3)(cid:48)(cid:46)(cid:3)(cid:12)(cid:13)(cid:5)(cid:2)(cid:14)(cid:46)(cid:2)(cid:28)(cid:5)(cid:3)(cid:10)(cid:5)(cid:2)(cid:64)(cid:46)(cid:4)(cid:12)(cid:2)(cid:28)(cid:3,,18167.0
,,18,,,Unknown,,cid:50)(cid:46)(cid:12)(cid:2)(cid:7)(cid:8)(cid:10)(cid:5)(cid:3)(cid:48)(cid:46)(cid:3)(cid:12)(cid:13)(cid:5)(cid:2)(cid:14)(cid:46)(cid:2)(cid:28)(cid:5)(cid:3)(cid:10)(cid:5)(cid:2)(cid:64)(cid:46)(cid:4)(cid:12)(cid:2)(cid:28)(cid:3,,18185.0
,,18,,,Unknown,,cid:50)(cid:46)(cid:12)(cid:2)(cid:7)(cid:8)(cid:10)(cid:5)(cid:3)(cid:48)(cid:46)(cid:3)(cid:12)(cid:13)(cid:5)(cid:2)(cid:14)(cid:46)(cid:2)(cid:28)(cid:5)(cid:3)(cid:10)(cid:5)(cid:2)(cid:64)(cid:46)(cid:4)(cid:12)(cid:2)(cid:28)(cid:3,,18203.0
,,18,,,Unknown,,cid:50)(cid:46)(cid:12)(cid:2)(cid:7)(cid:8)(cid:10)(cid:5)(cid:3)(cid:48)(cid:46)(cid:3)(cid:12)(cid:13)(cid:5)(cid:2)(cid:14)(cid:46)(cid:2)(cid:28)(cid:5)(cid:3)(cid:10)(cid:5)(cid:2)(cid:64)(cid:46)(cid:4)(cid:12)(cid:2)(cid:28)(cid:3,,18221.0
,,18,,,Unknown,,cid:50)(cid:46)(cid:12)(cid:2)(cid:7)(cid:8)(cid:10)(cid:5)(cid:3)(cid:48)(cid:46)(cid:3)(cid:12)(cid:13)(cid:5)(cid:2)(cid:14)(cid:46)(cid:2)(cid:28)(cid:5)(cid:3)(cid:10)(cid:5)(cid:2)(cid:64)(cid:46)(cid:4)(cid:12)(cid:2)(cid:28)(cid:3,,18239.0
,,37,,,Unknown,,cid:50)(cid:46)(cid:12)(cid:2)(cid:7)(cid:8)(cid:10)(cid:5)(cid:3)(cid:48)(cid:46)(cid:3)(cid:12)(cid:13)(cid:5)(cid:2)(cid:14)(cid:46)(cid:2)(cid:28)(cid:5)(cid:3)(cid:10)(cid:5)(cid:2)(cid:64)(cid:46)(cid:4)(cid:12)(cid:2)(cid:28)(cid:3,,18276.0
,,18,,,Unknown,,cid:50)(cid:46)(cid:12)(cid:2)(cid:7)(cid:8)(cid:10)(cid:5)(cid:3)(cid:48)(cid:46)(cid:3)(cid:12)(cid:13)(cid:5)(cid:2)(cid:14)(cid:46)(cid:2)(cid:28)(cid:5)(cid:3)(cid:10)(cid:5)(cid:2)(cid:64)(cid:46)(cid:4)(cid:12)(cid:2)(cid:28)(cid:3,,18294.0
,,33,,,Unknown,,cid:50)(cid:46)(cid:12)(cid:2)(cid:7)(cid:8)(cid:10)(cid:5)(cid:3)(cid:48)(cid:46)(cid:3)(cid:12)(cid:13)(cid:5)(cid:2)(cid:14)(cid:46)(cid:2)(cid:28)(cid:5)(cid:3)(cid:10)(cid:5)(cid:2)(cid:64)(cid:46)(cid:4)(cid:12)(cid:2)(cid:28)(cid:3,,18327.0
,,45,,,Unknown,,cid:50)(cid:46)(cid:12)(cid:2)(cid:7)(cid:8)(cid:10)(cid:5)(cid:3)(cid:48)(cid:46)(cid:3)(cid:12)(cid:13)(cid:5)(cid:2)(cid:14)(cid:46)(cid:2)(cid:28)(cid:5)(cid:3)(cid:10)(cid:5)(cid:2)(cid:64)(cid:46)(cid:4)(cid:12)(cid:2)(cid:28)(cid:3,,18372.0
,,18,,,Unknown,,cid:50)(cid:46)(cid:12)(cid:2)(cid:7)(cid:8)(cid:10)(cid:5)(cid:3)(cid:48)(cid:46)(cid:3)(cid:12)(cid:13)(cid:5)(cid:2)(cid:14)(cid:46)(cid:2)(cid:28)(cid:5)(cid:3)(cid:10)(cid:5)(cid:2)(cid:64)(cid:46)(cid:4)(cid:12)(cid:2)(cid:28)(cid:3,,18390.0
,,16,,,Unknown,,cid:50)(cid:46)(cid:12)(cid:2)(cid:7)(cid:8)(cid:10)(cid:5)(cid:3)(cid:48)(cid:46)(cid:3)(cid:12)(cid:13)(cid:5)(cid:2)(cid:14)(cid:46)(cid:2)(cid:28)(cid:5)(cid:3)(cid:10)(cid:5)(cid:2)(cid:64)(cid:46)(cid:4)(cid:12)(cid:2)(cid:28)(cid:3,,18406.0
,,14,,,Unknown,,cid:50)(cid:46)(cid:12)(cid:2)(cid:7)(cid:8)(cid:10)(cid:5)(cid:3)(cid:48)(cid:46)(cid:3)(cid:12)(cid:13)(cid:5)(cid:2)(cid:14)(cid:46)(cid:2)(cid:28)(cid:5)(cid:3)(cid:10)(cid:5)(cid:2)(cid:64)(cid:46)(cid:4)(cid:12)(cid:2)(cid:28)(cid:3,,18420.0
,,5,,,Unknown,,cid:50)(cid:46)(cid:12)(cid:2)(cid:7)(cid:8)(cid:10)(cid:5)(cid:3)(cid:48)(cid:46)(cid:3)(cid:12)(cid:13)(cid:5)(cid:2)(cid:14)(cid:46)(cid:2)(cid:28)(cid:5)(cid:3)(cid:10)(cid:5)(cid:2)(cid:64)(cid:46)(cid:4)(cid:12)(cid:2)(cid:28)(cid:3,,18425.0
,,12,,,Unknown,,cid:50)(cid:46)(cid:12)(cid:2)(cid:7)(cid:8)(cid:10)(cid:5)(cid:3)(cid:48)(cid:46)(cid:3)(cid:12)(cid:13)(cid:5)(cid:2)(cid:14)(cid:46)(cid:2)(cid:28)(cid:5)(cid:3)(cid:10)(cid:5)(cid:2)(cid:64)(cid:46)(cid:4)(cid:12)(cid:2)(cid:28)(cid:3,,18437.0
,,14,,,Unknown,,cid:50)(cid:46)(cid:12)(cid:2)(cid:7)(cid:8)(cid:10)(cid:5)(cid:3)(cid:48)(cid:46)(cid:3)(cid:12)(cid:13)(cid:5)(cid:2)(cid:14)(cid:46)(cid:2)(cid:28)(cid:5)(cid:3)(cid:10)(cid:5)(cid:2)(cid:64)(cid:46)(cid:4)(cid:12)(cid:2)(cid:28)(cid:3,,18451.0
,,5,,,Unknown,,cid:50)(cid:46)(cid:12)(cid:2)(cid:7)(cid:8)(cid:10)(cid:5)(cid:3)(cid:48)(cid:46)(cid:3)(cid:12)(cid:13)(cid:5)(cid:2)(cid:14)(cid:46)(cid:2)(cid:28)(cid:5)(cid:3)(cid:10)(cid:5)(cid:2)(cid:64)(cid:46)(cid:4)(cid:12)(cid:2)(cid:28)(cid:3,,18456.0
,,3,,,Unknown,,cid:50)(cid:46)(cid:12)(cid:2)(cid:7)(cid:8)(cid:10)(cid:5)(cid:3)(cid:48)(cid:46)(cid:3)(cid:12)(cid:13)(cid:5)(cid:2)(cid:14)(cid:46)(cid:2)(cid:28)(cid:5)(cid:3)(cid:10)(cid:5)(cid:2)(cid:64)(cid:46)(cid:4)(cid:12)(cid:2)(cid:28)(cid:3,,18459.0
,,12,,,Unknown,,cid:50)(cid:46)(cid:12)(cid:2)(cid:7)(cid:8)(cid:10)(cid:5)(cid:3)(cid:48)(cid:46)(cid:3)(cid:12)(cid:13)(cid:5)(cid:2)(cid:14)(cid:46)(cid:2)(cid:28)(cid:5)(cid:3)(cid:10)(cid:5)(cid:2)(cid:64)(cid:46)(cid:4)(cid:12)(cid:2)(cid:28)(cid:3,,18471.0
,,2,,,Unknown,,cid:50)(cid:46)(cid:12)(cid:2)(cid:7)(cid:8)(cid:10)(cid:5)(cid:3)(cid:48)(cid:46)(cid:3)(cid:12)(cid:13)(cid:5)(cid:2)(cid:14)(cid:46)(cid:2)(cid:28)(cid:5)(cid:3)(cid:10)(cid:5)(cid:2)(cid:64)(cid:46)(cid:4)(cid:12)(cid:2)(cid:28)(cid:3,,18473.0
,,12,,,Unknown,,cid:50)(cid:46)(cid:12)(cid:2)(cid:7)(cid:8)(cid:10)(cid:5)(cid:3)(cid:48)(cid:46)(cid:3)(cid:12)(cid:13)(cid:5)(cid:2)(cid:14)(cid:46)(cid:2)(cid:28)(cid:5)(cid:3)(cid:10)(cid:5)(cid:2)(cid:64)(cid:46)(cid:4)(cid:12)(cid:2)(cid:28)(cid:3,,18485.0
,,11,,,Unknown,,cid:50)(cid:46)(cid:12)(cid:2)(cid:7)(cid:8)(cid:10)(cid:5)(cid:3)(cid:48)(cid:46)(cid:3)(cid:12)(cid:13)(cid:5)(cid:2)(cid:14)(cid:46)(cid:2)(cid:28)(cid:5)(cid:3)(cid:10)(cid:5)(cid:2)(cid:64)(cid:46)(cid:4)(cid:12)(cid:2)(cid:28)(cid:3,,18496.0
,,4,,,Unknown,,cid:50)(cid:46)(cid:12)(cid:2)(cid:7)(cid:8)(cid:10)(cid:5)(cid:3)(cid:48)(cid:46)(cid:3)(cid:12)(cid:13)(cid:5)(cid:2)(cid:14)(cid:46)(cid:2)(cid:28)(cid:5)(cid:3)(cid:10)(cid:5)(cid:2)(cid:64)(cid:46)(cid:4)(cid:12)(cid:2)(cid:28)(cid:3,,18500.0
,,14,,,Unknown,,cid:50)(cid:46)(cid:12)(cid:2)(cid:7)(cid:8)(cid:10)(cid:5)(cid:3)(cid:48)(cid:46)(cid:3)(cid:12)(cid:13)(cid:5)(cid:2)(cid:14)(cid:46)(cid:2)(cid:28)(cid:5)(cid:3)(cid:10)(cid:5)(cid:2)(cid:64)(cid:46)(cid:4)(cid:12)(cid:2)(cid:28)(cid:3,,18514.0
,,11,,,Unknown,,cid:50)(cid:46)(cid:12)(cid:2)(cid:7)(cid:8)(cid:10)(cid:5)(cid:3)(cid:48)(cid:46)(cid:3)(cid:12)(cid:13)(cid:5)(cid:2)(cid:14)(cid:46)(cid:2)(cid:28)(cid:5)(cid:3)(cid:10)(cid:5)(cid:2)(cid:64)(cid:46)(cid:4)(cid:12)(cid:2)(cid:28)(cid:3,,18525.0
,,48,,,Unknown,,cid:50)(cid:46)(cid:12)(cid:2)(cid:7)(cid:8)(cid:10)(cid:5)(cid:3)(cid:48)(cid:46)(cid:3)(cid:12)(cid:13)(cid:5)(cid:2)(cid:14)(cid:46)(cid:2)(cid:28)(cid:5)(cid:3)(cid:10)(cid:5)(cid:2)(cid:64)(cid:46)(cid:4)(cid:12)(cid:2)(cid:28)(cid:3,,18573.0
,,48,,,Unknown,,cid:50)(cid:46)(cid:12)(cid:2)(cid:7)(cid:8)(cid:10)(cid:5)(cid:3)(cid:48)(cid:46)(cid:3)(cid:12)(cid:13)(cid:5)(cid:2)(cid:14)(cid:46)(cid:2)(cid:28)(cid:5)(cid:3)(cid:10)(cid:5)(cid:2)(cid:64)(cid:46)(cid:4)(cid:12)(cid:2)(cid:28)(cid:3,,18621.0
,,7,,,Unknown,,cid:50)(cid:46)(cid:12)(cid:2)(cid:7)(cid:8)(cid:10)(cid:5)(cid:3)(cid:48)(cid:46)(cid:3)(cid:12)(cid:13)(cid:5)(cid:2)(cid:14)(cid:46)(cid:2)(cid:28)(cid:5)(cid:3)(cid:10)(cid:5)(cid:2)(cid:64)(cid:46)(cid:4)(cid:12)(cid:2)(cid:28)(cid:3,,18628.0
,,5,,,Unknown,,cid:50)(cid:46)(cid:12)(cid:2)(cid:7)(cid:8)(cid:10)(cid:5)(cid:3)(cid:48)(cid:46)(cid:3)(cid:12)(cid:13)(cid:5)(cid:2)(cid:14)(cid:46)(cid:2)(cid:28)(cid:5)(cid:3)(cid:10)(cid:5)(cid:2)(cid:64)(cid:46)(cid:4)(cid:12)(cid:2)(cid:28)(cid:3,,18633.0
,,3,,,Unknown,,cid:50)(cid:46)(cid:12)(cid:2)(cid:7)(cid:8)(cid:10)(cid:5)(cid:3)(cid:48)(cid:46)(cid:3)(cid:12)(cid:13)(cid:5)(cid:2)(cid:14)(cid:46)(cid:2)(cid:28)(cid:5)(cid:3)(cid:10)(cid:5)(cid:2)(cid:64)(cid:46)(cid:4)(cid:12)(cid:2)(cid:28)(cid:3,,18636.0
,,2,,,Unknown,,cid:50)(cid:46)(cid:12)(cid:2)(cid:7)(cid:8)(cid:10)(cid:5)(cid:3)(cid:48)(cid:46)(cid:3)(cid:12)(cid:13)(cid:5)(cid:2)(cid:14)(cid:46)(cid:2)(cid:28)(cid:5)(cid:3)(cid:10)(cid:5)(cid:2)(cid:64)(cid:46)(cid:4)(cid:12)(cid:2)(cid:28)(cid:3,,18638.0
,,28,,,Unknown,,cid:50)(cid:46)(cid:12)(cid:2)(cid:7)(cid:8)(cid:10)(cid:5)(cid:3)(cid:48)(cid:46)(cid:3)(cid:12)(cid:13)(cid:5)(cid:2)(cid:14)(cid:46)(cid:2)(cid:28)(cid:5)(cid:3)(cid:10)(cid:5)(cid:2)(cid:64)(cid:46)(cid:4)(cid:12)(cid:2)(cid:28)(cid:3,,18666.0
,,3,,,Unknown,,cid:50)(cid:46)(cid:12)(cid:2)(cid:7)(cid:8)(cid:10)(cid:5)(cid:3)(cid:48)(cid:46)(cid:3)(cid:12)(cid:13)(cid:5)(cid:2)(cid:14)(cid:46)(cid:2)(cid:28)(cid:5)(cid:3)(cid:10)(cid:5)(cid:2)(cid:64)(cid:46)(cid:4)(cid:12)(cid:2)(cid:28)(cid:3,,18669.0
,,15,,,Unknown,,cid:50)(cid:46)(cid:12)(cid:2)(cid:7)(cid:8)(cid:10)(cid:5)(cid:3)(cid:48)(cid:46)(cid:3)(cid:12)(cid:13)(cid:5)(cid:2)(cid:14)(cid:46)(cid:2)(cid:28)(cid:5)(cid:3)(cid:10)(cid:5)(cid:2)(cid:64)(cid:46)(cid:4)(cid:12)(cid:2)(cid:28)(cid:3,,18684.0
,,2,,,Unknown,,cid:50)(cid:46)(cid:12)(cid:2)(cid:7)(cid:8)(cid:10)(cid:5)(cid:3)(cid:48)(cid:46)(cid:3)(cid:12)(cid:13)(cid:5)(cid:2)(cid:14)(cid:46)(cid:2)(cid:28)(cid:5)(cid:3)(cid:10)(cid:5)(cid:2)(cid:64)(cid:46)(cid:4)(cid:12)(cid:2)(cid:28)(cid:3,,18686.0
,,17,,,Unknown,,cid:50)(cid:46)(cid:12)(cid:2)(cid:7)(cid:8)(cid:10)(cid:5)(cid:3)(cid:48)(cid:46)(cid:3)(cid:12)(cid:13)(cid:5)(cid:2)(cid:14)(cid:46)(cid:2)(cid:28)(cid:5)(cid:3)(cid:10)(cid:5)(cid:2)(cid:64)(cid:46)(cid:4)(cid:12)(cid:2)(cid:28)(cid:3,,18703.0
,,33,,,Unknown,,cid:50)(cid:46)(cid:12)(cid:2)(cid:7)(cid:8)(cid:10)(cid:5)(cid:3)(cid:48)(cid:46)(cid:3)(cid:12)(cid:13)(cid:5)(cid:2)(cid:14)(cid:46)(cid:2)(cid:28)(cid:5)(cid:3)(cid:10)(cid:5)(cid:2)(cid:64)(cid:46)(cid:4)(cid:12)(cid:2)(cid:28)(cid:3,,18736.0
,,19,,,Unknown,,cid:50)(cid:46)(cid:12)(cid:2)(cid:7)(cid:8)(cid:10)(cid:5)(cid:3)(cid:48)(cid:46)(cid:3)(cid:12)(cid:13)(cid:5)(cid:2)(cid:14)(cid:46)(cid:2)(cid:28)(cid:5)(cid:3)(cid:10)(cid:5)(cid:2)(cid:64)(cid:46)(cid:4)(cid:12)(cid:2)(cid:28)(cid:3,,18755.0
,,17,,,Unknown,,cid:50)(cid:46)(cid:12)(cid:2)(cid:7)(cid:8)(cid:10)(cid:5)(cid:3)(cid:48)(cid:46)(cid:3)(cid:12)(cid:13)(cid:5)(cid:2)(cid:14)(cid:46)(cid:2)(cid:28)(cid:5)(cid:3)(cid:10)(cid:5)(cid:2)(cid:64)(cid:46)(cid:4)(cid:12)(cid:2)(cid:28)(cid:3,,18772.0
,,37,,,Unknown,,cid:50)(cid:46)(cid:12)(cid:2)(cid:7)(cid:8)(cid:10)(cid:5)(cid:3)(cid:48)(cid:46)(cid:3)(cid:12)(cid:13)(cid:5)(cid:2)(cid:14)(cid:46)(cid:2)(cid:28)(cid:5)(cid:3)(cid:10)(cid:5)(cid:2)(cid:64)(cid:46)(cid:4)(cid:12)(cid:2)(cid:28)(cid:3,,18809.0
,,2,,,Unknown,,cid:50)(cid:46)(cid:12)(cid:2)(cid:7)(cid:8)(cid:10)(cid:5)(cid:3)(cid:48)(cid:46)(cid:3)(cid:12)(cid:13)(cid:5)(cid:2)(cid:14)(cid:46)(cid:2)(cid:28)(cid:5)(cid:3)(cid:10)(cid:5)(cid:2)(cid:64)(cid:46)(cid:4)(cid:12)(cid:2)(cid:28)(cid:3,,18811.0
,,44,,,Unknown,,cid:50)(cid:46)(cid:12)(cid:2)(cid:7)(cid:8)(cid:10)(cid:5)(cid:3)(cid:48)(cid:46)(cid:3)(cid:12)(cid:13)(cid:5)(cid:2)(cid:14)(cid:46)(cid:2)(cid:28)(cid:5)(cid:3)(cid:10)(cid:5)(cid:2)(cid:64)(cid:46)(cid:4)(cid:12)(cid:2)(cid:28)(cid:3,,18855.0
,,12,,,Unknown,,cid:50)(cid:46)(cid:12)(cid:2)(cid:7)(cid:8)(cid:10)(cid:5)(cid:3)(cid:48)(cid:46)(cid:3)(cid:12)(cid:13)(cid:5)(cid:2)(cid:14)(cid:46)(cid:2)(cid:28)(cid:5)(cid:3)(cid:10)(cid:5)(cid:2)(cid:64)(cid:46)(cid:4)(cid:12)(cid:2)(cid:28)(cid:3,,18867.0
,,29,,,Unknown,,cid:50)(cid:46)(cid:12)(cid:2)(cid:7)(cid:8)(cid:10)(cid:5)(cid:3)(cid:48)(cid:46)(cid:3)(cid:12)(cid:13)(cid:5)(cid:2)(cid:14)(cid:46)(cid:2)(cid:28)(cid:5)(cid:3)(cid:10)(cid:5)(cid:2)(cid:64)(cid:46)(cid:4)(cid:12)(cid:2)(cid:28)(cid:3,,18896.0
,,26,,,Unknown,,cid:50)(cid:46)(cid:12)(cid:2)(cid:7)(cid:8)(cid:10)(cid:5)(cid:3)(cid:48)(cid:46)(cid:3)(cid:12)(cid:13)(cid:5)(cid:2)(cid:14)(cid:46)(cid:2)(cid:28)(cid:5)(cid:3)(cid:10)(cid:5)(cid:2)(cid:64)(cid:46)(cid:4)(cid:12)(cid:2)(cid:28)(cid:3,,18922.0
,,41,,,Unknown,,cid:50)(cid:46)(cid:12)(cid:2)(cid:7)(cid:8)(cid:10)(cid:5)(cid:3)(cid:48)(cid:46)(cid:3)(cid:12)(cid:13)(cid:5)(cid:2)(cid:14)(cid:46)(cid:2)(cid:28)(cid:5)(cid:3)(cid:10)(cid:5)(cid:2)(cid:64)(cid:46)(cid:4)(cid:12)(cid:2)(cid:28)(cid:3,,18963.0
,,25,,,Unknown,,cid:50)(cid:46)(cid:12)(cid:2)(cid:7)(cid:8)(cid:10)(cid:5)(cid:3)(cid:48)(cid:46)(cid:3)(cid:12)(cid:13)(cid:5)(cid:2)(cid:14)(cid:46)(cid:2)(cid:28)(cid:5)(cid:3)(cid:10)(cid:5)(cid:2)(cid:64)(cid:46)(cid:4)(cid:12)(cid:2)(cid:28)(cid:3,,18988.0
,,2,,,Unknown,,cid:50)(cid:46)(cid:12)(cid:2)(cid:7)(cid:8)(cid:10)(cid:5)(cid:3)(cid:48)(cid:46)(cid:3)(cid:12)(cid:13)(cid:5)(cid:2)(cid:14)(cid:46)(cid:2)(cid:28)(cid:5)(cid:3)(cid:10)(cid:5)(cid:2)(cid:64)(cid:46)(cid:4)(cid:12)(cid:2)(cid:28)(cid:3,,18990.0
,,58,,,Unknown,,cid:50)(cid:46)(cid:12)(cid:2)(cid:7)(cid:8)(cid:10)(cid:5)(cid:3)(cid:48)(cid:46)(cid:3)(cid:12)(cid:13)(cid:5)(cid:2)(cid:14)(cid:46)(cid:2)(cid:28)(cid:5)(cid:3)(cid:10)(cid:5)(cid:2)(cid:64)(cid:46)(cid:4)(cid:12)(cid:2)(cid:28)(cid:3,,19048.0
,,58,,,Unknown,,cid:50)(cid:46)(cid:12)(cid:2)(cid:7)(cid:8)(cid:10)(cid:5)(cid:3)(cid:48)(cid:46)(cid:3)(cid:12)(cid:13)(cid:5)(cid:2)(cid:14)(cid:46)(cid:2)(cid:28)(cid:5)(cid:3)(cid:10)(cid:5)(cid:2)(cid:64)(cid:46)(cid:4)(cid:12)(cid:2)(cid:28)(cid:3,,19106.0
,,37,,,Unknown,,cid:50)(cid:46)(cid:12)(cid:2)(cid:7)(cid:8)(cid:10)(cid:5)(cid:3)(cid:48)(cid:46)(cid:3)(cid:12)(cid:13)(cid:5)(cid:2)(cid:14)(cid:46)(cid:2)(cid:28)(cid:5)(cid:3)(cid:10)(cid:5)(cid:2)(cid:64)(cid:46)(cid:4)(cid:12)(cid:2)(cid:28)(cid:3,,19143.0
,,16,,,Unknown,,cid:50)(cid:46)(cid:12)(cid:2)(cid:7)(cid:8)(cid:10)(cid:5)(cid:3)(cid:48)(cid:46)(cid:3)(cid:12)(cid:13)(cid:5)(cid:2)(cid:14)(cid:46)(cid:2)(cid:28)(cid:5)(cid:3)(cid:10)(cid:5)(cid:2)(cid:64)(cid:46)(cid:4)(cid:12)(cid:2)(cid:28)(cid:3,,19159.0
,,34,,,Unknown,,cid:50)(cid:46)(cid:12)(cid:2)(cid:7)(cid:8)(cid:10)(cid:5)(cid:3)(cid:48)(cid:46)(cid:3)(cid:12)(cid:13)(cid:5)(cid:2)(cid:14)(cid:46)(cid:2)(cid:28)(cid:5)(cid:3)(cid:10)(cid:5)(cid:2)(cid:64)(cid:46)(cid:4)(cid:12)(cid:2)(cid:28)(cid:3,,19193.0
,,33,,,Unknown,,cid:50)(cid:46)(cid:12)(cid:2)(cid:7)(cid:8)(cid:10)(cid:5)(cid:3)(cid:48)(cid:46)(cid:3)(cid:12)(cid:13)(cid:5)(cid:2)(cid:14)(cid:46)(cid:2)(cid:28)(cid:5)(cid:3)(cid:10)(cid:5)(cid:2)(cid:64)(cid:46)(cid:4)(cid:12)(cid:2)(cid:28)(cid:3,,19226.0
,,18,,,Unknown,,cid:3)(cid:5)(cid:14)(cid:70)(cid:12)(cid:11)(cid:4)(cid:14)(cid:11)(cid:48)(cid:48)(cid:7)(cid:5)(cid:3)(cid:9)(cid:2)(cid:12)(cid:11)(cid:4)(cid:14)(cid:11)(cid:48)(cid:48)(cid:7)(cid:5)(cid:3)(cid:9)(cid:2)(cid:28)(cid:3,cid:17)(cid:17)(cid:45)(cid:18)(cid:16,18.0
,,33,,,Unknown,,cid:3)(cid:5)(cid:14)(cid:70)(cid:12)(cid:11)(cid:4)(cid:14)(cid:11)(cid:48)(cid:48)(cid:7)(cid:5)(cid:3)(cid:9)(cid:2)(cid:12)(cid:11)(cid:4)(cid:14)(cid:11)(cid:48)(cid:48)(cid:7)(cid:5)(cid:3)(cid:9)(cid:2)(cid:28)(cid:3,cid:15)(cid:2)(cid:35)(cid:19)(cid:1)(cid:1)(cid:2)(cid:44,51.0
,,45,,,Unknown,,cid:3)(cid:5)(cid:14)(cid:70)(cid:12)(cid:11)(cid:4)(cid:14)(cid:11)(cid:48)(cid:48)(cid:7)(cid:5)(cid:3)(cid:9)(cid:2)(cid:12)(cid:11)(cid:4)(cid:14)(cid:11)(cid:48)(cid:48)(cid:7)(cid:5)(cid:3)(cid:9)(cid:2)(cid:28)(cid:3,cid:10)(cid:46)(cid:47)(cid:46)(cid:12)(cid:2)(cid:50)(cid:5)(cid:9)(cid:2)(cid:10)(cid:5)(cid:48)(cid:2)(cid:12)(cid:11)(cid:4)(cid:14)(cid:11)(cid:48)(cid:48)(cid:7)(cid:5)(cid:3)(cid:2)(cid:28)(cid:3,96.0
,,18,,,Unknown,,cid:3)(cid:5)(cid:14)(cid:70)(cid:12)(cid:11)(cid:4)(cid:14)(cid:11)(cid:48)(cid:48)(cid:7)(cid:5)(cid:3)(cid:9)(cid:2)(cid:12)(cid:11)(cid:4)(cid:14)(cid:11)(cid:48)(cid:48)(cid:7)(cid:5)(cid:3)(cid:9)(cid:2)(cid:28)(cid:3,cid:17)(cid:34)(cid:45)(cid:18)(cid:16,114.0
,,16,,,Unknown,,cid:3)(cid:5)(cid:14)(cid:70)(cid:12)(cid:11)(cid:4)(cid:14)(cid:11)(cid:48)(cid:48)(cid:7)(cid:5)(cid:3)(cid:9)(cid:2)(cid:12)(cid:11)(cid:4)(cid:14)(cid:11)(cid:48)(cid:48)(cid:7)(cid:5)(cid:3)(cid:9)(cid:2)(cid:28)(cid:3,cid:17)(cid:34)(cid:45)(cid:18)(cid:16,130.0
,,48,,,Unknown,,cid:3)(cid:5)(cid:14)(cid:70)(cid:12)(cid:11)(cid:4)(cid:14)(cid:11)(cid:48)(cid:48)(cid:7)(cid:5)(cid:3)(cid:9)(cid:2)(cid:12)(cid:11)(cid:4)(cid:14)(cid:11)(cid:48)(cid:48)(cid:7)(cid:5)(cid:3)(cid:9)(cid:2)(cid:28)(cid:3,cid:9)(cid:46)(cid:8)(cid:5)(cid:28)(cid:2)(cid:46)(cid:4)(cid:10)(cid:11)(cid:3)(cid:11)(cid:4)(cid:10)(cid:5)(cid:2)(cid:9)(cid:5)(cid:8)(cid:14)(cid:7)(cid:9)(cid:2)(cid:12)(cid:5)(cid:50)(cid:5)(cid:40)(cid:2)(cid:28)(cid:3,178.0
,,12,,,Unknown,,cid:3)(cid:5)(cid:14)(cid:70)(cid:12)(cid:11)(cid:4)(cid:14)(cid:11)(cid:48)(cid:48)(cid:7)(cid:5)(cid:3)(cid:9)(cid:2)(cid:12)(cid:11)(cid:4)(cid:14)(cid:11)(cid:48)(cid:48)(cid:7)(cid:5)(cid:3)(cid:9)(cid:2)(cid:28)(cid:3,cid:9)(cid:46)(cid:8)(cid:5)(cid:28)(cid:2)(cid:46)(cid:4)(cid:10)(cid:11)(cid:3)(cid:11)(cid:4)(cid:10)(cid:5)(cid:2)(cid:9)(cid:5)(cid:8)(cid:14)(cid:7)(cid:9)(cid:2)(cid:12)(cid:5)(cid:50)(cid:5)(cid:40)(cid:2)(cid:28)(cid:3,190.0
,,2,,,Unknown,,cid:3)(cid:5)(cid:14)(cid:70)(cid:12)(cid:11)(cid:4)(cid:14)(cid:11)(cid:48)(cid:48)(cid:7)(cid:5)(cid:3)(cid:9)(cid:2)(cid:12)(cid:11)(cid:4)(cid:14)(cid:11)(cid:48)(cid:48)(cid:7)(cid:5)(cid:3)(cid:9)(cid:2)(cid:28)(cid:3,cid:48)(cid:12)(cid:50)(cid:11)(cid:8)(cid:46)(cid:14)(cid:50)(cid:9)(cid:17)(cid:36)(cid:18)(cid:1)(cid:2)(cid:12)(cid:11)(cid:4)(cid:7)(cid:14)(cid:14)(cid:49)(cid:2)(cid:46)(cid:4)(cid:2)(cid:28)(cid:3,192.0
,,50,,,Unknown,,cid:3)(cid:5)(cid:14)(cid:70)(cid:12)(cid:11)(cid:4)(cid:14)(cid:11)(cid:48)(cid:48)(cid:7)(cid:5)(cid:3)(cid:9)(cid:2)(cid:12)(cid:11)(cid:4)(cid:14)(cid:11)(cid:48)(cid:48)(cid:7)(cid:5)(cid:3)(cid:9)(cid:2)(cid:28)(cid:3,cid:9)(cid:46)(cid:8)(cid:5)(cid:28)(cid:2)(cid:9)(cid:5)(cid:8)(cid:14)(cid:7)(cid:9)(cid:2)(cid:28)(cid:3,242.0
,,11,,,Unknown,,cid:3)(cid:5)(cid:14)(cid:70)(cid:12)(cid:11)(cid:4)(cid:14)(cid:11)(cid:48)(cid:48)(cid:7)(cid:5)(cid:3)(cid:9)(cid:2)(cid:12)(cid:11)(cid:4)(cid:14)(cid:11)(cid:48)(cid:48)(cid:7)(cid:5)(cid:3)(cid:9)(cid:2)(cid:28)(cid:3,cid:9)(cid:46)(cid:8)(cid:5)(cid:28)(cid:2)(cid:46)(cid:4)(cid:10)(cid:11)(cid:3)(cid:11)(cid:4)(cid:10)(cid:5)(cid:2)(cid:9)(cid:5)(cid:8)(cid:14)(cid:7)(cid:9)(cid:2)(cid:12)(cid:5)(cid:50)(cid:5)(cid:40)(cid:2)(cid:28)(cid:3,253.0
,,8,,,Unknown,,cid:3)(cid:5)(cid:14)(cid:70)(cid:12)(cid:11)(cid:4)(cid:14)(cid:11)(cid:48)(cid:48)(cid:7)(cid:5)(cid:3)(cid:9)(cid:2)(cid:12)(cid:11)(cid:4)(cid:14)(cid:11)(cid:48)(cid:48)(cid:7)(cid:5)(cid:3)(cid:9)(cid:2)(cid:28)(cid:3,,261.0
,,46,,,Unknown,,cid:3)(cid:5)(cid:14)(cid:70)(cid:12)(cid:11)(cid:4)(cid:14)(cid:11)(cid:48)(cid:48)(cid:7)(cid:5)(cid:3)(cid:9)(cid:2)(cid:12)(cid:11)(cid:4)(cid:14)(cid:11)(cid:48)(cid:48)(cid:7)(cid:5)(cid:3)(cid:9)(cid:2)(cid:28)(cid:3,,307.0
,,14,,,Unknown,,cid:3)(cid:5)(cid:14)(cid:70)(cid:12)(cid:11)(cid:4)(cid:14)(cid:11)(cid:48)(cid:48)(cid:7)(cid:5)(cid:3)(cid:9)(cid:2)(cid:12)(cid:11)(cid:4)(cid:14)(cid:11)(cid:48)(cid:48)(cid:7)(cid:5)(cid:3)(cid:9)(cid:2)(cid:28)(cid:3,,321.0
,,50,,,Unknown,,cid:3)(cid:5)(cid:14)(cid:70)(cid:12)(cid:11)(cid:4)(cid:14)(cid:11)(cid:48)(cid:48)(cid:7)(cid:5)(cid:3)(cid:9)(cid:2)(cid:12)(cid:11)(cid:4)(cid:14)(cid:11)(cid:48)(cid:48)(cid:7)(cid:5)(cid:3)(cid:9)(cid:2)(cid:28)(cid:3,,371.0
,,69,,,Unknown,,cid:3)(cid:5)(cid:14)(cid:70)(cid:12)(cid:11)(cid:4)(cid:14)(cid:11)(cid:48)(cid:48)(cid:7)(cid:5)(cid:3)(cid:9)(cid:2)(cid:12)(cid:11)(cid:4)(cid:14)(cid:11)(cid:48)(cid:48)(cid:7)(cid:5)(cid:3)(cid:9)(cid:2)(cid:28)(cid:3,,440.0
,,9,,,Unknown,,cid:3)(cid:5)(cid:14)(cid:70)(cid:12)(cid:11)(cid:4)(cid:14)(cid:11)(cid:48)(cid:48)(cid:7)(cid:5)(cid:3)(cid:9)(cid:2)(cid:12)(cid:11)(cid:4)(cid:14)(cid:11)(cid:48)(cid:48)(cid:7)(cid:5)(cid:3)(cid:9)(cid:2)(cid:28)(cid:3,,449.0
,,2,,,Unknown,,cid:3)(cid:5)(cid:14)(cid:70)(cid:12)(cid:11)(cid:4)(cid:14)(cid:11)(cid:48)(cid:48)(cid:7)(cid:5)(cid:3)(cid:9)(cid:2)(cid:12)(cid:11)(cid:4)(cid:14)(cid:11)(cid:48)(cid:48)(cid:7)(cid:5)(cid:3)(cid:9)(cid:2)(cid:28)(cid:3,,451.0
,,12,,,Unknown,,cid:3)(cid:5)(cid:14)(cid:70)(cid:12)(cid:11)(cid:4)(cid:14)(cid:11)(cid:48)(cid:48)(cid:7)(cid:5)(cid:3)(cid:9)(cid:2)(cid:12)(cid:11)(cid:4)(cid:14)(cid:11)(cid:48)(cid:48)(cid:7)(cid:5)(cid:3)(cid:9)(cid:2)(cid:28)(cid:3,,463.0
,,11,,,Unknown,,cid:3)(cid:5)(cid:14)(cid:70)(cid:12)(cid:11)(cid:4)(cid:14)(cid:11)(cid:48)(cid:48)(cid:7)(cid:5)(cid:3)(cid:9)(cid:2)(cid:12)(cid:11)(cid:4)(cid:14)(cid:11)(cid:48)(cid:48)(cid:7)(cid:5)(cid:3)(cid:9)(cid:2)(cid:28)(cid:3,,474.0
,,4,,,Unknown,,cid:3)(cid:5)(cid:14)(cid:70)(cid:12)(cid:11)(cid:4)(cid:14)(cid:11)(cid:48)(cid:48)(cid:7)(cid:5)(cid:3)(cid:9)(cid:2)(cid:12)(cid:11)(cid:4)(cid:14)(cid:11)(cid:48)(cid:48)(cid:7)(cid:5)(cid:3)(cid:9)(cid:2)(cid:28)(cid:3,,478.0
,,14,,,Unknown,,cid:3)(cid:5)(cid:14)(cid:70)(cid:12)(cid:11)(cid:4)(cid:14)(cid:11)(cid:48)(cid:48)(cid:7)(cid:5)(cid:3)(cid:9)(cid:2)(cid:12)(cid:11)(cid:4)(cid:14)(cid:11)(cid:48)(cid:48)(cid:7)(cid:5)(cid:3)(cid:9)(cid:2)(cid:28)(cid:3,,492.0
,,11,,,Unknown,,cid:3)(cid:5)(cid:14)(cid:70)(cid:12)(cid:11)(cid:4)(cid:14)(cid:11)(cid:48)(cid:48)(cid:7)(cid:5)(cid:3)(cid:9)(cid:2)(cid:12)(cid:11)(cid:4)(cid:14)(cid:11)(cid:48)(cid:48)(cid:7)(cid:5)(cid:3)(cid:9)(cid:2)(cid:28)(cid:3,,503.0
,,48,,,Unknown,,cid:3)(cid:5)(cid:14)(cid:70)(cid:12)(cid:11)(cid:4)(cid:14)(cid:11)(cid:48)(cid:48)(cid:7)(cid:5)(cid:3)(cid:9)(cid:2)(cid:12)(cid:11)(cid:4)(cid:14)(cid:11)(cid:48)(cid:48)(cid:7)(cid:5)(cid:3)(cid:9)(cid:2)(cid:28)(cid:3,,551.0
,,48,,,Unknown,,cid:3)(cid:5)(cid:14)(cid:70)(cid:12)(cid:11)(cid:4)(cid:14)(cid:11)(cid:48)(cid:48)(cid:7)(cid:5)(cid:3)(cid:9)(cid:2)(cid:12)(cid:11)(cid:4)(cid:14)(cid:11)(cid:48)(cid:48)(cid:7)(cid:5)(cid:3)(cid:9)(cid:2)(cid:28)(cid:3,,599.0
,,7,,,Unknown,,cid:3)(cid:5)(cid:14)(cid:70)(cid:12)(cid:11)(cid:4)(cid:14)(cid:11)(cid:48)(cid:48)(cid:7)(cid:5)(cid:3)(cid:9)(cid:2)(cid:12)(cid:11)(cid:4)(cid:14)(cid:11)(cid:48)(cid:48)(cid:7)(cid:5)(cid:3)(cid:9)(cid:2)(cid:28)(cid:3,,606.0
,,5,,,Unknown,,cid:3)(cid:5)(cid:14)(cid:70)(cid:12)(cid:11)(cid:4)(cid:14)(cid:11)(cid:48)(cid:48)(cid:7)(cid:5)(cid:3)(cid:9)(cid:2)(cid:12)(cid:11)(cid:4)(cid:14)(cid:11)(cid:48)(cid:48)(cid:7)(cid:5)(cid:3)(cid:9)(cid:2)(cid:28)(cid:3,,611.0
,,3,,,Unknown,,cid:3)(cid:5)(cid:14)(cid:70)(cid:12)(cid:11)(cid:4)(cid:14)(cid:11)(cid:48)(cid:48)(cid:7)(cid:5)(cid:3)(cid:9)(cid:2)(cid:12)(cid:11)(cid:4)(cid:14)(cid:11)(cid:48)(cid:48)(cid:7)(cid:5)(cid:3)(cid:9)(cid:2)(cid:28)(cid:3,,614.0
,,2,,,Unknown,,cid:3)(cid:5)(cid:14)(cid:70)(cid:12)(cid:11)(cid:4)(cid:14)(cid:11)(cid:48)(cid:48)(cid:7)(cid:5)(cid:3)(cid:9)(cid:2)(cid:12)(cid:11)(cid:4)(cid:14)(cid:11)(cid:48)(cid:48)(cid:7)(cid:5)(cid:3)(cid:9)(cid:2)(cid:28)(cid:3,,616.0
,,28,,,Unknown,,cid:3)(cid:5)(cid:14)(cid:70)(cid:12)(cid:11)(cid:4)(cid:14)(cid:11)(cid:48)(cid:48)(cid:7)(cid:5)(cid:3)(cid:9)(cid:2)(cid:12)(cid:11)(cid:4)(cid:14)(cid:11)(cid:48)(cid:48)(cid:7)(cid:5)(cid:3)(cid:9)(cid:2)(cid:28)(cid:3,,644.0
,,3,,,Unknown,,cid:3)(cid:5)(cid:14)(cid:70)(cid:12)(cid:11)(cid:4)(cid:14)(cid:11)(cid:48)(cid:48)(cid:7)(cid:5)(cid:3)(cid:9)(cid:2)(cid:12)(cid:11)(cid:4)(cid:14)(cid:11)(cid:48)(cid:48)(cid:7)(cid:5)(cid:3)(cid:9)(cid:2)(cid:28)(cid:3,,647.0
,,15,,,Unknown,,cid:3)(cid:5)(cid:14)(cid:70)(cid:12)(cid:11)(cid:4)(cid:14)(cid:11)(cid:48)(cid:48)(cid:7)(cid:5)(cid:3)(cid:9)(cid:2)(cid:12)(cid:11)(cid:4)(cid:14)(cid:11)(cid:48)(cid:48)(cid:7)(cid:5)(cid:3)(cid:9)(cid:2)(cid:28)(cid:3,,662.0
,,2,,,Unknown,,cid:3)(cid:5)(cid:14)(cid:70)(cid:12)(cid:11)(cid:4)(cid:14)(cid:11)(cid:48)(cid:48)(cid:7)(cid:5)(cid:3)(cid:9)(cid:2)(cid:12)(cid:11)(cid:4)(cid:14)(cid:11)(cid:48)(cid:48)(cid:7)(cid:5)(cid:3)(cid:9)(cid:2)(cid:28)(cid:3,,664.0
,,32,,,Unknown,,cid:3)(cid:5)(cid:14)(cid:70)(cid:12)(cid:11)(cid:4)(cid:14)(cid:11)(cid:48)(cid:48)(cid:7)(cid:5)(cid:3)(cid:9)(cid:2)(cid:12)(cid:11)(cid:4)(cid:14)(cid:11)(cid:48)(cid:48)(cid:7)(cid:5)(cid:3)(cid:9)(cid:2)(cid:28)(cid:3,,696.0
,,18,,,Unknown,,cid:3)(cid:5)(cid:14)(cid:70)(cid:12)(cid:11)(cid:4)(cid:14)(cid:11)(cid:48)(cid:48)(cid:7)(cid:5)(cid:3)(cid:9)(cid:2)(cid:12)(cid:11)(cid:4)(cid:14)(cid:11)(cid:48)(cid:48)(cid:7)(cid:5)(cid:3)(cid:9)(cid:2)(cid:28)(cid:3,,714.0
,,19,,,Unknown,,cid:3)(cid:5)(cid:14)(cid:70)(cid:12)(cid:11)(cid:4)(cid:14)(cid:11)(cid:48)(cid:48)(cid:7)(cid:5)(cid:3)(cid:9)(cid:2)(cid:12)(cid:11)(cid:4)(cid:14)(cid:11)(cid:48)(cid:48)(cid:7)(cid:5)(cid:3)(cid:9)(cid:2)(cid:28)(cid:3,,733.0
,,17,,,Unknown,,cid:3)(cid:5)(cid:14)(cid:70)(cid:12)(cid:11)(cid:4)(cid:14)(cid:11)(cid:48)(cid:48)(cid:7)(cid:5)(cid:3)(cid:9)(cid:2)(cid:12)(cid:11)(cid:4)(cid:14)(cid:11)(cid:48)(cid:48)(cid:7)(cid:5)(cid:3)(cid:9)(cid:2)(cid:28)(cid:3,,750.0
,,34,,,Unknown,,cid:3)(cid:5)(cid:14)(cid:70)(cid:12)(cid:11)(cid:4)(cid:14)(cid:11)(cid:48)(cid:48)(cid:7)(cid:5)(cid:3)(cid:9)(cid:2)(cid:12)(cid:11)(cid:4)(cid:14)(cid:11)(cid:48)(cid:48)(cid:7)(cid:5)(cid:3)(cid:9)(cid:2)(cid:28)(cid:3,,784.0
,,2,,,Unknown,,cid:3)(cid:5)(cid:14)(cid:70)(cid:12)(cid:11)(cid:4)(cid:14)(cid:11)(cid:48)(cid:48)(cid:7)(cid:5)(cid:3)(cid:9)(cid:2)(cid:12)(cid:11)(cid:4)(cid:14)(cid:11)(cid:48)(cid:48)(cid:7)(cid:5)(cid:3)(cid:9)(cid:2)(cid:28)(cid:3,,786.0
,,44,,,Unknown,,cid:3)(cid:5)(cid:14)(cid:70)(cid:12)(cid:11)(cid:4)(cid:14)(cid:11)(cid:48)(cid:48)(cid:7)(cid:5)(cid:3)(cid:9)(cid:2)(cid:12)(cid:11)(cid:4)(cid:14)(cid:11)(cid:48)(cid:48)(cid:7)(cid:5)(cid:3)(cid:9)(cid:2)(cid:28)(cid:3,,830.0
,,12,,,Unknown,,cid:3)(cid:5)(cid:14)(cid:70)(cid:12)(cid:11)(cid:4)(cid:14)(cid:11)(cid:48)(cid:48)(cid:7)(cid:5)(cid:3)(cid:9)(cid:2)(cid:12)(cid:11)(cid:4)(cid:14)(cid:11)(cid:48)(cid:48)(cid:7)(cid:5)(cid:3)(cid:9)(cid:2)(cid:28)(cid:3,,842.0
,,29,,,Unknown,,cid:3)(cid:5)(cid:14)(cid:70)(cid:12)(cid:11)(cid:4)(cid:14)(cid:11)(cid:48)(cid:48)(cid:7)(cid:5)(cid:3)(cid:9)(cid:2)(cid:12)(cid:11)(cid:4)(cid:14)(cid:11)(cid:48)(cid:48)(cid:7)(cid:5)(cid:3)(cid:9)(cid:2)(cid:28)(cid:3,,871.0
,,26,,,Unknown,,cid:3)(cid:5)(cid:14)(cid:70)(cid:12)(cid:11)(cid:4)(cid:14)(cid:11)(cid:48)(cid:48)(cid:7)(cid:5)(cid:3)(cid:9)(cid:2)(cid:12)(cid:11)(cid:4)(cid:14)(cid:11)(cid:48)(cid:48)(cid:7)(cid:5)(cid:3)(cid:9)(cid:2)(cid:28)(cid:3,,897.0
,,41,,,Unknown,,cid:3)(cid:5)(cid:14)(cid:70)(cid:12)(cid:11)(cid:4)(cid:14)(cid:11)(cid:48)(cid:48)(cid:7)(cid:5)(cid:3)(cid:9)(cid:2)(cid:12)(cid:11)(cid:4)(cid:14)(cid:11)(cid:48)(cid:48)(cid:7)(cid:5)(cid:3)(cid:9)(cid:2)(cid:28)(cid:3,,938.0
,,25,,,Unknown,,cid:3)(cid:5)(cid:14)(cid:70)(cid:12)(cid:11)(cid:4)(cid:14)(cid:11)(cid:48)(cid:48)(cid:7)(cid:5)(cid:3)(cid:9)(cid:2)(cid:12)(cid:11)(cid:4)(cid:14)(cid:11)(cid:48)(cid:48)(cid:7)(cid:5)(cid:3)(cid:9)(cid:2)(cid:28)(cid:3,,963.0
,,2,,,Unknown,,cid:3)(cid:5)(cid:14)(cid:70)(cid:12)(cid:11)(cid:4)(cid:14)(cid:11)(cid:48)(cid:48)(cid:7)(cid:5)(cid:3)(cid:9)(cid:2)(cid:12)(cid:11)(cid:4)(cid:14)(cid:11)(cid:48)(cid:48)(cid:7)(cid:5)(cid:3)(cid:9)(cid:2)(cid:28)(cid:3,,965.0
,,58,,,Unknown,,cid:3)(cid:5)(cid:14)(cid:70)(cid:12)(cid:11)(cid:4)(cid:14)(cid:11)(cid:48)(cid:48)(cid:7)(cid:5)(cid:3)(cid:9)(cid:2)(cid:12)(cid:11)(cid:4)(cid:14)(cid:11)(cid:48)(cid:48)(cid:7)(cid:5)(cid:3)(cid:9)(cid:2)(cid:28)(cid:3,,1023.0
,,58,,,Unknown,,cid:3)(cid:5)(cid:14)(cid:70)(cid:12)(cid:11)(cid:4)(cid:14)(cid:11)(cid:48)(cid:48)(cid:7)(cid:5)(cid:3)(cid:9)(cid:2)(cid:12)(cid:11)(cid:4)(cid:14)(cid:11)(cid:48)(cid:48)(cid:7)(cid:5)(cid:3)(cid:9)(cid:2)(cid:28)(cid:3,,1081.0
,,37,,,Unknown,,cid:3)(cid:5)(cid:14)(cid:70)(cid:12)(cid:11)(cid:4)(cid:14)(cid:11)(cid:48)(cid:48)(cid:7)(cid:5)(cid:3)(cid:9)(cid:2)(cid:12)(cid:11)(cid:4)(cid:14)(cid:11)(cid:48)(cid:48)(cid:7)(cid:5)(cid:3)(cid:9)(cid:2)(cid:28)(cid:3,,1118.0
,,16,,,Unknown,,cid:3)(cid:5)(cid:14)(cid:70)(cid:12)(cid:11)(cid:4)(cid:14)(cid:11)(cid:48)(cid:48)(cid:7)(cid:5)(cid:3)(cid:9)(cid:2)(cid:12)(cid:11)(cid:4)(cid:14)(cid:11)(cid:48)(cid:48)(cid:7)(cid:5)(cid:3)(cid:9)(cid:2)(cid:28)(cid:3,,1134.0
,,34,,,Unknown,,cid:3)(cid:5)(cid:14)(cid:70)(cid:12)(cid:11)(cid:4)(cid:14)(cid:11)(cid:48)(cid:48)(cid:7)(cid:5)(cid:3)(cid:9)(cid:2)(cid:12)(cid:11)(cid:4)(cid:14)(cid:11)(cid:48)(cid:48)(cid:7)(cid:5)(cid:3)(cid:9)(cid:2)(cid:28)(cid:3,,1168.0
,,33,,,Unknown,,cid:3)(cid:5)(cid:14)(cid:70)(cid:12)(cid:11)(cid:4)(cid:14)(cid:11)(cid:48)(cid:48)(cid:7)(cid:5)(cid:3)(cid:9)(cid:2)(cid:12)(cid:11)(cid:4)(cid:14)(cid:11)(cid:48)(cid:48)(cid:7)(cid:5)(cid:3)(cid:9)(cid:2)(cid:28)(cid:3,,1201.0
,,17,,,Unknown,,cid:3)(cid:5)(cid:14)(cid:70)(cid:12)(cid:11)(cid:4)(cid:14)(cid:11)(cid:48)(cid:48)(cid:7)(cid:5)(cid:3)(cid:9)(cid:2)(cid:12)(cid:11)(cid:4)(cid:14)(cid:11)(cid:48)(cid:48)(cid:7)(cid:5)(cid:3)(cid:9)(cid:2)(cid:28)(cid:3,,1218.0
,,18,,,Unknown,,cid:3)(cid:5)(cid:14)(cid:70)(cid:12)(cid:11)(cid:4)(cid:14)(cid:11)(cid:48)(cid:48)(cid:7)(cid:5)(cid:3)(cid:9)(cid:2)(cid:12)(cid:11)(cid:4)(cid:14)(cid:11)(cid:48)(cid:48)(cid:7)(cid:5)(cid:3)(cid:9)(cid:2)(cid:28)(cid:3,,1236.0
,,45,,,Unknown,,cid:3)(cid:5)(cid:14)(cid:70)(cid:12)(cid:11)(cid:4)(cid:14)(cid:11)(cid:48)(cid:48)(cid:7)(cid:5)(cid:3)(cid:9)(cid:2)(cid:12)(cid:11)(cid:4)(cid:14)(cid:11)(cid:48)(cid:48)(cid:7)(cid:5)(cid:3)(cid:9)(cid:2)(cid:28)(cid:3,,1281.0
,,18,,,Unknown,,cid:3)(cid:5)(cid:14)(cid:70)(cid:12)(cid:11)(cid:4)(cid:14)(cid:11)(cid:48)(cid:48)(cid:7)(cid:5)(cid:3)(cid:9)(cid:2)(cid:12)(cid:11)(cid:4)(cid:14)(cid:11)(cid:48)(cid:48)(cid:7)(cid:5)(cid:3)(cid:9)(cid:2)(cid:28)(cid:3,,1299.0
,,16,,,Unknown,,cid:3)(cid:5)(cid:14)(cid:70)(cid:12)(cid:11)(cid:4)(cid:14)(cid:11)(cid:48)(cid:48)(cid:7)(cid:5)(cid:3)(cid:9)(cid:2)(cid:12)(cid:11)(cid:4)(cid:14)(cid:11)(cid:48)(cid:48)(cid:7)(cid:5)(cid:3)(cid:9)(cid:2)(cid:28)(cid:3,,1315.0
,,3,,,Unknown,,cid:3)(cid:5)(cid:14)(cid:70)(cid:12)(cid:11)(cid:4)(cid:14)(cid:11)(cid:48)(cid:48)(cid:7)(cid:5)(cid:3)(cid:9)(cid:2)(cid:12)(cid:11)(cid:4)(cid:14)(cid:11)(cid:48)(cid:48)(cid:7)(cid:5)(cid:3)(cid:9)(cid:2)(cid:28)(cid:3,,1318.0
,,5,,,Unknown,,cid:3)(cid:5)(cid:14)(cid:70)(cid:12)(cid:11)(cid:4)(cid:14)(cid:11)(cid:48)(cid:48)(cid:7)(cid:5)(cid:3)(cid:9)(cid:2)(cid:12)(cid:11)(cid:4)(cid:14)(cid:11)(cid:48)(cid:48)(cid:7)(cid:5)(cid:3)(cid:9)(cid:2)(cid:28)(cid:3,,1323.0
,,14,,,Unknown,,cid:3)(cid:5)(cid:14)(cid:70)(cid:12)(cid:11)(cid:4)(cid:14)(cid:11)(cid:48)(cid:48)(cid:7)(cid:5)(cid:3)(cid:9)(cid:2)(cid:12)(cid:11)(cid:4)(cid:14)(cid:11)(cid:48)(cid:48)(cid:7)(cid:5)(cid:3)(cid:9)(cid:2)(cid:28)(cid:3,,1337.0
,,70,,,Unknown,,cid:3)(cid:5)(cid:14)(cid:70)(cid:12)(cid:11)(cid:4)(cid:14)(cid:11)(cid:48)(cid:48)(cid:7)(cid:5)(cid:3)(cid:9)(cid:2)(cid:12)(cid:11)(cid:4)(cid:14)(cid:11)(cid:48)(cid:48)(cid:7)(cid:5)(cid:3)(cid:9)(cid:2)(cid:28)(cid:3,,1407.0
,,12,,,Unknown,,cid:3)(cid:5)(cid:14)(cid:70)(cid:12)(cid:11)(cid:4)(cid:14)(cid:11)(cid:48)(cid:48)(cid:7)(cid:5)(cid:3)(cid:9)(cid:2)(cid:12)(cid:11)(cid:4)(cid:14)(cid:11)(cid:48)(cid:48)(cid:7)(cid:5)(cid:3)(cid:9)(cid:2)(cid:28)(cid:3,,1419.0
,,11,,,Unknown,,cid:3)(cid:5)(cid:14)(cid:70)(cid:12)(cid:11)(cid:4)(cid:14)(cid:11)(cid:48)(cid:48)(cid:7)(cid:5)(cid:3)(cid:9)(cid:2)(cid:12)(cid:11)(cid:4)(cid:14)(cid:11)(cid:48)(cid:48)(cid:7)(cid:5)(cid:3)(cid:9)(cid:2)(cid:28)(cid:3,,1430.0
,,4,,,Unknown,,cid:3)(cid:5)(cid:14)(cid:70)(cid:12)(cid:11)(cid:4)(cid:14)(cid:11)(cid:48)(cid:48)(cid:7)(cid:5)(cid:3)(cid:9)(cid:2)(cid:12)(cid:11)(cid:4)(cid:14)(cid:11)(cid:48)(cid:48)(cid:7)(cid:5)(cid:3)(cid:9)(cid:2)(cid:28)(cid:3,,1434.0
,,14,,,Unknown,,cid:3)(cid:5)(cid:14)(cid:70)(cid:12)(cid:11)(cid:4)(cid:14)(cid:11)(cid:48)(cid:48)(cid:7)(cid:5)(cid:3)(cid:9)(cid:2)(cid:12)(cid:11)(cid:4)(cid:14)(cid:11)(cid:48)(cid:48)(cid:7)(cid:5)(cid:3)(cid:9)(cid:2)(cid:28)(cid:3,,1448.0
,,11,,,Unknown,,cid:3)(cid:5)(cid:14)(cid:70)(cid:12)(cid:11)(cid:4)(cid:14)(cid:11)(cid:48)(cid:48)(cid:7)(cid:5)(cid:3)(cid:9)(cid:2)(cid:12)(cid:11)(cid:4)(cid:14)(cid:11)(cid:48)(cid:48)(cid:7)(cid:5)(cid:3)(cid:9)(cid:2)(cid:28)(cid:3,,1459.0
,,48,,,Unknown,,cid:3)(cid:5)(cid:14)(cid:70)(cid:12)(cid:11)(cid:4)(cid:14)(cid:11)(cid:48)(cid:48)(cid:7)(cid:5)(cid:3)(cid:9)(cid:2)(cid:12)(cid:11)(cid:4)(cid:14)(cid:11)(cid:48)(cid:48)(cid:7)(cid:5)(cid:3)(cid:9)(cid:2)(cid:28)(cid:3,,1507.0
,,48,,,Unknown,,cid:3)(cid:5)(cid:14)(cid:70)(cid:12)(cid:11)(cid:4)(cid:14)(cid:11)(cid:48)(cid:48)(cid:7)(cid:5)(cid:3)(cid:9)(cid:2)(cid:12)(cid:11)(cid:4)(cid:14)(cid:11)(cid:48)(cid:48)(cid:7)(cid:5)(cid:3)(cid:9)(cid:2)(cid:28)(cid:3,,1555.0
,,7,,,Unknown,,cid:3)(cid:5)(cid:14)(cid:70)(cid:12)(cid:11)(cid:4)(cid:14)(cid:11)(cid:48)(cid:48)(cid:7)(cid:5)(cid:3)(cid:9)(cid:2)(cid:12)(cid:11)(cid:4)(cid:14)(cid:11)(cid:48)(cid:48)(cid:7)(cid:5)(cid:3)(cid:9)(cid:2)(cid:28)(cid:3,,1562.0
,,5,,,Unknown,,cid:3)(cid:5)(cid:14)(cid:70)(cid:12)(cid:11)(cid:4)(cid:14)(cid:11)(cid:48)(cid:48)(cid:7)(cid:5)(cid:3)(cid:9)(cid:2)(cid:12)(cid:11)(cid:4)(cid:14)(cid:11)(cid:48)(cid:48)(cid:7)(cid:5)(cid:3)(cid:9)(cid:2)(cid:28)(cid:3,,1567.0
,,3,,,Unknown,,cid:3)(cid:5)(cid:14)(cid:70)(cid:12)(cid:11)(cid:4)(cid:14)(cid:11)(cid:48)(cid:48)(cid:7)(cid:5)(cid:3)(cid:9)(cid:2)(cid:12)(cid:11)(cid:4)(cid:14)(cid:11)(cid:48)(cid:48)(cid:7)(cid:5)(cid:3)(cid:9)(cid:2)(cid:28)(cid:3,,1570.0
,,9,,,Unknown,,cid:3)(cid:5)(cid:14)(cid:70)(cid:12)(cid:11)(cid:4)(cid:14)(cid:11)(cid:48)(cid:48)(cid:7)(cid:5)(cid:3)(cid:9)(cid:2)(cid:12)(cid:11)(cid:4)(cid:14)(cid:11)(cid:48)(cid:48)(cid:7)(cid:5)(cid:3)(cid:9)(cid:2)(cid:28)(cid:3,,1579.0
,,2,,,Unknown,,cid:3)(cid:5)(cid:14)(cid:70)(cid:12)(cid:11)(cid:4)(cid:14)(cid:11)(cid:48)(cid:48)(cid:7)(cid:5)(cid:3)(cid:9)(cid:2)(cid:12)(cid:11)(cid:4)(cid:14)(cid:11)(cid:48)(cid:48)(cid:7)(cid:5)(cid:3)(cid:9)(cid:2)(cid:28)(cid:3,,1581.0
,,12,,,Unknown,,cid:3)(cid:5)(cid:14)(cid:70)(cid:12)(cid:11)(cid:4)(cid:14)(cid:11)(cid:48)(cid:48)(cid:7)(cid:5)(cid:3)(cid:9)(cid:2)(cid:12)(cid:11)(cid:4)(cid:14)(cid:11)(cid:48)(cid:48)(cid:7)(cid:5)(cid:3)(cid:9)(cid:2)(cid:28)(cid:3,,1593.0
,,11,,,Unknown,,cid:3)(cid:5)(cid:14)(cid:70)(cid:12)(cid:11)(cid:4)(cid:14)(cid:11)(cid:48)(cid:48)(cid:7)(cid:5)(cid:3)(cid:9)(cid:2)(cid:12)(cid:11)(cid:4)(cid:14)(cid:11)(cid:48)(cid:48)(cid:7)(cid:5)(cid:3)(cid:9)(cid:2)(cid:28)(cid:3,,1604.0
,,4,,,Unknown,,cid:3)(cid:5)(cid:14)(cid:70)(cid:12)(cid:11)(cid:4)(cid:14)(cid:11)(cid:48)(cid:48)(cid:7)(cid:5)(cid:3)(cid:9)(cid:2)(cid:12)(cid:11)(cid:4)(cid:14)(cid:11)(cid:48)(cid:48)(cid:7)(cid:5)(cid:3)(cid:9)(cid:2)(cid:28)(cid:3,,1608.0
,,14,,,Unknown,,cid:3)(cid:5)(cid:14)(cid:70)(cid:12)(cid:11)(cid:4)(cid:14)(cid:11)(cid:48)(cid:48)(cid:7)(cid:5)(cid:3)(cid:9)(cid:2)(cid:12)(cid:11)(cid:4)(cid:14)(cid:11)(cid:48)(cid:48)(cid:7)(cid:5)(cid:3)(cid:9)(cid:2)(cid:28)(cid:3,,1622.0
,,11,,,Unknown,,cid:3)(cid:5)(cid:14)(cid:70)(cid:12)(cid:11)(cid:4)(cid:14)(cid:11)(cid:48)(cid:48)(cid:7)(cid:5)(cid:3)(cid:9)(cid:2)(cid:12)(cid:11)(cid:4)(cid:14)(cid:11)(cid:48)(cid:48)(cid:7)(cid:5)(cid:3)(cid:9)(cid:2)(cid:28)(cid:3,,1633.0
,,48,,,Unknown,,cid:3)(cid:5)(cid:14)(cid:70)(cid:12)(cid:11)(cid:4)(cid:14)(cid:11)(cid:48)(cid:48)(cid:7)(cid:5)(cid:3)(cid:9)(cid:2)(cid:12)(cid:11)(cid:4)(cid:14)(cid:11)(cid:48)(cid:48)(cid:7)(cid:5)(cid:3)(cid:9)(cid:2)(cid:28)(cid:3,,1681.0
,,48,,,Unknown,,cid:3)(cid:5)(cid:14)(cid:70)(cid:12)(cid:11)(cid:4)(cid:14)(cid:11)(cid:48)(cid:48)(cid:7)(cid:5)(cid:3)(cid:9)(cid:2)(cid:12)(cid:11)(cid:4)(cid:14)(cid:11)(cid:48)(cid:48)(cid:7)(cid:5)(cid:3)(cid:9)(cid:2)(cid:28)(cid:3,,1729.0
,,7,,,Unknown,,cid:3)(cid:5)(cid:14)(cid:70)(cid:12)(cid:11)(cid:4)(cid:14)(cid:11)(cid:48)(cid:48)(cid:7)(cid:5)(cid:3)(cid:9)(cid:2)(cid:12)(cid:11)(cid:4)(cid:14)(cid:11)(cid:48)(cid:48)(cid:7)(cid:5)(cid:3)(cid:9)(cid:2)(cid:28)(cid:3,,1736.0
,,5,,,Unknown,,cid:3)(cid:5)(cid:14)(cid:70)(cid:12)(cid:11)(cid:4)(cid:14)(cid:11)(cid:48)(cid:48)(cid:7)(cid:5)(cid:3)(cid:9)(cid:2)(cid:12)(cid:11)(cid:4)(cid:14)(cid:11)(cid:48)(cid:48)(cid:7)(cid:5)(cid:3)(cid:9)(cid:2)(cid:28)(cid:3,,1741.0
,,3,,,Unknown,,cid:3)(cid:5)(cid:14)(cid:70)(cid:12)(cid:11)(cid:4)(cid:14)(cid:11)(cid:48)(cid:48)(cid:7)(cid:5)(cid:3)(cid:9)(cid:2)(cid:12)(cid:11)(cid:4)(cid:14)(cid:11)(cid:48)(cid:48)(cid:7)(cid:5)(cid:3)(cid:9)(cid:2)(cid:28)(cid:3,,1744.0
,,9,,,Unknown,,cid:3)(cid:5)(cid:14)(cid:70)(cid:12)(cid:11)(cid:4)(cid:14)(cid:11)(cid:48)(cid:48)(cid:7)(cid:5)(cid:3)(cid:9)(cid:2)(cid:12)(cid:11)(cid:4)(cid:14)(cid:11)(cid:48)(cid:48)(cid:7)(cid:5)(cid:3)(cid:9)(cid:2)(cid:28)(cid:3,,1753.0
,,2,,,Unknown,,cid:3)(cid:5)(cid:14)(cid:70)(cid:12)(cid:11)(cid:4)(cid:14)(cid:11)(cid:48)(cid:48)(cid:7)(cid:5)(cid:3)(cid:9)(cid:2)(cid:12)(cid:11)(cid:4)(cid:14)(cid:11)(cid:48)(cid:48)(cid:7)(cid:5)(cid:3)(cid:9)(cid:2)(cid:28)(cid:3,,1755.0
,,28,,,Unknown,,cid:3)(cid:5)(cid:14)(cid:70)(cid:12)(cid:11)(cid:4)(cid:14)(cid:11)(cid:48)(cid:48)(cid:7)(cid:5)(cid:3)(cid:9)(cid:2)(cid:12)(cid:11)(cid:4)(cid:14)(cid:11)(cid:48)(cid:48)(cid:7)(cid:5)(cid:3)(cid:9)(cid:2)(cid:28)(cid:3,,1783.0
,,3,,,Unknown,,cid:3)(cid:5)(cid:14)(cid:70)(cid:12)(cid:11)(cid:4)(cid:14)(cid:11)(cid:48)(cid:48)(cid:7)(cid:5)(cid:3)(cid:9)(cid:2)(cid:12)(cid:11)(cid:4)(cid:14)(cid:11)(cid:48)(cid:48)(cid:7)(cid:5)(cid:3)(cid:9)(cid:2)(cid:28)(cid:3,,1786.0
,,15,,,Unknown,,cid:3)(cid:5)(cid:14)(cid:70)(cid:12)(cid:11)(cid:4)(cid:14)(cid:11)(cid:48)(cid:48)(cid:7)(cid:5)(cid:3)(cid:9)(cid:2)(cid:12)(cid:11)(cid:4)(cid:14)(cid:11)(cid:48)(cid:48)(cid:7)(cid:5)(cid:3)(cid:9)(cid:2)(cid:28)(cid:3,,1801.0
,,2,,,Unknown,,cid:3)(cid:5)(cid:14)(cid:70)(cid:12)(cid:11)(cid:4)(cid:14)(cid:11)(cid:48)(cid:48)(cid:7)(cid:5)(cid:3)(cid:9)(cid:2)(cid:12)(cid:11)(cid:4)(cid:14)(cid:11)(cid:48)(cid:48)(cid:7)(cid:5)(cid:3)(cid:9)(cid:2)(cid:28)(cid:3,,1803.0
,,34,,,Unknown,,cid:3)(cid:5)(cid:14)(cid:70)(cid:12)(cid:11)(cid:4)(cid:14)(cid:11)(cid:48)(cid:48)(cid:7)(cid:5)(cid:3)(cid:9)(cid:2)(cid:12)(cid:11)(cid:4)(cid:14)(cid:11)(cid:48)(cid:48)(cid:7)(cid:5)(cid:3)(cid:9)(cid:2)(cid:28)(cid:3,,1837.0
,,18,,,Unknown,,cid:3)(cid:5)(cid:14)(cid:70)(cid:12)(cid:11)(cid:4)(cid:14)(cid:11)(cid:48)(cid:48)(cid:7)(cid:5)(cid:3)(cid:9)(cid:2)(cid:12)(cid:11)(cid:4)(cid:14)(cid:11)(cid:48)(cid:48)(cid:7)(cid:5)(cid:3)(cid:9)(cid:2)(cid:28)(cid:3,,1855.0
,,19,,,Unknown,,cid:3)(cid:5)(cid:14)(cid:70)(cid:12)(cid:11)(cid:4)(cid:14)(cid:11)(cid:48)(cid:48)(cid:7)(cid:5)(cid:3)(cid:9)(cid:2)(cid:12)(cid:11)(cid:4)(cid:14)(cid:11)(cid:48)(cid:48)(cid:7)(cid:5)(cid:3)(cid:9)(cid:2)(cid:28)(cid:3,,1874.0
,,18,,,Unknown,,cid:3)(cid:5)(cid:14)(cid:70)(cid:12)(cid:11)(cid:4)(cid:14)(cid:11)(cid:48)(cid:48)(cid:7)(cid:5)(cid:3)(cid:9)(cid:2)(cid:12)(cid:11)(cid:4)(cid:14)(cid:11)(cid:48)(cid:48)(cid:7)(cid:5)(cid:3)(cid:9)(cid:2)(cid:28)(cid:3,,1892.0
,,18,,,Unknown,,cid:3)(cid:5)(cid:14)(cid:70)(cid:12)(cid:11)(cid:4)(cid:14)(cid:11)(cid:48)(cid:48)(cid:7)(cid:5)(cid:3)(cid:9)(cid:2)(cid:12)(cid:11)(cid:4)(cid:14)(cid:11)(cid:48)(cid:48)(cid:7)(cid:5)(cid:3)(cid:9)(cid:2)(cid:28)(cid:3,,1910.0
,,2,,,Unknown,,cid:3)(cid:5)(cid:14)(cid:70)(cid:12)(cid:11)(cid:4)(cid:14)(cid:11)(cid:48)(cid:48)(cid:7)(cid:5)(cid:3)(cid:9)(cid:2)(cid:12)(cid:11)(cid:4)(cid:14)(cid:11)(cid:48)(cid:48)(cid:7)(cid:5)(cid:3)(cid:9)(cid:2)(cid:28)(cid:3,,1912.0
,,44,,,Unknown,,cid:3)(cid:5)(cid:14)(cid:70)(cid:12)(cid:11)(cid:4)(cid:14)(cid:11)(cid:48)(cid:48)(cid:7)(cid:5)(cid:3)(cid:9)(cid:2)(cid:12)(cid:11)(cid:4)(cid:14)(cid:11)(cid:48)(cid:48)(cid:7)(cid:5)(cid:3)(cid:9)(cid:2)(cid:28)(cid:3,,1956.0
,,12,,,Unknown,,cid:3)(cid:5)(cid:14)(cid:70)(cid:12)(cid:11)(cid:4)(cid:14)(cid:11)(cid:48)(cid:48)(cid:7)(cid:5)(cid:3)(cid:9)(cid:2)(cid:12)(cid:11)(cid:4)(cid:14)(cid:11)(cid:48)(cid:48)(cid:7)(cid:5)(cid:3)(cid:9)(cid:2)(cid:28)(cid:3,,1968.0
,,29,,,Unknown,,cid:3)(cid:5)(cid:14)(cid:70)(cid:12)(cid:11)(cid:4)(cid:14)(cid:11)(cid:48)(cid:48)(cid:7)(cid:5)(cid:3)(cid:9)(cid:2)(cid:12)(cid:11)(cid:4)(cid:14)(cid:11)(cid:48)(cid:48)(cid:7)(cid:5)(cid:3)(cid:9)(cid:2)(cid:28)(cid:3,,1997.0
,,26,,,Unknown,,cid:3)(cid:5)(cid:14)(cid:70)(cid:12)(cid:11)(cid:4)(cid:14)(cid:11)(cid:48)(cid:48)(cid:7)(cid:5)(cid:3)(cid:9)(cid:2)(cid:12)(cid:11)(cid:4)(cid:14)(cid:11)(cid:48)(cid:48)(cid:7)(cid:5)(cid:3)(cid:9)(cid:2)(cid:28)(cid:3,,2023.0
,,41,,,Unknown,,cid:3)(cid:5)(cid:14)(cid:70)(cid:12)(cid:11)(cid:4)(cid:14)(cid:11)(cid:48)(cid:48)(cid:7)(cid:5)(cid:3)(cid:9)(cid:2)(cid:12)(cid:11)(cid:4)(cid:14)(cid:11)(cid:48)(cid:48)(cid:7)(cid:5)(cid:3)(cid:9)(cid:2)(cid:28)(cid:3,,2064.0
,,25,,,Unknown,,cid:3)(cid:5)(cid:14)(cid:70)(cid:12)(cid:11)(cid:4)(cid:14)(cid:11)(cid:48)(cid:48)(cid:7)(cid:5)(cid:3)(cid:9)(cid:2)(cid:12)(cid:11)(cid:4)(cid:14)(cid:11)(cid:48)(cid:48)(cid:7)(cid:5)(cid:3)(cid:9)(cid:2)(cid:28)(cid:3,,2089.0
,,2,,,Unknown,,cid:3)(cid:5)(cid:14)(cid:70)(cid:12)(cid:11)(cid:4)(cid:14)(cid:11)(cid:48)(cid:48)(cid:7)(cid:5)(cid:3)(cid:9)(cid:2)(cid:12)(cid:11)(cid:4)(cid:14)(cid:11)(cid:48)(cid:48)(cid:7)(cid:5)(cid:3)(cid:9)(cid:2)(cid:28)(cid:3,,2091.0
,,58,,,Unknown,,cid:3)(cid:5)(cid:14)(cid:70)(cid:12)(cid:11)(cid:4)(cid:14)(cid:11)(cid:48)(cid:48)(cid:7)(cid:5)(cid:3)(cid:9)(cid:2)(cid:12)(cid:11)(cid:4)(cid:14)(cid:11)(cid:48)(cid:48)(cid:7)(cid:5)(cid:3)(cid:9)(cid:2)(cid:28)(cid:3,,2149.0
,,58,,,Unknown,,cid:3)(cid:5)(cid:14)(cid:70)(cid:12)(cid:11)(cid:4)(cid:14)(cid:11)(cid:48)(cid:48)(cid:7)(cid:5)(cid:3)(cid:9)(cid:2)(cid:12)(cid:11)(cid:4)(cid:14)(cid:11)(cid:48)(cid:48)(cid:7)(cid:5)(cid:3)(cid:9)(cid:2)(cid:28)(cid:3,,2207.0
,,37,,,Unknown,,cid:3)(cid:5)(cid:14)(cid:70)(cid:12)(cid:11)(cid:4)(cid:14)(cid:11)(cid:48)(cid:48)(cid:7)(cid:5)(cid:3)(cid:9)(cid:2)(cid:12)(cid:11)(cid:4)(cid:14)(cid:11)(cid:48)(cid:48)(cid:7)(cid:5)(cid:3)(cid:9)(cid:2)(cid:28)(cid:3,,2244.0
,,16,,,Unknown,,cid:3)(cid:5)(cid:14)(cid:70)(cid:12)(cid:11)(cid:4)(cid:14)(cid:11)(cid:48)(cid:48)(cid:7)(cid:5)(cid:3)(cid:9)(cid:2)(cid:12)(cid:11)(cid:4)(cid:14)(cid:11)(cid:48)(cid:48)(cid:7)(cid:5)(cid:3)(cid:9)(cid:2)(cid:28)(cid:3,,2260.0
,,34,,,Unknown,,cid:3)(cid:5)(cid:14)(cid:70)(cid:12)(cid:11)(cid:4)(cid:14)(cid:11)(cid:48)(cid:48)(cid:7)(cid:5)(cid:3)(cid:9)(cid:2)(cid:12)(cid:11)(cid:4)(cid:14)(cid:11)(cid:48)(cid:48)(cid:7)(cid:5)(cid:3)(cid:9)(cid:2)(cid:28)(cid:3,,2294.0
,,33,,,Unknown,,cid:3)(cid:5)(cid:14)(cid:70)(cid:12)(cid:11)(cid:4)(cid:14)(cid:11)(cid:48)(cid:48)(cid:7)(cid:5)(cid:3)(cid:9)(cid:2)(cid:12)(cid:11)(cid:4)(cid:14)(cid:11)(cid:48)(cid:48)(cid:7)(cid:5)(cid:3)(cid:9)(cid:2)(cid:28)(cid:3,,2327.0
,,17,,,Unknown,,cid:3)(cid:5)(cid:14)(cid:70)(cid:12)(cid:11)(cid:4)(cid:14)(cid:11)(cid:48)(cid:48)(cid:7)(cid:5)(cid:3)(cid:9)(cid:2)(cid:12)(cid:11)(cid:4)(cid:14)(cid:11)(cid:48)(cid:48)(cid:7)(cid:5)(cid:3)(cid:9)(cid:2)(cid:28)(cid:3,,2344.0
,,18,,,Unknown,,cid:3)(cid:5)(cid:14)(cid:70)(cid:12)(cid:11)(cid:4)(cid:14)(cid:11)(cid:48)(cid:48)(cid:7)(cid:5)(cid:3)(cid:9)(cid:2)(cid:12)(cid:11)(cid:4)(cid:14)(cid:11)(cid:48)(cid:48)(cid:7)(cid:5)(cid:3)(cid:9)(cid:2)(cid:28)(cid:3,,2362.0
,,45,,,Unknown,,cid:3)(cid:5)(cid:14)(cid:70)(cid:12)(cid:11)(cid:4)(cid:14)(cid:11)(cid:48)(cid:48)(cid:7)(cid:5)(cid:3)(cid:9)(cid:2)(cid:12)(cid:11)(cid:4)(cid:14)(cid:11)(cid:48)(cid:48)(cid:7)(cid:5)(cid:3)(cid:9)(cid:2)(cid:28)(cid:3,,2407.0
,,18,,,Unknown,,cid:3)(cid:5)(cid:14)(cid:70)(cid:12)(cid:11)(cid:4)(cid:14)(cid:11)(cid:48)(cid:48)(cid:7)(cid:5)(cid:3)(cid:9)(cid:2)(cid:12)(cid:11)(cid:4)(cid:14)(cid:11)(cid:48)(cid:48)(cid:7)(cid:5)(cid:3)(cid:9)(cid:2)(cid:28)(cid:3,,2425.0
,,16,,,Unknown,,cid:3)(cid:5)(cid:14)(cid:70)(cid:12)(cid:11)(cid:4)(cid:14)(cid:11)(cid:48)(cid:48)(cid:7)(cid:5)(cid:3)(cid:9)(cid:2)(cid:12)(cid:11)(cid:4)(cid:14)(cid:11)(cid:48)(cid:48)(cid:7)(cid:5)(cid:3)(cid:9)(cid:2)(cid:28)(cid:3,,2441.0
,,14,,,Unknown,,cid:3)(cid:5)(cid:14)(cid:70)(cid:12)(cid:11)(cid:4)(cid:14)(cid:11)(cid:48)(cid:48)(cid:7)(cid:5)(cid:3)(cid:9)(cid:2)(cid:12)(cid:11)(cid:4)(cid:14)(cid:11)(cid:48)(cid:48)(cid:7)(cid:5)(cid:3)(cid:9)(cid:2)(cid:28)(cid:3,,2455.0
,,69,,,Unknown,,cid:3)(cid:5)(cid:14)(cid:70)(cid:12)(cid:11)(cid:4)(cid:14)(cid:11)(cid:48)(cid:48)(cid:7)(cid:5)(cid:3)(cid:9)(cid:2)(cid:12)(cid:11)(cid:4)(cid:14)(cid:11)(cid:48)(cid:48)(cid:7)(cid:5)(cid:3)(cid:9)(cid:2)(cid:28)(cid:3,,2524.0
,,46,,,Unknown,,cid:3)(cid:5)(cid:14)(cid:70)(cid:12)(cid:11)(cid:4)(cid:14)(cid:11)(cid:48)(cid:48)(cid:7)(cid:5)(cid:3)(cid:9)(cid:2)(cid:12)(cid:11)(cid:4)(cid:14)(cid:11)(cid:48)(cid:48)(cid:7)(cid:5)(cid:3)(cid:9)(cid:2)(cid:28)(cid:3,,2570.0
,,47,,,Unknown,,cid:3)(cid:5)(cid:14)(cid:70)(cid:12)(cid:11)(cid:4)(cid:14)(cid:11)(cid:48)(cid:48)(cid:7)(cid:5)(cid:3)(cid:9)(cid:2)(cid:12)(cid:11)(cid:4)(cid:14)(cid:11)(cid:48)(cid:48)(cid:7)(cid:5)(cid:3)(cid:9)(cid:2)(cid:28)(cid:3,,2617.0
,,46,,,Unknown,,cid:3)(cid:5)(cid:14)(cid:70)(cid:12)(cid:11)(cid:4)(cid:14)(cid:11)(cid:48)(cid:48)(cid:7)(cid:5)(cid:3)(cid:9)(cid:2)(cid:12)(cid:11)(cid:4)(cid:14)(cid:11)(cid:48)(cid:48)(cid:7)(cid:5)(cid:3)(cid:9)(cid:2)(cid:28)(cid:3,,2663.0
,,10,,,Unknown,,cid:3)(cid:5)(cid:14)(cid:70)(cid:12)(cid:11)(cid:4)(cid:14)(cid:11)(cid:48)(cid:48)(cid:7)(cid:5)(cid:3)(cid:9)(cid:2)(cid:12)(cid:11)(cid:4)(cid:14)(cid:11)(cid:48)(cid:48)(cid:7)(cid:5)(cid:3)(cid:9)(cid:2)(cid:28)(cid:3,,2673.0
,,10,,,Unknown,,cid:3)(cid:5)(cid:14)(cid:70)(cid:12)(cid:11)(cid:4)(cid:14)(cid:11)(cid:48)(cid:48)(cid:7)(cid:5)(cid:3)(cid:9)(cid:2)(cid:12)(cid:11)(cid:4)(cid:14)(cid:11)(cid:48)(cid:48)(cid:7)(cid:5)(cid:3)(cid:9)(cid:2)(cid:28)(cid:3,,2683.0
,,11,,,Unknown,,cid:3)(cid:5)(cid:14)(cid:70)(cid:12)(cid:11)(cid:4)(cid:14)(cid:11)(cid:48)(cid:48)(cid:7)(cid:5)(cid:3)(cid:9)(cid:2)(cid:12)(cid:11)(cid:4)(cid:14)(cid:11)(cid:48)(cid:48)(cid:7)(cid:5)(cid:3)(cid:9)(cid:2)(cid:28)(cid:3,,2694.0
,,7,,,Unknown,,cid:3)(cid:5)(cid:14)(cid:70)(cid:12)(cid:11)(cid:4)(cid:14)(cid:11)(cid:48)(cid:48)(cid:7)(cid:5)(cid:3)(cid:9)(cid:2)(cid:12)(cid:11)(cid:4)(cid:14)(cid:11)(cid:48)(cid:48)(cid:7)(cid:5)(cid:3)(cid:9)(cid:2)(cid:28)(cid:3,,2701.0
,,3,,,Unknown,,cid:3)(cid:5)(cid:14)(cid:70)(cid:12)(cid:11)(cid:4)(cid:14)(cid:11)(cid:48)(cid:48)(cid:7)(cid:5)(cid:3)(cid:9)(cid:2)(cid:12)(cid:11)(cid:4)(cid:14)(cid:11)(cid:48)(cid:48)(cid:7)(cid:5)(cid:3)(cid:9)(cid:2)(cid:28)(cid:3,,2704.0
,,2,,,Unknown,,cid:3)(cid:5)(cid:14)(cid:70)(cid:12)(cid:11)(cid:4)(cid:14)(cid:11)(cid:48)(cid:48)(cid:7)(cid:5)(cid:3)(cid:9)(cid:2)(cid:12)(cid:11)(cid:4)(cid:14)(cid:11)(cid:48)(cid:48)(cid:7)(cid:5)(cid:3)(cid:9)(cid:2)(cid:28)(cid:3,,2706.0
,,50,,,Unknown,,cid:3)(cid:5)(cid:14)(cid:70)(cid:12)(cid:11)(cid:4)(cid:14)(cid:11)(cid:48)(cid:48)(cid:7)(cid:5)(cid:3)(cid:9)(cid:2)(cid:12)(cid:11)(cid:4)(cid:14)(cid:11)(cid:48)(cid:48)(cid:7)(cid:5)(cid:3)(cid:9)(cid:2)(cid:28)(cid:3,,2756.0
,,5,,,Unknown,,cid:3)(cid:5)(cid:14)(cid:70)(cid:12)(cid:11)(cid:4)(cid:14)(cid:11)(cid:48)(cid:48)(cid:7)(cid:5)(cid:3)(cid:9)(cid:2)(cid:12)(cid:11)(cid:4)(cid:14)(cid:11)(cid:48)(cid:48)(cid:7)(cid:5)(cid:3)(cid:9)(cid:2)(cid:28)(cid:3,,2761.0
,,2,,,Unknown,,cid:3)(cid:5)(cid:14)(cid:70)(cid:12)(cid:11)(cid:4)(cid:14)(cid:11)(cid:48)(cid:48)(cid:7)(cid:5)(cid:3)(cid:9)(cid:2)(cid:12)(cid:11)(cid:4)(cid:14)(cid:11)(cid:48)(cid:48)(cid:7)(cid:5)(cid:3)(cid:9)(cid:2)(cid:28)(cid:3,,2763.0
,,14,,,Unknown,,cid:3)(cid:5)(cid:14)(cid:70)(cid:12)(cid:11)(cid:4)(cid:14)(cid:11)(cid:48)(cid:48)(cid:7)(cid:5)(cid:3)(cid:9)(cid:2)(cid:12)(cid:11)(cid:4)(cid:14)(cid:11)(cid:48)(cid:48)(cid:7)(cid:5)(cid:3)(cid:9)(cid:2)(cid:28)(cid:3,,2777.0
,,2,,,Unknown,,cid:3)(cid:5)(cid:14)(cid:70)(cid:12)(cid:11)(cid:4)(cid:14)(cid:11)(cid:48)(cid:48)(cid:7)(cid:5)(cid:3)(cid:9)(cid:2)(cid:12)(cid:11)(cid:4)(cid:14)(cid:11)(cid:48)(cid:48)(cid:7)(cid:5)(cid:3)(cid:9)(cid:2)(cid:28)(cid:3,,2779.0
,,12,,,Unknown,,cid:3)(cid:5)(cid:14)(cid:70)(cid:12)(cid:11)(cid:4)(cid:14)(cid:11)(cid:48)(cid:48)(cid:7)(cid:5)(cid:3)(cid:9)(cid:2)(cid:12)(cid:11)(cid:4)(cid:14)(cid:11)(cid:48)(cid:48)(cid:7)(cid:5)(cid:3)(cid:9)(cid:2)(cid:28)(cid:3,,2791.0
,,11,,,Unknown,,cid:3)(cid:5)(cid:14)(cid:70)(cid:12)(cid:11)(cid:4)(cid:14)(cid:11)(cid:48)(cid:48)(cid:7)(cid:5)(cid:3)(cid:9)(cid:2)(cid:12)(cid:11)(cid:4)(cid:14)(cid:11)(cid:48)(cid:48)(cid:7)(cid:5)(cid:3)(cid:9)(cid:2)(cid:28)(cid:3,,2802.0
,,4,,,Unknown,,cid:3)(cid:5)(cid:14)(cid:70)(cid:12)(cid:11)(cid:4)(cid:14)(cid:11)(cid:48)(cid:48)(cid:7)(cid:5)(cid:3)(cid:9)(cid:2)(cid:12)(cid:11)(cid:4)(cid:14)(cid:11)(cid:48)(cid:48)(cid:7)(cid:5)(cid:3)(cid:9)(cid:2)(cid:28)(cid:3,,2806.0
,,14,,,Unknown,,cid:3)(cid:5)(cid:14)(cid:70)(cid:12)(cid:11)(cid:4)(cid:14)(cid:11)(cid:48)(cid:48)(cid:7)(cid:5)(cid:3)(cid:9)(cid:2)(cid:12)(cid:11)(cid:4)(cid:14)(cid:11)(cid:48)(cid:48)(cid:7)(cid:5)(cid:3)(cid:9)(cid:2)(cid:28)(cid:3,,2820.0
,,11,,,Unknown,,cid:3)(cid:5)(cid:14)(cid:70)(cid:12)(cid:11)(cid:4)(cid:14)(cid:11)(cid:48)(cid:48)(cid:7)(cid:5)(cid:3)(cid:9)(cid:2)(cid:12)(cid:11)(cid:4)(cid:14)(cid:11)(cid:48)(cid:48)(cid:7)(cid:5)(cid:3)(cid:9)(cid:2)(cid:28)(cid:3,,2831.0
,,48,,,Unknown,,cid:3)(cid:5)(cid:14)(cid:70)(cid:12)(cid:11)(cid:4)(cid:14)(cid:11)(cid:48)(cid:48)(cid:7)(cid:5)(cid:3)(cid:9)(cid:2)(cid:12)(cid:11)(cid:4)(cid:14)(cid:11)(cid:48)(cid:48)(cid:7)(cid:5)(cid:3)(cid:9)(cid:2)(cid:28)(cid:3,,2879.0
,,48,,,Unknown,,cid:3)(cid:5)(cid:14)(cid:70)(cid:12)(cid:11)(cid:4)(cid:14)(cid:11)(cid:48)(cid:48)(cid:7)(cid:5)(cid:3)(cid:9)(cid:2)(cid:12)(cid:11)(cid:4)(cid:14)(cid:11)(cid:48)(cid:48)(cid:7)(cid:5)(cid:3)(cid:9)(cid:2)(cid:28)(cid:3,,2927.0
,,7,,,Unknown,,cid:3)(cid:5)(cid:14)(cid:70)(cid:12)(cid:11)(cid:4)(cid:14)(cid:11)(cid:48)(cid:48)(cid:7)(cid:5)(cid:3)(cid:9)(cid:2)(cid:12)(cid:11)(cid:4)(cid:14)(cid:11)(cid:48)(cid:48)(cid:7)(cid:5)(cid:3)(cid:9)(cid:2)(cid:28)(cid:3,,2934.0
,,5,,,Unknown,,cid:3)(cid:5)(cid:14)(cid:70)(cid:12)(cid:11)(cid:4)(cid:14)(cid:11)(cid:48)(cid:48)(cid:7)(cid:5)(cid:3)(cid:9)(cid:2)(cid:12)(cid:11)(cid:4)(cid:14)(cid:11)(cid:48)(cid:48)(cid:7)(cid:5)(cid:3)(cid:9)(cid:2)(cid:28)(cid:3,,2939.0
,,3,,,Unknown,,cid:3)(cid:5)(cid:14)(cid:70)(cid:12)(cid:11)(cid:4)(cid:14)(cid:11)(cid:48)(cid:48)(cid:7)(cid:5)(cid:3)(cid:9)(cid:2)(cid:12)(cid:11)(cid:4)(cid:14)(cid:11)(cid:48)(cid:48)(cid:7)(cid:5)(cid:3)(cid:9)(cid:2)(cid:28)(cid:3,,2942.0
,,9,,,Unknown,,cid:3)(cid:5)(cid:14)(cid:70)(cid:12)(cid:11)(cid:4)(cid:14)(cid:11)(cid:48)(cid:48)(cid:7)(cid:5)(cid:3)(cid:9)(cid:2)(cid:12)(cid:11)(cid:4)(cid:14)(cid:11)(cid:48)(cid:48)(cid:7)(cid:5)(cid:3)(cid:9)(cid:2)(cid:28)(cid:3,,2951.0
,,2,,,Unknown,,cid:3)(cid:5)(cid:14)(cid:70)(cid:12)(cid:11)(cid:4)(cid:14)(cid:11)(cid:48)(cid:48)(cid:7)(cid:5)(cid:3)(cid:9)(cid:2)(cid:12)(cid:11)(cid:4)(cid:14)(cid:11)(cid:48)(cid:48)(cid:7)(cid:5)(cid:3)(cid:9)(cid:2)(cid:28)(cid:3,,2953.0
,,28,,,Unknown,,cid:3)(cid:5)(cid:14)(cid:70)(cid:12)(cid:11)(cid:4)(cid:14)(cid:11)(cid:48)(cid:48)(cid:7)(cid:5)(cid:3)(cid:9)(cid:2)(cid:12)(cid:11)(cid:4)(cid:14)(cid:11)(cid:48)(cid:48)(cid:7)(cid:5)(cid:3)(cid:9)(cid:2)(cid:28)(cid:3,,2981.0
,,3,,,Unknown,,cid:3)(cid:5)(cid:14)(cid:70)(cid:12)(cid:11)(cid:4)(cid:14)(cid:11)(cid:48)(cid:48)(cid:7)(cid:5)(cid:3)(cid:9)(cid:2)(cid:12)(cid:11)(cid:4)(cid:14)(cid:11)(cid:48)(cid:48)(cid:7)(cid:5)(cid:3)(cid:9)(cid:2)(cid:28)(cid:3,,2984.0
,,15,,,Unknown,,cid:3)(cid:5)(cid:14)(cid:70)(cid:12)(cid:11)(cid:4)(cid:14)(cid:11)(cid:48)(cid:48)(cid:7)(cid:5)(cid:3)(cid:9)(cid:2)(cid:12)(cid:11)(cid:4)(cid:14)(cid:11)(cid:48)(cid:48)(cid:7)(cid:5)(cid:3)(cid:9)(cid:2)(cid:28)(cid:3,,2999.0
,,2,,,Unknown,,cid:3)(cid:5)(cid:14)(cid:70)(cid:12)(cid:11)(cid:4)(cid:14)(cid:11)(cid:48)(cid:48)(cid:7)(cid:5)(cid:3)(cid:9)(cid:2)(cid:12)(cid:11)(cid:4)(cid:14)(cid:11)(cid:48)(cid:48)(cid:7)(cid:5)(cid:3)(cid:9)(cid:2)(cid:28)(cid:3,,3001.0
,,34,,,Unknown,,cid:3)(cid:5)(cid:14)(cid:70)(cid:12)(cid:11)(cid:4)(cid:14)(cid:11)(cid:48)(cid:48)(cid:7)(cid:5)(cid:3)(cid:9)(cid:2)(cid:12)(cid:11)(cid:4)(cid:14)(cid:11)(cid:48)(cid:48)(cid:7)(cid:5)(cid:3)(cid:9)(cid:2)(cid:28)(cid:3,,3035.0
,,36,,,Unknown,,cid:3)(cid:5)(cid:14)(cid:70)(cid:12)(cid:11)(cid:4)(cid:14)(cid:11)(cid:48)(cid:48)(cid:7)(cid:5)(cid:3)(cid:9)(cid:2)(cid:12)(cid:11)(cid:4)(cid:14)(cid:11)(cid:48)(cid:48)(cid:7)(cid:5)(cid:3)(cid:9)(cid:2)(cid:28)(cid:3,,3071.0
,,19,,,Unknown,,cid:3)(cid:5)(cid:14)(cid:70)(cid:12)(cid:11)(cid:4)(cid:14)(cid:11)(cid:48)(cid:48)(cid:7)(cid:5)(cid:3)(cid:9)(cid:2)(cid:12)(cid:11)(cid:4)(cid:14)(cid:11)(cid:48)(cid:48)(cid:7)(cid:5)(cid:3)(cid:9)(cid:2)(cid:28)(cid:3,,3090.0
,,16,,,Unknown,,cid:3)(cid:5)(cid:14)(cid:70)(cid:12)(cid:11)(cid:4)(cid:14)(cid:11)(cid:48)(cid:48)(cid:7)(cid:5)(cid:3)(cid:9)(cid:2)(cid:12)(cid:11)(cid:4)(cid:14)(cid:11)(cid:48)(cid:48)(cid:7)(cid:5)(cid:3)(cid:9)(cid:2)(cid:28)(cid:3,,3106.0
,,18,,,Unknown,,cid:3)(cid:5)(cid:14)(cid:70)(cid:12)(cid:11)(cid:4)(cid:14)(cid:11)(cid:48)(cid:48)(cid:7)(cid:5)(cid:3)(cid:9)(cid:2)(cid:12)(cid:11)(cid:4)(cid:14)(cid:11)(cid:48)(cid:48)(cid:7)(cid:5)(cid:3)(cid:9)(cid:2)(cid:28)(cid:3,,3124.0
,,2,,,Unknown,,cid:3)(cid:5)(cid:14)(cid:70)(cid:12)(cid:11)(cid:4)(cid:14)(cid:11)(cid:48)(cid:48)(cid:7)(cid:5)(cid:3)(cid:9)(cid:2)(cid:12)(cid:11)(cid:4)(cid:14)(cid:11)(cid:48)(cid:48)(cid:7)(cid:5)(cid:3)(cid:9)(cid:2)(cid:28)(cid:3,,3126.0
,,44,,,Unknown,,cid:3)(cid:5)(cid:14)(cid:70)(cid:12)(cid:11)(cid:4)(cid:14)(cid:11)(cid:48)(cid:48)(cid:7)(cid:5)(cid:3)(cid:9)(cid:2)(cid:12)(cid:11)(cid:4)(cid:14)(cid:11)(cid:48)(cid:48)(cid:7)(cid:5)(cid:3)(cid:9)(cid:2)(cid:28)(cid:3,,3170.0
,,12,,,Unknown,,cid:3)(cid:5)(cid:14)(cid:70)(cid:12)(cid:11)(cid:4)(cid:14)(cid:11)(cid:48)(cid:48)(cid:7)(cid:5)(cid:3)(cid:9)(cid:2)(cid:12)(cid:11)(cid:4)(cid:14)(cid:11)(cid:48)(cid:48)(cid:7)(cid:5)(cid:3)(cid:9)(cid:2)(cid:28)(cid:3,,3182.0
,,29,,,Unknown,,cid:3)(cid:5)(cid:14)(cid:70)(cid:12)(cid:11)(cid:4)(cid:14)(cid:11)(cid:48)(cid:48)(cid:7)(cid:5)(cid:3)(cid:9)(cid:2)(cid:12)(cid:11)(cid:4)(cid:14)(cid:11)(cid:48)(cid:48)(cid:7)(cid:5)(cid:3)(cid:9)(cid:2)(cid:28)(cid:3,,3211.0
,,26,,,Unknown,,cid:3)(cid:5)(cid:14)(cid:70)(cid:12)(cid:11)(cid:4)(cid:14)(cid:11)(cid:48)(cid:48)(cid:7)(cid:5)(cid:3)(cid:9)(cid:2)(cid:12)(cid:11)(cid:4)(cid:14)(cid:11)(cid:48)(cid:48)(cid:7)(cid:5)(cid:3)(cid:9)(cid:2)(cid:28)(cid:3,,3237.0
,,41,,,Unknown,,cid:3)(cid:5)(cid:14)(cid:70)(cid:12)(cid:11)(cid:4)(cid:14)(cid:11)(cid:48)(cid:48)(cid:7)(cid:5)(cid:3)(cid:9)(cid:2)(cid:12)(cid:11)(cid:4)(cid:14)(cid:11)(cid:48)(cid:48)(cid:7)(cid:5)(cid:3)(cid:9)(cid:2)(cid:28)(cid:3,,3278.0
,,25,,,Unknown,,cid:3)(cid:5)(cid:14)(cid:70)(cid:12)(cid:11)(cid:4)(cid:14)(cid:11)(cid:48)(cid:48)(cid:7)(cid:5)(cid:3)(cid:9)(cid:2)(cid:12)(cid:11)(cid:4)(cid:14)(cid:11)(cid:48)(cid:48)(cid:7)(cid:5)(cid:3)(cid:9)(cid:2)(cid:28)(cid:3,,3303.0
,,2,,,Unknown,,cid:3)(cid:5)(cid:14)(cid:70)(cid:12)(cid:11)(cid:4)(cid:14)(cid:11)(cid:48)(cid:48)(cid:7)(cid:5)(cid:3)(cid:9)(cid:2)(cid:12)(cid:11)(cid:4)(cid:14)(cid:11)(cid:48)(cid:48)(cid:7)(cid:5)(cid:3)(cid:9)(cid:2)(cid:28)(cid:3,,3305.0
,,58,,,Unknown,,cid:3)(cid:5)(cid:14)(cid:70)(cid:12)(cid:11)(cid:4)(cid:14)(cid:11)(cid:48)(cid:48)(cid:7)(cid:5)(cid:3)(cid:9)(cid:2)(cid:12)(cid:11)(cid:4)(cid:14)(cid:11)(cid:48)(cid:48)(cid:7)(cid:5)(cid:3)(cid:9)(cid:2)(cid:28)(cid:3,,3363.0
,,58,,,Unknown,,cid:3)(cid:5)(cid:14)(cid:70)(cid:12)(cid:11)(cid:4)(cid:14)(cid:11)(cid:48)(cid:48)(cid:7)(cid:5)(cid:3)(cid:9)(cid:2)(cid:12)(cid:11)(cid:4)(cid:14)(cid:11)(cid:48)(cid:48)(cid:7)(cid:5)(cid:3)(cid:9)(cid:2)(cid:28)(cid:3,,3421.0
,,37,,,Unknown,,cid:3)(cid:5)(cid:14)(cid:70)(cid:12)(cid:11)(cid:4)(cid:14)(cid:11)(cid:48)(cid:48)(cid:7)(cid:5)(cid:3)(cid:9)(cid:2)(cid:12)(cid:11)(cid:4)(cid:14)(cid:11)(cid:48)(cid:48)(cid:7)(cid:5)(cid:3)(cid:9)(cid:2)(cid:28)(cid:3,,3458.0
,,16,,,Unknown,,cid:3)(cid:5)(cid:14)(cid:70)(cid:12)(cid:11)(cid:4)(cid:14)(cid:11)(cid:48)(cid:48)(cid:7)(cid:5)(cid:3)(cid:9)(cid:2)(cid:12)(cid:11)(cid:4)(cid:14)(cid:11)(cid:48)(cid:48)(cid:7)(cid:5)(cid:3)(cid:9)(cid:2)(cid:28)(cid:3,,3474.0
,,34,,,Unknown,,cid:3)(cid:5)(cid:14)(cid:70)(cid:12)(cid:11)(cid:4)(cid:14)(cid:11)(cid:48)(cid:48)(cid:7)(cid:5)(cid:3)(cid:9)(cid:2)(cid:12)(cid:11)(cid:4)(cid:14)(cid:11)(cid:48)(cid:48)(cid:7)(cid:5)(cid:3)(cid:9)(cid:2)(cid:28)(cid:3,,3508.0
,,33,,,Unknown,,cid:3)(cid:5)(cid:14)(cid:70)(cid:12)(cid:11)(cid:4)(cid:14)(cid:11)(cid:48)(cid:48)(cid:7)(cid:5)(cid:3)(cid:9)(cid:2)(cid:12)(cid:11)(cid:4)(cid:14)(cid:11)(cid:48)(cid:48)(cid:7)(cid:5)(cid:3)(cid:9)(cid:2)(cid:28)(cid:3,,3541.0
,,17,,,Unknown,,cid:3)(cid:5)(cid:14)(cid:70)(cid:12)(cid:11)(cid:4)(cid:14)(cid:11)(cid:48)(cid:48)(cid:7)(cid:5)(cid:3)(cid:9)(cid:2)(cid:12)(cid:11)(cid:4)(cid:14)(cid:11)(cid:48)(cid:48)(cid:7)(cid:5)(cid:3)(cid:9)(cid:2)(cid:28)(cid:3,,3558.0
,,17,,,Unknown,,cid:3)(cid:5)(cid:14)(cid:70)(cid:12)(cid:11)(cid:4)(cid:14)(cid:11)(cid:48)(cid:48)(cid:7)(cid:5)(cid:3)(cid:9)(cid:2)(cid:12)(cid:11)(cid:4)(cid:14)(cid:11)(cid:48)(cid:48)(cid:7)(cid:5)(cid:3)(cid:9)(cid:2)(cid:28)(cid:3,,3575.0
,,45,,,Unknown,,cid:3)(cid:5)(cid:14)(cid:70)(cid:12)(cid:11)(cid:4)(cid:14)(cid:11)(cid:48)(cid:48)(cid:7)(cid:5)(cid:3)(cid:9)(cid:2)(cid:12)(cid:11)(cid:4)(cid:14)(cid:11)(cid:48)(cid:48)(cid:7)(cid:5)(cid:3)(cid:9)(cid:2)(cid:28)(cid:3,,3620.0
,,18,,,Unknown,,cid:3)(cid:5)(cid:14)(cid:70)(cid:12)(cid:11)(cid:4)(cid:14)(cid:11)(cid:48)(cid:48)(cid:7)(cid:5)(cid:3)(cid:9)(cid:2)(cid:12)(cid:11)(cid:4)(cid:14)(cid:11)(cid:48)(cid:48)(cid:7)(cid:5)(cid:3)(cid:9)(cid:2)(cid:28)(cid:3,,3638.0
,,16,,,Unknown,,cid:3)(cid:5)(cid:14)(cid:70)(cid:12)(cid:11)(cid:4)(cid:14)(cid:11)(cid:48)(cid:48)(cid:7)(cid:5)(cid:3)(cid:9)(cid:2)(cid:12)(cid:11)(cid:4)(cid:14)(cid:11)(cid:48)(cid:48)(cid:7)(cid:5)(cid:3)(cid:9)(cid:2)(cid:28)(cid:3,,3654.0
,,14,,,Unknown,,cid:3)(cid:5)(cid:14)(cid:70)(cid:12)(cid:11)(cid:4)(cid:14)(cid:11)(cid:48)(cid:48)(cid:7)(cid:5)(cid:3)(cid:9)(cid:2)(cid:12)(cid:11)(cid:4)(cid:14)(cid:11)(cid:48)(cid:48)(cid:7)(cid:5)(cid:3)(cid:9)(cid:2)(cid:28)(cid:3,,3668.0
,,5,,,Unknown,,cid:3)(cid:5)(cid:14)(cid:70)(cid:12)(cid:11)(cid:4)(cid:14)(cid:11)(cid:48)(cid:48)(cid:7)(cid:5)(cid:3)(cid:9)(cid:2)(cid:12)(cid:11)(cid:4)(cid:14)(cid:11)(cid:48)(cid:48)(cid:7)(cid:5)(cid:3)(cid:9)(cid:2)(cid:28)(cid:3,,3673.0
,,12,,,Unknown,,cid:3)(cid:5)(cid:14)(cid:70)(cid:12)(cid:11)(cid:4)(cid:14)(cid:11)(cid:48)(cid:48)(cid:7)(cid:5)(cid:3)(cid:9)(cid:2)(cid:12)(cid:11)(cid:4)(cid:14)(cid:11)(cid:48)(cid:48)(cid:7)(cid:5)(cid:3)(cid:9)(cid:2)(cid:28)(cid:3,,3685.0
,,14,,,Unknown,,cid:3)(cid:5)(cid:14)(cid:70)(cid:12)(cid:11)(cid:4)(cid:14)(cid:11)(cid:48)(cid:48)(cid:7)(cid:5)(cid:3)(cid:9)(cid:2)(cid:12)(cid:11)(cid:4)(cid:14)(cid:11)(cid:48)(cid:48)(cid:7)(cid:5)(cid:3)(cid:9)(cid:2)(cid:28)(cid:3,,3699.0
,,5,,,Unknown,,cid:3)(cid:5)(cid:14)(cid:70)(cid:12)(cid:11)(cid:4)(cid:14)(cid:11)(cid:48)(cid:48)(cid:7)(cid:5)(cid:3)(cid:9)(cid:2)(cid:12)(cid:11)(cid:4)(cid:14)(cid:11)(cid:48)(cid:48)(cid:7)(cid:5)(cid:3)(cid:9)(cid:2)(cid:28)(cid:3,,3704.0
,,3,,,Unknown,,cid:3)(cid:5)(cid:14)(cid:70)(cid:12)(cid:11)(cid:4)(cid:14)(cid:11)(cid:48)(cid:48)(cid:7)(cid:5)(cid:3)(cid:9)(cid:2)(cid:12)(cid:11)(cid:4)(cid:14)(cid:11)(cid:48)(cid:48)(cid:7)(cid:5)(cid:3)(cid:9)(cid:2)(cid:28)(cid:3,,3707.0
,,12,,,Unknown,,cid:3)(cid:5)(cid:14)(cid:70)(cid:12)(cid:11)(cid:4)(cid:14)(cid:11)(cid:48)(cid:48)(cid:7)(cid:5)(cid:3)(cid:9)(cid:2)(cid:12)(cid:11)(cid:4)(cid:14)(cid:11)(cid:48)(cid:48)(cid:7)(cid:5)(cid:3)(cid:9)(cid:2)(cid:28)(cid:3,,3719.0
,,2,,,Unknown,,cid:3)(cid:5)(cid:14)(cid:70)(cid:12)(cid:11)(cid:4)(cid:14)(cid:11)(cid:48)(cid:48)(cid:7)(cid:5)(cid:3)(cid:9)(cid:2)(cid:12)(cid:11)(cid:4)(cid:14)(cid:11)(cid:48)(cid:48)(cid:7)(cid:5)(cid:3)(cid:9)(cid:2)(cid:28)(cid:3,,3721.0
,,50,,,Unknown,,cid:3)(cid:5)(cid:14)(cid:70)(cid:12)(cid:11)(cid:4)(cid:14)(cid:11)(cid:48)(cid:48)(cid:7)(cid:5)(cid:3)(cid:9)(cid:2)(cid:12)(cid:11)(cid:4)(cid:14)(cid:11)(cid:48)(cid:48)(cid:7)(cid:5)(cid:3)(cid:9)(cid:2)(cid:28)(cid:3,,3771.0
,,7,,,Unknown,,cid:3)(cid:5)(cid:14)(cid:70)(cid:12)(cid:11)(cid:4)(cid:14)(cid:11)(cid:48)(cid:48)(cid:7)(cid:5)(cid:3)(cid:9)(cid:2)(cid:12)(cid:11)(cid:4)(cid:14)(cid:11)(cid:48)(cid:48)(cid:7)(cid:5)(cid:3)(cid:9)(cid:2)(cid:28)(cid:3,,3778.0
,,9,,,Unknown,,cid:3)(cid:5)(cid:14)(cid:70)(cid:12)(cid:11)(cid:4)(cid:14)(cid:11)(cid:48)(cid:48)(cid:7)(cid:5)(cid:3)(cid:9)(cid:2)(cid:12)(cid:11)(cid:4)(cid:14)(cid:11)(cid:48)(cid:48)(cid:7)(cid:5)(cid:3)(cid:9)(cid:2)(cid:28)(cid:3,,3787.0
,,10,,,Unknown,,cid:3)(cid:5)(cid:14)(cid:70)(cid:12)(cid:11)(cid:4)(cid:14)(cid:11)(cid:48)(cid:48)(cid:7)(cid:5)(cid:3)(cid:9)(cid:2)(cid:12)(cid:11)(cid:4)(cid:14)(cid:11)(cid:48)(cid:48)(cid:7)(cid:5)(cid:3)(cid:9)(cid:2)(cid:28)(cid:3,,3797.0
,,3,,,Unknown,,cid:3)(cid:5)(cid:14)(cid:70)(cid:12)(cid:11)(cid:4)(cid:14)(cid:11)(cid:48)(cid:48)(cid:7)(cid:5)(cid:3)(cid:9)(cid:2)(cid:12)(cid:11)(cid:4)(cid:14)(cid:11)(cid:48)(cid:48)(cid:7)(cid:5)(cid:3)(cid:9)(cid:2)(cid:28)(cid:3,,3800.0
,,2,,,Unknown,,cid:3)(cid:5)(cid:14)(cid:70)(cid:12)(cid:11)(cid:4)(cid:14)(cid:11)(cid:48)(cid:48)(cid:7)(cid:5)(cid:3)(cid:9)(cid:2)(cid:12)(cid:11)(cid:4)(cid:14)(cid:11)(cid:48)(cid:48)(cid:7)(cid:5)(cid:3)(cid:9)(cid:2)(cid:28)(cid:3,,3802.0
,,12,,,Unknown,,cid:3)(cid:5)(cid:14)(cid:70)(cid:12)(cid:11)(cid:4)(cid:14)(cid:11)(cid:48)(cid:48)(cid:7)(cid:5)(cid:3)(cid:9)(cid:2)(cid:12)(cid:11)(cid:4)(cid:14)(cid:11)(cid:48)(cid:48)(cid:7)(cid:5)(cid:3)(cid:9)(cid:2)(cid:28)(cid:3,,3814.0
,,11,,,Unknown,,cid:3)(cid:5)(cid:14)(cid:70)(cid:12)(cid:11)(cid:4)(cid:14)(cid:11)(cid:48)(cid:48)(cid:7)(cid:5)(cid:3)(cid:9)(cid:2)(cid:12)(cid:11)(cid:4)(cid:14)(cid:11)(cid:48)(cid:48)(cid:7)(cid:5)(cid:3)(cid:9)(cid:2)(cid:28)(cid:3,,3825.0
,,4,,,Unknown,,cid:3)(cid:5)(cid:14)(cid:70)(cid:12)(cid:11)(cid:4)(cid:14)(cid:11)(cid:48)(cid:48)(cid:7)(cid:5)(cid:3)(cid:9)(cid:2)(cid:12)(cid:11)(cid:4)(cid:14)(cid:11)(cid:48)(cid:48)(cid:7)(cid:5)(cid:3)(cid:9)(cid:2)(cid:28)(cid:3,,3829.0
,,14,,,Unknown,,cid:3)(cid:5)(cid:14)(cid:70)(cid:12)(cid:11)(cid:4)(cid:14)(cid:11)(cid:48)(cid:48)(cid:7)(cid:5)(cid:3)(cid:9)(cid:2)(cid:12)(cid:11)(cid:4)(cid:14)(cid:11)(cid:48)(cid:48)(cid:7)(cid:5)(cid:3)(cid:9)(cid:2)(cid:28)(cid:3,,3843.0
,,11,,,Unknown,,cid:3)(cid:5)(cid:14)(cid:70)(cid:12)(cid:11)(cid:4)(cid:14)(cid:11)(cid:48)(cid:48)(cid:7)(cid:5)(cid:3)(cid:9)(cid:2)(cid:12)(cid:11)(cid:4)(cid:14)(cid:11)(cid:48)(cid:48)(cid:7)(cid:5)(cid:3)(cid:9)(cid:2)(cid:28)(cid:3,,3854.0
,,48,,,Unknown,,cid:3)(cid:5)(cid:14)(cid:70)(cid:12)(cid:11)(cid:4)(cid:14)(cid:11)(cid:48)(cid:48)(cid:7)(cid:5)(cid:3)(cid:9)(cid:2)(cid:12)(cid:11)(cid:4)(cid:14)(cid:11)(cid:48)(cid:48)(cid:7)(cid:5)(cid:3)(cid:9)(cid:2)(cid:28)(cid:3,,3902.0
,,48,,,Unknown,,cid:3)(cid:5)(cid:14)(cid:70)(cid:12)(cid:11)(cid:4)(cid:14)(cid:11)(cid:48)(cid:48)(cid:7)(cid:5)(cid:3)(cid:9)(cid:2)(cid:12)(cid:11)(cid:4)(cid:14)(cid:11)(cid:48)(cid:48)(cid:7)(cid:5)(cid:3)(cid:9)(cid:2)(cid:28)(cid:3,,3950.0
,,7,,,Unknown,,cid:3)(cid:5)(cid:14)(cid:70)(cid:12)(cid:11)(cid:4)(cid:14)(cid:11)(cid:48)(cid:48)(cid:7)(cid:5)(cid:3)(cid:9)(cid:2)(cid:12)(cid:11)(cid:4)(cid:14)(cid:11)(cid:48)(cid:48)(cid:7)(cid:5)(cid:3)(cid:9)(cid:2)(cid:28)(cid:3,,3957.0
,,5,,,Unknown,,cid:3)(cid:5)(cid:14)(cid:70)(cid:12)(cid:11)(cid:4)(cid:14)(cid:11)(cid:48)(cid:48)(cid:7)(cid:5)(cid:3)(cid:9)(cid:2)(cid:12)(cid:11)(cid:4)(cid:14)(cid:11)(cid:48)(cid:48)(cid:7)(cid:5)(cid:3)(cid:9)(cid:2)(cid:28)(cid:3,,3962.0
,,3,,,Unknown,,cid:3)(cid:5)(cid:14)(cid:70)(cid:12)(cid:11)(cid:4)(cid:14)(cid:11)(cid:48)(cid:48)(cid:7)(cid:5)(cid:3)(cid:9)(cid:2)(cid:12)(cid:11)(cid:4)(cid:14)(cid:11)(cid:48)(cid:48)(cid:7)(cid:5)(cid:3)(cid:9)(cid:2)(cid:28)(cid:3,,3965.0
,,2,,,Unknown,,cid:3)(cid:5)(cid:14)(cid:70)(cid:12)(cid:11)(cid:4)(cid:14)(cid:11)(cid:48)(cid:48)(cid:7)(cid:5)(cid:3)(cid:9)(cid:2)(cid:12)(cid:11)(cid:4)(cid:14)(cid:11)(cid:48)(cid:48)(cid:7)(cid:5)(cid:3)(cid:9)(cid:2)(cid:28)(cid:3,,3967.0
,,28,,,Unknown,,cid:3)(cid:5)(cid:14)(cid:70)(cid:12)(cid:11)(cid:4)(cid:14)(cid:11)(cid:48)(cid:48)(cid:7)(cid:5)(cid:3)(cid:9)(cid:2)(cid:12)(cid:11)(cid:4)(cid:14)(cid:11)(cid:48)(cid:48)(cid:7)(cid:5)(cid:3)(cid:9)(cid:2)(cid:28)(cid:3,,3995.0
,,3,,,Unknown,,cid:3)(cid:5)(cid:14)(cid:70)(cid:12)(cid:11)(cid:4)(cid:14)(cid:11)(cid:48)(cid:48)(cid:7)(cid:5)(cid:3)(cid:9)(cid:2)(cid:12)(cid:11)(cid:4)(cid:14)(cid:11)(cid:48)(cid:48)(cid:7)(cid:5)(cid:3)(cid:9)(cid:2)(cid:28)(cid:3,,3998.0
,,15,,,Unknown,,cid:3)(cid:5)(cid:14)(cid:70)(cid:12)(cid:11)(cid:4)(cid:14)(cid:11)(cid:48)(cid:48)(cid:7)(cid:5)(cid:3)(cid:9)(cid:2)(cid:12)(cid:11)(cid:4)(cid:14)(cid:11)(cid:48)(cid:48)(cid:7)(cid:5)(cid:3)(cid:9)(cid:2)(cid:28)(cid:3,,4013.0
,,2,,,Unknown,,cid:3)(cid:5)(cid:14)(cid:70)(cid:12)(cid:11)(cid:4)(cid:14)(cid:11)(cid:48)(cid:48)(cid:7)(cid:5)(cid:3)(cid:9)(cid:2)(cid:12)(cid:11)(cid:4)(cid:14)(cid:11)(cid:48)(cid:48)(cid:7)(cid:5)(cid:3)(cid:9)(cid:2)(cid:28)(cid:3,,4015.0
,,1,,,Unknown,,cid:3)(cid:5)(cid:14)(cid:70)(cid:12)(cid:11)(cid:4)(cid:14)(cid:11)(cid:48)(cid:48)(cid:7)(cid:5)(cid:3)(cid:9)(cid:2)(cid:12)(cid:11)(cid:4)(cid:14)(cid:11)(cid:48)(cid:48)(cid:7)(cid:5)(cid:3)(cid:9)(cid:2)(cid:28)(cid:3,,4016.0
,,37,,,Unknown,,cid:3)(cid:5)(cid:14)(cid:70)(cid:12)(cid:11)(cid:4)(cid:14)(cid:11)(cid:48)(cid:48)(cid:7)(cid:5)(cid:3)(cid:9)(cid:2)(cid:12)(cid:11)(cid:4)(cid:14)(cid:11)(cid:48)(cid:48)(cid:7)(cid:5)(cid:3)(cid:9)(cid:2)(cid:28)(cid:3,,4053.0
,,18,,,Unknown,,cid:3)(cid:5)(cid:14)(cid:70)(cid:12)(cid:11)(cid:4)(cid:14)(cid:11)(cid:48)(cid:48)(cid:7)(cid:5)(cid:3)(cid:9)(cid:2)(cid:12)(cid:11)(cid:4)(cid:14)(cid:11)(cid:48)(cid:48)(cid:7)(cid:5)(cid:3)(cid:9)(cid:2)(cid:28)(cid:3,,4071.0
,,19,,,Unknown,,cid:3)(cid:5)(cid:14)(cid:70)(cid:12)(cid:11)(cid:4)(cid:14)(cid:11)(cid:48)(cid:48)(cid:7)(cid:5)(cid:3)(cid:9)(cid:2)(cid:12)(cid:11)(cid:4)(cid:14)(cid:11)(cid:48)(cid:48)(cid:7)(cid:5)(cid:3)(cid:9)(cid:2)(cid:28)(cid:3,,4090.0
,,17,,,Unknown,,cid:3)(cid:5)(cid:14)(cid:70)(cid:12)(cid:11)(cid:4)(cid:14)(cid:11)(cid:48)(cid:48)(cid:7)(cid:5)(cid:3)(cid:9)(cid:2)(cid:12)(cid:11)(cid:4)(cid:14)(cid:11)(cid:48)(cid:48)(cid:7)(cid:5)(cid:3)(cid:9)(cid:2)(cid:28)(cid:3,,4107.0
,,1,,,Unknown,,cid:3)(cid:5)(cid:14)(cid:70)(cid:12)(cid:11)(cid:4)(cid:14)(cid:11)(cid:48)(cid:48)(cid:7)(cid:5)(cid:3)(cid:9)(cid:2)(cid:12)(cid:11)(cid:4)(cid:14)(cid:11)(cid:48)(cid:48)(cid:7)(cid:5)(cid:3)(cid:9)(cid:2)(cid:28)(cid:3,,4108.0
,,2,,,Unknown,,cid:3)(cid:5)(cid:14)(cid:70)(cid:12)(cid:11)(cid:4)(cid:14)(cid:11)(cid:48)(cid:48)(cid:7)(cid:5)(cid:3)(cid:9)(cid:2)(cid:12)(cid:11)(cid:4)(cid:14)(cid:11)(cid:48)(cid:48)(cid:7)(cid:5)(cid:3)(cid:9)(cid:2)(cid:28)(cid:3,,4110.0
,,44,,,Unknown,,cid:3)(cid:5)(cid:14)(cid:70)(cid:12)(cid:11)(cid:4)(cid:14)(cid:11)(cid:48)(cid:48)(cid:7)(cid:5)(cid:3)(cid:9)(cid:2)(cid:12)(cid:11)(cid:4)(cid:14)(cid:11)(cid:48)(cid:48)(cid:7)(cid:5)(cid:3)(cid:9)(cid:2)(cid:28)(cid:3,,4154.0
,,12,,,Unknown,,cid:3)(cid:5)(cid:14)(cid:70)(cid:12)(cid:11)(cid:4)(cid:14)(cid:11)(cid:48)(cid:48)(cid:7)(cid:5)(cid:3)(cid:9)(cid:2)(cid:12)(cid:11)(cid:4)(cid:14)(cid:11)(cid:48)(cid:48)(cid:7)(cid:5)(cid:3)(cid:9)(cid:2)(cid:28)(cid:3,,4166.0
,,29,,,Unknown,,cid:3)(cid:5)(cid:14)(cid:70)(cid:12)(cid:11)(cid:4)(cid:14)(cid:11)(cid:48)(cid:48)(cid:7)(cid:5)(cid:3)(cid:9)(cid:2)(cid:12)(cid:11)(cid:4)(cid:14)(cid:11)(cid:48)(cid:48)(cid:7)(cid:5)(cid:3)(cid:9)(cid:2)(cid:28)(cid:3,,4195.0
,,26,,,Unknown,,cid:3)(cid:5)(cid:14)(cid:70)(cid:12)(cid:11)(cid:4)(cid:14)(cid:11)(cid:48)(cid:48)(cid:7)(cid:5)(cid:3)(cid:9)(cid:2)(cid:12)(cid:11)(cid:4)(cid:14)(cid:11)(cid:48)(cid:48)(cid:7)(cid:5)(cid:3)(cid:9)(cid:2)(cid:28)(cid:3,,4221.0
,,41,,,Unknown,,cid:3)(cid:5)(cid:14)(cid:70)(cid:12)(cid:11)(cid:4)(cid:14)(cid:11)(cid:48)(cid:48)(cid:7)(cid:5)(cid:3)(cid:9)(cid:2)(cid:12)(cid:11)(cid:4)(cid:14)(cid:11)(cid:48)(cid:48)(cid:7)(cid:5)(cid:3)(cid:9)(cid:2)(cid:28)(cid:3,,4262.0
,,25,,,Unknown,,cid:3)(cid:5)(cid:14)(cid:70)(cid:12)(cid:11)(cid:4)(cid:14)(cid:11)(cid:48)(cid:48)(cid:7)(cid:5)(cid:3)(cid:9)(cid:2)(cid:12)(cid:11)(cid:4)(cid:14)(cid:11)(cid:48)(cid:48)(cid:7)(cid:5)(cid:3)(cid:9)(cid:2)(cid:28)(cid:3,,4287.0
,,2,,,Unknown,,cid:3)(cid:5)(cid:14)(cid:70)(cid:12)(cid:11)(cid:4)(cid:14)(cid:11)(cid:48)(cid:48)(cid:7)(cid:5)(cid:3)(cid:9)(cid:2)(cid:12)(cid:11)(cid:4)(cid:14)(cid:11)(cid:48)(cid:48)(cid:7)(cid:5)(cid:3)(cid:9)(cid:2)(cid:28)(cid:3,,4289.0
,,58,,,Unknown,,cid:3)(cid:5)(cid:14)(cid:70)(cid:12)(cid:11)(cid:4)(cid:14)(cid:11)(cid:48)(cid:48)(cid:7)(cid:5)(cid:3)(cid:9)(cid:2)(cid:12)(cid:11)(cid:4)(cid:14)(cid:11)(cid:48)(cid:48)(cid:7)(cid:5)(cid:3)(cid:9)(cid:2)(cid:28)(cid:3,,4347.0
,,58,,,Unknown,,cid:3)(cid:5)(cid:14)(cid:70)(cid:12)(cid:11)(cid:4)(cid:14)(cid:11)(cid:48)(cid:48)(cid:7)(cid:5)(cid:3)(cid:9)(cid:2)(cid:12)(cid:11)(cid:4)(cid:14)(cid:11)(cid:48)(cid:48)(cid:7)(cid:5)(cid:3)(cid:9)(cid:2)(cid:28)(cid:3,,4405.0
,,37,,,Unknown,,cid:3)(cid:5)(cid:14)(cid:70)(cid:12)(cid:11)(cid:4)(cid:14)(cid:11)(cid:48)(cid:48)(cid:7)(cid:5)(cid:3)(cid:9)(cid:2)(cid:12)(cid:11)(cid:4)(cid:14)(cid:11)(cid:48)(cid:48)(cid:7)(cid:5)(cid:3)(cid:9)(cid:2)(cid:28)(cid:3,,4442.0
,,16,,,Unknown,,cid:3)(cid:5)(cid:14)(cid:70)(cid:12)(cid:11)(cid:4)(cid:14)(cid:11)(cid:48)(cid:48)(cid:7)(cid:5)(cid:3)(cid:9)(cid:2)(cid:12)(cid:11)(cid:4)(cid:14)(cid:11)(cid:48)(cid:48)(cid:7)(cid:5)(cid:3)(cid:9)(cid:2)(cid:28)(cid:3,,4458.0
,,34,,,Unknown,,cid:3)(cid:5)(cid:14)(cid:70)(cid:12)(cid:11)(cid:4)(cid:14)(cid:11)(cid:48)(cid:48)(cid:7)(cid:5)(cid:3)(cid:9)(cid:2)(cid:12)(cid:11)(cid:4)(cid:14)(cid:11)(cid:48)(cid:48)(cid:7)(cid:5)(cid:3)(cid:9)(cid:2)(cid:28)(cid:3,,4492.0
,,33,,,Unknown,,cid:3)(cid:5)(cid:14)(cid:70)(cid:12)(cid:11)(cid:4)(cid:14)(cid:11)(cid:48)(cid:48)(cid:7)(cid:5)(cid:3)(cid:9)(cid:2)(cid:12)(cid:11)(cid:4)(cid:14)(cid:11)(cid:48)(cid:48)(cid:7)(cid:5)(cid:3)(cid:9)(cid:2)(cid:28)(cid:3,,4525.0
,,17,,,Unknown,,cid:3)(cid:5)(cid:14)(cid:70)(cid:12)(cid:11)(cid:4)(cid:14)(cid:11)(cid:48)(cid:48)(cid:7)(cid:5)(cid:3)(cid:9)(cid:2)(cid:12)(cid:11)(cid:4)(cid:14)(cid:11)(cid:48)(cid:48)(cid:7)(cid:5)(cid:3)(cid:9)(cid:2)(cid:28)(cid:3,,4542.0
,,1,,,Unknown,,cid:3)(cid:5)(cid:14)(cid:70)(cid:12)(cid:11)(cid:4)(cid:14)(cid:11)(cid:48)(cid:48)(cid:7)(cid:5)(cid:3)(cid:9)(cid:2)(cid:12)(cid:11)(cid:4)(cid:14)(cid:11)(cid:48)(cid:48)(cid:7)(cid:5)(cid:3)(cid:9)(cid:2)(cid:28)(cid:3,,4543.0
,,45,,,Unknown,,cid:3)(cid:5)(cid:14)(cid:70)(cid:12)(cid:11)(cid:4)(cid:14)(cid:11)(cid:48)(cid:48)(cid:7)(cid:5)(cid:3)(cid:9)(cid:2)(cid:12)(cid:11)(cid:4)(cid:14)(cid:11)(cid:48)(cid:48)(cid:7)(cid:5)(cid:3)(cid:9)(cid:2)(cid:28)(cid:3,,4588.0
,,18,,,Unknown,,cid:3)(cid:5)(cid:14)(cid:70)(cid:12)(cid:11)(cid:4)(cid:14)(cid:11)(cid:48)(cid:48)(cid:7)(cid:5)(cid:3)(cid:9)(cid:2)(cid:12)(cid:11)(cid:4)(cid:14)(cid:11)(cid:48)(cid:48)(cid:7)(cid:5)(cid:3)(cid:9)(cid:2)(cid:28)(cid:3,,4606.0
,,16,,,Unknown,,cid:3)(cid:5)(cid:14)(cid:70)(cid:12)(cid:11)(cid:4)(cid:14)(cid:11)(cid:48)(cid:48)(cid:7)(cid:5)(cid:3)(cid:9)(cid:2)(cid:12)(cid:11)(cid:4)(cid:14)(cid:11)(cid:48)(cid:48)(cid:7)(cid:5)(cid:3)(cid:9)(cid:2)(cid:28)(cid:3,,4622.0
,,9,,,Unknown,,cid:3)(cid:5)(cid:14)(cid:70)(cid:12)(cid:11)(cid:4)(cid:14)(cid:11)(cid:48)(cid:48)(cid:7)(cid:5)(cid:3)(cid:9)(cid:2)(cid:12)(cid:11)(cid:4)(cid:14)(cid:11)(cid:48)(cid:48)(cid:7)(cid:5)(cid:3)(cid:9)(cid:2)(cid:28)(cid:3,,4631.0
,,46,,,Unknown,,cid:3)(cid:5)(cid:14)(cid:70)(cid:12)(cid:11)(cid:4)(cid:14)(cid:11)(cid:48)(cid:48)(cid:7)(cid:5)(cid:3)(cid:9)(cid:2)(cid:12)(cid:11)(cid:4)(cid:14)(cid:11)(cid:48)(cid:48)(cid:7)(cid:5)(cid:3)(cid:9)(cid:2)(cid:28)(cid:3,,4677.0
,,3,,,Unknown,,cid:3)(cid:5)(cid:14)(cid:70)(cid:12)(cid:11)(cid:4)(cid:14)(cid:11)(cid:48)(cid:48)(cid:7)(cid:5)(cid:3)(cid:9)(cid:2)(cid:12)(cid:11)(cid:4)(cid:14)(cid:11)(cid:48)(cid:48)(cid:7)(cid:5)(cid:3)(cid:9)(cid:2)(cid:28)(cid:3,,4680.0
,,14,,,Unknown,,cid:3)(cid:5)(cid:14)(cid:70)(cid:12)(cid:11)(cid:4)(cid:14)(cid:11)(cid:48)(cid:48)(cid:7)(cid:5)(cid:3)(cid:9)(cid:2)(cid:12)(cid:11)(cid:4)(cid:14)(cid:11)(cid:48)(cid:48)(cid:7)(cid:5)(cid:3)(cid:9)(cid:2)(cid:28)(cid:3,,4694.0
,,2,,,Unknown,,cid:3)(cid:5)(cid:14)(cid:70)(cid:12)(cid:11)(cid:4)(cid:14)(cid:11)(cid:48)(cid:48)(cid:7)(cid:5)(cid:3)(cid:9)(cid:2)(cid:12)(cid:11)(cid:4)(cid:14)(cid:11)(cid:48)(cid:48)(cid:7)(cid:5)(cid:3)(cid:9)(cid:2)(cid:28)(cid:3,,4696.0
,,65,,,Unknown,,cid:3)(cid:5)(cid:14)(cid:70)(cid:12)(cid:11)(cid:4)(cid:14)(cid:11)(cid:48)(cid:48)(cid:7)(cid:5)(cid:3)(cid:9)(cid:2)(cid:12)(cid:11)(cid:4)(cid:14)(cid:11)(cid:48)(cid:48)(cid:7)(cid:5)(cid:3)(cid:9)(cid:2)(cid:28)(cid:3,,4761.0
,,39,,,Unknown,,cid:3)(cid:5)(cid:14)(cid:70)(cid:12)(cid:11)(cid:4)(cid:14)(cid:11)(cid:48)(cid:48)(cid:7)(cid:5)(cid:3)(cid:9)(cid:2)(cid:12)(cid:11)(cid:4)(cid:14)(cid:11)(cid:48)(cid:48)(cid:7)(cid:5)(cid:3)(cid:9)(cid:2)(cid:28)(cid:3,,4800.0
,,46,,,Unknown,,cid:3)(cid:5)(cid:14)(cid:70)(cid:12)(cid:11)(cid:4)(cid:14)(cid:11)(cid:48)(cid:48)(cid:7)(cid:5)(cid:3)(cid:9)(cid:2)(cid:12)(cid:11)(cid:4)(cid:14)(cid:11)(cid:48)(cid:48)(cid:7)(cid:5)(cid:3)(cid:9)(cid:2)(cid:28)(cid:3,,4846.0
,,2,,,Unknown,,cid:3)(cid:5)(cid:14)(cid:70)(cid:12)(cid:11)(cid:4)(cid:14)(cid:11)(cid:48)(cid:48)(cid:7)(cid:5)(cid:3)(cid:9)(cid:2)(cid:12)(cid:11)(cid:4)(cid:14)(cid:11)(cid:48)(cid:48)(cid:7)(cid:5)(cid:3)(cid:9)(cid:2)(cid:28)(cid:3,,4848.0
,,48,,,Unknown,,cid:3)(cid:5)(cid:14)(cid:70)(cid:12)(cid:11)(cid:4)(cid:14)(cid:11)(cid:48)(cid:48)(cid:7)(cid:5)(cid:3)(cid:9)(cid:2)(cid:12)(cid:11)(cid:4)(cid:14)(cid:11)(cid:48)(cid:48)(cid:7)(cid:5)(cid:3)(cid:9)(cid:2)(cid:28)(cid:3,,4896.0
,,46,,,Unknown,,cid:3)(cid:5)(cid:14)(cid:70)(cid:12)(cid:11)(cid:4)(cid:14)(cid:11)(cid:48)(cid:48)(cid:7)(cid:5)(cid:3)(cid:9)(cid:2)(cid:12)(cid:11)(cid:4)(cid:14)(cid:11)(cid:48)(cid:48)(cid:7)(cid:5)(cid:3)(cid:9)(cid:2)(cid:28)(cid:3,,4942.0
,,3,,,Unknown,,cid:3)(cid:5)(cid:14)(cid:70)(cid:12)(cid:11)(cid:4)(cid:14)(cid:11)(cid:48)(cid:48)(cid:7)(cid:5)(cid:3)(cid:9)(cid:2)(cid:12)(cid:11)(cid:4)(cid:14)(cid:11)(cid:48)(cid:48)(cid:7)(cid:5)(cid:3)(cid:9)(cid:2)(cid:28)(cid:3,,4945.0
,,65,,,Unknown,,cid:3)(cid:5)(cid:14)(cid:70)(cid:12)(cid:11)(cid:4)(cid:14)(cid:11)(cid:48)(cid:48)(cid:7)(cid:5)(cid:3)(cid:9)(cid:2)(cid:12)(cid:11)(cid:4)(cid:14)(cid:11)(cid:48)(cid:48)(cid:7)(cid:5)(cid:3)(cid:9)(cid:2)(cid:28)(cid:3,,5010.0
,,5,,,Unknown,,cid:3)(cid:5)(cid:14)(cid:70)(cid:12)(cid:11)(cid:4)(cid:14)(cid:11)(cid:48)(cid:48)(cid:7)(cid:5)(cid:3)(cid:9)(cid:2)(cid:12)(cid:11)(cid:4)(cid:14)(cid:11)(cid:48)(cid:48)(cid:7)(cid:5)(cid:3)(cid:9)(cid:2)(cid:28)(cid:3,,5015.0
,,10,,,Unknown,,cid:3)(cid:5)(cid:14)(cid:70)(cid:12)(cid:11)(cid:4)(cid:14)(cid:11)(cid:48)(cid:48)(cid:7)(cid:5)(cid:3)(cid:9)(cid:2)(cid:12)(cid:11)(cid:4)(cid:14)(cid:11)(cid:48)(cid:48)(cid:7)(cid:5)(cid:3)(cid:9)(cid:2)(cid:28)(cid:3,,5025.0
,,2,,,Unknown,,cid:3)(cid:5)(cid:14)(cid:70)(cid:12)(cid:11)(cid:4)(cid:14)(cid:11)(cid:48)(cid:48)(cid:7)(cid:5)(cid:3)(cid:9)(cid:2)(cid:12)(cid:11)(cid:4)(cid:14)(cid:11)(cid:48)(cid:48)(cid:7)(cid:5)(cid:3)(cid:9)(cid:2)(cid:28)(cid:3,,5027.0
,,12,,,Unknown,,cid:3)(cid:5)(cid:14)(cid:70)(cid:12)(cid:11)(cid:4)(cid:14)(cid:11)(cid:48)(cid:48)(cid:7)(cid:5)(cid:3)(cid:9)(cid:2)(cid:12)(cid:11)(cid:4)(cid:14)(cid:11)(cid:48)(cid:48)(cid:7)(cid:5)(cid:3)(cid:9)(cid:2)(cid:28)(cid:3,,5039.0
,,11,,,Unknown,,cid:3)(cid:5)(cid:14)(cid:70)(cid:12)(cid:11)(cid:4)(cid:14)(cid:11)(cid:48)(cid:48)(cid:7)(cid:5)(cid:3)(cid:9)(cid:2)(cid:12)(cid:11)(cid:4)(cid:14)(cid:11)(cid:48)(cid:48)(cid:7)(cid:5)(cid:3)(cid:9)(cid:2)(cid:28)(cid:3,,5050.0
,,4,,,Unknown,,cid:3)(cid:5)(cid:14)(cid:70)(cid:12)(cid:11)(cid:4)(cid:14)(cid:11)(cid:48)(cid:48)(cid:7)(cid:5)(cid:3)(cid:9)(cid:2)(cid:12)(cid:11)(cid:4)(cid:14)(cid:11)(cid:48)(cid:48)(cid:7)(cid:5)(cid:3)(cid:9)(cid:2)(cid:28)(cid:3,,5054.0
,,14,,,Unknown,,cid:3)(cid:5)(cid:14)(cid:70)(cid:12)(cid:11)(cid:4)(cid:14)(cid:11)(cid:48)(cid:48)(cid:7)(cid:5)(cid:3)(cid:9)(cid:2)(cid:12)(cid:11)(cid:4)(cid:14)(cid:11)(cid:48)(cid:48)(cid:7)(cid:5)(cid:3)(cid:9)(cid:2)(cid:28)(cid:3,,5068.0
,,11,,,Unknown,,cid:3)(cid:5)(cid:14)(cid:70)(cid:12)(cid:11)(cid:4)(cid:14)(cid:11)(cid:48)(cid:48)(cid:7)(cid:5)(cid:3)(cid:9)(cid:2)(cid:12)(cid:11)(cid:4)(cid:14)(cid:11)(cid:48)(cid:48)(cid:7)(cid:5)(cid:3)(cid:9)(cid:2)(cid:28)(cid:3,,5079.0
,,48,,,Unknown,,cid:3)(cid:5)(cid:14)(cid:70)(cid:12)(cid:11)(cid:4)(cid:14)(cid:11)(cid:48)(cid:48)(cid:7)(cid:5)(cid:3)(cid:9)(cid:2)(cid:12)(cid:11)(cid:4)(cid:14)(cid:11)(cid:48)(cid:48)(cid:7)(cid:5)(cid:3)(cid:9)(cid:2)(cid:28)(cid:3,,5127.0
,,48,,,Unknown,,cid:3)(cid:5)(cid:14)(cid:70)(cid:12)(cid:11)(cid:4)(cid:14)(cid:11)(cid:48)(cid:48)(cid:7)(cid:5)(cid:3)(cid:9)(cid:2)(cid:12)(cid:11)(cid:4)(cid:14)(cid:11)(cid:48)(cid:48)(cid:7)(cid:5)(cid:3)(cid:9)(cid:2)(cid:28)(cid:3,,5175.0
,,7,,,Unknown,,cid:3)(cid:5)(cid:14)(cid:70)(cid:12)(cid:11)(cid:4)(cid:14)(cid:11)(cid:48)(cid:48)(cid:7)(cid:5)(cid:3)(cid:9)(cid:2)(cid:12)(cid:11)(cid:4)(cid:14)(cid:11)(cid:48)(cid:48)(cid:7)(cid:5)(cid:3)(cid:9)(cid:2)(cid:28)(cid:3,,5182.0
,,5,,,Unknown,,cid:3)(cid:5)(cid:14)(cid:70)(cid:12)(cid:11)(cid:4)(cid:14)(cid:11)(cid:48)(cid:48)(cid:7)(cid:5)(cid:3)(cid:9)(cid:2)(cid:12)(cid:11)(cid:4)(cid:14)(cid:11)(cid:48)(cid:48)(cid:7)(cid:5)(cid:3)(cid:9)(cid:2)(cid:28)(cid:3,,5187.0
,,3,,,Unknown,,cid:3)(cid:5)(cid:14)(cid:70)(cid:12)(cid:11)(cid:4)(cid:14)(cid:11)(cid:48)(cid:48)(cid:7)(cid:5)(cid:3)(cid:9)(cid:2)(cid:12)(cid:11)(cid:4)(cid:14)(cid:11)(cid:48)(cid:48)(cid:7)(cid:5)(cid:3)(cid:9)(cid:2)(cid:28)(cid:3,,5190.0
,,9,,,Unknown,,cid:3)(cid:5)(cid:14)(cid:70)(cid:12)(cid:11)(cid:4)(cid:14)(cid:11)(cid:48)(cid:48)(cid:7)(cid:5)(cid:3)(cid:9)(cid:2)(cid:12)(cid:11)(cid:4)(cid:14)(cid:11)(cid:48)(cid:48)(cid:7)(cid:5)(cid:3)(cid:9)(cid:2)(cid:28)(cid:3,,5199.0
,,2,,,Unknown,,cid:3)(cid:5)(cid:14)(cid:70)(cid:12)(cid:11)(cid:4)(cid:14)(cid:11)(cid:48)(cid:48)(cid:7)(cid:5)(cid:3)(cid:9)(cid:2)(cid:12)(cid:11)(cid:4)(cid:14)(cid:11)(cid:48)(cid:48)(cid:7)(cid:5)(cid:3)(cid:9)(cid:2)(cid:28)(cid:3,,5201.0
,,28,,,Unknown,,cid:3)(cid:5)(cid:14)(cid:70)(cid:12)(cid:11)(cid:4)(cid:14)(cid:11)(cid:48)(cid:48)(cid:7)(cid:5)(cid:3)(cid:9)(cid:2)(cid:12)(cid:11)(cid:4)(cid:14)(cid:11)(cid:48)(cid:48)(cid:7)(cid:5)(cid:3)(cid:9)(cid:2)(cid:28)(cid:3,,5229.0
,,3,,,Unknown,,cid:3)(cid:5)(cid:14)(cid:70)(cid:12)(cid:11)(cid:4)(cid:14)(cid:11)(cid:48)(cid:48)(cid:7)(cid:5)(cid:3)(cid:9)(cid:2)(cid:12)(cid:11)(cid:4)(cid:14)(cid:11)(cid:48)(cid:48)(cid:7)(cid:5)(cid:3)(cid:9)(cid:2)(cid:28)(cid:3,,5232.0
,,15,,,Unknown,,cid:3)(cid:5)(cid:14)(cid:70)(cid:12)(cid:11)(cid:4)(cid:14)(cid:11)(cid:48)(cid:48)(cid:7)(cid:5)(cid:3)(cid:9)(cid:2)(cid:12)(cid:11)(cid:4)(cid:14)(cid:11)(cid:48)(cid:48)(cid:7)(cid:5)(cid:3)(cid:9)(cid:2)(cid:28)(cid:3,,5247.0
,,2,,,Unknown,,cid:3)(cid:5)(cid:14)(cid:70)(cid:12)(cid:11)(cid:4)(cid:14)(cid:11)(cid:48)(cid:48)(cid:7)(cid:5)(cid:3)(cid:9)(cid:2)(cid:12)(cid:11)(cid:4)(cid:14)(cid:11)(cid:48)(cid:48)(cid:7)(cid:5)(cid:3)(cid:9)(cid:2)(cid:28)(cid:3,,5249.0
,,35,,,Unknown,,cid:3)(cid:5)(cid:14)(cid:70)(cid:12)(cid:11)(cid:4)(cid:14)(cid:11)(cid:48)(cid:48)(cid:7)(cid:5)(cid:3)(cid:9)(cid:2)(cid:12)(cid:11)(cid:4)(cid:14)(cid:11)(cid:48)(cid:48)(cid:7)(cid:5)(cid:3)(cid:9)(cid:2)(cid:28)(cid:3,,5284.0
,,19,,,Unknown,,cid:3)(cid:5)(cid:14)(cid:70)(cid:12)(cid:11)(cid:4)(cid:14)(cid:11)(cid:48)(cid:48)(cid:7)(cid:5)(cid:3)(cid:9)(cid:2)(cid:12)(cid:11)(cid:4)(cid:14)(cid:11)(cid:48)(cid:48)(cid:7)(cid:5)(cid:3)(cid:9)(cid:2)(cid:28)(cid:3,,5303.0
,,1,,,Unknown,,cid:3)(cid:5)(cid:14)(cid:70)(cid:12)(cid:11)(cid:4)(cid:14)(cid:11)(cid:48)(cid:48)(cid:7)(cid:5)(cid:3)(cid:9)(cid:2)(cid:12)(cid:11)(cid:4)(cid:14)(cid:11)(cid:48)(cid:48)(cid:7)(cid:5)(cid:3)(cid:9)(cid:2)(cid:28)(cid:3,,5304.0
,,1,,,Unknown,,cid:3)(cid:5)(cid:14)(cid:70)(cid:12)(cid:11)(cid:4)(cid:14)(cid:11)(cid:48)(cid:48)(cid:7)(cid:5)(cid:3)(cid:9)(cid:2)(cid:12)(cid:11)(cid:4)(cid:14)(cid:11)(cid:48)(cid:48)(cid:7)(cid:5)(cid:3)(cid:9)(cid:2)(cid:28)(cid:3,,5305.0
,,2,,,Unknown,,cid:3)(cid:5)(cid:14)(cid:70)(cid:12)(cid:11)(cid:4)(cid:14)(cid:11)(cid:48)(cid:48)(cid:7)(cid:5)(cid:3)(cid:9)(cid:2)(cid:12)(cid:11)(cid:4)(cid:14)(cid:11)(cid:48)(cid:48)(cid:7)(cid:5)(cid:3)(cid:9)(cid:2)(cid:28)(cid:3,,5307.0
,,44,,,Unknown,,cid:3)(cid:5)(cid:14)(cid:70)(cid:12)(cid:11)(cid:4)(cid:14)(cid:11)(cid:48)(cid:48)(cid:7)(cid:5)(cid:3)(cid:9)(cid:2)(cid:12)(cid:11)(cid:4)(cid:14)(cid:11)(cid:48)(cid:48)(cid:7)(cid:5)(cid:3)(cid:9)(cid:2)(cid:28)(cid:3,,5351.0
,,12,,,Unknown,,cid:3)(cid:5)(cid:14)(cid:70)(cid:12)(cid:11)(cid:4)(cid:14)(cid:11)(cid:48)(cid:48)(cid:7)(cid:5)(cid:3)(cid:9)(cid:2)(cid:12)(cid:11)(cid:4)(cid:14)(cid:11)(cid:48)(cid:48)(cid:7)(cid:5)(cid:3)(cid:9)(cid:2)(cid:28)(cid:3,,5363.0
,,29,,,Unknown,,cid:3)(cid:5)(cid:14)(cid:70)(cid:12)(cid:11)(cid:4)(cid:14)(cid:11)(cid:48)(cid:48)(cid:7)(cid:5)(cid:3)(cid:9)(cid:2)(cid:12)(cid:11)(cid:4)(cid:14)(cid:11)(cid:48)(cid:48)(cid:7)(cid:5)(cid:3)(cid:9)(cid:2)(cid:28)(cid:3,,5392.0
,,26,,,Unknown,,cid:3)(cid:5)(cid:14)(cid:70)(cid:12)(cid:11)(cid:4)(cid:14)(cid:11)(cid:48)(cid:48)(cid:7)(cid:5)(cid:3)(cid:9)(cid:2)(cid:12)(cid:11)(cid:4)(cid:14)(cid:11)(cid:48)(cid:48)(cid:7)(cid:5)(cid:3)(cid:9)(cid:2)(cid:28)(cid:3,,5418.0
,,41,,,Unknown,,cid:3)(cid:5)(cid:14)(cid:70)(cid:12)(cid:11)(cid:4)(cid:14)(cid:11)(cid:48)(cid:48)(cid:7)(cid:5)(cid:3)(cid:9)(cid:2)(cid:12)(cid:11)(cid:4)(cid:14)(cid:11)(cid:48)(cid:48)(cid:7)(cid:5)(cid:3)(cid:9)(cid:2)(cid:28)(cid:3,,5459.0
,,25,,,Unknown,,cid:3)(cid:5)(cid:14)(cid:70)(cid:12)(cid:11)(cid:4)(cid:14)(cid:11)(cid:48)(cid:48)(cid:7)(cid:5)(cid:3)(cid:9)(cid:2)(cid:12)(cid:11)(cid:4)(cid:14)(cid:11)(cid:48)(cid:48)(cid:7)(cid:5)(cid:3)(cid:9)(cid:2)(cid:28)(cid:3,,5484.0
,,2,,,Unknown,,cid:3)(cid:5)(cid:14)(cid:70)(cid:12)(cid:11)(cid:4)(cid:14)(cid:11)(cid:48)(cid:48)(cid:7)(cid:5)(cid:3)(cid:9)(cid:2)(cid:12)(cid:11)(cid:4)(cid:14)(cid:11)(cid:48)(cid:48)(cid:7)(cid:5)(cid:3)(cid:9)(cid:2)(cid:28)(cid:3,,5486.0
,,58,,,Unknown,,cid:3)(cid:5)(cid:14)(cid:70)(cid:12)(cid:11)(cid:4)(cid:14)(cid:11)(cid:48)(cid:48)(cid:7)(cid:5)(cid:3)(cid:9)(cid:2)(cid:12)(cid:11)(cid:4)(cid:14)(cid:11)(cid:48)(cid:48)(cid:7)(cid:5)(cid:3)(cid:9)(cid:2)(cid:28)(cid:3,,5544.0
,,58,,,Unknown,,cid:3)(cid:5)(cid:14)(cid:70)(cid:12)(cid:11)(cid:4)(cid:14)(cid:11)(cid:48)(cid:48)(cid:7)(cid:5)(cid:3)(cid:9)(cid:2)(cid:12)(cid:11)(cid:4)(cid:14)(cid:11)(cid:48)(cid:48)(cid:7)(cid:5)(cid:3)(cid:9)(cid:2)(cid:28)(cid:3,,5602.0
,,37,,,Unknown,,cid:3)(cid:5)(cid:14)(cid:70)(cid:12)(cid:11)(cid:4)(cid:14)(cid:11)(cid:48)(cid:48)(cid:7)(cid:5)(cid:3)(cid:9)(cid:2)(cid:12)(cid:11)(cid:4)(cid:14)(cid:11)(cid:48)(cid:48)(cid:7)(cid:5)(cid:3)(cid:9)(cid:2)(cid:28)(cid:3,,5639.0
,,16,,,Unknown,,cid:3)(cid:5)(cid:14)(cid:70)(cid:12)(cid:11)(cid:4)(cid:14)(cid:11)(cid:48)(cid:48)(cid:7)(cid:5)(cid:3)(cid:9)(cid:2)(cid:12)(cid:11)(cid:4)(cid:14)(cid:11)(cid:48)(cid:48)(cid:7)(cid:5)(cid:3)(cid:9)(cid:2)(cid:28)(cid:3,,5655.0
,,34,,,Unknown,,cid:3)(cid:5)(cid:14)(cid:70)(cid:12)(cid:11)(cid:4)(cid:14)(cid:11)(cid:48)(cid:48)(cid:7)(cid:5)(cid:3)(cid:9)(cid:2)(cid:12)(cid:11)(cid:4)(cid:14)(cid:11)(cid:48)(cid:48)(cid:7)(cid:5)(cid:3)(cid:9)(cid:2)(cid:28)(cid:3,,5689.0
,,33,,,Unknown,,cid:3)(cid:5)(cid:14)(cid:70)(cid:12)(cid:11)(cid:4)(cid:14)(cid:11)(cid:48)(cid:48)(cid:7)(cid:5)(cid:3)(cid:9)(cid:2)(cid:12)(cid:11)(cid:4)(cid:14)(cid:11)(cid:48)(cid:48)(cid:7)(cid:5)(cid:3)(cid:9)(cid:2)(cid:28)(cid:3,,5722.0
,,17,,,Unknown,,cid:3)(cid:5)(cid:14)(cid:70)(cid:12)(cid:11)(cid:4)(cid:14)(cid:11)(cid:48)(cid:48)(cid:7)(cid:5)(cid:3)(cid:9)(cid:2)(cid:12)(cid:11)(cid:4)(cid:14)(cid:11)(cid:48)(cid:48)(cid:7)(cid:5)(cid:3)(cid:9)(cid:2)(cid:28)(cid:3,,5739.0
,,1,,,Unknown,,cid:3)(cid:5)(cid:14)(cid:70)(cid:12)(cid:11)(cid:4)(cid:14)(cid:11)(cid:48)(cid:48)(cid:7)(cid:5)(cid:3)(cid:9)(cid:2)(cid:12)(cid:11)(cid:4)(cid:14)(cid:11)(cid:48)(cid:48)(cid:7)(cid:5)(cid:3)(cid:9)(cid:2)(cid:28)(cid:3,,5740.0
,,45,,,Unknown,,cid:3)(cid:5)(cid:14)(cid:70)(cid:12)(cid:11)(cid:4)(cid:14)(cid:11)(cid:48)(cid:48)(cid:7)(cid:5)(cid:3)(cid:9)(cid:2)(cid:12)(cid:11)(cid:4)(cid:14)(cid:11)(cid:48)(cid:48)(cid:7)(cid:5)(cid:3)(cid:9)(cid:2)(cid:28)(cid:3,,5785.0
,,18,,,Unknown,,cid:3)(cid:5)(cid:14)(cid:70)(cid:12)(cid:11)(cid:4)(cid:14)(cid:11)(cid:48)(cid:48)(cid:7)(cid:5)(cid:3)(cid:9)(cid:2)(cid:12)(cid:11)(cid:4)(cid:14)(cid:11)(cid:48)(cid:48)(cid:7)(cid:5)(cid:3)(cid:9)(cid:2)(cid:28)(cid:3,,5803.0
,,16,,,Unknown,,cid:3)(cid:5)(cid:14)(cid:70)(cid:12)(cid:11)(cid:4)(cid:14)(cid:11)(cid:48)(cid:48)(cid:7)(cid:5)(cid:3)(cid:9)(cid:2)(cid:12)(cid:11)(cid:4)(cid:14)(cid:11)(cid:48)(cid:48)(cid:7)(cid:5)(cid:3)(cid:9)(cid:2)(cid:28)(cid:3,,5819.0
,,10,,,Unknown,,cid:3)(cid:5)(cid:14)(cid:70)(cid:12)(cid:11)(cid:4)(cid:14)(cid:11)(cid:48)(cid:48)(cid:7)(cid:5)(cid:3)(cid:9)(cid:2)(cid:12)(cid:11)(cid:4)(cid:14)(cid:11)(cid:48)(cid:48)(cid:7)(cid:5)(cid:3)(cid:9)(cid:2)(cid:28)(cid:3,,5829.0
,,11,,,Unknown,,cid:3)(cid:5)(cid:14)(cid:70)(cid:12)(cid:11)(cid:4)(cid:14)(cid:11)(cid:48)(cid:48)(cid:7)(cid:5)(cid:3)(cid:9)(cid:2)(cid:12)(cid:11)(cid:4)(cid:14)(cid:11)(cid:48)(cid:48)(cid:7)(cid:5)(cid:3)(cid:9)(cid:2)(cid:28)(cid:3,,5840.0
,,10,,,Unknown,,cid:3)(cid:5)(cid:14)(cid:70)(cid:12)(cid:11)(cid:4)(cid:14)(cid:11)(cid:48)(cid:48)(cid:7)(cid:5)(cid:3)(cid:9)(cid:2)(cid:12)(cid:11)(cid:4)(cid:14)(cid:11)(cid:48)(cid:48)(cid:7)(cid:5)(cid:3)(cid:9)(cid:2)(cid:28)(cid:3,,5850.0
,,46,,,Unknown,,cid:3)(cid:5)(cid:14)(cid:70)(cid:12)(cid:11)(cid:4)(cid:14)(cid:11)(cid:48)(cid:48)(cid:7)(cid:5)(cid:3)(cid:9)(cid:2)(cid:12)(cid:11)(cid:4)(cid:14)(cid:11)(cid:48)(cid:48)(cid:7)(cid:5)(cid:3)(cid:9)(cid:2)(cid:28)(cid:3,,5896.0
,,14,,,Unknown,,cid:3)(cid:5)(cid:14)(cid:70)(cid:12)(cid:11)(cid:4)(cid:14)(cid:11)(cid:48)(cid:48)(cid:7)(cid:5)(cid:3)(cid:9)(cid:2)(cid:12)(cid:11)(cid:4)(cid:14)(cid:11)(cid:48)(cid:48)(cid:7)(cid:5)(cid:3)(cid:9)(cid:2)(cid:28)(cid:3,,5910.0
,,2,,,Unknown,,cid:3)(cid:5)(cid:14)(cid:70)(cid:12)(cid:11)(cid:4)(cid:14)(cid:11)(cid:48)(cid:48)(cid:7)(cid:5)(cid:3)(cid:9)(cid:2)(cid:12)(cid:11)(cid:4)(cid:14)(cid:11)(cid:48)(cid:48)(cid:7)(cid:5)(cid:3)(cid:9)(cid:2)(cid:28)(cid:3,,5912.0
,,12,,,Unknown,,cid:3)(cid:5)(cid:14)(cid:70)(cid:12)(cid:11)(cid:4)(cid:14)(cid:11)(cid:48)(cid:48)(cid:7)(cid:5)(cid:3)(cid:9)(cid:2)(cid:12)(cid:11)(cid:4)(cid:14)(cid:11)(cid:48)(cid:48)(cid:7)(cid:5)(cid:3)(cid:9)(cid:2)(cid:28)(cid:3,,5924.0
,,11,,,Unknown,,cid:3)(cid:5)(cid:14)(cid:70)(cid:12)(cid:11)(cid:4)(cid:14)(cid:11)(cid:48)(cid:48)(cid:7)(cid:5)(cid:3)(cid:9)(cid:2)(cid:12)(cid:11)(cid:4)(cid:14)(cid:11)(cid:48)(cid:48)(cid:7)(cid:5)(cid:3)(cid:9)(cid:2)(cid:28)(cid:3,,5935.0
,,4,,,Unknown,,cid:3)(cid:5)(cid:14)(cid:70)(cid:12)(cid:11)(cid:4)(cid:14)(cid:11)(cid:48)(cid:48)(cid:7)(cid:5)(cid:3)(cid:9)(cid:2)(cid:12)(cid:11)(cid:4)(cid:14)(cid:11)(cid:48)(cid:48)(cid:7)(cid:5)(cid:3)(cid:9)(cid:2)(cid:28)(cid:3,,5939.0
,,14,,,Unknown,,cid:3)(cid:5)(cid:14)(cid:70)(cid:12)(cid:11)(cid:4)(cid:14)(cid:11)(cid:48)(cid:48)(cid:7)(cid:5)(cid:3)(cid:9)(cid:2)(cid:12)(cid:11)(cid:4)(cid:14)(cid:11)(cid:48)(cid:48)(cid:7)(cid:5)(cid:3)(cid:9)(cid:2)(cid:28)(cid:3,,5953.0
,,11,,,Unknown,,cid:3)(cid:5)(cid:14)(cid:70)(cid:12)(cid:11)(cid:4)(cid:14)(cid:11)(cid:48)(cid:48)(cid:7)(cid:5)(cid:3)(cid:9)(cid:2)(cid:12)(cid:11)(cid:4)(cid:14)(cid:11)(cid:48)(cid:48)(cid:7)(cid:5)(cid:3)(cid:9)(cid:2)(cid:28)(cid:3,,5964.0
,,48,,,Unknown,,cid:3)(cid:5)(cid:14)(cid:70)(cid:12)(cid:11)(cid:4)(cid:14)(cid:11)(cid:48)(cid:48)(cid:7)(cid:5)(cid:3)(cid:9)(cid:2)(cid:12)(cid:11)(cid:4)(cid:14)(cid:11)(cid:48)(cid:48)(cid:7)(cid:5)(cid:3)(cid:9)(cid:2)(cid:28)(cid:3,,6012.0
,,48,,,Unknown,,cid:3)(cid:5)(cid:14)(cid:70)(cid:12)(cid:11)(cid:4)(cid:14)(cid:11)(cid:48)(cid:48)(cid:7)(cid:5)(cid:3)(cid:9)(cid:2)(cid:12)(cid:11)(cid:4)(cid:14)(cid:11)(cid:48)(cid:48)(cid:7)(cid:5)(cid:3)(cid:9)(cid:2)(cid:28)(cid:3,,6060.0
,,7,,,Unknown,,cid:3)(cid:5)(cid:14)(cid:70)(cid:12)(cid:11)(cid:4)(cid:14)(cid:11)(cid:48)(cid:48)(cid:7)(cid:5)(cid:3)(cid:9)(cid:2)(cid:12)(cid:11)(cid:4)(cid:14)(cid:11)(cid:48)(cid:48)(cid:7)(cid:5)(cid:3)(cid:9)(cid:2)(cid:28)(cid:3,,6067.0
,,5,,,Unknown,,cid:3)(cid:5)(cid:14)(cid:70)(cid:12)(cid:11)(cid:4)(cid:14)(cid:11)(cid:48)(cid:48)(cid:7)(cid:5)(cid:3)(cid:9)(cid:2)(cid:12)(cid:11)(cid:4)(cid:14)(cid:11)(cid:48)(cid:48)(cid:7)(cid:5)(cid:3)(cid:9)(cid:2)(cid:28)(cid:3,,6072.0
,,3,,,Unknown,,cid:3)(cid:5)(cid:14)(cid:70)(cid:12)(cid:11)(cid:4)(cid:14)(cid:11)(cid:48)(cid:48)(cid:7)(cid:5)(cid:3)(cid:9)(cid:2)(cid:12)(cid:11)(cid:4)(cid:14)(cid:11)(cid:48)(cid:48)(cid:7)(cid:5)(cid:3)(cid:9)(cid:2)(cid:28)(cid:3,,6075.0
,,9,,,Unknown,,cid:3)(cid:5)(cid:14)(cid:70)(cid:12)(cid:11)(cid:4)(cid:14)(cid:11)(cid:48)(cid:48)(cid:7)(cid:5)(cid:3)(cid:9)(cid:2)(cid:12)(cid:11)(cid:4)(cid:14)(cid:11)(cid:48)(cid:48)(cid:7)(cid:5)(cid:3)(cid:9)(cid:2)(cid:28)(cid:3,,6084.0
,,2,,,Unknown,,cid:3)(cid:5)(cid:14)(cid:70)(cid:12)(cid:11)(cid:4)(cid:14)(cid:11)(cid:48)(cid:48)(cid:7)(cid:5)(cid:3)(cid:9)(cid:2)(cid:12)(cid:11)(cid:4)(cid:14)(cid:11)(cid:48)(cid:48)(cid:7)(cid:5)(cid:3)(cid:9)(cid:2)(cid:28)(cid:3,,6086.0
,,28,,,Unknown,,cid:3)(cid:5)(cid:14)(cid:70)(cid:12)(cid:11)(cid:4)(cid:14)(cid:11)(cid:48)(cid:48)(cid:7)(cid:5)(cid:3)(cid:9)(cid:2)(cid:12)(cid:11)(cid:4)(cid:14)(cid:11)(cid:48)(cid:48)(cid:7)(cid:5)(cid:3)(cid:9)(cid:2)(cid:28)(cid:3,,6114.0
,,3,,,Unknown,,cid:3)(cid:5)(cid:14)(cid:70)(cid:12)(cid:11)(cid:4)(cid:14)(cid:11)(cid:48)(cid:48)(cid:7)(cid:5)(cid:3)(cid:9)(cid:2)(cid:12)(cid:11)(cid:4)(cid:14)(cid:11)(cid:48)(cid:48)(cid:7)(cid:5)(cid:3)(cid:9)(cid:2)(cid:28)(cid:3,,6117.0
,,15,,,Unknown,,cid:3)(cid:5)(cid:14)(cid:70)(cid:12)(cid:11)(cid:4)(cid:14)(cid:11)(cid:48)(cid:48)(cid:7)(cid:5)(cid:3)(cid:9)(cid:2)(cid:12)(cid:11)(cid:4)(cid:14)(cid:11)(cid:48)(cid:48)(cid:7)(cid:5)(cid:3)(cid:9)(cid:2)(cid:28)(cid:3,,6132.0
,,2,,,Unknown,,cid:3)(cid:5)(cid:14)(cid:70)(cid:12)(cid:11)(cid:4)(cid:14)(cid:11)(cid:48)(cid:48)(cid:7)(cid:5)(cid:3)(cid:9)(cid:2)(cid:12)(cid:11)(cid:4)(cid:14)(cid:11)(cid:48)(cid:48)(cid:7)(cid:5)(cid:3)(cid:9)(cid:2)(cid:28)(cid:3,,6134.0
,,16,,,Unknown,,cid:3)(cid:5)(cid:14)(cid:70)(cid:12)(cid:11)(cid:4)(cid:14)(cid:11)(cid:48)(cid:48)(cid:7)(cid:5)(cid:3)(cid:9)(cid:2)(cid:12)(cid:11)(cid:4)(cid:14)(cid:11)(cid:48)(cid:48)(cid:7)(cid:5)(cid:3)(cid:9)(cid:2)(cid:28)(cid:3,,6150.0
,,18,,,Unknown,,cid:3)(cid:5)(cid:14)(cid:70)(cid:12)(cid:11)(cid:4)(cid:14)(cid:11)(cid:48)(cid:48)(cid:7)(cid:5)(cid:3)(cid:9)(cid:2)(cid:12)(cid:11)(cid:4)(cid:14)(cid:11)(cid:48)(cid:48)(cid:7)(cid:5)(cid:3)(cid:9)(cid:2)(cid:28)(cid:3,,6168.0
,,19,,,Unknown,,cid:3)(cid:5)(cid:14)(cid:70)(cid:12)(cid:11)(cid:4)(cid:14)(cid:11)(cid:48)(cid:48)(cid:7)(cid:5)(cid:3)(cid:9)(cid:2)(cid:12)(cid:11)(cid:4)(cid:14)(cid:11)(cid:48)(cid:48)(cid:7)(cid:5)(cid:3)(cid:9)(cid:2)(cid:28)(cid:3,,6187.0
,,18,,,Unknown,,cid:3)(cid:5)(cid:14)(cid:70)(cid:12)(cid:11)(cid:4)(cid:14)(cid:11)(cid:48)(cid:48)(cid:7)(cid:5)(cid:3)(cid:9)(cid:2)(cid:12)(cid:11)(cid:4)(cid:14)(cid:11)(cid:48)(cid:48)(cid:7)(cid:5)(cid:3)(cid:9)(cid:2)(cid:28)(cid:3,,6205.0
,,18,,,Unknown,,cid:3)(cid:5)(cid:14)(cid:70)(cid:12)(cid:11)(cid:4)(cid:14)(cid:11)(cid:48)(cid:48)(cid:7)(cid:5)(cid:3)(cid:9)(cid:2)(cid:12)(cid:11)(cid:4)(cid:14)(cid:11)(cid:48)(cid:48)(cid:7)(cid:5)(cid:3)(cid:9)(cid:2)(cid:28)(cid:3,,6223.0
,,2,,,Unknown,,cid:3)(cid:5)(cid:14)(cid:70)(cid:12)(cid:11)(cid:4)(cid:14)(cid:11)(cid:48)(cid:48)(cid:7)(cid:5)(cid:3)(cid:9)(cid:2)(cid:12)(cid:11)(cid:4)(cid:14)(cid:11)(cid:48)(cid:48)(cid:7)(cid:5)(cid:3)(cid:9)(cid:2)(cid:28)(cid:3,,6225.0
,,44,,,Unknown,,cid:3)(cid:5)(cid:14)(cid:70)(cid:12)(cid:11)(cid:4)(cid:14)(cid:11)(cid:48)(cid:48)(cid:7)(cid:5)(cid:3)(cid:9)(cid:2)(cid:12)(cid:11)(cid:4)(cid:14)(cid:11)(cid:48)(cid:48)(cid:7)(cid:5)(cid:3)(cid:9)(cid:2)(cid:28)(cid:3,,6269.0
,,12,,,Unknown,,cid:3)(cid:5)(cid:14)(cid:70)(cid:12)(cid:11)(cid:4)(cid:14)(cid:11)(cid:48)(cid:48)(cid:7)(cid:5)(cid:3)(cid:9)(cid:2)(cid:12)(cid:11)(cid:4)(cid:14)(cid:11)(cid:48)(cid:48)(cid:7)(cid:5)(cid:3)(cid:9)(cid:2)(cid:28)(cid:3,,6281.0
,,29,,,Unknown,,cid:3)(cid:5)(cid:14)(cid:70)(cid:12)(cid:11)(cid:4)(cid:14)(cid:11)(cid:48)(cid:48)(cid:7)(cid:5)(cid:3)(cid:9)(cid:2)(cid:12)(cid:11)(cid:4)(cid:14)(cid:11)(cid:48)(cid:48)(cid:7)(cid:5)(cid:3)(cid:9)(cid:2)(cid:28)(cid:3,,6310.0
,,26,,,Unknown,,cid:3)(cid:5)(cid:14)(cid:70)(cid:12)(cid:11)(cid:4)(cid:14)(cid:11)(cid:48)(cid:48)(cid:7)(cid:5)(cid:3)(cid:9)(cid:2)(cid:12)(cid:11)(cid:4)(cid:14)(cid:11)(cid:48)(cid:48)(cid:7)(cid:5)(cid:3)(cid:9)(cid:2)(cid:28)(cid:3,,6336.0
,,41,,,Unknown,,cid:3)(cid:5)(cid:14)(cid:70)(cid:12)(cid:11)(cid:4)(cid:14)(cid:11)(cid:48)(cid:48)(cid:7)(cid:5)(cid:3)(cid:9)(cid:2)(cid:12)(cid:11)(cid:4)(cid:14)(cid:11)(cid:48)(cid:48)(cid:7)(cid:5)(cid:3)(cid:9)(cid:2)(cid:28)(cid:3,,6377.0
,,25,,,Unknown,,cid:3)(cid:5)(cid:14)(cid:70)(cid:12)(cid:11)(cid:4)(cid:14)(cid:11)(cid:48)(cid:48)(cid:7)(cid:5)(cid:3)(cid:9)(cid:2)(cid:12)(cid:11)(cid:4)(cid:14)(cid:11)(cid:48)(cid:48)(cid:7)(cid:5)(cid:3)(cid:9)(cid:2)(cid:28)(cid:3,,6402.0
,,2,,,Unknown,,cid:3)(cid:5)(cid:14)(cid:70)(cid:12)(cid:11)(cid:4)(cid:14)(cid:11)(cid:48)(cid:48)(cid:7)(cid:5)(cid:3)(cid:9)(cid:2)(cid:12)(cid:11)(cid:4)(cid:14)(cid:11)(cid:48)(cid:48)(cid:7)(cid:5)(cid:3)(cid:9)(cid:2)(cid:28)(cid:3,,6404.0
,,58,,,Unknown,,cid:3)(cid:5)(cid:14)(cid:70)(cid:12)(cid:11)(cid:4)(cid:14)(cid:11)(cid:48)(cid:48)(cid:7)(cid:5)(cid:3)(cid:9)(cid:2)(cid:12)(cid:11)(cid:4)(cid:14)(cid:11)(cid:48)(cid:48)(cid:7)(cid:5)(cid:3)(cid:9)(cid:2)(cid:28)(cid:3,,6462.0
,,58,,,Unknown,,cid:3)(cid:5)(cid:14)(cid:70)(cid:12)(cid:11)(cid:4)(cid:14)(cid:11)(cid:48)(cid:48)(cid:7)(cid:5)(cid:3)(cid:9)(cid:2)(cid:12)(cid:11)(cid:4)(cid:14)(cid:11)(cid:48)(cid:48)(cid:7)(cid:5)(cid:3)(cid:9)(cid:2)(cid:28)(cid:3,,6520.0
,,18,,,Unknown,,cid:3)(cid:5)(cid:14)(cid:70)(cid:12)(cid:11)(cid:4)(cid:14)(cid:11)(cid:48)(cid:48)(cid:7)(cid:5)(cid:3)(cid:9)(cid:2)(cid:12)(cid:11)(cid:4)(cid:14)(cid:11)(cid:48)(cid:48)(cid:7)(cid:5)(cid:3)(cid:9)(cid:2)(cid:28)(cid:3,,6538.0
,,1,,,Unknown,,cid:3)(cid:5)(cid:14)(cid:70)(cid:12)(cid:11)(cid:4)(cid:14)(cid:11)(cid:48)(cid:48)(cid:7)(cid:5)(cid:3)(cid:9)(cid:2)(cid:12)(cid:11)(cid:4)(cid:14)(cid:11)(cid:48)(cid:48)(cid:7)(cid:5)(cid:3)(cid:9)(cid:2)(cid:28)(cid:3,,6539.0
,,1,,,Unknown,,cid:3)(cid:5)(cid:14)(cid:70)(cid:12)(cid:11)(cid:4)(cid:14)(cid:11)(cid:48)(cid:48)(cid:7)(cid:5)(cid:3)(cid:9)(cid:2)(cid:12)(cid:11)(cid:4)(cid:14)(cid:11)(cid:48)(cid:48)(cid:7)(cid:5)(cid:3)(cid:9)(cid:2)(cid:28)(cid:3,,6540.0
,,37,,,Unknown,,cid:3)(cid:5)(cid:14)(cid:70)(cid:12)(cid:11)(cid:4)(cid:14)(cid:11)(cid:48)(cid:48)(cid:7)(cid:5)(cid:3)(cid:9)(cid:2)(cid:12)(cid:11)(cid:4)(cid:14)(cid:11)(cid:48)(cid:48)(cid:7)(cid:5)(cid:3)(cid:9)(cid:2)(cid:28)(cid:3,,6577.0
,,17,,,Unknown,,cid:3)(cid:5)(cid:14)(cid:70)(cid:12)(cid:11)(cid:4)(cid:14)(cid:11)(cid:48)(cid:48)(cid:7)(cid:5)(cid:3)(cid:9)(cid:2)(cid:12)(cid:11)(cid:4)(cid:14)(cid:11)(cid:48)(cid:48)(cid:7)(cid:5)(cid:3)(cid:9)(cid:2)(cid:28)(cid:3,,6594.0
,,37,,,Unknown,,cid:3)(cid:5)(cid:14)(cid:70)(cid:12)(cid:11)(cid:4)(cid:14)(cid:11)(cid:48)(cid:48)(cid:7)(cid:5)(cid:3)(cid:9)(cid:2)(cid:12)(cid:11)(cid:4)(cid:14)(cid:11)(cid:48)(cid:48)(cid:7)(cid:5)(cid:3)(cid:9)(cid:2)(cid:28)(cid:3,,6631.0
,,45,,,Unknown,,cid:3)(cid:5)(cid:14)(cid:70)(cid:12)(cid:11)(cid:4)(cid:14)(cid:11)(cid:48)(cid:48)(cid:7)(cid:5)(cid:3)(cid:9)(cid:2)(cid:12)(cid:11)(cid:4)(cid:14)(cid:11)(cid:48)(cid:48)(cid:7)(cid:5)(cid:3)(cid:9)(cid:2)(cid:28)(cid:3,,6676.0
,,18,,,Unknown,,cid:3)(cid:5)(cid:14)(cid:70)(cid:12)(cid:11)(cid:4)(cid:14)(cid:11)(cid:48)(cid:48)(cid:7)(cid:5)(cid:3)(cid:9)(cid:2)(cid:12)(cid:11)(cid:4)(cid:14)(cid:11)(cid:48)(cid:48)(cid:7)(cid:5)(cid:3)(cid:9)(cid:2)(cid:28)(cid:3,,6694.0
,,16,,,Unknown,,cid:3)(cid:5)(cid:14)(cid:70)(cid:12)(cid:11)(cid:4)(cid:14)(cid:11)(cid:48)(cid:48)(cid:7)(cid:5)(cid:3)(cid:9)(cid:2)(cid:12)(cid:11)(cid:4)(cid:14)(cid:11)(cid:48)(cid:48)(cid:7)(cid:5)(cid:3)(cid:9)(cid:2)(cid:28)(cid:3,,6710.0
,,11,,,Unknown,,cid:3)(cid:5)(cid:14)(cid:70)(cid:12)(cid:11)(cid:4)(cid:14)(cid:11)(cid:48)(cid:48)(cid:7)(cid:5)(cid:3)(cid:9)(cid:2)(cid:12)(cid:11)(cid:4)(cid:14)(cid:11)(cid:48)(cid:48)(cid:7)(cid:5)(cid:3)(cid:9)(cid:2)(cid:28)(cid:3,,6721.0
,,39,,,Unknown,,cid:3)(cid:5)(cid:14)(cid:70)(cid:12)(cid:11)(cid:4)(cid:14)(cid:11)(cid:48)(cid:48)(cid:7)(cid:5)(cid:3)(cid:9)(cid:2)(cid:12)(cid:11)(cid:4)(cid:14)(cid:11)(cid:48)(cid:48)(cid:7)(cid:5)(cid:3)(cid:9)(cid:2)(cid:28)(cid:3,,6760.0
,,13,,,Unknown,,cid:3)(cid:5)(cid:14)(cid:70)(cid:12)(cid:11)(cid:4)(cid:14)(cid:11)(cid:48)(cid:48)(cid:7)(cid:5)(cid:3)(cid:9)(cid:2)(cid:12)(cid:11)(cid:4)(cid:14)(cid:11)(cid:48)(cid:48)(cid:7)(cid:5)(cid:3)(cid:9)(cid:2)(cid:28)(cid:3,,6773.0
,,2,,,Unknown,,cid:3)(cid:5)(cid:14)(cid:70)(cid:12)(cid:11)(cid:4)(cid:14)(cid:11)(cid:48)(cid:48)(cid:7)(cid:5)(cid:3)(cid:9)(cid:2)(cid:12)(cid:11)(cid:4)(cid:14)(cid:11)(cid:48)(cid:48)(cid:7)(cid:5)(cid:3)(cid:9)(cid:2)(cid:28)(cid:3,,6775.0
,,12,,,Unknown,,cid:3)(cid:5)(cid:14)(cid:70)(cid:12)(cid:11)(cid:4)(cid:14)(cid:11)(cid:48)(cid:48)(cid:7)(cid:5)(cid:3)(cid:9)(cid:2)(cid:12)(cid:11)(cid:4)(cid:14)(cid:11)(cid:48)(cid:48)(cid:7)(cid:5)(cid:3)(cid:9)(cid:2)(cid:28)(cid:3,,6787.0
,,11,,,Unknown,,cid:3)(cid:5)(cid:14)(cid:70)(cid:12)(cid:11)(cid:4)(cid:14)(cid:11)(cid:48)(cid:48)(cid:7)(cid:5)(cid:3)(cid:9)(cid:2)(cid:12)(cid:11)(cid:4)(cid:14)(cid:11)(cid:48)(cid:48)(cid:7)(cid:5)(cid:3)(cid:9)(cid:2)(cid:28)(cid:3,,6798.0
,,4,,,Unknown,,cid:3)(cid:5)(cid:14)(cid:70)(cid:12)(cid:11)(cid:4)(cid:14)(cid:11)(cid:48)(cid:48)(cid:7)(cid:5)(cid:3)(cid:9)(cid:2)(cid:12)(cid:11)(cid:4)(cid:14)(cid:11)(cid:48)(cid:48)(cid:7)(cid:5)(cid:3)(cid:9)(cid:2)(cid:28)(cid:3,,6802.0
,,14,,,Unknown,,cid:3)(cid:5)(cid:14)(cid:70)(cid:12)(cid:11)(cid:4)(cid:14)(cid:11)(cid:48)(cid:48)(cid:7)(cid:5)(cid:3)(cid:9)(cid:2)(cid:12)(cid:11)(cid:4)(cid:14)(cid:11)(cid:48)(cid:48)(cid:7)(cid:5)(cid:3)(cid:9)(cid:2)(cid:28)(cid:3,,6816.0
,,11,,,Unknown,,cid:3)(cid:5)(cid:14)(cid:70)(cid:12)(cid:11)(cid:4)(cid:14)(cid:11)(cid:48)(cid:48)(cid:7)(cid:5)(cid:3)(cid:9)(cid:2)(cid:12)(cid:11)(cid:4)(cid:14)(cid:11)(cid:48)(cid:48)(cid:7)(cid:5)(cid:3)(cid:9)(cid:2)(cid:28)(cid:3,,6827.0
,,48,,,Unknown,,cid:3)(cid:5)(cid:14)(cid:70)(cid:12)(cid:11)(cid:4)(cid:14)(cid:11)(cid:48)(cid:48)(cid:7)(cid:5)(cid:3)(cid:9)(cid:2)(cid:12)(cid:11)(cid:4)(cid:14)(cid:11)(cid:48)(cid:48)(cid:7)(cid:5)(cid:3)(cid:9)(cid:2)(cid:28)(cid:3,,6875.0
,,48,,,Unknown,,cid:3)(cid:5)(cid:14)(cid:70)(cid:12)(cid:11)(cid:4)(cid:14)(cid:11)(cid:48)(cid:48)(cid:7)(cid:5)(cid:3)(cid:9)(cid:2)(cid:12)(cid:11)(cid:4)(cid:14)(cid:11)(cid:48)(cid:48)(cid:7)(cid:5)(cid:3)(cid:9)(cid:2)(cid:28)(cid:3,,6923.0
,,7,,,Unknown,,cid:3)(cid:5)(cid:14)(cid:70)(cid:12)(cid:11)(cid:4)(cid:14)(cid:11)(cid:48)(cid:48)(cid:7)(cid:5)(cid:3)(cid:9)(cid:2)(cid:12)(cid:11)(cid:4)(cid:14)(cid:11)(cid:48)(cid:48)(cid:7)(cid:5)(cid:3)(cid:9)(cid:2)(cid:28)(cid:3,,6930.0
,,5,,,Unknown,,cid:3)(cid:5)(cid:14)(cid:70)(cid:12)(cid:11)(cid:4)(cid:14)(cid:11)(cid:48)(cid:48)(cid:7)(cid:5)(cid:3)(cid:9)(cid:2)(cid:12)(cid:11)(cid:4)(cid:14)(cid:11)(cid:48)(cid:48)(cid:7)(cid:5)(cid:3)(cid:9)(cid:2)(cid:28)(cid:3,,6935.0
,,3,,,Unknown,,cid:3)(cid:5)(cid:14)(cid:70)(cid:12)(cid:11)(cid:4)(cid:14)(cid:11)(cid:48)(cid:48)(cid:7)(cid:5)(cid:3)(cid:9)(cid:2)(cid:12)(cid:11)(cid:4)(cid:14)(cid:11)(cid:48)(cid:48)(cid:7)(cid:5)(cid:3)(cid:9)(cid:2)(cid:28)(cid:3,,6938.0
,,9,,,Unknown,,cid:3)(cid:5)(cid:14)(cid:70)(cid:12)(cid:11)(cid:4)(cid:14)(cid:11)(cid:48)(cid:48)(cid:7)(cid:5)(cid:3)(cid:9)(cid:2)(cid:12)(cid:11)(cid:4)(cid:14)(cid:11)(cid:48)(cid:48)(cid:7)(cid:5)(cid:3)(cid:9)(cid:2)(cid:28)(cid:3,,6947.0
,,2,,,Unknown,,cid:3)(cid:5)(cid:14)(cid:70)(cid:12)(cid:11)(cid:4)(cid:14)(cid:11)(cid:48)(cid:48)(cid:7)(cid:5)(cid:3)(cid:9)(cid:2)(cid:12)(cid:11)(cid:4)(cid:14)(cid:11)(cid:48)(cid:48)(cid:7)(cid:5)(cid:3)(cid:9)(cid:2)(cid:28)(cid:3,,6949.0
,,12,,,Unknown,,cid:3)(cid:5)(cid:14)(cid:70)(cid:12)(cid:11)(cid:4)(cid:14)(cid:11)(cid:48)(cid:48)(cid:7)(cid:5)(cid:3)(cid:9)(cid:2)(cid:12)(cid:11)(cid:4)(cid:14)(cid:11)(cid:48)(cid:48)(cid:7)(cid:5)(cid:3)(cid:9)(cid:2)(cid:28)(cid:3,,6961.0
,,11,,,Unknown,,cid:3)(cid:5)(cid:14)(cid:70)(cid:12)(cid:11)(cid:4)(cid:14)(cid:11)(cid:48)(cid:48)(cid:7)(cid:5)(cid:3)(cid:9)(cid:2)(cid:12)(cid:11)(cid:4)(cid:14)(cid:11)(cid:48)(cid:48)(cid:7)(cid:5)(cid:3)(cid:9)(cid:2)(cid:28)(cid:3,,6972.0
,,4,,,Unknown,,cid:3)(cid:5)(cid:14)(cid:70)(cid:12)(cid:11)(cid:4)(cid:14)(cid:11)(cid:48)(cid:48)(cid:7)(cid:5)(cid:3)(cid:9)(cid:2)(cid:12)(cid:11)(cid:4)(cid:14)(cid:11)(cid:48)(cid:48)(cid:7)(cid:5)(cid:3)(cid:9)(cid:2)(cid:28)(cid:3,,6976.0
,,14,,,Unknown,,cid:3)(cid:5)(cid:14)(cid:70)(cid:12)(cid:11)(cid:4)(cid:14)(cid:11)(cid:48)(cid:48)(cid:7)(cid:5)(cid:3)(cid:9)(cid:2)(cid:12)(cid:11)(cid:4)(cid:14)(cid:11)(cid:48)(cid:48)(cid:7)(cid:5)(cid:3)(cid:9)(cid:2)(cid:28)(cid:3,,6990.0
,,11,,,Unknown,,cid:3)(cid:5)(cid:14)(cid:70)(cid:12)(cid:11)(cid:4)(cid:14)(cid:11)(cid:48)(cid:48)(cid:7)(cid:5)(cid:3)(cid:9)(cid:2)(cid:12)(cid:11)(cid:4)(cid:14)(cid:11)(cid:48)(cid:48)(cid:7)(cid:5)(cid:3)(cid:9)(cid:2)(cid:28)(cid:3,,7001.0
,,48,,,Unknown,,cid:3)(cid:5)(cid:14)(cid:70)(cid:12)(cid:11)(cid:4)(cid:14)(cid:11)(cid:48)(cid:48)(cid:7)(cid:5)(cid:3)(cid:9)(cid:2)(cid:12)(cid:11)(cid:4)(cid:14)(cid:11)(cid:48)(cid:48)(cid:7)(cid:5)(cid:3)(cid:9)(cid:2)(cid:28)(cid:3,,7049.0
,,48,,,Unknown,,cid:3)(cid:5)(cid:14)(cid:70)(cid:12)(cid:11)(cid:4)(cid:14)(cid:11)(cid:48)(cid:48)(cid:7)(cid:5)(cid:3)(cid:9)(cid:2)(cid:12)(cid:11)(cid:4)(cid:14)(cid:11)(cid:48)(cid:48)(cid:7)(cid:5)(cid:3)(cid:9)(cid:2)(cid:28)(cid:3,,7097.0
,,7,,,Unknown,,cid:3)(cid:5)(cid:14)(cid:70)(cid:12)(cid:11)(cid:4)(cid:14)(cid:11)(cid:48)(cid:48)(cid:7)(cid:5)(cid:3)(cid:9)(cid:2)(cid:12)(cid:11)(cid:4)(cid:14)(cid:11)(cid:48)(cid:48)(cid:7)(cid:5)(cid:3)(cid:9)(cid:2)(cid:28)(cid:3,,7104.0
,,5,,,Unknown,,cid:3)(cid:5)(cid:14)(cid:70)(cid:12)(cid:11)(cid:4)(cid:14)(cid:11)(cid:48)(cid:48)(cid:7)(cid:5)(cid:3)(cid:9)(cid:2)(cid:12)(cid:11)(cid:4)(cid:14)(cid:11)(cid:48)(cid:48)(cid:7)(cid:5)(cid:3)(cid:9)(cid:2)(cid:28)(cid:3,,7109.0
,,3,,,Unknown,,cid:3)(cid:5)(cid:14)(cid:70)(cid:12)(cid:11)(cid:4)(cid:14)(cid:11)(cid:48)(cid:48)(cid:7)(cid:5)(cid:3)(cid:9)(cid:2)(cid:12)(cid:11)(cid:4)(cid:14)(cid:11)(cid:48)(cid:48)(cid:7)(cid:5)(cid:3)(cid:9)(cid:2)(cid:28)(cid:3,,7112.0
,,9,,,Unknown,,cid:3)(cid:5)(cid:14)(cid:70)(cid:12)(cid:11)(cid:4)(cid:14)(cid:11)(cid:48)(cid:48)(cid:7)(cid:5)(cid:3)(cid:9)(cid:2)(cid:12)(cid:11)(cid:4)(cid:14)(cid:11)(cid:48)(cid:48)(cid:7)(cid:5)(cid:3)(cid:9)(cid:2)(cid:28)(cid:3,,7121.0
,,2,,,Unknown,,cid:3)(cid:5)(cid:14)(cid:70)(cid:12)(cid:11)(cid:4)(cid:14)(cid:11)(cid:48)(cid:48)(cid:7)(cid:5)(cid:3)(cid:9)(cid:2)(cid:12)(cid:11)(cid:4)(cid:14)(cid:11)(cid:48)(cid:48)(cid:7)(cid:5)(cid:3)(cid:9)(cid:2)(cid:28)(cid:3,,7123.0
,,28,,,Unknown,,cid:3)(cid:5)(cid:14)(cid:70)(cid:12)(cid:11)(cid:4)(cid:14)(cid:11)(cid:48)(cid:48)(cid:7)(cid:5)(cid:3)(cid:9)(cid:2)(cid:12)(cid:11)(cid:4)(cid:14)(cid:11)(cid:48)(cid:48)(cid:7)(cid:5)(cid:3)(cid:9)(cid:2)(cid:28)(cid:3,,7151.0
,,3,,,Unknown,,cid:3)(cid:5)(cid:14)(cid:70)(cid:12)(cid:11)(cid:4)(cid:14)(cid:11)(cid:48)(cid:48)(cid:7)(cid:5)(cid:3)(cid:9)(cid:2)(cid:12)(cid:11)(cid:4)(cid:14)(cid:11)(cid:48)(cid:48)(cid:7)(cid:5)(cid:3)(cid:9)(cid:2)(cid:28)(cid:3,,7154.0
,,15,,,Unknown,,cid:3)(cid:5)(cid:14)(cid:70)(cid:12)(cid:11)(cid:4)(cid:14)(cid:11)(cid:48)(cid:48)(cid:7)(cid:5)(cid:3)(cid:9)(cid:2)(cid:12)(cid:11)(cid:4)(cid:14)(cid:11)(cid:48)(cid:48)(cid:7)(cid:5)(cid:3)(cid:9)(cid:2)(cid:28)(cid:3,,7169.0
,,2,,,Unknown,,cid:3)(cid:5)(cid:14)(cid:70)(cid:12)(cid:11)(cid:4)(cid:14)(cid:11)(cid:48)(cid:48)(cid:7)(cid:5)(cid:3)(cid:9)(cid:2)(cid:12)(cid:11)(cid:4)(cid:14)(cid:11)(cid:48)(cid:48)(cid:7)(cid:5)(cid:3)(cid:9)(cid:2)(cid:28)(cid:3,,7171.0
,,17,,,Unknown,,cid:3)(cid:5)(cid:14)(cid:70)(cid:12)(cid:11)(cid:4)(cid:14)(cid:11)(cid:48)(cid:48)(cid:7)(cid:5)(cid:3)(cid:9)(cid:2)(cid:12)(cid:11)(cid:4)(cid:14)(cid:11)(cid:48)(cid:48)(cid:7)(cid:5)(cid:3)(cid:9)(cid:2)(cid:28)(cid:3,,7188.0
,,37,,,Unknown,,cid:3)(cid:5)(cid:14)(cid:70)(cid:12)(cid:11)(cid:4)(cid:14)(cid:11)(cid:48)(cid:48)(cid:7)(cid:5)(cid:3)(cid:9)(cid:2)(cid:12)(cid:11)(cid:4)(cid:14)(cid:11)(cid:48)(cid:48)(cid:7)(cid:5)(cid:3)(cid:9)(cid:2)(cid:28)(cid:3,,7225.0
,,32,,,Unknown,,cid:3)(cid:5)(cid:14)(cid:70)(cid:12)(cid:11)(cid:4)(cid:14)(cid:11)(cid:48)(cid:48)(cid:7)(cid:5)(cid:3)(cid:9)(cid:2)(cid:12)(cid:11)(cid:4)(cid:14)(cid:11)(cid:48)(cid:48)(cid:7)(cid:5)(cid:3)(cid:9)(cid:2)(cid:28)(cid:3,,7257.0
,,19,,,Unknown,,cid:3)(cid:5)(cid:14)(cid:70)(cid:12)(cid:11)(cid:4)(cid:14)(cid:11)(cid:48)(cid:48)(cid:7)(cid:5)(cid:3)(cid:9)(cid:2)(cid:12)(cid:11)(cid:4)(cid:14)(cid:11)(cid:48)(cid:48)(cid:7)(cid:5)(cid:3)(cid:9)(cid:2)(cid:28)(cid:3,,7276.0
,,36,,,Unknown,,cid:3)(cid:5)(cid:14)(cid:70)(cid:12)(cid:11)(cid:4)(cid:14)(cid:11)(cid:48)(cid:48)(cid:7)(cid:5)(cid:3)(cid:9)(cid:2)(cid:12)(cid:11)(cid:4)(cid:14)(cid:11)(cid:48)(cid:48)(cid:7)(cid:5)(cid:3)(cid:9)(cid:2)(cid:28)(cid:3,,7312.0
,,18,,,Unknown,,cid:3)(cid:5)(cid:14)(cid:70)(cid:12)(cid:11)(cid:4)(cid:14)(cid:11)(cid:48)(cid:48)(cid:7)(cid:5)(cid:3)(cid:9)(cid:2)(cid:12)(cid:11)(cid:4)(cid:14)(cid:11)(cid:48)(cid:48)(cid:7)(cid:5)(cid:3)(cid:9)(cid:2)(cid:28)(cid:3,,7330.0
,,2,,,Unknown,,cid:3)(cid:5)(cid:14)(cid:70)(cid:12)(cid:11)(cid:4)(cid:14)(cid:11)(cid:48)(cid:48)(cid:7)(cid:5)(cid:3)(cid:9)(cid:2)(cid:12)(cid:11)(cid:4)(cid:14)(cid:11)(cid:48)(cid:48)(cid:7)(cid:5)(cid:3)(cid:9)(cid:2)(cid:28)(cid:3,,7332.0
,,44,,,Unknown,,cid:3)(cid:5)(cid:14)(cid:70)(cid:12)(cid:11)(cid:4)(cid:14)(cid:11)(cid:48)(cid:48)(cid:7)(cid:5)(cid:3)(cid:9)(cid:2)(cid:12)(cid:11)(cid:4)(cid:14)(cid:11)(cid:48)(cid:48)(cid:7)(cid:5)(cid:3)(cid:9)(cid:2)(cid:28)(cid:3,,7376.0
,,12,,,Unknown,,cid:3)(cid:5)(cid:14)(cid:70)(cid:12)(cid:11)(cid:4)(cid:14)(cid:11)(cid:48)(cid:48)(cid:7)(cid:5)(cid:3)(cid:9)(cid:2)(cid:12)(cid:11)(cid:4)(cid:14)(cid:11)(cid:48)(cid:48)(cid:7)(cid:5)(cid:3)(cid:9)(cid:2)(cid:28)(cid:3,,7388.0
,,29,,,Unknown,,cid:3)(cid:5)(cid:14)(cid:70)(cid:12)(cid:11)(cid:4)(cid:14)(cid:11)(cid:48)(cid:48)(cid:7)(cid:5)(cid:3)(cid:9)(cid:2)(cid:12)(cid:11)(cid:4)(cid:14)(cid:11)(cid:48)(cid:48)(cid:7)(cid:5)(cid:3)(cid:9)(cid:2)(cid:28)(cid:3,,7417.0
,,26,,,Unknown,,cid:3)(cid:5)(cid:14)(cid:70)(cid:12)(cid:11)(cid:4)(cid:14)(cid:11)(cid:48)(cid:48)(cid:7)(cid:5)(cid:3)(cid:9)(cid:2)(cid:12)(cid:11)(cid:4)(cid:14)(cid:11)(cid:48)(cid:48)(cid:7)(cid:5)(cid:3)(cid:9)(cid:2)(cid:28)(cid:3,,7443.0
,,41,,,Unknown,,cid:3)(cid:5)(cid:14)(cid:70)(cid:12)(cid:11)(cid:4)(cid:14)(cid:11)(cid:48)(cid:48)(cid:7)(cid:5)(cid:3)(cid:9)(cid:2)(cid:12)(cid:11)(cid:4)(cid:14)(cid:11)(cid:48)(cid:48)(cid:7)(cid:5)(cid:3)(cid:9)(cid:2)(cid:28)(cid:3,,7484.0
,,25,,,Unknown,,cid:3)(cid:5)(cid:14)(cid:70)(cid:12)(cid:11)(cid:4)(cid:14)(cid:11)(cid:48)(cid:48)(cid:7)(cid:5)(cid:3)(cid:9)(cid:2)(cid:12)(cid:11)(cid:4)(cid:14)(cid:11)(cid:48)(cid:48)(cid:7)(cid:5)(cid:3)(cid:9)(cid:2)(cid:28)(cid:3,,7509.0
,,2,,,Unknown,,cid:3)(cid:5)(cid:14)(cid:70)(cid:12)(cid:11)(cid:4)(cid:14)(cid:11)(cid:48)(cid:48)(cid:7)(cid:5)(cid:3)(cid:9)(cid:2)(cid:12)(cid:11)(cid:4)(cid:14)(cid:11)(cid:48)(cid:48)(cid:7)(cid:5)(cid:3)(cid:9)(cid:2)(cid:28)(cid:3,,7511.0
,,58,,,Unknown,,cid:3)(cid:5)(cid:14)(cid:70)(cid:12)(cid:11)(cid:4)(cid:14)(cid:11)(cid:48)(cid:48)(cid:7)(cid:5)(cid:3)(cid:9)(cid:2)(cid:12)(cid:11)(cid:4)(cid:14)(cid:11)(cid:48)(cid:48)(cid:7)(cid:5)(cid:3)(cid:9)(cid:2)(cid:28)(cid:3,,7569.0
,,58,,,Unknown,,cid:3)(cid:5)(cid:14)(cid:70)(cid:12)(cid:11)(cid:4)(cid:14)(cid:11)(cid:48)(cid:48)(cid:7)(cid:5)(cid:3)(cid:9)(cid:2)(cid:12)(cid:11)(cid:4)(cid:14)(cid:11)(cid:48)(cid:48)(cid:7)(cid:5)(cid:3)(cid:9)(cid:2)(cid:28)(cid:3,,7627.0
,,37,,,Unknown,,cid:3)(cid:5)(cid:14)(cid:70)(cid:12)(cid:11)(cid:4)(cid:14)(cid:11)(cid:48)(cid:48)(cid:7)(cid:5)(cid:3)(cid:9)(cid:2)(cid:12)(cid:11)(cid:4)(cid:14)(cid:11)(cid:48)(cid:48)(cid:7)(cid:5)(cid:3)(cid:9)(cid:2)(cid:28)(cid:3,,7664.0
,,16,,,Unknown,,cid:3)(cid:5)(cid:14)(cid:70)(cid:12)(cid:11)(cid:4)(cid:14)(cid:11)(cid:48)(cid:48)(cid:7)(cid:5)(cid:3)(cid:9)(cid:2)(cid:12)(cid:11)(cid:4)(cid:14)(cid:11)(cid:48)(cid:48)(cid:7)(cid:5)(cid:3)(cid:9)(cid:2)(cid:28)(cid:3,,7680.0
,,34,,,Unknown,,cid:3)(cid:5)(cid:14)(cid:70)(cid:12)(cid:11)(cid:4)(cid:14)(cid:11)(cid:48)(cid:48)(cid:7)(cid:5)(cid:3)(cid:9)(cid:2)(cid:12)(cid:11)(cid:4)(cid:14)(cid:11)(cid:48)(cid:48)(cid:7)(cid:5)(cid:3)(cid:9)(cid:2)(cid:28)(cid:3,,7714.0
,,33,,,Unknown,,cid:3)(cid:5)(cid:14)(cid:70)(cid:12)(cid:11)(cid:4)(cid:14)(cid:11)(cid:48)(cid:48)(cid:7)(cid:5)(cid:3)(cid:9)(cid:2)(cid:12)(cid:11)(cid:4)(cid:14)(cid:11)(cid:48)(cid:48)(cid:7)(cid:5)(cid:3)(cid:9)(cid:2)(cid:28)(cid:3,,7747.0
,,17,,,Unknown,,cid:3)(cid:5)(cid:14)(cid:70)(cid:12)(cid:11)(cid:4)(cid:14)(cid:11)(cid:48)(cid:48)(cid:7)(cid:5)(cid:3)(cid:9)(cid:2)(cid:12)(cid:11)(cid:4)(cid:14)(cid:11)(cid:48)(cid:48)(cid:7)(cid:5)(cid:3)(cid:9)(cid:2)(cid:28)(cid:3,,7764.0
,,37,,,Unknown,,cid:3)(cid:5)(cid:14)(cid:70)(cid:12)(cid:11)(cid:4)(cid:14)(cid:11)(cid:48)(cid:48)(cid:7)(cid:5)(cid:3)(cid:9)(cid:2)(cid:12)(cid:11)(cid:4)(cid:14)(cid:11)(cid:48)(cid:48)(cid:7)(cid:5)(cid:3)(cid:9)(cid:2)(cid:28)(cid:3,,7801.0
,,45,,,Unknown,,cid:3)(cid:5)(cid:14)(cid:70)(cid:12)(cid:11)(cid:4)(cid:14)(cid:11)(cid:48)(cid:48)(cid:7)(cid:5)(cid:3)(cid:9)(cid:2)(cid:12)(cid:11)(cid:4)(cid:14)(cid:11)(cid:48)(cid:48)(cid:7)(cid:5)(cid:3)(cid:9)(cid:2)(cid:28)(cid:3,,7846.0
,,18,,,Unknown,,cid:3)(cid:5)(cid:14)(cid:70)(cid:12)(cid:11)(cid:4)(cid:14)(cid:11)(cid:48)(cid:48)(cid:7)(cid:5)(cid:3)(cid:9)(cid:2)(cid:12)(cid:11)(cid:4)(cid:14)(cid:11)(cid:48)(cid:48)(cid:7)(cid:5)(cid:3)(cid:9)(cid:2)(cid:28)(cid:3,,7864.0
,,16,,,Unknown,,cid:3)(cid:5)(cid:14)(cid:70)(cid:12)(cid:11)(cid:4)(cid:14)(cid:11)(cid:48)(cid:48)(cid:7)(cid:5)(cid:3)(cid:9)(cid:2)(cid:12)(cid:11)(cid:4)(cid:14)(cid:11)(cid:48)(cid:48)(cid:7)(cid:5)(cid:3)(cid:9)(cid:2)(cid:28)(cid:3,,7880.0
,,39,,,Unknown,,cid:3)(cid:5)(cid:14)(cid:70)(cid:12)(cid:11)(cid:4)(cid:14)(cid:11)(cid:48)(cid:48)(cid:7)(cid:5)(cid:3)(cid:9)(cid:2)(cid:12)(cid:11)(cid:4)(cid:14)(cid:11)(cid:48)(cid:48)(cid:7)(cid:5)(cid:3)(cid:9)(cid:2)(cid:28)(cid:3,,7919.0
,,5,,,Unknown,,cid:3)(cid:5)(cid:14)(cid:70)(cid:12)(cid:11)(cid:4)(cid:14)(cid:11)(cid:48)(cid:48)(cid:7)(cid:5)(cid:3)(cid:9)(cid:2)(cid:12)(cid:11)(cid:4)(cid:14)(cid:11)(cid:48)(cid:48)(cid:7)(cid:5)(cid:3)(cid:9)(cid:2)(cid:28)(cid:3,,7924.0
,,71,,,Unknown,,cid:3)(cid:5)(cid:14)(cid:70)(cid:12)(cid:11)(cid:4)(cid:14)(cid:11)(cid:48)(cid:48)(cid:7)(cid:5)(cid:3)(cid:9)(cid:2)(cid:12)(cid:11)(cid:4)(cid:14)(cid:11)(cid:48)(cid:48)(cid:7)(cid:5)(cid:3)(cid:9)(cid:2)(cid:28)(cid:3,,7995.0
,,71,,,Unknown,,cid:3)(cid:5)(cid:14)(cid:70)(cid:12)(cid:11)(cid:4)(cid:14)(cid:11)(cid:48)(cid:48)(cid:7)(cid:5)(cid:3)(cid:9)(cid:2)(cid:12)(cid:11)(cid:4)(cid:14)(cid:11)(cid:48)(cid:48)(cid:7)(cid:5)(cid:3)(cid:9)(cid:2)(cid:28)(cid:3,,8066.0
,,5,,,Unknown,,cid:3)(cid:5)(cid:14)(cid:70)(cid:12)(cid:11)(cid:4)(cid:14)(cid:11)(cid:48)(cid:48)(cid:7)(cid:5)(cid:3)(cid:9)(cid:2)(cid:12)(cid:11)(cid:4)(cid:14)(cid:11)(cid:48)(cid:48)(cid:7)(cid:5)(cid:3)(cid:9)(cid:2)(cid:28)(cid:3,,8071.0
,,10,,,Unknown,,cid:3)(cid:5)(cid:14)(cid:70)(cid:12)(cid:11)(cid:4)(cid:14)(cid:11)(cid:48)(cid:48)(cid:7)(cid:5)(cid:3)(cid:9)(cid:2)(cid:12)(cid:11)(cid:4)(cid:14)(cid:11)(cid:48)(cid:48)(cid:7)(cid:5)(cid:3)(cid:9)(cid:2)(cid:28)(cid:3,,8081.0
,,10,,,Unknown,,cid:3)(cid:5)(cid:14)(cid:70)(cid:12)(cid:11)(cid:4)(cid:14)(cid:11)(cid:48)(cid:48)(cid:7)(cid:5)(cid:3)(cid:9)(cid:2)(cid:12)(cid:11)(cid:4)(cid:14)(cid:11)(cid:48)(cid:48)(cid:7)(cid:5)(cid:3)(cid:9)(cid:2)(cid:28)(cid:3,,8091.0
,,46,,,Unknown,,cid:3)(cid:5)(cid:14)(cid:70)(cid:12)(cid:11)(cid:4)(cid:14)(cid:11)(cid:48)(cid:48)(cid:7)(cid:5)(cid:3)(cid:9)(cid:2)(cid:12)(cid:11)(cid:4)(cid:14)(cid:11)(cid:48)(cid:48)(cid:7)(cid:5)(cid:3)(cid:9)(cid:2)(cid:28)(cid:3,,8137.0
,,2,,,Unknown,,cid:3)(cid:5)(cid:14)(cid:70)(cid:12)(cid:11)(cid:4)(cid:14)(cid:11)(cid:48)(cid:48)(cid:7)(cid:5)(cid:3)(cid:9)(cid:2)(cid:12)(cid:11)(cid:4)(cid:14)(cid:11)(cid:48)(cid:48)(cid:7)(cid:5)(cid:3)(cid:9)(cid:2)(cid:28)(cid:3,,8139.0
,,50,,,Unknown,,cid:3)(cid:5)(cid:14)(cid:70)(cid:12)(cid:11)(cid:4)(cid:14)(cid:11)(cid:48)(cid:48)(cid:7)(cid:5)(cid:3)(cid:9)(cid:2)(cid:12)(cid:11)(cid:4)(cid:14)(cid:11)(cid:48)(cid:48)(cid:7)(cid:5)(cid:3)(cid:9)(cid:2)(cid:28)(cid:3,,8189.0
,,5,,,Unknown,,cid:3)(cid:5)(cid:14)(cid:70)(cid:12)(cid:11)(cid:4)(cid:14)(cid:11)(cid:48)(cid:48)(cid:7)(cid:5)(cid:3)(cid:9)(cid:2)(cid:12)(cid:11)(cid:4)(cid:14)(cid:11)(cid:48)(cid:48)(cid:7)(cid:5)(cid:3)(cid:9)(cid:2)(cid:28)(cid:3,,8194.0
,,48,,,Unknown,,cid:3)(cid:5)(cid:14)(cid:70)(cid:12)(cid:11)(cid:4)(cid:14)(cid:11)(cid:48)(cid:48)(cid:7)(cid:5)(cid:3)(cid:9)(cid:2)(cid:12)(cid:11)(cid:4)(cid:14)(cid:11)(cid:48)(cid:48)(cid:7)(cid:5)(cid:3)(cid:9)(cid:2)(cid:28)(cid:3,,8242.0
,,5,,,Unknown,,cid:3)(cid:5)(cid:14)(cid:70)(cid:12)(cid:11)(cid:4)(cid:14)(cid:11)(cid:48)(cid:48)(cid:7)(cid:5)(cid:3)(cid:9)(cid:2)(cid:12)(cid:11)(cid:4)(cid:14)(cid:11)(cid:48)(cid:48)(cid:7)(cid:5)(cid:3)(cid:9)(cid:2)(cid:28)(cid:3,,8247.0
,,2,,,Unknown,,cid:3)(cid:5)(cid:14)(cid:70)(cid:12)(cid:11)(cid:4)(cid:14)(cid:11)(cid:48)(cid:48)(cid:7)(cid:5)(cid:3)(cid:9)(cid:2)(cid:12)(cid:11)(cid:4)(cid:14)(cid:11)(cid:48)(cid:48)(cid:7)(cid:5)(cid:3)(cid:9)(cid:2)(cid:28)(cid:3,,8249.0
,,14,,,Unknown,,cid:3)(cid:5)(cid:14)(cid:70)(cid:12)(cid:11)(cid:4)(cid:14)(cid:11)(cid:48)(cid:48)(cid:7)(cid:5)(cid:3)(cid:9)(cid:2)(cid:12)(cid:11)(cid:4)(cid:14)(cid:11)(cid:48)(cid:48)(cid:7)(cid:5)(cid:3)(cid:9)(cid:2)(cid:28)(cid:3,,8263.0
,,46,,,Unknown,,cid:3)(cid:5)(cid:14)(cid:70)(cid:12)(cid:11)(cid:4)(cid:14)(cid:11)(cid:48)(cid:48)(cid:7)(cid:5)(cid:3)(cid:9)(cid:2)(cid:12)(cid:11)(cid:4)(cid:14)(cid:11)(cid:48)(cid:48)(cid:7)(cid:5)(cid:3)(cid:9)(cid:2)(cid:28)(cid:3,,8309.0
,,2,,,Unknown,,cid:3)(cid:5)(cid:14)(cid:70)(cid:12)(cid:11)(cid:4)(cid:14)(cid:11)(cid:48)(cid:48)(cid:7)(cid:5)(cid:3)(cid:9)(cid:2)(cid:12)(cid:11)(cid:4)(cid:14)(cid:11)(cid:48)(cid:48)(cid:7)(cid:5)(cid:3)(cid:9)(cid:2)(cid:28)(cid:3,,8311.0
,,28,,,Unknown,,cid:3)(cid:5)(cid:14)(cid:70)(cid:12)(cid:11)(cid:4)(cid:14)(cid:11)(cid:48)(cid:48)(cid:7)(cid:5)(cid:3)(cid:9)(cid:2)(cid:12)(cid:11)(cid:4)(cid:14)(cid:11)(cid:48)(cid:48)(cid:7)(cid:5)(cid:3)(cid:9)(cid:2)(cid:28)(cid:3,,8339.0
,,5,,,Unknown,,cid:3)(cid:5)(cid:14)(cid:70)(cid:12)(cid:11)(cid:4)(cid:14)(cid:11)(cid:48)(cid:48)(cid:7)(cid:5)(cid:3)(cid:9)(cid:2)(cid:12)(cid:11)(cid:4)(cid:14)(cid:11)(cid:48)(cid:48)(cid:7)(cid:5)(cid:3)(cid:9)(cid:2)(cid:28)(cid:3,,8344.0
,,3,,,Unknown,,cid:3)(cid:5)(cid:14)(cid:70)(cid:12)(cid:11)(cid:4)(cid:14)(cid:11)(cid:48)(cid:48)(cid:7)(cid:5)(cid:3)(cid:9)(cid:2)(cid:12)(cid:11)(cid:4)(cid:14)(cid:11)(cid:48)(cid:48)(cid:7)(cid:5)(cid:3)(cid:9)(cid:2)(cid:28)(cid:3,,8347.0
,,10,,,Unknown,,cid:3)(cid:5)(cid:14)(cid:70)(cid:12)(cid:11)(cid:4)(cid:14)(cid:11)(cid:48)(cid:48)(cid:7)(cid:5)(cid:3)(cid:9)(cid:2)(cid:12)(cid:11)(cid:4)(cid:14)(cid:11)(cid:48)(cid:48)(cid:7)(cid:5)(cid:3)(cid:9)(cid:2)(cid:28)(cid:3,,8357.0
,,5,,,Unknown,,cid:3)(cid:5)(cid:14)(cid:70)(cid:12)(cid:11)(cid:4)(cid:14)(cid:11)(cid:48)(cid:48)(cid:7)(cid:5)(cid:3)(cid:9)(cid:2)(cid:12)(cid:11)(cid:4)(cid:14)(cid:11)(cid:48)(cid:48)(cid:7)(cid:5)(cid:3)(cid:9)(cid:2)(cid:28)(cid:3,,8362.0
,,2,,,Unknown,,cid:3)(cid:5)(cid:14)(cid:70)(cid:12)(cid:11)(cid:4)(cid:14)(cid:11)(cid:48)(cid:48)(cid:7)(cid:5)(cid:3)(cid:9)(cid:2)(cid:12)(cid:11)(cid:4)(cid:14)(cid:11)(cid:48)(cid:48)(cid:7)(cid:5)(cid:3)(cid:9)(cid:2)(cid:28)(cid:3,,8364.0
,,9,,,Unknown,,cid:3)(cid:5)(cid:14)(cid:70)(cid:12)(cid:11)(cid:4)(cid:14)(cid:11)(cid:48)(cid:48)(cid:7)(cid:5)(cid:3)(cid:9)(cid:2)(cid:12)(cid:11)(cid:4)(cid:14)(cid:11)(cid:48)(cid:48)(cid:7)(cid:5)(cid:3)(cid:9)(cid:2)(cid:28)(cid:3,,8373.0
,,11,,,Unknown,,cid:3)(cid:5)(cid:14)(cid:70)(cid:12)(cid:11)(cid:4)(cid:14)(cid:11)(cid:48)(cid:48)(cid:7)(cid:5)(cid:3)(cid:9)(cid:2)(cid:12)(cid:11)(cid:4)(cid:14)(cid:11)(cid:48)(cid:48)(cid:7)(cid:5)(cid:3)(cid:9)(cid:2)(cid:28)(cid:3,,8384.0
,,4,,,Unknown,,cid:3)(cid:5)(cid:14)(cid:70)(cid:12)(cid:11)(cid:4)(cid:14)(cid:11)(cid:48)(cid:48)(cid:7)(cid:5)(cid:3)(cid:9)(cid:2)(cid:12)(cid:11)(cid:4)(cid:14)(cid:11)(cid:48)(cid:48)(cid:7)(cid:5)(cid:3)(cid:9)(cid:2)(cid:28)(cid:3,,8388.0
,,2,,,Unknown,,cid:3)(cid:5)(cid:14)(cid:70)(cid:12)(cid:11)(cid:4)(cid:14)(cid:11)(cid:48)(cid:48)(cid:7)(cid:5)(cid:3)(cid:9)(cid:2)(cid:12)(cid:11)(cid:4)(cid:14)(cid:11)(cid:48)(cid:48)(cid:7)(cid:5)(cid:3)(cid:9)(cid:2)(cid:28)(cid:3,,8390.0
,,28,,,Unknown,,cid:3)(cid:5)(cid:14)(cid:70)(cid:12)(cid:11)(cid:4)(cid:14)(cid:11)(cid:48)(cid:48)(cid:7)(cid:5)(cid:3)(cid:9)(cid:2)(cid:12)(cid:11)(cid:4)(cid:14)(cid:11)(cid:48)(cid:48)(cid:7)(cid:5)(cid:3)(cid:9)(cid:2)(cid:28)(cid:3,,8418.0
,,3,,,Unknown,,cid:3)(cid:5)(cid:14)(cid:70)(cid:12)(cid:11)(cid:4)(cid:14)(cid:11)(cid:48)(cid:48)(cid:7)(cid:5)(cid:3)(cid:9)(cid:2)(cid:12)(cid:11)(cid:4)(cid:14)(cid:11)(cid:48)(cid:48)(cid:7)(cid:5)(cid:3)(cid:9)(cid:2)(cid:28)(cid:3,,8421.0
,,15,,,Unknown,,cid:3)(cid:5)(cid:14)(cid:70)(cid:12)(cid:11)(cid:4)(cid:14)(cid:11)(cid:48)(cid:48)(cid:7)(cid:5)(cid:3)(cid:9)(cid:2)(cid:12)(cid:11)(cid:4)(cid:14)(cid:11)(cid:48)(cid:48)(cid:7)(cid:5)(cid:3)(cid:9)(cid:2)(cid:28)(cid:3,,8436.0
,,2,,,Unknown,,cid:3)(cid:5)(cid:14)(cid:70)(cid:12)(cid:11)(cid:4)(cid:14)(cid:11)(cid:48)(cid:48)(cid:7)(cid:5)(cid:3)(cid:9)(cid:2)(cid:12)(cid:11)(cid:4)(cid:14)(cid:11)(cid:48)(cid:48)(cid:7)(cid:5)(cid:3)(cid:9)(cid:2)(cid:28)(cid:3,,8438.0
,,17,,,Unknown,,cid:3)(cid:5)(cid:14)(cid:70)(cid:12)(cid:11)(cid:4)(cid:14)(cid:11)(cid:48)(cid:48)(cid:7)(cid:5)(cid:3)(cid:9)(cid:2)(cid:12)(cid:11)(cid:4)(cid:14)(cid:11)(cid:48)(cid:48)(cid:7)(cid:5)(cid:3)(cid:9)(cid:2)(cid:28)(cid:3,,8455.0
,,18,,,Unknown,,cid:3)(cid:5)(cid:14)(cid:70)(cid:12)(cid:11)(cid:4)(cid:14)(cid:11)(cid:48)(cid:48)(cid:7)(cid:5)(cid:3)(cid:9)(cid:2)(cid:12)(cid:11)(cid:4)(cid:14)(cid:11)(cid:48)(cid:48)(cid:7)(cid:5)(cid:3)(cid:9)(cid:2)(cid:28)(cid:3,,8473.0
,,18,,,Unknown,,cid:3)(cid:5)(cid:14)(cid:70)(cid:12)(cid:11)(cid:4)(cid:14)(cid:11)(cid:48)(cid:48)(cid:7)(cid:5)(cid:3)(cid:9)(cid:2)(cid:12)(cid:11)(cid:4)(cid:14)(cid:11)(cid:48)(cid:48)(cid:7)(cid:5)(cid:3)(cid:9)(cid:2)(cid:28)(cid:3,,8491.0
,,19,,,Unknown,,cid:3)(cid:5)(cid:14)(cid:70)(cid:12)(cid:11)(cid:4)(cid:14)(cid:11)(cid:48)(cid:48)(cid:7)(cid:5)(cid:3)(cid:9)(cid:2)(cid:12)(cid:11)(cid:4)(cid:14)(cid:11)(cid:48)(cid:48)(cid:7)(cid:5)(cid:3)(cid:9)(cid:2)(cid:28)(cid:3,,8510.0
,,34,,,Unknown,,cid:3)(cid:5)(cid:14)(cid:70)(cid:12)(cid:11)(cid:4)(cid:14)(cid:11)(cid:48)(cid:48)(cid:7)(cid:5)(cid:3)(cid:9)(cid:2)(cid:12)(cid:11)(cid:4)(cid:14)(cid:11)(cid:48)(cid:48)(cid:7)(cid:5)(cid:3)(cid:9)(cid:2)(cid:28)(cid:3,,8544.0
,,18,,,Unknown,,cid:3)(cid:5)(cid:14)(cid:70)(cid:12)(cid:11)(cid:4)(cid:14)(cid:11)(cid:48)(cid:48)(cid:7)(cid:5)(cid:3)(cid:9)(cid:2)(cid:12)(cid:11)(cid:4)(cid:14)(cid:11)(cid:48)(cid:48)(cid:7)(cid:5)(cid:3)(cid:9)(cid:2)(cid:28)(cid:3,,8562.0
,,2,,,Unknown,,cid:3)(cid:5)(cid:14)(cid:70)(cid:12)(cid:11)(cid:4)(cid:14)(cid:11)(cid:48)(cid:48)(cid:7)(cid:5)(cid:3)(cid:9)(cid:2)(cid:12)(cid:11)(cid:4)(cid:14)(cid:11)(cid:48)(cid:48)(cid:7)(cid:5)(cid:3)(cid:9)(cid:2)(cid:28)(cid:3,,8564.0
,,44,,,Unknown,,cid:3)(cid:5)(cid:14)(cid:70)(cid:12)(cid:11)(cid:4)(cid:14)(cid:11)(cid:48)(cid:48)(cid:7)(cid:5)(cid:3)(cid:9)(cid:2)(cid:12)(cid:11)(cid:4)(cid:14)(cid:11)(cid:48)(cid:48)(cid:7)(cid:5)(cid:3)(cid:9)(cid:2)(cid:28)(cid:3,,8608.0
,,12,,,Unknown,,cid:3)(cid:5)(cid:14)(cid:70)(cid:12)(cid:11)(cid:4)(cid:14)(cid:11)(cid:48)(cid:48)(cid:7)(cid:5)(cid:3)(cid:9)(cid:2)(cid:12)(cid:11)(cid:4)(cid:14)(cid:11)(cid:48)(cid:48)(cid:7)(cid:5)(cid:3)(cid:9)(cid:2)(cid:28)(cid:3,,8620.0
,,29,,,Unknown,,cid:3)(cid:5)(cid:14)(cid:70)(cid:12)(cid:11)(cid:4)(cid:14)(cid:11)(cid:48)(cid:48)(cid:7)(cid:5)(cid:3)(cid:9)(cid:2)(cid:12)(cid:11)(cid:4)(cid:14)(cid:11)(cid:48)(cid:48)(cid:7)(cid:5)(cid:3)(cid:9)(cid:2)(cid:28)(cid:3,,8649.0
,,26,,,Unknown,,cid:3)(cid:5)(cid:14)(cid:70)(cid:12)(cid:11)(cid:4)(cid:14)(cid:11)(cid:48)(cid:48)(cid:7)(cid:5)(cid:3)(cid:9)(cid:2)(cid:12)(cid:11)(cid:4)(cid:14)(cid:11)(cid:48)(cid:48)(cid:7)(cid:5)(cid:3)(cid:9)(cid:2)(cid:28)(cid:3,,8675.0
,,41,,,Unknown,,cid:3)(cid:5)(cid:14)(cid:70)(cid:12)(cid:11)(cid:4)(cid:14)(cid:11)(cid:48)(cid:48)(cid:7)(cid:5)(cid:3)(cid:9)(cid:2)(cid:12)(cid:11)(cid:4)(cid:14)(cid:11)(cid:48)(cid:48)(cid:7)(cid:5)(cid:3)(cid:9)(cid:2)(cid:28)(cid:3,,8716.0
,,25,,,Unknown,,cid:3)(cid:5)(cid:14)(cid:70)(cid:12)(cid:11)(cid:4)(cid:14)(cid:11)(cid:48)(cid:48)(cid:7)(cid:5)(cid:3)(cid:9)(cid:2)(cid:12)(cid:11)(cid:4)(cid:14)(cid:11)(cid:48)(cid:48)(cid:7)(cid:5)(cid:3)(cid:9)(cid:2)(cid:28)(cid:3,,8741.0
,,2,,,Unknown,,cid:3)(cid:5)(cid:14)(cid:70)(cid:12)(cid:11)(cid:4)(cid:14)(cid:11)(cid:48)(cid:48)(cid:7)(cid:5)(cid:3)(cid:9)(cid:2)(cid:12)(cid:11)(cid:4)(cid:14)(cid:11)(cid:48)(cid:48)(cid:7)(cid:5)(cid:3)(cid:9)(cid:2)(cid:28)(cid:3,,8743.0
,,58,,,Unknown,,cid:3)(cid:5)(cid:14)(cid:70)(cid:12)(cid:11)(cid:4)(cid:14)(cid:11)(cid:48)(cid:48)(cid:7)(cid:5)(cid:3)(cid:9)(cid:2)(cid:12)(cid:11)(cid:4)(cid:14)(cid:11)(cid:48)(cid:48)(cid:7)(cid:5)(cid:3)(cid:9)(cid:2)(cid:28)(cid:3,,8801.0
,,58,,,Unknown,,cid:3)(cid:5)(cid:14)(cid:70)(cid:12)(cid:11)(cid:4)(cid:14)(cid:11)(cid:48)(cid:48)(cid:7)(cid:5)(cid:3)(cid:9)(cid:2)(cid:12)(cid:11)(cid:4)(cid:14)(cid:11)(cid:48)(cid:48)(cid:7)(cid:5)(cid:3)(cid:9)(cid:2)(cid:28)(cid:3,,8859.0
,,18,,,Unknown,,cid:3)(cid:5)(cid:14)(cid:70)(cid:12)(cid:11)(cid:4)(cid:14)(cid:11)(cid:48)(cid:48)(cid:7)(cid:5)(cid:3)(cid:9)(cid:2)(cid:12)(cid:11)(cid:4)(cid:14)(cid:11)(cid:48)(cid:48)(cid:7)(cid:5)(cid:3)(cid:9)(cid:2)(cid:28)(cid:3,,8877.0
,,1,,,Unknown,,cid:3)(cid:5)(cid:14)(cid:70)(cid:12)(cid:11)(cid:4)(cid:14)(cid:11)(cid:48)(cid:48)(cid:7)(cid:5)(cid:3)(cid:9)(cid:2)(cid:12)(cid:11)(cid:4)(cid:14)(cid:11)(cid:48)(cid:48)(cid:7)(cid:5)(cid:3)(cid:9)(cid:2)(cid:28)(cid:3,,8878.0
,,1,,,Unknown,,cid:3)(cid:5)(cid:14)(cid:70)(cid:12)(cid:11)(cid:4)(cid:14)(cid:11)(cid:48)(cid:48)(cid:7)(cid:5)(cid:3)(cid:9)(cid:2)(cid:12)(cid:11)(cid:4)(cid:14)(cid:11)(cid:48)(cid:48)(cid:7)(cid:5)(cid:3)(cid:9)(cid:2)(cid:28)(cid:3,,8879.0
,,37,,,Unknown,,cid:3)(cid:5)(cid:14)(cid:70)(cid:12)(cid:11)(cid:4)(cid:14)(cid:11)(cid:48)(cid:48)(cid:7)(cid:5)(cid:3)(cid:9)(cid:2)(cid:12)(cid:11)(cid:4)(cid:14)(cid:11)(cid:48)(cid:48)(cid:7)(cid:5)(cid:3)(cid:9)(cid:2)(cid:28)(cid:3,,8916.0
,,17,,,Unknown,,cid:3)(cid:5)(cid:14)(cid:70)(cid:12)(cid:11)(cid:4)(cid:14)(cid:11)(cid:48)(cid:48)(cid:7)(cid:5)(cid:3)(cid:9)(cid:2)(cid:12)(cid:11)(cid:4)(cid:14)(cid:11)(cid:48)(cid:48)(cid:7)(cid:5)(cid:3)(cid:9)(cid:2)(cid:28)(cid:3,,8933.0
,,37,,,Unknown,,cid:3)(cid:5)(cid:14)(cid:70)(cid:12)(cid:11)(cid:4)(cid:14)(cid:11)(cid:48)(cid:48)(cid:7)(cid:5)(cid:3)(cid:9)(cid:2)(cid:12)(cid:11)(cid:4)(cid:14)(cid:11)(cid:48)(cid:48)(cid:7)(cid:5)(cid:3)(cid:9)(cid:2)(cid:28)(cid:3,,8970.0
,,45,,,Unknown,,cid:3)(cid:5)(cid:14)(cid:70)(cid:12)(cid:11)(cid:4)(cid:14)(cid:11)(cid:48)(cid:48)(cid:7)(cid:5)(cid:3)(cid:9)(cid:2)(cid:12)(cid:11)(cid:4)(cid:14)(cid:11)(cid:48)(cid:48)(cid:7)(cid:5)(cid:3)(cid:9)(cid:2)(cid:28)(cid:3,,9015.0
,,18,,,Unknown,,cid:3)(cid:5)(cid:14)(cid:70)(cid:12)(cid:11)(cid:4)(cid:14)(cid:11)(cid:48)(cid:48)(cid:7)(cid:5)(cid:3)(cid:9)(cid:2)(cid:12)(cid:11)(cid:4)(cid:14)(cid:11)(cid:48)(cid:48)(cid:7)(cid:5)(cid:3)(cid:9)(cid:2)(cid:28)(cid:3,,9033.0
,,16,,,Unknown,,cid:3)(cid:5)(cid:14)(cid:70)(cid:12)(cid:11)(cid:4)(cid:14)(cid:11)(cid:48)(cid:48)(cid:7)(cid:5)(cid:3)(cid:9)(cid:2)(cid:12)(cid:11)(cid:4)(cid:14)(cid:11)(cid:48)(cid:48)(cid:7)(cid:5)(cid:3)(cid:9)(cid:2)(cid:28)(cid:3,,9049.0
,,39,,,Unknown,,cid:3)(cid:5)(cid:14)(cid:70)(cid:12)(cid:11)(cid:4)(cid:14)(cid:11)(cid:48)(cid:48)(cid:7)(cid:5)(cid:3)(cid:9)(cid:2)(cid:12)(cid:11)(cid:4)(cid:14)(cid:11)(cid:48)(cid:48)(cid:7)(cid:5)(cid:3)(cid:9)(cid:2)(cid:28)(cid:3,,9088.0
,,5,,,Unknown,,cid:3)(cid:5)(cid:14)(cid:70)(cid:12)(cid:11)(cid:4)(cid:14)(cid:11)(cid:48)(cid:48)(cid:7)(cid:5)(cid:3)(cid:9)(cid:2)(cid:12)(cid:11)(cid:4)(cid:14)(cid:11)(cid:48)(cid:48)(cid:7)(cid:5)(cid:3)(cid:9)(cid:2)(cid:28)(cid:3,,9093.0
,,71,,,Unknown,,cid:3)(cid:5)(cid:14)(cid:70)(cid:12)(cid:11)(cid:4)(cid:14)(cid:11)(cid:48)(cid:48)(cid:7)(cid:5)(cid:3)(cid:9)(cid:2)(cid:12)(cid:11)(cid:4)(cid:14)(cid:11)(cid:48)(cid:48)(cid:7)(cid:5)(cid:3)(cid:9)(cid:2)(cid:28)(cid:3,,9164.0
,,71,,,Unknown,,cid:3)(cid:5)(cid:14)(cid:70)(cid:12)(cid:11)(cid:4)(cid:14)(cid:11)(cid:48)(cid:48)(cid:7)(cid:5)(cid:3)(cid:9)(cid:2)(cid:12)(cid:11)(cid:4)(cid:14)(cid:11)(cid:48)(cid:48)(cid:7)(cid:5)(cid:3)(cid:9)(cid:2)(cid:28)(cid:3,,9235.0
,,5,,,Unknown,,cid:3)(cid:5)(cid:14)(cid:70)(cid:12)(cid:11)(cid:4)(cid:14)(cid:11)(cid:48)(cid:48)(cid:7)(cid:5)(cid:3)(cid:9)(cid:2)(cid:12)(cid:11)(cid:4)(cid:14)(cid:11)(cid:48)(cid:48)(cid:7)(cid:5)(cid:3)(cid:9)(cid:2)(cid:28)(cid:3,,9240.0
,,10,,,Unknown,,cid:3)(cid:5)(cid:14)(cid:70)(cid:12)(cid:11)(cid:4)(cid:14)(cid:11)(cid:48)(cid:48)(cid:7)(cid:5)(cid:3)(cid:9)(cid:2)(cid:12)(cid:11)(cid:4)(cid:14)(cid:11)(cid:48)(cid:48)(cid:7)(cid:5)(cid:3)(cid:9)(cid:2)(cid:28)(cid:3,,9250.0
,,10,,,Unknown,,cid:3)(cid:5)(cid:14)(cid:70)(cid:12)(cid:11)(cid:4)(cid:14)(cid:11)(cid:48)(cid:48)(cid:7)(cid:5)(cid:3)(cid:9)(cid:2)(cid:12)(cid:11)(cid:4)(cid:14)(cid:11)(cid:48)(cid:48)(cid:7)(cid:5)(cid:3)(cid:9)(cid:2)(cid:28)(cid:3,,9260.0
,,46,,,Unknown,,cid:3)(cid:5)(cid:14)(cid:70)(cid:12)(cid:11)(cid:4)(cid:14)(cid:11)(cid:48)(cid:48)(cid:7)(cid:5)(cid:3)(cid:9)(cid:2)(cid:12)(cid:11)(cid:4)(cid:14)(cid:11)(cid:48)(cid:48)(cid:7)(cid:5)(cid:3)(cid:9)(cid:2)(cid:28)(cid:3,,9306.0
,,2,,,Unknown,,cid:3)(cid:5)(cid:14)(cid:70)(cid:12)(cid:11)(cid:4)(cid:14)(cid:11)(cid:48)(cid:48)(cid:7)(cid:5)(cid:3)(cid:9)(cid:2)(cid:12)(cid:11)(cid:4)(cid:14)(cid:11)(cid:48)(cid:48)(cid:7)(cid:5)(cid:3)(cid:9)(cid:2)(cid:28)(cid:3,,9308.0
,,50,,,Unknown,,cid:3)(cid:5)(cid:14)(cid:70)(cid:12)(cid:11)(cid:4)(cid:14)(cid:11)(cid:48)(cid:48)(cid:7)(cid:5)(cid:3)(cid:9)(cid:2)(cid:12)(cid:11)(cid:4)(cid:14)(cid:11)(cid:48)(cid:48)(cid:7)(cid:5)(cid:3)(cid:9)(cid:2)(cid:28)(cid:3,,9358.0
,,5,,,Unknown,,cid:3)(cid:5)(cid:14)(cid:70)(cid:12)(cid:11)(cid:4)(cid:14)(cid:11)(cid:48)(cid:48)(cid:7)(cid:5)(cid:3)(cid:9)(cid:2)(cid:12)(cid:11)(cid:4)(cid:14)(cid:11)(cid:48)(cid:48)(cid:7)(cid:5)(cid:3)(cid:9)(cid:2)(cid:28)(cid:3,,9363.0
,,48,,,Unknown,,cid:3)(cid:5)(cid:14)(cid:70)(cid:12)(cid:11)(cid:4)(cid:14)(cid:11)(cid:48)(cid:48)(cid:7)(cid:5)(cid:3)(cid:9)(cid:2)(cid:12)(cid:11)(cid:4)(cid:14)(cid:11)(cid:48)(cid:48)(cid:7)(cid:5)(cid:3)(cid:9)(cid:2)(cid:28)(cid:3,,9411.0
,,5,,,Unknown,,cid:3)(cid:5)(cid:14)(cid:70)(cid:12)(cid:11)(cid:4)(cid:14)(cid:11)(cid:48)(cid:48)(cid:7)(cid:5)(cid:3)(cid:9)(cid:2)(cid:12)(cid:11)(cid:4)(cid:14)(cid:11)(cid:48)(cid:48)(cid:7)(cid:5)(cid:3)(cid:9)(cid:2)(cid:28)(cid:3,,9416.0
,,2,,,Unknown,,cid:3)(cid:5)(cid:14)(cid:70)(cid:12)(cid:11)(cid:4)(cid:14)(cid:11)(cid:48)(cid:48)(cid:7)(cid:5)(cid:3)(cid:9)(cid:2)(cid:12)(cid:11)(cid:4)(cid:14)(cid:11)(cid:48)(cid:48)(cid:7)(cid:5)(cid:3)(cid:9)(cid:2)(cid:28)(cid:3,,9418.0
,,14,,,Unknown,,cid:3)(cid:5)(cid:14)(cid:70)(cid:12)(cid:11)(cid:4)(cid:14)(cid:11)(cid:48)(cid:48)(cid:7)(cid:5)(cid:3)(cid:9)(cid:2)(cid:12)(cid:11)(cid:4)(cid:14)(cid:11)(cid:48)(cid:48)(cid:7)(cid:5)(cid:3)(cid:9)(cid:2)(cid:28)(cid:3,,9432.0
,,46,,,Unknown,,cid:3)(cid:5)(cid:14)(cid:70)(cid:12)(cid:11)(cid:4)(cid:14)(cid:11)(cid:48)(cid:48)(cid:7)(cid:5)(cid:3)(cid:9)(cid:2)(cid:12)(cid:11)(cid:4)(cid:14)(cid:11)(cid:48)(cid:48)(cid:7)(cid:5)(cid:3)(cid:9)(cid:2)(cid:28)(cid:3,,9478.0
,,2,,,Unknown,,cid:3)(cid:5)(cid:14)(cid:70)(cid:12)(cid:11)(cid:4)(cid:14)(cid:11)(cid:48)(cid:48)(cid:7)(cid:5)(cid:3)(cid:9)(cid:2)(cid:12)(cid:11)(cid:4)(cid:14)(cid:11)(cid:48)(cid:48)(cid:7)(cid:5)(cid:3)(cid:9)(cid:2)(cid:28)(cid:3,,9480.0
,,28,,,Unknown,,cid:3)(cid:5)(cid:14)(cid:70)(cid:12)(cid:11)(cid:4)(cid:14)(cid:11)(cid:48)(cid:48)(cid:7)(cid:5)(cid:3)(cid:9)(cid:2)(cid:12)(cid:11)(cid:4)(cid:14)(cid:11)(cid:48)(cid:48)(cid:7)(cid:5)(cid:3)(cid:9)(cid:2)(cid:28)(cid:3,,9508.0
,,5,,,Unknown,,cid:3)(cid:5)(cid:14)(cid:70)(cid:12)(cid:11)(cid:4)(cid:14)(cid:11)(cid:48)(cid:48)(cid:7)(cid:5)(cid:3)(cid:9)(cid:2)(cid:12)(cid:11)(cid:4)(cid:14)(cid:11)(cid:48)(cid:48)(cid:7)(cid:5)(cid:3)(cid:9)(cid:2)(cid:28)(cid:3,,9513.0
,,3,,,Unknown,,cid:3)(cid:5)(cid:14)(cid:70)(cid:12)(cid:11)(cid:4)(cid:14)(cid:11)(cid:48)(cid:48)(cid:7)(cid:5)(cid:3)(cid:9)(cid:2)(cid:12)(cid:11)(cid:4)(cid:14)(cid:11)(cid:48)(cid:48)(cid:7)(cid:5)(cid:3)(cid:9)(cid:2)(cid:28)(cid:3,,9516.0
,,10,,,Unknown,,cid:3)(cid:5)(cid:14)(cid:70)(cid:12)(cid:11)(cid:4)(cid:14)(cid:11)(cid:48)(cid:48)(cid:7)(cid:5)(cid:3)(cid:9)(cid:2)(cid:12)(cid:11)(cid:4)(cid:14)(cid:11)(cid:48)(cid:48)(cid:7)(cid:5)(cid:3)(cid:9)(cid:2)(cid:28)(cid:3,,9526.0
,,5,,,Unknown,,cid:3)(cid:5)(cid:14)(cid:70)(cid:12)(cid:11)(cid:4)(cid:14)(cid:11)(cid:48)(cid:48)(cid:7)(cid:5)(cid:3)(cid:9)(cid:2)(cid:12)(cid:11)(cid:4)(cid:14)(cid:11)(cid:48)(cid:48)(cid:7)(cid:5)(cid:3)(cid:9)(cid:2)(cid:28)(cid:3,,9531.0
,,2,,,Unknown,,cid:3)(cid:5)(cid:14)(cid:70)(cid:12)(cid:11)(cid:4)(cid:14)(cid:11)(cid:48)(cid:48)(cid:7)(cid:5)(cid:3)(cid:9)(cid:2)(cid:12)(cid:11)(cid:4)(cid:14)(cid:11)(cid:48)(cid:48)(cid:7)(cid:5)(cid:3)(cid:9)(cid:2)(cid:28)(cid:3,,9533.0
,,9,,,Unknown,,cid:3)(cid:5)(cid:14)(cid:70)(cid:12)(cid:11)(cid:4)(cid:14)(cid:11)(cid:48)(cid:48)(cid:7)(cid:5)(cid:3)(cid:9)(cid:2)(cid:12)(cid:11)(cid:4)(cid:14)(cid:11)(cid:48)(cid:48)(cid:7)(cid:5)(cid:3)(cid:9)(cid:2)(cid:28)(cid:3,,9542.0
,,11,,,Unknown,,cid:3)(cid:5)(cid:14)(cid:70)(cid:12)(cid:11)(cid:4)(cid:14)(cid:11)(cid:48)(cid:48)(cid:7)(cid:5)(cid:3)(cid:9)(cid:2)(cid:12)(cid:11)(cid:4)(cid:14)(cid:11)(cid:48)(cid:48)(cid:7)(cid:5)(cid:3)(cid:9)(cid:2)(cid:28)(cid:3,,9553.0
,,4,,,Unknown,,cid:3)(cid:5)(cid:14)(cid:70)(cid:12)(cid:11)(cid:4)(cid:14)(cid:11)(cid:48)(cid:48)(cid:7)(cid:5)(cid:3)(cid:9)(cid:2)(cid:12)(cid:11)(cid:4)(cid:14)(cid:11)(cid:48)(cid:48)(cid:7)(cid:5)(cid:3)(cid:9)(cid:2)(cid:28)(cid:3,,9557.0
,,2,,,Unknown,,cid:3)(cid:5)(cid:14)(cid:70)(cid:12)(cid:11)(cid:4)(cid:14)(cid:11)(cid:48)(cid:48)(cid:7)(cid:5)(cid:3)(cid:9)(cid:2)(cid:12)(cid:11)(cid:4)(cid:14)(cid:11)(cid:48)(cid:48)(cid:7)(cid:5)(cid:3)(cid:9)(cid:2)(cid:28)(cid:3,,9559.0
,,28,,,Unknown,,cid:3)(cid:5)(cid:14)(cid:70)(cid:12)(cid:11)(cid:4)(cid:14)(cid:11)(cid:48)(cid:48)(cid:7)(cid:5)(cid:3)(cid:9)(cid:2)(cid:12)(cid:11)(cid:4)(cid:14)(cid:11)(cid:48)(cid:48)(cid:7)(cid:5)(cid:3)(cid:9)(cid:2)(cid:28)(cid:3,,9587.0
,,3,,,Unknown,,cid:3)(cid:5)(cid:14)(cid:70)(cid:12)(cid:11)(cid:4)(cid:14)(cid:11)(cid:48)(cid:48)(cid:7)(cid:5)(cid:3)(cid:9)(cid:2)(cid:12)(cid:11)(cid:4)(cid:14)(cid:11)(cid:48)(cid:48)(cid:7)(cid:5)(cid:3)(cid:9)(cid:2)(cid:28)(cid:3,,9590.0
,,15,,,Unknown,,cid:3)(cid:5)(cid:14)(cid:70)(cid:12)(cid:11)(cid:4)(cid:14)(cid:11)(cid:48)(cid:48)(cid:7)(cid:5)(cid:3)(cid:9)(cid:2)(cid:12)(cid:11)(cid:4)(cid:14)(cid:11)(cid:48)(cid:48)(cid:7)(cid:5)(cid:3)(cid:9)(cid:2)(cid:28)(cid:3,,9605.0
,,2,,,Unknown,,cid:3)(cid:5)(cid:14)(cid:70)(cid:12)(cid:11)(cid:4)(cid:14)(cid:11)(cid:48)(cid:48)(cid:7)(cid:5)(cid:3)(cid:9)(cid:2)(cid:12)(cid:11)(cid:4)(cid:14)(cid:11)(cid:48)(cid:48)(cid:7)(cid:5)(cid:3)(cid:9)(cid:2)(cid:28)(cid:3,,9607.0
,,33,,,Unknown,,cid:3)(cid:5)(cid:14)(cid:70)(cid:12)(cid:11)(cid:4)(cid:14)(cid:11)(cid:48)(cid:48)(cid:7)(cid:5)(cid:3)(cid:9)(cid:2)(cid:12)(cid:11)(cid:4)(cid:14)(cid:11)(cid:48)(cid:48)(cid:7)(cid:5)(cid:3)(cid:9)(cid:2)(cid:28)(cid:3,,9640.0
,,16,,,Unknown,,cid:3)(cid:5)(cid:14)(cid:70)(cid:12)(cid:11)(cid:4)(cid:14)(cid:11)(cid:48)(cid:48)(cid:7)(cid:5)(cid:3)(cid:9)(cid:2)(cid:12)(cid:11)(cid:4)(cid:14)(cid:11)(cid:48)(cid:48)(cid:7)(cid:5)(cid:3)(cid:9)(cid:2)(cid:28)(cid:3,,9656.0
,,19,,,Unknown,,cid:3)(cid:5)(cid:14)(cid:70)(cid:12)(cid:11)(cid:4)(cid:14)(cid:11)(cid:48)(cid:48)(cid:7)(cid:5)(cid:3)(cid:9)(cid:2)(cid:12)(cid:11)(cid:4)(cid:14)(cid:11)(cid:48)(cid:48)(cid:7)(cid:5)(cid:3)(cid:9)(cid:2)(cid:28)(cid:3,,9675.0
,,34,,,Unknown,,cid:3)(cid:5)(cid:14)(cid:70)(cid:12)(cid:11)(cid:4)(cid:14)(cid:11)(cid:48)(cid:48)(cid:7)(cid:5)(cid:3)(cid:9)(cid:2)(cid:12)(cid:11)(cid:4)(cid:14)(cid:11)(cid:48)(cid:48)(cid:7)(cid:5)(cid:3)(cid:9)(cid:2)(cid:28)(cid:3,,9709.0
,,18,,,Unknown,,cid:3)(cid:5)(cid:14)(cid:70)(cid:12)(cid:11)(cid:4)(cid:14)(cid:11)(cid:48)(cid:48)(cid:7)(cid:5)(cid:3)(cid:9)(cid:2)(cid:12)(cid:11)(cid:4)(cid:14)(cid:11)(cid:48)(cid:48)(cid:7)(cid:5)(cid:3)(cid:9)(cid:2)(cid:28)(cid:3,,9727.0
,,2,,,Unknown,,cid:3)(cid:5)(cid:14)(cid:70)(cid:12)(cid:11)(cid:4)(cid:14)(cid:11)(cid:48)(cid:48)(cid:7)(cid:5)(cid:3)(cid:9)(cid:2)(cid:12)(cid:11)(cid:4)(cid:14)(cid:11)(cid:48)(cid:48)(cid:7)(cid:5)(cid:3)(cid:9)(cid:2)(cid:28)(cid:3,,9729.0
,,44,,,Unknown,,cid:3)(cid:5)(cid:14)(cid:70)(cid:12)(cid:11)(cid:4)(cid:14)(cid:11)(cid:48)(cid:48)(cid:7)(cid:5)(cid:3)(cid:9)(cid:2)(cid:12)(cid:11)(cid:4)(cid:14)(cid:11)(cid:48)(cid:48)(cid:7)(cid:5)(cid:3)(cid:9)(cid:2)(cid:28)(cid:3,,9773.0
,,12,,,Unknown,,cid:3)(cid:5)(cid:14)(cid:70)(cid:12)(cid:11)(cid:4)(cid:14)(cid:11)(cid:48)(cid:48)(cid:7)(cid:5)(cid:3)(cid:9)(cid:2)(cid:12)(cid:11)(cid:4)(cid:14)(cid:11)(cid:48)(cid:48)(cid:7)(cid:5)(cid:3)(cid:9)(cid:2)(cid:28)(cid:3,,9785.0
,,29,,,Unknown,,cid:3)(cid:5)(cid:14)(cid:70)(cid:12)(cid:11)(cid:4)(cid:14)(cid:11)(cid:48)(cid:48)(cid:7)(cid:5)(cid:3)(cid:9)(cid:2)(cid:12)(cid:11)(cid:4)(cid:14)(cid:11)(cid:48)(cid:48)(cid:7)(cid:5)(cid:3)(cid:9)(cid:2)(cid:28)(cid:3,,9814.0
,,26,,,Unknown,,cid:3)(cid:5)(cid:14)(cid:70)(cid:12)(cid:11)(cid:4)(cid:14)(cid:11)(cid:48)(cid:48)(cid:7)(cid:5)(cid:3)(cid:9)(cid:2)(cid:12)(cid:11)(cid:4)(cid:14)(cid:11)(cid:48)(cid:48)(cid:7)(cid:5)(cid:3)(cid:9)(cid:2)(cid:28)(cid:3,,9840.0
,,41,,,Unknown,,cid:3)(cid:5)(cid:14)(cid:70)(cid:12)(cid:11)(cid:4)(cid:14)(cid:11)(cid:48)(cid:48)(cid:7)(cid:5)(cid:3)(cid:9)(cid:2)(cid:12)(cid:11)(cid:4)(cid:14)(cid:11)(cid:48)(cid:48)(cid:7)(cid:5)(cid:3)(cid:9)(cid:2)(cid:28)(cid:3,,9881.0
,,25,,,Unknown,,cid:3)(cid:5)(cid:14)(cid:70)(cid:12)(cid:11)(cid:4)(cid:14)(cid:11)(cid:48)(cid:48)(cid:7)(cid:5)(cid:3)(cid:9)(cid:2)(cid:12)(cid:11)(cid:4)(cid:14)(cid:11)(cid:48)(cid:48)(cid:7)(cid:5)(cid:3)(cid:9)(cid:2)(cid:28)(cid:3,,9906.0
,,2,,,Unknown,,cid:3)(cid:5)(cid:14)(cid:70)(cid:12)(cid:11)(cid:4)(cid:14)(cid:11)(cid:48)(cid:48)(cid:7)(cid:5)(cid:3)(cid:9)(cid:2)(cid:12)(cid:11)(cid:4)(cid:14)(cid:11)(cid:48)(cid:48)(cid:7)(cid:5)(cid:3)(cid:9)(cid:2)(cid:28)(cid:3,,9908.0
,,58,,,Unknown,,cid:3)(cid:5)(cid:14)(cid:70)(cid:12)(cid:11)(cid:4)(cid:14)(cid:11)(cid:48)(cid:48)(cid:7)(cid:5)(cid:3)(cid:9)(cid:2)(cid:12)(cid:11)(cid:4)(cid:14)(cid:11)(cid:48)(cid:48)(cid:7)(cid:5)(cid:3)(cid:9)(cid:2)(cid:28)(cid:3,,9966.0
,,58,,,Unknown,,cid:3)(cid:5)(cid:14)(cid:70)(cid:12)(cid:11)(cid:4)(cid:14)(cid:11)(cid:48)(cid:48)(cid:7)(cid:5)(cid:3)(cid:9)(cid:2)(cid:12)(cid:11)(cid:4)(cid:14)(cid:11)(cid:48)(cid:48)(cid:7)(cid:5)(cid:3)(cid:9)(cid:2)(cid:28)(cid:3,,10024.0
,,18,,,Unknown,,cid:3)(cid:5)(cid:14)(cid:70)(cid:12)(cid:11)(cid:4)(cid:14)(cid:11)(cid:48)(cid:48)(cid:7)(cid:5)(cid:3)(cid:9)(cid:2)(cid:12)(cid:11)(cid:4)(cid:14)(cid:11)(cid:48)(cid:48)(cid:7)(cid:5)(cid:3)(cid:9)(cid:2)(cid:28)(cid:3,,10042.0
,,1,,,Unknown,,cid:3)(cid:5)(cid:14)(cid:70)(cid:12)(cid:11)(cid:4)(cid:14)(cid:11)(cid:48)(cid:48)(cid:7)(cid:5)(cid:3)(cid:9)(cid:2)(cid:12)(cid:11)(cid:4)(cid:14)(cid:11)(cid:48)(cid:48)(cid:7)(cid:5)(cid:3)(cid:9)(cid:2)(cid:28)(cid:3,,10043.0
,,1,,,Unknown,,cid:3)(cid:5)(cid:14)(cid:70)(cid:12)(cid:11)(cid:4)(cid:14)(cid:11)(cid:48)(cid:48)(cid:7)(cid:5)(cid:3)(cid:9)(cid:2)(cid:12)(cid:11)(cid:4)(cid:14)(cid:11)(cid:48)(cid:48)(cid:7)(cid:5)(cid:3)(cid:9)(cid:2)(cid:28)(cid:3,,10044.0
,,37,,,Unknown,,cid:3)(cid:5)(cid:14)(cid:70)(cid:12)(cid:11)(cid:4)(cid:14)(cid:11)(cid:48)(cid:48)(cid:7)(cid:5)(cid:3)(cid:9)(cid:2)(cid:12)(cid:11)(cid:4)(cid:14)(cid:11)(cid:48)(cid:48)(cid:7)(cid:5)(cid:3)(cid:9)(cid:2)(cid:28)(cid:3,,10081.0
,,17,,,Unknown,,cid:3)(cid:5)(cid:14)(cid:70)(cid:12)(cid:11)(cid:4)(cid:14)(cid:11)(cid:48)(cid:48)(cid:7)(cid:5)(cid:3)(cid:9)(cid:2)(cid:12)(cid:11)(cid:4)(cid:14)(cid:11)(cid:48)(cid:48)(cid:7)(cid:5)(cid:3)(cid:9)(cid:2)(cid:28)(cid:3,,10098.0
,,37,,,Unknown,,cid:3)(cid:5)(cid:14)(cid:70)(cid:12)(cid:11)(cid:4)(cid:14)(cid:11)(cid:48)(cid:48)(cid:7)(cid:5)(cid:3)(cid:9)(cid:2)(cid:12)(cid:11)(cid:4)(cid:14)(cid:11)(cid:48)(cid:48)(cid:7)(cid:5)(cid:3)(cid:9)(cid:2)(cid:28)(cid:3,,10135.0
,,45,,,Unknown,,cid:3)(cid:5)(cid:14)(cid:70)(cid:12)(cid:11)(cid:4)(cid:14)(cid:11)(cid:48)(cid:48)(cid:7)(cid:5)(cid:3)(cid:9)(cid:2)(cid:12)(cid:11)(cid:4)(cid:14)(cid:11)(cid:48)(cid:48)(cid:7)(cid:5)(cid:3)(cid:9)(cid:2)(cid:28)(cid:3,,10180.0
,,18,,,Unknown,,cid:3)(cid:5)(cid:14)(cid:70)(cid:12)(cid:11)(cid:4)(cid:14)(cid:11)(cid:48)(cid:48)(cid:7)(cid:5)(cid:3)(cid:9)(cid:2)(cid:12)(cid:11)(cid:4)(cid:14)(cid:11)(cid:48)(cid:48)(cid:7)(cid:5)(cid:3)(cid:9)(cid:2)(cid:28)(cid:3,,10198.0
,,16,,,Unknown,,cid:3)(cid:5)(cid:14)(cid:70)(cid:12)(cid:11)(cid:4)(cid:14)(cid:11)(cid:48)(cid:48)(cid:7)(cid:5)(cid:3)(cid:9)(cid:2)(cid:12)(cid:11)(cid:4)(cid:14)(cid:11)(cid:48)(cid:48)(cid:7)(cid:5)(cid:3)(cid:9)(cid:2)(cid:28)(cid:3,,10214.0
,,10,,,Unknown,,cid:3)(cid:5)(cid:14)(cid:70)(cid:12)(cid:11)(cid:4)(cid:14)(cid:11)(cid:48)(cid:48)(cid:7)(cid:5)(cid:3)(cid:9)(cid:2)(cid:12)(cid:11)(cid:4)(cid:14)(cid:11)(cid:48)(cid:48)(cid:7)(cid:5)(cid:3)(cid:9)(cid:2)(cid:28)(cid:3,,10224.0
,,46,,,Unknown,,cid:3)(cid:5)(cid:14)(cid:70)(cid:12)(cid:11)(cid:4)(cid:14)(cid:11)(cid:48)(cid:48)(cid:7)(cid:5)(cid:3)(cid:9)(cid:2)(cid:12)(cid:11)(cid:4)(cid:14)(cid:11)(cid:48)(cid:48)(cid:7)(cid:5)(cid:3)(cid:9)(cid:2)(cid:28)(cid:3,,10270.0
,,47,,,Unknown,,cid:3)(cid:5)(cid:14)(cid:70)(cid:12)(cid:11)(cid:4)(cid:14)(cid:11)(cid:48)(cid:48)(cid:7)(cid:5)(cid:3)(cid:9)(cid:2)(cid:12)(cid:11)(cid:4)(cid:14)(cid:11)(cid:48)(cid:48)(cid:7)(cid:5)(cid:3)(cid:9)(cid:2)(cid:28)(cid:3,,10317.0
,,46,,,Unknown,,cid:3)(cid:5)(cid:14)(cid:70)(cid:12)(cid:11)(cid:4)(cid:14)(cid:11)(cid:48)(cid:48)(cid:7)(cid:5)(cid:3)(cid:9)(cid:2)(cid:12)(cid:11)(cid:4)(cid:14)(cid:11)(cid:48)(cid:48)(cid:7)(cid:5)(cid:3)(cid:9)(cid:2)(cid:28)(cid:3,,10363.0
,,12,,,Unknown,,cid:3)(cid:5)(cid:14)(cid:70)(cid:12)(cid:11)(cid:4)(cid:14)(cid:11)(cid:48)(cid:48)(cid:7)(cid:5)(cid:3)(cid:9)(cid:2)(cid:12)(cid:11)(cid:4)(cid:14)(cid:11)(cid:48)(cid:48)(cid:7)(cid:5)(cid:3)(cid:9)(cid:2)(cid:28)(cid:3,,10375.0
,,2,,,Unknown,,cid:3)(cid:5)(cid:14)(cid:70)(cid:12)(cid:11)(cid:4)(cid:14)(cid:11)(cid:48)(cid:48)(cid:7)(cid:5)(cid:3)(cid:9)(cid:2)(cid:12)(cid:11)(cid:4)(cid:14)(cid:11)(cid:48)(cid:48)(cid:7)(cid:5)(cid:3)(cid:9)(cid:2)(cid:28)(cid:3,,10377.0
,,50,,,Unknown,,cid:3)(cid:5)(cid:14)(cid:70)(cid:12)(cid:11)(cid:4)(cid:14)(cid:11)(cid:48)(cid:48)(cid:7)(cid:5)(cid:3)(cid:9)(cid:2)(cid:12)(cid:11)(cid:4)(cid:14)(cid:11)(cid:48)(cid:48)(cid:7)(cid:5)(cid:3)(cid:9)(cid:2)(cid:28)(cid:3,,10427.0
,,5,,,Unknown,,cid:3)(cid:5)(cid:14)(cid:70)(cid:12)(cid:11)(cid:4)(cid:14)(cid:11)(cid:48)(cid:48)(cid:7)(cid:5)(cid:3)(cid:9)(cid:2)(cid:12)(cid:11)(cid:4)(cid:14)(cid:11)(cid:48)(cid:48)(cid:7)(cid:5)(cid:3)(cid:9)(cid:2)(cid:28)(cid:3,,10432.0
,,9,,,Unknown,,cid:3)(cid:5)(cid:14)(cid:70)(cid:12)(cid:11)(cid:4)(cid:14)(cid:11)(cid:48)(cid:48)(cid:7)(cid:5)(cid:3)(cid:9)(cid:2)(cid:12)(cid:11)(cid:4)(cid:14)(cid:11)(cid:48)(cid:48)(cid:7)(cid:5)(cid:3)(cid:9)(cid:2)(cid:28)(cid:3,,10441.0
,,2,,,Unknown,,cid:3)(cid:5)(cid:14)(cid:70)(cid:12)(cid:11)(cid:4)(cid:14)(cid:11)(cid:48)(cid:48)(cid:7)(cid:5)(cid:3)(cid:9)(cid:2)(cid:12)(cid:11)(cid:4)(cid:14)(cid:11)(cid:48)(cid:48)(cid:7)(cid:5)(cid:3)(cid:9)(cid:2)(cid:28)(cid:3,,10443.0
,,10,,,Unknown,,cid:3)(cid:5)(cid:14)(cid:70)(cid:12)(cid:11)(cid:4)(cid:14)(cid:11)(cid:48)(cid:48)(cid:7)(cid:5)(cid:3)(cid:9)(cid:2)(cid:12)(cid:11)(cid:4)(cid:14)(cid:11)(cid:48)(cid:48)(cid:7)(cid:5)(cid:3)(cid:9)(cid:2)(cid:28)(cid:3,,10453.0
,,5,,,Unknown,,cid:3)(cid:5)(cid:14)(cid:70)(cid:12)(cid:11)(cid:4)(cid:14)(cid:11)(cid:48)(cid:48)(cid:7)(cid:5)(cid:3)(cid:9)(cid:2)(cid:12)(cid:11)(cid:4)(cid:14)(cid:11)(cid:48)(cid:48)(cid:7)(cid:5)(cid:3)(cid:9)(cid:2)(cid:28)(cid:3,,10458.0
,,48,,,Unknown,,cid:3)(cid:5)(cid:14)(cid:70)(cid:12)(cid:11)(cid:4)(cid:14)(cid:11)(cid:48)(cid:48)(cid:7)(cid:5)(cid:3)(cid:9)(cid:2)(cid:12)(cid:11)(cid:4)(cid:14)(cid:11)(cid:48)(cid:48)(cid:7)(cid:5)(cid:3)(cid:9)(cid:2)(cid:28)(cid:3,,10506.0
,,2,,,Unknown,,cid:3)(cid:5)(cid:14)(cid:70)(cid:12)(cid:11)(cid:4)(cid:14)(cid:11)(cid:48)(cid:48)(cid:7)(cid:5)(cid:3)(cid:9)(cid:2)(cid:12)(cid:11)(cid:4)(cid:14)(cid:11)(cid:48)(cid:48)(cid:7)(cid:5)(cid:3)(cid:9)(cid:2)(cid:28)(cid:3,,10508.0
,,12,,,Unknown,,cid:3)(cid:5)(cid:14)(cid:70)(cid:12)(cid:11)(cid:4)(cid:14)(cid:11)(cid:48)(cid:48)(cid:7)(cid:5)(cid:3)(cid:9)(cid:2)(cid:12)(cid:11)(cid:4)(cid:14)(cid:11)(cid:48)(cid:48)(cid:7)(cid:5)(cid:3)(cid:9)(cid:2)(cid:28)(cid:3,,10520.0
,,11,,,Unknown,,cid:3)(cid:5)(cid:14)(cid:70)(cid:12)(cid:11)(cid:4)(cid:14)(cid:11)(cid:48)(cid:48)(cid:7)(cid:5)(cid:3)(cid:9)(cid:2)(cid:12)(cid:11)(cid:4)(cid:14)(cid:11)(cid:48)(cid:48)(cid:7)(cid:5)(cid:3)(cid:9)(cid:2)(cid:28)(cid:3,,10531.0
,,4,,,Unknown,,cid:3)(cid:5)(cid:14)(cid:70)(cid:12)(cid:11)(cid:4)(cid:14)(cid:11)(cid:48)(cid:48)(cid:7)(cid:5)(cid:3)(cid:9)(cid:2)(cid:12)(cid:11)(cid:4)(cid:14)(cid:11)(cid:48)(cid:48)(cid:7)(cid:5)(cid:3)(cid:9)(cid:2)(cid:28)(cid:3,,10535.0
,,14,,,Unknown,,cid:3)(cid:5)(cid:14)(cid:70)(cid:12)(cid:11)(cid:4)(cid:14)(cid:11)(cid:48)(cid:48)(cid:7)(cid:5)(cid:3)(cid:9)(cid:2)(cid:12)(cid:11)(cid:4)(cid:14)(cid:11)(cid:48)(cid:48)(cid:7)(cid:5)(cid:3)(cid:9)(cid:2)(cid:28)(cid:3,,10549.0
,,11,,,Unknown,,cid:3)(cid:5)(cid:14)(cid:70)(cid:12)(cid:11)(cid:4)(cid:14)(cid:11)(cid:48)(cid:48)(cid:7)(cid:5)(cid:3)(cid:9)(cid:2)(cid:12)(cid:11)(cid:4)(cid:14)(cid:11)(cid:48)(cid:48)(cid:7)(cid:5)(cid:3)(cid:9)(cid:2)(cid:28)(cid:3,,10560.0
,,48,,,Unknown,,cid:3)(cid:5)(cid:14)(cid:70)(cid:12)(cid:11)(cid:4)(cid:14)(cid:11)(cid:48)(cid:48)(cid:7)(cid:5)(cid:3)(cid:9)(cid:2)(cid:12)(cid:11)(cid:4)(cid:14)(cid:11)(cid:48)(cid:48)(cid:7)(cid:5)(cid:3)(cid:9)(cid:2)(cid:28)(cid:3,,10608.0
,,48,,,Unknown,,cid:3)(cid:5)(cid:14)(cid:70)(cid:12)(cid:11)(cid:4)(cid:14)(cid:11)(cid:48)(cid:48)(cid:7)(cid:5)(cid:3)(cid:9)(cid:2)(cid:12)(cid:11)(cid:4)(cid:14)(cid:11)(cid:48)(cid:48)(cid:7)(cid:5)(cid:3)(cid:9)(cid:2)(cid:28)(cid:3,,10656.0
,,7,,,Unknown,,cid:3)(cid:5)(cid:14)(cid:70)(cid:12)(cid:11)(cid:4)(cid:14)(cid:11)(cid:48)(cid:48)(cid:7)(cid:5)(cid:3)(cid:9)(cid:2)(cid:12)(cid:11)(cid:4)(cid:14)(cid:11)(cid:48)(cid:48)(cid:7)(cid:5)(cid:3)(cid:9)(cid:2)(cid:28)(cid:3,,10663.0
,,5,,,Unknown,,cid:3)(cid:5)(cid:14)(cid:70)(cid:12)(cid:11)(cid:4)(cid:14)(cid:11)(cid:48)(cid:48)(cid:7)(cid:5)(cid:3)(cid:9)(cid:2)(cid:12)(cid:11)(cid:4)(cid:14)(cid:11)(cid:48)(cid:48)(cid:7)(cid:5)(cid:3)(cid:9)(cid:2)(cid:28)(cid:3,,10668.0
,,3,,,Unknown,,cid:3)(cid:5)(cid:14)(cid:70)(cid:12)(cid:11)(cid:4)(cid:14)(cid:11)(cid:48)(cid:48)(cid:7)(cid:5)(cid:3)(cid:9)(cid:2)(cid:12)(cid:11)(cid:4)(cid:14)(cid:11)(cid:48)(cid:48)(cid:7)(cid:5)(cid:3)(cid:9)(cid:2)(cid:28)(cid:3,,10671.0
,,2,,,Unknown,,cid:3)(cid:5)(cid:14)(cid:70)(cid:12)(cid:11)(cid:4)(cid:14)(cid:11)(cid:48)(cid:48)(cid:7)(cid:5)(cid:3)(cid:9)(cid:2)(cid:12)(cid:11)(cid:4)(cid:14)(cid:11)(cid:48)(cid:48)(cid:7)(cid:5)(cid:3)(cid:9)(cid:2)(cid:28)(cid:3,,10673.0
,,28,,,Unknown,,cid:3)(cid:5)(cid:14)(cid:70)(cid:12)(cid:11)(cid:4)(cid:14)(cid:11)(cid:48)(cid:48)(cid:7)(cid:5)(cid:3)(cid:9)(cid:2)(cid:12)(cid:11)(cid:4)(cid:14)(cid:11)(cid:48)(cid:48)(cid:7)(cid:5)(cid:3)(cid:9)(cid:2)(cid:28)(cid:3,,10701.0
,,3,,,Unknown,,cid:3)(cid:5)(cid:14)(cid:70)(cid:12)(cid:11)(cid:4)(cid:14)(cid:11)(cid:48)(cid:48)(cid:7)(cid:5)(cid:3)(cid:9)(cid:2)(cid:12)(cid:11)(cid:4)(cid:14)(cid:11)(cid:48)(cid:48)(cid:7)(cid:5)(cid:3)(cid:9)(cid:2)(cid:28)(cid:3,,10704.0
,,15,,,Unknown,,cid:3)(cid:5)(cid:14)(cid:70)(cid:12)(cid:11)(cid:4)(cid:14)(cid:11)(cid:48)(cid:48)(cid:7)(cid:5)(cid:3)(cid:9)(cid:2)(cid:12)(cid:11)(cid:4)(cid:14)(cid:11)(cid:48)(cid:48)(cid:7)(cid:5)(cid:3)(cid:9)(cid:2)(cid:28)(cid:3,,10719.0
,,2,,,Unknown,,cid:3)(cid:5)(cid:14)(cid:70)(cid:12)(cid:11)(cid:4)(cid:14)(cid:11)(cid:48)(cid:48)(cid:7)(cid:5)(cid:3)(cid:9)(cid:2)(cid:12)(cid:11)(cid:4)(cid:14)(cid:11)(cid:48)(cid:48)(cid:7)(cid:5)(cid:3)(cid:9)(cid:2)(cid:28)(cid:3,,10721.0
,,37,,,Unknown,,cid:3)(cid:5)(cid:14)(cid:70)(cid:12)(cid:11)(cid:4)(cid:14)(cid:11)(cid:48)(cid:48)(cid:7)(cid:5)(cid:3)(cid:9)(cid:2)(cid:12)(cid:11)(cid:4)(cid:14)(cid:11)(cid:48)(cid:48)(cid:7)(cid:5)(cid:3)(cid:9)(cid:2)(cid:28)(cid:3,,10758.0
,,17,,,Unknown,,cid:3)(cid:5)(cid:14)(cid:70)(cid:12)(cid:11)(cid:4)(cid:14)(cid:11)(cid:48)(cid:48)(cid:7)(cid:5)(cid:3)(cid:9)(cid:2)(cid:12)(cid:11)(cid:4)(cid:14)(cid:11)(cid:48)(cid:48)(cid:7)(cid:5)(cid:3)(cid:9)(cid:2)(cid:28)(cid:3,,10775.0
,,19,,,Unknown,,cid:3)(cid:5)(cid:14)(cid:70)(cid:12)(cid:11)(cid:4)(cid:14)(cid:11)(cid:48)(cid:48)(cid:7)(cid:5)(cid:3)(cid:9)(cid:2)(cid:12)(cid:11)(cid:4)(cid:14)(cid:11)(cid:48)(cid:48)(cid:7)(cid:5)(cid:3)(cid:9)(cid:2)(cid:28)(cid:3,,10794.0
,,36,,,Unknown,,cid:3)(cid:5)(cid:14)(cid:70)(cid:12)(cid:11)(cid:4)(cid:14)(cid:11)(cid:48)(cid:48)(cid:7)(cid:5)(cid:3)(cid:9)(cid:2)(cid:12)(cid:11)(cid:4)(cid:14)(cid:11)(cid:48)(cid:48)(cid:7)(cid:5)(cid:3)(cid:9)(cid:2)(cid:28)(cid:3,,10830.0
,,18,,,Unknown,,cid:3)(cid:5)(cid:14)(cid:70)(cid:12)(cid:11)(cid:4)(cid:14)(cid:11)(cid:48)(cid:48)(cid:7)(cid:5)(cid:3)(cid:9)(cid:2)(cid:12)(cid:11)(cid:4)(cid:14)(cid:11)(cid:48)(cid:48)(cid:7)(cid:5)(cid:3)(cid:9)(cid:2)(cid:28)(cid:3,,10848.0
,,2,,,Unknown,,cid:3)(cid:5)(cid:14)(cid:70)(cid:12)(cid:11)(cid:4)(cid:14)(cid:11)(cid:48)(cid:48)(cid:7)(cid:5)(cid:3)(cid:9)(cid:2)(cid:12)(cid:11)(cid:4)(cid:14)(cid:11)(cid:48)(cid:48)(cid:7)(cid:5)(cid:3)(cid:9)(cid:2)(cid:28)(cid:3,,10850.0
,,44,,,Unknown,,cid:3)(cid:5)(cid:14)(cid:70)(cid:12)(cid:11)(cid:4)(cid:14)(cid:11)(cid:48)(cid:48)(cid:7)(cid:5)(cid:3)(cid:9)(cid:2)(cid:12)(cid:11)(cid:4)(cid:14)(cid:11)(cid:48)(cid:48)(cid:7)(cid:5)(cid:3)(cid:9)(cid:2)(cid:28)(cid:3,,10894.0
,,12,,,Unknown,,cid:3)(cid:5)(cid:14)(cid:70)(cid:12)(cid:11)(cid:4)(cid:14)(cid:11)(cid:48)(cid:48)(cid:7)(cid:5)(cid:3)(cid:9)(cid:2)(cid:12)(cid:11)(cid:4)(cid:14)(cid:11)(cid:48)(cid:48)(cid:7)(cid:5)(cid:3)(cid:9)(cid:2)(cid:28)(cid:3,,10906.0
,,29,,,Unknown,,cid:3)(cid:5)(cid:14)(cid:70)(cid:12)(cid:11)(cid:4)(cid:14)(cid:11)(cid:48)(cid:48)(cid:7)(cid:5)(cid:3)(cid:9)(cid:2)(cid:12)(cid:11)(cid:4)(cid:14)(cid:11)(cid:48)(cid:48)(cid:7)(cid:5)(cid:3)(cid:9)(cid:2)(cid:28)(cid:3,,10935.0
,,26,,,Unknown,,cid:3)(cid:5)(cid:14)(cid:70)(cid:12)(cid:11)(cid:4)(cid:14)(cid:11)(cid:48)(cid:48)(cid:7)(cid:5)(cid:3)(cid:9)(cid:2)(cid:12)(cid:11)(cid:4)(cid:14)(cid:11)(cid:48)(cid:48)(cid:7)(cid:5)(cid:3)(cid:9)(cid:2)(cid:28)(cid:3,,10961.0
,,41,,,Unknown,,cid:3)(cid:5)(cid:14)(cid:70)(cid:12)(cid:11)(cid:4)(cid:14)(cid:11)(cid:48)(cid:48)(cid:7)(cid:5)(cid:3)(cid:9)(cid:2)(cid:12)(cid:11)(cid:4)(cid:14)(cid:11)(cid:48)(cid:48)(cid:7)(cid:5)(cid:3)(cid:9)(cid:2)(cid:28)(cid:3,,11002.0
,,25,,,Unknown,,cid:3)(cid:5)(cid:14)(cid:70)(cid:12)(cid:11)(cid:4)(cid:14)(cid:11)(cid:48)(cid:48)(cid:7)(cid:5)(cid:3)(cid:9)(cid:2)(cid:12)(cid:11)(cid:4)(cid:14)(cid:11)(cid:48)(cid:48)(cid:7)(cid:5)(cid:3)(cid:9)(cid:2)(cid:28)(cid:3,,11027.0
,,2,,,Unknown,,cid:3)(cid:5)(cid:14)(cid:70)(cid:12)(cid:11)(cid:4)(cid:14)(cid:11)(cid:48)(cid:48)(cid:7)(cid:5)(cid:3)(cid:9)(cid:2)(cid:12)(cid:11)(cid:4)(cid:14)(cid:11)(cid:48)(cid:48)(cid:7)(cid:5)(cid:3)(cid:9)(cid:2)(cid:28)(cid:3,,11029.0
,,58,,,Unknown,,cid:3)(cid:5)(cid:14)(cid:70)(cid:12)(cid:11)(cid:4)(cid:14)(cid:11)(cid:48)(cid:48)(cid:7)(cid:5)(cid:3)(cid:9)(cid:2)(cid:12)(cid:11)(cid:4)(cid:14)(cid:11)(cid:48)(cid:48)(cid:7)(cid:5)(cid:3)(cid:9)(cid:2)(cid:28)(cid:3,,11087.0
,,58,,,Unknown,,cid:3)(cid:5)(cid:14)(cid:70)(cid:12)(cid:11)(cid:4)(cid:14)(cid:11)(cid:48)(cid:48)(cid:7)(cid:5)(cid:3)(cid:9)(cid:2)(cid:12)(cid:11)(cid:4)(cid:14)(cid:11)(cid:48)(cid:48)(cid:7)(cid:5)(cid:3)(cid:9)(cid:2)(cid:28)(cid:3,,11145.0
,,37,,,Unknown,,cid:3)(cid:5)(cid:14)(cid:70)(cid:12)(cid:11)(cid:4)(cid:14)(cid:11)(cid:48)(cid:48)(cid:7)(cid:5)(cid:3)(cid:9)(cid:2)(cid:12)(cid:11)(cid:4)(cid:14)(cid:11)(cid:48)(cid:48)(cid:7)(cid:5)(cid:3)(cid:9)(cid:2)(cid:28)(cid:3,,11182.0
,,16,,,Unknown,,cid:3)(cid:5)(cid:14)(cid:70)(cid:12)(cid:11)(cid:4)(cid:14)(cid:11)(cid:48)(cid:48)(cid:7)(cid:5)(cid:3)(cid:9)(cid:2)(cid:12)(cid:11)(cid:4)(cid:14)(cid:11)(cid:48)(cid:48)(cid:7)(cid:5)(cid:3)(cid:9)(cid:2)(cid:28)(cid:3,,11198.0
,,34,,,Unknown,,cid:3)(cid:5)(cid:14)(cid:70)(cid:12)(cid:11)(cid:4)(cid:14)(cid:11)(cid:48)(cid:48)(cid:7)(cid:5)(cid:3)(cid:9)(cid:2)(cid:12)(cid:11)(cid:4)(cid:14)(cid:11)(cid:48)(cid:48)(cid:7)(cid:5)(cid:3)(cid:9)(cid:2)(cid:28)(cid:3,,11232.0
,,33,,,Unknown,,cid:3)(cid:5)(cid:14)(cid:70)(cid:12)(cid:11)(cid:4)(cid:14)(cid:11)(cid:48)(cid:48)(cid:7)(cid:5)(cid:3)(cid:9)(cid:2)(cid:12)(cid:11)(cid:4)(cid:14)(cid:11)(cid:48)(cid:48)(cid:7)(cid:5)(cid:3)(cid:9)(cid:2)(cid:28)(cid:3,,11265.0
,,17,,,Unknown,,cid:3)(cid:5)(cid:14)(cid:70)(cid:12)(cid:11)(cid:4)(cid:14)(cid:11)(cid:48)(cid:48)(cid:7)(cid:5)(cid:3)(cid:9)(cid:2)(cid:12)(cid:11)(cid:4)(cid:14)(cid:11)(cid:48)(cid:48)(cid:7)(cid:5)(cid:3)(cid:9)(cid:2)(cid:28)(cid:3,,11282.0
,,36,,,Unknown,,cid:3)(cid:5)(cid:14)(cid:70)(cid:12)(cid:11)(cid:4)(cid:14)(cid:11)(cid:48)(cid:48)(cid:7)(cid:5)(cid:3)(cid:9)(cid:2)(cid:12)(cid:11)(cid:4)(cid:14)(cid:11)(cid:48)(cid:48)(cid:7)(cid:5)(cid:3)(cid:9)(cid:2)(cid:28)(cid:3,,11318.0
,,45,,,Unknown,,cid:3)(cid:5)(cid:14)(cid:70)(cid:12)(cid:11)(cid:4)(cid:14)(cid:11)(cid:48)(cid:48)(cid:7)(cid:5)(cid:3)(cid:9)(cid:2)(cid:12)(cid:11)(cid:4)(cid:14)(cid:11)(cid:48)(cid:48)(cid:7)(cid:5)(cid:3)(cid:9)(cid:2)(cid:28)(cid:3,,11363.0
,,18,,,Unknown,,cid:3)(cid:5)(cid:14)(cid:70)(cid:12)(cid:11)(cid:4)(cid:14)(cid:11)(cid:48)(cid:48)(cid:7)(cid:5)(cid:3)(cid:9)(cid:2)(cid:12)(cid:11)(cid:4)(cid:14)(cid:11)(cid:48)(cid:48)(cid:7)(cid:5)(cid:3)(cid:9)(cid:2)(cid:28)(cid:3,,11381.0
,,16,,,Unknown,,cid:3)(cid:5)(cid:14)(cid:70)(cid:12)(cid:11)(cid:4)(cid:14)(cid:11)(cid:48)(cid:48)(cid:7)(cid:5)(cid:3)(cid:9)(cid:2)(cid:12)(cid:11)(cid:4)(cid:14)(cid:11)(cid:48)(cid:48)(cid:7)(cid:5)(cid:3)(cid:9)(cid:2)(cid:28)(cid:3,,11397.0
,,48,,,Unknown,,cid:3)(cid:5)(cid:14)(cid:70)(cid:12)(cid:11)(cid:4)(cid:14)(cid:11)(cid:48)(cid:48)(cid:7)(cid:5)(cid:3)(cid:9)(cid:2)(cid:12)(cid:11)(cid:4)(cid:14)(cid:11)(cid:48)(cid:48)(cid:7)(cid:5)(cid:3)(cid:9)(cid:2)(cid:28)(cid:3,,11445.0
,,12,,,Unknown,,cid:3)(cid:5)(cid:14)(cid:70)(cid:12)(cid:11)(cid:4)(cid:14)(cid:11)(cid:48)(cid:48)(cid:7)(cid:5)(cid:3)(cid:9)(cid:2)(cid:12)(cid:11)(cid:4)(cid:14)(cid:11)(cid:48)(cid:48)(cid:7)(cid:5)(cid:3)(cid:9)(cid:2)(cid:28)(cid:3,,11457.0
,,2,,,Unknown,,cid:3)(cid:5)(cid:14)(cid:70)(cid:12)(cid:11)(cid:4)(cid:14)(cid:11)(cid:48)(cid:48)(cid:7)(cid:5)(cid:3)(cid:9)(cid:2)(cid:12)(cid:11)(cid:4)(cid:14)(cid:11)(cid:48)(cid:48)(cid:7)(cid:5)(cid:3)(cid:9)(cid:2)(cid:28)(cid:3,,11459.0
,,50,,,Unknown,,cid:3)(cid:5)(cid:14)(cid:70)(cid:12)(cid:11)(cid:4)(cid:14)(cid:11)(cid:48)(cid:48)(cid:7)(cid:5)(cid:3)(cid:9)(cid:2)(cid:12)(cid:11)(cid:4)(cid:14)(cid:11)(cid:48)(cid:48)(cid:7)(cid:5)(cid:3)(cid:9)(cid:2)(cid:28)(cid:3,,11509.0
,,11,,,Unknown,,cid:3)(cid:5)(cid:14)(cid:70)(cid:12)(cid:11)(cid:4)(cid:14)(cid:11)(cid:48)(cid:48)(cid:7)(cid:5)(cid:3)(cid:9)(cid:2)(cid:12)(cid:11)(cid:4)(cid:14)(cid:11)(cid:48)(cid:48)(cid:7)(cid:5)(cid:3)(cid:9)(cid:2)(cid:28)(cid:3,,11520.0
,,8,,,Unknown,,cid:3)(cid:5)(cid:14)(cid:70)(cid:12)(cid:11)(cid:4)(cid:14)(cid:11)(cid:48)(cid:48)(cid:7)(cid:5)(cid:3)(cid:9)(cid:2)(cid:12)(cid:11)(cid:4)(cid:14)(cid:11)(cid:48)(cid:48)(cid:7)(cid:5)(cid:3)(cid:9)(cid:2)(cid:28)(cid:3,,11528.0
,,46,,,Unknown,,cid:3)(cid:5)(cid:14)(cid:70)(cid:12)(cid:11)(cid:4)(cid:14)(cid:11)(cid:48)(cid:48)(cid:7)(cid:5)(cid:3)(cid:9)(cid:2)(cid:12)(cid:11)(cid:4)(cid:14)(cid:11)(cid:48)(cid:48)(cid:7)(cid:5)(cid:3)(cid:9)(cid:2)(cid:28)(cid:3,,11574.0
,,14,,,Unknown,,cid:3)(cid:5)(cid:14)(cid:70)(cid:12)(cid:11)(cid:4)(cid:14)(cid:11)(cid:48)(cid:48)(cid:7)(cid:5)(cid:3)(cid:9)(cid:2)(cid:12)(cid:11)(cid:4)(cid:14)(cid:11)(cid:48)(cid:48)(cid:7)(cid:5)(cid:3)(cid:9)(cid:2)(cid:28)(cid:3,,11588.0
,,50,,,Unknown,,cid:3)(cid:5)(cid:14)(cid:70)(cid:12)(cid:11)(cid:4)(cid:14)(cid:11)(cid:48)(cid:48)(cid:7)(cid:5)(cid:3)(cid:9)(cid:2)(cid:12)(cid:11)(cid:4)(cid:14)(cid:11)(cid:48)(cid:48)(cid:7)(cid:5)(cid:3)(cid:9)(cid:2)(cid:28)(cid:3,,11638.0
,,69,,,Unknown,,cid:3)(cid:5)(cid:14)(cid:70)(cid:12)(cid:11)(cid:4)(cid:14)(cid:11)(cid:48)(cid:48)(cid:7)(cid:5)(cid:3)(cid:9)(cid:2)(cid:12)(cid:11)(cid:4)(cid:14)(cid:11)(cid:48)(cid:48)(cid:7)(cid:5)(cid:3)(cid:9)(cid:2)(cid:28)(cid:3,,11707.0
,,9,,,Unknown,,cid:3)(cid:5)(cid:14)(cid:70)(cid:12)(cid:11)(cid:4)(cid:14)(cid:11)(cid:48)(cid:48)(cid:7)(cid:5)(cid:3)(cid:9)(cid:2)(cid:12)(cid:11)(cid:4)(cid:14)(cid:11)(cid:48)(cid:48)(cid:7)(cid:5)(cid:3)(cid:9)(cid:2)(cid:28)(cid:3,,11716.0
,,2,,,Unknown,,cid:3)(cid:5)(cid:14)(cid:70)(cid:12)(cid:11)(cid:4)(cid:14)(cid:11)(cid:48)(cid:48)(cid:7)(cid:5)(cid:3)(cid:9)(cid:2)(cid:12)(cid:11)(cid:4)(cid:14)(cid:11)(cid:48)(cid:48)(cid:7)(cid:5)(cid:3)(cid:9)(cid:2)(cid:28)(cid:3,,11718.0
,,12,,,Unknown,,cid:3)(cid:5)(cid:14)(cid:70)(cid:12)(cid:11)(cid:4)(cid:14)(cid:11)(cid:48)(cid:48)(cid:7)(cid:5)(cid:3)(cid:9)(cid:2)(cid:12)(cid:11)(cid:4)(cid:14)(cid:11)(cid:48)(cid:48)(cid:7)(cid:5)(cid:3)(cid:9)(cid:2)(cid:28)(cid:3,,11730.0
,,11,,,Unknown,,cid:3)(cid:5)(cid:14)(cid:70)(cid:12)(cid:11)(cid:4)(cid:14)(cid:11)(cid:48)(cid:48)(cid:7)(cid:5)(cid:3)(cid:9)(cid:2)(cid:12)(cid:11)(cid:4)(cid:14)(cid:11)(cid:48)(cid:48)(cid:7)(cid:5)(cid:3)(cid:9)(cid:2)(cid:28)(cid:3,,11741.0
,,4,,,Unknown,,cid:3)(cid:5)(cid:14)(cid:70)(cid:12)(cid:11)(cid:4)(cid:14)(cid:11)(cid:48)(cid:48)(cid:7)(cid:5)(cid:3)(cid:9)(cid:2)(cid:12)(cid:11)(cid:4)(cid:14)(cid:11)(cid:48)(cid:48)(cid:7)(cid:5)(cid:3)(cid:9)(cid:2)(cid:28)(cid:3,,11745.0
,,14,,,Unknown,,cid:3)(cid:5)(cid:14)(cid:70)(cid:12)(cid:11)(cid:4)(cid:14)(cid:11)(cid:48)(cid:48)(cid:7)(cid:5)(cid:3)(cid:9)(cid:2)(cid:12)(cid:11)(cid:4)(cid:14)(cid:11)(cid:48)(cid:48)(cid:7)(cid:5)(cid:3)(cid:9)(cid:2)(cid:28)(cid:3,,11759.0
,,11,,,Unknown,,cid:3)(cid:5)(cid:14)(cid:70)(cid:12)(cid:11)(cid:4)(cid:14)(cid:11)(cid:48)(cid:48)(cid:7)(cid:5)(cid:3)(cid:9)(cid:2)(cid:12)(cid:11)(cid:4)(cid:14)(cid:11)(cid:48)(cid:48)(cid:7)(cid:5)(cid:3)(cid:9)(cid:2)(cid:28)(cid:3,,11770.0
,,48,,,Unknown,,cid:3)(cid:5)(cid:14)(cid:70)(cid:12)(cid:11)(cid:4)(cid:14)(cid:11)(cid:48)(cid:48)(cid:7)(cid:5)(cid:3)(cid:9)(cid:2)(cid:12)(cid:11)(cid:4)(cid:14)(cid:11)(cid:48)(cid:48)(cid:7)(cid:5)(cid:3)(cid:9)(cid:2)(cid:28)(cid:3,,11818.0
,,48,,,Unknown,,cid:3)(cid:5)(cid:14)(cid:70)(cid:12)(cid:11)(cid:4)(cid:14)(cid:11)(cid:48)(cid:48)(cid:7)(cid:5)(cid:3)(cid:9)(cid:2)(cid:12)(cid:11)(cid:4)(cid:14)(cid:11)(cid:48)(cid:48)(cid:7)(cid:5)(cid:3)(cid:9)(cid:2)(cid:28)(cid:3,,11866.0
,,7,,,Unknown,,cid:3)(cid:5)(cid:14)(cid:70)(cid:12)(cid:11)(cid:4)(cid:14)(cid:11)(cid:48)(cid:48)(cid:7)(cid:5)(cid:3)(cid:9)(cid:2)(cid:12)(cid:11)(cid:4)(cid:14)(cid:11)(cid:48)(cid:48)(cid:7)(cid:5)(cid:3)(cid:9)(cid:2)(cid:28)(cid:3,,11873.0
,,5,,,Unknown,,cid:3)(cid:5)(cid:14)(cid:70)(cid:12)(cid:11)(cid:4)(cid:14)(cid:11)(cid:48)(cid:48)(cid:7)(cid:5)(cid:3)(cid:9)(cid:2)(cid:12)(cid:11)(cid:4)(cid:14)(cid:11)(cid:48)(cid:48)(cid:7)(cid:5)(cid:3)(cid:9)(cid:2)(cid:28)(cid:3,,11878.0
,,3,,,Unknown,,cid:3)(cid:5)(cid:14)(cid:70)(cid:12)(cid:11)(cid:4)(cid:14)(cid:11)(cid:48)(cid:48)(cid:7)(cid:5)(cid:3)(cid:9)(cid:2)(cid:12)(cid:11)(cid:4)(cid:14)(cid:11)(cid:48)(cid:48)(cid:7)(cid:5)(cid:3)(cid:9)(cid:2)(cid:28)(cid:3,,11881.0
,,2,,,Unknown,,cid:3)(cid:5)(cid:14)(cid:70)(cid:12)(cid:11)(cid:4)(cid:14)(cid:11)(cid:48)(cid:48)(cid:7)(cid:5)(cid:3)(cid:9)(cid:2)(cid:12)(cid:11)(cid:4)(cid:14)(cid:11)(cid:48)(cid:48)(cid:7)(cid:5)(cid:3)(cid:9)(cid:2)(cid:28)(cid:3,,11883.0
,,28,,,Unknown,,cid:3)(cid:5)(cid:14)(cid:70)(cid:12)(cid:11)(cid:4)(cid:14)(cid:11)(cid:48)(cid:48)(cid:7)(cid:5)(cid:3)(cid:9)(cid:2)(cid:12)(cid:11)(cid:4)(cid:14)(cid:11)(cid:48)(cid:48)(cid:7)(cid:5)(cid:3)(cid:9)(cid:2)(cid:28)(cid:3,,11911.0
,,3,,,Unknown,,cid:3)(cid:5)(cid:14)(cid:70)(cid:12)(cid:11)(cid:4)(cid:14)(cid:11)(cid:48)(cid:48)(cid:7)(cid:5)(cid:3)(cid:9)(cid:2)(cid:12)(cid:11)(cid:4)(cid:14)(cid:11)(cid:48)(cid:48)(cid:7)(cid:5)(cid:3)(cid:9)(cid:2)(cid:28)(cid:3,,11914.0
,,15,,,Unknown,,cid:3)(cid:5)(cid:14)(cid:70)(cid:12)(cid:11)(cid:4)(cid:14)(cid:11)(cid:48)(cid:48)(cid:7)(cid:5)(cid:3)(cid:9)(cid:2)(cid:12)(cid:11)(cid:4)(cid:14)(cid:11)(cid:48)(cid:48)(cid:7)(cid:5)(cid:3)(cid:9)(cid:2)(cid:28)(cid:3,,11929.0
,,2,,,Unknown,,cid:3)(cid:5)(cid:14)(cid:70)(cid:12)(cid:11)(cid:4)(cid:14)(cid:11)(cid:48)(cid:48)(cid:7)(cid:5)(cid:3)(cid:9)(cid:2)(cid:12)(cid:11)(cid:4)(cid:14)(cid:11)(cid:48)(cid:48)(cid:7)(cid:5)(cid:3)(cid:9)(cid:2)(cid:28)(cid:3,,11931.0
,,36,,,Unknown,,cid:3)(cid:5)(cid:14)(cid:70)(cid:12)(cid:11)(cid:4)(cid:14)(cid:11)(cid:48)(cid:48)(cid:7)(cid:5)(cid:3)(cid:9)(cid:2)(cid:12)(cid:11)(cid:4)(cid:14)(cid:11)(cid:48)(cid:48)(cid:7)(cid:5)(cid:3)(cid:9)(cid:2)(cid:28)(cid:3,,11967.0
,,36,,,Unknown,,cid:3)(cid:5)(cid:14)(cid:70)(cid:12)(cid:11)(cid:4)(cid:14)(cid:11)(cid:48)(cid:48)(cid:7)(cid:5)(cid:3)(cid:9)(cid:2)(cid:12)(cid:11)(cid:4)(cid:14)(cid:11)(cid:48)(cid:48)(cid:7)(cid:5)(cid:3)(cid:9)(cid:2)(cid:28)(cid:3,,12003.0
,,19,,,Unknown,,cid:3)(cid:5)(cid:14)(cid:70)(cid:12)(cid:11)(cid:4)(cid:14)(cid:11)(cid:48)(cid:48)(cid:7)(cid:5)(cid:3)(cid:9)(cid:2)(cid:12)(cid:11)(cid:4)(cid:14)(cid:11)(cid:48)(cid:48)(cid:7)(cid:5)(cid:3)(cid:9)(cid:2)(cid:28)(cid:3,,12022.0
,,33,,,Unknown,,cid:3)(cid:5)(cid:14)(cid:70)(cid:12)(cid:11)(cid:4)(cid:14)(cid:11)(cid:48)(cid:48)(cid:7)(cid:5)(cid:3)(cid:9)(cid:2)(cid:12)(cid:11)(cid:4)(cid:14)(cid:11)(cid:48)(cid:48)(cid:7)(cid:5)(cid:3)(cid:9)(cid:2)(cid:28)(cid:3,,12055.0
,,18,,,Unknown,,cid:3)(cid:5)(cid:14)(cid:70)(cid:12)(cid:11)(cid:4)(cid:14)(cid:11)(cid:48)(cid:48)(cid:7)(cid:5)(cid:3)(cid:9)(cid:2)(cid:12)(cid:11)(cid:4)(cid:14)(cid:11)(cid:48)(cid:48)(cid:7)(cid:5)(cid:3)(cid:9)(cid:2)(cid:28)(cid:3,,12073.0
,,2,,,Unknown,,cid:3)(cid:5)(cid:14)(cid:70)(cid:12)(cid:11)(cid:4)(cid:14)(cid:11)(cid:48)(cid:48)(cid:7)(cid:5)(cid:3)(cid:9)(cid:2)(cid:12)(cid:11)(cid:4)(cid:14)(cid:11)(cid:48)(cid:48)(cid:7)(cid:5)(cid:3)(cid:9)(cid:2)(cid:28)(cid:3,,12075.0
,,44,,,Unknown,,cid:3)(cid:5)(cid:14)(cid:70)(cid:12)(cid:11)(cid:4)(cid:14)(cid:11)(cid:48)(cid:48)(cid:7)(cid:5)(cid:3)(cid:9)(cid:2)(cid:12)(cid:11)(cid:4)(cid:14)(cid:11)(cid:48)(cid:48)(cid:7)(cid:5)(cid:3)(cid:9)(cid:2)(cid:28)(cid:3,,12119.0
,,12,,,Unknown,,cid:3)(cid:5)(cid:14)(cid:70)(cid:12)(cid:11)(cid:4)(cid:14)(cid:11)(cid:48)(cid:48)(cid:7)(cid:5)(cid:3)(cid:9)(cid:2)(cid:12)(cid:11)(cid:4)(cid:14)(cid:11)(cid:48)(cid:48)(cid:7)(cid:5)(cid:3)(cid:9)(cid:2)(cid:28)(cid:3,,12131.0
,,29,,,Unknown,,cid:3)(cid:5)(cid:14)(cid:70)(cid:12)(cid:11)(cid:4)(cid:14)(cid:11)(cid:48)(cid:48)(cid:7)(cid:5)(cid:3)(cid:9)(cid:2)(cid:12)(cid:11)(cid:4)(cid:14)(cid:11)(cid:48)(cid:48)(cid:7)(cid:5)(cid:3)(cid:9)(cid:2)(cid:28)(cid:3,,12160.0
,,26,,,Unknown,,cid:3)(cid:5)(cid:14)(cid:70)(cid:12)(cid:11)(cid:4)(cid:14)(cid:11)(cid:48)(cid:48)(cid:7)(cid:5)(cid:3)(cid:9)(cid:2)(cid:12)(cid:11)(cid:4)(cid:14)(cid:11)(cid:48)(cid:48)(cid:7)(cid:5)(cid:3)(cid:9)(cid:2)(cid:28)(cid:3,,12186.0
,,41,,,Unknown,,cid:3)(cid:5)(cid:14)(cid:70)(cid:12)(cid:11)(cid:4)(cid:14)(cid:11)(cid:48)(cid:48)(cid:7)(cid:5)(cid:3)(cid:9)(cid:2)(cid:12)(cid:11)(cid:4)(cid:14)(cid:11)(cid:48)(cid:48)(cid:7)(cid:5)(cid:3)(cid:9)(cid:2)(cid:28)(cid:3,,12227.0
,,25,,,Unknown,,cid:3)(cid:5)(cid:14)(cid:70)(cid:12)(cid:11)(cid:4)(cid:14)(cid:11)(cid:48)(cid:48)(cid:7)(cid:5)(cid:3)(cid:9)(cid:2)(cid:12)(cid:11)(cid:4)(cid:14)(cid:11)(cid:48)(cid:48)(cid:7)(cid:5)(cid:3)(cid:9)(cid:2)(cid:28)(cid:3,,12252.0
,,2,,,Unknown,,cid:3)(cid:5)(cid:14)(cid:70)(cid:12)(cid:11)(cid:4)(cid:14)(cid:11)(cid:48)(cid:48)(cid:7)(cid:5)(cid:3)(cid:9)(cid:2)(cid:12)(cid:11)(cid:4)(cid:14)(cid:11)(cid:48)(cid:48)(cid:7)(cid:5)(cid:3)(cid:9)(cid:2)(cid:28)(cid:3,,12254.0
,,58,,,Unknown,,cid:3)(cid:5)(cid:14)(cid:70)(cid:12)(cid:11)(cid:4)(cid:14)(cid:11)(cid:48)(cid:48)(cid:7)(cid:5)(cid:3)(cid:9)(cid:2)(cid:12)(cid:11)(cid:4)(cid:14)(cid:11)(cid:48)(cid:48)(cid:7)(cid:5)(cid:3)(cid:9)(cid:2)(cid:28)(cid:3,,12312.0
,,58,,,Unknown,,cid:3)(cid:5)(cid:14)(cid:70)(cid:12)(cid:11)(cid:4)(cid:14)(cid:11)(cid:48)(cid:48)(cid:7)(cid:5)(cid:3)(cid:9)(cid:2)(cid:12)(cid:11)(cid:4)(cid:14)(cid:11)(cid:48)(cid:48)(cid:7)(cid:5)(cid:3)(cid:9)(cid:2)(cid:28)(cid:3,,12370.0
,,37,,,Unknown,,cid:3)(cid:5)(cid:14)(cid:70)(cid:12)(cid:11)(cid:4)(cid:14)(cid:11)(cid:48)(cid:48)(cid:7)(cid:5)(cid:3)(cid:9)(cid:2)(cid:12)(cid:11)(cid:4)(cid:14)(cid:11)(cid:48)(cid:48)(cid:7)(cid:5)(cid:3)(cid:9)(cid:2)(cid:28)(cid:3,,12407.0
,,16,,,Unknown,,cid:3)(cid:5)(cid:14)(cid:70)(cid:12)(cid:11)(cid:4)(cid:14)(cid:11)(cid:48)(cid:48)(cid:7)(cid:5)(cid:3)(cid:9)(cid:2)(cid:12)(cid:11)(cid:4)(cid:14)(cid:11)(cid:48)(cid:48)(cid:7)(cid:5)(cid:3)(cid:9)(cid:2)(cid:28)(cid:3,,12423.0
,,34,,,Unknown,,cid:3)(cid:5)(cid:14)(cid:70)(cid:12)(cid:11)(cid:4)(cid:14)(cid:11)(cid:48)(cid:48)(cid:7)(cid:5)(cid:3)(cid:9)(cid:2)(cid:12)(cid:11)(cid:4)(cid:14)(cid:11)(cid:48)(cid:48)(cid:7)(cid:5)(cid:3)(cid:9)(cid:2)(cid:28)(cid:3,,12457.0
,,33,,,Unknown,,cid:3)(cid:5)(cid:14)(cid:70)(cid:12)(cid:11)(cid:4)(cid:14)(cid:11)(cid:48)(cid:48)(cid:7)(cid:5)(cid:3)(cid:9)(cid:2)(cid:12)(cid:11)(cid:4)(cid:14)(cid:11)(cid:48)(cid:48)(cid:7)(cid:5)(cid:3)(cid:9)(cid:2)(cid:28)(cid:3,,12490.0
,,17,,,Unknown,,cid:3)(cid:5)(cid:14)(cid:70)(cid:12)(cid:11)(cid:4)(cid:14)(cid:11)(cid:48)(cid:48)(cid:7)(cid:5)(cid:3)(cid:9)(cid:2)(cid:12)(cid:11)(cid:4)(cid:14)(cid:11)(cid:48)(cid:48)(cid:7)(cid:5)(cid:3)(cid:9)(cid:2)(cid:28)(cid:3,,12507.0
,,34,,,Unknown,,cid:3)(cid:5)(cid:14)(cid:70)(cid:12)(cid:11)(cid:4)(cid:14)(cid:11)(cid:48)(cid:48)(cid:7)(cid:5)(cid:3)(cid:9)(cid:2)(cid:12)(cid:11)(cid:4)(cid:14)(cid:11)(cid:48)(cid:48)(cid:7)(cid:5)(cid:3)(cid:9)(cid:2)(cid:28)(cid:3,,12541.0
,,45,,,Unknown,,cid:3)(cid:5)(cid:14)(cid:70)(cid:12)(cid:11)(cid:4)(cid:14)(cid:11)(cid:48)(cid:48)(cid:7)(cid:5)(cid:3)(cid:9)(cid:2)(cid:12)(cid:11)(cid:4)(cid:14)(cid:11)(cid:48)(cid:48)(cid:7)(cid:5)(cid:3)(cid:9)(cid:2)(cid:28)(cid:3,,12586.0
,,18,,,Unknown,,cid:3)(cid:5)(cid:14)(cid:70)(cid:12)(cid:11)(cid:4)(cid:14)(cid:11)(cid:48)(cid:48)(cid:7)(cid:5)(cid:3)(cid:9)(cid:2)(cid:12)(cid:11)(cid:4)(cid:14)(cid:11)(cid:48)(cid:48)(cid:7)(cid:5)(cid:3)(cid:9)(cid:2)(cid:28)(cid:3,,12604.0
,,16,,,Unknown,,cid:3)(cid:5)(cid:14)(cid:70)(cid:12)(cid:11)(cid:4)(cid:14)(cid:11)(cid:48)(cid:48)(cid:7)(cid:5)(cid:3)(cid:9)(cid:2)(cid:12)(cid:11)(cid:4)(cid:14)(cid:11)(cid:48)(cid:48)(cid:7)(cid:5)(cid:3)(cid:9)(cid:2)(cid:28)(cid:3,,12620.0
,,12,,,Unknown,,cid:3)(cid:5)(cid:14)(cid:70)(cid:12)(cid:11)(cid:4)(cid:14)(cid:11)(cid:48)(cid:48)(cid:7)(cid:5)(cid:3)(cid:9)(cid:2)(cid:12)(cid:11)(cid:4)(cid:14)(cid:11)(cid:48)(cid:48)(cid:7)(cid:5)(cid:3)(cid:9)(cid:2)(cid:28)(cid:3,,12632.0
,,11,,,Unknown,,cid:3)(cid:5)(cid:14)(cid:70)(cid:12)(cid:11)(cid:4)(cid:14)(cid:11)(cid:48)(cid:48)(cid:7)(cid:5)(cid:3)(cid:9)(cid:2)(cid:12)(cid:11)(cid:4)(cid:14)(cid:11)(cid:48)(cid:48)(cid:7)(cid:5)(cid:3)(cid:9)(cid:2)(cid:28)(cid:3,,12643.0
,,8,,,Unknown,,cid:3)(cid:5)(cid:14)(cid:70)(cid:12)(cid:11)(cid:4)(cid:14)(cid:11)(cid:48)(cid:48)(cid:7)(cid:5)(cid:3)(cid:9)(cid:2)(cid:12)(cid:11)(cid:4)(cid:14)(cid:11)(cid:48)(cid:48)(cid:7)(cid:5)(cid:3)(cid:9)(cid:2)(cid:28)(cid:3,,12651.0
,,10,,,Unknown,,cid:3)(cid:5)(cid:14)(cid:70)(cid:12)(cid:11)(cid:4)(cid:14)(cid:11)(cid:48)(cid:48)(cid:7)(cid:5)(cid:3)(cid:9)(cid:2)(cid:12)(cid:11)(cid:4)(cid:14)(cid:11)(cid:48)(cid:48)(cid:7)(cid:5)(cid:3)(cid:9)(cid:2)(cid:28)(cid:3,,12661.0
,,3,,,Unknown,,cid:3)(cid:5)(cid:14)(cid:70)(cid:12)(cid:11)(cid:4)(cid:14)(cid:11)(cid:48)(cid:48)(cid:7)(cid:5)(cid:3)(cid:9)(cid:2)(cid:12)(cid:11)(cid:4)(cid:14)(cid:11)(cid:48)(cid:48)(cid:7)(cid:5)(cid:3)(cid:9)(cid:2)(cid:28)(cid:3,,12664.0
,,11,,,Unknown,,cid:3)(cid:5)(cid:14)(cid:70)(cid:12)(cid:11)(cid:4)(cid:14)(cid:11)(cid:48)(cid:48)(cid:7)(cid:5)(cid:3)(cid:9)(cid:2)(cid:12)(cid:11)(cid:4)(cid:14)(cid:11)(cid:48)(cid:48)(cid:7)(cid:5)(cid:3)(cid:9)(cid:2)(cid:28)(cid:3,,12675.0
,,14,,,Unknown,,cid:3)(cid:5)(cid:14)(cid:70)(cid:12)(cid:11)(cid:4)(cid:14)(cid:11)(cid:48)(cid:48)(cid:7)(cid:5)(cid:3)(cid:9)(cid:2)(cid:12)(cid:11)(cid:4)(cid:14)(cid:11)(cid:48)(cid:48)(cid:7)(cid:5)(cid:3)(cid:9)(cid:2)(cid:28)(cid:3,,12689.0
,,5,,,Unknown,,cid:3)(cid:5)(cid:14)(cid:70)(cid:12)(cid:11)(cid:4)(cid:14)(cid:11)(cid:48)(cid:48)(cid:7)(cid:5)(cid:3)(cid:9)(cid:2)(cid:12)(cid:11)(cid:4)(cid:14)(cid:11)(cid:48)(cid:48)(cid:7)(cid:5)(cid:3)(cid:9)(cid:2)(cid:28)(cid:3,,12694.0
,,2,,,Unknown,,cid:3)(cid:5)(cid:14)(cid:70)(cid:12)(cid:11)(cid:4)(cid:14)(cid:11)(cid:48)(cid:48)(cid:7)(cid:5)(cid:3)(cid:9)(cid:2)(cid:12)(cid:11)(cid:4)(cid:14)(cid:11)(cid:48)(cid:48)(cid:7)(cid:5)(cid:3)(cid:9)(cid:2)(cid:28)(cid:3,,12696.0
,,10,,,Unknown,,cid:3)(cid:5)(cid:14)(cid:70)(cid:12)(cid:11)(cid:4)(cid:14)(cid:11)(cid:48)(cid:48)(cid:7)(cid:5)(cid:3)(cid:9)(cid:2)(cid:12)(cid:11)(cid:4)(cid:14)(cid:11)(cid:48)(cid:48)(cid:7)(cid:5)(cid:3)(cid:9)(cid:2)(cid:28)(cid:3,,12706.0
,,5,,,Unknown,,cid:3)(cid:5)(cid:14)(cid:70)(cid:12)(cid:11)(cid:4)(cid:14)(cid:11)(cid:48)(cid:48)(cid:7)(cid:5)(cid:3)(cid:9)(cid:2)(cid:12)(cid:11)(cid:4)(cid:14)(cid:11)(cid:48)(cid:48)(cid:7)(cid:5)(cid:3)(cid:9)(cid:2)(cid:28)(cid:3,,12711.0
,,12,,,Unknown,,cid:3)(cid:5)(cid:14)(cid:70)(cid:12)(cid:11)(cid:4)(cid:14)(cid:11)(cid:48)(cid:48)(cid:7)(cid:5)(cid:3)(cid:9)(cid:2)(cid:12)(cid:11)(cid:4)(cid:14)(cid:11)(cid:48)(cid:48)(cid:7)(cid:5)(cid:3)(cid:9)(cid:2)(cid:28)(cid:3,,12723.0
,,13,,,Unknown,,cid:3)(cid:5)(cid:14)(cid:70)(cid:12)(cid:11)(cid:4)(cid:14)(cid:11)(cid:48)(cid:48)(cid:7)(cid:5)(cid:3)(cid:9)(cid:2)(cid:12)(cid:11)(cid:4)(cid:14)(cid:11)(cid:48)(cid:48)(cid:7)(cid:5)(cid:3)(cid:9)(cid:2)(cid:28)(cid:3,,12736.0
,,2,,,Unknown,,cid:3)(cid:5)(cid:14)(cid:70)(cid:12)(cid:11)(cid:4)(cid:14)(cid:11)(cid:48)(cid:48)(cid:7)(cid:5)(cid:3)(cid:9)(cid:2)(cid:12)(cid:11)(cid:4)(cid:14)(cid:11)(cid:48)(cid:48)(cid:7)(cid:5)(cid:3)(cid:9)(cid:2)(cid:28)(cid:3,,12738.0
,,48,,,Unknown,,cid:3)(cid:5)(cid:14)(cid:70)(cid:12)(cid:11)(cid:4)(cid:14)(cid:11)(cid:48)(cid:48)(cid:7)(cid:5)(cid:3)(cid:9)(cid:2)(cid:12)(cid:11)(cid:4)(cid:14)(cid:11)(cid:48)(cid:48)(cid:7)(cid:5)(cid:3)(cid:9)(cid:2)(cid:28)(cid:3,,12786.0
,,11,,,Unknown,,cid:3)(cid:5)(cid:14)(cid:70)(cid:12)(cid:11)(cid:4)(cid:14)(cid:11)(cid:48)(cid:48)(cid:7)(cid:5)(cid:3)(cid:9)(cid:2)(cid:12)(cid:11)(cid:4)(cid:14)(cid:11)(cid:48)(cid:48)(cid:7)(cid:5)(cid:3)(cid:9)(cid:2)(cid:28)(cid:3,,12797.0
,,4,,,Unknown,,cid:3)(cid:5)(cid:14)(cid:70)(cid:12)(cid:11)(cid:4)(cid:14)(cid:11)(cid:48)(cid:48)(cid:7)(cid:5)(cid:3)(cid:9)(cid:2)(cid:12)(cid:11)(cid:4)(cid:14)(cid:11)(cid:48)(cid:48)(cid:7)(cid:5)(cid:3)(cid:9)(cid:2)(cid:28)(cid:3,,12801.0
,,3,,,Unknown,,cid:3)(cid:5)(cid:14)(cid:70)(cid:12)(cid:11)(cid:4)(cid:14)(cid:11)(cid:48)(cid:48)(cid:7)(cid:5)(cid:3)(cid:9)(cid:2)(cid:12)(cid:11)(cid:4)(cid:14)(cid:11)(cid:48)(cid:48)(cid:7)(cid:5)(cid:3)(cid:9)(cid:2)(cid:28)(cid:3,,12804.0
,,11,,,Unknown,,cid:3)(cid:5)(cid:14)(cid:70)(cid:12)(cid:11)(cid:4)(cid:14)(cid:11)(cid:48)(cid:48)(cid:7)(cid:5)(cid:3)(cid:9)(cid:2)(cid:12)(cid:11)(cid:4)(cid:14)(cid:11)(cid:48)(cid:48)(cid:7)(cid:5)(cid:3)(cid:9)(cid:2)(cid:28)(cid:3,,12815.0
,,4,,,Unknown,,cid:3)(cid:5)(cid:14)(cid:70)(cid:12)(cid:11)(cid:4)(cid:14)(cid:11)(cid:48)(cid:48)(cid:7)(cid:5)(cid:3)(cid:9)(cid:2)(cid:12)(cid:11)(cid:4)(cid:14)(cid:11)(cid:48)(cid:48)(cid:7)(cid:5)(cid:3)(cid:9)(cid:2)(cid:28)(cid:3,,12819.0
,,40,,,Unknown,,cid:3)(cid:5)(cid:14)(cid:70)(cid:12)(cid:11)(cid:4)(cid:14)(cid:11)(cid:48)(cid:48)(cid:7)(cid:5)(cid:3)(cid:9)(cid:2)(cid:12)(cid:11)(cid:4)(cid:14)(cid:11)(cid:48)(cid:48)(cid:7)(cid:5)(cid:3)(cid:9)(cid:2)(cid:28)(cid:3,,12859.0
,,2,,,Unknown,,cid:3)(cid:5)(cid:14)(cid:70)(cid:12)(cid:11)(cid:4)(cid:14)(cid:11)(cid:48)(cid:48)(cid:7)(cid:5)(cid:3)(cid:9)(cid:2)(cid:12)(cid:11)(cid:4)(cid:14)(cid:11)(cid:48)(cid:48)(cid:7)(cid:5)(cid:3)(cid:9)(cid:2)(cid:28)(cid:3,,12861.0
,,28,,,Unknown,,cid:3)(cid:5)(cid:14)(cid:70)(cid:12)(cid:11)(cid:4)(cid:14)(cid:11)(cid:48)(cid:48)(cid:7)(cid:5)(cid:3)(cid:9)(cid:2)(cid:12)(cid:11)(cid:4)(cid:14)(cid:11)(cid:48)(cid:48)(cid:7)(cid:5)(cid:3)(cid:9)(cid:2)(cid:28)(cid:3,,12889.0
,,3,,,Unknown,,cid:3)(cid:5)(cid:14)(cid:70)(cid:12)(cid:11)(cid:4)(cid:14)(cid:11)(cid:48)(cid:48)(cid:7)(cid:5)(cid:3)(cid:9)(cid:2)(cid:12)(cid:11)(cid:4)(cid:14)(cid:11)(cid:48)(cid:48)(cid:7)(cid:5)(cid:3)(cid:9)(cid:2)(cid:28)(cid:3,,12892.0
,,15,,,Unknown,,cid:3)(cid:5)(cid:14)(cid:70)(cid:12)(cid:11)(cid:4)(cid:14)(cid:11)(cid:48)(cid:48)(cid:7)(cid:5)(cid:3)(cid:9)(cid:2)(cid:12)(cid:11)(cid:4)(cid:14)(cid:11)(cid:48)(cid:48)(cid:7)(cid:5)(cid:3)(cid:9)(cid:2)(cid:28)(cid:3,,12907.0
,,2,,,Unknown,,cid:3)(cid:5)(cid:14)(cid:70)(cid:12)(cid:11)(cid:4)(cid:14)(cid:11)(cid:48)(cid:48)(cid:7)(cid:5)(cid:3)(cid:9)(cid:2)(cid:12)(cid:11)(cid:4)(cid:14)(cid:11)(cid:48)(cid:48)(cid:7)(cid:5)(cid:3)(cid:9)(cid:2)(cid:28)(cid:3,,12909.0
,,35,,,Unknown,,cid:3)(cid:5)(cid:14)(cid:70)(cid:12)(cid:11)(cid:4)(cid:14)(cid:11)(cid:48)(cid:48)(cid:7)(cid:5)(cid:3)(cid:9)(cid:2)(cid:12)(cid:11)(cid:4)(cid:14)(cid:11)(cid:48)(cid:48)(cid:7)(cid:5)(cid:3)(cid:9)(cid:2)(cid:28)(cid:3,,12944.0
,,18,,,Unknown,,cid:3)(cid:5)(cid:14)(cid:70)(cid:12)(cid:11)(cid:4)(cid:14)(cid:11)(cid:48)(cid:48)(cid:7)(cid:5)(cid:3)(cid:9)(cid:2)(cid:12)(cid:11)(cid:4)(cid:14)(cid:11)(cid:48)(cid:48)(cid:7)(cid:5)(cid:3)(cid:9)(cid:2)(cid:28)(cid:3,,12962.0
,,19,,,Unknown,,cid:3)(cid:5)(cid:14)(cid:70)(cid:12)(cid:11)(cid:4)(cid:14)(cid:11)(cid:48)(cid:48)(cid:7)(cid:5)(cid:3)(cid:9)(cid:2)(cid:12)(cid:11)(cid:4)(cid:14)(cid:11)(cid:48)(cid:48)(cid:7)(cid:5)(cid:3)(cid:9)(cid:2)(cid:28)(cid:3,,12981.0
,,18,,,Unknown,,cid:3)(cid:5)(cid:14)(cid:70)(cid:12)(cid:11)(cid:4)(cid:14)(cid:11)(cid:48)(cid:48)(cid:7)(cid:5)(cid:3)(cid:9)(cid:2)(cid:12)(cid:11)(cid:4)(cid:14)(cid:11)(cid:48)(cid:48)(cid:7)(cid:5)(cid:3)(cid:9)(cid:2)(cid:28)(cid:3,,12999.0
,,18,,,Unknown,,cid:3)(cid:5)(cid:14)(cid:70)(cid:12)(cid:11)(cid:4)(cid:14)(cid:11)(cid:48)(cid:48)(cid:7)(cid:5)(cid:3)(cid:9)(cid:2)(cid:12)(cid:11)(cid:4)(cid:14)(cid:11)(cid:48)(cid:48)(cid:7)(cid:5)(cid:3)(cid:9)(cid:2)(cid:28)(cid:3,,13017.0
,,2,,,Unknown,,cid:3)(cid:5)(cid:14)(cid:70)(cid:12)(cid:11)(cid:4)(cid:14)(cid:11)(cid:48)(cid:48)(cid:7)(cid:5)(cid:3)(cid:9)(cid:2)(cid:12)(cid:11)(cid:4)(cid:14)(cid:11)(cid:48)(cid:48)(cid:7)(cid:5)(cid:3)(cid:9)(cid:2)(cid:28)(cid:3,,13019.0
,,44,,,Unknown,,cid:3)(cid:5)(cid:14)(cid:70)(cid:12)(cid:11)(cid:4)(cid:14)(cid:11)(cid:48)(cid:48)(cid:7)(cid:5)(cid:3)(cid:9)(cid:2)(cid:12)(cid:11)(cid:4)(cid:14)(cid:11)(cid:48)(cid:48)(cid:7)(cid:5)(cid:3)(cid:9)(cid:2)(cid:28)(cid:3,,13063.0
,,12,,,Unknown,,cid:3)(cid:5)(cid:14)(cid:70)(cid:12)(cid:11)(cid:4)(cid:14)(cid:11)(cid:48)(cid:48)(cid:7)(cid:5)(cid:3)(cid:9)(cid:2)(cid:12)(cid:11)(cid:4)(cid:14)(cid:11)(cid:48)(cid:48)(cid:7)(cid:5)(cid:3)(cid:9)(cid:2)(cid:28)(cid:3,,13075.0
,,29,,,Unknown,,cid:3)(cid:5)(cid:14)(cid:70)(cid:12)(cid:11)(cid:4)(cid:14)(cid:11)(cid:48)(cid:48)(cid:7)(cid:5)(cid:3)(cid:9)(cid:2)(cid:12)(cid:11)(cid:4)(cid:14)(cid:11)(cid:48)(cid:48)(cid:7)(cid:5)(cid:3)(cid:9)(cid:2)(cid:28)(cid:3,,13104.0
,,26,,,Unknown,,cid:3)(cid:5)(cid:14)(cid:70)(cid:12)(cid:11)(cid:4)(cid:14)(cid:11)(cid:48)(cid:48)(cid:7)(cid:5)(cid:3)(cid:9)(cid:2)(cid:12)(cid:11)(cid:4)(cid:14)(cid:11)(cid:48)(cid:48)(cid:7)(cid:5)(cid:3)(cid:9)(cid:2)(cid:28)(cid:3,,13130.0
,,41,,,Unknown,,cid:3)(cid:5)(cid:14)(cid:70)(cid:12)(cid:11)(cid:4)(cid:14)(cid:11)(cid:48)(cid:48)(cid:7)(cid:5)(cid:3)(cid:9)(cid:2)(cid:12)(cid:11)(cid:4)(cid:14)(cid:11)(cid:48)(cid:48)(cid:7)(cid:5)(cid:3)(cid:9)(cid:2)(cid:28)(cid:3,,13171.0
,,25,,,Unknown,,cid:3)(cid:5)(cid:14)(cid:70)(cid:12)(cid:11)(cid:4)(cid:14)(cid:11)(cid:48)(cid:48)(cid:7)(cid:5)(cid:3)(cid:9)(cid:2)(cid:12)(cid:11)(cid:4)(cid:14)(cid:11)(cid:48)(cid:48)(cid:7)(cid:5)(cid:3)(cid:9)(cid:2)(cid:28)(cid:3,,13196.0
,,2,,,Unknown,,cid:3)(cid:5)(cid:14)(cid:70)(cid:12)(cid:11)(cid:4)(cid:14)(cid:11)(cid:48)(cid:48)(cid:7)(cid:5)(cid:3)(cid:9)(cid:2)(cid:12)(cid:11)(cid:4)(cid:14)(cid:11)(cid:48)(cid:48)(cid:7)(cid:5)(cid:3)(cid:9)(cid:2)(cid:28)(cid:3,,13198.0
,,58,,,Unknown,,cid:3)(cid:5)(cid:14)(cid:70)(cid:12)(cid:11)(cid:4)(cid:14)(cid:11)(cid:48)(cid:48)(cid:7)(cid:5)(cid:3)(cid:9)(cid:2)(cid:12)(cid:11)(cid:4)(cid:14)(cid:11)(cid:48)(cid:48)(cid:7)(cid:5)(cid:3)(cid:9)(cid:2)(cid:28)(cid:3,,13256.0
,,58,,,Unknown,,cid:3)(cid:5)(cid:14)(cid:70)(cid:12)(cid:11)(cid:4)(cid:14)(cid:11)(cid:48)(cid:48)(cid:7)(cid:5)(cid:3)(cid:9)(cid:2)(cid:12)(cid:11)(cid:4)(cid:14)(cid:11)(cid:48)(cid:48)(cid:7)(cid:5)(cid:3)(cid:9)(cid:2)(cid:28)(cid:3,,13314.0
,,18,,,Unknown,,cid:3)(cid:5)(cid:14)(cid:70)(cid:12)(cid:11)(cid:4)(cid:14)(cid:11)(cid:48)(cid:48)(cid:7)(cid:5)(cid:3)(cid:9)(cid:2)(cid:12)(cid:11)(cid:4)(cid:14)(cid:11)(cid:48)(cid:48)(cid:7)(cid:5)(cid:3)(cid:9)(cid:2)(cid:28)(cid:3,,13332.0
,,1,,,Unknown,,cid:3)(cid:5)(cid:14)(cid:70)(cid:12)(cid:11)(cid:4)(cid:14)(cid:11)(cid:48)(cid:48)(cid:7)(cid:5)(cid:3)(cid:9)(cid:2)(cid:12)(cid:11)(cid:4)(cid:14)(cid:11)(cid:48)(cid:48)(cid:7)(cid:5)(cid:3)(cid:9)(cid:2)(cid:28)(cid:3,,13333.0
,,1,,,Unknown,,cid:3)(cid:5)(cid:14)(cid:70)(cid:12)(cid:11)(cid:4)(cid:14)(cid:11)(cid:48)(cid:48)(cid:7)(cid:5)(cid:3)(cid:9)(cid:2)(cid:12)(cid:11)(cid:4)(cid:14)(cid:11)(cid:48)(cid:48)(cid:7)(cid:5)(cid:3)(cid:9)(cid:2)(cid:28)(cid:3,,13334.0
,,37,,,Unknown,,cid:3)(cid:5)(cid:14)(cid:70)(cid:12)(cid:11)(cid:4)(cid:14)(cid:11)(cid:48)(cid:48)(cid:7)(cid:5)(cid:3)(cid:9)(cid:2)(cid:12)(cid:11)(cid:4)(cid:14)(cid:11)(cid:48)(cid:48)(cid:7)(cid:5)(cid:3)(cid:9)(cid:2)(cid:28)(cid:3,,13371.0
,,17,,,Unknown,,cid:3)(cid:5)(cid:14)(cid:70)(cid:12)(cid:11)(cid:4)(cid:14)(cid:11)(cid:48)(cid:48)(cid:7)(cid:5)(cid:3)(cid:9)(cid:2)(cid:12)(cid:11)(cid:4)(cid:14)(cid:11)(cid:48)(cid:48)(cid:7)(cid:5)(cid:3)(cid:9)(cid:2)(cid:28)(cid:3,,13388.0
,,34,,,Unknown,,cid:3)(cid:5)(cid:14)(cid:70)(cid:12)(cid:11)(cid:4)(cid:14)(cid:11)(cid:48)(cid:48)(cid:7)(cid:5)(cid:3)(cid:9)(cid:2)(cid:12)(cid:11)(cid:4)(cid:14)(cid:11)(cid:48)(cid:48)(cid:7)(cid:5)(cid:3)(cid:9)(cid:2)(cid:28)(cid:3,,13422.0
,,45,,,Unknown,,cid:3)(cid:5)(cid:14)(cid:70)(cid:12)(cid:11)(cid:4)(cid:14)(cid:11)(cid:48)(cid:48)(cid:7)(cid:5)(cid:3)(cid:9)(cid:2)(cid:12)(cid:11)(cid:4)(cid:14)(cid:11)(cid:48)(cid:48)(cid:7)(cid:5)(cid:3)(cid:9)(cid:2)(cid:28)(cid:3,,13467.0
,,18,,,Unknown,,cid:3)(cid:5)(cid:14)(cid:70)(cid:12)(cid:11)(cid:4)(cid:14)(cid:11)(cid:48)(cid:48)(cid:7)(cid:5)(cid:3)(cid:9)(cid:2)(cid:12)(cid:11)(cid:4)(cid:14)(cid:11)(cid:48)(cid:48)(cid:7)(cid:5)(cid:3)(cid:9)(cid:2)(cid:28)(cid:3,,13485.0
,,16,,,Unknown,,cid:3)(cid:5)(cid:14)(cid:70)(cid:12)(cid:11)(cid:4)(cid:14)(cid:11)(cid:48)(cid:48)(cid:7)(cid:5)(cid:3)(cid:9)(cid:2)(cid:12)(cid:11)(cid:4)(cid:14)(cid:11)(cid:48)(cid:48)(cid:7)(cid:5)(cid:3)(cid:9)(cid:2)(cid:28)(cid:3,,13501.0
,,48,,,Unknown,,cid:3)(cid:5)(cid:14)(cid:70)(cid:12)(cid:11)(cid:4)(cid:14)(cid:11)(cid:48)(cid:48)(cid:7)(cid:5)(cid:3)(cid:9)(cid:2)(cid:12)(cid:11)(cid:4)(cid:14)(cid:11)(cid:48)(cid:48)(cid:7)(cid:5)(cid:3)(cid:9)(cid:2)(cid:28)(cid:3,,13549.0
,,12,,,Unknown,,cid:3)(cid:5)(cid:14)(cid:70)(cid:12)(cid:11)(cid:4)(cid:14)(cid:11)(cid:48)(cid:48)(cid:7)(cid:5)(cid:3)(cid:9)(cid:2)(cid:12)(cid:11)(cid:4)(cid:14)(cid:11)(cid:48)(cid:48)(cid:7)(cid:5)(cid:3)(cid:9)(cid:2)(cid:28)(cid:3,,13561.0
,,50,,,Unknown,,cid:3)(cid:5)(cid:14)(cid:70)(cid:12)(cid:11)(cid:4)(cid:14)(cid:11)(cid:48)(cid:48)(cid:7)(cid:5)(cid:3)(cid:9)(cid:2)(cid:12)(cid:11)(cid:4)(cid:14)(cid:11)(cid:48)(cid:48)(cid:7)(cid:5)(cid:3)(cid:9)(cid:2)(cid:28)(cid:3,,13611.0
,,11,,,Unknown,,cid:3)(cid:5)(cid:14)(cid:70)(cid:12)(cid:11)(cid:4)(cid:14)(cid:11)(cid:48)(cid:48)(cid:7)(cid:5)(cid:3)(cid:9)(cid:2)(cid:12)(cid:11)(cid:4)(cid:14)(cid:11)(cid:48)(cid:48)(cid:7)(cid:5)(cid:3)(cid:9)(cid:2)(cid:28)(cid:3,,13622.0
,,8,,,Unknown,,cid:3)(cid:5)(cid:14)(cid:70)(cid:12)(cid:11)(cid:4)(cid:14)(cid:11)(cid:48)(cid:48)(cid:7)(cid:5)(cid:3)(cid:9)(cid:2)(cid:12)(cid:11)(cid:4)(cid:14)(cid:11)(cid:48)(cid:48)(cid:7)(cid:5)(cid:3)(cid:9)(cid:2)(cid:28)(cid:3,,13630.0
,,46,,,Unknown,,cid:3)(cid:5)(cid:14)(cid:70)(cid:12)(cid:11)(cid:4)(cid:14)(cid:11)(cid:48)(cid:48)(cid:7)(cid:5)(cid:3)(cid:9)(cid:2)(cid:12)(cid:11)(cid:4)(cid:14)(cid:11)(cid:48)(cid:48)(cid:7)(cid:5)(cid:3)(cid:9)(cid:2)(cid:28)(cid:3,,13676.0
,,14,,,Unknown,,cid:3)(cid:5)(cid:14)(cid:70)(cid:12)(cid:11)(cid:4)(cid:14)(cid:11)(cid:48)(cid:48)(cid:7)(cid:5)(cid:3)(cid:9)(cid:2)(cid:12)(cid:11)(cid:4)(cid:14)(cid:11)(cid:48)(cid:48)(cid:7)(cid:5)(cid:3)(cid:9)(cid:2)(cid:28)(cid:3,,13690.0
,,50,,,Unknown,,cid:3)(cid:5)(cid:14)(cid:70)(cid:12)(cid:11)(cid:4)(cid:14)(cid:11)(cid:48)(cid:48)(cid:7)(cid:5)(cid:3)(cid:9)(cid:2)(cid:12)(cid:11)(cid:4)(cid:14)(cid:11)(cid:48)(cid:48)(cid:7)(cid:5)(cid:3)(cid:9)(cid:2)(cid:28)(cid:3,,13740.0
,,9,,,Unknown,,cid:3)(cid:5)(cid:14)(cid:70)(cid:12)(cid:11)(cid:4)(cid:14)(cid:11)(cid:48)(cid:48)(cid:7)(cid:5)(cid:3)(cid:9)(cid:2)(cid:12)(cid:11)(cid:4)(cid:14)(cid:11)(cid:48)(cid:48)(cid:7)(cid:5)(cid:3)(cid:9)(cid:2)(cid:28)(cid:3,,13749.0
,,17,,,Unknown,,cid:3)(cid:5)(cid:14)(cid:70)(cid:12)(cid:11)(cid:4)(cid:14)(cid:11)(cid:48)(cid:48)(cid:7)(cid:5)(cid:3)(cid:9)(cid:2)(cid:12)(cid:11)(cid:4)(cid:14)(cid:11)(cid:48)(cid:48)(cid:7)(cid:5)(cid:3)(cid:9)(cid:2)(cid:28)(cid:3,,13766.0
,,36,,,Unknown,,cid:3)(cid:5)(cid:14)(cid:70)(cid:12)(cid:11)(cid:4)(cid:14)(cid:11)(cid:48)(cid:48)(cid:7)(cid:5)(cid:3)(cid:9)(cid:2)(cid:12)(cid:11)(cid:4)(cid:14)(cid:11)(cid:48)(cid:48)(cid:7)(cid:5)(cid:3)(cid:9)(cid:2)(cid:28)(cid:3,,13802.0
,,18,,,Unknown,,cid:3)(cid:5)(cid:14)(cid:70)(cid:12)(cid:11)(cid:4)(cid:14)(cid:11)(cid:48)(cid:48)(cid:7)(cid:5)(cid:3)(cid:9)(cid:2)(cid:12)(cid:11)(cid:4)(cid:14)(cid:11)(cid:48)(cid:48)(cid:7)(cid:5)(cid:3)(cid:9)(cid:2)(cid:28)(cid:3,,13820.0
,,1,,,Unknown,,cid:3)(cid:5)(cid:14)(cid:70)(cid:12)(cid:11)(cid:4)(cid:14)(cid:11)(cid:48)(cid:48)(cid:7)(cid:5)(cid:3)(cid:9)(cid:2)(cid:12)(cid:11)(cid:4)(cid:14)(cid:11)(cid:48)(cid:48)(cid:7)(cid:5)(cid:3)(cid:9)(cid:2)(cid:28)(cid:3,,13821.0
,,2,,,Unknown,,cid:3)(cid:5)(cid:14)(cid:70)(cid:12)(cid:11)(cid:4)(cid:14)(cid:11)(cid:48)(cid:48)(cid:7)(cid:5)(cid:3)(cid:9)(cid:2)(cid:12)(cid:11)(cid:4)(cid:14)(cid:11)(cid:48)(cid:48)(cid:7)(cid:5)(cid:3)(cid:9)(cid:2)(cid:28)(cid:3,,13823.0
,,12,,,Unknown,,cid:3)(cid:5)(cid:14)(cid:70)(cid:12)(cid:11)(cid:4)(cid:14)(cid:11)(cid:48)(cid:48)(cid:7)(cid:5)(cid:3)(cid:9)(cid:2)(cid:12)(cid:11)(cid:4)(cid:14)(cid:11)(cid:48)(cid:48)(cid:7)(cid:5)(cid:3)(cid:9)(cid:2)(cid:28)(cid:3,,13835.0
,,11,,,Unknown,,cid:3)(cid:5)(cid:14)(cid:70)(cid:12)(cid:11)(cid:4)(cid:14)(cid:11)(cid:48)(cid:48)(cid:7)(cid:5)(cid:3)(cid:9)(cid:2)(cid:12)(cid:11)(cid:4)(cid:14)(cid:11)(cid:48)(cid:48)(cid:7)(cid:5)(cid:3)(cid:9)(cid:2)(cid:28)(cid:3,,13846.0
,,4,,,Unknown,,cid:3)(cid:5)(cid:14)(cid:70)(cid:12)(cid:11)(cid:4)(cid:14)(cid:11)(cid:48)(cid:48)(cid:7)(cid:5)(cid:3)(cid:9)(cid:2)(cid:12)(cid:11)(cid:4)(cid:14)(cid:11)(cid:48)(cid:48)(cid:7)(cid:5)(cid:3)(cid:9)(cid:2)(cid:28)(cid:3,,13850.0
,,7,,,Unknown,,cid:3)(cid:5)(cid:14)(cid:70)(cid:12)(cid:11)(cid:4)(cid:14)(cid:11)(cid:48)(cid:48)(cid:7)(cid:5)(cid:3)(cid:9)(cid:2)(cid:12)(cid:11)(cid:4)(cid:14)(cid:11)(cid:48)(cid:48)(cid:7)(cid:5)(cid:3)(cid:9)(cid:2)(cid:28)(cid:3,,13857.0
,,14,,,Unknown,,cid:3)(cid:5)(cid:14)(cid:70)(cid:12)(cid:11)(cid:4)(cid:14)(cid:11)(cid:48)(cid:48)(cid:7)(cid:5)(cid:3)(cid:9)(cid:2)(cid:12)(cid:11)(cid:4)(cid:14)(cid:11)(cid:48)(cid:48)(cid:7)(cid:5)(cid:3)(cid:9)(cid:2)(cid:28)(cid:3,,13871.0
,,14,,,Unknown,,cid:3)(cid:5)(cid:14)(cid:70)(cid:12)(cid:11)(cid:4)(cid:14)(cid:11)(cid:48)(cid:48)(cid:7)(cid:5)(cid:3)(cid:9)(cid:2)(cid:12)(cid:11)(cid:4)(cid:14)(cid:11)(cid:48)(cid:48)(cid:7)(cid:5)(cid:3)(cid:9)(cid:2)(cid:28)(cid:3,,13885.0
,,49,,,Unknown,,cid:3)(cid:5)(cid:14)(cid:70)(cid:12)(cid:11)(cid:4)(cid:14)(cid:11)(cid:48)(cid:48)(cid:7)(cid:5)(cid:3)(cid:9)(cid:2)(cid:12)(cid:11)(cid:4)(cid:14)(cid:11)(cid:48)(cid:48)(cid:7)(cid:5)(cid:3)(cid:9)(cid:2)(cid:28)(cid:3,,13934.0
,,2,,,Unknown,,cid:3)(cid:5)(cid:14)(cid:70)(cid:12)(cid:11)(cid:4)(cid:14)(cid:11)(cid:48)(cid:48)(cid:7)(cid:5)(cid:3)(cid:9)(cid:2)(cid:12)(cid:11)(cid:4)(cid:14)(cid:11)(cid:48)(cid:48)(cid:7)(cid:5)(cid:3)(cid:9)(cid:2)(cid:28)(cid:3,,13936.0
,,39,,,Unknown,,cid:3)(cid:5)(cid:14)(cid:70)(cid:12)(cid:11)(cid:4)(cid:14)(cid:11)(cid:48)(cid:48)(cid:7)(cid:5)(cid:3)(cid:9)(cid:2)(cid:12)(cid:11)(cid:4)(cid:14)(cid:11)(cid:48)(cid:48)(cid:7)(cid:5)(cid:3)(cid:9)(cid:2)(cid:28)(cid:3,,13975.0
,,11,,,Unknown,,cid:3)(cid:5)(cid:14)(cid:70)(cid:12)(cid:11)(cid:4)(cid:14)(cid:11)(cid:48)(cid:48)(cid:7)(cid:5)(cid:3)(cid:9)(cid:2)(cid:12)(cid:11)(cid:4)(cid:14)(cid:11)(cid:48)(cid:48)(cid:7)(cid:5)(cid:3)(cid:9)(cid:2)(cid:28)(cid:3,,13986.0
,,2,,,Unknown,,cid:3)(cid:5)(cid:14)(cid:70)(cid:12)(cid:11)(cid:4)(cid:14)(cid:11)(cid:48)(cid:48)(cid:7)(cid:5)(cid:3)(cid:9)(cid:2)(cid:12)(cid:11)(cid:4)(cid:14)(cid:11)(cid:48)(cid:48)(cid:7)(cid:5)(cid:3)(cid:9)(cid:2)(cid:28)(cid:3,,13988.0
,,28,,,Unknown,,cid:3)(cid:5)(cid:14)(cid:70)(cid:12)(cid:11)(cid:4)(cid:14)(cid:11)(cid:48)(cid:48)(cid:7)(cid:5)(cid:3)(cid:9)(cid:2)(cid:12)(cid:11)(cid:4)(cid:14)(cid:11)(cid:48)(cid:48)(cid:7)(cid:5)(cid:3)(cid:9)(cid:2)(cid:28)(cid:3,,14016.0
,,3,,,Unknown,,cid:3)(cid:5)(cid:14)(cid:70)(cid:12)(cid:11)(cid:4)(cid:14)(cid:11)(cid:48)(cid:48)(cid:7)(cid:5)(cid:3)(cid:9)(cid:2)(cid:12)(cid:11)(cid:4)(cid:14)(cid:11)(cid:48)(cid:48)(cid:7)(cid:5)(cid:3)(cid:9)(cid:2)(cid:28)(cid:3,,14019.0
,,15,,,Unknown,,cid:3)(cid:5)(cid:14)(cid:70)(cid:12)(cid:11)(cid:4)(cid:14)(cid:11)(cid:48)(cid:48)(cid:7)(cid:5)(cid:3)(cid:9)(cid:2)(cid:12)(cid:11)(cid:4)(cid:14)(cid:11)(cid:48)(cid:48)(cid:7)(cid:5)(cid:3)(cid:9)(cid:2)(cid:28)(cid:3,,14034.0
,,2,,,Unknown,,cid:3)(cid:5)(cid:14)(cid:70)(cid:12)(cid:11)(cid:4)(cid:14)(cid:11)(cid:48)(cid:48)(cid:7)(cid:5)(cid:3)(cid:9)(cid:2)(cid:12)(cid:11)(cid:4)(cid:14)(cid:11)(cid:48)(cid:48)(cid:7)(cid:5)(cid:3)(cid:9)(cid:2)(cid:28)(cid:3,,14036.0
,,17,,,Unknown,,cid:3)(cid:5)(cid:14)(cid:70)(cid:12)(cid:11)(cid:4)(cid:14)(cid:11)(cid:48)(cid:48)(cid:7)(cid:5)(cid:3)(cid:9)(cid:2)(cid:12)(cid:11)(cid:4)(cid:14)(cid:11)(cid:48)(cid:48)(cid:7)(cid:5)(cid:3)(cid:9)(cid:2)(cid:28)(cid:3,,14053.0
,,33,,,Unknown,,cid:3)(cid:5)(cid:14)(cid:70)(cid:12)(cid:11)(cid:4)(cid:14)(cid:11)(cid:48)(cid:48)(cid:7)(cid:5)(cid:3)(cid:9)(cid:2)(cid:12)(cid:11)(cid:4)(cid:14)(cid:11)(cid:48)(cid:48)(cid:7)(cid:5)(cid:3)(cid:9)(cid:2)(cid:28)(cid:3,,14086.0
,,19,,,Unknown,,cid:3)(cid:5)(cid:14)(cid:70)(cid:12)(cid:11)(cid:4)(cid:14)(cid:11)(cid:48)(cid:48)(cid:7)(cid:5)(cid:3)(cid:9)(cid:2)(cid:12)(cid:11)(cid:4)(cid:14)(cid:11)(cid:48)(cid:48)(cid:7)(cid:5)(cid:3)(cid:9)(cid:2)(cid:28)(cid:3,,14105.0
,,17,,,Unknown,,cid:3)(cid:5)(cid:14)(cid:70)(cid:12)(cid:11)(cid:4)(cid:14)(cid:11)(cid:48)(cid:48)(cid:7)(cid:5)(cid:3)(cid:9)(cid:2)(cid:12)(cid:11)(cid:4)(cid:14)(cid:11)(cid:48)(cid:48)(cid:7)(cid:5)(cid:3)(cid:9)(cid:2)(cid:28)(cid:3,,14122.0
,,18,,,Unknown,,cid:3)(cid:5)(cid:14)(cid:70)(cid:12)(cid:11)(cid:4)(cid:14)(cid:11)(cid:48)(cid:48)(cid:7)(cid:5)(cid:3)(cid:9)(cid:2)(cid:12)(cid:11)(cid:4)(cid:14)(cid:11)(cid:48)(cid:48)(cid:7)(cid:5)(cid:3)(cid:9)(cid:2)(cid:28)(cid:3,,14140.0
,,2,,,Unknown,,cid:3)(cid:5)(cid:14)(cid:70)(cid:12)(cid:11)(cid:4)(cid:14)(cid:11)(cid:48)(cid:48)(cid:7)(cid:5)(cid:3)(cid:9)(cid:2)(cid:12)(cid:11)(cid:4)(cid:14)(cid:11)(cid:48)(cid:48)(cid:7)(cid:5)(cid:3)(cid:9)(cid:2)(cid:28)(cid:3,,14142.0
,,44,,,Unknown,,cid:3)(cid:5)(cid:14)(cid:70)(cid:12)(cid:11)(cid:4)(cid:14)(cid:11)(cid:48)(cid:48)(cid:7)(cid:5)(cid:3)(cid:9)(cid:2)(cid:12)(cid:11)(cid:4)(cid:14)(cid:11)(cid:48)(cid:48)(cid:7)(cid:5)(cid:3)(cid:9)(cid:2)(cid:28)(cid:3,,14186.0
,,12,,,Unknown,,cid:3)(cid:5)(cid:14)(cid:70)(cid:12)(cid:11)(cid:4)(cid:14)(cid:11)(cid:48)(cid:48)(cid:7)(cid:5)(cid:3)(cid:9)(cid:2)(cid:12)(cid:11)(cid:4)(cid:14)(cid:11)(cid:48)(cid:48)(cid:7)(cid:5)(cid:3)(cid:9)(cid:2)(cid:28)(cid:3,,14198.0
,,29,,,Unknown,,cid:3)(cid:5)(cid:14)(cid:70)(cid:12)(cid:11)(cid:4)(cid:14)(cid:11)(cid:48)(cid:48)(cid:7)(cid:5)(cid:3)(cid:9)(cid:2)(cid:12)(cid:11)(cid:4)(cid:14)(cid:11)(cid:48)(cid:48)(cid:7)(cid:5)(cid:3)(cid:9)(cid:2)(cid:28)(cid:3,,14227.0
,,26,,,Unknown,,cid:3)(cid:5)(cid:14)(cid:70)(cid:12)(cid:11)(cid:4)(cid:14)(cid:11)(cid:48)(cid:48)(cid:7)(cid:5)(cid:3)(cid:9)(cid:2)(cid:12)(cid:11)(cid:4)(cid:14)(cid:11)(cid:48)(cid:48)(cid:7)(cid:5)(cid:3)(cid:9)(cid:2)(cid:28)(cid:3,,14253.0
,,41,,,Unknown,,cid:3)(cid:5)(cid:14)(cid:70)(cid:12)(cid:11)(cid:4)(cid:14)(cid:11)(cid:48)(cid:48)(cid:7)(cid:5)(cid:3)(cid:9)(cid:2)(cid:12)(cid:11)(cid:4)(cid:14)(cid:11)(cid:48)(cid:48)(cid:7)(cid:5)(cid:3)(cid:9)(cid:2)(cid:28)(cid:3,,14294.0
,,25,,,Unknown,,cid:3)(cid:5)(cid:14)(cid:70)(cid:12)(cid:11)(cid:4)(cid:14)(cid:11)(cid:48)(cid:48)(cid:7)(cid:5)(cid:3)(cid:9)(cid:2)(cid:12)(cid:11)(cid:4)(cid:14)(cid:11)(cid:48)(cid:48)(cid:7)(cid:5)(cid:3)(cid:9)(cid:2)(cid:28)(cid:3,,14319.0
,,2,,,Unknown,,cid:3)(cid:5)(cid:14)(cid:70)(cid:12)(cid:11)(cid:4)(cid:14)(cid:11)(cid:48)(cid:48)(cid:7)(cid:5)(cid:3)(cid:9)(cid:2)(cid:12)(cid:11)(cid:4)(cid:14)(cid:11)(cid:48)(cid:48)(cid:7)(cid:5)(cid:3)(cid:9)(cid:2)(cid:28)(cid:3,,14321.0
,,58,,,Unknown,,cid:3)(cid:5)(cid:14)(cid:70)(cid:12)(cid:11)(cid:4)(cid:14)(cid:11)(cid:48)(cid:48)(cid:7)(cid:5)(cid:3)(cid:9)(cid:2)(cid:12)(cid:11)(cid:4)(cid:14)(cid:11)(cid:48)(cid:48)(cid:7)(cid:5)(cid:3)(cid:9)(cid:2)(cid:28)(cid:3,,14379.0
,,58,,,Unknown,,cid:3)(cid:5)(cid:14)(cid:70)(cid:12)(cid:11)(cid:4)(cid:14)(cid:11)(cid:48)(cid:48)(cid:7)(cid:5)(cid:3)(cid:9)(cid:2)(cid:12)(cid:11)(cid:4)(cid:14)(cid:11)(cid:48)(cid:48)(cid:7)(cid:5)(cid:3)(cid:9)(cid:2)(cid:28)(cid:3,,14437.0
,,18,,,Unknown,,cid:3)(cid:5)(cid:14)(cid:70)(cid:12)(cid:11)(cid:4)(cid:14)(cid:11)(cid:48)(cid:48)(cid:7)(cid:5)(cid:3)(cid:9)(cid:2)(cid:12)(cid:11)(cid:4)(cid:14)(cid:11)(cid:48)(cid:48)(cid:7)(cid:5)(cid:3)(cid:9)(cid:2)(cid:28)(cid:3,,14455.0
,,1,,,Unknown,,cid:3)(cid:5)(cid:14)(cid:70)(cid:12)(cid:11)(cid:4)(cid:14)(cid:11)(cid:48)(cid:48)(cid:7)(cid:5)(cid:3)(cid:9)(cid:2)(cid:12)(cid:11)(cid:4)(cid:14)(cid:11)(cid:48)(cid:48)(cid:7)(cid:5)(cid:3)(cid:9)(cid:2)(cid:28)(cid:3,,14456.0
,,1,,,Unknown,,cid:3)(cid:5)(cid:14)(cid:70)(cid:12)(cid:11)(cid:4)(cid:14)(cid:11)(cid:48)(cid:48)(cid:7)(cid:5)(cid:3)(cid:9)(cid:2)(cid:12)(cid:11)(cid:4)(cid:14)(cid:11)(cid:48)(cid:48)(cid:7)(cid:5)(cid:3)(cid:9)(cid:2)(cid:28)(cid:3,,14457.0
,,37,,,Unknown,,cid:3)(cid:5)(cid:14)(cid:70)(cid:12)(cid:11)(cid:4)(cid:14)(cid:11)(cid:48)(cid:48)(cid:7)(cid:5)(cid:3)(cid:9)(cid:2)(cid:12)(cid:11)(cid:4)(cid:14)(cid:11)(cid:48)(cid:48)(cid:7)(cid:5)(cid:3)(cid:9)(cid:2)(cid:28)(cid:3,,14494.0
,,17,,,Unknown,,cid:3)(cid:5)(cid:14)(cid:70)(cid:12)(cid:11)(cid:4)(cid:14)(cid:11)(cid:48)(cid:48)(cid:7)(cid:5)(cid:3)(cid:9)(cid:2)(cid:12)(cid:11)(cid:4)(cid:14)(cid:11)(cid:48)(cid:48)(cid:7)(cid:5)(cid:3)(cid:9)(cid:2)(cid:28)(cid:3,,14511.0
,,16,,,Unknown,,cid:3)(cid:5)(cid:14)(cid:70)(cid:12)(cid:11)(cid:4)(cid:14)(cid:11)(cid:48)(cid:48)(cid:7)(cid:5)(cid:3)(cid:9)(cid:2)(cid:12)(cid:11)(cid:4)(cid:14)(cid:11)(cid:48)(cid:48)(cid:7)(cid:5)(cid:3)(cid:9)(cid:2)(cid:28)(cid:3,,14527.0
,,45,,,Unknown,,cid:3)(cid:5)(cid:14)(cid:70)(cid:12)(cid:11)(cid:4)(cid:14)(cid:11)(cid:48)(cid:48)(cid:7)(cid:5)(cid:3)(cid:9)(cid:2)(cid:12)(cid:11)(cid:4)(cid:14)(cid:11)(cid:48)(cid:48)(cid:7)(cid:5)(cid:3)(cid:9)(cid:2)(cid:28)(cid:3,,14572.0
,,18,,,Unknown,,cid:3)(cid:5)(cid:14)(cid:70)(cid:12)(cid:11)(cid:4)(cid:14)(cid:11)(cid:48)(cid:48)(cid:7)(cid:5)(cid:3)(cid:9)(cid:2)(cid:12)(cid:11)(cid:4)(cid:14)(cid:11)(cid:48)(cid:48)(cid:7)(cid:5)(cid:3)(cid:9)(cid:2)(cid:28)(cid:3,,14590.0
,,16,,,Unknown,,cid:3)(cid:5)(cid:14)(cid:70)(cid:12)(cid:11)(cid:4)(cid:14)(cid:11)(cid:48)(cid:48)(cid:7)(cid:5)(cid:3)(cid:9)(cid:2)(cid:12)(cid:11)(cid:4)(cid:14)(cid:11)(cid:48)(cid:48)(cid:7)(cid:5)(cid:3)(cid:9)(cid:2)(cid:28)(cid:3,,14606.0
,,9,,,Unknown,,cid:3)(cid:5)(cid:14)(cid:70)(cid:12)(cid:11)(cid:4)(cid:14)(cid:11)(cid:48)(cid:48)(cid:7)(cid:5)(cid:3)(cid:9)(cid:2)(cid:12)(cid:11)(cid:4)(cid:14)(cid:11)(cid:48)(cid:48)(cid:7)(cid:5)(cid:3)(cid:9)(cid:2)(cid:28)(cid:3,,14615.0
,,46,,,Unknown,,cid:3)(cid:5)(cid:14)(cid:70)(cid:12)(cid:11)(cid:4)(cid:14)(cid:11)(cid:48)(cid:48)(cid:7)(cid:5)(cid:3)(cid:9)(cid:2)(cid:12)(cid:11)(cid:4)(cid:14)(cid:11)(cid:48)(cid:48)(cid:7)(cid:5)(cid:3)(cid:9)(cid:2)(cid:28)(cid:3,,14661.0
,,8,,,Unknown,,cid:3)(cid:5)(cid:14)(cid:70)(cid:12)(cid:11)(cid:4)(cid:14)(cid:11)(cid:48)(cid:48)(cid:7)(cid:5)(cid:3)(cid:9)(cid:2)(cid:12)(cid:11)(cid:4)(cid:14)(cid:11)(cid:48)(cid:48)(cid:7)(cid:5)(cid:3)(cid:9)(cid:2)(cid:28)(cid:3,,14669.0
,,5,,,Unknown,,cid:3)(cid:5)(cid:14)(cid:70)(cid:12)(cid:11)(cid:4)(cid:14)(cid:11)(cid:48)(cid:48)(cid:7)(cid:5)(cid:3)(cid:9)(cid:2)(cid:12)(cid:11)(cid:4)(cid:14)(cid:11)(cid:48)(cid:48)(cid:7)(cid:5)(cid:3)(cid:9)(cid:2)(cid:28)(cid:3,,14674.0
,,28,,,Unknown,,cid:3)(cid:5)(cid:14)(cid:70)(cid:12)(cid:11)(cid:4)(cid:14)(cid:11)(cid:48)(cid:48)(cid:7)(cid:5)(cid:3)(cid:9)(cid:2)(cid:12)(cid:11)(cid:4)(cid:14)(cid:11)(cid:48)(cid:48)(cid:7)(cid:5)(cid:3)(cid:9)(cid:2)(cid:28)(cid:3,,14702.0
,,2,,,Unknown,,cid:3)(cid:5)(cid:14)(cid:70)(cid:12)(cid:11)(cid:4)(cid:14)(cid:11)(cid:48)(cid:48)(cid:7)(cid:5)(cid:3)(cid:9)(cid:2)(cid:12)(cid:11)(cid:4)(cid:14)(cid:11)(cid:48)(cid:48)(cid:7)(cid:5)(cid:3)(cid:9)(cid:2)(cid:28)(cid:3,,14704.0
,,46,,,Unknown,,cid:3)(cid:5)(cid:14)(cid:70)(cid:12)(cid:11)(cid:4)(cid:14)(cid:11)(cid:48)(cid:48)(cid:7)(cid:5)(cid:3)(cid:9)(cid:2)(cid:12)(cid:11)(cid:4)(cid:14)(cid:11)(cid:48)(cid:48)(cid:7)(cid:5)(cid:3)(cid:9)(cid:2)(cid:28)(cid:3,,14750.0
,,4,,,Unknown,,cid:3)(cid:5)(cid:14)(cid:70)(cid:12)(cid:11)(cid:4)(cid:14)(cid:11)(cid:48)(cid:48)(cid:7)(cid:5)(cid:3)(cid:9)(cid:2)(cid:12)(cid:11)(cid:4)(cid:14)(cid:11)(cid:48)(cid:48)(cid:7)(cid:5)(cid:3)(cid:9)(cid:2)(cid:28)(cid:3,,14754.0
,,10,,,Unknown,,cid:3)(cid:5)(cid:14)(cid:70)(cid:12)(cid:11)(cid:4)(cid:14)(cid:11)(cid:48)(cid:48)(cid:7)(cid:5)(cid:3)(cid:9)(cid:2)(cid:12)(cid:11)(cid:4)(cid:14)(cid:11)(cid:48)(cid:48)(cid:7)(cid:5)(cid:3)(cid:9)(cid:2)(cid:28)(cid:3,,14764.0
,,11,,,Unknown,,cid:3)(cid:5)(cid:14)(cid:70)(cid:12)(cid:11)(cid:4)(cid:14)(cid:11)(cid:48)(cid:48)(cid:7)(cid:5)(cid:3)(cid:9)(cid:2)(cid:12)(cid:11)(cid:4)(cid:14)(cid:11)(cid:48)(cid:48)(cid:7)(cid:5)(cid:3)(cid:9)(cid:2)(cid:28)(cid:3,,14775.0
,,3,,,Unknown,,cid:3)(cid:5)(cid:14)(cid:70)(cid:12)(cid:11)(cid:4)(cid:14)(cid:11)(cid:48)(cid:48)(cid:7)(cid:5)(cid:3)(cid:9)(cid:2)(cid:12)(cid:11)(cid:4)(cid:14)(cid:11)(cid:48)(cid:48)(cid:7)(cid:5)(cid:3)(cid:9)(cid:2)(cid:28)(cid:3,,14778.0
,,11,,,Unknown,,cid:3)(cid:5)(cid:14)(cid:70)(cid:12)(cid:11)(cid:4)(cid:14)(cid:11)(cid:48)(cid:48)(cid:7)(cid:5)(cid:3)(cid:9)(cid:2)(cid:12)(cid:11)(cid:4)(cid:14)(cid:11)(cid:48)(cid:48)(cid:7)(cid:5)(cid:3)(cid:9)(cid:2)(cid:28)(cid:3,,14789.0
,,4,,,Unknown,,cid:3)(cid:5)(cid:14)(cid:70)(cid:12)(cid:11)(cid:4)(cid:14)(cid:11)(cid:48)(cid:48)(cid:7)(cid:5)(cid:3)(cid:9)(cid:2)(cid:12)(cid:11)(cid:4)(cid:14)(cid:11)(cid:48)(cid:48)(cid:7)(cid:5)(cid:3)(cid:9)(cid:2)(cid:28)(cid:3,,14793.0
,,10,,,Unknown,,cid:3)(cid:5)(cid:14)(cid:70)(cid:12)(cid:11)(cid:4)(cid:14)(cid:11)(cid:48)(cid:48)(cid:7)(cid:5)(cid:3)(cid:9)(cid:2)(cid:12)(cid:11)(cid:4)(cid:14)(cid:11)(cid:48)(cid:48)(cid:7)(cid:5)(cid:3)(cid:9)(cid:2)(cid:28)(cid:3,,14803.0
,,5,,,Unknown,,cid:3)(cid:5)(cid:14)(cid:70)(cid:12)(cid:11)(cid:4)(cid:14)(cid:11)(cid:48)(cid:48)(cid:7)(cid:5)(cid:3)(cid:9)(cid:2)(cid:12)(cid:11)(cid:4)(cid:14)(cid:11)(cid:48)(cid:48)(cid:7)(cid:5)(cid:3)(cid:9)(cid:2)(cid:28)(cid:3,,14808.0
,,2,,,Unknown,,cid:3)(cid:5)(cid:14)(cid:70)(cid:12)(cid:11)(cid:4)(cid:14)(cid:11)(cid:48)(cid:48)(cid:7)(cid:5)(cid:3)(cid:9)(cid:2)(cid:12)(cid:11)(cid:4)(cid:14)(cid:11)(cid:48)(cid:48)(cid:7)(cid:5)(cid:3)(cid:9)(cid:2)(cid:28)(cid:3,,14810.0
,,9,,,Unknown,,cid:3)(cid:5)(cid:14)(cid:70)(cid:12)(cid:11)(cid:4)(cid:14)(cid:11)(cid:48)(cid:48)(cid:7)(cid:5)(cid:3)(cid:9)(cid:2)(cid:12)(cid:11)(cid:4)(cid:14)(cid:11)(cid:48)(cid:48)(cid:7)(cid:5)(cid:3)(cid:9)(cid:2)(cid:28)(cid:3,,14819.0
,,5,,,Unknown,,cid:3)(cid:5)(cid:14)(cid:70)(cid:12)(cid:11)(cid:4)(cid:14)(cid:11)(cid:48)(cid:48)(cid:7)(cid:5)(cid:3)(cid:9)(cid:2)(cid:12)(cid:11)(cid:4)(cid:14)(cid:11)(cid:48)(cid:48)(cid:7)(cid:5)(cid:3)(cid:9)(cid:2)(cid:28)(cid:3,,14824.0
,,8,,,Unknown,,cid:3)(cid:5)(cid:14)(cid:70)(cid:12)(cid:11)(cid:4)(cid:14)(cid:11)(cid:48)(cid:48)(cid:7)(cid:5)(cid:3)(cid:9)(cid:2)(cid:12)(cid:11)(cid:4)(cid:14)(cid:11)(cid:48)(cid:48)(cid:7)(cid:5)(cid:3)(cid:9)(cid:2)(cid:28)(cid:3,,14832.0
,,14,,,Unknown,,cid:3)(cid:5)(cid:14)(cid:70)(cid:12)(cid:11)(cid:4)(cid:14)(cid:11)(cid:48)(cid:48)(cid:7)(cid:5)(cid:3)(cid:9)(cid:2)(cid:12)(cid:11)(cid:4)(cid:14)(cid:11)(cid:48)(cid:48)(cid:7)(cid:5)(cid:3)(cid:9)(cid:2)(cid:28)(cid:3,,14846.0
,,7,,,Unknown,,cid:3)(cid:5)(cid:14)(cid:70)(cid:12)(cid:11)(cid:4)(cid:14)(cid:11)(cid:48)(cid:48)(cid:7)(cid:5)(cid:3)(cid:9)(cid:2)(cid:12)(cid:11)(cid:4)(cid:14)(cid:11)(cid:48)(cid:48)(cid:7)(cid:5)(cid:3)(cid:9)(cid:2)(cid:28)(cid:3,,14853.0
,,9,,,Unknown,,cid:3)(cid:5)(cid:14)(cid:70)(cid:12)(cid:11)(cid:4)(cid:14)(cid:11)(cid:48)(cid:48)(cid:7)(cid:5)(cid:3)(cid:9)(cid:2)(cid:12)(cid:11)(cid:4)(cid:14)(cid:11)(cid:48)(cid:48)(cid:7)(cid:5)(cid:3)(cid:9)(cid:2)(cid:28)(cid:3,,14862.0
,,2,,,Unknown,,cid:3)(cid:5)(cid:14)(cid:70)(cid:12)(cid:11)(cid:4)(cid:14)(cid:11)(cid:48)(cid:48)(cid:7)(cid:5)(cid:3)(cid:9)(cid:2)(cid:12)(cid:11)(cid:4)(cid:14)(cid:11)(cid:48)(cid:48)(cid:7)(cid:5)(cid:3)(cid:9)(cid:2)(cid:28)(cid:3,,14864.0
,,12,,,Unknown,,cid:3)(cid:5)(cid:14)(cid:70)(cid:12)(cid:11)(cid:4)(cid:14)(cid:11)(cid:48)(cid:48)(cid:7)(cid:5)(cid:3)(cid:9)(cid:2)(cid:12)(cid:11)(cid:4)(cid:14)(cid:11)(cid:48)(cid:48)(cid:7)(cid:5)(cid:3)(cid:9)(cid:2)(cid:28)(cid:3,,14876.0
,,5,,,Unknown,,cid:3)(cid:5)(cid:14)(cid:70)(cid:12)(cid:11)(cid:4)(cid:14)(cid:11)(cid:48)(cid:48)(cid:7)(cid:5)(cid:3)(cid:9)(cid:2)(cid:12)(cid:11)(cid:4)(cid:14)(cid:11)(cid:48)(cid:48)(cid:7)(cid:5)(cid:3)(cid:9)(cid:2)(cid:28)(cid:3,,14881.0
,,50,,,Unknown,,cid:3)(cid:5)(cid:14)(cid:70)(cid:12)(cid:11)(cid:4)(cid:14)(cid:11)(cid:48)(cid:48)(cid:7)(cid:5)(cid:3)(cid:9)(cid:2)(cid:12)(cid:11)(cid:4)(cid:14)(cid:11)(cid:48)(cid:48)(cid:7)(cid:5)(cid:3)(cid:9)(cid:2)(cid:28)(cid:3,,14931.0
,,5,,,Unknown,,cid:3)(cid:5)(cid:14)(cid:70)(cid:12)(cid:11)(cid:4)(cid:14)(cid:11)(cid:48)(cid:48)(cid:7)(cid:5)(cid:3)(cid:9)(cid:2)(cid:12)(cid:11)(cid:4)(cid:14)(cid:11)(cid:48)(cid:48)(cid:7)(cid:5)(cid:3)(cid:9)(cid:2)(cid:28)(cid:3,,14936.0
,,40,,,Unknown,,cid:3)(cid:5)(cid:14)(cid:70)(cid:12)(cid:11)(cid:4)(cid:14)(cid:11)(cid:48)(cid:48)(cid:7)(cid:5)(cid:3)(cid:9)(cid:2)(cid:12)(cid:11)(cid:4)(cid:14)(cid:11)(cid:48)(cid:48)(cid:7)(cid:5)(cid:3)(cid:9)(cid:2)(cid:28)(cid:3,,14976.0
,,2,,,Unknown,,cid:3)(cid:5)(cid:14)(cid:70)(cid:12)(cid:11)(cid:4)(cid:14)(cid:11)(cid:48)(cid:48)(cid:7)(cid:5)(cid:3)(cid:9)(cid:2)(cid:12)(cid:11)(cid:4)(cid:14)(cid:11)(cid:48)(cid:48)(cid:7)(cid:5)(cid:3)(cid:9)(cid:2)(cid:28)(cid:3,,14978.0
,,28,,,Unknown,,cid:3)(cid:5)(cid:14)(cid:70)(cid:12)(cid:11)(cid:4)(cid:14)(cid:11)(cid:48)(cid:48)(cid:7)(cid:5)(cid:3)(cid:9)(cid:2)(cid:12)(cid:11)(cid:4)(cid:14)(cid:11)(cid:48)(cid:48)(cid:7)(cid:5)(cid:3)(cid:9)(cid:2)(cid:28)(cid:3,,15006.0
,,3,,,Unknown,,cid:3)(cid:5)(cid:14)(cid:70)(cid:12)(cid:11)(cid:4)(cid:14)(cid:11)(cid:48)(cid:48)(cid:7)(cid:5)(cid:3)(cid:9)(cid:2)(cid:12)(cid:11)(cid:4)(cid:14)(cid:11)(cid:48)(cid:48)(cid:7)(cid:5)(cid:3)(cid:9)(cid:2)(cid:28)(cid:3,,15009.0
,,15,,,Unknown,,cid:3)(cid:5)(cid:14)(cid:70)(cid:12)(cid:11)(cid:4)(cid:14)(cid:11)(cid:48)(cid:48)(cid:7)(cid:5)(cid:3)(cid:9)(cid:2)(cid:12)(cid:11)(cid:4)(cid:14)(cid:11)(cid:48)(cid:48)(cid:7)(cid:5)(cid:3)(cid:9)(cid:2)(cid:28)(cid:3,,15024.0
,,2,,,Unknown,,cid:3)(cid:5)(cid:14)(cid:70)(cid:12)(cid:11)(cid:4)(cid:14)(cid:11)(cid:48)(cid:48)(cid:7)(cid:5)(cid:3)(cid:9)(cid:2)(cid:12)(cid:11)(cid:4)(cid:14)(cid:11)(cid:48)(cid:48)(cid:7)(cid:5)(cid:3)(cid:9)(cid:2)(cid:28)(cid:3,,15026.0
,,1,,,Unknown,,cid:3)(cid:5)(cid:14)(cid:70)(cid:12)(cid:11)(cid:4)(cid:14)(cid:11)(cid:48)(cid:48)(cid:7)(cid:5)(cid:3)(cid:9)(cid:2)(cid:12)(cid:11)(cid:4)(cid:14)(cid:11)(cid:48)(cid:48)(cid:7)(cid:5)(cid:3)(cid:9)(cid:2)(cid:28)(cid:3,,15027.0
,,19,,,Unknown,,cid:3)(cid:5)(cid:14)(cid:70)(cid:12)(cid:11)(cid:4)(cid:14)(cid:11)(cid:48)(cid:48)(cid:7)(cid:5)(cid:3)(cid:9)(cid:2)(cid:12)(cid:11)(cid:4)(cid:14)(cid:11)(cid:48)(cid:48)(cid:7)(cid:5)(cid:3)(cid:9)(cid:2)(cid:28)(cid:3,,15046.0
,,37,,,Unknown,,cid:3)(cid:5)(cid:14)(cid:70)(cid:12)(cid:11)(cid:4)(cid:14)(cid:11)(cid:48)(cid:48)(cid:7)(cid:5)(cid:3)(cid:9)(cid:2)(cid:12)(cid:11)(cid:4)(cid:14)(cid:11)(cid:48)(cid:48)(cid:7)(cid:5)(cid:3)(cid:9)(cid:2)(cid:28)(cid:3,,15083.0
,,18,,,Unknown,,cid:3)(cid:5)(cid:14)(cid:70)(cid:12)(cid:11)(cid:4)(cid:14)(cid:11)(cid:48)(cid:48)(cid:7)(cid:5)(cid:3)(cid:9)(cid:2)(cid:12)(cid:11)(cid:4)(cid:14)(cid:11)(cid:48)(cid:48)(cid:7)(cid:5)(cid:3)(cid:9)(cid:2)(cid:28)(cid:3,,15101.0
,,2,,,Unknown,,cid:3)(cid:5)(cid:14)(cid:70)(cid:12)(cid:11)(cid:4)(cid:14)(cid:11)(cid:48)(cid:48)(cid:7)(cid:5)(cid:3)(cid:9)(cid:2)(cid:12)(cid:11)(cid:4)(cid:14)(cid:11)(cid:48)(cid:48)(cid:7)(cid:5)(cid:3)(cid:9)(cid:2)(cid:28)(cid:3,,15103.0
,,44,,,Unknown,,cid:3)(cid:5)(cid:14)(cid:70)(cid:12)(cid:11)(cid:4)(cid:14)(cid:11)(cid:48)(cid:48)(cid:7)(cid:5)(cid:3)(cid:9)(cid:2)(cid:12)(cid:11)(cid:4)(cid:14)(cid:11)(cid:48)(cid:48)(cid:7)(cid:5)(cid:3)(cid:9)(cid:2)(cid:28)(cid:3,,15147.0
,,12,,,Unknown,,cid:3)(cid:5)(cid:14)(cid:70)(cid:12)(cid:11)(cid:4)(cid:14)(cid:11)(cid:48)(cid:48)(cid:7)(cid:5)(cid:3)(cid:9)(cid:2)(cid:12)(cid:11)(cid:4)(cid:14)(cid:11)(cid:48)(cid:48)(cid:7)(cid:5)(cid:3)(cid:9)(cid:2)(cid:28)(cid:3,,15159.0
,,29,,,Unknown,,cid:3)(cid:5)(cid:14)(cid:70)(cid:12)(cid:11)(cid:4)(cid:14)(cid:11)(cid:48)(cid:48)(cid:7)(cid:5)(cid:3)(cid:9)(cid:2)(cid:12)(cid:11)(cid:4)(cid:14)(cid:11)(cid:48)(cid:48)(cid:7)(cid:5)(cid:3)(cid:9)(cid:2)(cid:28)(cid:3,,15188.0
,,26,,,Unknown,,cid:3)(cid:5)(cid:14)(cid:70)(cid:12)(cid:11)(cid:4)(cid:14)(cid:11)(cid:48)(cid:48)(cid:7)(cid:5)(cid:3)(cid:9)(cid:2)(cid:12)(cid:11)(cid:4)(cid:14)(cid:11)(cid:48)(cid:48)(cid:7)(cid:5)(cid:3)(cid:9)(cid:2)(cid:28)(cid:3,,15214.0
,,41,,,Unknown,,cid:3)(cid:5)(cid:14)(cid:70)(cid:12)(cid:11)(cid:4)(cid:14)(cid:11)(cid:48)(cid:48)(cid:7)(cid:5)(cid:3)(cid:9)(cid:2)(cid:12)(cid:11)(cid:4)(cid:14)(cid:11)(cid:48)(cid:48)(cid:7)(cid:5)(cid:3)(cid:9)(cid:2)(cid:28)(cid:3,,15255.0
,,25,,,Unknown,,cid:3)(cid:5)(cid:14)(cid:70)(cid:12)(cid:11)(cid:4)(cid:14)(cid:11)(cid:48)(cid:48)(cid:7)(cid:5)(cid:3)(cid:9)(cid:2)(cid:12)(cid:11)(cid:4)(cid:14)(cid:11)(cid:48)(cid:48)(cid:7)(cid:5)(cid:3)(cid:9)(cid:2)(cid:28)(cid:3,,15280.0
,,2,,,Unknown,,cid:3)(cid:5)(cid:14)(cid:70)(cid:12)(cid:11)(cid:4)(cid:14)(cid:11)(cid:48)(cid:48)(cid:7)(cid:5)(cid:3)(cid:9)(cid:2)(cid:12)(cid:11)(cid:4)(cid:14)(cid:11)(cid:48)(cid:48)(cid:7)(cid:5)(cid:3)(cid:9)(cid:2)(cid:28)(cid:3,,15282.0
,,58,,,Unknown,,cid:3)(cid:5)(cid:14)(cid:70)(cid:12)(cid:11)(cid:4)(cid:14)(cid:11)(cid:48)(cid:48)(cid:7)(cid:5)(cid:3)(cid:9)(cid:2)(cid:12)(cid:11)(cid:4)(cid:14)(cid:11)(cid:48)(cid:48)(cid:7)(cid:5)(cid:3)(cid:9)(cid:2)(cid:28)(cid:3,,15340.0
,,58,,,Unknown,,cid:3)(cid:5)(cid:14)(cid:70)(cid:12)(cid:11)(cid:4)(cid:14)(cid:11)(cid:48)(cid:48)(cid:7)(cid:5)(cid:3)(cid:9)(cid:2)(cid:12)(cid:11)(cid:4)(cid:14)(cid:11)(cid:48)(cid:48)(cid:7)(cid:5)(cid:3)(cid:9)(cid:2)(cid:28)(cid:3,,15398.0
,,18,,,Unknown,,cid:3)(cid:5)(cid:14)(cid:70)(cid:12)(cid:11)(cid:4)(cid:14)(cid:11)(cid:48)(cid:48)(cid:7)(cid:5)(cid:3)(cid:9)(cid:2)(cid:12)(cid:11)(cid:4)(cid:14)(cid:11)(cid:48)(cid:48)(cid:7)(cid:5)(cid:3)(cid:9)(cid:2)(cid:28)(cid:3,,15416.0
,,1,,,Unknown,,cid:3)(cid:5)(cid:14)(cid:70)(cid:12)(cid:11)(cid:4)(cid:14)(cid:11)(cid:48)(cid:48)(cid:7)(cid:5)(cid:3)(cid:9)(cid:2)(cid:12)(cid:11)(cid:4)(cid:14)(cid:11)(cid:48)(cid:48)(cid:7)(cid:5)(cid:3)(cid:9)(cid:2)(cid:28)(cid:3,,15417.0
,,1,,,Unknown,,cid:3)(cid:5)(cid:14)(cid:70)(cid:12)(cid:11)(cid:4)(cid:14)(cid:11)(cid:48)(cid:48)(cid:7)(cid:5)(cid:3)(cid:9)(cid:2)(cid:12)(cid:11)(cid:4)(cid:14)(cid:11)(cid:48)(cid:48)(cid:7)(cid:5)(cid:3)(cid:9)(cid:2)(cid:28)(cid:3,,15418.0
,,37,,,Unknown,,cid:3)(cid:5)(cid:14)(cid:70)(cid:12)(cid:11)(cid:4)(cid:14)(cid:11)(cid:48)(cid:48)(cid:7)(cid:5)(cid:3)(cid:9)(cid:2)(cid:12)(cid:11)(cid:4)(cid:14)(cid:11)(cid:48)(cid:48)(cid:7)(cid:5)(cid:3)(cid:9)(cid:2)(cid:28)(cid:3,,15455.0
,,17,,,Unknown,,cid:3)(cid:5)(cid:14)(cid:70)(cid:12)(cid:11)(cid:4)(cid:14)(cid:11)(cid:48)(cid:48)(cid:7)(cid:5)(cid:3)(cid:9)(cid:2)(cid:12)(cid:11)(cid:4)(cid:14)(cid:11)(cid:48)(cid:48)(cid:7)(cid:5)(cid:3)(cid:9)(cid:2)(cid:28)(cid:3,,15472.0
,,16,,,Unknown,,cid:3)(cid:5)(cid:14)(cid:70)(cid:12)(cid:11)(cid:4)(cid:14)(cid:11)(cid:48)(cid:48)(cid:7)(cid:5)(cid:3)(cid:9)(cid:2)(cid:12)(cid:11)(cid:4)(cid:14)(cid:11)(cid:48)(cid:48)(cid:7)(cid:5)(cid:3)(cid:9)(cid:2)(cid:28)(cid:3,,15488.0
,,45,,,Unknown,,cid:3)(cid:5)(cid:14)(cid:70)(cid:12)(cid:11)(cid:4)(cid:14)(cid:11)(cid:48)(cid:48)(cid:7)(cid:5)(cid:3)(cid:9)(cid:2)(cid:12)(cid:11)(cid:4)(cid:14)(cid:11)(cid:48)(cid:48)(cid:7)(cid:5)(cid:3)(cid:9)(cid:2)(cid:28)(cid:3,,15533.0
,,18,,,Unknown,,cid:3)(cid:5)(cid:14)(cid:70)(cid:12)(cid:11)(cid:4)(cid:14)(cid:11)(cid:48)(cid:48)(cid:7)(cid:5)(cid:3)(cid:9)(cid:2)(cid:12)(cid:11)(cid:4)(cid:14)(cid:11)(cid:48)(cid:48)(cid:7)(cid:5)(cid:3)(cid:9)(cid:2)(cid:28)(cid:3,,15551.0
,,16,,,Unknown,,cid:3)(cid:5)(cid:14)(cid:70)(cid:12)(cid:11)(cid:4)(cid:14)(cid:11)(cid:48)(cid:48)(cid:7)(cid:5)(cid:3)(cid:9)(cid:2)(cid:12)(cid:11)(cid:4)(cid:14)(cid:11)(cid:48)(cid:48)(cid:7)(cid:5)(cid:3)(cid:9)(cid:2)(cid:28)(cid:3,,15567.0
,,9,,,Unknown,,cid:3)(cid:5)(cid:14)(cid:70)(cid:12)(cid:11)(cid:4)(cid:14)(cid:11)(cid:48)(cid:48)(cid:7)(cid:5)(cid:3)(cid:9)(cid:2)(cid:12)(cid:11)(cid:4)(cid:14)(cid:11)(cid:48)(cid:48)(cid:7)(cid:5)(cid:3)(cid:9)(cid:2)(cid:28)(cid:3,,15576.0
,,46,,,Unknown,,cid:3)(cid:5)(cid:14)(cid:70)(cid:12)(cid:11)(cid:4)(cid:14)(cid:11)(cid:48)(cid:48)(cid:7)(cid:5)(cid:3)(cid:9)(cid:2)(cid:12)(cid:11)(cid:4)(cid:14)(cid:11)(cid:48)(cid:48)(cid:7)(cid:5)(cid:3)(cid:9)(cid:2)(cid:28)(cid:3,,15622.0
,,8,,,Unknown,,cid:3)(cid:5)(cid:14)(cid:70)(cid:12)(cid:11)(cid:4)(cid:14)(cid:11)(cid:48)(cid:48)(cid:7)(cid:5)(cid:3)(cid:9)(cid:2)(cid:12)(cid:11)(cid:4)(cid:14)(cid:11)(cid:48)(cid:48)(cid:7)(cid:5)(cid:3)(cid:9)(cid:2)(cid:28)(cid:3,,15630.0
,,5,,,Unknown,,cid:3)(cid:5)(cid:14)(cid:70)(cid:12)(cid:11)(cid:4)(cid:14)(cid:11)(cid:48)(cid:48)(cid:7)(cid:5)(cid:3)(cid:9)(cid:2)(cid:12)(cid:11)(cid:4)(cid:14)(cid:11)(cid:48)(cid:48)(cid:7)(cid:5)(cid:3)(cid:9)(cid:2)(cid:28)(cid:3,,15635.0
,,28,,,Unknown,,cid:3)(cid:5)(cid:14)(cid:70)(cid:12)(cid:11)(cid:4)(cid:14)(cid:11)(cid:48)(cid:48)(cid:7)(cid:5)(cid:3)(cid:9)(cid:2)(cid:12)(cid:11)(cid:4)(cid:14)(cid:11)(cid:48)(cid:48)(cid:7)(cid:5)(cid:3)(cid:9)(cid:2)(cid:28)(cid:3,,15663.0
,,2,,,Unknown,,cid:3)(cid:5)(cid:14)(cid:70)(cid:12)(cid:11)(cid:4)(cid:14)(cid:11)(cid:48)(cid:48)(cid:7)(cid:5)(cid:3)(cid:9)(cid:2)(cid:12)(cid:11)(cid:4)(cid:14)(cid:11)(cid:48)(cid:48)(cid:7)(cid:5)(cid:3)(cid:9)(cid:2)(cid:28)(cid:3,,15665.0
,,46,,,Unknown,,cid:3)(cid:5)(cid:14)(cid:70)(cid:12)(cid:11)(cid:4)(cid:14)(cid:11)(cid:48)(cid:48)(cid:7)(cid:5)(cid:3)(cid:9)(cid:2)(cid:12)(cid:11)(cid:4)(cid:14)(cid:11)(cid:48)(cid:48)(cid:7)(cid:5)(cid:3)(cid:9)(cid:2)(cid:28)(cid:3,,15711.0
,,4,,,Unknown,,cid:3)(cid:5)(cid:14)(cid:70)(cid:12)(cid:11)(cid:4)(cid:14)(cid:11)(cid:48)(cid:48)(cid:7)(cid:5)(cid:3)(cid:9)(cid:2)(cid:12)(cid:11)(cid:4)(cid:14)(cid:11)(cid:48)(cid:48)(cid:7)(cid:5)(cid:3)(cid:9)(cid:2)(cid:28)(cid:3,,15715.0
,,10,,,Unknown,,cid:3)(cid:5)(cid:14)(cid:70)(cid:12)(cid:11)(cid:4)(cid:14)(cid:11)(cid:48)(cid:48)(cid:7)(cid:5)(cid:3)(cid:9)(cid:2)(cid:12)(cid:11)(cid:4)(cid:14)(cid:11)(cid:48)(cid:48)(cid:7)(cid:5)(cid:3)(cid:9)(cid:2)(cid:28)(cid:3,,15725.0
,,11,,,Unknown,,cid:3)(cid:5)(cid:14)(cid:70)(cid:12)(cid:11)(cid:4)(cid:14)(cid:11)(cid:48)(cid:48)(cid:7)(cid:5)(cid:3)(cid:9)(cid:2)(cid:12)(cid:11)(cid:4)(cid:14)(cid:11)(cid:48)(cid:48)(cid:7)(cid:5)(cid:3)(cid:9)(cid:2)(cid:28)(cid:3,,15736.0
,,3,,,Unknown,,cid:3)(cid:5)(cid:14)(cid:70)(cid:12)(cid:11)(cid:4)(cid:14)(cid:11)(cid:48)(cid:48)(cid:7)(cid:5)(cid:3)(cid:9)(cid:2)(cid:12)(cid:11)(cid:4)(cid:14)(cid:11)(cid:48)(cid:48)(cid:7)(cid:5)(cid:3)(cid:9)(cid:2)(cid:28)(cid:3,,15739.0
,,11,,,Unknown,,cid:3)(cid:5)(cid:14)(cid:70)(cid:12)(cid:11)(cid:4)(cid:14)(cid:11)(cid:48)(cid:48)(cid:7)(cid:5)(cid:3)(cid:9)(cid:2)(cid:12)(cid:11)(cid:4)(cid:14)(cid:11)(cid:48)(cid:48)(cid:7)(cid:5)(cid:3)(cid:9)(cid:2)(cid:28)(cid:3,,15750.0
,,4,,,Unknown,,cid:3)(cid:5)(cid:14)(cid:70)(cid:12)(cid:11)(cid:4)(cid:14)(cid:11)(cid:48)(cid:48)(cid:7)(cid:5)(cid:3)(cid:9)(cid:2)(cid:12)(cid:11)(cid:4)(cid:14)(cid:11)(cid:48)(cid:48)(cid:7)(cid:5)(cid:3)(cid:9)(cid:2)(cid:28)(cid:3,,15754.0
,,10,,,Unknown,,cid:3)(cid:5)(cid:14)(cid:70)(cid:12)(cid:11)(cid:4)(cid:14)(cid:11)(cid:48)(cid:48)(cid:7)(cid:5)(cid:3)(cid:9)(cid:2)(cid:12)(cid:11)(cid:4)(cid:14)(cid:11)(cid:48)(cid:48)(cid:7)(cid:5)(cid:3)(cid:9)(cid:2)(cid:28)(cid:3,,15764.0
,,5,,,Unknown,,cid:3)(cid:5)(cid:14)(cid:70)(cid:12)(cid:11)(cid:4)(cid:14)(cid:11)(cid:48)(cid:48)(cid:7)(cid:5)(cid:3)(cid:9)(cid:2)(cid:12)(cid:11)(cid:4)(cid:14)(cid:11)(cid:48)(cid:48)(cid:7)(cid:5)(cid:3)(cid:9)(cid:2)(cid:28)(cid:3,,15769.0
,,2,,,Unknown,,cid:3)(cid:5)(cid:14)(cid:70)(cid:12)(cid:11)(cid:4)(cid:14)(cid:11)(cid:48)(cid:48)(cid:7)(cid:5)(cid:3)(cid:9)(cid:2)(cid:12)(cid:11)(cid:4)(cid:14)(cid:11)(cid:48)(cid:48)(cid:7)(cid:5)(cid:3)(cid:9)(cid:2)(cid:28)(cid:3,,15771.0
,,9,,,Unknown,,cid:3)(cid:5)(cid:14)(cid:70)(cid:12)(cid:11)(cid:4)(cid:14)(cid:11)(cid:48)(cid:48)(cid:7)(cid:5)(cid:3)(cid:9)(cid:2)(cid:12)(cid:11)(cid:4)(cid:14)(cid:11)(cid:48)(cid:48)(cid:7)(cid:5)(cid:3)(cid:9)(cid:2)(cid:28)(cid:3,,15780.0
,,5,,,Unknown,,cid:3)(cid:5)(cid:14)(cid:70)(cid:12)(cid:11)(cid:4)(cid:14)(cid:11)(cid:48)(cid:48)(cid:7)(cid:5)(cid:3)(cid:9)(cid:2)(cid:12)(cid:11)(cid:4)(cid:14)(cid:11)(cid:48)(cid:48)(cid:7)(cid:5)(cid:3)(cid:9)(cid:2)(cid:28)(cid:3,,15785.0
,,8,,,Unknown,,cid:3)(cid:5)(cid:14)(cid:70)(cid:12)(cid:11)(cid:4)(cid:14)(cid:11)(cid:48)(cid:48)(cid:7)(cid:5)(cid:3)(cid:9)(cid:2)(cid:12)(cid:11)(cid:4)(cid:14)(cid:11)(cid:48)(cid:48)(cid:7)(cid:5)(cid:3)(cid:9)(cid:2)(cid:28)(cid:3,,15793.0
,,14,,,Unknown,,cid:3)(cid:5)(cid:14)(cid:70)(cid:12)(cid:11)(cid:4)(cid:14)(cid:11)(cid:48)(cid:48)(cid:7)(cid:5)(cid:3)(cid:9)(cid:2)(cid:12)(cid:11)(cid:4)(cid:14)(cid:11)(cid:48)(cid:48)(cid:7)(cid:5)(cid:3)(cid:9)(cid:2)(cid:28)(cid:3,,15807.0
,,7,,,Unknown,,cid:3)(cid:5)(cid:14)(cid:70)(cid:12)(cid:11)(cid:4)(cid:14)(cid:11)(cid:48)(cid:48)(cid:7)(cid:5)(cid:3)(cid:9)(cid:2)(cid:12)(cid:11)(cid:4)(cid:14)(cid:11)(cid:48)(cid:48)(cid:7)(cid:5)(cid:3)(cid:9)(cid:2)(cid:28)(cid:3,,15814.0
,,9,,,Unknown,,cid:3)(cid:5)(cid:14)(cid:70)(cid:12)(cid:11)(cid:4)(cid:14)(cid:11)(cid:48)(cid:48)(cid:7)(cid:5)(cid:3)(cid:9)(cid:2)(cid:12)(cid:11)(cid:4)(cid:14)(cid:11)(cid:48)(cid:48)(cid:7)(cid:5)(cid:3)(cid:9)(cid:2)(cid:28)(cid:3,,15823.0
,,2,,,Unknown,,cid:3)(cid:5)(cid:14)(cid:70)(cid:12)(cid:11)(cid:4)(cid:14)(cid:11)(cid:48)(cid:48)(cid:7)(cid:5)(cid:3)(cid:9)(cid:2)(cid:12)(cid:11)(cid:4)(cid:14)(cid:11)(cid:48)(cid:48)(cid:7)(cid:5)(cid:3)(cid:9)(cid:2)(cid:28)(cid:3,,15825.0
,,12,,,Unknown,,cid:3)(cid:5)(cid:14)(cid:70)(cid:12)(cid:11)(cid:4)(cid:14)(cid:11)(cid:48)(cid:48)(cid:7)(cid:5)(cid:3)(cid:9)(cid:2)(cid:12)(cid:11)(cid:4)(cid:14)(cid:11)(cid:48)(cid:48)(cid:7)(cid:5)(cid:3)(cid:9)(cid:2)(cid:28)(cid:3,,15837.0
,,5,,,Unknown,,cid:3)(cid:5)(cid:14)(cid:70)(cid:12)(cid:11)(cid:4)(cid:14)(cid:11)(cid:48)(cid:48)(cid:7)(cid:5)(cid:3)(cid:9)(cid:2)(cid:12)(cid:11)(cid:4)(cid:14)(cid:11)(cid:48)(cid:48)(cid:7)(cid:5)(cid:3)(cid:9)(cid:2)(cid:28)(cid:3,,15842.0
,,50,,,Unknown,,cid:3)(cid:5)(cid:14)(cid:70)(cid:12)(cid:11)(cid:4)(cid:14)(cid:11)(cid:48)(cid:48)(cid:7)(cid:5)(cid:3)(cid:9)(cid:2)(cid:12)(cid:11)(cid:4)(cid:14)(cid:11)(cid:48)(cid:48)(cid:7)(cid:5)(cid:3)(cid:9)(cid:2)(cid:28)(cid:3,,15892.0
,,5,,,Unknown,,cid:3)(cid:5)(cid:14)(cid:70)(cid:12)(cid:11)(cid:4)(cid:14)(cid:11)(cid:48)(cid:48)(cid:7)(cid:5)(cid:3)(cid:9)(cid:2)(cid:12)(cid:11)(cid:4)(cid:14)(cid:11)(cid:48)(cid:48)(cid:7)(cid:5)(cid:3)(cid:9)(cid:2)(cid:28)(cid:3,,15897.0
,,40,,,Unknown,,cid:3)(cid:5)(cid:14)(cid:70)(cid:12)(cid:11)(cid:4)(cid:14)(cid:11)(cid:48)(cid:48)(cid:7)(cid:5)(cid:3)(cid:9)(cid:2)(cid:12)(cid:11)(cid:4)(cid:14)(cid:11)(cid:48)(cid:48)(cid:7)(cid:5)(cid:3)(cid:9)(cid:2)(cid:28)(cid:3,,15937.0
,,2,,,Unknown,,cid:3)(cid:5)(cid:14)(cid:70)(cid:12)(cid:11)(cid:4)(cid:14)(cid:11)(cid:48)(cid:48)(cid:7)(cid:5)(cid:3)(cid:9)(cid:2)(cid:12)(cid:11)(cid:4)(cid:14)(cid:11)(cid:48)(cid:48)(cid:7)(cid:5)(cid:3)(cid:9)(cid:2)(cid:28)(cid:3,,15939.0
,,28,,,Unknown,,cid:3)(cid:5)(cid:14)(cid:70)(cid:12)(cid:11)(cid:4)(cid:14)(cid:11)(cid:48)(cid:48)(cid:7)(cid:5)(cid:3)(cid:9)(cid:2)(cid:12)(cid:11)(cid:4)(cid:14)(cid:11)(cid:48)(cid:48)(cid:7)(cid:5)(cid:3)(cid:9)(cid:2)(cid:28)(cid:3,,15967.0
,,3,,,Unknown,,cid:3)(cid:5)(cid:14)(cid:70)(cid:12)(cid:11)(cid:4)(cid:14)(cid:11)(cid:48)(cid:48)(cid:7)(cid:5)(cid:3)(cid:9)(cid:2)(cid:12)(cid:11)(cid:4)(cid:14)(cid:11)(cid:48)(cid:48)(cid:7)(cid:5)(cid:3)(cid:9)(cid:2)(cid:28)(cid:3,,15970.0
,,15,,,Unknown,,cid:3)(cid:5)(cid:14)(cid:70)(cid:12)(cid:11)(cid:4)(cid:14)(cid:11)(cid:48)(cid:48)(cid:7)(cid:5)(cid:3)(cid:9)(cid:2)(cid:12)(cid:11)(cid:4)(cid:14)(cid:11)(cid:48)(cid:48)(cid:7)(cid:5)(cid:3)(cid:9)(cid:2)(cid:28)(cid:3,,15985.0
,,2,,,Unknown,,cid:3)(cid:5)(cid:14)(cid:70)(cid:12)(cid:11)(cid:4)(cid:14)(cid:11)(cid:48)(cid:48)(cid:7)(cid:5)(cid:3)(cid:9)(cid:2)(cid:12)(cid:11)(cid:4)(cid:14)(cid:11)(cid:48)(cid:48)(cid:7)(cid:5)(cid:3)(cid:9)(cid:2)(cid:28)(cid:3,,15987.0
,,1,,,Unknown,,cid:3)(cid:5)(cid:14)(cid:70)(cid:12)(cid:11)(cid:4)(cid:14)(cid:11)(cid:48)(cid:48)(cid:7)(cid:5)(cid:3)(cid:9)(cid:2)(cid:12)(cid:11)(cid:4)(cid:14)(cid:11)(cid:48)(cid:48)(cid:7)(cid:5)(cid:3)(cid:9)(cid:2)(cid:28)(cid:3,,15988.0
,,19,,,Unknown,,cid:3)(cid:5)(cid:14)(cid:70)(cid:12)(cid:11)(cid:4)(cid:14)(cid:11)(cid:48)(cid:48)(cid:7)(cid:5)(cid:3)(cid:9)(cid:2)(cid:12)(cid:11)(cid:4)(cid:14)(cid:11)(cid:48)(cid:48)(cid:7)(cid:5)(cid:3)(cid:9)(cid:2)(cid:28)(cid:3,,16007.0
,,37,,,Unknown,,cid:3)(cid:5)(cid:14)(cid:70)(cid:12)(cid:11)(cid:4)(cid:14)(cid:11)(cid:48)(cid:48)(cid:7)(cid:5)(cid:3)(cid:9)(cid:2)(cid:12)(cid:11)(cid:4)(cid:14)(cid:11)(cid:48)(cid:48)(cid:7)(cid:5)(cid:3)(cid:9)(cid:2)(cid:28)(cid:3,,16044.0
,,18,,,Unknown,,cid:3)(cid:5)(cid:14)(cid:70)(cid:12)(cid:11)(cid:4)(cid:14)(cid:11)(cid:48)(cid:48)(cid:7)(cid:5)(cid:3)(cid:9)(cid:2)(cid:12)(cid:11)(cid:4)(cid:14)(cid:11)(cid:48)(cid:48)(cid:7)(cid:5)(cid:3)(cid:9)(cid:2)(cid:28)(cid:3,,16062.0
,,2,,,Unknown,,cid:3)(cid:5)(cid:14)(cid:70)(cid:12)(cid:11)(cid:4)(cid:14)(cid:11)(cid:48)(cid:48)(cid:7)(cid:5)(cid:3)(cid:9)(cid:2)(cid:12)(cid:11)(cid:4)(cid:14)(cid:11)(cid:48)(cid:48)(cid:7)(cid:5)(cid:3)(cid:9)(cid:2)(cid:28)(cid:3,,16064.0
,,44,,,Unknown,,cid:3)(cid:5)(cid:14)(cid:70)(cid:12)(cid:11)(cid:4)(cid:14)(cid:11)(cid:48)(cid:48)(cid:7)(cid:5)(cid:3)(cid:9)(cid:2)(cid:12)(cid:11)(cid:4)(cid:14)(cid:11)(cid:48)(cid:48)(cid:7)(cid:5)(cid:3)(cid:9)(cid:2)(cid:28)(cid:3,,16108.0
,,12,,,Unknown,,cid:3)(cid:5)(cid:14)(cid:70)(cid:12)(cid:11)(cid:4)(cid:14)(cid:11)(cid:48)(cid:48)(cid:7)(cid:5)(cid:3)(cid:9)(cid:2)(cid:12)(cid:11)(cid:4)(cid:14)(cid:11)(cid:48)(cid:48)(cid:7)(cid:5)(cid:3)(cid:9)(cid:2)(cid:28)(cid:3,,16120.0
,,29,,,Unknown,,cid:3)(cid:5)(cid:14)(cid:70)(cid:12)(cid:11)(cid:4)(cid:14)(cid:11)(cid:48)(cid:48)(cid:7)(cid:5)(cid:3)(cid:9)(cid:2)(cid:12)(cid:11)(cid:4)(cid:14)(cid:11)(cid:48)(cid:48)(cid:7)(cid:5)(cid:3)(cid:9)(cid:2)(cid:28)(cid:3,,16149.0
,,26,,,Unknown,,cid:3)(cid:5)(cid:14)(cid:70)(cid:12)(cid:11)(cid:4)(cid:14)(cid:11)(cid:48)(cid:48)(cid:7)(cid:5)(cid:3)(cid:9)(cid:2)(cid:12)(cid:11)(cid:4)(cid:14)(cid:11)(cid:48)(cid:48)(cid:7)(cid:5)(cid:3)(cid:9)(cid:2)(cid:28)(cid:3,,16175.0
,,41,,,Unknown,,cid:3)(cid:5)(cid:14)(cid:70)(cid:12)(cid:11)(cid:4)(cid:14)(cid:11)(cid:48)(cid:48)(cid:7)(cid:5)(cid:3)(cid:9)(cid:2)(cid:12)(cid:11)(cid:4)(cid:14)(cid:11)(cid:48)(cid:48)(cid:7)(cid:5)(cid:3)(cid:9)(cid:2)(cid:28)(cid:3,,16216.0
,,25,,,Unknown,,cid:3)(cid:5)(cid:14)(cid:70)(cid:12)(cid:11)(cid:4)(cid:14)(cid:11)(cid:48)(cid:48)(cid:7)(cid:5)(cid:3)(cid:9)(cid:2)(cid:12)(cid:11)(cid:4)(cid:14)(cid:11)(cid:48)(cid:48)(cid:7)(cid:5)(cid:3)(cid:9)(cid:2)(cid:28)(cid:3,,16241.0
,,2,,,Unknown,,cid:3)(cid:5)(cid:14)(cid:70)(cid:12)(cid:11)(cid:4)(cid:14)(cid:11)(cid:48)(cid:48)(cid:7)(cid:5)(cid:3)(cid:9)(cid:2)(cid:12)(cid:11)(cid:4)(cid:14)(cid:11)(cid:48)(cid:48)(cid:7)(cid:5)(cid:3)(cid:9)(cid:2)(cid:28)(cid:3,,16243.0
,,58,,,Unknown,,cid:3)(cid:5)(cid:14)(cid:70)(cid:12)(cid:11)(cid:4)(cid:14)(cid:11)(cid:48)(cid:48)(cid:7)(cid:5)(cid:3)(cid:9)(cid:2)(cid:12)(cid:11)(cid:4)(cid:14)(cid:11)(cid:48)(cid:48)(cid:7)(cid:5)(cid:3)(cid:9)(cid:2)(cid:28)(cid:3,,16301.0
,,58,,,Unknown,,cid:3)(cid:5)(cid:14)(cid:70)(cid:12)(cid:11)(cid:4)(cid:14)(cid:11)(cid:48)(cid:48)(cid:7)(cid:5)(cid:3)(cid:9)(cid:2)(cid:12)(cid:11)(cid:4)(cid:14)(cid:11)(cid:48)(cid:48)(cid:7)(cid:5)(cid:3)(cid:9)(cid:2)(cid:28)(cid:3,,16359.0
,,18,,,Unknown,,cid:3)(cid:5)(cid:14)(cid:70)(cid:12)(cid:11)(cid:4)(cid:14)(cid:11)(cid:48)(cid:48)(cid:7)(cid:5)(cid:3)(cid:9)(cid:2)(cid:12)(cid:11)(cid:4)(cid:14)(cid:11)(cid:48)(cid:48)(cid:7)(cid:5)(cid:3)(cid:9)(cid:2)(cid:28)(cid:3,,16377.0
,,1,,,Unknown,,cid:3)(cid:5)(cid:14)(cid:70)(cid:12)(cid:11)(cid:4)(cid:14)(cid:11)(cid:48)(cid:48)(cid:7)(cid:5)(cid:3)(cid:9)(cid:2)(cid:12)(cid:11)(cid:4)(cid:14)(cid:11)(cid:48)(cid:48)(cid:7)(cid:5)(cid:3)(cid:9)(cid:2)(cid:28)(cid:3,,16378.0
,,1,,,Unknown,,cid:3)(cid:5)(cid:14)(cid:70)(cid:12)(cid:11)(cid:4)(cid:14)(cid:11)(cid:48)(cid:48)(cid:7)(cid:5)(cid:3)(cid:9)(cid:2)(cid:12)(cid:11)(cid:4)(cid:14)(cid:11)(cid:48)(cid:48)(cid:7)(cid:5)(cid:3)(cid:9)(cid:2)(cid:28)(cid:3,,16379.0
,,37,,,Unknown,,cid:3)(cid:5)(cid:14)(cid:70)(cid:12)(cid:11)(cid:4)(cid:14)(cid:11)(cid:48)(cid:48)(cid:7)(cid:5)(cid:3)(cid:9)(cid:2)(cid:12)(cid:11)(cid:4)(cid:14)(cid:11)(cid:48)(cid:48)(cid:7)(cid:5)(cid:3)(cid:9)(cid:2)(cid:28)(cid:3,,16416.0
,,17,,,Unknown,,cid:3)(cid:5)(cid:14)(cid:70)(cid:12)(cid:11)(cid:4)(cid:14)(cid:11)(cid:48)(cid:48)(cid:7)(cid:5)(cid:3)(cid:9)(cid:2)(cid:12)(cid:11)(cid:4)(cid:14)(cid:11)(cid:48)(cid:48)(cid:7)(cid:5)(cid:3)(cid:9)(cid:2)(cid:28)(cid:3,,16433.0
,,16,,,Unknown,,cid:3)(cid:5)(cid:14)(cid:70)(cid:12)(cid:11)(cid:4)(cid:14)(cid:11)(cid:48)(cid:48)(cid:7)(cid:5)(cid:3)(cid:9)(cid:2)(cid:12)(cid:11)(cid:4)(cid:14)(cid:11)(cid:48)(cid:48)(cid:7)(cid:5)(cid:3)(cid:9)(cid:2)(cid:28)(cid:3,,16449.0
,,45,,,Unknown,,cid:3)(cid:5)(cid:14)(cid:70)(cid:12)(cid:11)(cid:4)(cid:14)(cid:11)(cid:48)(cid:48)(cid:7)(cid:5)(cid:3)(cid:9)(cid:2)(cid:12)(cid:11)(cid:4)(cid:14)(cid:11)(cid:48)(cid:48)(cid:7)(cid:5)(cid:3)(cid:9)(cid:2)(cid:28)(cid:3,,16494.0
,,18,,,Unknown,,cid:3)(cid:5)(cid:14)(cid:70)(cid:12)(cid:11)(cid:4)(cid:14)(cid:11)(cid:48)(cid:48)(cid:7)(cid:5)(cid:3)(cid:9)(cid:2)(cid:12)(cid:11)(cid:4)(cid:14)(cid:11)(cid:48)(cid:48)(cid:7)(cid:5)(cid:3)(cid:9)(cid:2)(cid:28)(cid:3,,16512.0
,,16,,,Unknown,,cid:3)(cid:5)(cid:14)(cid:70)(cid:12)(cid:11)(cid:4)(cid:14)(cid:11)(cid:48)(cid:48)(cid:7)(cid:5)(cid:3)(cid:9)(cid:2)(cid:12)(cid:11)(cid:4)(cid:14)(cid:11)(cid:48)(cid:48)(cid:7)(cid:5)(cid:3)(cid:9)(cid:2)(cid:28)(cid:3,,16528.0
,,39,,,Unknown,,cid:3)(cid:5)(cid:14)(cid:70)(cid:12)(cid:11)(cid:4)(cid:14)(cid:11)(cid:48)(cid:48)(cid:7)(cid:5)(cid:3)(cid:9)(cid:2)(cid:12)(cid:11)(cid:4)(cid:14)(cid:11)(cid:48)(cid:48)(cid:7)(cid:5)(cid:3)(cid:9)(cid:2)(cid:28)(cid:3,,16567.0
,,3,,,Unknown,,cid:3)(cid:5)(cid:14)(cid:70)(cid:12)(cid:11)(cid:4)(cid:14)(cid:11)(cid:48)(cid:48)(cid:7)(cid:5)(cid:3)(cid:9)(cid:2)(cid:12)(cid:11)(cid:4)(cid:14)(cid:11)(cid:48)(cid:48)(cid:7)(cid:5)(cid:3)(cid:9)(cid:2)(cid:28)(cid:3,,16570.0
,,7,,,Unknown,,cid:3)(cid:5)(cid:14)(cid:70)(cid:12)(cid:11)(cid:4)(cid:14)(cid:11)(cid:48)(cid:48)(cid:7)(cid:5)(cid:3)(cid:9)(cid:2)(cid:12)(cid:11)(cid:4)(cid:14)(cid:11)(cid:48)(cid:48)(cid:7)(cid:5)(cid:3)(cid:9)(cid:2)(cid:28)(cid:3,,16577.0
,,48,,,Unknown,,cid:3)(cid:5)(cid:14)(cid:70)(cid:12)(cid:11)(cid:4)(cid:14)(cid:11)(cid:48)(cid:48)(cid:7)(cid:5)(cid:3)(cid:9)(cid:2)(cid:12)(cid:11)(cid:4)(cid:14)(cid:11)(cid:48)(cid:48)(cid:7)(cid:5)(cid:3)(cid:9)(cid:2)(cid:28)(cid:3,,16625.0
,,46,,,Unknown,,cid:3)(cid:5)(cid:14)(cid:70)(cid:12)(cid:11)(cid:4)(cid:14)(cid:11)(cid:48)(cid:48)(cid:7)(cid:5)(cid:3)(cid:9)(cid:2)(cid:12)(cid:11)(cid:4)(cid:14)(cid:11)(cid:48)(cid:48)(cid:7)(cid:5)(cid:3)(cid:9)(cid:2)(cid:28)(cid:3,,16671.0
,,3,,,Unknown,,cid:3)(cid:5)(cid:14)(cid:70)(cid:12)(cid:11)(cid:4)(cid:14)(cid:11)(cid:48)(cid:48)(cid:7)(cid:5)(cid:3)(cid:9)(cid:2)(cid:12)(cid:11)(cid:4)(cid:14)(cid:11)(cid:48)(cid:48)(cid:7)(cid:5)(cid:3)(cid:9)(cid:2)(cid:28)(cid:3,,16674.0
,,65,,,Unknown,,cid:3)(cid:5)(cid:14)(cid:70)(cid:12)(cid:11)(cid:4)(cid:14)(cid:11)(cid:48)(cid:48)(cid:7)(cid:5)(cid:3)(cid:9)(cid:2)(cid:12)(cid:11)(cid:4)(cid:14)(cid:11)(cid:48)(cid:48)(cid:7)(cid:5)(cid:3)(cid:9)(cid:2)(cid:28)(cid:3,,16739.0
,,2,,,Unknown,,cid:3)(cid:5)(cid:14)(cid:70)(cid:12)(cid:11)(cid:4)(cid:14)(cid:11)(cid:48)(cid:48)(cid:7)(cid:5)(cid:3)(cid:9)(cid:2)(cid:12)(cid:11)(cid:4)(cid:14)(cid:11)(cid:48)(cid:48)(cid:7)(cid:5)(cid:3)(cid:9)(cid:2)(cid:28)(cid:3,,16741.0
,,9,,,Unknown,,cid:3)(cid:5)(cid:14)(cid:70)(cid:12)(cid:11)(cid:4)(cid:14)(cid:11)(cid:48)(cid:48)(cid:7)(cid:5)(cid:3)(cid:9)(cid:2)(cid:12)(cid:11)(cid:4)(cid:14)(cid:11)(cid:48)(cid:48)(cid:7)(cid:5)(cid:3)(cid:9)(cid:2)(cid:28)(cid:3,,16750.0
,,5,,,Unknown,,cid:3)(cid:5)(cid:14)(cid:70)(cid:12)(cid:11)(cid:4)(cid:14)(cid:11)(cid:48)(cid:48)(cid:7)(cid:5)(cid:3)(cid:9)(cid:2)(cid:12)(cid:11)(cid:4)(cid:14)(cid:11)(cid:48)(cid:48)(cid:7)(cid:5)(cid:3)(cid:9)(cid:2)(cid:28)(cid:3,,16755.0
,,3,,,Unknown,,cid:3)(cid:5)(cid:14)(cid:70)(cid:12)(cid:11)(cid:4)(cid:14)(cid:11)(cid:48)(cid:48)(cid:7)(cid:5)(cid:3)(cid:9)(cid:2)(cid:12)(cid:11)(cid:4)(cid:14)(cid:11)(cid:48)(cid:48)(cid:7)(cid:5)(cid:3)(cid:9)(cid:2)(cid:28)(cid:3,,16758.0
,,3,,,Unknown,,cid:3)(cid:5)(cid:14)(cid:70)(cid:12)(cid:11)(cid:4)(cid:14)(cid:11)(cid:48)(cid:48)(cid:7)(cid:5)(cid:3)(cid:9)(cid:2)(cid:12)(cid:11)(cid:4)(cid:14)(cid:11)(cid:48)(cid:48)(cid:7)(cid:5)(cid:3)(cid:9)(cid:2)(cid:28)(cid:3,,16761.0
,,7,,,Unknown,,cid:3)(cid:5)(cid:14)(cid:70)(cid:12)(cid:11)(cid:4)(cid:14)(cid:11)(cid:48)(cid:48)(cid:7)(cid:5)(cid:3)(cid:9)(cid:2)(cid:12)(cid:11)(cid:4)(cid:14)(cid:11)(cid:48)(cid:48)(cid:7)(cid:5)(cid:3)(cid:9)(cid:2)(cid:28)(cid:3,,16768.0
,,9,,,Unknown,,cid:3)(cid:5)(cid:14)(cid:70)(cid:12)(cid:11)(cid:4)(cid:14)(cid:11)(cid:48)(cid:48)(cid:7)(cid:5)(cid:3)(cid:9)(cid:2)(cid:12)(cid:11)(cid:4)(cid:14)(cid:11)(cid:48)(cid:48)(cid:7)(cid:5)(cid:3)(cid:9)(cid:2)(cid:28)(cid:3,,16777.0
,,2,,,Unknown,,cid:3)(cid:5)(cid:14)(cid:70)(cid:12)(cid:11)(cid:4)(cid:14)(cid:11)(cid:48)(cid:48)(cid:7)(cid:5)(cid:3)(cid:9)(cid:2)(cid:12)(cid:11)(cid:4)(cid:14)(cid:11)(cid:48)(cid:48)(cid:7)(cid:5)(cid:3)(cid:9)(cid:2)(cid:28)(cid:3,,16779.0
,,9,,,Unknown,,cid:3)(cid:5)(cid:14)(cid:70)(cid:12)(cid:11)(cid:4)(cid:14)(cid:11)(cid:48)(cid:48)(cid:7)(cid:5)(cid:3)(cid:9)(cid:2)(cid:12)(cid:11)(cid:4)(cid:14)(cid:11)(cid:48)(cid:48)(cid:7)(cid:5)(cid:3)(cid:9)(cid:2)(cid:28)(cid:3,,16788.0
,,5,,,Unknown,,cid:3)(cid:5)(cid:14)(cid:70)(cid:12)(cid:11)(cid:4)(cid:14)(cid:11)(cid:48)(cid:48)(cid:7)(cid:5)(cid:3)(cid:9)(cid:2)(cid:12)(cid:11)(cid:4)(cid:14)(cid:11)(cid:48)(cid:48)(cid:7)(cid:5)(cid:3)(cid:9)(cid:2)(cid:28)(cid:3,,16793.0
,,3,,,Unknown,,cid:3)(cid:5)(cid:14)(cid:70)(cid:12)(cid:11)(cid:4)(cid:14)(cid:11)(cid:48)(cid:48)(cid:7)(cid:5)(cid:3)(cid:9)(cid:2)(cid:12)(cid:11)(cid:4)(cid:14)(cid:11)(cid:48)(cid:48)(cid:7)(cid:5)(cid:3)(cid:9)(cid:2)(cid:28)(cid:3,,16796.0
,,3,,,Unknown,,cid:3)(cid:5)(cid:14)(cid:70)(cid:12)(cid:11)(cid:4)(cid:14)(cid:11)(cid:48)(cid:48)(cid:7)(cid:5)(cid:3)(cid:9)(cid:2)(cid:12)(cid:11)(cid:4)(cid:14)(cid:11)(cid:48)(cid:48)(cid:7)(cid:5)(cid:3)(cid:9)(cid:2)(cid:28)(cid:3,,16799.0
,,7,,,Unknown,,cid:3)(cid:5)(cid:14)(cid:70)(cid:12)(cid:11)(cid:4)(cid:14)(cid:11)(cid:48)(cid:48)(cid:7)(cid:5)(cid:3)(cid:9)(cid:2)(cid:12)(cid:11)(cid:4)(cid:14)(cid:11)(cid:48)(cid:48)(cid:7)(cid:5)(cid:3)(cid:9)(cid:2)(cid:28)(cid:3,,16806.0
,,9,,,Unknown,,cid:3)(cid:5)(cid:14)(cid:70)(cid:12)(cid:11)(cid:4)(cid:14)(cid:11)(cid:48)(cid:48)(cid:7)(cid:5)(cid:3)(cid:9)(cid:2)(cid:12)(cid:11)(cid:4)(cid:14)(cid:11)(cid:48)(cid:48)(cid:7)(cid:5)(cid:3)(cid:9)(cid:2)(cid:28)(cid:3,,16815.0
,,2,,,Unknown,,cid:3)(cid:5)(cid:14)(cid:70)(cid:12)(cid:11)(cid:4)(cid:14)(cid:11)(cid:48)(cid:48)(cid:7)(cid:5)(cid:3)(cid:9)(cid:2)(cid:12)(cid:11)(cid:4)(cid:14)(cid:11)(cid:48)(cid:48)(cid:7)(cid:5)(cid:3)(cid:9)(cid:2)(cid:28)(cid:3,,16817.0
,,28,,,Unknown,,cid:3)(cid:5)(cid:14)(cid:70)(cid:12)(cid:11)(cid:4)(cid:14)(cid:11)(cid:48)(cid:48)(cid:7)(cid:5)(cid:3)(cid:9)(cid:2)(cid:12)(cid:11)(cid:4)(cid:14)(cid:11)(cid:48)(cid:48)(cid:7)(cid:5)(cid:3)(cid:9)(cid:2)(cid:28)(cid:3,,16845.0
,,3,,,Unknown,,cid:3)(cid:5)(cid:14)(cid:70)(cid:12)(cid:11)(cid:4)(cid:14)(cid:11)(cid:48)(cid:48)(cid:7)(cid:5)(cid:3)(cid:9)(cid:2)(cid:12)(cid:11)(cid:4)(cid:14)(cid:11)(cid:48)(cid:48)(cid:7)(cid:5)(cid:3)(cid:9)(cid:2)(cid:28)(cid:3,,16848.0
,,15,,,Unknown,,cid:3)(cid:5)(cid:14)(cid:70)(cid:12)(cid:11)(cid:4)(cid:14)(cid:11)(cid:48)(cid:48)(cid:7)(cid:5)(cid:3)(cid:9)(cid:2)(cid:12)(cid:11)(cid:4)(cid:14)(cid:11)(cid:48)(cid:48)(cid:7)(cid:5)(cid:3)(cid:9)(cid:2)(cid:28)(cid:3,,16863.0
,,2,,,Unknown,,cid:3)(cid:5)(cid:14)(cid:70)(cid:12)(cid:11)(cid:4)(cid:14)(cid:11)(cid:48)(cid:48)(cid:7)(cid:5)(cid:3)(cid:9)(cid:2)(cid:12)(cid:11)(cid:4)(cid:14)(cid:11)(cid:48)(cid:48)(cid:7)(cid:5)(cid:3)(cid:9)(cid:2)(cid:28)(cid:3,,16865.0
,,17,,,Unknown,,cid:3)(cid:5)(cid:14)(cid:70)(cid:12)(cid:11)(cid:4)(cid:14)(cid:11)(cid:48)(cid:48)(cid:7)(cid:5)(cid:3)(cid:9)(cid:2)(cid:12)(cid:11)(cid:4)(cid:14)(cid:11)(cid:48)(cid:48)(cid:7)(cid:5)(cid:3)(cid:9)(cid:2)(cid:28)(cid:3,,16882.0
,,17,,,Unknown,,cid:3)(cid:5)(cid:14)(cid:70)(cid:12)(cid:11)(cid:4)(cid:14)(cid:11)(cid:48)(cid:48)(cid:7)(cid:5)(cid:3)(cid:9)(cid:2)(cid:12)(cid:11)(cid:4)(cid:14)(cid:11)(cid:48)(cid:48)(cid:7)(cid:5)(cid:3)(cid:9)(cid:2)(cid:28)(cid:3,,16899.0
,,35,,,Unknown,,cid:3)(cid:5)(cid:14)(cid:70)(cid:12)(cid:11)(cid:4)(cid:14)(cid:11)(cid:48)(cid:48)(cid:7)(cid:5)(cid:3)(cid:9)(cid:2)(cid:12)(cid:11)(cid:4)(cid:14)(cid:11)(cid:48)(cid:48)(cid:7)(cid:5)(cid:3)(cid:9)(cid:2)(cid:28)(cid:3,,16934.0
,,19,,,Unknown,,cid:3)(cid:5)(cid:14)(cid:70)(cid:12)(cid:11)(cid:4)(cid:14)(cid:11)(cid:48)(cid:48)(cid:7)(cid:5)(cid:3)(cid:9)(cid:2)(cid:12)(cid:11)(cid:4)(cid:14)(cid:11)(cid:48)(cid:48)(cid:7)(cid:5)(cid:3)(cid:9)(cid:2)(cid:28)(cid:3,,16953.0
,,34,,,Unknown,,cid:3)(cid:5)(cid:14)(cid:70)(cid:12)(cid:11)(cid:4)(cid:14)(cid:11)(cid:48)(cid:48)(cid:7)(cid:5)(cid:3)(cid:9)(cid:2)(cid:12)(cid:11)(cid:4)(cid:14)(cid:11)(cid:48)(cid:48)(cid:7)(cid:5)(cid:3)(cid:9)(cid:2)(cid:28)(cid:3,,16987.0
,,18,,,Unknown,,cid:3)(cid:5)(cid:14)(cid:70)(cid:12)(cid:11)(cid:4)(cid:14)(cid:11)(cid:48)(cid:48)(cid:7)(cid:5)(cid:3)(cid:9)(cid:2)(cid:12)(cid:11)(cid:4)(cid:14)(cid:11)(cid:48)(cid:48)(cid:7)(cid:5)(cid:3)(cid:9)(cid:2)(cid:28)(cid:3,,17005.0
,,2,,,Unknown,,cid:3)(cid:5)(cid:14)(cid:70)(cid:12)(cid:11)(cid:4)(cid:14)(cid:11)(cid:48)(cid:48)(cid:7)(cid:5)(cid:3)(cid:9)(cid:2)(cid:12)(cid:11)(cid:4)(cid:14)(cid:11)(cid:48)(cid:48)(cid:7)(cid:5)(cid:3)(cid:9)(cid:2)(cid:28)(cid:3,,17007.0
,,44,,,Unknown,,cid:3)(cid:5)(cid:14)(cid:70)(cid:12)(cid:11)(cid:4)(cid:14)(cid:11)(cid:48)(cid:48)(cid:7)(cid:5)(cid:3)(cid:9)(cid:2)(cid:12)(cid:11)(cid:4)(cid:14)(cid:11)(cid:48)(cid:48)(cid:7)(cid:5)(cid:3)(cid:9)(cid:2)(cid:28)(cid:3,,17051.0
,,12,,,Unknown,,cid:3)(cid:5)(cid:14)(cid:70)(cid:12)(cid:11)(cid:4)(cid:14)(cid:11)(cid:48)(cid:48)(cid:7)(cid:5)(cid:3)(cid:9)(cid:2)(cid:12)(cid:11)(cid:4)(cid:14)(cid:11)(cid:48)(cid:48)(cid:7)(cid:5)(cid:3)(cid:9)(cid:2)(cid:28)(cid:3,,17063.0
,,29,,,Unknown,,cid:3)(cid:5)(cid:14)(cid:70)(cid:12)(cid:11)(cid:4)(cid:14)(cid:11)(cid:48)(cid:48)(cid:7)(cid:5)(cid:3)(cid:9)(cid:2)(cid:12)(cid:11)(cid:4)(cid:14)(cid:11)(cid:48)(cid:48)(cid:7)(cid:5)(cid:3)(cid:9)(cid:2)(cid:28)(cid:3,,17092.0
,,26,,,Unknown,,cid:3)(cid:5)(cid:14)(cid:70)(cid:12)(cid:11)(cid:4)(cid:14)(cid:11)(cid:48)(cid:48)(cid:7)(cid:5)(cid:3)(cid:9)(cid:2)(cid:12)(cid:11)(cid:4)(cid:14)(cid:11)(cid:48)(cid:48)(cid:7)(cid:5)(cid:3)(cid:9)(cid:2)(cid:28)(cid:3,,17118.0
,,41,,,Unknown,,cid:3)(cid:5)(cid:14)(cid:70)(cid:12)(cid:11)(cid:4)(cid:14)(cid:11)(cid:48)(cid:48)(cid:7)(cid:5)(cid:3)(cid:9)(cid:2)(cid:12)(cid:11)(cid:4)(cid:14)(cid:11)(cid:48)(cid:48)(cid:7)(cid:5)(cid:3)(cid:9)(cid:2)(cid:28)(cid:3,,17159.0
,,25,,,Unknown,,cid:3)(cid:5)(cid:14)(cid:70)(cid:12)(cid:11)(cid:4)(cid:14)(cid:11)(cid:48)(cid:48)(cid:7)(cid:5)(cid:3)(cid:9)(cid:2)(cid:12)(cid:11)(cid:4)(cid:14)(cid:11)(cid:48)(cid:48)(cid:7)(cid:5)(cid:3)(cid:9)(cid:2)(cid:28)(cid:3,,17184.0
,,2,,,Unknown,,cid:3)(cid:5)(cid:14)(cid:70)(cid:12)(cid:11)(cid:4)(cid:14)(cid:11)(cid:48)(cid:48)(cid:7)(cid:5)(cid:3)(cid:9)(cid:2)(cid:12)(cid:11)(cid:4)(cid:14)(cid:11)(cid:48)(cid:48)(cid:7)(cid:5)(cid:3)(cid:9)(cid:2)(cid:28)(cid:3,,17186.0
,,58,,,Unknown,,cid:3)(cid:5)(cid:14)(cid:70)(cid:12)(cid:11)(cid:4)(cid:14)(cid:11)(cid:48)(cid:48)(cid:7)(cid:5)(cid:3)(cid:9)(cid:2)(cid:12)(cid:11)(cid:4)(cid:14)(cid:11)(cid:48)(cid:48)(cid:7)(cid:5)(cid:3)(cid:9)(cid:2)(cid:28)(cid:3,,17244.0
,,58,,,Unknown,,cid:3)(cid:5)(cid:14)(cid:70)(cid:12)(cid:11)(cid:4)(cid:14)(cid:11)(cid:48)(cid:48)(cid:7)(cid:5)(cid:3)(cid:9)(cid:2)(cid:12)(cid:11)(cid:4)(cid:14)(cid:11)(cid:48)(cid:48)(cid:7)(cid:5)(cid:3)(cid:9)(cid:2)(cid:28)(cid:3,,17302.0
,,37,,,Unknown,,cid:3)(cid:5)(cid:14)(cid:70)(cid:12)(cid:11)(cid:4)(cid:14)(cid:11)(cid:48)(cid:48)(cid:7)(cid:5)(cid:3)(cid:9)(cid:2)(cid:12)(cid:11)(cid:4)(cid:14)(cid:11)(cid:48)(cid:48)(cid:7)(cid:5)(cid:3)(cid:9)(cid:2)(cid:28)(cid:3,,17339.0
,,16,,,Unknown,,cid:3)(cid:5)(cid:14)(cid:70)(cid:12)(cid:11)(cid:4)(cid:14)(cid:11)(cid:48)(cid:48)(cid:7)(cid:5)(cid:3)(cid:9)(cid:2)(cid:12)(cid:11)(cid:4)(cid:14)(cid:11)(cid:48)(cid:48)(cid:7)(cid:5)(cid:3)(cid:9)(cid:2)(cid:28)(cid:3,,17355.0
,,34,,,Unknown,,cid:3)(cid:5)(cid:14)(cid:70)(cid:12)(cid:11)(cid:4)(cid:14)(cid:11)(cid:48)(cid:48)(cid:7)(cid:5)(cid:3)(cid:9)(cid:2)(cid:12)(cid:11)(cid:4)(cid:14)(cid:11)(cid:48)(cid:48)(cid:7)(cid:5)(cid:3)(cid:9)(cid:2)(cid:28)(cid:3,,17389.0
,,33,,,Unknown,,cid:3)(cid:5)(cid:14)(cid:70)(cid:12)(cid:11)(cid:4)(cid:14)(cid:11)(cid:48)(cid:48)(cid:7)(cid:5)(cid:3)(cid:9)(cid:2)(cid:12)(cid:11)(cid:4)(cid:14)(cid:11)(cid:48)(cid:48)(cid:7)(cid:5)(cid:3)(cid:9)(cid:2)(cid:28)(cid:3,,17422.0
,,17,,,Unknown,,cid:3)(cid:5)(cid:14)(cid:70)(cid:12)(cid:11)(cid:4)(cid:14)(cid:11)(cid:48)(cid:48)(cid:7)(cid:5)(cid:3)(cid:9)(cid:2)(cid:12)(cid:11)(cid:4)(cid:14)(cid:11)(cid:48)(cid:48)(cid:7)(cid:5)(cid:3)(cid:9)(cid:2)(cid:28)(cid:3,,17439.0
,,16,,,Unknown,,cid:3)(cid:5)(cid:14)(cid:70)(cid:12)(cid:11)(cid:4)(cid:14)(cid:11)(cid:48)(cid:48)(cid:7)(cid:5)(cid:3)(cid:9)(cid:2)(cid:12)(cid:11)(cid:4)(cid:14)(cid:11)(cid:48)(cid:48)(cid:7)(cid:5)(cid:3)(cid:9)(cid:2)(cid:28)(cid:3,,17455.0
,,45,,,Unknown,,cid:3)(cid:5)(cid:14)(cid:70)(cid:12)(cid:11)(cid:4)(cid:14)(cid:11)(cid:48)(cid:48)(cid:7)(cid:5)(cid:3)(cid:9)(cid:2)(cid:12)(cid:11)(cid:4)(cid:14)(cid:11)(cid:48)(cid:48)(cid:7)(cid:5)(cid:3)(cid:9)(cid:2)(cid:28)(cid:3,,17500.0
,,18,,,Unknown,,cid:3)(cid:5)(cid:14)(cid:70)(cid:12)(cid:11)(cid:4)(cid:14)(cid:11)(cid:48)(cid:48)(cid:7)(cid:5)(cid:3)(cid:9)(cid:2)(cid:12)(cid:11)(cid:4)(cid:14)(cid:11)(cid:48)(cid:48)(cid:7)(cid:5)(cid:3)(cid:9)(cid:2)(cid:28)(cid:3,,17518.0
,,16,,,Unknown,,cid:3)(cid:5)(cid:14)(cid:70)(cid:12)(cid:11)(cid:4)(cid:14)(cid:11)(cid:48)(cid:48)(cid:7)(cid:5)(cid:3)(cid:9)(cid:2)(cid:12)(cid:11)(cid:4)(cid:14)(cid:11)(cid:48)(cid:48)(cid:7)(cid:5)(cid:3)(cid:9)(cid:2)(cid:28)(cid:3,,17534.0
,,14,,,Unknown,,cid:3)(cid:5)(cid:14)(cid:70)(cid:12)(cid:11)(cid:4)(cid:14)(cid:11)(cid:48)(cid:48)(cid:7)(cid:5)(cid:3)(cid:9)(cid:2)(cid:12)(cid:11)(cid:4)(cid:14)(cid:11)(cid:48)(cid:48)(cid:7)(cid:5)(cid:3)(cid:9)(cid:2)(cid:28)(cid:3,,17548.0
,,5,,,Unknown,,cid:3)(cid:5)(cid:14)(cid:70)(cid:12)(cid:11)(cid:4)(cid:14)(cid:11)(cid:48)(cid:48)(cid:7)(cid:5)(cid:3)(cid:9)(cid:2)(cid:12)(cid:11)(cid:4)(cid:14)(cid:11)(cid:48)(cid:48)(cid:7)(cid:5)(cid:3)(cid:9)(cid:2)(cid:28)(cid:3,,17553.0
,,12,,,Unknown,,cid:3)(cid:5)(cid:14)(cid:70)(cid:12)(cid:11)(cid:4)(cid:14)(cid:11)(cid:48)(cid:48)(cid:7)(cid:5)(cid:3)(cid:9)(cid:2)(cid:12)(cid:11)(cid:4)(cid:14)(cid:11)(cid:48)(cid:48)(cid:7)(cid:5)(cid:3)(cid:9)(cid:2)(cid:28)(cid:3,,17565.0
,,14,,,Unknown,,cid:3)(cid:5)(cid:14)(cid:70)(cid:12)(cid:11)(cid:4)(cid:14)(cid:11)(cid:48)(cid:48)(cid:7)(cid:5)(cid:3)(cid:9)(cid:2)(cid:12)(cid:11)(cid:4)(cid:14)(cid:11)(cid:48)(cid:48)(cid:7)(cid:5)(cid:3)(cid:9)(cid:2)(cid:28)(cid:3,,17579.0
,,5,,,Unknown,,cid:3)(cid:5)(cid:14)(cid:70)(cid:12)(cid:11)(cid:4)(cid:14)(cid:11)(cid:48)(cid:48)(cid:7)(cid:5)(cid:3)(cid:9)(cid:2)(cid:12)(cid:11)(cid:4)(cid:14)(cid:11)(cid:48)(cid:48)(cid:7)(cid:5)(cid:3)(cid:9)(cid:2)(cid:28)(cid:3,,17584.0
,,3,,,Unknown,,cid:3)(cid:5)(cid:14)(cid:70)(cid:12)(cid:11)(cid:4)(cid:14)(cid:11)(cid:48)(cid:48)(cid:7)(cid:5)(cid:3)(cid:9)(cid:2)(cid:12)(cid:11)(cid:4)(cid:14)(cid:11)(cid:48)(cid:48)(cid:7)(cid:5)(cid:3)(cid:9)(cid:2)(cid:28)(cid:3,,17587.0
,,12,,,Unknown,,cid:3)(cid:5)(cid:14)(cid:70)(cid:12)(cid:11)(cid:4)(cid:14)(cid:11)(cid:48)(cid:48)(cid:7)(cid:5)(cid:3)(cid:9)(cid:2)(cid:12)(cid:11)(cid:4)(cid:14)(cid:11)(cid:48)(cid:48)(cid:7)(cid:5)(cid:3)(cid:9)(cid:2)(cid:28)(cid:3,,17599.0
,,2,,,Unknown,,cid:3)(cid:5)(cid:14)(cid:70)(cid:12)(cid:11)(cid:4)(cid:14)(cid:11)(cid:48)(cid:48)(cid:7)(cid:5)(cid:3)(cid:9)(cid:2)(cid:12)(cid:11)(cid:4)(cid:14)(cid:11)(cid:48)(cid:48)(cid:7)(cid:5)(cid:3)(cid:9)(cid:2)(cid:28)(cid:3,,17601.0
,,50,,,Unknown,,cid:3)(cid:5)(cid:14)(cid:70)(cid:12)(cid:11)(cid:4)(cid:14)(cid:11)(cid:48)(cid:48)(cid:7)(cid:5)(cid:3)(cid:9)(cid:2)(cid:12)(cid:11)(cid:4)(cid:14)(cid:11)(cid:48)(cid:48)(cid:7)(cid:5)(cid:3)(cid:9)(cid:2)(cid:28)(cid:3,,17651.0
,,7,,,Unknown,,cid:3)(cid:5)(cid:14)(cid:70)(cid:12)(cid:11)(cid:4)(cid:14)(cid:11)(cid:48)(cid:48)(cid:7)(cid:5)(cid:3)(cid:9)(cid:2)(cid:12)(cid:11)(cid:4)(cid:14)(cid:11)(cid:48)(cid:48)(cid:7)(cid:5)(cid:3)(cid:9)(cid:2)(cid:28)(cid:3,,17658.0
,,9,,,Unknown,,cid:3)(cid:5)(cid:14)(cid:70)(cid:12)(cid:11)(cid:4)(cid:14)(cid:11)(cid:48)(cid:48)(cid:7)(cid:5)(cid:3)(cid:9)(cid:2)(cid:12)(cid:11)(cid:4)(cid:14)(cid:11)(cid:48)(cid:48)(cid:7)(cid:5)(cid:3)(cid:9)(cid:2)(cid:28)(cid:3,,17667.0
,,10,,,Unknown,,cid:3)(cid:5)(cid:14)(cid:70)(cid:12)(cid:11)(cid:4)(cid:14)(cid:11)(cid:48)(cid:48)(cid:7)(cid:5)(cid:3)(cid:9)(cid:2)(cid:12)(cid:11)(cid:4)(cid:14)(cid:11)(cid:48)(cid:48)(cid:7)(cid:5)(cid:3)(cid:9)(cid:2)(cid:28)(cid:3,,17677.0
,,3,,,Unknown,,cid:3)(cid:5)(cid:14)(cid:70)(cid:12)(cid:11)(cid:4)(cid:14)(cid:11)(cid:48)(cid:48)(cid:7)(cid:5)(cid:3)(cid:9)(cid:2)(cid:12)(cid:11)(cid:4)(cid:14)(cid:11)(cid:48)(cid:48)(cid:7)(cid:5)(cid:3)(cid:9)(cid:2)(cid:28)(cid:3,,17680.0
,,2,,,Unknown,,cid:3)(cid:5)(cid:14)(cid:70)(cid:12)(cid:11)(cid:4)(cid:14)(cid:11)(cid:48)(cid:48)(cid:7)(cid:5)(cid:3)(cid:9)(cid:2)(cid:12)(cid:11)(cid:4)(cid:14)(cid:11)(cid:48)(cid:48)(cid:7)(cid:5)(cid:3)(cid:9)(cid:2)(cid:28)(cid:3,,17682.0
,,12,,,Unknown,,cid:3)(cid:5)(cid:14)(cid:70)(cid:12)(cid:11)(cid:4)(cid:14)(cid:11)(cid:48)(cid:48)(cid:7)(cid:5)(cid:3)(cid:9)(cid:2)(cid:12)(cid:11)(cid:4)(cid:14)(cid:11)(cid:48)(cid:48)(cid:7)(cid:5)(cid:3)(cid:9)(cid:2)(cid:28)(cid:3,,17694.0
,,11,,,Unknown,,cid:3)(cid:5)(cid:14)(cid:70)(cid:12)(cid:11)(cid:4)(cid:14)(cid:11)(cid:48)(cid:48)(cid:7)(cid:5)(cid:3)(cid:9)(cid:2)(cid:12)(cid:11)(cid:4)(cid:14)(cid:11)(cid:48)(cid:48)(cid:7)(cid:5)(cid:3)(cid:9)(cid:2)(cid:28)(cid:3,,17705.0
,,4,,,Unknown,,cid:3)(cid:5)(cid:14)(cid:70)(cid:12)(cid:11)(cid:4)(cid:14)(cid:11)(cid:48)(cid:48)(cid:7)(cid:5)(cid:3)(cid:9)(cid:2)(cid:12)(cid:11)(cid:4)(cid:14)(cid:11)(cid:48)(cid:48)(cid:7)(cid:5)(cid:3)(cid:9)(cid:2)(cid:28)(cid:3,,17709.0
,,14,,,Unknown,,cid:3)(cid:5)(cid:14)(cid:70)(cid:12)(cid:11)(cid:4)(cid:14)(cid:11)(cid:48)(cid:48)(cid:7)(cid:5)(cid:3)(cid:9)(cid:2)(cid:12)(cid:11)(cid:4)(cid:14)(cid:11)(cid:48)(cid:48)(cid:7)(cid:5)(cid:3)(cid:9)(cid:2)(cid:28)(cid:3,,17723.0
,,11,,,Unknown,,cid:3)(cid:5)(cid:14)(cid:70)(cid:12)(cid:11)(cid:4)(cid:14)(cid:11)(cid:48)(cid:48)(cid:7)(cid:5)(cid:3)(cid:9)(cid:2)(cid:12)(cid:11)(cid:4)(cid:14)(cid:11)(cid:48)(cid:48)(cid:7)(cid:5)(cid:3)(cid:9)(cid:2)(cid:28)(cid:3,,17734.0
,,48,,,Unknown,,cid:3)(cid:5)(cid:14)(cid:70)(cid:12)(cid:11)(cid:4)(cid:14)(cid:11)(cid:48)(cid:48)(cid:7)(cid:5)(cid:3)(cid:9)(cid:2)(cid:12)(cid:11)(cid:4)(cid:14)(cid:11)(cid:48)(cid:48)(cid:7)(cid:5)(cid:3)(cid:9)(cid:2)(cid:28)(cid:3,,17782.0
,,48,,,Unknown,,cid:3)(cid:5)(cid:14)(cid:70)(cid:12)(cid:11)(cid:4)(cid:14)(cid:11)(cid:48)(cid:48)(cid:7)(cid:5)(cid:3)(cid:9)(cid:2)(cid:12)(cid:11)(cid:4)(cid:14)(cid:11)(cid:48)(cid:48)(cid:7)(cid:5)(cid:3)(cid:9)(cid:2)(cid:28)(cid:3,,17830.0
,,7,,,Unknown,,cid:3)(cid:5)(cid:14)(cid:70)(cid:12)(cid:11)(cid:4)(cid:14)(cid:11)(cid:48)(cid:48)(cid:7)(cid:5)(cid:3)(cid:9)(cid:2)(cid:12)(cid:11)(cid:4)(cid:14)(cid:11)(cid:48)(cid:48)(cid:7)(cid:5)(cid:3)(cid:9)(cid:2)(cid:28)(cid:3,,17837.0
,,5,,,Unknown,,cid:3)(cid:5)(cid:14)(cid:70)(cid:12)(cid:11)(cid:4)(cid:14)(cid:11)(cid:48)(cid:48)(cid:7)(cid:5)(cid:3)(cid:9)(cid:2)(cid:12)(cid:11)(cid:4)(cid:14)(cid:11)(cid:48)(cid:48)(cid:7)(cid:5)(cid:3)(cid:9)(cid:2)(cid:28)(cid:3,,17842.0
,,3,,,Unknown,,cid:3)(cid:5)(cid:14)(cid:70)(cid:12)(cid:11)(cid:4)(cid:14)(cid:11)(cid:48)(cid:48)(cid:7)(cid:5)(cid:3)(cid:9)(cid:2)(cid:12)(cid:11)(cid:4)(cid:14)(cid:11)(cid:48)(cid:48)(cid:7)(cid:5)(cid:3)(cid:9)(cid:2)(cid:28)(cid:3,,17845.0
,,2,,,Unknown,,cid:3)(cid:5)(cid:14)(cid:70)(cid:12)(cid:11)(cid:4)(cid:14)(cid:11)(cid:48)(cid:48)(cid:7)(cid:5)(cid:3)(cid:9)(cid:2)(cid:12)(cid:11)(cid:4)(cid:14)(cid:11)(cid:48)(cid:48)(cid:7)(cid:5)(cid:3)(cid:9)(cid:2)(cid:28)(cid:3,,17847.0
,,28,,,Unknown,,cid:3)(cid:5)(cid:14)(cid:70)(cid:12)(cid:11)(cid:4)(cid:14)(cid:11)(cid:48)(cid:48)(cid:7)(cid:5)(cid:3)(cid:9)(cid:2)(cid:12)(cid:11)(cid:4)(cid:14)(cid:11)(cid:48)(cid:48)(cid:7)(cid:5)(cid:3)(cid:9)(cid:2)(cid:28)(cid:3,,17875.0
,,3,,,Unknown,,cid:3)(cid:5)(cid:14)(cid:70)(cid:12)(cid:11)(cid:4)(cid:14)(cid:11)(cid:48)(cid:48)(cid:7)(cid:5)(cid:3)(cid:9)(cid:2)(cid:12)(cid:11)(cid:4)(cid:14)(cid:11)(cid:48)(cid:48)(cid:7)(cid:5)(cid:3)(cid:9)(cid:2)(cid:28)(cid:3,,17878.0
,,15,,,Unknown,,cid:3)(cid:5)(cid:14)(cid:70)(cid:12)(cid:11)(cid:4)(cid:14)(cid:11)(cid:48)(cid:48)(cid:7)(cid:5)(cid:3)(cid:9)(cid:2)(cid:12)(cid:11)(cid:4)(cid:14)(cid:11)(cid:48)(cid:48)(cid:7)(cid:5)(cid:3)(cid:9)(cid:2)(cid:28)(cid:3,,17893.0
,,2,,,Unknown,,cid:3)(cid:5)(cid:14)(cid:70)(cid:12)(cid:11)(cid:4)(cid:14)(cid:11)(cid:48)(cid:48)(cid:7)(cid:5)(cid:3)(cid:9)(cid:2)(cid:12)(cid:11)(cid:4)(cid:14)(cid:11)(cid:48)(cid:48)(cid:7)(cid:5)(cid:3)(cid:9)(cid:2)(cid:28)(cid:3,,17895.0
,,17,,,Unknown,,cid:3)(cid:5)(cid:14)(cid:70)(cid:12)(cid:11)(cid:4)(cid:14)(cid:11)(cid:48)(cid:48)(cid:7)(cid:5)(cid:3)(cid:9)(cid:2)(cid:12)(cid:11)(cid:4)(cid:14)(cid:11)(cid:48)(cid:48)(cid:7)(cid:5)(cid:3)(cid:9)(cid:2)(cid:28)(cid:3,,17912.0
,,18,,,Unknown,,cid:3)(cid:5)(cid:14)(cid:70)(cid:12)(cid:11)(cid:4)(cid:14)(cid:11)(cid:48)(cid:48)(cid:7)(cid:5)(cid:3)(cid:9)(cid:2)(cid:12)(cid:11)(cid:4)(cid:14)(cid:11)(cid:48)(cid:48)(cid:7)(cid:5)(cid:3)(cid:9)(cid:2)(cid:28)(cid:3,,17930.0
,,18,,,Unknown,,cid:3)(cid:5)(cid:14)(cid:70)(cid:12)(cid:11)(cid:4)(cid:14)(cid:11)(cid:48)(cid:48)(cid:7)(cid:5)(cid:3)(cid:9)(cid:2)(cid:12)(cid:11)(cid:4)(cid:14)(cid:11)(cid:48)(cid:48)(cid:7)(cid:5)(cid:3)(cid:9)(cid:2)(cid:28)(cid:3,,17948.0
,,19,,,Unknown,,cid:3)(cid:5)(cid:14)(cid:70)(cid:12)(cid:11)(cid:4)(cid:14)(cid:11)(cid:48)(cid:48)(cid:7)(cid:5)(cid:3)(cid:9)(cid:2)(cid:12)(cid:11)(cid:4)(cid:14)(cid:11)(cid:48)(cid:48)(cid:7)(cid:5)(cid:3)(cid:9)(cid:2)(cid:28)(cid:3,,17967.0
,,18,,,Unknown,,cid:3)(cid:5)(cid:14)(cid:70)(cid:12)(cid:11)(cid:4)(cid:14)(cid:11)(cid:48)(cid:48)(cid:7)(cid:5)(cid:3)(cid:9)(cid:2)(cid:12)(cid:11)(cid:4)(cid:14)(cid:11)(cid:48)(cid:48)(cid:7)(cid:5)(cid:3)(cid:9)(cid:2)(cid:28)(cid:3,,17985.0
,,18,,,Unknown,,cid:3)(cid:5)(cid:14)(cid:70)(cid:12)(cid:11)(cid:4)(cid:14)(cid:11)(cid:48)(cid:48)(cid:7)(cid:5)(cid:3)(cid:9)(cid:2)(cid:12)(cid:11)(cid:4)(cid:14)(cid:11)(cid:48)(cid:48)(cid:7)(cid:5)(cid:3)(cid:9)(cid:2)(cid:28)(cid:3,,18003.0
,,2,,,Unknown,,cid:3)(cid:5)(cid:14)(cid:70)(cid:12)(cid:11)(cid:4)(cid:14)(cid:11)(cid:48)(cid:48)(cid:7)(cid:5)(cid:3)(cid:9)(cid:2)(cid:12)(cid:11)(cid:4)(cid:14)(cid:11)(cid:48)(cid:48)(cid:7)(cid:5)(cid:3)(cid:9)(cid:2)(cid:28)(cid:3,,18005.0
,,44,,,Unknown,,cid:3)(cid:5)(cid:14)(cid:70)(cid:12)(cid:11)(cid:4)(cid:14)(cid:11)(cid:48)(cid:48)(cid:7)(cid:5)(cid:3)(cid:9)(cid:2)(cid:12)(cid:11)(cid:4)(cid:14)(cid:11)(cid:48)(cid:48)(cid:7)(cid:5)(cid:3)(cid:9)(cid:2)(cid:28)(cid:3,,18049.0
,,12,,,Unknown,,cid:3)(cid:5)(cid:14)(cid:70)(cid:12)(cid:11)(cid:4)(cid:14)(cid:11)(cid:48)(cid:48)(cid:7)(cid:5)(cid:3)(cid:9)(cid:2)(cid:12)(cid:11)(cid:4)(cid:14)(cid:11)(cid:48)(cid:48)(cid:7)(cid:5)(cid:3)(cid:9)(cid:2)(cid:28)(cid:3,,18061.0
,,29,,,Unknown,,cid:3)(cid:5)(cid:14)(cid:70)(cid:12)(cid:11)(cid:4)(cid:14)(cid:11)(cid:48)(cid:48)(cid:7)(cid:5)(cid:3)(cid:9)(cid:2)(cid:12)(cid:11)(cid:4)(cid:14)(cid:11)(cid:48)(cid:48)(cid:7)(cid:5)(cid:3)(cid:9)(cid:2)(cid:28)(cid:3,,18090.0
,,26,,,Unknown,,cid:3)(cid:5)(cid:14)(cid:70)(cid:12)(cid:11)(cid:4)(cid:14)(cid:11)(cid:48)(cid:48)(cid:7)(cid:5)(cid:3)(cid:9)(cid:2)(cid:12)(cid:11)(cid:4)(cid:14)(cid:11)(cid:48)(cid:48)(cid:7)(cid:5)(cid:3)(cid:9)(cid:2)(cid:28)(cid:3,,18116.0
,,41,,,Unknown,,cid:3)(cid:5)(cid:14)(cid:70)(cid:12)(cid:11)(cid:4)(cid:14)(cid:11)(cid:48)(cid:48)(cid:7)(cid:5)(cid:3)(cid:9)(cid:2)(cid:12)(cid:11)(cid:4)(cid:14)(cid:11)(cid:48)(cid:48)(cid:7)(cid:5)(cid:3)(cid:9)(cid:2)(cid:28)(cid:3,,18157.0
,,25,,,Unknown,,cid:3)(cid:5)(cid:14)(cid:70)(cid:12)(cid:11)(cid:4)(cid:14)(cid:11)(cid:48)(cid:48)(cid:7)(cid:5)(cid:3)(cid:9)(cid:2)(cid:12)(cid:11)(cid:4)(cid:14)(cid:11)(cid:48)(cid:48)(cid:7)(cid:5)(cid:3)(cid:9)(cid:2)(cid:28)(cid:3,,18182.0
,,2,,,Unknown,,cid:3)(cid:5)(cid:14)(cid:70)(cid:12)(cid:11)(cid:4)(cid:14)(cid:11)(cid:48)(cid:48)(cid:7)(cid:5)(cid:3)(cid:9)(cid:2)(cid:12)(cid:11)(cid:4)(cid:14)(cid:11)(cid:48)(cid:48)(cid:7)(cid:5)(cid:3)(cid:9)(cid:2)(cid:28)(cid:3,,18184.0
,,58,,,Unknown,,cid:3)(cid:5)(cid:14)(cid:70)(cid:12)(cid:11)(cid:4)(cid:14)(cid:11)(cid:48)(cid:48)(cid:7)(cid:5)(cid:3)(cid:9)(cid:2)(cid:12)(cid:11)(cid:4)(cid:14)(cid:11)(cid:48)(cid:48)(cid:7)(cid:5)(cid:3)(cid:9)(cid:2)(cid:28)(cid:3,,18242.0
,,58,,,Unknown,,cid:3)(cid:5)(cid:14)(cid:70)(cid:12)(cid:11)(cid:4)(cid:14)(cid:11)(cid:48)(cid:48)(cid:7)(cid:5)(cid:3)(cid:9)(cid:2)(cid:12)(cid:11)(cid:4)(cid:14)(cid:11)(cid:48)(cid:48)(cid:7)(cid:5)(cid:3)(cid:9)(cid:2)(cid:28)(cid:3,,18300.0
,,37,,,Unknown,,cid:3)(cid:5)(cid:14)(cid:70)(cid:12)(cid:11)(cid:4)(cid:14)(cid:11)(cid:48)(cid:48)(cid:7)(cid:5)(cid:3)(cid:9)(cid:2)(cid:12)(cid:11)(cid:4)(cid:14)(cid:11)(cid:48)(cid:48)(cid:7)(cid:5)(cid:3)(cid:9)(cid:2)(cid:28)(cid:3,,18337.0
,,16,,,Unknown,,cid:3)(cid:5)(cid:14)(cid:70)(cid:12)(cid:11)(cid:4)(cid:14)(cid:11)(cid:48)(cid:48)(cid:7)(cid:5)(cid:3)(cid:9)(cid:2)(cid:12)(cid:11)(cid:4)(cid:14)(cid:11)(cid:48)(cid:48)(cid:7)(cid:5)(cid:3)(cid:9)(cid:2)(cid:28)(cid:3,,18353.0
,,34,,,Unknown,,cid:3)(cid:5)(cid:14)(cid:70)(cid:12)(cid:11)(cid:4)(cid:14)(cid:11)(cid:48)(cid:48)(cid:7)(cid:5)(cid:3)(cid:9)(cid:2)(cid:12)(cid:11)(cid:4)(cid:14)(cid:11)(cid:48)(cid:48)(cid:7)(cid:5)(cid:3)(cid:9)(cid:2)(cid:28)(cid:3,,18387.0
,,33,,,Unknown,,cid:3)(cid:5)(cid:14)(cid:70)(cid:12)(cid:11)(cid:4)(cid:14)(cid:11)(cid:48)(cid:48)(cid:7)(cid:5)(cid:3)(cid:9)(cid:2)(cid:12)(cid:11)(cid:4)(cid:14)(cid:11)(cid:48)(cid:48)(cid:7)(cid:5)(cid:3)(cid:9)(cid:2)(cid:28)(cid:3,,18420.0
,,17,,,Unknown,,cid:3)(cid:5)(cid:14)(cid:70)(cid:12)(cid:11)(cid:4)(cid:14)(cid:11)(cid:48)(cid:48)(cid:7)(cid:5)(cid:3)(cid:9)(cid:2)(cid:12)(cid:11)(cid:4)(cid:14)(cid:11)(cid:48)(cid:48)(cid:7)(cid:5)(cid:3)(cid:9)(cid:2)(cid:28)(cid:3,,18437.0
,,35,,,Unknown,,cid:3)(cid:5)(cid:14)(cid:70)(cid:12)(cid:11)(cid:4)(cid:14)(cid:11)(cid:48)(cid:48)(cid:7)(cid:5)(cid:3)(cid:9)(cid:2)(cid:12)(cid:11)(cid:4)(cid:14)(cid:11)(cid:48)(cid:48)(cid:7)(cid:5)(cid:3)(cid:9)(cid:2)(cid:28)(cid:3,,18472.0
,,45,,,Unknown,,cid:3)(cid:5)(cid:14)(cid:70)(cid:12)(cid:11)(cid:4)(cid:14)(cid:11)(cid:48)(cid:48)(cid:7)(cid:5)(cid:3)(cid:9)(cid:2)(cid:12)(cid:11)(cid:4)(cid:14)(cid:11)(cid:48)(cid:48)(cid:7)(cid:5)(cid:3)(cid:9)(cid:2)(cid:28)(cid:3,,18517.0
,,18,,,Unknown,,cid:3)(cid:5)(cid:14)(cid:70)(cid:12)(cid:11)(cid:4)(cid:14)(cid:11)(cid:48)(cid:48)(cid:7)(cid:5)(cid:3)(cid:9)(cid:2)(cid:12)(cid:11)(cid:4)(cid:14)(cid:11)(cid:48)(cid:48)(cid:7)(cid:5)(cid:3)(cid:9)(cid:2)(cid:28)(cid:3,,18535.0
,,16,,,Unknown,,cid:3)(cid:5)(cid:14)(cid:70)(cid:12)(cid:11)(cid:4)(cid:14)(cid:11)(cid:48)(cid:48)(cid:7)(cid:5)(cid:3)(cid:9)(cid:2)(cid:12)(cid:11)(cid:4)(cid:14)(cid:11)(cid:48)(cid:48)(cid:7)(cid:5)(cid:3)(cid:9)(cid:2)(cid:28)(cid:3,,18551.0
,,10,,,Unknown,,cid:3)(cid:5)(cid:14)(cid:70)(cid:12)(cid:11)(cid:4)(cid:14)(cid:11)(cid:48)(cid:48)(cid:7)(cid:5)(cid:3)(cid:9)(cid:2)(cid:12)(cid:11)(cid:4)(cid:14)(cid:11)(cid:48)(cid:48)(cid:7)(cid:5)(cid:3)(cid:9)(cid:2)(cid:28)(cid:3,,18561.0
,,11,,,Unknown,,cid:3)(cid:5)(cid:14)(cid:70)(cid:12)(cid:11)(cid:4)(cid:14)(cid:11)(cid:48)(cid:48)(cid:7)(cid:5)(cid:3)(cid:9)(cid:2)(cid:12)(cid:11)(cid:4)(cid:14)(cid:11)(cid:48)(cid:48)(cid:7)(cid:5)(cid:3)(cid:9)(cid:2)(cid:28)(cid:3,,18572.0
,,10,,,Unknown,,cid:3)(cid:5)(cid:14)(cid:70)(cid:12)(cid:11)(cid:4)(cid:14)(cid:11)(cid:48)(cid:48)(cid:7)(cid:5)(cid:3)(cid:9)(cid:2)(cid:12)(cid:11)(cid:4)(cid:14)(cid:11)(cid:48)(cid:48)(cid:7)(cid:5)(cid:3)(cid:9)(cid:2)(cid:28)(cid:3,,18582.0
,,46,,,Unknown,,cid:3)(cid:5)(cid:14)(cid:70)(cid:12)(cid:11)(cid:4)(cid:14)(cid:11)(cid:48)(cid:48)(cid:7)(cid:5)(cid:3)(cid:9)(cid:2)(cid:12)(cid:11)(cid:4)(cid:14)(cid:11)(cid:48)(cid:48)(cid:7)(cid:5)(cid:3)(cid:9)(cid:2)(cid:28)(cid:3,,18628.0
,,14,,,Unknown,,cid:3)(cid:5)(cid:14)(cid:70)(cid:12)(cid:11)(cid:4)(cid:14)(cid:11)(cid:48)(cid:48)(cid:7)(cid:5)(cid:3)(cid:9)(cid:2)(cid:12)(cid:11)(cid:4)(cid:14)(cid:11)(cid:48)(cid:48)(cid:7)(cid:5)(cid:3)(cid:9)(cid:2)(cid:28)(cid:3,,18642.0
,,2,,,Unknown,,cid:3)(cid:5)(cid:14)(cid:70)(cid:12)(cid:11)(cid:4)(cid:14)(cid:11)(cid:48)(cid:48)(cid:7)(cid:5)(cid:3)(cid:9)(cid:2)(cid:12)(cid:11)(cid:4)(cid:14)(cid:11)(cid:48)(cid:48)(cid:7)(cid:5)(cid:3)(cid:9)(cid:2)(cid:28)(cid:3,,18644.0
,,12,,,Unknown,,cid:3)(cid:5)(cid:14)(cid:70)(cid:12)(cid:11)(cid:4)(cid:14)(cid:11)(cid:48)(cid:48)(cid:7)(cid:5)(cid:3)(cid:9)(cid:2)(cid:12)(cid:11)(cid:4)(cid:14)(cid:11)(cid:48)(cid:48)(cid:7)(cid:5)(cid:3)(cid:9)(cid:2)(cid:28)(cid:3,,18656.0
,,11,,,Unknown,,cid:3)(cid:5)(cid:14)(cid:70)(cid:12)(cid:11)(cid:4)(cid:14)(cid:11)(cid:48)(cid:48)(cid:7)(cid:5)(cid:3)(cid:9)(cid:2)(cid:12)(cid:11)(cid:4)(cid:14)(cid:11)(cid:48)(cid:48)(cid:7)(cid:5)(cid:3)(cid:9)(cid:2)(cid:28)(cid:3,,18667.0
,,4,,,Unknown,,cid:3)(cid:5)(cid:14)(cid:70)(cid:12)(cid:11)(cid:4)(cid:14)(cid:11)(cid:48)(cid:48)(cid:7)(cid:5)(cid:3)(cid:9)(cid:2)(cid:12)(cid:11)(cid:4)(cid:14)(cid:11)(cid:48)(cid:48)(cid:7)(cid:5)(cid:3)(cid:9)(cid:2)(cid:28)(cid:3,,18671.0
,,14,,,Unknown,,cid:3)(cid:5)(cid:14)(cid:70)(cid:12)(cid:11)(cid:4)(cid:14)(cid:11)(cid:48)(cid:48)(cid:7)(cid:5)(cid:3)(cid:9)(cid:2)(cid:12)(cid:11)(cid:4)(cid:14)(cid:11)(cid:48)(cid:48)(cid:7)(cid:5)(cid:3)(cid:9)(cid:2)(cid:28)(cid:3,,18685.0
,,11,,,Unknown,,cid:3)(cid:5)(cid:14)(cid:70)(cid:12)(cid:11)(cid:4)(cid:14)(cid:11)(cid:48)(cid:48)(cid:7)(cid:5)(cid:3)(cid:9)(cid:2)(cid:12)(cid:11)(cid:4)(cid:14)(cid:11)(cid:48)(cid:48)(cid:7)(cid:5)(cid:3)(cid:9)(cid:2)(cid:28)(cid:3,,18696.0
,,48,,,Unknown,,cid:3)(cid:5)(cid:14)(cid:70)(cid:12)(cid:11)(cid:4)(cid:14)(cid:11)(cid:48)(cid:48)(cid:7)(cid:5)(cid:3)(cid:9)(cid:2)(cid:12)(cid:11)(cid:4)(cid:14)(cid:11)(cid:48)(cid:48)(cid:7)(cid:5)(cid:3)(cid:9)(cid:2)(cid:28)(cid:3,,18744.0
,,48,,,Unknown,,cid:3)(cid:5)(cid:14)(cid:70)(cid:12)(cid:11)(cid:4)(cid:14)(cid:11)(cid:48)(cid:48)(cid:7)(cid:5)(cid:3)(cid:9)(cid:2)(cid:12)(cid:11)(cid:4)(cid:14)(cid:11)(cid:48)(cid:48)(cid:7)(cid:5)(cid:3)(cid:9)(cid:2)(cid:28)(cid:3,,18792.0
,,7,,,Unknown,,cid:3)(cid:5)(cid:14)(cid:70)(cid:12)(cid:11)(cid:4)(cid:14)(cid:11)(cid:48)(cid:48)(cid:7)(cid:5)(cid:3)(cid:9)(cid:2)(cid:12)(cid:11)(cid:4)(cid:14)(cid:11)(cid:48)(cid:48)(cid:7)(cid:5)(cid:3)(cid:9)(cid:2)(cid:28)(cid:3,,18799.0
,,5,,,Unknown,,cid:3)(cid:5)(cid:14)(cid:70)(cid:12)(cid:11)(cid:4)(cid:14)(cid:11)(cid:48)(cid:48)(cid:7)(cid:5)(cid:3)(cid:9)(cid:2)(cid:12)(cid:11)(cid:4)(cid:14)(cid:11)(cid:48)(cid:48)(cid:7)(cid:5)(cid:3)(cid:9)(cid:2)(cid:28)(cid:3,,18804.0
,,3,,,Unknown,,cid:3)(cid:5)(cid:14)(cid:70)(cid:12)(cid:11)(cid:4)(cid:14)(cid:11)(cid:48)(cid:48)(cid:7)(cid:5)(cid:3)(cid:9)(cid:2)(cid:12)(cid:11)(cid:4)(cid:14)(cid:11)(cid:48)(cid:48)(cid:7)(cid:5)(cid:3)(cid:9)(cid:2)(cid:28)(cid:3,,18807.0
,,9,,,Unknown,,cid:3)(cid:5)(cid:14)(cid:70)(cid:12)(cid:11)(cid:4)(cid:14)(cid:11)(cid:48)(cid:48)(cid:7)(cid:5)(cid:3)(cid:9)(cid:2)(cid:12)(cid:11)(cid:4)(cid:14)(cid:11)(cid:48)(cid:48)(cid:7)(cid:5)(cid:3)(cid:9)(cid:2)(cid:28)(cid:3,,18816.0
,,2,,,Unknown,,cid:3)(cid:5)(cid:14)(cid:70)(cid:12)(cid:11)(cid:4)(cid:14)(cid:11)(cid:48)(cid:48)(cid:7)(cid:5)(cid:3)(cid:9)(cid:2)(cid:12)(cid:11)(cid:4)(cid:14)(cid:11)(cid:48)(cid:48)(cid:7)(cid:5)(cid:3)(cid:9)(cid:2)(cid:28)(cid:3,,18818.0
,,28,,,Unknown,,cid:3)(cid:5)(cid:14)(cid:70)(cid:12)(cid:11)(cid:4)(cid:14)(cid:11)(cid:48)(cid:48)(cid:7)(cid:5)(cid:3)(cid:9)(cid:2)(cid:12)(cid:11)(cid:4)(cid:14)(cid:11)(cid:48)(cid:48)(cid:7)(cid:5)(cid:3)(cid:9)(cid:2)(cid:28)(cid:3,,18846.0
,,3,,,Unknown,,cid:3)(cid:5)(cid:14)(cid:70)(cid:12)(cid:11)(cid:4)(cid:14)(cid:11)(cid:48)(cid:48)(cid:7)(cid:5)(cid:3)(cid:9)(cid:2)(cid:12)(cid:11)(cid:4)(cid:14)(cid:11)(cid:48)(cid:48)(cid:7)(cid:5)(cid:3)(cid:9)(cid:2)(cid:28)(cid:3,,18849.0
,,15,,,Unknown,,cid:3)(cid:5)(cid:14)(cid:70)(cid:12)(cid:11)(cid:4)(cid:14)(cid:11)(cid:48)(cid:48)(cid:7)(cid:5)(cid:3)(cid:9)(cid:2)(cid:12)(cid:11)(cid:4)(cid:14)(cid:11)(cid:48)(cid:48)(cid:7)(cid:5)(cid:3)(cid:9)(cid:2)(cid:28)(cid:3,,18864.0
,,2,,,Unknown,,cid:3)(cid:5)(cid:14)(cid:70)(cid:12)(cid:11)(cid:4)(cid:14)(cid:11)(cid:48)(cid:48)(cid:7)(cid:5)(cid:3)(cid:9)(cid:2)(cid:12)(cid:11)(cid:4)(cid:14)(cid:11)(cid:48)(cid:48)(cid:7)(cid:5)(cid:3)(cid:9)(cid:2)(cid:28)(cid:3,,18866.0
,,32,,,Unknown,,cid:3)(cid:5)(cid:14)(cid:70)(cid:12)(cid:11)(cid:4)(cid:14)(cid:11)(cid:48)(cid:48)(cid:7)(cid:5)(cid:3)(cid:9)(cid:2)(cid:12)(cid:11)(cid:4)(cid:14)(cid:11)(cid:48)(cid:48)(cid:7)(cid:5)(cid:3)(cid:9)(cid:2)(cid:28)(cid:3,,18898.0
,,18,,,Unknown,,cid:3)(cid:5)(cid:14)(cid:70)(cid:12)(cid:11)(cid:4)(cid:14)(cid:11)(cid:48)(cid:48)(cid:7)(cid:5)(cid:3)(cid:9)(cid:2)(cid:12)(cid:11)(cid:4)(cid:14)(cid:11)(cid:48)(cid:48)(cid:7)(cid:5)(cid:3)(cid:9)(cid:2)(cid:28)(cid:3,,18916.0
,,19,,,Unknown,,cid:3)(cid:5)(cid:14)(cid:70)(cid:12)(cid:11)(cid:4)(cid:14)(cid:11)(cid:48)(cid:48)(cid:7)(cid:5)(cid:3)(cid:9)(cid:2)(cid:12)(cid:11)(cid:4)(cid:14)(cid:11)(cid:48)(cid:48)(cid:7)(cid:5)(cid:3)(cid:9)(cid:2)(cid:28)(cid:3,,18935.0
,,18,,,Unknown,,cid:3)(cid:5)(cid:14)(cid:70)(cid:12)(cid:11)(cid:4)(cid:14)(cid:11)(cid:48)(cid:48)(cid:7)(cid:5)(cid:3)(cid:9)(cid:2)(cid:12)(cid:11)(cid:4)(cid:14)(cid:11)(cid:48)(cid:48)(cid:7)(cid:5)(cid:3)(cid:9)(cid:2)(cid:28)(cid:3,,18953.0
,,17,,,Unknown,,cid:3)(cid:5)(cid:14)(cid:70)(cid:12)(cid:11)(cid:4)(cid:14)(cid:11)(cid:48)(cid:48)(cid:7)(cid:5)(cid:3)(cid:9)(cid:2)(cid:12)(cid:11)(cid:4)(cid:14)(cid:11)(cid:48)(cid:48)(cid:7)(cid:5)(cid:3)(cid:9)(cid:2)(cid:28)(cid:3,,18970.0
,,2,,,Unknown,,cid:3)(cid:5)(cid:14)(cid:70)(cid:12)(cid:11)(cid:4)(cid:14)(cid:11)(cid:48)(cid:48)(cid:7)(cid:5)(cid:3)(cid:9)(cid:2)(cid:12)(cid:11)(cid:4)(cid:14)(cid:11)(cid:48)(cid:48)(cid:7)(cid:5)(cid:3)(cid:9)(cid:2)(cid:28)(cid:3,,18972.0
,,44,,,Unknown,,cid:3)(cid:5)(cid:14)(cid:70)(cid:12)(cid:11)(cid:4)(cid:14)(cid:11)(cid:48)(cid:48)(cid:7)(cid:5)(cid:3)(cid:9)(cid:2)(cid:12)(cid:11)(cid:4)(cid:14)(cid:11)(cid:48)(cid:48)(cid:7)(cid:5)(cid:3)(cid:9)(cid:2)(cid:28)(cid:3,,19016.0
,,12,,,Unknown,,cid:3)(cid:5)(cid:14)(cid:70)(cid:12)(cid:11)(cid:4)(cid:14)(cid:11)(cid:48)(cid:48)(cid:7)(cid:5)(cid:3)(cid:9)(cid:2)(cid:12)(cid:11)(cid:4)(cid:14)(cid:11)(cid:48)(cid:48)(cid:7)(cid:5)(cid:3)(cid:9)(cid:2)(cid:28)(cid:3,,19028.0
,,29,,,Unknown,,cid:3)(cid:5)(cid:14)(cid:70)(cid:12)(cid:11)(cid:4)(cid:14)(cid:11)(cid:48)(cid:48)(cid:7)(cid:5)(cid:3)(cid:9)(cid:2)(cid:12)(cid:11)(cid:4)(cid:14)(cid:11)(cid:48)(cid:48)(cid:7)(cid:5)(cid:3)(cid:9)(cid:2)(cid:28)(cid:3,,19057.0
,,26,,,Unknown,,cid:3)(cid:5)(cid:14)(cid:70)(cid:12)(cid:11)(cid:4)(cid:14)(cid:11)(cid:48)(cid:48)(cid:7)(cid:5)(cid:3)(cid:9)(cid:2)(cid:12)(cid:11)(cid:4)(cid:14)(cid:11)(cid:48)(cid:48)(cid:7)(cid:5)(cid:3)(cid:9)(cid:2)(cid:28)(cid:3,,19083.0
,,41,,,Unknown,,cid:3)(cid:5)(cid:14)(cid:70)(cid:12)(cid:11)(cid:4)(cid:14)(cid:11)(cid:48)(cid:48)(cid:7)(cid:5)(cid:3)(cid:9)(cid:2)(cid:12)(cid:11)(cid:4)(cid:14)(cid:11)(cid:48)(cid:48)(cid:7)(cid:5)(cid:3)(cid:9)(cid:2)(cid:28)(cid:3,,19124.0
,,25,,,Unknown,,cid:3)(cid:5)(cid:14)(cid:70)(cid:12)(cid:11)(cid:4)(cid:14)(cid:11)(cid:48)(cid:48)(cid:7)(cid:5)(cid:3)(cid:9)(cid:2)(cid:12)(cid:11)(cid:4)(cid:14)(cid:11)(cid:48)(cid:48)(cid:7)(cid:5)(cid:3)(cid:9)(cid:2)(cid:28)(cid:3,,19149.0
,,2,,,Unknown,,cid:3)(cid:5)(cid:14)(cid:70)(cid:12)(cid:11)(cid:4)(cid:14)(cid:11)(cid:48)(cid:48)(cid:7)(cid:5)(cid:3)(cid:9)(cid:2)(cid:12)(cid:11)(cid:4)(cid:14)(cid:11)(cid:48)(cid:48)(cid:7)(cid:5)(cid:3)(cid:9)(cid:2)(cid:28)(cid:3,,19151.0
,,58,,,Unknown,,cid:3)(cid:5)(cid:14)(cid:70)(cid:12)(cid:11)(cid:4)(cid:14)(cid:11)(cid:48)(cid:48)(cid:7)(cid:5)(cid:3)(cid:9)(cid:2)(cid:12)(cid:11)(cid:4)(cid:14)(cid:11)(cid:48)(cid:48)(cid:7)(cid:5)(cid:3)(cid:9)(cid:2)(cid:28)(cid:3,,19209.0
,,58,,,Unknown,,cid:3)(cid:5)(cid:14)(cid:70)(cid:12)(cid:11)(cid:4)(cid:14)(cid:11)(cid:48)(cid:48)(cid:7)(cid:5)(cid:3)(cid:9)(cid:2)(cid:12)(cid:11)(cid:4)(cid:14)(cid:11)(cid:48)(cid:48)(cid:7)(cid:5)(cid:3)(cid:9)(cid:2)(cid:28)(cid:3,,19267.0
,,37,,,Unknown,,cid:3)(cid:5)(cid:14)(cid:70)(cid:12)(cid:11)(cid:4)(cid:14)(cid:11)(cid:48)(cid:48)(cid:7)(cid:5)(cid:3)(cid:9)(cid:2)(cid:12)(cid:11)(cid:4)(cid:14)(cid:11)(cid:48)(cid:48)(cid:7)(cid:5)(cid:3)(cid:9)(cid:2)(cid:28)(cid:3,,19304.0
,,16,,,Unknown,,cid:3)(cid:5)(cid:14)(cid:70)(cid:12)(cid:11)(cid:4)(cid:14)(cid:11)(cid:48)(cid:48)(cid:7)(cid:5)(cid:3)(cid:9)(cid:2)(cid:12)(cid:11)(cid:4)(cid:14)(cid:11)(cid:48)(cid:48)(cid:7)(cid:5)(cid:3)(cid:9)(cid:2)(cid:28)(cid:3,,19320.0
,,34,,,Unknown,,cid:3)(cid:5)(cid:14)(cid:70)(cid:12)(cid:11)(cid:4)(cid:14)(cid:11)(cid:48)(cid:48)(cid:7)(cid:5)(cid:3)(cid:9)(cid:2)(cid:12)(cid:11)(cid:4)(cid:14)(cid:11)(cid:48)(cid:48)(cid:7)(cid:5)(cid:3)(cid:9)(cid:2)(cid:28)(cid:3,,19354.0
,,33,,,Unknown,,cid:3)(cid:5)(cid:14)(cid:70)(cid:12)(cid:11)(cid:4)(cid:14)(cid:11)(cid:48)(cid:48)(cid:7)(cid:5)(cid:3)(cid:9)(cid:2)(cid:12)(cid:11)(cid:4)(cid:14)(cid:11)(cid:48)(cid:48)(cid:7)(cid:5)(cid:3)(cid:9)(cid:2)(cid:28)(cid:3,,19387.0
,,17,,,Unknown,,cid:3)(cid:5)(cid:14)(cid:70)(cid:12)(cid:11)(cid:4)(cid:14)(cid:11)(cid:48)(cid:48)(cid:7)(cid:5)(cid:3)(cid:9)(cid:2)(cid:12)(cid:11)(cid:4)(cid:14)(cid:11)(cid:48)(cid:48)(cid:7)(cid:5)(cid:3)(cid:9)(cid:2)(cid:28)(cid:3,,19404.0
,,33,,,Unknown,,cid:3)(cid:5)(cid:14)(cid:70)(cid:12)(cid:11)(cid:4)(cid:14)(cid:11)(cid:48)(cid:48)(cid:7)(cid:5)(cid:3)(cid:9)(cid:2)(cid:12)(cid:11)(cid:4)(cid:14)(cid:11)(cid:48)(cid:48)(cid:7)(cid:5)(cid:3)(cid:9)(cid:2)(cid:28)(cid:3,,19437.0
,,45,,,Unknown,,cid:3)(cid:5)(cid:14)(cid:70)(cid:12)(cid:11)(cid:4)(cid:14)(cid:11)(cid:48)(cid:48)(cid:7)(cid:5)(cid:3)(cid:9)(cid:2)(cid:12)(cid:11)(cid:4)(cid:14)(cid:11)(cid:48)(cid:48)(cid:7)(cid:5)(cid:3)(cid:9)(cid:2)(cid:28)(cid:3,,19482.0
,,18,,,Unknown,,cid:3)(cid:5)(cid:14)(cid:70)(cid:12)(cid:11)(cid:4)(cid:14)(cid:11)(cid:48)(cid:48)(cid:7)(cid:5)(cid:3)(cid:9)(cid:2)(cid:12)(cid:11)(cid:4)(cid:14)(cid:11)(cid:48)(cid:48)(cid:7)(cid:5)(cid:3)(cid:9)(cid:2)(cid:28)(cid:3,,19500.0
,,16,,,Unknown,,cid:3)(cid:5)(cid:14)(cid:70)(cid:12)(cid:11)(cid:4)(cid:14)(cid:11)(cid:48)(cid:48)(cid:7)(cid:5)(cid:3)(cid:9)(cid:2)(cid:12)(cid:11)(cid:4)(cid:14)(cid:11)(cid:48)(cid:48)(cid:7)(cid:5)(cid:3)(cid:9)(cid:2)(cid:28)(cid:3,,19516.0
,,39,,,Unknown,,cid:3)(cid:5)(cid:14)(cid:70)(cid:12)(cid:11)(cid:4)(cid:14)(cid:11)(cid:48)(cid:48)(cid:7)(cid:5)(cid:3)(cid:9)(cid:2)(cid:12)(cid:11)(cid:4)(cid:14)(cid:11)(cid:48)(cid:48)(cid:7)(cid:5)(cid:3)(cid:9)(cid:2)(cid:28)(cid:3,,19555.0
,,7,,,Unknown,,cid:3)(cid:5)(cid:14)(cid:70)(cid:12)(cid:11)(cid:4)(cid:14)(cid:11)(cid:48)(cid:48)(cid:7)(cid:5)(cid:3)(cid:9)(cid:2)(cid:12)(cid:11)(cid:4)(cid:14)(cid:11)(cid:48)(cid:48)(cid:7)(cid:5)(cid:3)(cid:9)(cid:2)(cid:28)(cid:3,,19562.0
,,71,,,Unknown,,cid:3)(cid:5)(cid:14)(cid:70)(cid:12)(cid:11)(cid:4)(cid:14)(cid:11)(cid:48)(cid:48)(cid:7)(cid:5)(cid:3)(cid:9)(cid:2)(cid:12)(cid:11)(cid:4)(cid:14)(cid:11)(cid:48)(cid:48)(cid:7)(cid:5)(cid:3)(cid:9)(cid:2)(cid:28)(cid:3,,19633.0
,,71,,,Unknown,,cid:3)(cid:5)(cid:14)(cid:70)(cid:12)(cid:11)(cid:4)(cid:14)(cid:11)(cid:48)(cid:48)(cid:7)(cid:5)(cid:3)(cid:9)(cid:2)(cid:12)(cid:11)(cid:4)(cid:14)(cid:11)(cid:48)(cid:48)(cid:7)(cid:5)(cid:3)(cid:9)(cid:2)(cid:28)(cid:3,,19704.0
,,5,,,Unknown,,cid:3)(cid:5)(cid:14)(cid:70)(cid:12)(cid:11)(cid:4)(cid:14)(cid:11)(cid:48)(cid:48)(cid:7)(cid:5)(cid:3)(cid:9)(cid:2)(cid:12)(cid:11)(cid:4)(cid:14)(cid:11)(cid:48)(cid:48)(cid:7)(cid:5)(cid:3)(cid:9)(cid:2)(cid:28)(cid:3,,19709.0
,,3,,,Unknown,,cid:3)(cid:5)(cid:14)(cid:70)(cid:12)(cid:11)(cid:4)(cid:14)(cid:11)(cid:48)(cid:48)(cid:7)(cid:5)(cid:3)(cid:9)(cid:2)(cid:12)(cid:11)(cid:4)(cid:14)(cid:11)(cid:48)(cid:48)(cid:7)(cid:5)(cid:3)(cid:9)(cid:2)(cid:28)(cid:3,,19712.0
,,7,,,Unknown,,cid:3)(cid:5)(cid:14)(cid:70)(cid:12)(cid:11)(cid:4)(cid:14)(cid:11)(cid:48)(cid:48)(cid:7)(cid:5)(cid:3)(cid:9)(cid:2)(cid:12)(cid:11)(cid:4)(cid:14)(cid:11)(cid:48)(cid:48)(cid:7)(cid:5)(cid:3)(cid:9)(cid:2)(cid:28)(cid:3,,19719.0
,,46,,,Unknown,,cid:3)(cid:5)(cid:14)(cid:70)(cid:12)(cid:11)(cid:4)(cid:14)(cid:11)(cid:48)(cid:48)(cid:7)(cid:5)(cid:3)(cid:9)(cid:2)(cid:12)(cid:11)(cid:4)(cid:14)(cid:11)(cid:48)(cid:48)(cid:7)(cid:5)(cid:3)(cid:9)(cid:2)(cid:28)(cid:3,,19765.0
,,2,,,Unknown,,cid:3)(cid:5)(cid:14)(cid:70)(cid:12)(cid:11)(cid:4)(cid:14)(cid:11)(cid:48)(cid:48)(cid:7)(cid:5)(cid:3)(cid:9)(cid:2)(cid:12)(cid:11)(cid:4)(cid:14)(cid:11)(cid:48)(cid:48)(cid:7)(cid:5)(cid:3)(cid:9)(cid:2)(cid:28)(cid:3,,19767.0
,,12,,,Unknown,,cid:3)(cid:5)(cid:14)(cid:70)(cid:12)(cid:11)(cid:4)(cid:14)(cid:11)(cid:48)(cid:48)(cid:7)(cid:5)(cid:3)(cid:9)(cid:2)(cid:12)(cid:11)(cid:4)(cid:14)(cid:11)(cid:48)(cid:48)(cid:7)(cid:5)(cid:3)(cid:9)(cid:2)(cid:28)(cid:3,,19779.0
,,11,,,Unknown,,cid:3)(cid:5)(cid:14)(cid:70)(cid:12)(cid:11)(cid:4)(cid:14)(cid:11)(cid:48)(cid:48)(cid:7)(cid:5)(cid:3)(cid:9)(cid:2)(cid:12)(cid:11)(cid:4)(cid:14)(cid:11)(cid:48)(cid:48)(cid:7)(cid:5)(cid:3)(cid:9)(cid:2)(cid:28)(cid:3,,19790.0
,,4,,,Unknown,,cid:3)(cid:5)(cid:14)(cid:70)(cid:12)(cid:11)(cid:4)(cid:14)(cid:11)(cid:48)(cid:48)(cid:7)(cid:5)(cid:3)(cid:9)(cid:2)(cid:12)(cid:11)(cid:4)(cid:14)(cid:11)(cid:48)(cid:48)(cid:7)(cid:5)(cid:3)(cid:9)(cid:2)(cid:28)(cid:3,,19794.0
,,14,,,Unknown,,cid:3)(cid:5)(cid:14)(cid:70)(cid:12)(cid:11)(cid:4)(cid:14)(cid:11)(cid:48)(cid:48)(cid:7)(cid:5)(cid:3)(cid:9)(cid:2)(cid:12)(cid:11)(cid:4)(cid:14)(cid:11)(cid:48)(cid:48)(cid:7)(cid:5)(cid:3)(cid:9)(cid:2)(cid:28)(cid:3,,19808.0
,,11,,,Unknown,,cid:3)(cid:5)(cid:14)(cid:70)(cid:12)(cid:11)(cid:4)(cid:14)(cid:11)(cid:48)(cid:48)(cid:7)(cid:5)(cid:3)(cid:9)(cid:2)(cid:12)(cid:11)(cid:4)(cid:14)(cid:11)(cid:48)(cid:48)(cid:7)(cid:5)(cid:3)(cid:9)(cid:2)(cid:28)(cid:3,,19819.0
,,48,,,Unknown,,cid:3)(cid:5)(cid:14)(cid:70)(cid:12)(cid:11)(cid:4)(cid:14)(cid:11)(cid:48)(cid:48)(cid:7)(cid:5)(cid:3)(cid:9)(cid:2)(cid:12)(cid:11)(cid:4)(cid:14)(cid:11)(cid:48)(cid:48)(cid:7)(cid:5)(cid:3)(cid:9)(cid:2)(cid:28)(cid:3,,19867.0
,,48,,,Unknown,,cid:3)(cid:5)(cid:14)(cid:70)(cid:12)(cid:11)(cid:4)(cid:14)(cid:11)(cid:48)(cid:48)(cid:7)(cid:5)(cid:3)(cid:9)(cid:2)(cid:12)(cid:11)(cid:4)(cid:14)(cid:11)(cid:48)(cid:48)(cid:7)(cid:5)(cid:3)(cid:9)(cid:2)(cid:28)(cid:3,,19915.0
,,7,,,Unknown,,cid:3)(cid:5)(cid:14)(cid:70)(cid:12)(cid:11)(cid:4)(cid:14)(cid:11)(cid:48)(cid:48)(cid:7)(cid:5)(cid:3)(cid:9)(cid:2)(cid:12)(cid:11)(cid:4)(cid:14)(cid:11)(cid:48)(cid:48)(cid:7)(cid:5)(cid:3)(cid:9)(cid:2)(cid:28)(cid:3,,19922.0
,,5,,,Unknown,,cid:3)(cid:5)(cid:14)(cid:70)(cid:12)(cid:11)(cid:4)(cid:14)(cid:11)(cid:48)(cid:48)(cid:7)(cid:5)(cid:3)(cid:9)(cid:2)(cid:12)(cid:11)(cid:4)(cid:14)(cid:11)(cid:48)(cid:48)(cid:7)(cid:5)(cid:3)(cid:9)(cid:2)(cid:28)(cid:3,,19927.0
,,3,,,Unknown,,cid:3)(cid:5)(cid:14)(cid:70)(cid:12)(cid:11)(cid:4)(cid:14)(cid:11)(cid:48)(cid:48)(cid:7)(cid:5)(cid:3)(cid:9)(cid:2)(cid:12)(cid:11)(cid:4)(cid:14)(cid:11)(cid:48)(cid:48)(cid:7)(cid:5)(cid:3)(cid:9)(cid:2)(cid:28)(cid:3,,19930.0
,,9,,,Unknown,,cid:3)(cid:5)(cid:14)(cid:70)(cid:12)(cid:11)(cid:4)(cid:14)(cid:11)(cid:48)(cid:48)(cid:7)(cid:5)(cid:3)(cid:9)(cid:2)(cid:12)(cid:11)(cid:4)(cid:14)(cid:11)(cid:48)(cid:48)(cid:7)(cid:5)(cid:3)(cid:9)(cid:2)(cid:28)(cid:3,,19939.0
,,2,,,Unknown,,cid:3)(cid:5)(cid:14)(cid:70)(cid:12)(cid:11)(cid:4)(cid:14)(cid:11)(cid:48)(cid:48)(cid:7)(cid:5)(cid:3)(cid:9)(cid:2)(cid:12)(cid:11)(cid:4)(cid:14)(cid:11)(cid:48)(cid:48)(cid:7)(cid:5)(cid:3)(cid:9)(cid:2)(cid:28)(cid:3,,19941.0
,,28,,,Unknown,,cid:3)(cid:5)(cid:14)(cid:70)(cid:12)(cid:11)(cid:4)(cid:14)(cid:11)(cid:48)(cid:48)(cid:7)(cid:5)(cid:3)(cid:9)(cid:2)(cid:12)(cid:11)(cid:4)(cid:14)(cid:11)(cid:48)(cid:48)(cid:7)(cid:5)(cid:3)(cid:9)(cid:2)(cid:28)(cid:3,,19969.0
,,3,,,Unknown,,cid:3)(cid:5)(cid:14)(cid:70)(cid:12)(cid:11)(cid:4)(cid:14)(cid:11)(cid:48)(cid:48)(cid:7)(cid:5)(cid:3)(cid:9)(cid:2)(cid:12)(cid:11)(cid:4)(cid:14)(cid:11)(cid:48)(cid:48)(cid:7)(cid:5)(cid:3)(cid:9)(cid:2)(cid:28)(cid:3,,19972.0
,,15,,,Unknown,,cid:3)(cid:5)(cid:14)(cid:70)(cid:12)(cid:11)(cid:4)(cid:14)(cid:11)(cid:48)(cid:48)(cid:7)(cid:5)(cid:3)(cid:9)(cid:2)(cid:12)(cid:11)(cid:4)(cid:14)(cid:11)(cid:48)(cid:48)(cid:7)(cid:5)(cid:3)(cid:9)(cid:2)(cid:28)(cid:3,,19987.0
,,2,,,Unknown,,cid:3)(cid:5)(cid:14)(cid:70)(cid:12)(cid:11)(cid:4)(cid:14)(cid:11)(cid:48)(cid:48)(cid:7)(cid:5)(cid:3)(cid:9)(cid:2)(cid:12)(cid:11)(cid:4)(cid:14)(cid:11)(cid:48)(cid:48)(cid:7)(cid:5)(cid:3)(cid:9)(cid:2)(cid:28)(cid:3,,19989.0
,,36,,,Unknown,,cid:3)(cid:5)(cid:14)(cid:70)(cid:12)(cid:11)(cid:4)(cid:14)(cid:11)(cid:48)(cid:48)(cid:7)(cid:5)(cid:3)(cid:9)(cid:2)(cid:12)(cid:11)(cid:4)(cid:14)(cid:11)(cid:48)(cid:48)(cid:7)(cid:5)(cid:3)(cid:9)(cid:2)(cid:28)(cid:3,,20025.0
,,34,,,Unknown,,cid:3)(cid:5)(cid:14)(cid:70)(cid:12)(cid:11)(cid:4)(cid:14)(cid:11)(cid:48)(cid:48)(cid:7)(cid:5)(cid:3)(cid:9)(cid:2)(cid:12)(cid:11)(cid:4)(cid:14)(cid:11)(cid:48)(cid:48)(cid:7)(cid:5)(cid:3)(cid:9)(cid:2)(cid:28)(cid:3,,20059.0
,,19,,,Unknown,,cid:3)(cid:5)(cid:14)(cid:70)(cid:12)(cid:11)(cid:4)(cid:14)(cid:11)(cid:48)(cid:48)(cid:7)(cid:5)(cid:3)(cid:9)(cid:2)(cid:12)(cid:11)(cid:4)(cid:14)(cid:11)(cid:48)(cid:48)(cid:7)(cid:5)(cid:3)(cid:9)(cid:2)(cid:28)(cid:3,,20078.0
,,18,,,Unknown,,cid:3)(cid:5)(cid:14)(cid:70)(cid:12)(cid:11)(cid:4)(cid:14)(cid:11)(cid:48)(cid:48)(cid:7)(cid:5)(cid:3)(cid:9)(cid:2)(cid:12)(cid:11)(cid:4)(cid:14)(cid:11)(cid:48)(cid:48)(cid:7)(cid:5)(cid:3)(cid:9)(cid:2)(cid:28)(cid:3,,20096.0
,,18,,,Unknown,,cid:3)(cid:5)(cid:14)(cid:70)(cid:12)(cid:11)(cid:4)(cid:14)(cid:11)(cid:48)(cid:48)(cid:7)(cid:5)(cid:3)(cid:9)(cid:2)(cid:12)(cid:11)(cid:4)(cid:14)(cid:11)(cid:48)(cid:48)(cid:7)(cid:5)(cid:3)(cid:9)(cid:2)(cid:28)(cid:3,,20114.0
,,2,,,Unknown,,cid:3)(cid:5)(cid:14)(cid:70)(cid:12)(cid:11)(cid:4)(cid:14)(cid:11)(cid:48)(cid:48)(cid:7)(cid:5)(cid:3)(cid:9)(cid:2)(cid:12)(cid:11)(cid:4)(cid:14)(cid:11)(cid:48)(cid:48)(cid:7)(cid:5)(cid:3)(cid:9)(cid:2)(cid:28)(cid:3,,20116.0
,,44,,,Unknown,,cid:3)(cid:5)(cid:14)(cid:70)(cid:12)(cid:11)(cid:4)(cid:14)(cid:11)(cid:48)(cid:48)(cid:7)(cid:5)(cid:3)(cid:9)(cid:2)(cid:12)(cid:11)(cid:4)(cid:14)(cid:11)(cid:48)(cid:48)(cid:7)(cid:5)(cid:3)(cid:9)(cid:2)(cid:28)(cid:3,,20160.0
,,12,,,Unknown,,cid:3)(cid:5)(cid:14)(cid:70)(cid:12)(cid:11)(cid:4)(cid:14)(cid:11)(cid:48)(cid:48)(cid:7)(cid:5)(cid:3)(cid:9)(cid:2)(cid:12)(cid:11)(cid:4)(cid:14)(cid:11)(cid:48)(cid:48)(cid:7)(cid:5)(cid:3)(cid:9)(cid:2)(cid:28)(cid:3,,20172.0
,,29,,,Unknown,,cid:3)(cid:5)(cid:14)(cid:70)(cid:12)(cid:11)(cid:4)(cid:14)(cid:11)(cid:48)(cid:48)(cid:7)(cid:5)(cid:3)(cid:9)(cid:2)(cid:12)(cid:11)(cid:4)(cid:14)(cid:11)(cid:48)(cid:48)(cid:7)(cid:5)(cid:3)(cid:9)(cid:2)(cid:28)(cid:3,,20201.0
,,26,,,Unknown,,cid:3)(cid:5)(cid:14)(cid:70)(cid:12)(cid:11)(cid:4)(cid:14)(cid:11)(cid:48)(cid:48)(cid:7)(cid:5)(cid:3)(cid:9)(cid:2)(cid:12)(cid:11)(cid:4)(cid:14)(cid:11)(cid:48)(cid:48)(cid:7)(cid:5)(cid:3)(cid:9)(cid:2)(cid:28)(cid:3,,20227.0
,,41,,,Unknown,,cid:3)(cid:5)(cid:14)(cid:70)(cid:12)(cid:11)(cid:4)(cid:14)(cid:11)(cid:48)(cid:48)(cid:7)(cid:5)(cid:3)(cid:9)(cid:2)(cid:12)(cid:11)(cid:4)(cid:14)(cid:11)(cid:48)(cid:48)(cid:7)(cid:5)(cid:3)(cid:9)(cid:2)(cid:28)(cid:3,,20268.0
,,25,,,Unknown,,cid:3)(cid:5)(cid:14)(cid:70)(cid:12)(cid:11)(cid:4)(cid:14)(cid:11)(cid:48)(cid:48)(cid:7)(cid:5)(cid:3)(cid:9)(cid:2)(cid:12)(cid:11)(cid:4)(cid:14)(cid:11)(cid:48)(cid:48)(cid:7)(cid:5)(cid:3)(cid:9)(cid:2)(cid:28)(cid:3,,20293.0
,,2,,,Unknown,,cid:3)(cid:5)(cid:14)(cid:70)(cid:12)(cid:11)(cid:4)(cid:14)(cid:11)(cid:48)(cid:48)(cid:7)(cid:5)(cid:3)(cid:9)(cid:2)(cid:12)(cid:11)(cid:4)(cid:14)(cid:11)(cid:48)(cid:48)(cid:7)(cid:5)(cid:3)(cid:9)(cid:2)(cid:28)(cid:3,,20295.0
,,58,,,Unknown,,cid:3)(cid:5)(cid:14)(cid:70)(cid:12)(cid:11)(cid:4)(cid:14)(cid:11)(cid:48)(cid:48)(cid:7)(cid:5)(cid:3)(cid:9)(cid:2)(cid:12)(cid:11)(cid:4)(cid:14)(cid:11)(cid:48)(cid:48)(cid:7)(cid:5)(cid:3)(cid:9)(cid:2)(cid:28)(cid:3,,20353.0
,,58,,,Unknown,,cid:3)(cid:5)(cid:14)(cid:70)(cid:12)(cid:11)(cid:4)(cid:14)(cid:11)(cid:48)(cid:48)(cid:7)(cid:5)(cid:3)(cid:9)(cid:2)(cid:12)(cid:11)(cid:4)(cid:14)(cid:11)(cid:48)(cid:48)(cid:7)(cid:5)(cid:3)(cid:9)(cid:2)(cid:28)(cid:3,,20411.0
,,37,,,Unknown,,cid:3)(cid:5)(cid:14)(cid:70)(cid:12)(cid:11)(cid:4)(cid:14)(cid:11)(cid:48)(cid:48)(cid:7)(cid:5)(cid:3)(cid:9)(cid:2)(cid:12)(cid:11)(cid:4)(cid:14)(cid:11)(cid:48)(cid:48)(cid:7)(cid:5)(cid:3)(cid:9)(cid:2)(cid:28)(cid:3,,20448.0
,,16,,,Unknown,,cid:3)(cid:5)(cid:14)(cid:70)(cid:12)(cid:11)(cid:4)(cid:14)(cid:11)(cid:48)(cid:48)(cid:7)(cid:5)(cid:3)(cid:9)(cid:2)(cid:12)(cid:11)(cid:4)(cid:14)(cid:11)(cid:48)(cid:48)(cid:7)(cid:5)(cid:3)(cid:9)(cid:2)(cid:28)(cid:3,,20464.0
,,34,,,Unknown,,cid:3)(cid:5)(cid:14)(cid:70)(cid:12)(cid:11)(cid:4)(cid:14)(cid:11)(cid:48)(cid:48)(cid:7)(cid:5)(cid:3)(cid:9)(cid:2)(cid:12)(cid:11)(cid:4)(cid:14)(cid:11)(cid:48)(cid:48)(cid:7)(cid:5)(cid:3)(cid:9)(cid:2)(cid:28)(cid:3,,20498.0
,,33,,,Unknown,,cid:3)(cid:5)(cid:14)(cid:70)(cid:12)(cid:11)(cid:4)(cid:14)(cid:11)(cid:48)(cid:48)(cid:7)(cid:5)(cid:3)(cid:9)(cid:2)(cid:12)(cid:11)(cid:4)(cid:14)(cid:11)(cid:48)(cid:48)(cid:7)(cid:5)(cid:3)(cid:9)(cid:2)(cid:28)(cid:3,,20531.0
,,17,,,Unknown,,cid:3)(cid:5)(cid:14)(cid:70)(cid:12)(cid:11)(cid:4)(cid:14)(cid:11)(cid:48)(cid:48)(cid:7)(cid:5)(cid:3)(cid:9)(cid:2)(cid:12)(cid:11)(cid:4)(cid:14)(cid:11)(cid:48)(cid:48)(cid:7)(cid:5)(cid:3)(cid:9)(cid:2)(cid:28)(cid:3,,20548.0
,,33,,,Unknown,,cid:3)(cid:5)(cid:14)(cid:70)(cid:12)(cid:11)(cid:4)(cid:14)(cid:11)(cid:48)(cid:48)(cid:7)(cid:5)(cid:3)(cid:9)(cid:2)(cid:12)(cid:11)(cid:4)(cid:14)(cid:11)(cid:48)(cid:48)(cid:7)(cid:5)(cid:3)(cid:9)(cid:2)(cid:28)(cid:3,,20581.0
,,45,,,Unknown,,cid:3)(cid:5)(cid:14)(cid:70)(cid:12)(cid:11)(cid:4)(cid:14)(cid:11)(cid:48)(cid:48)(cid:7)(cid:5)(cid:3)(cid:9)(cid:2)(cid:12)(cid:11)(cid:4)(cid:14)(cid:11)(cid:48)(cid:48)(cid:7)(cid:5)(cid:3)(cid:9)(cid:2)(cid:28)(cid:3,,20626.0
,,18,,,Unknown,,cid:3)(cid:5)(cid:14)(cid:70)(cid:12)(cid:11)(cid:4)(cid:14)(cid:11)(cid:48)(cid:48)(cid:7)(cid:5)(cid:3)(cid:9)(cid:2)(cid:12)(cid:11)(cid:4)(cid:14)(cid:11)(cid:48)(cid:48)(cid:7)(cid:5)(cid:3)(cid:9)(cid:2)(cid:28)(cid:3,,20644.0
,,16,,,Unknown,,cid:3)(cid:5)(cid:14)(cid:70)(cid:12)(cid:11)(cid:4)(cid:14)(cid:11)(cid:48)(cid:48)(cid:7)(cid:5)(cid:3)(cid:9)(cid:2)(cid:12)(cid:11)(cid:4)(cid:14)(cid:11)(cid:48)(cid:48)(cid:7)(cid:5)(cid:3)(cid:9)(cid:2)(cid:28)(cid:3,,20660.0
,,48,,,Unknown,,cid:3)(cid:5)(cid:14)(cid:70)(cid:12)(cid:11)(cid:4)(cid:14)(cid:11)(cid:48)(cid:48)(cid:7)(cid:5)(cid:3)(cid:9)(cid:2)(cid:12)(cid:11)(cid:4)(cid:14)(cid:11)(cid:48)(cid:48)(cid:7)(cid:5)(cid:3)(cid:9)(cid:2)(cid:28)(cid:3,,20708.0
,,12,,,Unknown,,cid:3)(cid:5)(cid:14)(cid:70)(cid:12)(cid:11)(cid:4)(cid:14)(cid:11)(cid:48)(cid:48)(cid:7)(cid:5)(cid:3)(cid:9)(cid:2)(cid:12)(cid:11)(cid:4)(cid:14)(cid:11)(cid:48)(cid:48)(cid:7)(cid:5)(cid:3)(cid:9)(cid:2)(cid:28)(cid:3,,20720.0
,,50,,,Unknown,,cid:3)(cid:5)(cid:14)(cid:70)(cid:12)(cid:11)(cid:4)(cid:14)(cid:11)(cid:48)(cid:48)(cid:7)(cid:5)(cid:3)(cid:9)(cid:2)(cid:12)(cid:11)(cid:4)(cid:14)(cid:11)(cid:48)(cid:48)(cid:7)(cid:5)(cid:3)(cid:9)(cid:2)(cid:28)(cid:3,,20770.0
,,11,,,Unknown,,cid:3)(cid:5)(cid:14)(cid:70)(cid:12)(cid:11)(cid:4)(cid:14)(cid:11)(cid:48)(cid:48)(cid:7)(cid:5)(cid:3)(cid:9)(cid:2)(cid:12)(cid:11)(cid:4)(cid:14)(cid:11)(cid:48)(cid:48)(cid:7)(cid:5)(cid:3)(cid:9)(cid:2)(cid:28)(cid:3,,20781.0
,,8,,,Unknown,,cid:3)(cid:5)(cid:14)(cid:70)(cid:12)(cid:11)(cid:4)(cid:14)(cid:11)(cid:48)(cid:48)(cid:7)(cid:5)(cid:3)(cid:9)(cid:2)(cid:12)(cid:11)(cid:4)(cid:14)(cid:11)(cid:48)(cid:48)(cid:7)(cid:5)(cid:3)(cid:9)(cid:2)(cid:28)(cid:3,,20789.0
,,46,,,Unknown,,cid:3)(cid:5)(cid:14)(cid:70)(cid:12)(cid:11)(cid:4)(cid:14)(cid:11)(cid:48)(cid:48)(cid:7)(cid:5)(cid:3)(cid:9)(cid:2)(cid:12)(cid:11)(cid:4)(cid:14)(cid:11)(cid:48)(cid:48)(cid:7)(cid:5)(cid:3)(cid:9)(cid:2)(cid:28)(cid:3,,20835.0
,,14,,,Unknown,,cid:3)(cid:5)(cid:14)(cid:70)(cid:12)(cid:11)(cid:4)(cid:14)(cid:11)(cid:48)(cid:48)(cid:7)(cid:5)(cid:3)(cid:9)(cid:2)(cid:12)(cid:11)(cid:4)(cid:14)(cid:11)(cid:48)(cid:48)(cid:7)(cid:5)(cid:3)(cid:9)(cid:2)(cid:28)(cid:3,,20849.0
,,50,,,Unknown,,cid:3)(cid:5)(cid:14)(cid:70)(cid:12)(cid:11)(cid:4)(cid:14)(cid:11)(cid:48)(cid:48)(cid:7)(cid:5)(cid:3)(cid:9)(cid:2)(cid:12)(cid:11)(cid:4)(cid:14)(cid:11)(cid:48)(cid:48)(cid:7)(cid:5)(cid:3)(cid:9)(cid:2)(cid:28)(cid:3,,20899.0
,,9,,,Unknown,,cid:3)(cid:5)(cid:14)(cid:70)(cid:12)(cid:11)(cid:4)(cid:14)(cid:11)(cid:48)(cid:48)(cid:7)(cid:5)(cid:3)(cid:9)(cid:2)(cid:12)(cid:11)(cid:4)(cid:14)(cid:11)(cid:48)(cid:48)(cid:7)(cid:5)(cid:3)(cid:9)(cid:2)(cid:28)(cid:3,,20908.0
,,17,,,Unknown,,cid:3)(cid:5)(cid:14)(cid:70)(cid:12)(cid:11)(cid:4)(cid:14)(cid:11)(cid:48)(cid:48)(cid:7)(cid:5)(cid:3)(cid:9)(cid:2)(cid:12)(cid:11)(cid:4)(cid:14)(cid:11)(cid:48)(cid:48)(cid:7)(cid:5)(cid:3)(cid:9)(cid:2)(cid:28)(cid:3,,20925.0
,,36,,,Unknown,,cid:3)(cid:5)(cid:14)(cid:70)(cid:12)(cid:11)(cid:4)(cid:14)(cid:11)(cid:48)(cid:48)(cid:7)(cid:5)(cid:3)(cid:9)(cid:2)(cid:12)(cid:11)(cid:4)(cid:14)(cid:11)(cid:48)(cid:48)(cid:7)(cid:5)(cid:3)(cid:9)(cid:2)(cid:28)(cid:3,,20961.0
,,18,,,Unknown,,cid:3)(cid:5)(cid:14)(cid:70)(cid:12)(cid:11)(cid:4)(cid:14)(cid:11)(cid:48)(cid:48)(cid:7)(cid:5)(cid:3)(cid:9)(cid:2)(cid:12)(cid:11)(cid:4)(cid:14)(cid:11)(cid:48)(cid:48)(cid:7)(cid:5)(cid:3)(cid:9)(cid:2)(cid:28)(cid:3,,20979.0
,,1,,,Unknown,,cid:3)(cid:5)(cid:14)(cid:70)(cid:12)(cid:11)(cid:4)(cid:14)(cid:11)(cid:48)(cid:48)(cid:7)(cid:5)(cid:3)(cid:9)(cid:2)(cid:12)(cid:11)(cid:4)(cid:14)(cid:11)(cid:48)(cid:48)(cid:7)(cid:5)(cid:3)(cid:9)(cid:2)(cid:28)(cid:3,,20980.0
,,2,,,Unknown,,cid:3)(cid:5)(cid:14)(cid:70)(cid:12)(cid:11)(cid:4)(cid:14)(cid:11)(cid:48)(cid:48)(cid:7)(cid:5)(cid:3)(cid:9)(cid:2)(cid:12)(cid:11)(cid:4)(cid:14)(cid:11)(cid:48)(cid:48)(cid:7)(cid:5)(cid:3)(cid:9)(cid:2)(cid:28)(cid:3,,20982.0
,,12,,,Unknown,,cid:3)(cid:5)(cid:14)(cid:70)(cid:12)(cid:11)(cid:4)(cid:14)(cid:11)(cid:48)(cid:48)(cid:7)(cid:5)(cid:3)(cid:9)(cid:2)(cid:12)(cid:11)(cid:4)(cid:14)(cid:11)(cid:48)(cid:48)(cid:7)(cid:5)(cid:3)(cid:9)(cid:2)(cid:28)(cid:3,,20994.0
,,11,,,Unknown,,cid:3)(cid:5)(cid:14)(cid:70)(cid:12)(cid:11)(cid:4)(cid:14)(cid:11)(cid:48)(cid:48)(cid:7)(cid:5)(cid:3)(cid:9)(cid:2)(cid:12)(cid:11)(cid:4)(cid:14)(cid:11)(cid:48)(cid:48)(cid:7)(cid:5)(cid:3)(cid:9)(cid:2)(cid:28)(cid:3,,21005.0
,,4,,,Unknown,,cid:3)(cid:5)(cid:14)(cid:70)(cid:12)(cid:11)(cid:4)(cid:14)(cid:11)(cid:48)(cid:48)(cid:7)(cid:5)(cid:3)(cid:9)(cid:2)(cid:12)(cid:11)(cid:4)(cid:14)(cid:11)(cid:48)(cid:48)(cid:7)(cid:5)(cid:3)(cid:9)(cid:2)(cid:28)(cid:3,,21009.0
,,7,,,Unknown,,cid:3)(cid:5)(cid:14)(cid:70)(cid:12)(cid:11)(cid:4)(cid:14)(cid:11)(cid:48)(cid:48)(cid:7)(cid:5)(cid:3)(cid:9)(cid:2)(cid:12)(cid:11)(cid:4)(cid:14)(cid:11)(cid:48)(cid:48)(cid:7)(cid:5)(cid:3)(cid:9)(cid:2)(cid:28)(cid:3,,21016.0
,,14,,,Unknown,,cid:3)(cid:5)(cid:14)(cid:70)(cid:12)(cid:11)(cid:4)(cid:14)(cid:11)(cid:48)(cid:48)(cid:7)(cid:5)(cid:3)(cid:9)(cid:2)(cid:12)(cid:11)(cid:4)(cid:14)(cid:11)(cid:48)(cid:48)(cid:7)(cid:5)(cid:3)(cid:9)(cid:2)(cid:28)(cid:3,,21030.0
,,14,,,Unknown,,cid:3)(cid:5)(cid:14)(cid:70)(cid:12)(cid:11)(cid:4)(cid:14)(cid:11)(cid:48)(cid:48)(cid:7)(cid:5)(cid:3)(cid:9)(cid:2)(cid:12)(cid:11)(cid:4)(cid:14)(cid:11)(cid:48)(cid:48)(cid:7)(cid:5)(cid:3)(cid:9)(cid:2)(cid:28)(cid:3,,21044.0
,,49,,,Unknown,,cid:3)(cid:5)(cid:14)(cid:70)(cid:12)(cid:11)(cid:4)(cid:14)(cid:11)(cid:48)(cid:48)(cid:7)(cid:5)(cid:3)(cid:9)(cid:2)(cid:12)(cid:11)(cid:4)(cid:14)(cid:11)(cid:48)(cid:48)(cid:7)(cid:5)(cid:3)(cid:9)(cid:2)(cid:28)(cid:3,,21093.0
,,2,,,Unknown,,cid:3)(cid:5)(cid:14)(cid:70)(cid:12)(cid:11)(cid:4)(cid:14)(cid:11)(cid:48)(cid:48)(cid:7)(cid:5)(cid:3)(cid:9)(cid:2)(cid:12)(cid:11)(cid:4)(cid:14)(cid:11)(cid:48)(cid:48)(cid:7)(cid:5)(cid:3)(cid:9)(cid:2)(cid:28)(cid:3,,21095.0
,,46,,,Unknown,,cid:3)(cid:5)(cid:14)(cid:70)(cid:12)(cid:11)(cid:4)(cid:14)(cid:11)(cid:48)(cid:48)(cid:7)(cid:5)(cid:3)(cid:9)(cid:2)(cid:12)(cid:11)(cid:4)(cid:14)(cid:11)(cid:48)(cid:48)(cid:7)(cid:5)(cid:3)(cid:9)(cid:2)(cid:28)(cid:3,,21141.0
,,4,,,Unknown,,cid:3)(cid:5)(cid:14)(cid:70)(cid:12)(cid:11)(cid:4)(cid:14)(cid:11)(cid:48)(cid:48)(cid:7)(cid:5)(cid:3)(cid:9)(cid:2)(cid:12)(cid:11)(cid:4)(cid:14)(cid:11)(cid:48)(cid:48)(cid:7)(cid:5)(cid:3)(cid:9)(cid:2)(cid:28)(cid:3,,21145.0
,,2,,,Unknown,,cid:3)(cid:5)(cid:14)(cid:70)(cid:12)(cid:11)(cid:4)(cid:14)(cid:11)(cid:48)(cid:48)(cid:7)(cid:5)(cid:3)(cid:9)(cid:2)(cid:12)(cid:11)(cid:4)(cid:14)(cid:11)(cid:48)(cid:48)(cid:7)(cid:5)(cid:3)(cid:9)(cid:2)(cid:28)(cid:3,,21147.0
,,28,,,Unknown,,cid:3)(cid:5)(cid:14)(cid:70)(cid:12)(cid:11)(cid:4)(cid:14)(cid:11)(cid:48)(cid:48)(cid:7)(cid:5)(cid:3)(cid:9)(cid:2)(cid:12)(cid:11)(cid:4)(cid:14)(cid:11)(cid:48)(cid:48)(cid:7)(cid:5)(cid:3)(cid:9)(cid:2)(cid:28)(cid:3,,21175.0
,,3,,,Unknown,,cid:3)(cid:5)(cid:14)(cid:70)(cid:12)(cid:11)(cid:4)(cid:14)(cid:11)(cid:48)(cid:48)(cid:7)(cid:5)(cid:3)(cid:9)(cid:2)(cid:12)(cid:11)(cid:4)(cid:14)(cid:11)(cid:48)(cid:48)(cid:7)(cid:5)(cid:3)(cid:9)(cid:2)(cid:28)(cid:3,,21178.0
,,15,,,Unknown,,cid:3)(cid:5)(cid:14)(cid:70)(cid:12)(cid:11)(cid:4)(cid:14)(cid:11)(cid:48)(cid:48)(cid:7)(cid:5)(cid:3)(cid:9)(cid:2)(cid:12)(cid:11)(cid:4)(cid:14)(cid:11)(cid:48)(cid:48)(cid:7)(cid:5)(cid:3)(cid:9)(cid:2)(cid:28)(cid:3,,21193.0
,,2,,,Unknown,,cid:3)(cid:5)(cid:14)(cid:70)(cid:12)(cid:11)(cid:4)(cid:14)(cid:11)(cid:48)(cid:48)(cid:7)(cid:5)(cid:3)(cid:9)(cid:2)(cid:12)(cid:11)(cid:4)(cid:14)(cid:11)(cid:48)(cid:48)(cid:7)(cid:5)(cid:3)(cid:9)(cid:2)(cid:28)(cid:3,,21195.0
,,1,,,Unknown,,cid:3)(cid:5)(cid:14)(cid:70)(cid:12)(cid:11)(cid:4)(cid:14)(cid:11)(cid:48)(cid:48)(cid:7)(cid:5)(cid:3)(cid:9)(cid:2)(cid:12)(cid:11)(cid:4)(cid:14)(cid:11)(cid:48)(cid:48)(cid:7)(cid:5)(cid:3)(cid:9)(cid:2)(cid:28)(cid:3,,21196.0
,,19,,,Unknown,,cid:3)(cid:5)(cid:14)(cid:70)(cid:12)(cid:11)(cid:4)(cid:14)(cid:11)(cid:48)(cid:48)(cid:7)(cid:5)(cid:3)(cid:9)(cid:2)(cid:12)(cid:11)(cid:4)(cid:14)(cid:11)(cid:48)(cid:48)(cid:7)(cid:5)(cid:3)(cid:9)(cid:2)(cid:28)(cid:3,,21215.0
,,1,,,Unknown,,cid:3)(cid:5)(cid:14)(cid:70)(cid:12)(cid:11)(cid:4)(cid:14)(cid:11)(cid:48)(cid:48)(cid:7)(cid:5)(cid:3)(cid:9)(cid:2)(cid:12)(cid:11)(cid:4)(cid:14)(cid:11)(cid:48)(cid:48)(cid:7)(cid:5)(cid:3)(cid:9)(cid:2)(cid:28)(cid:3,,21216.0
,,18,,,Unknown,,cid:3)(cid:5)(cid:14)(cid:70)(cid:12)(cid:11)(cid:4)(cid:14)(cid:11)(cid:48)(cid:48)(cid:7)(cid:5)(cid:3)(cid:9)(cid:2)(cid:12)(cid:11)(cid:4)(cid:14)(cid:11)(cid:48)(cid:48)(cid:7)(cid:5)(cid:3)(cid:9)(cid:2)(cid:28)(cid:3,,21234.0
,,2,,,Unknown,,cid:3)(cid:5)(cid:14)(cid:70)(cid:12)(cid:11)(cid:4)(cid:14)(cid:11)(cid:48)(cid:48)(cid:7)(cid:5)(cid:3)(cid:9)(cid:2)(cid:12)(cid:11)(cid:4)(cid:14)(cid:11)(cid:48)(cid:48)(cid:7)(cid:5)(cid:3)(cid:9)(cid:2)(cid:28)(cid:3,,21236.0
,,44,,,Unknown,,cid:3)(cid:5)(cid:14)(cid:70)(cid:12)(cid:11)(cid:4)(cid:14)(cid:11)(cid:48)(cid:48)(cid:7)(cid:5)(cid:3)(cid:9)(cid:2)(cid:12)(cid:11)(cid:4)(cid:14)(cid:11)(cid:48)(cid:48)(cid:7)(cid:5)(cid:3)(cid:9)(cid:2)(cid:28)(cid:3,,21280.0
,,12,,,Unknown,,cid:3)(cid:5)(cid:14)(cid:70)(cid:12)(cid:11)(cid:4)(cid:14)(cid:11)(cid:48)(cid:48)(cid:7)(cid:5)(cid:3)(cid:9)(cid:2)(cid:12)(cid:11)(cid:4)(cid:14)(cid:11)(cid:48)(cid:48)(cid:7)(cid:5)(cid:3)(cid:9)(cid:2)(cid:28)(cid:3,,21292.0
,,29,,,Unknown,,cid:3)(cid:5)(cid:14)(cid:70)(cid:12)(cid:11)(cid:4)(cid:14)(cid:11)(cid:48)(cid:48)(cid:7)(cid:5)(cid:3)(cid:9)(cid:2)(cid:12)(cid:11)(cid:4)(cid:14)(cid:11)(cid:48)(cid:48)(cid:7)(cid:5)(cid:3)(cid:9)(cid:2)(cid:28)(cid:3,,21321.0
,,26,,,Unknown,,cid:3)(cid:5)(cid:14)(cid:70)(cid:12)(cid:11)(cid:4)(cid:14)(cid:11)(cid:48)(cid:48)(cid:7)(cid:5)(cid:3)(cid:9)(cid:2)(cid:12)(cid:11)(cid:4)(cid:14)(cid:11)(cid:48)(cid:48)(cid:7)(cid:5)(cid:3)(cid:9)(cid:2)(cid:28)(cid:3,,21347.0
,,41,,,Unknown,,cid:3)(cid:5)(cid:14)(cid:70)(cid:12)(cid:11)(cid:4)(cid:14)(cid:11)(cid:48)(cid:48)(cid:7)(cid:5)(cid:3)(cid:9)(cid:2)(cid:12)(cid:11)(cid:4)(cid:14)(cid:11)(cid:48)(cid:48)(cid:7)(cid:5)(cid:3)(cid:9)(cid:2)(cid:28)(cid:3,,21388.0
,,25,,,Unknown,,cid:3)(cid:5)(cid:14)(cid:70)(cid:12)(cid:11)(cid:4)(cid:14)(cid:11)(cid:48)(cid:48)(cid:7)(cid:5)(cid:3)(cid:9)(cid:2)(cid:12)(cid:11)(cid:4)(cid:14)(cid:11)(cid:48)(cid:48)(cid:7)(cid:5)(cid:3)(cid:9)(cid:2)(cid:28)(cid:3,,21413.0
,,2,,,Unknown,,cid:3)(cid:5)(cid:14)(cid:70)(cid:12)(cid:11)(cid:4)(cid:14)(cid:11)(cid:48)(cid:48)(cid:7)(cid:5)(cid:3)(cid:9)(cid:2)(cid:12)(cid:11)(cid:4)(cid:14)(cid:11)(cid:48)(cid:48)(cid:7)(cid:5)(cid:3)(cid:9)(cid:2)(cid:28)(cid:3,,21415.0
,,58,,,Unknown,,cid:3)(cid:5)(cid:14)(cid:70)(cid:12)(cid:11)(cid:4)(cid:14)(cid:11)(cid:48)(cid:48)(cid:7)(cid:5)(cid:3)(cid:9)(cid:2)(cid:12)(cid:11)(cid:4)(cid:14)(cid:11)(cid:48)(cid:48)(cid:7)(cid:5)(cid:3)(cid:9)(cid:2)(cid:28)(cid:3,,21473.0
,,58,,,Unknown,,cid:3)(cid:5)(cid:14)(cid:70)(cid:12)(cid:11)(cid:4)(cid:14)(cid:11)(cid:48)(cid:48)(cid:7)(cid:5)(cid:3)(cid:9)(cid:2)(cid:12)(cid:11)(cid:4)(cid:14)(cid:11)(cid:48)(cid:48)(cid:7)(cid:5)(cid:3)(cid:9)(cid:2)(cid:28)(cid:3,,21531.0
,,37,,,Unknown,,cid:3)(cid:5)(cid:14)(cid:70)(cid:12)(cid:11)(cid:4)(cid:14)(cid:11)(cid:48)(cid:48)(cid:7)(cid:5)(cid:3)(cid:9)(cid:2)(cid:12)(cid:11)(cid:4)(cid:14)(cid:11)(cid:48)(cid:48)(cid:7)(cid:5)(cid:3)(cid:9)(cid:2)(cid:28)(cid:3,,21568.0
,,16,,,Unknown,,cid:3)(cid:5)(cid:14)(cid:70)(cid:12)(cid:11)(cid:4)(cid:14)(cid:11)(cid:48)(cid:48)(cid:7)(cid:5)(cid:3)(cid:9)(cid:2)(cid:12)(cid:11)(cid:4)(cid:14)(cid:11)(cid:48)(cid:48)(cid:7)(cid:5)(cid:3)(cid:9)(cid:2)(cid:28)(cid:3,,21584.0
,,34,,,Unknown,,cid:3)(cid:5)(cid:14)(cid:70)(cid:12)(cid:11)(cid:4)(cid:14)(cid:11)(cid:48)(cid:48)(cid:7)(cid:5)(cid:3)(cid:9)(cid:2)(cid:12)(cid:11)(cid:4)(cid:14)(cid:11)(cid:48)(cid:48)(cid:7)(cid:5)(cid:3)(cid:9)(cid:2)(cid:28)(cid:3,,21618.0
,,33,,,Unknown,,cid:3)(cid:5)(cid:14)(cid:70)(cid:12)(cid:11)(cid:4)(cid:14)(cid:11)(cid:48)(cid:48)(cid:7)(cid:5)(cid:3)(cid:9)(cid:2)(cid:12)(cid:11)(cid:4)(cid:14)(cid:11)(cid:48)(cid:48)(cid:7)(cid:5)(cid:3)(cid:9)(cid:2)(cid:28)(cid:3,,21651.0
,,17,,,Unknown,,cid:3)(cid:5)(cid:14)(cid:70)(cid:12)(cid:11)(cid:4)(cid:14)(cid:11)(cid:48)(cid:48)(cid:7)(cid:5)(cid:3)(cid:9)(cid:2)(cid:12)(cid:11)(cid:4)(cid:14)(cid:11)(cid:48)(cid:48)(cid:7)(cid:5)(cid:3)(cid:9)(cid:2)(cid:28)(cid:3,,21668.0
,,33,,,Unknown,,cid:3)(cid:5)(cid:14)(cid:70)(cid:12)(cid:11)(cid:4)(cid:14)(cid:11)(cid:48)(cid:48)(cid:7)(cid:5)(cid:3)(cid:9)(cid:2)(cid:12)(cid:11)(cid:4)(cid:14)(cid:11)(cid:48)(cid:48)(cid:7)(cid:5)(cid:3)(cid:9)(cid:2)(cid:28)(cid:3,,21701.0
,,45,,,Unknown,,cid:3)(cid:5)(cid:14)(cid:70)(cid:12)(cid:11)(cid:4)(cid:14)(cid:11)(cid:48)(cid:48)(cid:7)(cid:5)(cid:3)(cid:9)(cid:2)(cid:12)(cid:11)(cid:4)(cid:14)(cid:11)(cid:48)(cid:48)(cid:7)(cid:5)(cid:3)(cid:9)(cid:2)(cid:28)(cid:3,,21746.0
,,18,,,Unknown,,cid:3)(cid:5)(cid:14)(cid:70)(cid:12)(cid:11)(cid:4)(cid:14)(cid:11)(cid:48)(cid:48)(cid:7)(cid:5)(cid:3)(cid:9)(cid:2)(cid:12)(cid:11)(cid:4)(cid:14)(cid:11)(cid:48)(cid:48)(cid:7)(cid:5)(cid:3)(cid:9)(cid:2)(cid:28)(cid:3,,21764.0
,,16,,,Unknown,,cid:3)(cid:5)(cid:14)(cid:70)(cid:12)(cid:11)(cid:4)(cid:14)(cid:11)(cid:48)(cid:48)(cid:7)(cid:5)(cid:3)(cid:9)(cid:2)(cid:12)(cid:11)(cid:4)(cid:14)(cid:11)(cid:48)(cid:48)(cid:7)(cid:5)(cid:3)(cid:9)(cid:2)(cid:28)(cid:3,,21780.0
,,48,,,Unknown,,cid:3)(cid:5)(cid:14)(cid:70)(cid:12)(cid:11)(cid:4)(cid:14)(cid:11)(cid:48)(cid:48)(cid:7)(cid:5)(cid:3)(cid:9)(cid:2)(cid:12)(cid:11)(cid:4)(cid:14)(cid:11)(cid:48)(cid:48)(cid:7)(cid:5)(cid:3)(cid:9)(cid:2)(cid:28)(cid:3,,21828.0
,,12,,,Unknown,,cid:3)(cid:5)(cid:14)(cid:70)(cid:12)(cid:11)(cid:4)(cid:14)(cid:11)(cid:48)(cid:48)(cid:7)(cid:5)(cid:3)(cid:9)(cid:2)(cid:12)(cid:11)(cid:4)(cid:14)(cid:11)(cid:48)(cid:48)(cid:7)(cid:5)(cid:3)(cid:9)(cid:2)(cid:28)(cid:3,,21840.0
,,50,,,Unknown,,cid:3)(cid:5)(cid:14)(cid:70)(cid:12)(cid:11)(cid:4)(cid:14)(cid:11)(cid:48)(cid:48)(cid:7)(cid:5)(cid:3)(cid:9)(cid:2)(cid:12)(cid:11)(cid:4)(cid:14)(cid:11)(cid:48)(cid:48)(cid:7)(cid:5)(cid:3)(cid:9)(cid:2)(cid:28)(cid:3,,21890.0
,,11,,,Unknown,,cid:3)(cid:5)(cid:14)(cid:70)(cid:12)(cid:11)(cid:4)(cid:14)(cid:11)(cid:48)(cid:48)(cid:7)(cid:5)(cid:3)(cid:9)(cid:2)(cid:12)(cid:11)(cid:4)(cid:14)(cid:11)(cid:48)(cid:48)(cid:7)(cid:5)(cid:3)(cid:9)(cid:2)(cid:28)(cid:3,,21901.0
,,8,,,Unknown,,cid:3)(cid:5)(cid:14)(cid:70)(cid:12)(cid:11)(cid:4)(cid:14)(cid:11)(cid:48)(cid:48)(cid:7)(cid:5)(cid:3)(cid:9)(cid:2)(cid:12)(cid:11)(cid:4)(cid:14)(cid:11)(cid:48)(cid:48)(cid:7)(cid:5)(cid:3)(cid:9)(cid:2)(cid:28)(cid:3,,21909.0
,,46,,,Unknown,,cid:3)(cid:5)(cid:14)(cid:70)(cid:12)(cid:11)(cid:4)(cid:14)(cid:11)(cid:48)(cid:48)(cid:7)(cid:5)(cid:3)(cid:9)(cid:2)(cid:12)(cid:11)(cid:4)(cid:14)(cid:11)(cid:48)(cid:48)(cid:7)(cid:5)(cid:3)(cid:9)(cid:2)(cid:28)(cid:3,,21955.0
,,14,,,Unknown,,cid:3)(cid:5)(cid:14)(cid:70)(cid:12)(cid:11)(cid:4)(cid:14)(cid:11)(cid:48)(cid:48)(cid:7)(cid:5)(cid:3)(cid:9)(cid:2)(cid:12)(cid:11)(cid:4)(cid:14)(cid:11)(cid:48)(cid:48)(cid:7)(cid:5)(cid:3)(cid:9)(cid:2)(cid:28)(cid:3,,21969.0
,,50,,,Unknown,,cid:3)(cid:5)(cid:14)(cid:70)(cid:12)(cid:11)(cid:4)(cid:14)(cid:11)(cid:48)(cid:48)(cid:7)(cid:5)(cid:3)(cid:9)(cid:2)(cid:12)(cid:11)(cid:4)(cid:14)(cid:11)(cid:48)(cid:48)(cid:7)(cid:5)(cid:3)(cid:9)(cid:2)(cid:28)(cid:3,,22019.0
,,9,,,Unknown,,cid:3)(cid:5)(cid:14)(cid:70)(cid:12)(cid:11)(cid:4)(cid:14)(cid:11)(cid:48)(cid:48)(cid:7)(cid:5)(cid:3)(cid:9)(cid:2)(cid:12)(cid:11)(cid:4)(cid:14)(cid:11)(cid:48)(cid:48)(cid:7)(cid:5)(cid:3)(cid:9)(cid:2)(cid:28)(cid:3,,22028.0
,,17,,,Unknown,,cid:3)(cid:5)(cid:14)(cid:70)(cid:12)(cid:11)(cid:4)(cid:14)(cid:11)(cid:48)(cid:48)(cid:7)(cid:5)(cid:3)(cid:9)(cid:2)(cid:12)(cid:11)(cid:4)(cid:14)(cid:11)(cid:48)(cid:48)(cid:7)(cid:5)(cid:3)(cid:9)(cid:2)(cid:28)(cid:3,,22045.0
,,36,,,Unknown,,cid:3)(cid:5)(cid:14)(cid:70)(cid:12)(cid:11)(cid:4)(cid:14)(cid:11)(cid:48)(cid:48)(cid:7)(cid:5)(cid:3)(cid:9)(cid:2)(cid:12)(cid:11)(cid:4)(cid:14)(cid:11)(cid:48)(cid:48)(cid:7)(cid:5)(cid:3)(cid:9)(cid:2)(cid:28)(cid:3,,22081.0
,,18,,,Unknown,,cid:3)(cid:5)(cid:14)(cid:70)(cid:12)(cid:11)(cid:4)(cid:14)(cid:11)(cid:48)(cid:48)(cid:7)(cid:5)(cid:3)(cid:9)(cid:2)(cid:12)(cid:11)(cid:4)(cid:14)(cid:11)(cid:48)(cid:48)(cid:7)(cid:5)(cid:3)(cid:9)(cid:2)(cid:28)(cid:3,,22099.0
,,1,,,Unknown,,cid:3)(cid:5)(cid:14)(cid:70)(cid:12)(cid:11)(cid:4)(cid:14)(cid:11)(cid:48)(cid:48)(cid:7)(cid:5)(cid:3)(cid:9)(cid:2)(cid:12)(cid:11)(cid:4)(cid:14)(cid:11)(cid:48)(cid:48)(cid:7)(cid:5)(cid:3)(cid:9)(cid:2)(cid:28)(cid:3,,22100.0
,,2,,,Unknown,,cid:3)(cid:5)(cid:14)(cid:70)(cid:12)(cid:11)(cid:4)(cid:14)(cid:11)(cid:48)(cid:48)(cid:7)(cid:5)(cid:3)(cid:9)(cid:2)(cid:12)(cid:11)(cid:4)(cid:14)(cid:11)(cid:48)(cid:48)(cid:7)(cid:5)(cid:3)(cid:9)(cid:2)(cid:28)(cid:3,,22102.0
,,12,,,Unknown,,cid:3)(cid:5)(cid:14)(cid:70)(cid:12)(cid:11)(cid:4)(cid:14)(cid:11)(cid:48)(cid:48)(cid:7)(cid:5)(cid:3)(cid:9)(cid:2)(cid:12)(cid:11)(cid:4)(cid:14)(cid:11)(cid:48)(cid:48)(cid:7)(cid:5)(cid:3)(cid:9)(cid:2)(cid:28)(cid:3,,22114.0
,,11,,,Unknown,,cid:3)(cid:5)(cid:14)(cid:70)(cid:12)(cid:11)(cid:4)(cid:14)(cid:11)(cid:48)(cid:48)(cid:7)(cid:5)(cid:3)(cid:9)(cid:2)(cid:12)(cid:11)(cid:4)(cid:14)(cid:11)(cid:48)(cid:48)(cid:7)(cid:5)(cid:3)(cid:9)(cid:2)(cid:28)(cid:3,,22125.0
,,4,,,Unknown,,cid:3)(cid:5)(cid:14)(cid:70)(cid:12)(cid:11)(cid:4)(cid:14)(cid:11)(cid:48)(cid:48)(cid:7)(cid:5)(cid:3)(cid:9)(cid:2)(cid:12)(cid:11)(cid:4)(cid:14)(cid:11)(cid:48)(cid:48)(cid:7)(cid:5)(cid:3)(cid:9)(cid:2)(cid:28)(cid:3,,22129.0
,,7,,,Unknown,,cid:3)(cid:5)(cid:14)(cid:70)(cid:12)(cid:11)(cid:4)(cid:14)(cid:11)(cid:48)(cid:48)(cid:7)(cid:5)(cid:3)(cid:9)(cid:2)(cid:12)(cid:11)(cid:4)(cid:14)(cid:11)(cid:48)(cid:48)(cid:7)(cid:5)(cid:3)(cid:9)(cid:2)(cid:28)(cid:3,,22136.0
,,14,,,Unknown,,cid:3)(cid:5)(cid:14)(cid:70)(cid:12)(cid:11)(cid:4)(cid:14)(cid:11)(cid:48)(cid:48)(cid:7)(cid:5)(cid:3)(cid:9)(cid:2)(cid:12)(cid:11)(cid:4)(cid:14)(cid:11)(cid:48)(cid:48)(cid:7)(cid:5)(cid:3)(cid:9)(cid:2)(cid:28)(cid:3,,22150.0
,,14,,,Unknown,,cid:3)(cid:5)(cid:14)(cid:70)(cid:12)(cid:11)(cid:4)(cid:14)(cid:11)(cid:48)(cid:48)(cid:7)(cid:5)(cid:3)(cid:9)(cid:2)(cid:12)(cid:11)(cid:4)(cid:14)(cid:11)(cid:48)(cid:48)(cid:7)(cid:5)(cid:3)(cid:9)(cid:2)(cid:28)(cid:3,,22164.0
,,49,,,Unknown,,cid:3)(cid:5)(cid:14)(cid:70)(cid:12)(cid:11)(cid:4)(cid:14)(cid:11)(cid:48)(cid:48)(cid:7)(cid:5)(cid:3)(cid:9)(cid:2)(cid:12)(cid:11)(cid:4)(cid:14)(cid:11)(cid:48)(cid:48)(cid:7)(cid:5)(cid:3)(cid:9)(cid:2)(cid:28)(cid:3,,22213.0
,,2,,,Unknown,,cid:3)(cid:5)(cid:14)(cid:70)(cid:12)(cid:11)(cid:4)(cid:14)(cid:11)(cid:48)(cid:48)(cid:7)(cid:5)(cid:3)(cid:9)(cid:2)(cid:12)(cid:11)(cid:4)(cid:14)(cid:11)(cid:48)(cid:48)(cid:7)(cid:5)(cid:3)(cid:9)(cid:2)(cid:28)(cid:3,,22215.0
,,39,,,Unknown,,cid:3)(cid:5)(cid:14)(cid:70)(cid:12)(cid:11)(cid:4)(cid:14)(cid:11)(cid:48)(cid:48)(cid:7)(cid:5)(cid:3)(cid:9)(cid:2)(cid:12)(cid:11)(cid:4)(cid:14)(cid:11)(cid:48)(cid:48)(cid:7)(cid:5)(cid:3)(cid:9)(cid:2)(cid:28)(cid:3,,22254.0
,,11,,,Unknown,,cid:3)(cid:5)(cid:14)(cid:70)(cid:12)(cid:11)(cid:4)(cid:14)(cid:11)(cid:48)(cid:48)(cid:7)(cid:5)(cid:3)(cid:9)(cid:2)(cid:12)(cid:11)(cid:4)(cid:14)(cid:11)(cid:48)(cid:48)(cid:7)(cid:5)(cid:3)(cid:9)(cid:2)(cid:28)(cid:3,,22265.0
,,2,,,Unknown,,cid:3)(cid:5)(cid:14)(cid:70)(cid:12)(cid:11)(cid:4)(cid:14)(cid:11)(cid:48)(cid:48)(cid:7)(cid:5)(cid:3)(cid:9)(cid:2)(cid:12)(cid:11)(cid:4)(cid:14)(cid:11)(cid:48)(cid:48)(cid:7)(cid:5)(cid:3)(cid:9)(cid:2)(cid:28)(cid:3,,22267.0
,,28,,,Unknown,,cid:3)(cid:5)(cid:14)(cid:70)(cid:12)(cid:11)(cid:4)(cid:14)(cid:11)(cid:48)(cid:48)(cid:7)(cid:5)(cid:3)(cid:9)(cid:2)(cid:12)(cid:11)(cid:4)(cid:14)(cid:11)(cid:48)(cid:48)(cid:7)(cid:5)(cid:3)(cid:9)(cid:2)(cid:28)(cid:3,,22295.0
,,3,,,Unknown,,cid:3)(cid:5)(cid:14)(cid:70)(cid:12)(cid:11)(cid:4)(cid:14)(cid:11)(cid:48)(cid:48)(cid:7)(cid:5)(cid:3)(cid:9)(cid:2)(cid:12)(cid:11)(cid:4)(cid:14)(cid:11)(cid:48)(cid:48)(cid:7)(cid:5)(cid:3)(cid:9)(cid:2)(cid:28)(cid:3,,22298.0
,,15,,,Unknown,,cid:3)(cid:5)(cid:14)(cid:70)(cid:12)(cid:11)(cid:4)(cid:14)(cid:11)(cid:48)(cid:48)(cid:7)(cid:5)(cid:3)(cid:9)(cid:2)(cid:12)(cid:11)(cid:4)(cid:14)(cid:11)(cid:48)(cid:48)(cid:7)(cid:5)(cid:3)(cid:9)(cid:2)(cid:28)(cid:3,,22313.0
,,2,,,Unknown,,cid:3)(cid:5)(cid:14)(cid:70)(cid:12)(cid:11)(cid:4)(cid:14)(cid:11)(cid:48)(cid:48)(cid:7)(cid:5)(cid:3)(cid:9)(cid:2)(cid:12)(cid:11)(cid:4)(cid:14)(cid:11)(cid:48)(cid:48)(cid:7)(cid:5)(cid:3)(cid:9)(cid:2)(cid:28)(cid:3,,22315.0
,,37,,,Unknown,,cid:3)(cid:5)(cid:14)(cid:70)(cid:12)(cid:11)(cid:4)(cid:14)(cid:11)(cid:48)(cid:48)(cid:7)(cid:5)(cid:3)(cid:9)(cid:2)(cid:12)(cid:11)(cid:4)(cid:14)(cid:11)(cid:48)(cid:48)(cid:7)(cid:5)(cid:3)(cid:9)(cid:2)(cid:28)(cid:3,,22352.0
,,36,,,Unknown,,cid:3)(cid:5)(cid:14)(cid:70)(cid:12)(cid:11)(cid:4)(cid:14)(cid:11)(cid:48)(cid:48)(cid:7)(cid:5)(cid:3)(cid:9)(cid:2)(cid:12)(cid:11)(cid:4)(cid:14)(cid:11)(cid:48)(cid:48)(cid:7)(cid:5)(cid:3)(cid:9)(cid:2)(cid:28)(cid:3,,22388.0
,,19,,,Unknown,,cid:3)(cid:5)(cid:14)(cid:70)(cid:12)(cid:11)(cid:4)(cid:14)(cid:11)(cid:48)(cid:48)(cid:7)(cid:5)(cid:3)(cid:9)(cid:2)(cid:12)(cid:11)(cid:4)(cid:14)(cid:11)(cid:48)(cid:48)(cid:7)(cid:5)(cid:3)(cid:9)(cid:2)(cid:28)(cid:3,,22407.0
,,1,,,Unknown,,cid:3)(cid:5)(cid:14)(cid:70)(cid:12)(cid:11)(cid:4)(cid:14)(cid:11)(cid:48)(cid:48)(cid:7)(cid:5)(cid:3)(cid:9)(cid:2)(cid:12)(cid:11)(cid:4)(cid:14)(cid:11)(cid:48)(cid:48)(cid:7)(cid:5)(cid:3)(cid:9)(cid:2)(cid:28)(cid:3,,22408.0
,,34,,,Unknown,,cid:3)(cid:5)(cid:14)(cid:70)(cid:12)(cid:11)(cid:4)(cid:14)(cid:11)(cid:48)(cid:48)(cid:7)(cid:5)(cid:3)(cid:9)(cid:2)(cid:12)(cid:11)(cid:4)(cid:14)(cid:11)(cid:48)(cid:48)(cid:7)(cid:5)(cid:3)(cid:9)(cid:2)(cid:28)(cid:3,,22442.0
,,2,,,Unknown,,cid:3)(cid:5)(cid:14)(cid:70)(cid:12)(cid:11)(cid:4)(cid:14)(cid:11)(cid:48)(cid:48)(cid:7)(cid:5)(cid:3)(cid:9)(cid:2)(cid:12)(cid:11)(cid:4)(cid:14)(cid:11)(cid:48)(cid:48)(cid:7)(cid:5)(cid:3)(cid:9)(cid:2)(cid:28)(cid:3,,22444.0
,,44,,,Unknown,,cid:3)(cid:5)(cid:14)(cid:70)(cid:12)(cid:11)(cid:4)(cid:14)(cid:11)(cid:48)(cid:48)(cid:7)(cid:5)(cid:3)(cid:9)(cid:2)(cid:12)(cid:11)(cid:4)(cid:14)(cid:11)(cid:48)(cid:48)(cid:7)(cid:5)(cid:3)(cid:9)(cid:2)(cid:28)(cid:3,,22488.0
,,12,,,Unknown,,cid:3)(cid:5)(cid:14)(cid:70)(cid:12)(cid:11)(cid:4)(cid:14)(cid:11)(cid:48)(cid:48)(cid:7)(cid:5)(cid:3)(cid:9)(cid:2)(cid:12)(cid:11)(cid:4)(cid:14)(cid:11)(cid:48)(cid:48)(cid:7)(cid:5)(cid:3)(cid:9)(cid:2)(cid:28)(cid:3,,22500.0
,,29,,,Unknown,,cid:3)(cid:5)(cid:14)(cid:70)(cid:12)(cid:11)(cid:4)(cid:14)(cid:11)(cid:48)(cid:48)(cid:7)(cid:5)(cid:3)(cid:9)(cid:2)(cid:12)(cid:11)(cid:4)(cid:14)(cid:11)(cid:48)(cid:48)(cid:7)(cid:5)(cid:3)(cid:9)(cid:2)(cid:28)(cid:3,,22529.0
,,26,,,Unknown,,cid:3)(cid:5)(cid:14)(cid:70)(cid:12)(cid:11)(cid:4)(cid:14)(cid:11)(cid:48)(cid:48)(cid:7)(cid:5)(cid:3)(cid:9)(cid:2)(cid:12)(cid:11)(cid:4)(cid:14)(cid:11)(cid:48)(cid:48)(cid:7)(cid:5)(cid:3)(cid:9)(cid:2)(cid:28)(cid:3,,22555.0
,,41,,,Unknown,,cid:3)(cid:5)(cid:14)(cid:70)(cid:12)(cid:11)(cid:4)(cid:14)(cid:11)(cid:48)(cid:48)(cid:7)(cid:5)(cid:3)(cid:9)(cid:2)(cid:12)(cid:11)(cid:4)(cid:14)(cid:11)(cid:48)(cid:48)(cid:7)(cid:5)(cid:3)(cid:9)(cid:2)(cid:28)(cid:3,,22596.0
,,25,,,Unknown,,cid:3)(cid:5)(cid:14)(cid:70)(cid:12)(cid:11)(cid:4)(cid:14)(cid:11)(cid:48)(cid:48)(cid:7)(cid:5)(cid:3)(cid:9)(cid:2)(cid:12)(cid:11)(cid:4)(cid:14)(cid:11)(cid:48)(cid:48)(cid:7)(cid:5)(cid:3)(cid:9)(cid:2)(cid:28)(cid:3,,22621.0
,,2,,,Unknown,,cid:3)(cid:5)(cid:14)(cid:70)(cid:12)(cid:11)(cid:4)(cid:14)(cid:11)(cid:48)(cid:48)(cid:7)(cid:5)(cid:3)(cid:9)(cid:2)(cid:12)(cid:11)(cid:4)(cid:14)(cid:11)(cid:48)(cid:48)(cid:7)(cid:5)(cid:3)(cid:9)(cid:2)(cid:28)(cid:3,,22623.0
,,58,,,Unknown,,cid:3)(cid:5)(cid:14)(cid:70)(cid:12)(cid:11)(cid:4)(cid:14)(cid:11)(cid:48)(cid:48)(cid:7)(cid:5)(cid:3)(cid:9)(cid:2)(cid:12)(cid:11)(cid:4)(cid:14)(cid:11)(cid:48)(cid:48)(cid:7)(cid:5)(cid:3)(cid:9)(cid:2)(cid:28)(cid:3,,22681.0
,,58,,,Unknown,,cid:3)(cid:5)(cid:14)(cid:70)(cid:12)(cid:11)(cid:4)(cid:14)(cid:11)(cid:48)(cid:48)(cid:7)(cid:5)(cid:3)(cid:9)(cid:2)(cid:12)(cid:11)(cid:4)(cid:14)(cid:11)(cid:48)(cid:48)(cid:7)(cid:5)(cid:3)(cid:9)(cid:2)(cid:28)(cid:3,,22739.0
,,37,,,Unknown,,cid:3)(cid:5)(cid:14)(cid:70)(cid:12)(cid:11)(cid:4)(cid:14)(cid:11)(cid:48)(cid:48)(cid:7)(cid:5)(cid:3)(cid:9)(cid:2)(cid:12)(cid:11)(cid:4)(cid:14)(cid:11)(cid:48)(cid:48)(cid:7)(cid:5)(cid:3)(cid:9)(cid:2)(cid:28)(cid:3,,22776.0
,,16,,,Unknown,,cid:3)(cid:5)(cid:14)(cid:70)(cid:12)(cid:11)(cid:4)(cid:14)(cid:11)(cid:48)(cid:48)(cid:7)(cid:5)(cid:3)(cid:9)(cid:2)(cid:12)(cid:11)(cid:4)(cid:14)(cid:11)(cid:48)(cid:48)(cid:7)(cid:5)(cid:3)(cid:9)(cid:2)(cid:28)(cid:3,,22792.0
,,34,,,Unknown,,cid:3)(cid:5)(cid:14)(cid:70)(cid:12)(cid:11)(cid:4)(cid:14)(cid:11)(cid:48)(cid:48)(cid:7)(cid:5)(cid:3)(cid:9)(cid:2)(cid:12)(cid:11)(cid:4)(cid:14)(cid:11)(cid:48)(cid:48)(cid:7)(cid:5)(cid:3)(cid:9)(cid:2)(cid:28)(cid:3,,22826.0
,,33,,,Unknown,,cid:3)(cid:5)(cid:14)(cid:70)(cid:12)(cid:11)(cid:4)(cid:14)(cid:11)(cid:48)(cid:48)(cid:7)(cid:5)(cid:3)(cid:9)(cid:2)(cid:12)(cid:11)(cid:4)(cid:14)(cid:11)(cid:48)(cid:48)(cid:7)(cid:5)(cid:3)(cid:9)(cid:2)(cid:28)(cid:3,,22859.0
,,17,,,Unknown,,cid:3)(cid:5)(cid:14)(cid:70)(cid:12)(cid:11)(cid:4)(cid:14)(cid:11)(cid:48)(cid:48)(cid:7)(cid:5)(cid:3)(cid:9)(cid:2)(cid:12)(cid:11)(cid:4)(cid:14)(cid:11)(cid:48)(cid:48)(cid:7)(cid:5)(cid:3)(cid:9)(cid:2)(cid:28)(cid:3,,22876.0
,,33,,,Unknown,,cid:3)(cid:5)(cid:14)(cid:70)(cid:12)(cid:11)(cid:4)(cid:14)(cid:11)(cid:48)(cid:48)(cid:7)(cid:5)(cid:3)(cid:9)(cid:2)(cid:12)(cid:11)(cid:4)(cid:14)(cid:11)(cid:48)(cid:48)(cid:7)(cid:5)(cid:3)(cid:9)(cid:2)(cid:28)(cid:3,,22909.0
,,45,,,Unknown,,cid:3)(cid:5)(cid:14)(cid:70)(cid:12)(cid:11)(cid:4)(cid:14)(cid:11)(cid:48)(cid:48)(cid:7)(cid:5)(cid:3)(cid:9)(cid:2)(cid:12)(cid:11)(cid:4)(cid:14)(cid:11)(cid:48)(cid:48)(cid:7)(cid:5)(cid:3)(cid:9)(cid:2)(cid:28)(cid:3,,22954.0
,,18,,,Unknown,,cid:3)(cid:5)(cid:14)(cid:70)(cid:12)(cid:11)(cid:4)(cid:14)(cid:11)(cid:48)(cid:48)(cid:7)(cid:5)(cid:3)(cid:9)(cid:2)(cid:12)(cid:11)(cid:4)(cid:14)(cid:11)(cid:48)(cid:48)(cid:7)(cid:5)(cid:3)(cid:9)(cid:2)(cid:28)(cid:3,,22972.0
,,16,,,Unknown,,cid:3)(cid:5)(cid:14)(cid:70)(cid:12)(cid:11)(cid:4)(cid:14)(cid:11)(cid:48)(cid:48)(cid:7)(cid:5)(cid:3)(cid:9)(cid:2)(cid:12)(cid:11)(cid:4)(cid:14)(cid:11)(cid:48)(cid:48)(cid:7)(cid:5)(cid:3)(cid:9)(cid:2)(cid:28)(cid:3,,22988.0
,,11,,,Unknown,,cid:3)(cid:5)(cid:14)(cid:70)(cid:12)(cid:11)(cid:4)(cid:14)(cid:11)(cid:48)(cid:48)(cid:7)(cid:5)(cid:3)(cid:9)(cid:2)(cid:12)(cid:11)(cid:4)(cid:14)(cid:11)(cid:48)(cid:48)(cid:7)(cid:5)(cid:3)(cid:9)(cid:2)(cid:28)(cid:3,,22999.0
,,50,,,Unknown,,cid:3)(cid:5)(cid:14)(cid:70)(cid:12)(cid:11)(cid:4)(cid:14)(cid:11)(cid:48)(cid:48)(cid:7)(cid:5)(cid:3)(cid:9)(cid:2)(cid:12)(cid:11)(cid:4)(cid:14)(cid:11)(cid:48)(cid:48)(cid:7)(cid:5)(cid:3)(cid:9)(cid:2)(cid:28)(cid:3,,23049.0
,,7,,,Unknown,,cid:3)(cid:5)(cid:14)(cid:70)(cid:12)(cid:11)(cid:4)(cid:14)(cid:11)(cid:48)(cid:48)(cid:7)(cid:5)(cid:3)(cid:9)(cid:2)(cid:12)(cid:11)(cid:4)(cid:14)(cid:11)(cid:48)(cid:48)(cid:7)(cid:5)(cid:3)(cid:9)(cid:2)(cid:28)(cid:3,,23056.0
,,11,,,Unknown,,cid:3)(cid:5)(cid:14)(cid:70)(cid:12)(cid:11)(cid:4)(cid:14)(cid:11)(cid:48)(cid:48)(cid:7)(cid:5)(cid:3)(cid:9)(cid:2)(cid:12)(cid:11)(cid:4)(cid:14)(cid:11)(cid:48)(cid:48)(cid:7)(cid:5)(cid:3)(cid:9)(cid:2)(cid:28)(cid:3,,23067.0
,,8,,,Unknown,,cid:3)(cid:5)(cid:14)(cid:70)(cid:12)(cid:11)(cid:4)(cid:14)(cid:11)(cid:48)(cid:48)(cid:7)(cid:5)(cid:3)(cid:9)(cid:2)(cid:12)(cid:11)(cid:4)(cid:14)(cid:11)(cid:48)(cid:48)(cid:7)(cid:5)(cid:3)(cid:9)(cid:2)(cid:28)(cid:3,,23075.0
,,2,,,Unknown,,cid:3)(cid:5)(cid:14)(cid:70)(cid:12)(cid:11)(cid:4)(cid:14)(cid:11)(cid:48)(cid:48)(cid:7)(cid:5)(cid:3)(cid:9)(cid:2)(cid:12)(cid:11)(cid:4)(cid:14)(cid:11)(cid:48)(cid:48)(cid:7)(cid:5)(cid:3)(cid:9)(cid:2)(cid:28)(cid:3,,23077.0
,,9,,,Unknown,,cid:3)(cid:5)(cid:14)(cid:70)(cid:12)(cid:11)(cid:4)(cid:14)(cid:11)(cid:48)(cid:48)(cid:7)(cid:5)(cid:3)(cid:9)(cid:2)(cid:12)(cid:11)(cid:4)(cid:14)(cid:11)(cid:48)(cid:48)(cid:7)(cid:5)(cid:3)(cid:9)(cid:2)(cid:28)(cid:3,,23086.0
,,5,,,Unknown,,cid:3)(cid:5)(cid:14)(cid:70)(cid:12)(cid:11)(cid:4)(cid:14)(cid:11)(cid:48)(cid:48)(cid:7)(cid:5)(cid:3)(cid:9)(cid:2)(cid:12)(cid:11)(cid:4)(cid:14)(cid:11)(cid:48)(cid:48)(cid:7)(cid:5)(cid:3)(cid:9)(cid:2)(cid:28)(cid:3,,23091.0
,,39,,,Unknown,,cid:3)(cid:5)(cid:14)(cid:70)(cid:12)(cid:11)(cid:4)(cid:14)(cid:11)(cid:48)(cid:48)(cid:7)(cid:5)(cid:3)(cid:9)(cid:2)(cid:12)(cid:11)(cid:4)(cid:14)(cid:11)(cid:48)(cid:48)(cid:7)(cid:5)(cid:3)(cid:9)(cid:2)(cid:28)(cid:3,,23130.0
,,10,,,Unknown,,cid:3)(cid:5)(cid:14)(cid:70)(cid:12)(cid:11)(cid:4)(cid:14)(cid:11)(cid:48)(cid:48)(cid:7)(cid:5)(cid:3)(cid:9)(cid:2)(cid:12)(cid:11)(cid:4)(cid:14)(cid:11)(cid:48)(cid:48)(cid:7)(cid:5)(cid:3)(cid:9)(cid:2)(cid:28)(cid:3,,23140.0
,,15,,,Unknown,,cid:3)(cid:5)(cid:14)(cid:70)(cid:12)(cid:11)(cid:4)(cid:14)(cid:11)(cid:48)(cid:48)(cid:7)(cid:5)(cid:3)(cid:9)(cid:2)(cid:12)(cid:11)(cid:4)(cid:14)(cid:11)(cid:48)(cid:48)(cid:7)(cid:5)(cid:3)(cid:9)(cid:2)(cid:28)(cid:3,,23155.0
,,9,,,Unknown,,cid:3)(cid:5)(cid:14)(cid:70)(cid:12)(cid:11)(cid:4)(cid:14)(cid:11)(cid:48)(cid:48)(cid:7)(cid:5)(cid:3)(cid:9)(cid:2)(cid:12)(cid:11)(cid:4)(cid:14)(cid:11)(cid:48)(cid:48)(cid:7)(cid:5)(cid:3)(cid:9)(cid:2)(cid:28)(cid:3,,23164.0
,,11,,,Unknown,,cid:3)(cid:5)(cid:14)(cid:70)(cid:12)(cid:11)(cid:4)(cid:14)(cid:11)(cid:48)(cid:48)(cid:7)(cid:5)(cid:3)(cid:9)(cid:2)(cid:12)(cid:11)(cid:4)(cid:14)(cid:11)(cid:48)(cid:48)(cid:7)(cid:5)(cid:3)(cid:9)(cid:2)(cid:28)(cid:3,,23175.0
,,3,,,Unknown,,cid:3)(cid:5)(cid:14)(cid:70)(cid:12)(cid:11)(cid:4)(cid:14)(cid:11)(cid:48)(cid:48)(cid:7)(cid:5)(cid:3)(cid:9)(cid:2)(cid:12)(cid:11)(cid:4)(cid:14)(cid:11)(cid:48)(cid:48)(cid:7)(cid:5)(cid:3)(cid:9)(cid:2)(cid:28)(cid:3,,23178.0
,,10,,,Unknown,,cid:3)(cid:5)(cid:14)(cid:70)(cid:12)(cid:11)(cid:4)(cid:14)(cid:11)(cid:48)(cid:48)(cid:7)(cid:5)(cid:3)(cid:9)(cid:2)(cid:12)(cid:11)(cid:4)(cid:14)(cid:11)(cid:48)(cid:48)(cid:7)(cid:5)(cid:3)(cid:9)(cid:2)(cid:28)(cid:3,,23188.0
,,9,,,Unknown,,cid:3)(cid:5)(cid:14)(cid:70)(cid:12)(cid:11)(cid:4)(cid:14)(cid:11)(cid:48)(cid:48)(cid:7)(cid:5)(cid:3)(cid:9)(cid:2)(cid:12)(cid:11)(cid:4)(cid:14)(cid:11)(cid:48)(cid:48)(cid:7)(cid:5)(cid:3)(cid:9)(cid:2)(cid:28)(cid:3,,23197.0
,,2,,,Unknown,,cid:3)(cid:5)(cid:14)(cid:70)(cid:12)(cid:11)(cid:4)(cid:14)(cid:11)(cid:48)(cid:48)(cid:7)(cid:5)(cid:3)(cid:9)(cid:2)(cid:12)(cid:11)(cid:4)(cid:14)(cid:11)(cid:48)(cid:48)(cid:7)(cid:5)(cid:3)(cid:9)(cid:2)(cid:28)(cid:3,,23199.0
,,28,,,Unknown,,cid:3)(cid:5)(cid:14)(cid:70)(cid:12)(cid:11)(cid:4)(cid:14)(cid:11)(cid:48)(cid:48)(cid:7)(cid:5)(cid:3)(cid:9)(cid:2)(cid:12)(cid:11)(cid:4)(cid:14)(cid:11)(cid:48)(cid:48)(cid:7)(cid:5)(cid:3)(cid:9)(cid:2)(cid:28)(cid:3,,23227.0
,,3,,,Unknown,,cid:3)(cid:5)(cid:14)(cid:70)(cid:12)(cid:11)(cid:4)(cid:14)(cid:11)(cid:48)(cid:48)(cid:7)(cid:5)(cid:3)(cid:9)(cid:2)(cid:12)(cid:11)(cid:4)(cid:14)(cid:11)(cid:48)(cid:48)(cid:7)(cid:5)(cid:3)(cid:9)(cid:2)(cid:28)(cid:3,,23230.0
,,15,,,Unknown,,cid:3)(cid:5)(cid:14)(cid:70)(cid:12)(cid:11)(cid:4)(cid:14)(cid:11)(cid:48)(cid:48)(cid:7)(cid:5)(cid:3)(cid:9)(cid:2)(cid:12)(cid:11)(cid:4)(cid:14)(cid:11)(cid:48)(cid:48)(cid:7)(cid:5)(cid:3)(cid:9)(cid:2)(cid:28)(cid:3,,23245.0
,,2,,,Unknown,,cid:3)(cid:5)(cid:14)(cid:70)(cid:12)(cid:11)(cid:4)(cid:14)(cid:11)(cid:48)(cid:48)(cid:7)(cid:5)(cid:3)(cid:9)(cid:2)(cid:12)(cid:11)(cid:4)(cid:14)(cid:11)(cid:48)(cid:48)(cid:7)(cid:5)(cid:3)(cid:9)(cid:2)(cid:28)(cid:3,,23247.0
,,1,,,Unknown,,cid:3)(cid:5)(cid:14)(cid:70)(cid:12)(cid:11)(cid:4)(cid:14)(cid:11)(cid:48)(cid:48)(cid:7)(cid:5)(cid:3)(cid:9)(cid:2)(cid:12)(cid:11)(cid:4)(cid:14)(cid:11)(cid:48)(cid:48)(cid:7)(cid:5)(cid:3)(cid:9)(cid:2)(cid:28)(cid:3,,23248.0
,,33,,,Unknown,,cid:3)(cid:5)(cid:14)(cid:70)(cid:12)(cid:11)(cid:4)(cid:14)(cid:11)(cid:48)(cid:48)(cid:7)(cid:5)(cid:3)(cid:9)(cid:2)(cid:12)(cid:11)(cid:4)(cid:14)(cid:11)(cid:48)(cid:48)(cid:7)(cid:5)(cid:3)(cid:9)(cid:2)(cid:28)(cid:3,,23281.0
,,19,,,Unknown,,cid:3)(cid:5)(cid:14)(cid:70)(cid:12)(cid:11)(cid:4)(cid:14)(cid:11)(cid:48)(cid:48)(cid:7)(cid:5)(cid:3)(cid:9)(cid:2)(cid:12)(cid:11)(cid:4)(cid:14)(cid:11)(cid:48)(cid:48)(cid:7)(cid:5)(cid:3)(cid:9)(cid:2)(cid:28)(cid:3,,23300.0
,,1,,,Unknown,,cid:3)(cid:5)(cid:14)(cid:70)(cid:12)(cid:11)(cid:4)(cid:14)(cid:11)(cid:48)(cid:48)(cid:7)(cid:5)(cid:3)(cid:9)(cid:2)(cid:12)(cid:11)(cid:4)(cid:14)(cid:11)(cid:48)(cid:48)(cid:7)(cid:5)(cid:3)(cid:9)(cid:2)(cid:28)(cid:3,,23301.0
,,18,,,Unknown,,cid:3)(cid:5)(cid:14)(cid:70)(cid:12)(cid:11)(cid:4)(cid:14)(cid:11)(cid:48)(cid:48)(cid:7)(cid:5)(cid:3)(cid:9)(cid:2)(cid:12)(cid:11)(cid:4)(cid:14)(cid:11)(cid:48)(cid:48)(cid:7)(cid:5)(cid:3)(cid:9)(cid:2)(cid:28)(cid:3,,23319.0
,,2,,,Unknown,,cid:3)(cid:5)(cid:14)(cid:70)(cid:12)(cid:11)(cid:4)(cid:14)(cid:11)(cid:48)(cid:48)(cid:7)(cid:5)(cid:3)(cid:9)(cid:2)(cid:12)(cid:11)(cid:4)(cid:14)(cid:11)(cid:48)(cid:48)(cid:7)(cid:5)(cid:3)(cid:9)(cid:2)(cid:28)(cid:3,,23321.0
,,44,,,Unknown,,cid:3)(cid:5)(cid:14)(cid:70)(cid:12)(cid:11)(cid:4)(cid:14)(cid:11)(cid:48)(cid:48)(cid:7)(cid:5)(cid:3)(cid:9)(cid:2)(cid:12)(cid:11)(cid:4)(cid:14)(cid:11)(cid:48)(cid:48)(cid:7)(cid:5)(cid:3)(cid:9)(cid:2)(cid:28)(cid:3,,23365.0
,,12,,,Unknown,,cid:3)(cid:5)(cid:14)(cid:70)(cid:12)(cid:11)(cid:4)(cid:14)(cid:11)(cid:48)(cid:48)(cid:7)(cid:5)(cid:3)(cid:9)(cid:2)(cid:12)(cid:11)(cid:4)(cid:14)(cid:11)(cid:48)(cid:48)(cid:7)(cid:5)(cid:3)(cid:9)(cid:2)(cid:28)(cid:3,,23377.0
,,29,,,Unknown,,cid:3)(cid:5)(cid:14)(cid:70)(cid:12)(cid:11)(cid:4)(cid:14)(cid:11)(cid:48)(cid:48)(cid:7)(cid:5)(cid:3)(cid:9)(cid:2)(cid:12)(cid:11)(cid:4)(cid:14)(cid:11)(cid:48)(cid:48)(cid:7)(cid:5)(cid:3)(cid:9)(cid:2)(cid:28)(cid:3,,23406.0
,,26,,,Unknown,,cid:3)(cid:5)(cid:14)(cid:70)(cid:12)(cid:11)(cid:4)(cid:14)(cid:11)(cid:48)(cid:48)(cid:7)(cid:5)(cid:3)(cid:9)(cid:2)(cid:12)(cid:11)(cid:4)(cid:14)(cid:11)(cid:48)(cid:48)(cid:7)(cid:5)(cid:3)(cid:9)(cid:2)(cid:28)(cid:3,,23432.0
,,41,,,Unknown,,cid:3)(cid:5)(cid:14)(cid:70)(cid:12)(cid:11)(cid:4)(cid:14)(cid:11)(cid:48)(cid:48)(cid:7)(cid:5)(cid:3)(cid:9)(cid:2)(cid:12)(cid:11)(cid:4)(cid:14)(cid:11)(cid:48)(cid:48)(cid:7)(cid:5)(cid:3)(cid:9)(cid:2)(cid:28)(cid:3,,23473.0
,,25,,,Unknown,,cid:3)(cid:5)(cid:14)(cid:70)(cid:12)(cid:11)(cid:4)(cid:14)(cid:11)(cid:48)(cid:48)(cid:7)(cid:5)(cid:3)(cid:9)(cid:2)(cid:12)(cid:11)(cid:4)(cid:14)(cid:11)(cid:48)(cid:48)(cid:7)(cid:5)(cid:3)(cid:9)(cid:2)(cid:28)(cid:3,,23498.0
,,2,,,Unknown,,cid:3)(cid:5)(cid:14)(cid:70)(cid:12)(cid:11)(cid:4)(cid:14)(cid:11)(cid:48)(cid:48)(cid:7)(cid:5)(cid:3)(cid:9)(cid:2)(cid:12)(cid:11)(cid:4)(cid:14)(cid:11)(cid:48)(cid:48)(cid:7)(cid:5)(cid:3)(cid:9)(cid:2)(cid:28)(cid:3,,23500.0
,,58,,,Unknown,,cid:3)(cid:5)(cid:14)(cid:70)(cid:12)(cid:11)(cid:4)(cid:14)(cid:11)(cid:48)(cid:48)(cid:7)(cid:5)(cid:3)(cid:9)(cid:2)(cid:12)(cid:11)(cid:4)(cid:14)(cid:11)(cid:48)(cid:48)(cid:7)(cid:5)(cid:3)(cid:9)(cid:2)(cid:28)(cid:3,,23558.0
,,58,,,Unknown,,cid:3)(cid:5)(cid:14)(cid:70)(cid:12)(cid:11)(cid:4)(cid:14)(cid:11)(cid:48)(cid:48)(cid:7)(cid:5)(cid:3)(cid:9)(cid:2)(cid:12)(cid:11)(cid:4)(cid:14)(cid:11)(cid:48)(cid:48)(cid:7)(cid:5)(cid:3)(cid:9)(cid:2)(cid:28)(cid:3,,23616.0
,,18,,,Unknown,,cid:3)(cid:5)(cid:14)(cid:70)(cid:12)(cid:11)(cid:4)(cid:14)(cid:11)(cid:48)(cid:48)(cid:7)(cid:5)(cid:3)(cid:9)(cid:2)(cid:12)(cid:11)(cid:4)(cid:14)(cid:11)(cid:48)(cid:48)(cid:7)(cid:5)(cid:3)(cid:9)(cid:2)(cid:28)(cid:3,,23634.0
,,1,,,Unknown,,cid:3)(cid:5)(cid:14)(cid:70)(cid:12)(cid:11)(cid:4)(cid:14)(cid:11)(cid:48)(cid:48)(cid:7)(cid:5)(cid:3)(cid:9)(cid:2)(cid:12)(cid:11)(cid:4)(cid:14)(cid:11)(cid:48)(cid:48)(cid:7)(cid:5)(cid:3)(cid:9)(cid:2)(cid:28)(cid:3,,23635.0
,,1,,,Unknown,,cid:3)(cid:5)(cid:14)(cid:70)(cid:12)(cid:11)(cid:4)(cid:14)(cid:11)(cid:48)(cid:48)(cid:7)(cid:5)(cid:3)(cid:9)(cid:2)(cid:12)(cid:11)(cid:4)(cid:14)(cid:11)(cid:48)(cid:48)(cid:7)(cid:5)(cid:3)(cid:9)(cid:2)(cid:28)(cid:3,,23636.0
,,37,,,Unknown,,cid:3)(cid:5)(cid:14)(cid:70)(cid:12)(cid:11)(cid:4)(cid:14)(cid:11)(cid:48)(cid:48)(cid:7)(cid:5)(cid:3)(cid:9)(cid:2)(cid:12)(cid:11)(cid:4)(cid:14)(cid:11)(cid:48)(cid:48)(cid:7)(cid:5)(cid:3)(cid:9)(cid:2)(cid:28)(cid:3,,23673.0
,,1,,,Unknown,,cid:3)(cid:5)(cid:14)(cid:70)(cid:12)(cid:11)(cid:4)(cid:14)(cid:11)(cid:48)(cid:48)(cid:7)(cid:5)(cid:3)(cid:9)(cid:2)(cid:12)(cid:11)(cid:4)(cid:14)(cid:11)(cid:48)(cid:48)(cid:7)(cid:5)(cid:3)(cid:9)(cid:2)(cid:28)(cid:3,,23674.0
,,18,,,Unknown,,cid:3)(cid:5)(cid:14)(cid:70)(cid:12)(cid:11)(cid:4)(cid:14)(cid:11)(cid:48)(cid:48)(cid:7)(cid:5)(cid:3)(cid:9)(cid:2)(cid:12)(cid:11)(cid:4)(cid:14)(cid:11)(cid:48)(cid:48)(cid:7)(cid:5)(cid:3)(cid:9)(cid:2)(cid:28)(cid:3,,23692.0
,,45,,,Unknown,,cid:3)(cid:5)(cid:14)(cid:70)(cid:12)(cid:11)(cid:4)(cid:14)(cid:11)(cid:48)(cid:48)(cid:7)(cid:5)(cid:3)(cid:9)(cid:2)(cid:12)(cid:11)(cid:4)(cid:14)(cid:11)(cid:48)(cid:48)(cid:7)(cid:5)(cid:3)(cid:9)(cid:2)(cid:28)(cid:3,,23737.0
,,18,,,Unknown,,cid:3)(cid:5)(cid:14)(cid:70)(cid:12)(cid:11)(cid:4)(cid:14)(cid:11)(cid:48)(cid:48)(cid:7)(cid:5)(cid:3)(cid:9)(cid:2)(cid:12)(cid:11)(cid:4)(cid:14)(cid:11)(cid:48)(cid:48)(cid:7)(cid:5)(cid:3)(cid:9)(cid:2)(cid:28)(cid:3,,23755.0
,,16,,,Unknown,,cid:3)(cid:5)(cid:14)(cid:70)(cid:12)(cid:11)(cid:4)(cid:14)(cid:11)(cid:48)(cid:48)(cid:7)(cid:5)(cid:3)(cid:9)(cid:2)(cid:12)(cid:11)(cid:4)(cid:14)(cid:11)(cid:48)(cid:48)(cid:7)(cid:5)(cid:3)(cid:9)(cid:2)(cid:28)(cid:3,,23771.0
,,14,,,Unknown,,cid:3)(cid:5)(cid:14)(cid:70)(cid:12)(cid:11)(cid:4)(cid:14)(cid:11)(cid:48)(cid:48)(cid:7)(cid:5)(cid:3)(cid:9)(cid:2)(cid:12)(cid:11)(cid:4)(cid:14)(cid:11)(cid:48)(cid:48)(cid:7)(cid:5)(cid:3)(cid:9)(cid:2)(cid:28)(cid:3,,23785.0
,,46,,,Unknown,,cid:3)(cid:5)(cid:14)(cid:70)(cid:12)(cid:11)(cid:4)(cid:14)(cid:11)(cid:48)(cid:48)(cid:7)(cid:5)(cid:3)(cid:9)(cid:2)(cid:12)(cid:11)(cid:4)(cid:14)(cid:11)(cid:48)(cid:48)(cid:7)(cid:5)(cid:3)(cid:9)(cid:2)(cid:28)(cid:3,,23831.0
,,2,,,Unknown,,cid:3)(cid:5)(cid:14)(cid:70)(cid:12)(cid:11)(cid:4)(cid:14)(cid:11)(cid:48)(cid:48)(cid:7)(cid:5)(cid:3)(cid:9)(cid:2)(cid:12)(cid:11)(cid:4)(cid:14)(cid:11)(cid:48)(cid:48)(cid:7)(cid:5)(cid:3)(cid:9)(cid:2)(cid:28)(cid:3,,23833.0
,,39,,,Unknown,,cid:3)(cid:5)(cid:14)(cid:70)(cid:12)(cid:11)(cid:4)(cid:14)(cid:11)(cid:48)(cid:48)(cid:7)(cid:5)(cid:3)(cid:9)(cid:2)(cid:12)(cid:11)(cid:4)(cid:14)(cid:11)(cid:48)(cid:48)(cid:7)(cid:5)(cid:3)(cid:9)(cid:2)(cid:28)(cid:3,,23872.0
,,11,,,Unknown,,cid:3)(cid:5)(cid:14)(cid:70)(cid:12)(cid:11)(cid:4)(cid:14)(cid:11)(cid:48)(cid:48)(cid:7)(cid:5)(cid:3)(cid:9)(cid:2)(cid:12)(cid:11)(cid:4)(cid:14)(cid:11)(cid:48)(cid:48)(cid:7)(cid:5)(cid:3)(cid:9)(cid:2)(cid:28)(cid:3,,23883.0
,,9,,,Unknown,,cid:3)(cid:5)(cid:14)(cid:70)(cid:12)(cid:11)(cid:4)(cid:14)(cid:11)(cid:48)(cid:48)(cid:7)(cid:5)(cid:3)(cid:9)(cid:2)(cid:12)(cid:11)(cid:4)(cid:14)(cid:11)(cid:48)(cid:48)(cid:7)(cid:5)(cid:3)(cid:9)(cid:2)(cid:28)(cid:3,,23892.0
,,10,,,Unknown,,cid:3)(cid:5)(cid:14)(cid:70)(cid:12)(cid:11)(cid:4)(cid:14)(cid:11)(cid:48)(cid:48)(cid:7)(cid:5)(cid:3)(cid:9)(cid:2)(cid:12)(cid:11)(cid:4)(cid:14)(cid:11)(cid:48)(cid:48)(cid:7)(cid:5)(cid:3)(cid:9)(cid:2)(cid:28)(cid:3,,23902.0
,,5,,,Unknown,,cid:3)(cid:5)(cid:14)(cid:70)(cid:12)(cid:11)(cid:4)(cid:14)(cid:11)(cid:48)(cid:48)(cid:7)(cid:5)(cid:3)(cid:9)(cid:2)(cid:12)(cid:11)(cid:4)(cid:14)(cid:11)(cid:48)(cid:48)(cid:7)(cid:5)(cid:3)(cid:9)(cid:2)(cid:28)(cid:3,,23907.0
,,2,,,Unknown,,cid:3)(cid:5)(cid:14)(cid:70)(cid:12)(cid:11)(cid:4)(cid:14)(cid:11)(cid:48)(cid:48)(cid:7)(cid:5)(cid:3)(cid:9)(cid:2)(cid:12)(cid:11)(cid:4)(cid:14)(cid:11)(cid:48)(cid:48)(cid:7)(cid:5)(cid:3)(cid:9)(cid:2)(cid:28)(cid:3,,23909.0
,,14,,,Unknown,,cid:3)(cid:5)(cid:14)(cid:70)(cid:12)(cid:11)(cid:4)(cid:14)(cid:11)(cid:48)(cid:48)(cid:7)(cid:5)(cid:3)(cid:9)(cid:2)(cid:12)(cid:11)(cid:4)(cid:14)(cid:11)(cid:48)(cid:48)(cid:7)(cid:5)(cid:3)(cid:9)(cid:2)(cid:28)(cid:3,,23923.0
,,16,,,Unknown,,cid:3)(cid:5)(cid:14)(cid:70)(cid:12)(cid:11)(cid:4)(cid:14)(cid:11)(cid:48)(cid:48)(cid:7)(cid:5)(cid:3)(cid:9)(cid:2)(cid:12)(cid:11)(cid:4)(cid:14)(cid:11)(cid:48)(cid:48)(cid:7)(cid:5)(cid:3)(cid:9)(cid:2)(cid:28)(cid:3,,23939.0
,,16,,,Unknown,,cid:3)(cid:5)(cid:14)(cid:70)(cid:12)(cid:11)(cid:4)(cid:14)(cid:11)(cid:48)(cid:48)(cid:7)(cid:5)(cid:3)(cid:9)(cid:2)(cid:12)(cid:11)(cid:4)(cid:14)(cid:11)(cid:48)(cid:48)(cid:7)(cid:5)(cid:3)(cid:9)(cid:2)(cid:28)(cid:3,,23955.0
,,17,,,Unknown,,cid:3)(cid:5)(cid:14)(cid:70)(cid:12)(cid:11)(cid:4)(cid:14)(cid:11)(cid:48)(cid:48)(cid:7)(cid:5)(cid:3)(cid:9)(cid:2)(cid:12)(cid:11)(cid:4)(cid:14)(cid:11)(cid:48)(cid:48)(cid:7)(cid:5)(cid:3)(cid:9)(cid:2)(cid:28)(cid:3,,23972.0
,,37,,,Unknown,,cid:3)(cid:5)(cid:14)(cid:70)(cid:12)(cid:11)(cid:4)(cid:14)(cid:11)(cid:48)(cid:48)(cid:7)(cid:5)(cid:3)(cid:9)(cid:2)(cid:12)(cid:11)(cid:4)(cid:14)(cid:11)(cid:48)(cid:48)(cid:7)(cid:5)(cid:3)(cid:9)(cid:2)(cid:28)(cid:3,,24009.0
,,17,,,Unknown,,cid:3)(cid:5)(cid:14)(cid:70)(cid:12)(cid:11)(cid:4)(cid:14)(cid:11)(cid:48)(cid:48)(cid:7)(cid:5)(cid:3)(cid:9)(cid:2)(cid:12)(cid:11)(cid:4)(cid:14)(cid:11)(cid:48)(cid:48)(cid:7)(cid:5)(cid:3)(cid:9)(cid:2)(cid:28)(cid:3,,24026.0
,,18,,,Unknown,,cid:3)(cid:5)(cid:14)(cid:70)(cid:12)(cid:11)(cid:4)(cid:14)(cid:11)(cid:48)(cid:48)(cid:7)(cid:5)(cid:3)(cid:9)(cid:2)(cid:12)(cid:11)(cid:4)(cid:14)(cid:11)(cid:48)(cid:48)(cid:7)(cid:5)(cid:3)(cid:9)(cid:2)(cid:28)(cid:3,,24044.0
,,2,,,Unknown,,cid:3)(cid:5)(cid:14)(cid:70)(cid:12)(cid:11)(cid:4)(cid:14)(cid:11)(cid:48)(cid:48)(cid:7)(cid:5)(cid:3)(cid:9)(cid:2)(cid:12)(cid:11)(cid:4)(cid:14)(cid:11)(cid:48)(cid:48)(cid:7)(cid:5)(cid:3)(cid:9)(cid:2)(cid:28)(cid:3,,24046.0
,,12,,,Unknown,,cid:3)(cid:5)(cid:14)(cid:70)(cid:12)(cid:11)(cid:4)(cid:14)(cid:11)(cid:48)(cid:48)(cid:7)(cid:5)(cid:3)(cid:9)(cid:2)(cid:12)(cid:11)(cid:4)(cid:14)(cid:11)(cid:48)(cid:48)(cid:7)(cid:5)(cid:3)(cid:9)(cid:2)(cid:28)(cid:3,,24058.0
,,11,,,Unknown,,cid:3)(cid:5)(cid:14)(cid:70)(cid:12)(cid:11)(cid:4)(cid:14)(cid:11)(cid:48)(cid:48)(cid:7)(cid:5)(cid:3)(cid:9)(cid:2)(cid:12)(cid:11)(cid:4)(cid:14)(cid:11)(cid:48)(cid:48)(cid:7)(cid:5)(cid:3)(cid:9)(cid:2)(cid:28)(cid:3,,24069.0
,,4,,,Unknown,,cid:3)(cid:5)(cid:14)(cid:70)(cid:12)(cid:11)(cid:4)(cid:14)(cid:11)(cid:48)(cid:48)(cid:7)(cid:5)(cid:3)(cid:9)(cid:2)(cid:12)(cid:11)(cid:4)(cid:14)(cid:11)(cid:48)(cid:48)(cid:7)(cid:5)(cid:3)(cid:9)(cid:2)(cid:28)(cid:3,,24073.0
,,14,,,Unknown,,cid:3)(cid:5)(cid:14)(cid:70)(cid:12)(cid:11)(cid:4)(cid:14)(cid:11)(cid:48)(cid:48)(cid:7)(cid:5)(cid:3)(cid:9)(cid:2)(cid:12)(cid:11)(cid:4)(cid:14)(cid:11)(cid:48)(cid:48)(cid:7)(cid:5)(cid:3)(cid:9)(cid:2)(cid:28)(cid:3,,24087.0
,,11,,,Unknown,,cid:3)(cid:5)(cid:14)(cid:70)(cid:12)(cid:11)(cid:4)(cid:14)(cid:11)(cid:48)(cid:48)(cid:7)(cid:5)(cid:3)(cid:9)(cid:2)(cid:12)(cid:11)(cid:4)(cid:14)(cid:11)(cid:48)(cid:48)(cid:7)(cid:5)(cid:3)(cid:9)(cid:2)(cid:28)(cid:3,,24098.0
,,48,,,Unknown,,cid:3)(cid:5)(cid:14)(cid:70)(cid:12)(cid:11)(cid:4)(cid:14)(cid:11)(cid:48)(cid:48)(cid:7)(cid:5)(cid:3)(cid:9)(cid:2)(cid:12)(cid:11)(cid:4)(cid:14)(cid:11)(cid:48)(cid:48)(cid:7)(cid:5)(cid:3)(cid:9)(cid:2)(cid:28)(cid:3,,24146.0
,,48,,,Unknown,,cid:3)(cid:5)(cid:14)(cid:70)(cid:12)(cid:11)(cid:4)(cid:14)(cid:11)(cid:48)(cid:48)(cid:7)(cid:5)(cid:3)(cid:9)(cid:2)(cid:12)(cid:11)(cid:4)(cid:14)(cid:11)(cid:48)(cid:48)(cid:7)(cid:5)(cid:3)(cid:9)(cid:2)(cid:28)(cid:3,,24194.0
,,7,,,Unknown,,cid:3)(cid:5)(cid:14)(cid:70)(cid:12)(cid:11)(cid:4)(cid:14)(cid:11)(cid:48)(cid:48)(cid:7)(cid:5)(cid:3)(cid:9)(cid:2)(cid:12)(cid:11)(cid:4)(cid:14)(cid:11)(cid:48)(cid:48)(cid:7)(cid:5)(cid:3)(cid:9)(cid:2)(cid:28)(cid:3,,24201.0
,,5,,,Unknown,,cid:3)(cid:5)(cid:14)(cid:70)(cid:12)(cid:11)(cid:4)(cid:14)(cid:11)(cid:48)(cid:48)(cid:7)(cid:5)(cid:3)(cid:9)(cid:2)(cid:12)(cid:11)(cid:4)(cid:14)(cid:11)(cid:48)(cid:48)(cid:7)(cid:5)(cid:3)(cid:9)(cid:2)(cid:28)(cid:3,,24206.0
,,3,,,Unknown,,cid:3)(cid:5)(cid:14)(cid:70)(cid:12)(cid:11)(cid:4)(cid:14)(cid:11)(cid:48)(cid:48)(cid:7)(cid:5)(cid:3)(cid:9)(cid:2)(cid:12)(cid:11)(cid:4)(cid:14)(cid:11)(cid:48)(cid:48)(cid:7)(cid:5)(cid:3)(cid:9)(cid:2)(cid:28)(cid:3,,24209.0
,,9,,,Unknown,,cid:3)(cid:5)(cid:14)(cid:70)(cid:12)(cid:11)(cid:4)(cid:14)(cid:11)(cid:48)(cid:48)(cid:7)(cid:5)(cid:3)(cid:9)(cid:2)(cid:12)(cid:11)(cid:4)(cid:14)(cid:11)(cid:48)(cid:48)(cid:7)(cid:5)(cid:3)(cid:9)(cid:2)(cid:28)(cid:3,,24218.0
,,2,,,Unknown,,cid:3)(cid:5)(cid:14)(cid:70)(cid:12)(cid:11)(cid:4)(cid:14)(cid:11)(cid:48)(cid:48)(cid:7)(cid:5)(cid:3)(cid:9)(cid:2)(cid:12)(cid:11)(cid:4)(cid:14)(cid:11)(cid:48)(cid:48)(cid:7)(cid:5)(cid:3)(cid:9)(cid:2)(cid:28)(cid:3,,24220.0
,,28,,,Unknown,,cid:3)(cid:5)(cid:14)(cid:70)(cid:12)(cid:11)(cid:4)(cid:14)(cid:11)(cid:48)(cid:48)(cid:7)(cid:5)(cid:3)(cid:9)(cid:2)(cid:12)(cid:11)(cid:4)(cid:14)(cid:11)(cid:48)(cid:48)(cid:7)(cid:5)(cid:3)(cid:9)(cid:2)(cid:28)(cid:3,,24248.0
,,3,,,Unknown,,cid:3)(cid:5)(cid:14)(cid:70)(cid:12)(cid:11)(cid:4)(cid:14)(cid:11)(cid:48)(cid:48)(cid:7)(cid:5)(cid:3)(cid:9)(cid:2)(cid:12)(cid:11)(cid:4)(cid:14)(cid:11)(cid:48)(cid:48)(cid:7)(cid:5)(cid:3)(cid:9)(cid:2)(cid:28)(cid:3,,24251.0
,,15,,,Unknown,,cid:3)(cid:5)(cid:14)(cid:70)(cid:12)(cid:11)(cid:4)(cid:14)(cid:11)(cid:48)(cid:48)(cid:7)(cid:5)(cid:3)(cid:9)(cid:2)(cid:12)(cid:11)(cid:4)(cid:14)(cid:11)(cid:48)(cid:48)(cid:7)(cid:5)(cid:3)(cid:9)(cid:2)(cid:28)(cid:3,,24266.0
,,2,,,Unknown,,cid:3)(cid:5)(cid:14)(cid:70)(cid:12)(cid:11)(cid:4)(cid:14)(cid:11)(cid:48)(cid:48)(cid:7)(cid:5)(cid:3)(cid:9)(cid:2)(cid:12)(cid:11)(cid:4)(cid:14)(cid:11)(cid:48)(cid:48)(cid:7)(cid:5)(cid:3)(cid:9)(cid:2)(cid:28)(cid:3,,24268.0
,,36,,,Unknown,,cid:3)(cid:5)(cid:14)(cid:70)(cid:12)(cid:11)(cid:4)(cid:14)(cid:11)(cid:48)(cid:48)(cid:7)(cid:5)(cid:3)(cid:9)(cid:2)(cid:12)(cid:11)(cid:4)(cid:14)(cid:11)(cid:48)(cid:48)(cid:7)(cid:5)(cid:3)(cid:9)(cid:2)(cid:28)(cid:3,,24304.0
,,19,,,Unknown,,cid:3)(cid:5)(cid:14)(cid:70)(cid:12)(cid:11)(cid:4)(cid:14)(cid:11)(cid:48)(cid:48)(cid:7)(cid:5)(cid:3)(cid:9)(cid:2)(cid:12)(cid:11)(cid:4)(cid:14)(cid:11)(cid:48)(cid:48)(cid:7)(cid:5)(cid:3)(cid:9)(cid:2)(cid:28)(cid:3,,24323.0
,,1,,,Unknown,,cid:3)(cid:5)(cid:14)(cid:70)(cid:12)(cid:11)(cid:4)(cid:14)(cid:11)(cid:48)(cid:48)(cid:7)(cid:5)(cid:3)(cid:9)(cid:2)(cid:12)(cid:11)(cid:4)(cid:14)(cid:11)(cid:48)(cid:48)(cid:7)(cid:5)(cid:3)(cid:9)(cid:2)(cid:28)(cid:3,,24324.0
,,18,,,Unknown,,cid:3)(cid:5)(cid:14)(cid:70)(cid:12)(cid:11)(cid:4)(cid:14)(cid:11)(cid:48)(cid:48)(cid:7)(cid:5)(cid:3)(cid:9)(cid:2)(cid:12)(cid:11)(cid:4)(cid:14)(cid:11)(cid:48)(cid:48)(cid:7)(cid:5)(cid:3)(cid:9)(cid:2)(cid:28)(cid:3,,24342.0
,,2,,,Unknown,,cid:3)(cid:5)(cid:14)(cid:70)(cid:12)(cid:11)(cid:4)(cid:14)(cid:11)(cid:48)(cid:48)(cid:7)(cid:5)(cid:3)(cid:9)(cid:2)(cid:12)(cid:11)(cid:4)(cid:14)(cid:11)(cid:48)(cid:48)(cid:7)(cid:5)(cid:3)(cid:9)(cid:2)(cid:28)(cid:3,,24344.0
,,44,,,Unknown,,cid:3)(cid:5)(cid:14)(cid:70)(cid:12)(cid:11)(cid:4)(cid:14)(cid:11)(cid:48)(cid:48)(cid:7)(cid:5)(cid:3)(cid:9)(cid:2)(cid:12)(cid:11)(cid:4)(cid:14)(cid:11)(cid:48)(cid:48)(cid:7)(cid:5)(cid:3)(cid:9)(cid:2)(cid:28)(cid:3,,24388.0
,,12,,,Unknown,,cid:3)(cid:5)(cid:14)(cid:70)(cid:12)(cid:11)(cid:4)(cid:14)(cid:11)(cid:48)(cid:48)(cid:7)(cid:5)(cid:3)(cid:9)(cid:2)(cid:12)(cid:11)(cid:4)(cid:14)(cid:11)(cid:48)(cid:48)(cid:7)(cid:5)(cid:3)(cid:9)(cid:2)(cid:28)(cid:3,,24400.0
,,29,,,Unknown,,cid:3)(cid:5)(cid:14)(cid:70)(cid:12)(cid:11)(cid:4)(cid:14)(cid:11)(cid:48)(cid:48)(cid:7)(cid:5)(cid:3)(cid:9)(cid:2)(cid:12)(cid:11)(cid:4)(cid:14)(cid:11)(cid:48)(cid:48)(cid:7)(cid:5)(cid:3)(cid:9)(cid:2)(cid:28)(cid:3,,24429.0
,,26,,,Unknown,,cid:3)(cid:5)(cid:14)(cid:70)(cid:12)(cid:11)(cid:4)(cid:14)(cid:11)(cid:48)(cid:48)(cid:7)(cid:5)(cid:3)(cid:9)(cid:2)(cid:12)(cid:11)(cid:4)(cid:14)(cid:11)(cid:48)(cid:48)(cid:7)(cid:5)(cid:3)(cid:9)(cid:2)(cid:28)(cid:3,,24455.0
,,41,,,Unknown,,cid:3)(cid:5)(cid:14)(cid:70)(cid:12)(cid:11)(cid:4)(cid:14)(cid:11)(cid:48)(cid:48)(cid:7)(cid:5)(cid:3)(cid:9)(cid:2)(cid:12)(cid:11)(cid:4)(cid:14)(cid:11)(cid:48)(cid:48)(cid:7)(cid:5)(cid:3)(cid:9)(cid:2)(cid:28)(cid:3,,24496.0
,,25,,,Unknown,,cid:3)(cid:5)(cid:14)(cid:70)(cid:12)(cid:11)(cid:4)(cid:14)(cid:11)(cid:48)(cid:48)(cid:7)(cid:5)(cid:3)(cid:9)(cid:2)(cid:12)(cid:11)(cid:4)(cid:14)(cid:11)(cid:48)(cid:48)(cid:7)(cid:5)(cid:3)(cid:9)(cid:2)(cid:28)(cid:3,,24521.0
,,2,,,Unknown,,cid:3)(cid:5)(cid:14)(cid:70)(cid:12)(cid:11)(cid:4)(cid:14)(cid:11)(cid:48)(cid:48)(cid:7)(cid:5)(cid:3)(cid:9)(cid:2)(cid:12)(cid:11)(cid:4)(cid:14)(cid:11)(cid:48)(cid:48)(cid:7)(cid:5)(cid:3)(cid:9)(cid:2)(cid:28)(cid:3,,24523.0
,,58,,,Unknown,,cid:3)(cid:5)(cid:14)(cid:70)(cid:12)(cid:11)(cid:4)(cid:14)(cid:11)(cid:48)(cid:48)(cid:7)(cid:5)(cid:3)(cid:9)(cid:2)(cid:12)(cid:11)(cid:4)(cid:14)(cid:11)(cid:48)(cid:48)(cid:7)(cid:5)(cid:3)(cid:9)(cid:2)(cid:28)(cid:3,,24581.0
,,58,,,Unknown,,cid:3)(cid:5)(cid:14)(cid:70)(cid:12)(cid:11)(cid:4)(cid:14)(cid:11)(cid:48)(cid:48)(cid:7)(cid:5)(cid:3)(cid:9)(cid:2)(cid:12)(cid:11)(cid:4)(cid:14)(cid:11)(cid:48)(cid:48)(cid:7)(cid:5)(cid:3)(cid:9)(cid:2)(cid:28)(cid:3,,24639.0
,,37,,,Unknown,,cid:3)(cid:5)(cid:14)(cid:70)(cid:12)(cid:11)(cid:4)(cid:14)(cid:11)(cid:48)(cid:48)(cid:7)(cid:5)(cid:3)(cid:9)(cid:2)(cid:12)(cid:11)(cid:4)(cid:14)(cid:11)(cid:48)(cid:48)(cid:7)(cid:5)(cid:3)(cid:9)(cid:2)(cid:28)(cid:3,,24676.0
,,16,,,Unknown,,cid:3)(cid:5)(cid:14)(cid:70)(cid:12)(cid:11)(cid:4)(cid:14)(cid:11)(cid:48)(cid:48)(cid:7)(cid:5)(cid:3)(cid:9)(cid:2)(cid:12)(cid:11)(cid:4)(cid:14)(cid:11)(cid:48)(cid:48)(cid:7)(cid:5)(cid:3)(cid:9)(cid:2)(cid:28)(cid:3,,24692.0
,,34,,,Unknown,,cid:3)(cid:5)(cid:14)(cid:70)(cid:12)(cid:11)(cid:4)(cid:14)(cid:11)(cid:48)(cid:48)(cid:7)(cid:5)(cid:3)(cid:9)(cid:2)(cid:12)(cid:11)(cid:4)(cid:14)(cid:11)(cid:48)(cid:48)(cid:7)(cid:5)(cid:3)(cid:9)(cid:2)(cid:28)(cid:3,,24726.0
,,33,,,Unknown,,cid:3)(cid:5)(cid:14)(cid:70)(cid:12)(cid:11)(cid:4)(cid:14)(cid:11)(cid:48)(cid:48)(cid:7)(cid:5)(cid:3)(cid:9)(cid:2)(cid:12)(cid:11)(cid:4)(cid:14)(cid:11)(cid:48)(cid:48)(cid:7)(cid:5)(cid:3)(cid:9)(cid:2)(cid:28)(cid:3,,24759.0
,,1,,,Unknown,,cid:3)(cid:5)(cid:14)(cid:70)(cid:12)(cid:11)(cid:4)(cid:14)(cid:11)(cid:48)(cid:48)(cid:7)(cid:5)(cid:3)(cid:9)(cid:2)(cid:12)(cid:11)(cid:4)(cid:14)(cid:11)(cid:48)(cid:48)(cid:7)(cid:5)(cid:3)(cid:9)(cid:2)(cid:28)(cid:3,,24760.0
,,17,,,Unknown,,cid:3)(cid:5)(cid:14)(cid:70)(cid:12)(cid:11)(cid:4)(cid:14)(cid:11)(cid:48)(cid:48)(cid:7)(cid:5)(cid:3)(cid:9)(cid:2)(cid:12)(cid:11)(cid:4)(cid:14)(cid:11)(cid:48)(cid:48)(cid:7)(cid:5)(cid:3)(cid:9)(cid:2)(cid:28)(cid:3,,24777.0
,,45,,,Unknown,,cid:3)(cid:5)(cid:14)(cid:70)(cid:12)(cid:11)(cid:4)(cid:14)(cid:11)(cid:48)(cid:48)(cid:7)(cid:5)(cid:3)(cid:9)(cid:2)(cid:12)(cid:11)(cid:4)(cid:14)(cid:11)(cid:48)(cid:48)(cid:7)(cid:5)(cid:3)(cid:9)(cid:2)(cid:28)(cid:3,,24822.0
,,18,,,Unknown,,cid:3)(cid:5)(cid:14)(cid:70)(cid:12)(cid:11)(cid:4)(cid:14)(cid:11)(cid:48)(cid:48)(cid:7)(cid:5)(cid:3)(cid:9)(cid:2)(cid:12)(cid:11)(cid:4)(cid:14)(cid:11)(cid:48)(cid:48)(cid:7)(cid:5)(cid:3)(cid:9)(cid:2)(cid:28)(cid:3,,24840.0
,,16,,,Unknown,,cid:3)(cid:5)(cid:14)(cid:70)(cid:12)(cid:11)(cid:4)(cid:14)(cid:11)(cid:48)(cid:48)(cid:7)(cid:5)(cid:3)(cid:9)(cid:2)(cid:12)(cid:11)(cid:4)(cid:14)(cid:11)(cid:48)(cid:48)(cid:7)(cid:5)(cid:3)(cid:9)(cid:2)(cid:28)(cid:3,,24856.0
,,9,,,Unknown,,cid:3)(cid:5)(cid:14)(cid:70)(cid:12)(cid:11)(cid:4)(cid:14)(cid:11)(cid:48)(cid:48)(cid:7)(cid:5)(cid:3)(cid:9)(cid:2)(cid:12)(cid:11)(cid:4)(cid:14)(cid:11)(cid:48)(cid:48)(cid:7)(cid:5)(cid:3)(cid:9)(cid:2)(cid:28)(cid:3,,24865.0
,,46,,,Unknown,,cid:3)(cid:5)(cid:14)(cid:70)(cid:12)(cid:11)(cid:4)(cid:14)(cid:11)(cid:48)(cid:48)(cid:7)(cid:5)(cid:3)(cid:9)(cid:2)(cid:12)(cid:11)(cid:4)(cid:14)(cid:11)(cid:48)(cid:48)(cid:7)(cid:5)(cid:3)(cid:9)(cid:2)(cid:28)(cid:3,,24911.0
,,8,,,Unknown,,cid:3)(cid:5)(cid:14)(cid:70)(cid:12)(cid:11)(cid:4)(cid:14)(cid:11)(cid:48)(cid:48)(cid:7)(cid:5)(cid:3)(cid:9)(cid:2)(cid:12)(cid:11)(cid:4)(cid:14)(cid:11)(cid:48)(cid:48)(cid:7)(cid:5)(cid:3)(cid:9)(cid:2)(cid:28)(cid:3,,24919.0
,,5,,,Unknown,,cid:3)(cid:5)(cid:14)(cid:70)(cid:12)(cid:11)(cid:4)(cid:14)(cid:11)(cid:48)(cid:48)(cid:7)(cid:5)(cid:3)(cid:9)(cid:2)(cid:12)(cid:11)(cid:4)(cid:14)(cid:11)(cid:48)(cid:48)(cid:7)(cid:5)(cid:3)(cid:9)(cid:2)(cid:28)(cid:3,,24924.0
,,28,,,Unknown,,cid:3)(cid:5)(cid:14)(cid:70)(cid:12)(cid:11)(cid:4)(cid:14)(cid:11)(cid:48)(cid:48)(cid:7)(cid:5)(cid:3)(cid:9)(cid:2)(cid:12)(cid:11)(cid:4)(cid:14)(cid:11)(cid:48)(cid:48)(cid:7)(cid:5)(cid:3)(cid:9)(cid:2)(cid:28)(cid:3,,24952.0
,,2,,,Unknown,,cid:3)(cid:5)(cid:14)(cid:70)(cid:12)(cid:11)(cid:4)(cid:14)(cid:11)(cid:48)(cid:48)(cid:7)(cid:5)(cid:3)(cid:9)(cid:2)(cid:12)(cid:11)(cid:4)(cid:14)(cid:11)(cid:48)(cid:48)(cid:7)(cid:5)(cid:3)(cid:9)(cid:2)(cid:28)(cid:3,,24954.0
,,9,,,Unknown,,cid:3)(cid:5)(cid:14)(cid:70)(cid:12)(cid:11)(cid:4)(cid:14)(cid:11)(cid:48)(cid:48)(cid:7)(cid:5)(cid:3)(cid:9)(cid:2)(cid:12)(cid:11)(cid:4)(cid:14)(cid:11)(cid:48)(cid:48)(cid:7)(cid:5)(cid:3)(cid:9)(cid:2)(cid:28)(cid:3,,24963.0
,,5,,,Unknown,,cid:3)(cid:5)(cid:14)(cid:70)(cid:12)(cid:11)(cid:4)(cid:14)(cid:11)(cid:48)(cid:48)(cid:7)(cid:5)(cid:3)(cid:9)(cid:2)(cid:12)(cid:11)(cid:4)(cid:14)(cid:11)(cid:48)(cid:48)(cid:7)(cid:5)(cid:3)(cid:9)(cid:2)(cid:28)(cid:3,,24968.0
,,8,,,Unknown,,cid:3)(cid:5)(cid:14)(cid:70)(cid:12)(cid:11)(cid:4)(cid:14)(cid:11)(cid:48)(cid:48)(cid:7)(cid:5)(cid:3)(cid:9)(cid:2)(cid:12)(cid:11)(cid:4)(cid:14)(cid:11)(cid:48)(cid:48)(cid:7)(cid:5)(cid:3)(cid:9)(cid:2)(cid:28)(cid:3,,24976.0
,,14,,,Unknown,,cid:3)(cid:5)(cid:14)(cid:70)(cid:12)(cid:11)(cid:4)(cid:14)(cid:11)(cid:48)(cid:48)(cid:7)(cid:5)(cid:3)(cid:9)(cid:2)(cid:12)(cid:11)(cid:4)(cid:14)(cid:11)(cid:48)(cid:48)(cid:7)(cid:5)(cid:3)(cid:9)(cid:2)(cid:28)(cid:3,,24990.0
,,7,,,Unknown,,cid:3)(cid:5)(cid:14)(cid:70)(cid:12)(cid:11)(cid:4)(cid:14)(cid:11)(cid:48)(cid:48)(cid:7)(cid:5)(cid:3)(cid:9)(cid:2)(cid:12)(cid:11)(cid:4)(cid:14)(cid:11)(cid:48)(cid:48)(cid:7)(cid:5)(cid:3)(cid:9)(cid:2)(cid:28)(cid:3,,24997.0
,,9,,,Unknown,,cid:3)(cid:5)(cid:14)(cid:70)(cid:12)(cid:11)(cid:4)(cid:14)(cid:11)(cid:48)(cid:48)(cid:7)(cid:5)(cid:3)(cid:9)(cid:2)(cid:12)(cid:11)(cid:4)(cid:14)(cid:11)(cid:48)(cid:48)(cid:7)(cid:5)(cid:3)(cid:9)(cid:2)(cid:28)(cid:3,,25006.0
,,2,,,Unknown,,cid:3)(cid:5)(cid:14)(cid:70)(cid:12)(cid:11)(cid:4)(cid:14)(cid:11)(cid:48)(cid:48)(cid:7)(cid:5)(cid:3)(cid:9)(cid:2)(cid:12)(cid:11)(cid:4)(cid:14)(cid:11)(cid:48)(cid:48)(cid:7)(cid:5)(cid:3)(cid:9)(cid:2)(cid:28)(cid:3,,25008.0
,,28,,,Unknown,,cid:3)(cid:5)(cid:14)(cid:70)(cid:12)(cid:11)(cid:4)(cid:14)(cid:11)(cid:48)(cid:48)(cid:7)(cid:5)(cid:3)(cid:9)(cid:2)(cid:12)(cid:11)(cid:4)(cid:14)(cid:11)(cid:48)(cid:48)(cid:7)(cid:5)(cid:3)(cid:9)(cid:2)(cid:28)(cid:3,,25036.0
,,3,,,Unknown,,cid:3)(cid:5)(cid:14)(cid:70)(cid:12)(cid:11)(cid:4)(cid:14)(cid:11)(cid:48)(cid:48)(cid:7)(cid:5)(cid:3)(cid:9)(cid:2)(cid:12)(cid:11)(cid:4)(cid:14)(cid:11)(cid:48)(cid:48)(cid:7)(cid:5)(cid:3)(cid:9)(cid:2)(cid:28)(cid:3,,25039.0
,,15,,,Unknown,,cid:3)(cid:5)(cid:14)(cid:70)(cid:12)(cid:11)(cid:4)(cid:14)(cid:11)(cid:48)(cid:48)(cid:7)(cid:5)(cid:3)(cid:9)(cid:2)(cid:12)(cid:11)(cid:4)(cid:14)(cid:11)(cid:48)(cid:48)(cid:7)(cid:5)(cid:3)(cid:9)(cid:2)(cid:28)(cid:3,,25054.0
,,2,,,Unknown,,cid:3)(cid:5)(cid:14)(cid:70)(cid:12)(cid:11)(cid:4)(cid:14)(cid:11)(cid:48)(cid:48)(cid:7)(cid:5)(cid:3)(cid:9)(cid:2)(cid:12)(cid:11)(cid:4)(cid:14)(cid:11)(cid:48)(cid:48)(cid:7)(cid:5)(cid:3)(cid:9)(cid:2)(cid:28)(cid:3,,25056.0
,,1,,,Unknown,,cid:3)(cid:5)(cid:14)(cid:70)(cid:12)(cid:11)(cid:4)(cid:14)(cid:11)(cid:48)(cid:48)(cid:7)(cid:5)(cid:3)(cid:9)(cid:2)(cid:12)(cid:11)(cid:4)(cid:14)(cid:11)(cid:48)(cid:48)(cid:7)(cid:5)(cid:3)(cid:9)(cid:2)(cid:28)(cid:3,,25057.0
,,19,,,Unknown,,cid:3)(cid:5)(cid:14)(cid:70)(cid:12)(cid:11)(cid:4)(cid:14)(cid:11)(cid:48)(cid:48)(cid:7)(cid:5)(cid:3)(cid:9)(cid:2)(cid:12)(cid:11)(cid:4)(cid:14)(cid:11)(cid:48)(cid:48)(cid:7)(cid:5)(cid:3)(cid:9)(cid:2)(cid:28)(cid:3,,25076.0
,,37,,,Unknown,,cid:3)(cid:5)(cid:14)(cid:70)(cid:12)(cid:11)(cid:4)(cid:14)(cid:11)(cid:48)(cid:48)(cid:7)(cid:5)(cid:3)(cid:9)(cid:2)(cid:12)(cid:11)(cid:4)(cid:14)(cid:11)(cid:48)(cid:48)(cid:7)(cid:5)(cid:3)(cid:9)(cid:2)(cid:28)(cid:3,,25113.0
,,18,,,Unknown,,cid:3)(cid:5)(cid:14)(cid:70)(cid:12)(cid:11)(cid:4)(cid:14)(cid:11)(cid:48)(cid:48)(cid:7)(cid:5)(cid:3)(cid:9)(cid:2)(cid:12)(cid:11)(cid:4)(cid:14)(cid:11)(cid:48)(cid:48)(cid:7)(cid:5)(cid:3)(cid:9)(cid:2)(cid:28)(cid:3,,25131.0
,,2,,,Unknown,,cid:3)(cid:5)(cid:14)(cid:70)(cid:12)(cid:11)(cid:4)(cid:14)(cid:11)(cid:48)(cid:48)(cid:7)(cid:5)(cid:3)(cid:9)(cid:2)(cid:12)(cid:11)(cid:4)(cid:14)(cid:11)(cid:48)(cid:48)(cid:7)(cid:5)(cid:3)(cid:9)(cid:2)(cid:28)(cid:3,,25133.0
,,44,,,Unknown,,cid:3)(cid:5)(cid:14)(cid:70)(cid:12)(cid:11)(cid:4)(cid:14)(cid:11)(cid:48)(cid:48)(cid:7)(cid:5)(cid:3)(cid:9)(cid:2)(cid:12)(cid:11)(cid:4)(cid:14)(cid:11)(cid:48)(cid:48)(cid:7)(cid:5)(cid:3)(cid:9)(cid:2)(cid:28)(cid:3,,25177.0
,,12,,,Unknown,,cid:3)(cid:5)(cid:14)(cid:70)(cid:12)(cid:11)(cid:4)(cid:14)(cid:11)(cid:48)(cid:48)(cid:7)(cid:5)(cid:3)(cid:9)(cid:2)(cid:12)(cid:11)(cid:4)(cid:14)(cid:11)(cid:48)(cid:48)(cid:7)(cid:5)(cid:3)(cid:9)(cid:2)(cid:28)(cid:3,,25189.0
,,29,,,Unknown,,cid:3)(cid:5)(cid:14)(cid:70)(cid:12)(cid:11)(cid:4)(cid:14)(cid:11)(cid:48)(cid:48)(cid:7)(cid:5)(cid:3)(cid:9)(cid:2)(cid:12)(cid:11)(cid:4)(cid:14)(cid:11)(cid:48)(cid:48)(cid:7)(cid:5)(cid:3)(cid:9)(cid:2)(cid:28)(cid:3,,25218.0
,,26,,,Unknown,,cid:3)(cid:5)(cid:14)(cid:70)(cid:12)(cid:11)(cid:4)(cid:14)(cid:11)(cid:48)(cid:48)(cid:7)(cid:5)(cid:3)(cid:9)(cid:2)(cid:12)(cid:11)(cid:4)(cid:14)(cid:11)(cid:48)(cid:48)(cid:7)(cid:5)(cid:3)(cid:9)(cid:2)(cid:28)(cid:3,,25244.0
,,41,,,Unknown,,cid:3)(cid:5)(cid:14)(cid:70)(cid:12)(cid:11)(cid:4)(cid:14)(cid:11)(cid:48)(cid:48)(cid:7)(cid:5)(cid:3)(cid:9)(cid:2)(cid:12)(cid:11)(cid:4)(cid:14)(cid:11)(cid:48)(cid:48)(cid:7)(cid:5)(cid:3)(cid:9)(cid:2)(cid:28)(cid:3,,25285.0
,,25,,,Unknown,,cid:3)(cid:5)(cid:14)(cid:70)(cid:12)(cid:11)(cid:4)(cid:14)(cid:11)(cid:48)(cid:48)(cid:7)(cid:5)(cid:3)(cid:9)(cid:2)(cid:12)(cid:11)(cid:4)(cid:14)(cid:11)(cid:48)(cid:48)(cid:7)(cid:5)(cid:3)(cid:9)(cid:2)(cid:28)(cid:3,,25310.0
,,2,,,Unknown,,cid:3)(cid:5)(cid:14)(cid:70)(cid:12)(cid:11)(cid:4)(cid:14)(cid:11)(cid:48)(cid:48)(cid:7)(cid:5)(cid:3)(cid:9)(cid:2)(cid:12)(cid:11)(cid:4)(cid:14)(cid:11)(cid:48)(cid:48)(cid:7)(cid:5)(cid:3)(cid:9)(cid:2)(cid:28)(cid:3,,25312.0
,,58,,,Unknown,,cid:3)(cid:5)(cid:14)(cid:70)(cid:12)(cid:11)(cid:4)(cid:14)(cid:11)(cid:48)(cid:48)(cid:7)(cid:5)(cid:3)(cid:9)(cid:2)(cid:12)(cid:11)(cid:4)(cid:14)(cid:11)(cid:48)(cid:48)(cid:7)(cid:5)(cid:3)(cid:9)(cid:2)(cid:28)(cid:3,,25370.0
,,58,,,Unknown,,cid:3)(cid:5)(cid:14)(cid:70)(cid:12)(cid:11)(cid:4)(cid:14)(cid:11)(cid:48)(cid:48)(cid:7)(cid:5)(cid:3)(cid:9)(cid:2)(cid:12)(cid:11)(cid:4)(cid:14)(cid:11)(cid:48)(cid:48)(cid:7)(cid:5)(cid:3)(cid:9)(cid:2)(cid:28)(cid:3,,25428.0
,,37,,,Unknown,,cid:3)(cid:5)(cid:14)(cid:70)(cid:12)(cid:11)(cid:4)(cid:14)(cid:11)(cid:48)(cid:48)(cid:7)(cid:5)(cid:3)(cid:9)(cid:2)(cid:12)(cid:11)(cid:4)(cid:14)(cid:11)(cid:48)(cid:48)(cid:7)(cid:5)(cid:3)(cid:9)(cid:2)(cid:28)(cid:3,,25465.0
,,16,,,Unknown,,cid:3)(cid:5)(cid:14)(cid:70)(cid:12)(cid:11)(cid:4)(cid:14)(cid:11)(cid:48)(cid:48)(cid:7)(cid:5)(cid:3)(cid:9)(cid:2)(cid:12)(cid:11)(cid:4)(cid:14)(cid:11)(cid:48)(cid:48)(cid:7)(cid:5)(cid:3)(cid:9)(cid:2)(cid:28)(cid:3,,25481.0
,,34,,,Unknown,,cid:3)(cid:5)(cid:14)(cid:70)(cid:12)(cid:11)(cid:4)(cid:14)(cid:11)(cid:48)(cid:48)(cid:7)(cid:5)(cid:3)(cid:9)(cid:2)(cid:12)(cid:11)(cid:4)(cid:14)(cid:11)(cid:48)(cid:48)(cid:7)(cid:5)(cid:3)(cid:9)(cid:2)(cid:28)(cid:3,,25515.0
,,33,,,Unknown,,cid:3)(cid:5)(cid:14)(cid:70)(cid:12)(cid:11)(cid:4)(cid:14)(cid:11)(cid:48)(cid:48)(cid:7)(cid:5)(cid:3)(cid:9)(cid:2)(cid:12)(cid:11)(cid:4)(cid:14)(cid:11)(cid:48)(cid:48)(cid:7)(cid:5)(cid:3)(cid:9)(cid:2)(cid:28)(cid:3,,25548.0
,,1,,,Unknown,,cid:3)(cid:5)(cid:14)(cid:70)(cid:12)(cid:11)(cid:4)(cid:14)(cid:11)(cid:48)(cid:48)(cid:7)(cid:5)(cid:3)(cid:9)(cid:2)(cid:12)(cid:11)(cid:4)(cid:14)(cid:11)(cid:48)(cid:48)(cid:7)(cid:5)(cid:3)(cid:9)(cid:2)(cid:28)(cid:3,,25549.0
,,17,,,Unknown,,cid:3)(cid:5)(cid:14)(cid:70)(cid:12)(cid:11)(cid:4)(cid:14)(cid:11)(cid:48)(cid:48)(cid:7)(cid:5)(cid:3)(cid:9)(cid:2)(cid:12)(cid:11)(cid:4)(cid:14)(cid:11)(cid:48)(cid:48)(cid:7)(cid:5)(cid:3)(cid:9)(cid:2)(cid:28)(cid:3,,25566.0
,,45,,,Unknown,,cid:3)(cid:5)(cid:14)(cid:70)(cid:12)(cid:11)(cid:4)(cid:14)(cid:11)(cid:48)(cid:48)(cid:7)(cid:5)(cid:3)(cid:9)(cid:2)(cid:12)(cid:11)(cid:4)(cid:14)(cid:11)(cid:48)(cid:48)(cid:7)(cid:5)(cid:3)(cid:9)(cid:2)(cid:28)(cid:3,,25611.0
,,18,,,Unknown,,cid:3)(cid:5)(cid:14)(cid:70)(cid:12)(cid:11)(cid:4)(cid:14)(cid:11)(cid:48)(cid:48)(cid:7)(cid:5)(cid:3)(cid:9)(cid:2)(cid:12)(cid:11)(cid:4)(cid:14)(cid:11)(cid:48)(cid:48)(cid:7)(cid:5)(cid:3)(cid:9)(cid:2)(cid:28)(cid:3,,25629.0
,,16,,,Unknown,,cid:3)(cid:5)(cid:14)(cid:70)(cid:12)(cid:11)(cid:4)(cid:14)(cid:11)(cid:48)(cid:48)(cid:7)(cid:5)(cid:3)(cid:9)(cid:2)(cid:12)(cid:11)(cid:4)(cid:14)(cid:11)(cid:48)(cid:48)(cid:7)(cid:5)(cid:3)(cid:9)(cid:2)(cid:28)(cid:3,,25645.0
,,9,,,Unknown,,cid:3)(cid:5)(cid:14)(cid:70)(cid:12)(cid:11)(cid:4)(cid:14)(cid:11)(cid:48)(cid:48)(cid:7)(cid:5)(cid:3)(cid:9)(cid:2)(cid:12)(cid:11)(cid:4)(cid:14)(cid:11)(cid:48)(cid:48)(cid:7)(cid:5)(cid:3)(cid:9)(cid:2)(cid:28)(cid:3,,25654.0
,,46,,,Unknown,,cid:3)(cid:5)(cid:14)(cid:70)(cid:12)(cid:11)(cid:4)(cid:14)(cid:11)(cid:48)(cid:48)(cid:7)(cid:5)(cid:3)(cid:9)(cid:2)(cid:12)(cid:11)(cid:4)(cid:14)(cid:11)(cid:48)(cid:48)(cid:7)(cid:5)(cid:3)(cid:9)(cid:2)(cid:28)(cid:3,,25700.0
,,8,,,Unknown,,cid:3)(cid:5)(cid:14)(cid:70)(cid:12)(cid:11)(cid:4)(cid:14)(cid:11)(cid:48)(cid:48)(cid:7)(cid:5)(cid:3)(cid:9)(cid:2)(cid:12)(cid:11)(cid:4)(cid:14)(cid:11)(cid:48)(cid:48)(cid:7)(cid:5)(cid:3)(cid:9)(cid:2)(cid:28)(cid:3,,25708.0
,,5,,,Unknown,,cid:3)(cid:5)(cid:14)(cid:70)(cid:12)(cid:11)(cid:4)(cid:14)(cid:11)(cid:48)(cid:48)(cid:7)(cid:5)(cid:3)(cid:9)(cid:2)(cid:12)(cid:11)(cid:4)(cid:14)(cid:11)(cid:48)(cid:48)(cid:7)(cid:5)(cid:3)(cid:9)(cid:2)(cid:28)(cid:3,,25713.0
,,28,,,Unknown,,cid:3)(cid:5)(cid:14)(cid:70)(cid:12)(cid:11)(cid:4)(cid:14)(cid:11)(cid:48)(cid:48)(cid:7)(cid:5)(cid:3)(cid:9)(cid:2)(cid:12)(cid:11)(cid:4)(cid:14)(cid:11)(cid:48)(cid:48)(cid:7)(cid:5)(cid:3)(cid:9)(cid:2)(cid:28)(cid:3,,25741.0
,,2,,,Unknown,,cid:3)(cid:5)(cid:14)(cid:70)(cid:12)(cid:11)(cid:4)(cid:14)(cid:11)(cid:48)(cid:48)(cid:7)(cid:5)(cid:3)(cid:9)(cid:2)(cid:12)(cid:11)(cid:4)(cid:14)(cid:11)(cid:48)(cid:48)(cid:7)(cid:5)(cid:3)(cid:9)(cid:2)(cid:28)(cid:3,,25743.0
,,46,,,Unknown,,cid:3)(cid:5)(cid:14)(cid:70)(cid:12)(cid:11)(cid:4)(cid:14)(cid:11)(cid:48)(cid:48)(cid:7)(cid:5)(cid:3)(cid:9)(cid:2)(cid:12)(cid:11)(cid:4)(cid:14)(cid:11)(cid:48)(cid:48)(cid:7)(cid:5)(cid:3)(cid:9)(cid:2)(cid:28)(cid:3,,25789.0
,,4,,,Unknown,,cid:3)(cid:5)(cid:14)(cid:70)(cid:12)(cid:11)(cid:4)(cid:14)(cid:11)(cid:48)(cid:48)(cid:7)(cid:5)(cid:3)(cid:9)(cid:2)(cid:12)(cid:11)(cid:4)(cid:14)(cid:11)(cid:48)(cid:48)(cid:7)(cid:5)(cid:3)(cid:9)(cid:2)(cid:28)(cid:3,,25793.0
,,10,,,Unknown,,cid:3)(cid:5)(cid:14)(cid:70)(cid:12)(cid:11)(cid:4)(cid:14)(cid:11)(cid:48)(cid:48)(cid:7)(cid:5)(cid:3)(cid:9)(cid:2)(cid:12)(cid:11)(cid:4)(cid:14)(cid:11)(cid:48)(cid:48)(cid:7)(cid:5)(cid:3)(cid:9)(cid:2)(cid:28)(cid:3,,25803.0
,,11,,,Unknown,,cid:3)(cid:5)(cid:14)(cid:70)(cid:12)(cid:11)(cid:4)(cid:14)(cid:11)(cid:48)(cid:48)(cid:7)(cid:5)(cid:3)(cid:9)(cid:2)(cid:12)(cid:11)(cid:4)(cid:14)(cid:11)(cid:48)(cid:48)(cid:7)(cid:5)(cid:3)(cid:9)(cid:2)(cid:28)(cid:3,,25814.0
,,3,,,Unknown,,cid:3)(cid:5)(cid:14)(cid:70)(cid:12)(cid:11)(cid:4)(cid:14)(cid:11)(cid:48)(cid:48)(cid:7)(cid:5)(cid:3)(cid:9)(cid:2)(cid:12)(cid:11)(cid:4)(cid:14)(cid:11)(cid:48)(cid:48)(cid:7)(cid:5)(cid:3)(cid:9)(cid:2)(cid:28)(cid:3,,25817.0
,,11,,,Unknown,,cid:3)(cid:5)(cid:14)(cid:70)(cid:12)(cid:11)(cid:4)(cid:14)(cid:11)(cid:48)(cid:48)(cid:7)(cid:5)(cid:3)(cid:9)(cid:2)(cid:12)(cid:11)(cid:4)(cid:14)(cid:11)(cid:48)(cid:48)(cid:7)(cid:5)(cid:3)(cid:9)(cid:2)(cid:28)(cid:3,,25828.0
,,4,,,Unknown,,cid:3)(cid:5)(cid:14)(cid:70)(cid:12)(cid:11)(cid:4)(cid:14)(cid:11)(cid:48)(cid:48)(cid:7)(cid:5)(cid:3)(cid:9)(cid:2)(cid:12)(cid:11)(cid:4)(cid:14)(cid:11)(cid:48)(cid:48)(cid:7)(cid:5)(cid:3)(cid:9)(cid:2)(cid:28)(cid:3,,25832.0
,,10,,,Unknown,,cid:3)(cid:5)(cid:14)(cid:70)(cid:12)(cid:11)(cid:4)(cid:14)(cid:11)(cid:48)(cid:48)(cid:7)(cid:5)(cid:3)(cid:9)(cid:2)(cid:12)(cid:11)(cid:4)(cid:14)(cid:11)(cid:48)(cid:48)(cid:7)(cid:5)(cid:3)(cid:9)(cid:2)(cid:28)(cid:3,,25842.0
,,5,,,Unknown,,cid:3)(cid:5)(cid:14)(cid:70)(cid:12)(cid:11)(cid:4)(cid:14)(cid:11)(cid:48)(cid:48)(cid:7)(cid:5)(cid:3)(cid:9)(cid:2)(cid:12)(cid:11)(cid:4)(cid:14)(cid:11)(cid:48)(cid:48)(cid:7)(cid:5)(cid:3)(cid:9)(cid:2)(cid:28)(cid:3,,25847.0
,,2,,,Unknown,,cid:3)(cid:5)(cid:14)(cid:70)(cid:12)(cid:11)(cid:4)(cid:14)(cid:11)(cid:48)(cid:48)(cid:7)(cid:5)(cid:3)(cid:9)(cid:2)(cid:12)(cid:11)(cid:4)(cid:14)(cid:11)(cid:48)(cid:48)(cid:7)(cid:5)(cid:3)(cid:9)(cid:2)(cid:28)(cid:3,,25849.0
,,9,,,Unknown,,cid:3)(cid:5)(cid:14)(cid:70)(cid:12)(cid:11)(cid:4)(cid:14)(cid:11)(cid:48)(cid:48)(cid:7)(cid:5)(cid:3)(cid:9)(cid:2)(cid:12)(cid:11)(cid:4)(cid:14)(cid:11)(cid:48)(cid:48)(cid:7)(cid:5)(cid:3)(cid:9)(cid:2)(cid:28)(cid:3,,25858.0
,,5,,,Unknown,,cid:3)(cid:5)(cid:14)(cid:70)(cid:12)(cid:11)(cid:4)(cid:14)(cid:11)(cid:48)(cid:48)(cid:7)(cid:5)(cid:3)(cid:9)(cid:2)(cid:12)(cid:11)(cid:4)(cid:14)(cid:11)(cid:48)(cid:48)(cid:7)(cid:5)(cid:3)(cid:9)(cid:2)(cid:28)(cid:3,,25863.0
,,8,,,Unknown,,cid:3)(cid:5)(cid:14)(cid:70)(cid:12)(cid:11)(cid:4)(cid:14)(cid:11)(cid:48)(cid:48)(cid:7)(cid:5)(cid:3)(cid:9)(cid:2)(cid:12)(cid:11)(cid:4)(cid:14)(cid:11)(cid:48)(cid:48)(cid:7)(cid:5)(cid:3)(cid:9)(cid:2)(cid:28)(cid:3,,25871.0
,,14,,,Unknown,,cid:3)(cid:5)(cid:14)(cid:70)(cid:12)(cid:11)(cid:4)(cid:14)(cid:11)(cid:48)(cid:48)(cid:7)(cid:5)(cid:3)(cid:9)(cid:2)(cid:12)(cid:11)(cid:4)(cid:14)(cid:11)(cid:48)(cid:48)(cid:7)(cid:5)(cid:3)(cid:9)(cid:2)(cid:28)(cid:3,,25885.0
,,7,,,Unknown,,cid:3)(cid:5)(cid:14)(cid:70)(cid:12)(cid:11)(cid:4)(cid:14)(cid:11)(cid:48)(cid:48)(cid:7)(cid:5)(cid:3)(cid:9)(cid:2)(cid:12)(cid:11)(cid:4)(cid:14)(cid:11)(cid:48)(cid:48)(cid:7)(cid:5)(cid:3)(cid:9)(cid:2)(cid:28)(cid:3,,25892.0
,,9,,,Unknown,,cid:3)(cid:5)(cid:14)(cid:70)(cid:12)(cid:11)(cid:4)(cid:14)(cid:11)(cid:48)(cid:48)(cid:7)(cid:5)(cid:3)(cid:9)(cid:2)(cid:12)(cid:11)(cid:4)(cid:14)(cid:11)(cid:48)(cid:48)(cid:7)(cid:5)(cid:3)(cid:9)(cid:2)(cid:28)(cid:3,,25901.0
,,2,,,Unknown,,cid:3)(cid:5)(cid:14)(cid:70)(cid:12)(cid:11)(cid:4)(cid:14)(cid:11)(cid:48)(cid:48)(cid:7)(cid:5)(cid:3)(cid:9)(cid:2)(cid:12)(cid:11)(cid:4)(cid:14)(cid:11)(cid:48)(cid:48)(cid:7)(cid:5)(cid:3)(cid:9)(cid:2)(cid:28)(cid:3,,25903.0
,,12,,,Unknown,,cid:3)(cid:5)(cid:14)(cid:70)(cid:12)(cid:11)(cid:4)(cid:14)(cid:11)(cid:48)(cid:48)(cid:7)(cid:5)(cid:3)(cid:9)(cid:2)(cid:12)(cid:11)(cid:4)(cid:14)(cid:11)(cid:48)(cid:48)(cid:7)(cid:5)(cid:3)(cid:9)(cid:2)(cid:28)(cid:3,,25915.0
,,5,,,Unknown,,cid:3)(cid:5)(cid:14)(cid:70)(cid:12)(cid:11)(cid:4)(cid:14)(cid:11)(cid:48)(cid:48)(cid:7)(cid:5)(cid:3)(cid:9)(cid:2)(cid:12)(cid:11)(cid:4)(cid:14)(cid:11)(cid:48)(cid:48)(cid:7)(cid:5)(cid:3)(cid:9)(cid:2)(cid:28)(cid:3,,25920.0
,,50,,,Unknown,,cid:3)(cid:5)(cid:14)(cid:70)(cid:12)(cid:11)(cid:4)(cid:14)(cid:11)(cid:48)(cid:48)(cid:7)(cid:5)(cid:3)(cid:9)(cid:2)(cid:12)(cid:11)(cid:4)(cid:14)(cid:11)(cid:48)(cid:48)(cid:7)(cid:5)(cid:3)(cid:9)(cid:2)(cid:28)(cid:3,,25970.0
,,5,,,Unknown,,cid:3)(cid:5)(cid:14)(cid:70)(cid:12)(cid:11)(cid:4)(cid:14)(cid:11)(cid:48)(cid:48)(cid:7)(cid:5)(cid:3)(cid:9)(cid:2)(cid:12)(cid:11)(cid:4)(cid:14)(cid:11)(cid:48)(cid:48)(cid:7)(cid:5)(cid:3)(cid:9)(cid:2)(cid:28)(cid:3,,25975.0
,,40,,,Unknown,,cid:3)(cid:5)(cid:14)(cid:70)(cid:12)(cid:11)(cid:4)(cid:14)(cid:11)(cid:48)(cid:48)(cid:7)(cid:5)(cid:3)(cid:9)(cid:2)(cid:12)(cid:11)(cid:4)(cid:14)(cid:11)(cid:48)(cid:48)(cid:7)(cid:5)(cid:3)(cid:9)(cid:2)(cid:28)(cid:3,,26015.0
,,2,,,Unknown,,cid:3)(cid:5)(cid:14)(cid:70)(cid:12)(cid:11)(cid:4)(cid:14)(cid:11)(cid:48)(cid:48)(cid:7)(cid:5)(cid:3)(cid:9)(cid:2)(cid:12)(cid:11)(cid:4)(cid:14)(cid:11)(cid:48)(cid:48)(cid:7)(cid:5)(cid:3)(cid:9)(cid:2)(cid:28)(cid:3,,26017.0
,,28,,,Unknown,,cid:3)(cid:5)(cid:14)(cid:70)(cid:12)(cid:11)(cid:4)(cid:14)(cid:11)(cid:48)(cid:48)(cid:7)(cid:5)(cid:3)(cid:9)(cid:2)(cid:12)(cid:11)(cid:4)(cid:14)(cid:11)(cid:48)(cid:48)(cid:7)(cid:5)(cid:3)(cid:9)(cid:2)(cid:28)(cid:3,,26045.0
,,3,,,Unknown,,cid:3)(cid:5)(cid:14)(cid:70)(cid:12)(cid:11)(cid:4)(cid:14)(cid:11)(cid:48)(cid:48)(cid:7)(cid:5)(cid:3)(cid:9)(cid:2)(cid:12)(cid:11)(cid:4)(cid:14)(cid:11)(cid:48)(cid:48)(cid:7)(cid:5)(cid:3)(cid:9)(cid:2)(cid:28)(cid:3,,26048.0
,,15,,,Unknown,,cid:3)(cid:5)(cid:14)(cid:70)(cid:12)(cid:11)(cid:4)(cid:14)(cid:11)(cid:48)(cid:48)(cid:7)(cid:5)(cid:3)(cid:9)(cid:2)(cid:12)(cid:11)(cid:4)(cid:14)(cid:11)(cid:48)(cid:48)(cid:7)(cid:5)(cid:3)(cid:9)(cid:2)(cid:28)(cid:3,,26063.0
,,2,,,Unknown,,cid:3)(cid:5)(cid:14)(cid:70)(cid:12)(cid:11)(cid:4)(cid:14)(cid:11)(cid:48)(cid:48)(cid:7)(cid:5)(cid:3)(cid:9)(cid:2)(cid:12)(cid:11)(cid:4)(cid:14)(cid:11)(cid:48)(cid:48)(cid:7)(cid:5)(cid:3)(cid:9)(cid:2)(cid:28)(cid:3,,26065.0
,,1,,,Unknown,,cid:3)(cid:5)(cid:14)(cid:70)(cid:12)(cid:11)(cid:4)(cid:14)(cid:11)(cid:48)(cid:48)(cid:7)(cid:5)(cid:3)(cid:9)(cid:2)(cid:12)(cid:11)(cid:4)(cid:14)(cid:11)(cid:48)(cid:48)(cid:7)(cid:5)(cid:3)(cid:9)(cid:2)(cid:28)(cid:3,,26066.0
,,19,,,Unknown,,cid:3)(cid:5)(cid:14)(cid:70)(cid:12)(cid:11)(cid:4)(cid:14)(cid:11)(cid:48)(cid:48)(cid:7)(cid:5)(cid:3)(cid:9)(cid:2)(cid:12)(cid:11)(cid:4)(cid:14)(cid:11)(cid:48)(cid:48)(cid:7)(cid:5)(cid:3)(cid:9)(cid:2)(cid:28)(cid:3,,26085.0
,,37,,,Unknown,,cid:3)(cid:5)(cid:14)(cid:70)(cid:12)(cid:11)(cid:4)(cid:14)(cid:11)(cid:48)(cid:48)(cid:7)(cid:5)(cid:3)(cid:9)(cid:2)(cid:12)(cid:11)(cid:4)(cid:14)(cid:11)(cid:48)(cid:48)(cid:7)(cid:5)(cid:3)(cid:9)(cid:2)(cid:28)(cid:3,,26122.0
,,18,,,Unknown,,cid:3)(cid:5)(cid:14)(cid:70)(cid:12)(cid:11)(cid:4)(cid:14)(cid:11)(cid:48)(cid:48)(cid:7)(cid:5)(cid:3)(cid:9)(cid:2)(cid:12)(cid:11)(cid:4)(cid:14)(cid:11)(cid:48)(cid:48)(cid:7)(cid:5)(cid:3)(cid:9)(cid:2)(cid:28)(cid:3,,26140.0
,,2,,,Unknown,,cid:3)(cid:5)(cid:14)(cid:70)(cid:12)(cid:11)(cid:4)(cid:14)(cid:11)(cid:48)(cid:48)(cid:7)(cid:5)(cid:3)(cid:9)(cid:2)(cid:12)(cid:11)(cid:4)(cid:14)(cid:11)(cid:48)(cid:48)(cid:7)(cid:5)(cid:3)(cid:9)(cid:2)(cid:28)(cid:3,,26142.0
,,44,,,Unknown,,cid:3)(cid:5)(cid:14)(cid:70)(cid:12)(cid:11)(cid:4)(cid:14)(cid:11)(cid:48)(cid:48)(cid:7)(cid:5)(cid:3)(cid:9)(cid:2)(cid:12)(cid:11)(cid:4)(cid:14)(cid:11)(cid:48)(cid:48)(cid:7)(cid:5)(cid:3)(cid:9)(cid:2)(cid:28)(cid:3,,26186.0
,,12,,,Unknown,,cid:3)(cid:5)(cid:14)(cid:70)(cid:12)(cid:11)(cid:4)(cid:14)(cid:11)(cid:48)(cid:48)(cid:7)(cid:5)(cid:3)(cid:9)(cid:2)(cid:12)(cid:11)(cid:4)(cid:14)(cid:11)(cid:48)(cid:48)(cid:7)(cid:5)(cid:3)(cid:9)(cid:2)(cid:28)(cid:3,,26198.0
,,29,,,Unknown,,cid:3)(cid:5)(cid:14)(cid:70)(cid:12)(cid:11)(cid:4)(cid:14)(cid:11)(cid:48)(cid:48)(cid:7)(cid:5)(cid:3)(cid:9)(cid:2)(cid:12)(cid:11)(cid:4)(cid:14)(cid:11)(cid:48)(cid:48)(cid:7)(cid:5)(cid:3)(cid:9)(cid:2)(cid:28)(cid:3,,26227.0
,,26,,,Unknown,,cid:3)(cid:5)(cid:14)(cid:70)(cid:12)(cid:11)(cid:4)(cid:14)(cid:11)(cid:48)(cid:48)(cid:7)(cid:5)(cid:3)(cid:9)(cid:2)(cid:12)(cid:11)(cid:4)(cid:14)(cid:11)(cid:48)(cid:48)(cid:7)(cid:5)(cid:3)(cid:9)(cid:2)(cid:28)(cid:3,,26253.0
,,41,,,Unknown,,cid:3)(cid:5)(cid:14)(cid:70)(cid:12)(cid:11)(cid:4)(cid:14)(cid:11)(cid:48)(cid:48)(cid:7)(cid:5)(cid:3)(cid:9)(cid:2)(cid:12)(cid:11)(cid:4)(cid:14)(cid:11)(cid:48)(cid:48)(cid:7)(cid:5)(cid:3)(cid:9)(cid:2)(cid:28)(cid:3,,26294.0
,,25,,,Unknown,,cid:3)(cid:5)(cid:14)(cid:70)(cid:12)(cid:11)(cid:4)(cid:14)(cid:11)(cid:48)(cid:48)(cid:7)(cid:5)(cid:3)(cid:9)(cid:2)(cid:12)(cid:11)(cid:4)(cid:14)(cid:11)(cid:48)(cid:48)(cid:7)(cid:5)(cid:3)(cid:9)(cid:2)(cid:28)(cid:3,,26319.0
,,2,,,Unknown,,cid:3)(cid:5)(cid:14)(cid:70)(cid:12)(cid:11)(cid:4)(cid:14)(cid:11)(cid:48)(cid:48)(cid:7)(cid:5)(cid:3)(cid:9)(cid:2)(cid:12)(cid:11)(cid:4)(cid:14)(cid:11)(cid:48)(cid:48)(cid:7)(cid:5)(cid:3)(cid:9)(cid:2)(cid:28)(cid:3,,26321.0
,,58,,,Unknown,,cid:3)(cid:5)(cid:14)(cid:70)(cid:12)(cid:11)(cid:4)(cid:14)(cid:11)(cid:48)(cid:48)(cid:7)(cid:5)(cid:3)(cid:9)(cid:2)(cid:12)(cid:11)(cid:4)(cid:14)(cid:11)(cid:48)(cid:48)(cid:7)(cid:5)(cid:3)(cid:9)(cid:2)(cid:28)(cid:3,,26379.0
,,58,,,Unknown,,cid:3)(cid:5)(cid:14)(cid:70)(cid:12)(cid:11)(cid:4)(cid:14)(cid:11)(cid:48)(cid:48)(cid:7)(cid:5)(cid:3)(cid:9)(cid:2)(cid:12)(cid:11)(cid:4)(cid:14)(cid:11)(cid:48)(cid:48)(cid:7)(cid:5)(cid:3)(cid:9)(cid:2)(cid:28)(cid:3,,26437.0
,,37,,,Unknown,,cid:3)(cid:5)(cid:14)(cid:70)(cid:12)(cid:11)(cid:4)(cid:14)(cid:11)(cid:48)(cid:48)(cid:7)(cid:5)(cid:3)(cid:9)(cid:2)(cid:12)(cid:11)(cid:4)(cid:14)(cid:11)(cid:48)(cid:48)(cid:7)(cid:5)(cid:3)(cid:9)(cid:2)(cid:28)(cid:3,,26474.0
,,16,,,Unknown,,cid:3)(cid:5)(cid:14)(cid:70)(cid:12)(cid:11)(cid:4)(cid:14)(cid:11)(cid:48)(cid:48)(cid:7)(cid:5)(cid:3)(cid:9)(cid:2)(cid:12)(cid:11)(cid:4)(cid:14)(cid:11)(cid:48)(cid:48)(cid:7)(cid:5)(cid:3)(cid:9)(cid:2)(cid:28)(cid:3,,26490.0
,,34,,,Unknown,,cid:3)(cid:5)(cid:14)(cid:70)(cid:12)(cid:11)(cid:4)(cid:14)(cid:11)(cid:48)(cid:48)(cid:7)(cid:5)(cid:3)(cid:9)(cid:2)(cid:12)(cid:11)(cid:4)(cid:14)(cid:11)(cid:48)(cid:48)(cid:7)(cid:5)(cid:3)(cid:9)(cid:2)(cid:28)(cid:3,,26524.0
,,33,,,Unknown,,cid:3)(cid:5)(cid:14)(cid:70)(cid:12)(cid:11)(cid:4)(cid:14)(cid:11)(cid:48)(cid:48)(cid:7)(cid:5)(cid:3)(cid:9)(cid:2)(cid:12)(cid:11)(cid:4)(cid:14)(cid:11)(cid:48)(cid:48)(cid:7)(cid:5)(cid:3)(cid:9)(cid:2)(cid:28)(cid:3,,26557.0
,,1,,,Unknown,,cid:12)(cid:29)(cid:26)(cid:41)(cid:25)(cid:2)(cid:58)(cid:58)(cid:37)(cid:16)(cid:34)(cid:33,cid:7)(cid:8)(cid:28)(cid:11)(cid:64)(cid:3)(cid:5)(cid:28)(cid:28)(cid:5)(cid:2)(cid:12)(cid:47)(cid:2)(cid:66)(cid:7)(cid:8)(cid:12)(cid:5)(cid:8)(cid:8)(cid:5)(cid:9)(cid:2)(cid:28)(cid:3,1.0
,,17,,,Unknown,,cid:12)(cid:29)(cid:26)(cid:41)(cid:25)(cid:2)(cid:58)(cid:58)(cid:37)(cid:16)(cid:34)(cid:33,cid:9)(cid:46)(cid:8)(cid:5)(cid:28)(cid:2)(cid:9)(cid:5)(cid:8)(cid:14)(cid:7)(cid:9)(cid:2)(cid:28)(cid:3,18.0
,,45,,,Unknown,,cid:12)(cid:29)(cid:26)(cid:41)(cid:25)(cid:2)(cid:58)(cid:58)(cid:37)(cid:16)(cid:34)(cid:33,cid:9)(cid:46)(cid:8)(cid:5)(cid:28)(cid:2)(cid:9)(cid:5)(cid:8)(cid:14)(cid:7)(cid:9)(cid:2)(cid:28)(cid:3,63.0
,,18,,,Unknown,,cid:12)(cid:29)(cid:26)(cid:41)(cid:25)(cid:2)(cid:58)(cid:58)(cid:37)(cid:16)(cid:34)(cid:33,,81.0
,,16,,,Unknown,,cid:12)(cid:29)(cid:26)(cid:41)(cid:25)(cid:2)(cid:58)(cid:58)(cid:37)(cid:16)(cid:34)(cid:33,,97.0
,,11,,,Unknown,,cid:12)(cid:29)(cid:26)(cid:41)(cid:25)(cid:2)(cid:58)(cid:58)(cid:37)(cid:16)(cid:34)(cid:33,,108.0
,,3,,,Unknown,,cid:12)(cid:29)(cid:26)(cid:41)(cid:25)(cid:2)(cid:58)(cid:58)(cid:37)(cid:16)(cid:34)(cid:33,,111.0
,,46,,,Unknown,,cid:12)(cid:29)(cid:26)(cid:41)(cid:25)(cid:2)(cid:58)(cid:58)(cid:37)(cid:16)(cid:34)(cid:33,,157.0
,,8,,,Unknown,,cid:12)(cid:29)(cid:26)(cid:41)(cid:25)(cid:2)(cid:58)(cid:58)(cid:37)(cid:16)(cid:34)(cid:33,,165.0
,,64,,,Unknown,,cid:12)(cid:29)(cid:26)(cid:41)(cid:25)(cid:2)(cid:58)(cid:58)(cid:37)(cid:16)(cid:34)(cid:33,,229.0
,,5,,,Unknown,,cid:12)(cid:29)(cid:26)(cid:41)(cid:25)(cid:2)(cid:58)(cid:58)(cid:37)(cid:16)(cid:34)(cid:33,,234.0
,,2,,,Unknown,,cid:12)(cid:29)(cid:26)(cid:41)(cid:25)(cid:2)(cid:58)(cid:58)(cid:37)(cid:16)(cid:34)(cid:33,,236.0
,,28,,,Unknown,,cid:12)(cid:29)(cid:26)(cid:41)(cid:25)(cid:2)(cid:58)(cid:58)(cid:37)(cid:16)(cid:34)(cid:33,,264.0
,,46,,,Unknown,,cid:12)(cid:29)(cid:26)(cid:41)(cid:25)(cid:2)(cid:58)(cid:58)(cid:37)(cid:16)(cid:34)(cid:33,,310.0
,,12,,,Unknown,,cid:12)(cid:29)(cid:26)(cid:41)(cid:25)(cid:2)(cid:58)(cid:58)(cid:37)(cid:16)(cid:34)(cid:33,,322.0
,,10,,,Unknown,,cid:12)(cid:29)(cid:26)(cid:41)(cid:25)(cid:2)(cid:58)(cid:58)(cid:37)(cid:16)(cid:34)(cid:33,,332.0
,,2,,,Unknown,,cid:12)(cid:29)(cid:26)(cid:41)(cid:25)(cid:2)(cid:58)(cid:58)(cid:37)(cid:16)(cid:34)(cid:33,,334.0
,,16,,,Unknown,,cid:12)(cid:29)(cid:26)(cid:41)(cid:25)(cid:2)(cid:58)(cid:58)(cid:37)(cid:16)(cid:34)(cid:33,,350.0
,,36,,,Unknown,,cid:12)(cid:29)(cid:26)(cid:41)(cid:25)(cid:2)(cid:58)(cid:58)(cid:37)(cid:16)(cid:34)(cid:33,,386.0
,,2,,,Unknown,,cid:12)(cid:29)(cid:26)(cid:41)(cid:25)(cid:2)(cid:58)(cid:58)(cid:37)(cid:16)(cid:34)(cid:33,,388.0
,,39,,,Unknown,,cid:12)(cid:29)(cid:26)(cid:41)(cid:25)(cid:2)(cid:58)(cid:58)(cid:37)(cid:16)(cid:34)(cid:33,,427.0
,,46,,,Unknown,,cid:12)(cid:29)(cid:26)(cid:41)(cid:25)(cid:2)(cid:58)(cid:58)(cid:37)(cid:16)(cid:34)(cid:33,,473.0
,,3,,,Unknown,,cid:12)(cid:29)(cid:26)(cid:41)(cid:25)(cid:2)(cid:58)(cid:58)(cid:37)(cid:16)(cid:34)(cid:33,,476.0
,,7,,,Unknown,,cid:12)(cid:29)(cid:26)(cid:41)(cid:25)(cid:2)(cid:58)(cid:58)(cid:37)(cid:16)(cid:34)(cid:33,,483.0
,,9,,,Unknown,,cid:12)(cid:29)(cid:26)(cid:41)(cid:25)(cid:2)(cid:58)(cid:58)(cid:37)(cid:16)(cid:34)(cid:33,,492.0
,,2,,,Unknown,,cid:12)(cid:29)(cid:26)(cid:41)(cid:25)(cid:2)(cid:58)(cid:58)(cid:37)(cid:16)(cid:34)(cid:33,,494.0
,,28,,,Unknown,,cid:12)(cid:29)(cid:26)(cid:41)(cid:25)(cid:2)(cid:58)(cid:58)(cid:37)(cid:16)(cid:34)(cid:33,,522.0
,,3,,,Unknown,,cid:12)(cid:29)(cid:26)(cid:41)(cid:25)(cid:2)(cid:58)(cid:58)(cid:37)(cid:16)(cid:34)(cid:33,,525.0
,,15,,,Unknown,,cid:12)(cid:29)(cid:26)(cid:41)(cid:25)(cid:2)(cid:58)(cid:58)(cid:37)(cid:16)(cid:34)(cid:33,,540.0
,,2,,,Unknown,,cid:12)(cid:29)(cid:26)(cid:41)(cid:25)(cid:2)(cid:58)(cid:58)(cid:37)(cid:16)(cid:34)(cid:33,,542.0
,,32,,,Unknown,,cid:12)(cid:29)(cid:26)(cid:41)(cid:25)(cid:2)(cid:58)(cid:58)(cid:37)(cid:16)(cid:34)(cid:33,,574.0
,,36,,,Unknown,,cid:12)(cid:29)(cid:26)(cid:41)(cid:25)(cid:2)(cid:58)(cid:58)(cid:37)(cid:16)(cid:34)(cid:33,,610.0
,,19,,,Unknown,,cid:12)(cid:29)(cid:26)(cid:41)(cid:25)(cid:2)(cid:58)(cid:58)(cid:37)(cid:16)(cid:34)(cid:33,,629.0
,,33,,,Unknown,,cid:12)(cid:29)(cid:26)(cid:41)(cid:25)(cid:2)(cid:58)(cid:58)(cid:37)(cid:16)(cid:34)(cid:33,,662.0
,,33,,,Unknown,,cid:12)(cid:29)(cid:26)(cid:41)(cid:25)(cid:2)(cid:58)(cid:58)(cid:37)(cid:16)(cid:34)(cid:33,,695.0
,,2,,,Unknown,,cid:12)(cid:29)(cid:26)(cid:41)(cid:25)(cid:2)(cid:58)(cid:58)(cid:37)(cid:16)(cid:34)(cid:33,,697.0
,,44,,,Unknown,,cid:12)(cid:29)(cid:26)(cid:41)(cid:25)(cid:2)(cid:58)(cid:58)(cid:37)(cid:16)(cid:34)(cid:33,,741.0
,,12,,,Unknown,,cid:12)(cid:29)(cid:26)(cid:41)(cid:25)(cid:2)(cid:58)(cid:58)(cid:37)(cid:16)(cid:34)(cid:33,,753.0
,,29,,,Unknown,,cid:12)(cid:29)(cid:26)(cid:41)(cid:25)(cid:2)(cid:58)(cid:58)(cid:37)(cid:16)(cid:34)(cid:33,,782.0
,,26,,,Unknown,,cid:12)(cid:29)(cid:26)(cid:41)(cid:25)(cid:2)(cid:58)(cid:58)(cid:37)(cid:16)(cid:34)(cid:33,,808.0
,,41,,,Unknown,,cid:12)(cid:29)(cid:26)(cid:41)(cid:25)(cid:2)(cid:58)(cid:58)(cid:37)(cid:16)(cid:34)(cid:33,,849.0
,,25,,,Unknown,,cid:12)(cid:29)(cid:26)(cid:41)(cid:25)(cid:2)(cid:58)(cid:58)(cid:37)(cid:16)(cid:34)(cid:33,,874.0
,,2,,,Unknown,,cid:12)(cid:29)(cid:26)(cid:41)(cid:25)(cid:2)(cid:58)(cid:58)(cid:37)(cid:16)(cid:34)(cid:33,,876.0
,,58,,,Unknown,,cid:12)(cid:29)(cid:26)(cid:41)(cid:25)(cid:2)(cid:58)(cid:58)(cid:37)(cid:16)(cid:34)(cid:33,,934.0
,,58,,,Unknown,,cid:12)(cid:29)(cid:26)(cid:41)(cid:25)(cid:2)(cid:58)(cid:58)(cid:37)(cid:16)(cid:34)(cid:33,,992.0
,,37,,,Unknown,,cid:12)(cid:29)(cid:26)(cid:41)(cid:25)(cid:2)(cid:58)(cid:58)(cid:37)(cid:16)(cid:34)(cid:33,,1029.0
,,16,,,Unknown,,cid:12)(cid:29)(cid:26)(cid:41)(cid:25)(cid:2)(cid:58)(cid:58)(cid:37)(cid:16)(cid:34)(cid:33,,1045.0
,,34,,,Unknown,,cid:12)(cid:29)(cid:26)(cid:41)(cid:25)(cid:2)(cid:58)(cid:58)(cid:37)(cid:16)(cid:34)(cid:33,,1079.0
,,33,,,Unknown,,cid:12)(cid:29)(cid:26)(cid:41)(cid:25)(cid:2)(cid:58)(cid:58)(cid:37)(cid:16)(cid:34)(cid:33,,1112.0
,,1,,,Unknown,,cid:12)(cid:29)(cid:26)(cid:41)(cid:25)(cid:2)(cid:58)(cid:58)(cid:37)(cid:16)(cid:34)(cid:33,,1113.0
,,1,,,Unknown,,cid:12)(cid:29)(cid:26)(cid:41)(cid:25)(cid:2)(cid:58)(cid:58)(cid:37)(cid:16)(cid:34)(cid:33,,1114.0
,,45,,,Unknown,,cid:12)(cid:29)(cid:26)(cid:41)(cid:25)(cid:2)(cid:58)(cid:58)(cid:37)(cid:16)(cid:34)(cid:33,,1159.0
,,18,,,Unknown,,cid:12)(cid:29)(cid:26)(cid:41)(cid:25)(cid:2)(cid:58)(cid:58)(cid:37)(cid:16)(cid:34)(cid:33,,1177.0
,,16,,,Unknown,,cid:12)(cid:29)(cid:26)(cid:41)(cid:25)(cid:2)(cid:58)(cid:58)(cid:37)(cid:16)(cid:34)(cid:33,,1193.0
,,14,,,Unknown,,cid:12)(cid:29)(cid:26)(cid:41)(cid:25)(cid:2)(cid:58)(cid:58)(cid:37)(cid:16)(cid:34)(cid:33,,1207.0
,,5,,,Unknown,,cid:12)(cid:29)(cid:26)(cid:41)(cid:25)(cid:2)(cid:58)(cid:58)(cid:37)(cid:16)(cid:34)(cid:33,,1212.0
,,47,,,Unknown,,cid:12)(cid:29)(cid:26)(cid:41)(cid:25)(cid:2)(cid:58)(cid:58)(cid:37)(cid:16)(cid:34)(cid:33,,1259.0
,,5,,,Unknown,,cid:12)(cid:29)(cid:26)(cid:41)(cid:25)(cid:2)(cid:58)(cid:58)(cid:37)(cid:16)(cid:34)(cid:33,,1264.0
,,5,,,Unknown,,cid:12)(cid:29)(cid:26)(cid:41)(cid:25)(cid:2)(cid:58)(cid:58)(cid:37)(cid:16)(cid:34)(cid:33,,1269.0
,,43,,,Unknown,,cid:12)(cid:29)(cid:26)(cid:41)(cid:25)(cid:2)(cid:58)(cid:58)(cid:37)(cid:16)(cid:34)(cid:33,,1312.0
,,2,,,Unknown,,cid:12)(cid:29)(cid:26)(cid:41)(cid:25)(cid:2)(cid:58)(cid:58)(cid:37)(cid:16)(cid:34)(cid:33,,1314.0
,,36,,,Unknown,,cid:12)(cid:29)(cid:26)(cid:41)(cid:25)(cid:2)(cid:58)(cid:58)(cid:37)(cid:16)(cid:34)(cid:33,,1350.0
,,35,,,Unknown,,cid:12)(cid:29)(cid:26)(cid:41)(cid:25)(cid:2)(cid:58)(cid:58)(cid:37)(cid:16)(cid:34)(cid:33,,1385.0
,,18,,,Unknown,,cid:12)(cid:29)(cid:26)(cid:41)(cid:25)(cid:2)(cid:58)(cid:58)(cid:37)(cid:16)(cid:34)(cid:33,,1403.0
,,19,,,Unknown,,cid:12)(cid:29)(cid:26)(cid:41)(cid:25)(cid:2)(cid:58)(cid:58)(cid:37)(cid:16)(cid:34)(cid:33,,1422.0
,,18,,,Unknown,,cid:12)(cid:29)(cid:26)(cid:41)(cid:25)(cid:2)(cid:58)(cid:58)(cid:37)(cid:16)(cid:34)(cid:33,,1440.0
,,18,,,Unknown,,cid:12)(cid:29)(cid:26)(cid:41)(cid:25)(cid:2)(cid:58)(cid:58)(cid:37)(cid:16)(cid:34)(cid:33,,1458.0
,,2,,,Unknown,,cid:12)(cid:29)(cid:26)(cid:41)(cid:25)(cid:2)(cid:58)(cid:58)(cid:37)(cid:16)(cid:34)(cid:33,,1460.0
,,44,,,Unknown,,cid:12)(cid:29)(cid:26)(cid:41)(cid:25)(cid:2)(cid:58)(cid:58)(cid:37)(cid:16)(cid:34)(cid:33,,1504.0
,,50,,,Unknown,,cid:12)(cid:29)(cid:26)(cid:41)(cid:25)(cid:2)(cid:58)(cid:58)(cid:37)(cid:16)(cid:34)(cid:33,,1554.0
,,42,,,Unknown,,cid:12)(cid:29)(cid:26)(cid:41)(cid:25)(cid:2)(cid:58)(cid:58)(cid:37)(cid:16)(cid:34)(cid:33,,1596.0
,,51,,,Unknown,,cid:12)(cid:29)(cid:26)(cid:41)(cid:25)(cid:2)(cid:58)(cid:58)(cid:37)(cid:16)(cid:34)(cid:33,,1647.0
,,52,,,Unknown,,cid:12)(cid:29)(cid:26)(cid:41)(cid:25)(cid:2)(cid:58)(cid:58)(cid:37)(cid:16)(cid:34)(cid:33,,1699.0
,,41,,,Unknown,,cid:12)(cid:29)(cid:26)(cid:41)(cid:25)(cid:2)(cid:58)(cid:58)(cid:37)(cid:16)(cid:34)(cid:33,,1740.0
,,2,,,Unknown,,cid:12)(cid:29)(cid:26)(cid:41)(cid:25)(cid:2)(cid:58)(cid:58)(cid:37)(cid:16)(cid:34)(cid:33,,1742.0
,,53,,,Unknown,,cid:12)(cid:29)(cid:26)(cid:41)(cid:25)(cid:2)(cid:58)(cid:58)(cid:37)(cid:16)(cid:34)(cid:33,,1795.0
,,25,,,Unknown,,cid:12)(cid:29)(cid:26)(cid:41)(cid:25)(cid:2)(cid:58)(cid:58)(cid:37)(cid:16)(cid:34)(cid:33,,1820.0
,,2,,,Unknown,,cid:12)(cid:29)(cid:26)(cid:41)(cid:25)(cid:2)(cid:58)(cid:58)(cid:37)(cid:16)(cid:34)(cid:33,,1822.0
,,31,,,Unknown,,cid:12)(cid:29)(cid:26)(cid:41)(cid:25)(cid:2)(cid:58)(cid:58)(cid:37)(cid:16)(cid:34)(cid:33,,1853.0
,,54,,,Unknown,,cid:12)(cid:29)(cid:26)(cid:41)(cid:25)(cid:2)(cid:58)(cid:58)(cid:37)(cid:16)(cid:34)(cid:33,,1907.0
,,55,,,Unknown,,cid:12)(cid:29)(cid:26)(cid:41)(cid:25)(cid:2)(cid:58)(cid:58)(cid:37)(cid:16)(cid:34)(cid:33,,1962.0
,,56,,,Unknown,,cid:12)(cid:29)(cid:26)(cid:41)(cid:25)(cid:2)(cid:58)(cid:58)(cid:37)(cid:16)(cid:34)(cid:33,,2018.0
,,21,,,Unknown,,cid:12)(cid:29)(cid:26)(cid:41)(cid:25)(cid:2)(cid:58)(cid:58)(cid:37)(cid:16)(cid:34)(cid:33,,2039.0
,,25,,,Unknown,,cid:12)(cid:29)(cid:26)(cid:41)(cid:25)(cid:2)(cid:58)(cid:58)(cid:37)(cid:16)(cid:34)(cid:33,,2064.0
,,1,,,Unknown,,cid:12)(cid:29)(cid:26)(cid:41)(cid:25)(cid:2)(cid:58)(cid:58)(cid:37)(cid:16)(cid:34)(cid:33,,2065.0
,,1,,,Unknown,,cid:12)(cid:29)(cid:26)(cid:41)(cid:25)(cid:2)(cid:58)(cid:58)(cid:37)(cid:16)(cid:34)(cid:33,,2066.0
,,45,,,Unknown,,cid:12)(cid:29)(cid:26)(cid:41)(cid:25)(cid:2)(cid:58)(cid:58)(cid:37)(cid:16)(cid:34)(cid:33,,2111.0
,,18,,,Unknown,,cid:12)(cid:29)(cid:26)(cid:41)(cid:25)(cid:2)(cid:58)(cid:58)(cid:37)(cid:16)(cid:34)(cid:33,,2129.0
,,16,,,Unknown,,cid:12)(cid:29)(cid:26)(cid:41)(cid:25)(cid:2)(cid:58)(cid:58)(cid:37)(cid:16)(cid:34)(cid:33,,2145.0
,,50,,,Unknown,,cid:12)(cid:29)(cid:26)(cid:41)(cid:25)(cid:2)(cid:58)(cid:58)(cid:37)(cid:16)(cid:34)(cid:33,,2195.0
,,46,,,Unknown,,cid:12)(cid:29)(cid:26)(cid:41)(cid:25)(cid:2)(cid:58)(cid:58)(cid:37)(cid:16)(cid:34)(cid:33,,2241.0
,,4,,,Unknown,,cid:12)(cid:29)(cid:26)(cid:41)(cid:25)(cid:2)(cid:58)(cid:58)(cid:37)(cid:16)(cid:34)(cid:33,,2245.0
,,64,,,Unknown,,cid:12)(cid:29)(cid:26)(cid:41)(cid:25)(cid:2)(cid:58)(cid:58)(cid:37)(cid:16)(cid:34)(cid:33,,2309.0
,,8,,,Unknown,,cid:12)(cid:29)(cid:26)(cid:41)(cid:25)(cid:2)(cid:58)(cid:58)(cid:37)(cid:16)(cid:34)(cid:33,,2317.0
,,49,,,Unknown,,cid:12)(cid:29)(cid:26)(cid:41)(cid:25)(cid:2)(cid:58)(cid:58)(cid:37)(cid:16)(cid:34)(cid:33,,2366.0
,,2,,,Unknown,,cid:12)(cid:29)(cid:26)(cid:41)(cid:25)(cid:2)(cid:58)(cid:58)(cid:37)(cid:16)(cid:34)(cid:33,,2368.0
,,72,,,Unknown,,cid:12)(cid:29)(cid:26)(cid:41)(cid:25)(cid:2)(cid:58)(cid:58)(cid:37)(cid:16)(cid:34)(cid:33,,2440.0
,,46,,,Unknown,,cid:12)(cid:29)(cid:26)(cid:41)(cid:25)(cid:2)(cid:58)(cid:58)(cid:37)(cid:16)(cid:34)(cid:33,,2486.0
,,12,,,Unknown,,cid:12)(cid:29)(cid:26)(cid:41)(cid:25)(cid:2)(cid:58)(cid:58)(cid:37)(cid:16)(cid:34)(cid:33,,2498.0
,,38,,,Unknown,,cid:12)(cid:29)(cid:26)(cid:41)(cid:25)(cid:2)(cid:58)(cid:58)(cid:37)(cid:16)(cid:34)(cid:33,,2536.0
,,4,,,Unknown,,cid:12)(cid:29)(cid:26)(cid:41)(cid:25)(cid:2)(cid:58)(cid:58)(cid:37)(cid:16)(cid:34)(cid:33,,2540.0
,,5,,,Unknown,,cid:12)(cid:29)(cid:26)(cid:41)(cid:25)(cid:2)(cid:58)(cid:58)(cid:37)(cid:16)(cid:34)(cid:33,,2545.0
,,14,,,Unknown,,cid:12)(cid:29)(cid:26)(cid:41)(cid:25)(cid:2)(cid:58)(cid:58)(cid:37)(cid:16)(cid:34)(cid:33,,2559.0
,,7,,,Unknown,,cid:12)(cid:29)(cid:26)(cid:41)(cid:25)(cid:2)(cid:58)(cid:58)(cid:37)(cid:16)(cid:34)(cid:33,,2566.0
,,8,,,Unknown,,cid:12)(cid:29)(cid:26)(cid:41)(cid:25)(cid:2)(cid:58)(cid:58)(cid:37)(cid:16)(cid:34)(cid:33,,2574.0
,,5,,,Unknown,,cid:12)(cid:29)(cid:26)(cid:41)(cid:25)(cid:2)(cid:58)(cid:58)(cid:37)(cid:16)(cid:34)(cid:33,,2579.0
,,43,,,Unknown,,cid:12)(cid:29)(cid:26)(cid:41)(cid:25)(cid:2)(cid:58)(cid:58)(cid:37)(cid:16)(cid:34)(cid:33,,2622.0
,,2,,,Unknown,,cid:12)(cid:29)(cid:26)(cid:41)(cid:25)(cid:2)(cid:58)(cid:58)(cid:37)(cid:16)(cid:34)(cid:33,,2624.0
,,1,,,Unknown,,cid:12)(cid:29)(cid:26)(cid:41)(cid:25)(cid:2)(cid:58)(cid:58)(cid:37)(cid:16)(cid:34)(cid:33,,2625.0
,,32,,,Unknown,,cid:12)(cid:29)(cid:26)(cid:41)(cid:25)(cid:2)(cid:58)(cid:58)(cid:37)(cid:16)(cid:34)(cid:33,,2657.0
,,18,,,Unknown,,cid:12)(cid:29)(cid:26)(cid:41)(cid:25)(cid:2)(cid:58)(cid:58)(cid:37)(cid:16)(cid:34)(cid:33,,2675.0
,,19,,,Unknown,,cid:12)(cid:29)(cid:26)(cid:41)(cid:25)(cid:2)(cid:58)(cid:58)(cid:37)(cid:16)(cid:34)(cid:33,,2694.0
,,18,,,Unknown,,cid:12)(cid:29)(cid:26)(cid:41)(cid:25)(cid:2)(cid:58)(cid:58)(cid:37)(cid:16)(cid:34)(cid:33,,2712.0
,,18,,,Unknown,,cid:12)(cid:29)(cid:26)(cid:41)(cid:25)(cid:2)(cid:58)(cid:58)(cid:37)(cid:16)(cid:34)(cid:33,,2730.0
,,2,,,Unknown,,cid:12)(cid:29)(cid:26)(cid:41)(cid:25)(cid:2)(cid:58)(cid:58)(cid:37)(cid:16)(cid:34)(cid:33,,2732.0
,,44,,,Unknown,,cid:12)(cid:29)(cid:26)(cid:41)(cid:25)(cid:2)(cid:58)(cid:58)(cid:37)(cid:16)(cid:34)(cid:33,,2776.0
,,50,,,Unknown,,cid:12)(cid:29)(cid:26)(cid:41)(cid:25)(cid:2)(cid:58)(cid:58)(cid:37)(cid:16)(cid:34)(cid:33,,2826.0
,,42,,,Unknown,,cid:12)(cid:29)(cid:26)(cid:41)(cid:25)(cid:2)(cid:58)(cid:58)(cid:37)(cid:16)(cid:34)(cid:33,,2868.0
,,51,,,Unknown,,cid:12)(cid:29)(cid:26)(cid:41)(cid:25)(cid:2)(cid:58)(cid:58)(cid:37)(cid:16)(cid:34)(cid:33,,2919.0
,,52,,,Unknown,,cid:12)(cid:29)(cid:26)(cid:41)(cid:25)(cid:2)(cid:58)(cid:58)(cid:37)(cid:16)(cid:34)(cid:33,,2971.0
,,41,,,Unknown,,cid:12)(cid:29)(cid:26)(cid:41)(cid:25)(cid:2)(cid:58)(cid:58)(cid:37)(cid:16)(cid:34)(cid:33,,3012.0
,,2,,,Unknown,,cid:12)(cid:29)(cid:26)(cid:41)(cid:25)(cid:2)(cid:58)(cid:58)(cid:37)(cid:16)(cid:34)(cid:33,,3014.0
,,53,,,Unknown,,cid:12)(cid:29)(cid:26)(cid:41)(cid:25)(cid:2)(cid:58)(cid:58)(cid:37)(cid:16)(cid:34)(cid:33,,3067.0
,,25,,,Unknown,,cid:12)(cid:29)(cid:26)(cid:41)(cid:25)(cid:2)(cid:58)(cid:58)(cid:37)(cid:16)(cid:34)(cid:33,,3092.0
,,2,,,Unknown,,cid:12)(cid:29)(cid:26)(cid:41)(cid:25)(cid:2)(cid:58)(cid:58)(cid:37)(cid:16)(cid:34)(cid:33,,3094.0
,,31,,,Unknown,,cid:12)(cid:29)(cid:26)(cid:41)(cid:25)(cid:2)(cid:58)(cid:58)(cid:37)(cid:16)(cid:34)(cid:33,,3125.0
,,54,,,Unknown,,cid:12)(cid:29)(cid:26)(cid:41)(cid:25)(cid:2)(cid:58)(cid:58)(cid:37)(cid:16)(cid:34)(cid:33,,3179.0
,,55,,,Unknown,,cid:12)(cid:29)(cid:26)(cid:41)(cid:25)(cid:2)(cid:58)(cid:58)(cid:37)(cid:16)(cid:34)(cid:33,,3234.0
,,56,,,Unknown,,cid:12)(cid:29)(cid:26)(cid:41)(cid:25)(cid:2)(cid:58)(cid:58)(cid:37)(cid:16)(cid:34)(cid:33,,3290.0
,,21,,,Unknown,,cid:12)(cid:29)(cid:26)(cid:41)(cid:25)(cid:2)(cid:58)(cid:58)(cid:37)(cid:16)(cid:34)(cid:33,,3311.0
,,25,,,Unknown,,cid:12)(cid:29)(cid:26)(cid:41)(cid:25)(cid:2)(cid:58)(cid:58)(cid:37)(cid:16)(cid:34)(cid:33,,3336.0
,,1,,,Unknown,,cid:12)(cid:29)(cid:26)(cid:41)(cid:25)(cid:2)(cid:58)(cid:58)(cid:37)(cid:16)(cid:34)(cid:33,,3337.0
,,1,,,Unknown,,cid:12)(cid:29)(cid:26)(cid:41)(cid:25)(cid:2)(cid:58)(cid:58)(cid:37)(cid:16)(cid:34)(cid:33,,3338.0
,,45,,,Unknown,,cid:12)(cid:29)(cid:26)(cid:41)(cid:25)(cid:2)(cid:58)(cid:58)(cid:37)(cid:16)(cid:34)(cid:33,,3383.0
,,18,,,Unknown,,cid:12)(cid:29)(cid:26)(cid:41)(cid:25)(cid:2)(cid:58)(cid:58)(cid:37)(cid:16)(cid:34)(cid:33,,3401.0
,,16,,,Unknown,,cid:12)(cid:29)(cid:26)(cid:41)(cid:25)(cid:2)(cid:58)(cid:58)(cid:37)(cid:16)(cid:34)(cid:33,,3417.0
,,50,,,Unknown,,cid:12)(cid:29)(cid:26)(cid:41)(cid:25)(cid:2)(cid:58)(cid:58)(cid:37)(cid:16)(cid:34)(cid:33,,3467.0
,,46,,,Unknown,,cid:12)(cid:29)(cid:26)(cid:41)(cid:25)(cid:2)(cid:58)(cid:58)(cid:37)(cid:16)(cid:34)(cid:33,,3513.0
,,4,,,Unknown,,cid:12)(cid:29)(cid:26)(cid:41)(cid:25)(cid:2)(cid:58)(cid:58)(cid:37)(cid:16)(cid:34)(cid:33,,3517.0
,,64,,,Unknown,,cid:12)(cid:29)(cid:26)(cid:41)(cid:25)(cid:2)(cid:58)(cid:58)(cid:37)(cid:16)(cid:34)(cid:33,,3581.0
,,8,,,Unknown,,cid:12)(cid:29)(cid:26)(cid:41)(cid:25)(cid:2)(cid:58)(cid:58)(cid:37)(cid:16)(cid:34)(cid:33,,3589.0
,,49,,,Unknown,,cid:12)(cid:29)(cid:26)(cid:41)(cid:25)(cid:2)(cid:58)(cid:58)(cid:37)(cid:16)(cid:34)(cid:33,,3638.0
,,43,,,Unknown,,cid:12)(cid:29)(cid:26)(cid:41)(cid:25)(cid:2)(cid:58)(cid:58)(cid:37)(cid:16)(cid:34)(cid:33,,3681.0
,,2,,,Unknown,,cid:12)(cid:29)(cid:26)(cid:41)(cid:25)(cid:2)(cid:58)(cid:58)(cid:37)(cid:16)(cid:34)(cid:33,,3683.0
,,1,,,Unknown,,cid:12)(cid:29)(cid:26)(cid:41)(cid:25)(cid:2)(cid:58)(cid:58)(cid:37)(cid:16)(cid:34)(cid:33,,3684.0
,,32,,,Unknown,,cid:12)(cid:29)(cid:26)(cid:41)(cid:25)(cid:2)(cid:58)(cid:58)(cid:37)(cid:16)(cid:34)(cid:33,,3716.0
,,18,,,Unknown,,cid:12)(cid:29)(cid:26)(cid:41)(cid:25)(cid:2)(cid:58)(cid:58)(cid:37)(cid:16)(cid:34)(cid:33,,3734.0
,,19,,,Unknown,,cid:12)(cid:29)(cid:26)(cid:41)(cid:25)(cid:2)(cid:58)(cid:58)(cid:37)(cid:16)(cid:34)(cid:33,,3753.0
,,18,,,Unknown,,cid:12)(cid:29)(cid:26)(cid:41)(cid:25)(cid:2)(cid:58)(cid:58)(cid:37)(cid:16)(cid:34)(cid:33,,3771.0
,,18,,,Unknown,,cid:12)(cid:29)(cid:26)(cid:41)(cid:25)(cid:2)(cid:58)(cid:58)(cid:37)(cid:16)(cid:34)(cid:33,,3789.0
,,2,,,Unknown,,cid:12)(cid:29)(cid:26)(cid:41)(cid:25)(cid:2)(cid:58)(cid:58)(cid:37)(cid:16)(cid:34)(cid:33,,3791.0
,,44,,,Unknown,,cid:12)(cid:29)(cid:26)(cid:41)(cid:25)(cid:2)(cid:58)(cid:58)(cid:37)(cid:16)(cid:34)(cid:33,,3835.0
,,50,,,Unknown,,cid:12)(cid:29)(cid:26)(cid:41)(cid:25)(cid:2)(cid:58)(cid:58)(cid:37)(cid:16)(cid:34)(cid:33,,3885.0
,,42,,,Unknown,,cid:12)(cid:29)(cid:26)(cid:41)(cid:25)(cid:2)(cid:58)(cid:58)(cid:37)(cid:16)(cid:34)(cid:33,,3927.0
,,51,,,Unknown,,cid:12)(cid:29)(cid:26)(cid:41)(cid:25)(cid:2)(cid:58)(cid:58)(cid:37)(cid:16)(cid:34)(cid:33,,3978.0
,,52,,,Unknown,,cid:12)(cid:29)(cid:26)(cid:41)(cid:25)(cid:2)(cid:58)(cid:58)(cid:37)(cid:16)(cid:34)(cid:33,,4030.0
,,41,,,Unknown,,cid:12)(cid:29)(cid:26)(cid:41)(cid:25)(cid:2)(cid:58)(cid:58)(cid:37)(cid:16)(cid:34)(cid:33,,4071.0
,,2,,,Unknown,,cid:12)(cid:29)(cid:26)(cid:41)(cid:25)(cid:2)(cid:58)(cid:58)(cid:37)(cid:16)(cid:34)(cid:33,,4073.0
,,53,,,Unknown,,cid:12)(cid:29)(cid:26)(cid:41)(cid:25)(cid:2)(cid:58)(cid:58)(cid:37)(cid:16)(cid:34)(cid:33,,4126.0
,,25,,,Unknown,,cid:12)(cid:29)(cid:26)(cid:41)(cid:25)(cid:2)(cid:58)(cid:58)(cid:37)(cid:16)(cid:34)(cid:33,,4151.0
,,2,,,Unknown,,cid:12)(cid:29)(cid:26)(cid:41)(cid:25)(cid:2)(cid:58)(cid:58)(cid:37)(cid:16)(cid:34)(cid:33,,4153.0
,,31,,,Unknown,,cid:12)(cid:29)(cid:26)(cid:41)(cid:25)(cid:2)(cid:58)(cid:58)(cid:37)(cid:16)(cid:34)(cid:33,,4184.0
,,54,,,Unknown,,cid:12)(cid:29)(cid:26)(cid:41)(cid:25)(cid:2)(cid:58)(cid:58)(cid:37)(cid:16)(cid:34)(cid:33,,4238.0
,,55,,,Unknown,,cid:12)(cid:29)(cid:26)(cid:41)(cid:25)(cid:2)(cid:58)(cid:58)(cid:37)(cid:16)(cid:34)(cid:33,,4293.0
,,56,,,Unknown,,cid:12)(cid:29)(cid:26)(cid:41)(cid:25)(cid:2)(cid:58)(cid:58)(cid:37)(cid:16)(cid:34)(cid:33,,4349.0
,,21,,,Unknown,,cid:12)(cid:29)(cid:26)(cid:41)(cid:25)(cid:2)(cid:58)(cid:58)(cid:37)(cid:16)(cid:34)(cid:33,,4370.0
,,25,,,Unknown,,cid:12)(cid:29)(cid:26)(cid:41)(cid:25)(cid:2)(cid:58)(cid:58)(cid:37)(cid:16)(cid:34)(cid:33,,4395.0
,,1,,,Unknown,,cid:12)(cid:29)(cid:26)(cid:41)(cid:25)(cid:2)(cid:58)(cid:58)(cid:37)(cid:16)(cid:34)(cid:33,,4396.0
,,1,,,Unknown,,cid:12)(cid:29)(cid:26)(cid:41)(cid:25)(cid:2)(cid:58)(cid:58)(cid:37)(cid:16)(cid:34)(cid:33,,4397.0
,,45,,,Unknown,,cid:12)(cid:29)(cid:26)(cid:41)(cid:25)(cid:2)(cid:58)(cid:58)(cid:37)(cid:16)(cid:34)(cid:33,,4442.0
,,18,,,Unknown,,cid:12)(cid:29)(cid:26)(cid:41)(cid:25)(cid:2)(cid:58)(cid:58)(cid:37)(cid:16)(cid:34)(cid:33,,4460.0
,,16,,,Unknown,,cid:12)(cid:29)(cid:26)(cid:41)(cid:25)(cid:2)(cid:58)(cid:58)(cid:37)(cid:16)(cid:34)(cid:33,,4476.0
,,38,,,Unknown,,cid:12)(cid:29)(cid:26)(cid:41)(cid:25)(cid:2)(cid:58)(cid:58)(cid:37)(cid:16)(cid:34)(cid:33,,4514.0
,,20,,,Unknown,,cid:12)(cid:29)(cid:26)(cid:41)(cid:25)(cid:2)(cid:58)(cid:58)(cid:37)(cid:16)(cid:34)(cid:33,,4534.0
,,30,,,Unknown,,cid:12)(cid:29)(cid:26)(cid:41)(cid:25)(cid:2)(cid:58)(cid:58)(cid:37)(cid:16)(cid:34)(cid:33,,4564.0
,,41,,,Unknown,,cid:12)(cid:29)(cid:26)(cid:41)(cid:25)(cid:2)(cid:58)(cid:58)(cid:37)(cid:16)(cid:34)(cid:33,,4605.0
,,20,,,Unknown,,cid:12)(cid:29)(cid:26)(cid:41)(cid:25)(cid:2)(cid:58)(cid:58)(cid:37)(cid:16)(cid:34)(cid:33,,4625.0
,,15,,,Unknown,,cid:12)(cid:29)(cid:26)(cid:41)(cid:25)(cid:2)(cid:58)(cid:58)(cid:37)(cid:16)(cid:34)(cid:33,,4640.0
,,2,,,Unknown,,cid:12)(cid:29)(cid:26)(cid:41)(cid:25)(cid:2)(cid:58)(cid:58)(cid:37)(cid:16)(cid:34)(cid:33,,4642.0
,,1,,,Unknown,,cid:12)(cid:29)(cid:26)(cid:41)(cid:25)(cid:2)(cid:58)(cid:58)(cid:37)(cid:16)(cid:34)(cid:33,,4643.0
,,19,,,Unknown,,cid:12)(cid:29)(cid:26)(cid:41)(cid:25)(cid:2)(cid:58)(cid:58)(cid:37)(cid:16)(cid:34)(cid:33,,4662.0
,,36,,,Unknown,,cid:12)(cid:29)(cid:26)(cid:41)(cid:25)(cid:2)(cid:58)(cid:58)(cid:37)(cid:16)(cid:34)(cid:33,,4698.0
,,18,,,Unknown,,cid:12)(cid:29)(cid:26)(cid:41)(cid:25)(cid:2)(cid:58)(cid:58)(cid:37)(cid:16)(cid:34)(cid:33,,4716.0
,,2,,,Unknown,,cid:12)(cid:29)(cid:26)(cid:41)(cid:25)(cid:2)(cid:58)(cid:58)(cid:37)(cid:16)(cid:34)(cid:33,,4718.0
,,44,,,Unknown,,cid:12)(cid:29)(cid:26)(cid:41)(cid:25)(cid:2)(cid:58)(cid:58)(cid:37)(cid:16)(cid:34)(cid:33,,4762.0
,,46,,,Unknown,,cid:12)(cid:29)(cid:26)(cid:41)(cid:25)(cid:2)(cid:58)(cid:58)(cid:37)(cid:16)(cid:34)(cid:33,,4808.0
,,57,,,Unknown,,cid:12)(cid:29)(cid:26)(cid:41)(cid:25)(cid:2)(cid:58)(cid:58)(cid:37)(cid:16)(cid:34)(cid:33,,4865.0
,,20,,,Unknown,,cid:12)(cid:29)(cid:26)(cid:41)(cid:25)(cid:2)(cid:58)(cid:58)(cid:37)(cid:16)(cid:34)(cid:33,,4885.0
,,30,,,Unknown,,cid:12)(cid:29)(cid:26)(cid:41)(cid:25)(cid:2)(cid:58)(cid:58)(cid:37)(cid:16)(cid:34)(cid:33,,4915.0
,,30,,,Unknown,,cid:12)(cid:29)(cid:26)(cid:41)(cid:25)(cid:2)(cid:58)(cid:58)(cid:37)(cid:16)(cid:34)(cid:33,,4945.0
,,25,,,Unknown,,cid:12)(cid:29)(cid:26)(cid:41)(cid:25)(cid:2)(cid:58)(cid:58)(cid:37)(cid:16)(cid:34)(cid:33,,4970.0
,,23,,,Unknown,,cid:12)(cid:29)(cid:26)(cid:41)(cid:25)(cid:2)(cid:58)(cid:58)(cid:37)(cid:16)(cid:34)(cid:33,,4993.0
,,25,,,Unknown,,cid:12)(cid:29)(cid:26)(cid:41)(cid:25)(cid:2)(cid:58)(cid:58)(cid:37)(cid:16)(cid:34)(cid:33,,5018.0
,,30,,,Unknown,,cid:12)(cid:29)(cid:26)(cid:41)(cid:25)(cid:2)(cid:58)(cid:58)(cid:37)(cid:16)(cid:34)(cid:33,,5048.0
,,41,,,Unknown,,cid:12)(cid:29)(cid:26)(cid:41)(cid:25)(cid:2)(cid:58)(cid:58)(cid:37)(cid:16)(cid:34)(cid:33,,5089.0
,,2,,,Unknown,,cid:12)(cid:29)(cid:26)(cid:41)(cid:25)(cid:2)(cid:58)(cid:58)(cid:37)(cid:16)(cid:34)(cid:33,,5091.0
,,45,,,Unknown,,cid:12)(cid:29)(cid:26)(cid:41)(cid:25)(cid:2)(cid:58)(cid:58)(cid:37)(cid:16)(cid:34)(cid:33,,5136.0
,,2,,,Unknown,,cid:12)(cid:29)(cid:26)(cid:41)(cid:25)(cid:2)(cid:58)(cid:58)(cid:37)(cid:16)(cid:34)(cid:33,,5138.0
,,28,,,Unknown,,cid:12)(cid:29)(cid:26)(cid:41)(cid:25)(cid:2)(cid:58)(cid:58)(cid:37)(cid:16)(cid:34)(cid:33,,5166.0
,,26,,,Unknown,,cid:12)(cid:29)(cid:26)(cid:41)(cid:25)(cid:2)(cid:58)(cid:58)(cid:37)(cid:16)(cid:34)(cid:33,,5192.0
,,29,,,Unknown,,cid:12)(cid:29)(cid:26)(cid:41)(cid:25)(cid:2)(cid:58)(cid:58)(cid:37)(cid:16)(cid:34)(cid:33,,5221.0
,,24,,,Unknown,,cid:12)(cid:29)(cid:26)(cid:41)(cid:25)(cid:2)(cid:58)(cid:58)(cid:37)(cid:16)(cid:34)(cid:33,,5245.0
,,27,,,Unknown,,cid:12)(cid:29)(cid:26)(cid:41)(cid:25)(cid:2)(cid:58)(cid:58)(cid:37)(cid:16)(cid:34)(cid:33,,5272.0
,,2,,,Unknown,,cid:12)(cid:29)(cid:26)(cid:41)(cid:25)(cid:2)(cid:58)(cid:58)(cid:37)(cid:16)(cid:34)(cid:33,,5274.0
,,29,,,Unknown,,cid:12)(cid:29)(cid:26)(cid:41)(cid:25)(cid:2)(cid:58)(cid:58)(cid:37)(cid:16)(cid:34)(cid:33,,5303.0
,,53,,,Unknown,,cid:12)(cid:29)(cid:26)(cid:41)(cid:25)(cid:2)(cid:58)(cid:58)(cid:37)(cid:16)(cid:34)(cid:33,,5356.0
,,53,,,Unknown,,cid:12)(cid:29)(cid:26)(cid:41)(cid:25)(cid:2)(cid:58)(cid:58)(cid:37)(cid:16)(cid:34)(cid:33,,5409.0
,,24,,,Unknown,,cid:12)(cid:29)(cid:26)(cid:41)(cid:25)(cid:2)(cid:58)(cid:58)(cid:37)(cid:16)(cid:34)(cid:33,,5433.0
,,41,,,Unknown,,cid:12)(cid:29)(cid:26)(cid:41)(cid:25)(cid:2)(cid:58)(cid:58)(cid:37)(cid:16)(cid:34)(cid:33,,5474.0
,,24,,,Unknown,,cid:12)(cid:29)(cid:26)(cid:41)(cid:25)(cid:2)(cid:58)(cid:58)(cid:37)(cid:16)(cid:34)(cid:33,,5498.0
,,20,,,Unknown,,cid:12)(cid:29)(cid:26)(cid:41)(cid:25)(cid:2)(cid:58)(cid:58)(cid:37)(cid:16)(cid:34)(cid:33,,5518.0
,,30,,,Unknown,,cid:12)(cid:29)(cid:26)(cid:41)(cid:25)(cid:2)(cid:58)(cid:58)(cid:37)(cid:16)(cid:34)(cid:33,,5548.0
,,30,,,Unknown,,cid:12)(cid:29)(cid:26)(cid:41)(cid:25)(cid:2)(cid:58)(cid:58)(cid:37)(cid:16)(cid:34)(cid:33,,5578.0
,,25,,,Unknown,,cid:12)(cid:29)(cid:26)(cid:41)(cid:25)(cid:2)(cid:58)(cid:58)(cid:37)(cid:16)(cid:34)(cid:33,,5603.0
,,22,,,Unknown,,cid:12)(cid:29)(cid:26)(cid:41)(cid:25)(cid:2)(cid:58)(cid:58)(cid:37)(cid:16)(cid:34)(cid:33,,5625.0
,,27,,,Unknown,,cid:12)(cid:29)(cid:26)(cid:41)(cid:25)(cid:2)(cid:58)(cid:58)(cid:37)(cid:16)(cid:34)(cid:33,,5652.0
,,1,,,Unknown,,cid:12)(cid:29)(cid:26)(cid:41)(cid:25)(cid:2)(cid:58)(cid:58)(cid:37)(cid:16)(cid:34)(cid:33,,5653.0
,,1,,,Unknown,,cid:12)(cid:29)(cid:26)(cid:41)(cid:25)(cid:2)(cid:58)(cid:58)(cid:37)(cid:16)(cid:34)(cid:33,,5654.0
,,45,,,Unknown,,cid:12)(cid:29)(cid:26)(cid:41)(cid:25)(cid:2)(cid:58)(cid:58)(cid:37)(cid:16)(cid:34)(cid:33,,5699.0
,,18,,,Unknown,,cid:12)(cid:29)(cid:26)(cid:41)(cid:25)(cid:2)(cid:58)(cid:58)(cid:37)(cid:16)(cid:34)(cid:33,,5717.0
,,16,,,Unknown,,cid:12)(cid:29)(cid:26)(cid:41)(cid:25)(cid:2)(cid:58)(cid:58)(cid:37)(cid:16)(cid:34)(cid:33,,5733.0
,,38,,,Unknown,,cid:12)(cid:29)(cid:26)(cid:41)(cid:25)(cid:2)(cid:58)(cid:58)(cid:37)(cid:16)(cid:34)(cid:33,,5771.0
,,20,,,Unknown,,cid:12)(cid:29)(cid:26)(cid:41)(cid:25)(cid:2)(cid:58)(cid:58)(cid:37)(cid:16)(cid:34)(cid:33,,5791.0
,,30,,,Unknown,,cid:12)(cid:29)(cid:26)(cid:41)(cid:25)(cid:2)(cid:58)(cid:58)(cid:37)(cid:16)(cid:34)(cid:33,,5821.0
,,41,,,Unknown,,cid:12)(cid:29)(cid:26)(cid:41)(cid:25)(cid:2)(cid:58)(cid:58)(cid:37)(cid:16)(cid:34)(cid:33,,5862.0
,,20,,,Unknown,,cid:12)(cid:29)(cid:26)(cid:41)(cid:25)(cid:2)(cid:58)(cid:58)(cid:37)(cid:16)(cid:34)(cid:33,,5882.0
,,15,,,Unknown,,cid:12)(cid:29)(cid:26)(cid:41)(cid:25)(cid:2)(cid:58)(cid:58)(cid:37)(cid:16)(cid:34)(cid:33,,5897.0
,,2,,,Unknown,,cid:12)(cid:29)(cid:26)(cid:41)(cid:25)(cid:2)(cid:58)(cid:58)(cid:37)(cid:16)(cid:34)(cid:33,,5899.0
,,1,,,Unknown,,cid:12)(cid:29)(cid:26)(cid:41)(cid:25)(cid:2)(cid:58)(cid:58)(cid:37)(cid:16)(cid:34)(cid:33,,5900.0
,,19,,,Unknown,,cid:12)(cid:29)(cid:26)(cid:41)(cid:25)(cid:2)(cid:58)(cid:58)(cid:37)(cid:16)(cid:34)(cid:33,,5919.0
,,36,,,Unknown,,cid:12)(cid:29)(cid:26)(cid:41)(cid:25)(cid:2)(cid:58)(cid:58)(cid:37)(cid:16)(cid:34)(cid:33,,5955.0
,,18,,,Unknown,,cid:12)(cid:29)(cid:26)(cid:41)(cid:25)(cid:2)(cid:58)(cid:58)(cid:37)(cid:16)(cid:34)(cid:33,,5973.0
,,2,,,Unknown,,cid:12)(cid:29)(cid:26)(cid:41)(cid:25)(cid:2)(cid:58)(cid:58)(cid:37)(cid:16)(cid:34)(cid:33,,5975.0
,,44,,,Unknown,,cid:12)(cid:29)(cid:26)(cid:41)(cid:25)(cid:2)(cid:58)(cid:58)(cid:37)(cid:16)(cid:34)(cid:33,,6019.0
,,46,,,Unknown,,cid:12)(cid:29)(cid:26)(cid:41)(cid:25)(cid:2)(cid:58)(cid:58)(cid:37)(cid:16)(cid:34)(cid:33,,6065.0
,,57,,,Unknown,,cid:12)(cid:29)(cid:26)(cid:41)(cid:25)(cid:2)(cid:58)(cid:58)(cid:37)(cid:16)(cid:34)(cid:33,,6122.0
,,20,,,Unknown,,cid:12)(cid:29)(cid:26)(cid:41)(cid:25)(cid:2)(cid:58)(cid:58)(cid:37)(cid:16)(cid:34)(cid:33,,6142.0
,,30,,,Unknown,,cid:12)(cid:29)(cid:26)(cid:41)(cid:25)(cid:2)(cid:58)(cid:58)(cid:37)(cid:16)(cid:34)(cid:33,,6172.0
,,30,,,Unknown,,cid:12)(cid:29)(cid:26)(cid:41)(cid:25)(cid:2)(cid:58)(cid:58)(cid:37)(cid:16)(cid:34)(cid:33,,6202.0
,,25,,,Unknown,,cid:12)(cid:29)(cid:26)(cid:41)(cid:25)(cid:2)(cid:58)(cid:58)(cid:37)(cid:16)(cid:34)(cid:33,,6227.0
,,23,,,Unknown,,cid:12)(cid:29)(cid:26)(cid:41)(cid:25)(cid:2)(cid:58)(cid:58)(cid:37)(cid:16)(cid:34)(cid:33,,6250.0
,,25,,,Unknown,,cid:12)(cid:29)(cid:26)(cid:41)(cid:25)(cid:2)(cid:58)(cid:58)(cid:37)(cid:16)(cid:34)(cid:33,,6275.0
,,30,,,Unknown,,cid:12)(cid:29)(cid:26)(cid:41)(cid:25)(cid:2)(cid:58)(cid:58)(cid:37)(cid:16)(cid:34)(cid:33,,6305.0
,,41,,,Unknown,,cid:12)(cid:29)(cid:26)(cid:41)(cid:25)(cid:2)(cid:58)(cid:58)(cid:37)(cid:16)(cid:34)(cid:33,,6346.0
,,2,,,Unknown,,cid:12)(cid:29)(cid:26)(cid:41)(cid:25)(cid:2)(cid:58)(cid:58)(cid:37)(cid:16)(cid:34)(cid:33,,6348.0
,,45,,,Unknown,,cid:12)(cid:29)(cid:26)(cid:41)(cid:25)(cid:2)(cid:58)(cid:58)(cid:37)(cid:16)(cid:34)(cid:33,,6393.0
,,2,,,Unknown,,cid:12)(cid:29)(cid:26)(cid:41)(cid:25)(cid:2)(cid:58)(cid:58)(cid:37)(cid:16)(cid:34)(cid:33,,6395.0
,,28,,,Unknown,,cid:12)(cid:29)(cid:26)(cid:41)(cid:25)(cid:2)(cid:58)(cid:58)(cid:37)(cid:16)(cid:34)(cid:33,,6423.0
,,26,,,Unknown,,cid:12)(cid:29)(cid:26)(cid:41)(cid:25)(cid:2)(cid:58)(cid:58)(cid:37)(cid:16)(cid:34)(cid:33,,6449.0
,,29,,,Unknown,,cid:12)(cid:29)(cid:26)(cid:41)(cid:25)(cid:2)(cid:58)(cid:58)(cid:37)(cid:16)(cid:34)(cid:33,,6478.0
,,24,,,Unknown,,cid:12)(cid:29)(cid:26)(cid:41)(cid:25)(cid:2)(cid:58)(cid:58)(cid:37)(cid:16)(cid:34)(cid:33,,6502.0
,,27,,,Unknown,,cid:12)(cid:29)(cid:26)(cid:41)(cid:25)(cid:2)(cid:58)(cid:58)(cid:37)(cid:16)(cid:34)(cid:33,,6529.0
,,2,,,Unknown,,cid:12)(cid:29)(cid:26)(cid:41)(cid:25)(cid:2)(cid:58)(cid:58)(cid:37)(cid:16)(cid:34)(cid:33,,6531.0
,,29,,,Unknown,,cid:12)(cid:29)(cid:26)(cid:41)(cid:25)(cid:2)(cid:58)(cid:58)(cid:37)(cid:16)(cid:34)(cid:33,,6560.0
,,53,,,Unknown,,cid:12)(cid:29)(cid:26)(cid:41)(cid:25)(cid:2)(cid:58)(cid:58)(cid:37)(cid:16)(cid:34)(cid:33,,6613.0
,,53,,,Unknown,,cid:12)(cid:29)(cid:26)(cid:41)(cid:25)(cid:2)(cid:58)(cid:58)(cid:37)(cid:16)(cid:34)(cid:33,,6666.0
,,24,,,Unknown,,cid:12)(cid:29)(cid:26)(cid:41)(cid:25)(cid:2)(cid:58)(cid:58)(cid:37)(cid:16)(cid:34)(cid:33,,6690.0
,,41,,,Unknown,,cid:12)(cid:29)(cid:26)(cid:41)(cid:25)(cid:2)(cid:58)(cid:58)(cid:37)(cid:16)(cid:34)(cid:33,,6731.0
,,24,,,Unknown,,cid:12)(cid:29)(cid:26)(cid:41)(cid:25)(cid:2)(cid:58)(cid:58)(cid:37)(cid:16)(cid:34)(cid:33,,6755.0
,,20,,,Unknown,,cid:12)(cid:29)(cid:26)(cid:41)(cid:25)(cid:2)(cid:58)(cid:58)(cid:37)(cid:16)(cid:34)(cid:33,,6775.0
,,30,,,Unknown,,cid:12)(cid:29)(cid:26)(cid:41)(cid:25)(cid:2)(cid:58)(cid:58)(cid:37)(cid:16)(cid:34)(cid:33,,6805.0
,,30,,,Unknown,,cid:12)(cid:29)(cid:26)(cid:41)(cid:25)(cid:2)(cid:58)(cid:58)(cid:37)(cid:16)(cid:34)(cid:33,,6835.0
,,25,,,Unknown,,cid:12)(cid:29)(cid:26)(cid:41)(cid:25)(cid:2)(cid:58)(cid:58)(cid:37)(cid:16)(cid:34)(cid:33,,6860.0
,,22,,,Unknown,,cid:12)(cid:29)(cid:26)(cid:41)(cid:25)(cid:2)(cid:58)(cid:58)(cid:37)(cid:16)(cid:34)(cid:33,,6882.0
,,27,,,Unknown,,cid:12)(cid:29)(cid:26)(cid:41)(cid:25)(cid:2)(cid:58)(cid:58)(cid:37)(cid:16)(cid:34)(cid:33,,6909.0
,,1,,,Unknown,,cid:12)(cid:29)(cid:26)(cid:41)(cid:25)(cid:2)(cid:58)(cid:58)(cid:37)(cid:16)(cid:34)(cid:33,,6910.0
,,1,,,Unknown,,cid:12)(cid:29)(cid:26)(cid:41)(cid:25)(cid:2)(cid:58)(cid:58)(cid:37)(cid:16)(cid:34)(cid:33,,6911.0
,,45,,,Unknown,,cid:12)(cid:29)(cid:26)(cid:41)(cid:25)(cid:2)(cid:58)(cid:58)(cid:37)(cid:16)(cid:34)(cid:33,,6956.0
,,18,,,Unknown,,cid:12)(cid:29)(cid:26)(cid:41)(cid:25)(cid:2)(cid:58)(cid:58)(cid:37)(cid:16)(cid:34)(cid:33,,6974.0
,,16,,,Unknown,,cid:12)(cid:29)(cid:26)(cid:41)(cid:25)(cid:2)(cid:58)(cid:58)(cid:37)(cid:16)(cid:34)(cid:33,,6990.0
,,38,,,Unknown,,cid:12)(cid:29)(cid:26)(cid:41)(cid:25)(cid:2)(cid:58)(cid:58)(cid:37)(cid:16)(cid:34)(cid:33,,7028.0
,,20,,,Unknown,,cid:12)(cid:29)(cid:26)(cid:41)(cid:25)(cid:2)(cid:58)(cid:58)(cid:37)(cid:16)(cid:34)(cid:33,,7048.0
,,30,,,Unknown,,cid:12)(cid:29)(cid:26)(cid:41)(cid:25)(cid:2)(cid:58)(cid:58)(cid:37)(cid:16)(cid:34)(cid:33,,7078.0
,,41,,,Unknown,,cid:12)(cid:29)(cid:26)(cid:41)(cid:25)(cid:2)(cid:58)(cid:58)(cid:37)(cid:16)(cid:34)(cid:33,,7119.0
,,20,,,Unknown,,cid:12)(cid:29)(cid:26)(cid:41)(cid:25)(cid:2)(cid:58)(cid:58)(cid:37)(cid:16)(cid:34)(cid:33,,7139.0
,,15,,,Unknown,,cid:12)(cid:29)(cid:26)(cid:41)(cid:25)(cid:2)(cid:58)(cid:58)(cid:37)(cid:16)(cid:34)(cid:33,,7154.0
,,2,,,Unknown,,cid:12)(cid:29)(cid:26)(cid:41)(cid:25)(cid:2)(cid:58)(cid:58)(cid:37)(cid:16)(cid:34)(cid:33,,7156.0
,,1,,,Unknown,,cid:12)(cid:29)(cid:26)(cid:41)(cid:25)(cid:2)(cid:58)(cid:58)(cid:37)(cid:16)(cid:34)(cid:33,,7157.0
,,19,,,Unknown,,cid:12)(cid:29)(cid:26)(cid:41)(cid:25)(cid:2)(cid:58)(cid:58)(cid:37)(cid:16)(cid:34)(cid:33,,7176.0
,,36,,,Unknown,,cid:12)(cid:29)(cid:26)(cid:41)(cid:25)(cid:2)(cid:58)(cid:58)(cid:37)(cid:16)(cid:34)(cid:33,,7212.0
,,18,,,Unknown,,cid:12)(cid:29)(cid:26)(cid:41)(cid:25)(cid:2)(cid:58)(cid:58)(cid:37)(cid:16)(cid:34)(cid:33,,7230.0
,,2,,,Unknown,,cid:12)(cid:29)(cid:26)(cid:41)(cid:25)(cid:2)(cid:58)(cid:58)(cid:37)(cid:16)(cid:34)(cid:33,,7232.0
,,44,,,Unknown,,cid:12)(cid:29)(cid:26)(cid:41)(cid:25)(cid:2)(cid:58)(cid:58)(cid:37)(cid:16)(cid:34)(cid:33,,7276.0
,,46,,,Unknown,,cid:12)(cid:29)(cid:26)(cid:41)(cid:25)(cid:2)(cid:58)(cid:58)(cid:37)(cid:16)(cid:34)(cid:33,,7322.0
,,57,,,Unknown,,cid:12)(cid:29)(cid:26)(cid:41)(cid:25)(cid:2)(cid:58)(cid:58)(cid:37)(cid:16)(cid:34)(cid:33,,7379.0
,,20,,,Unknown,,cid:12)(cid:29)(cid:26)(cid:41)(cid:25)(cid:2)(cid:58)(cid:58)(cid:37)(cid:16)(cid:34)(cid:33,,7399.0
,,30,,,Unknown,,cid:12)(cid:29)(cid:26)(cid:41)(cid:25)(cid:2)(cid:58)(cid:58)(cid:37)(cid:16)(cid:34)(cid:33,,7429.0
,,30,,,Unknown,,cid:12)(cid:29)(cid:26)(cid:41)(cid:25)(cid:2)(cid:58)(cid:58)(cid:37)(cid:16)(cid:34)(cid:33,,7459.0
,,25,,,Unknown,,cid:12)(cid:29)(cid:26)(cid:41)(cid:25)(cid:2)(cid:58)(cid:58)(cid:37)(cid:16)(cid:34)(cid:33,,7484.0
,,23,,,Unknown,,cid:12)(cid:29)(cid:26)(cid:41)(cid:25)(cid:2)(cid:58)(cid:58)(cid:37)(cid:16)(cid:34)(cid:33,,7507.0
,,25,,,Unknown,,cid:12)(cid:29)(cid:26)(cid:41)(cid:25)(cid:2)(cid:58)(cid:58)(cid:37)(cid:16)(cid:34)(cid:33,,7532.0
,,30,,,Unknown,,cid:12)(cid:29)(cid:26)(cid:41)(cid:25)(cid:2)(cid:58)(cid:58)(cid:37)(cid:16)(cid:34)(cid:33,,7562.0
,,41,,,Unknown,,cid:12)(cid:29)(cid:26)(cid:41)(cid:25)(cid:2)(cid:58)(cid:58)(cid:37)(cid:16)(cid:34)(cid:33,,7603.0
,,2,,,Unknown,,cid:12)(cid:29)(cid:26)(cid:41)(cid:25)(cid:2)(cid:58)(cid:58)(cid:37)(cid:16)(cid:34)(cid:33,,7605.0
,,45,,,Unknown,,cid:12)(cid:29)(cid:26)(cid:41)(cid:25)(cid:2)(cid:58)(cid:58)(cid:37)(cid:16)(cid:34)(cid:33,,7650.0
,,2,,,Unknown,,cid:12)(cid:29)(cid:26)(cid:41)(cid:25)(cid:2)(cid:58)(cid:58)(cid:37)(cid:16)(cid:34)(cid:33,,7652.0
,,28,,,Unknown,,cid:12)(cid:29)(cid:26)(cid:41)(cid:25)(cid:2)(cid:58)(cid:58)(cid:37)(cid:16)(cid:34)(cid:33,,7680.0
,,26,,,Unknown,,cid:12)(cid:29)(cid:26)(cid:41)(cid:25)(cid:2)(cid:58)(cid:58)(cid:37)(cid:16)(cid:34)(cid:33,,7706.0
,,29,,,Unknown,,cid:12)(cid:29)(cid:26)(cid:41)(cid:25)(cid:2)(cid:58)(cid:58)(cid:37)(cid:16)(cid:34)(cid:33,,7735.0
,,24,,,Unknown,,cid:12)(cid:29)(cid:26)(cid:41)(cid:25)(cid:2)(cid:58)(cid:58)(cid:37)(cid:16)(cid:34)(cid:33,,7759.0
,,27,,,Unknown,,cid:12)(cid:29)(cid:26)(cid:41)(cid:25)(cid:2)(cid:58)(cid:58)(cid:37)(cid:16)(cid:34)(cid:33,,7786.0
,,2,,,Unknown,,cid:12)(cid:29)(cid:26)(cid:41)(cid:25)(cid:2)(cid:58)(cid:58)(cid:37)(cid:16)(cid:34)(cid:33,,7788.0
,,29,,,Unknown,,cid:12)(cid:29)(cid:26)(cid:41)(cid:25)(cid:2)(cid:58)(cid:58)(cid:37)(cid:16)(cid:34)(cid:33,,7817.0
,,53,,,Unknown,,cid:12)(cid:29)(cid:26)(cid:41)(cid:25)(cid:2)(cid:58)(cid:58)(cid:37)(cid:16)(cid:34)(cid:33,,7870.0
,,53,,,Unknown,,cid:12)(cid:29)(cid:26)(cid:41)(cid:25)(cid:2)(cid:58)(cid:58)(cid:37)(cid:16)(cid:34)(cid:33,,7923.0
,,24,,,Unknown,,cid:12)(cid:29)(cid:26)(cid:41)(cid:25)(cid:2)(cid:58)(cid:58)(cid:37)(cid:16)(cid:34)(cid:33,,7947.0
,,41,,,Unknown,,cid:12)(cid:29)(cid:26)(cid:41)(cid:25)(cid:2)(cid:58)(cid:58)(cid:37)(cid:16)(cid:34)(cid:33,,7988.0
,,24,,,Unknown,,cid:12)(cid:29)(cid:26)(cid:41)(cid:25)(cid:2)(cid:58)(cid:58)(cid:37)(cid:16)(cid:34)(cid:33,,8012.0
,,20,,,Unknown,,cid:12)(cid:29)(cid:26)(cid:41)(cid:25)(cid:2)(cid:58)(cid:58)(cid:37)(cid:16)(cid:34)(cid:33,,8032.0
,,30,,,Unknown,,cid:12)(cid:29)(cid:26)(cid:41)(cid:25)(cid:2)(cid:58)(cid:58)(cid:37)(cid:16)(cid:34)(cid:33,,8062.0
,,30,,,Unknown,,cid:12)(cid:29)(cid:26)(cid:41)(cid:25)(cid:2)(cid:58)(cid:58)(cid:37)(cid:16)(cid:34)(cid:33,,8092.0
,,25,,,Unknown,,cid:12)(cid:29)(cid:26)(cid:41)(cid:25)(cid:2)(cid:58)(cid:58)(cid:37)(cid:16)(cid:34)(cid:33,,8117.0
,,22,,,Unknown,,cid:12)(cid:29)(cid:26)(cid:41)(cid:25)(cid:2)(cid:58)(cid:58)(cid:37)(cid:16)(cid:34)(cid:33,,8139.0
,,27,,,Unknown,,cid:12)(cid:29)(cid:26)(cid:41)(cid:25)(cid:2)(cid:58)(cid:58)(cid:37)(cid:16)(cid:34)(cid:33,,8166.0
,,1,,,Unknown,,cid:12)(cid:29)(cid:26)(cid:41)(cid:25)(cid:2)(cid:58)(cid:58)(cid:37)(cid:16)(cid:34)(cid:33,,8167.0
,,37,,,Unknown,,cid:12)(cid:29)(cid:26)(cid:41)(cid:25)(cid:2)(cid:58)(cid:58)(cid:37)(cid:16)(cid:34)(cid:33,,8204.0
,,45,,,Unknown,,cid:12)(cid:29)(cid:26)(cid:41)(cid:25)(cid:2)(cid:58)(cid:58)(cid:37)(cid:16)(cid:34)(cid:33,,8249.0
,,18,,,Unknown,,cid:12)(cid:29)(cid:26)(cid:41)(cid:25)(cid:2)(cid:58)(cid:58)(cid:37)(cid:16)(cid:34)(cid:33,,8267.0
,,16,,,Unknown,,cid:12)(cid:29)(cid:26)(cid:41)(cid:25)(cid:2)(cid:58)(cid:58)(cid:37)(cid:16)(cid:34)(cid:33,,8283.0
,,7,,,Unknown,,cid:12)(cid:29)(cid:26)(cid:41)(cid:25)(cid:2)(cid:58)(cid:58)(cid:37)(cid:16)(cid:34)(cid:33,,8290.0
,,8,,,Unknown,,cid:12)(cid:29)(cid:26)(cid:41)(cid:25)(cid:2)(cid:58)(cid:58)(cid:37)(cid:16)(cid:34)(cid:33,,8298.0
,,28,,,Unknown,,cid:12)(cid:29)(cid:26)(cid:41)(cid:25)(cid:2)(cid:58)(cid:58)(cid:37)(cid:16)(cid:34)(cid:33,,8326.0
,,11,,,Unknown,,cid:12)(cid:29)(cid:26)(cid:41)(cid:25)(cid:2)(cid:58)(cid:58)(cid:37)(cid:16)(cid:34)(cid:33,,8337.0
,,64,,,Unknown,,cid:12)(cid:29)(cid:26)(cid:41)(cid:25)(cid:2)(cid:58)(cid:58)(cid:37)(cid:16)(cid:34)(cid:33,,8401.0
,,3,,,Unknown,,cid:12)(cid:29)(cid:26)(cid:41)(cid:25)(cid:2)(cid:58)(cid:58)(cid:37)(cid:16)(cid:34)(cid:33,,8404.0
,,5,,,Unknown,,cid:12)(cid:29)(cid:26)(cid:41)(cid:25)(cid:2)(cid:58)(cid:58)(cid:37)(cid:16)(cid:34)(cid:33,,8409.0
,,28,,,Unknown,,cid:12)(cid:29)(cid:26)(cid:41)(cid:25)(cid:2)(cid:58)(cid:58)(cid:37)(cid:16)(cid:34)(cid:33,,8437.0
,,28,,,Unknown,,cid:12)(cid:29)(cid:26)(cid:41)(cid:25)(cid:2)(cid:58)(cid:58)(cid:37)(cid:16)(cid:34)(cid:33,,8465.0
,,5,,,Unknown,,cid:12)(cid:29)(cid:26)(cid:41)(cid:25)(cid:2)(cid:58)(cid:58)(cid:37)(cid:16)(cid:34)(cid:33,,8470.0
,,2,,,Unknown,,cid:12)(cid:29)(cid:26)(cid:41)(cid:25)(cid:2)(cid:58)(cid:58)(cid:37)(cid:16)(cid:34)(cid:33,,8472.0
,,12,,,Unknown,,cid:12)(cid:29)(cid:26)(cid:41)(cid:25)(cid:2)(cid:58)(cid:58)(cid:37)(cid:16)(cid:34)(cid:33,,8484.0
,,47,,,Unknown,,cid:12)(cid:29)(cid:26)(cid:41)(cid:25)(cid:2)(cid:58)(cid:58)(cid:37)(cid:16)(cid:34)(cid:33,,8531.0
,,2,,,Unknown,,cid:12)(cid:29)(cid:26)(cid:41)(cid:25)(cid:2)(cid:58)(cid:58)(cid:37)(cid:16)(cid:34)(cid:33,,8533.0
,,66,,,Unknown,,cid:12)(cid:29)(cid:26)(cid:41)(cid:25)(cid:2)(cid:58)(cid:58)(cid:37)(cid:16)(cid:34)(cid:33,,8599.0
,,7,,,Unknown,,cid:12)(cid:29)(cid:26)(cid:41)(cid:25)(cid:2)(cid:58)(cid:58)(cid:37)(cid:16)(cid:34)(cid:33,,8606.0
,,8,,,Unknown,,cid:12)(cid:29)(cid:26)(cid:41)(cid:25)(cid:2)(cid:58)(cid:58)(cid:37)(cid:16)(cid:34)(cid:33,,8614.0
,,12,,,Unknown,,cid:12)(cid:29)(cid:26)(cid:41)(cid:25)(cid:2)(cid:58)(cid:58)(cid:37)(cid:16)(cid:34)(cid:33,,8626.0
,,5,,,Unknown,,cid:12)(cid:29)(cid:26)(cid:41)(cid:25)(cid:2)(cid:58)(cid:58)(cid:37)(cid:16)(cid:34)(cid:33,,8631.0
,,8,,,Unknown,,cid:12)(cid:29)(cid:26)(cid:41)(cid:25)(cid:2)(cid:58)(cid:58)(cid:37)(cid:16)(cid:34)(cid:33,,8639.0
,,8,,,Unknown,,cid:12)(cid:29)(cid:26)(cid:41)(cid:25)(cid:2)(cid:58)(cid:58)(cid:37)(cid:16)(cid:34)(cid:33,,8647.0
,,5,,,Unknown,,cid:12)(cid:29)(cid:26)(cid:41)(cid:25)(cid:2)(cid:58)(cid:58)(cid:37)(cid:16)(cid:34)(cid:33,,8652.0
,,9,,,Unknown,,cid:12)(cid:29)(cid:26)(cid:41)(cid:25)(cid:2)(cid:58)(cid:58)(cid:37)(cid:16)(cid:34)(cid:33,,8661.0
,,2,,,Unknown,,cid:12)(cid:29)(cid:26)(cid:41)(cid:25)(cid:2)(cid:58)(cid:58)(cid:37)(cid:16)(cid:34)(cid:33,,8663.0
,,28,,,Unknown,,cid:12)(cid:29)(cid:26)(cid:41)(cid:25)(cid:2)(cid:58)(cid:58)(cid:37)(cid:16)(cid:34)(cid:33,,8691.0
,,3,,,Unknown,,cid:12)(cid:29)(cid:26)(cid:41)(cid:25)(cid:2)(cid:58)(cid:58)(cid:37)(cid:16)(cid:34)(cid:33,,8694.0
,,15,,,Unknown,,cid:12)(cid:29)(cid:26)(cid:41)(cid:25)(cid:2)(cid:58)(cid:58)(cid:37)(cid:16)(cid:34)(cid:33,,8709.0
,,2,,,Unknown,,cid:12)(cid:29)(cid:26)(cid:41)(cid:25)(cid:2)(cid:58)(cid:58)(cid:37)(cid:16)(cid:34)(cid:33,,8711.0
,,37,,,Unknown,,cid:12)(cid:29)(cid:26)(cid:41)(cid:25)(cid:2)(cid:58)(cid:58)(cid:37)(cid:16)(cid:34)(cid:33,,8748.0
,,19,,,Unknown,,cid:12)(cid:29)(cid:26)(cid:41)(cid:25)(cid:2)(cid:58)(cid:58)(cid:37)(cid:16)(cid:34)(cid:33,,8767.0
,,37,,,Unknown,,cid:12)(cid:29)(cid:26)(cid:41)(cid:25)(cid:2)(cid:58)(cid:58)(cid:37)(cid:16)(cid:34)(cid:33,,8804.0
,,16,,,Unknown,,cid:12)(cid:29)(cid:26)(cid:41)(cid:25)(cid:2)(cid:58)(cid:58)(cid:37)(cid:16)(cid:34)(cid:33,,8820.0
,,2,,,Unknown,,cid:12)(cid:29)(cid:26)(cid:41)(cid:25)(cid:2)(cid:58)(cid:58)(cid:37)(cid:16)(cid:34)(cid:33,,8822.0
,,44,,,Unknown,,cid:12)(cid:29)(cid:26)(cid:41)(cid:25)(cid:2)(cid:58)(cid:58)(cid:37)(cid:16)(cid:34)(cid:33,,8866.0
,,12,,,Unknown,,cid:12)(cid:29)(cid:26)(cid:41)(cid:25)(cid:2)(cid:58)(cid:58)(cid:37)(cid:16)(cid:34)(cid:33,,8878.0
,,29,,,Unknown,,cid:12)(cid:29)(cid:26)(cid:41)(cid:25)(cid:2)(cid:58)(cid:58)(cid:37)(cid:16)(cid:34)(cid:33,,8907.0
,,26,,,Unknown,,cid:12)(cid:29)(cid:26)(cid:41)(cid:25)(cid:2)(cid:58)(cid:58)(cid:37)(cid:16)(cid:34)(cid:33,,8933.0
,,41,,,Unknown,,cid:12)(cid:29)(cid:26)(cid:41)(cid:25)(cid:2)(cid:58)(cid:58)(cid:37)(cid:16)(cid:34)(cid:33,,8974.0
,,25,,,Unknown,,cid:12)(cid:29)(cid:26)(cid:41)(cid:25)(cid:2)(cid:58)(cid:58)(cid:37)(cid:16)(cid:34)(cid:33,,8999.0
,,2,,,Unknown,,cid:12)(cid:29)(cid:26)(cid:41)(cid:25)(cid:2)(cid:58)(cid:58)(cid:37)(cid:16)(cid:34)(cid:33,,9001.0
,,58,,,Unknown,,cid:12)(cid:29)(cid:26)(cid:41)(cid:25)(cid:2)(cid:58)(cid:58)(cid:37)(cid:16)(cid:34)(cid:33,,9059.0
,,58,,,Unknown,,cid:12)(cid:29)(cid:26)(cid:41)(cid:25)(cid:2)(cid:58)(cid:58)(cid:37)(cid:16)(cid:34)(cid:33,,9117.0
,,37,,,Unknown,,cid:12)(cid:29)(cid:26)(cid:41)(cid:25)(cid:2)(cid:58)(cid:58)(cid:37)(cid:16)(cid:34)(cid:33,,9154.0
,,16,,,Unknown,,cid:12)(cid:29)(cid:26)(cid:41)(cid:25)(cid:2)(cid:58)(cid:58)(cid:37)(cid:16)(cid:34)(cid:33,,9170.0
,,34,,,Unknown,,cid:12)(cid:29)(cid:26)(cid:41)(cid:25)(cid:2)(cid:58)(cid:58)(cid:37)(cid:16)(cid:34)(cid:33,,9204.0
,,33,,,Unknown,,cid:12)(cid:29)(cid:26)(cid:41)(cid:25)(cid:2)(cid:58)(cid:58)(cid:37)(cid:16)(cid:34)(cid:33,,9237.0
,,1,,,Unknown,,cid:12)(cid:29)(cid:26)(cid:41)(cid:25)(cid:2)(cid:58)(cid:58)(cid:37)(cid:16)(cid:34)(cid:33,,9238.0
,,37,,,Unknown,,cid:12)(cid:29)(cid:26)(cid:41)(cid:25)(cid:2)(cid:58)(cid:58)(cid:37)(cid:16)(cid:34)(cid:33,,9275.0
,,45,,,Unknown,,cid:12)(cid:29)(cid:26)(cid:41)(cid:25)(cid:2)(cid:58)(cid:58)(cid:37)(cid:16)(cid:34)(cid:33,,9320.0
,,18,,,Unknown,,cid:12)(cid:29)(cid:26)(cid:41)(cid:25)(cid:2)(cid:58)(cid:58)(cid:37)(cid:16)(cid:34)(cid:33,,9338.0
,,16,,,Unknown,,cid:12)(cid:29)(cid:26)(cid:41)(cid:25)(cid:2)(cid:58)(cid:58)(cid:37)(cid:16)(cid:34)(cid:33,,9354.0
,,71,,,Unknown,,cid:12)(cid:29)(cid:26)(cid:41)(cid:25)(cid:2)(cid:58)(cid:58)(cid:37)(cid:16)(cid:34)(cid:33,,9425.0
,,29,,,Unknown,,cid:12)(cid:29)(cid:26)(cid:41)(cid:25)(cid:2)(cid:58)(cid:58)(cid:37)(cid:16)(cid:34)(cid:33,,9454.0
,,22,,,Unknown,,cid:12)(cid:29)(cid:26)(cid:41)(cid:25)(cid:2)(cid:58)(cid:58)(cid:37)(cid:16)(cid:34)(cid:33,,9476.0
,,29,,,Unknown,,cid:12)(cid:29)(cid:26)(cid:41)(cid:25)(cid:2)(cid:58)(cid:58)(cid:37)(cid:16)(cid:34)(cid:33,,9505.0
,,30,,,Unknown,,cid:12)(cid:29)(cid:26)(cid:41)(cid:25)(cid:2)(cid:58)(cid:58)(cid:37)(cid:16)(cid:34)(cid:33,,9535.0
,,53,,,Unknown,,cid:12)(cid:29)(cid:26)(cid:41)(cid:25)(cid:2)(cid:58)(cid:58)(cid:37)(cid:16)(cid:34)(cid:33,,9588.0
,,20,,,Unknown,,cid:12)(cid:29)(cid:26)(cid:41)(cid:25)(cid:2)(cid:58)(cid:58)(cid:37)(cid:16)(cid:34)(cid:33,,9608.0
,,2,,,Unknown,,cid:12)(cid:29)(cid:26)(cid:41)(cid:25)(cid:2)(cid:58)(cid:58)(cid:37)(cid:16)(cid:34)(cid:33,,9610.0
,,39,,,Unknown,,cid:12)(cid:29)(cid:26)(cid:41)(cid:25)(cid:2)(cid:58)(cid:58)(cid:37)(cid:16)(cid:34)(cid:33,,9649.0
,,29,,,Unknown,,cid:12)(cid:29)(cid:26)(cid:41)(cid:25)(cid:2)(cid:58)(cid:58)(cid:37)(cid:16)(cid:34)(cid:33,,9678.0
,,59,,,Unknown,,cid:12)(cid:29)(cid:26)(cid:41)(cid:25)(cid:2)(cid:58)(cid:58)(cid:37)(cid:16)(cid:34)(cid:33,,9737.0
,,23,,,Unknown,,cid:12)(cid:29)(cid:26)(cid:41)(cid:25)(cid:2)(cid:58)(cid:58)(cid:37)(cid:16)(cid:34)(cid:33,,9760.0
,,25,,,Unknown,,cid:12)(cid:29)(cid:26)(cid:41)(cid:25)(cid:2)(cid:58)(cid:58)(cid:37)(cid:16)(cid:34)(cid:33,,9785.0
,,30,,,Unknown,,cid:12)(cid:29)(cid:26)(cid:41)(cid:25)(cid:2)(cid:58)(cid:58)(cid:37)(cid:16)(cid:34)(cid:33,,9815.0
,,41,,,Unknown,,cid:12)(cid:29)(cid:26)(cid:41)(cid:25)(cid:2)(cid:58)(cid:58)(cid:37)(cid:16)(cid:34)(cid:33,,9856.0
,,27,,,Unknown,,cid:12)(cid:29)(cid:26)(cid:41)(cid:25)(cid:2)(cid:58)(cid:58)(cid:37)(cid:16)(cid:34)(cid:33,,9883.0
,,2,,,Unknown,,cid:12)(cid:29)(cid:26)(cid:41)(cid:25)(cid:2)(cid:58)(cid:58)(cid:37)(cid:16)(cid:34)(cid:33,,9885.0
,,47,,,Unknown,,cid:12)(cid:29)(cid:26)(cid:41)(cid:25)(cid:2)(cid:58)(cid:58)(cid:37)(cid:16)(cid:34)(cid:33,,9932.0
,,25,,,Unknown,,cid:12)(cid:29)(cid:26)(cid:41)(cid:25)(cid:2)(cid:58)(cid:58)(cid:37)(cid:16)(cid:34)(cid:33,,9957.0
,,26,,,Unknown,,cid:12)(cid:29)(cid:26)(cid:41)(cid:25)(cid:2)(cid:58)(cid:58)(cid:37)(cid:16)(cid:34)(cid:33,,9983.0
,,22,,,Unknown,,cid:12)(cid:29)(cid:26)(cid:41)(cid:25)(cid:2)(cid:58)(cid:58)(cid:37)(cid:16)(cid:34)(cid:33,,10005.0
,,24,,,Unknown,,cid:12)(cid:29)(cid:26)(cid:41)(cid:25)(cid:2)(cid:58)(cid:58)(cid:37)(cid:16)(cid:34)(cid:33,,10029.0
,,30,,,Unknown,,cid:12)(cid:29)(cid:26)(cid:41)(cid:25)(cid:2)(cid:58)(cid:58)(cid:37)(cid:16)(cid:34)(cid:33,,10059.0
,,2,,,Unknown,,cid:12)(cid:29)(cid:26)(cid:41)(cid:25)(cid:2)(cid:58)(cid:58)(cid:37)(cid:16)(cid:34)(cid:33,,10061.0
,,50,,,Unknown,,cid:12)(cid:29)(cid:26)(cid:41)(cid:25)(cid:2)(cid:58)(cid:58)(cid:37)(cid:16)(cid:34)(cid:33,,10111.0
,,5,,,Unknown,,cid:12)(cid:29)(cid:26)(cid:41)(cid:25)(cid:2)(cid:58)(cid:58)(cid:37)(cid:16)(cid:34)(cid:33,,10116.0
,,15,,,Unknown,,cid:12)(cid:29)(cid:26)(cid:41)(cid:25)(cid:2)(cid:58)(cid:58)(cid:37)(cid:16)(cid:34)(cid:33,,10131.0
,,2,,,Unknown,,cid:12)(cid:29)(cid:26)(cid:41)(cid:25)(cid:2)(cid:58)(cid:58)(cid:37)(cid:16)(cid:34)(cid:33,,10133.0
,,32,,,Unknown,,cid:12)(cid:29)(cid:26)(cid:41)(cid:25)(cid:2)(cid:58)(cid:58)(cid:37)(cid:16)(cid:34)(cid:33,,10165.0
,,36,,,Unknown,,cid:12)(cid:29)(cid:26)(cid:41)(cid:25)(cid:2)(cid:58)(cid:58)(cid:37)(cid:16)(cid:34)(cid:33,,10201.0
,,19,,,Unknown,,cid:12)(cid:29)(cid:26)(cid:41)(cid:25)(cid:2)(cid:58)(cid:58)(cid:37)(cid:16)(cid:34)(cid:33,,10220.0
,,33,,,Unknown,,cid:12)(cid:29)(cid:26)(cid:41)(cid:25)(cid:2)(cid:58)(cid:58)(cid:37)(cid:16)(cid:34)(cid:33,,10253.0
,,34,,,Unknown,,cid:12)(cid:29)(cid:26)(cid:41)(cid:25)(cid:2)(cid:58)(cid:58)(cid:37)(cid:16)(cid:34)(cid:33,,10287.0
,,2,,,Unknown,,cid:12)(cid:29)(cid:26)(cid:41)(cid:25)(cid:2)(cid:58)(cid:58)(cid:37)(cid:16)(cid:34)(cid:33,,10289.0
,,44,,,Unknown,,cid:12)(cid:29)(cid:26)(cid:41)(cid:25)(cid:2)(cid:58)(cid:58)(cid:37)(cid:16)(cid:34)(cid:33,,10333.0
,,12,,,Unknown,,cid:12)(cid:29)(cid:26)(cid:41)(cid:25)(cid:2)(cid:58)(cid:58)(cid:37)(cid:16)(cid:34)(cid:33,,10345.0
,,29,,,Unknown,,cid:12)(cid:29)(cid:26)(cid:41)(cid:25)(cid:2)(cid:58)(cid:58)(cid:37)(cid:16)(cid:34)(cid:33,,10374.0
,,26,,,Unknown,,cid:12)(cid:29)(cid:26)(cid:41)(cid:25)(cid:2)(cid:58)(cid:58)(cid:37)(cid:16)(cid:34)(cid:33,,10400.0
,,41,,,Unknown,,cid:12)(cid:29)(cid:26)(cid:41)(cid:25)(cid:2)(cid:58)(cid:58)(cid:37)(cid:16)(cid:34)(cid:33,,10441.0
,,25,,,Unknown,,cid:12)(cid:29)(cid:26)(cid:41)(cid:25)(cid:2)(cid:58)(cid:58)(cid:37)(cid:16)(cid:34)(cid:33,,10466.0
,,2,,,Unknown,,cid:12)(cid:29)(cid:26)(cid:41)(cid:25)(cid:2)(cid:58)(cid:58)(cid:37)(cid:16)(cid:34)(cid:33,,10468.0
,,58,,,Unknown,,cid:12)(cid:29)(cid:26)(cid:41)(cid:25)(cid:2)(cid:58)(cid:58)(cid:37)(cid:16)(cid:34)(cid:33,,10526.0
,,58,,,Unknown,,cid:12)(cid:29)(cid:26)(cid:41)(cid:25)(cid:2)(cid:58)(cid:58)(cid:37)(cid:16)(cid:34)(cid:33,,10584.0
,,37,,,Unknown,,cid:12)(cid:29)(cid:26)(cid:41)(cid:25)(cid:2)(cid:58)(cid:58)(cid:37)(cid:16)(cid:34)(cid:33,,10621.0
,,16,,,Unknown,,cid:12)(cid:29)(cid:26)(cid:41)(cid:25)(cid:2)(cid:58)(cid:58)(cid:37)(cid:16)(cid:34)(cid:33,,10637.0
,,34,,,Unknown,,cid:12)(cid:29)(cid:26)(cid:41)(cid:25)(cid:2)(cid:58)(cid:58)(cid:37)(cid:16)(cid:34)(cid:33,,10671.0
,,33,,,Unknown,,cid:12)(cid:29)(cid:26)(cid:41)(cid:25)(cid:2)(cid:58)(cid:58)(cid:37)(cid:16)(cid:34)(cid:33,,10704.0
,,1,,,Unknown,,cid:12)(cid:29)(cid:26)(cid:41)(cid:25)(cid:2)(cid:58)(cid:58)(cid:37)(cid:16)(cid:34)(cid:33,,10705.0
,,37,,,Unknown,,cid:12)(cid:29)(cid:26)(cid:41)(cid:25)(cid:2)(cid:58)(cid:58)(cid:37)(cid:16)(cid:34)(cid:33,,10742.0
,,45,,,Unknown,,cid:12)(cid:29)(cid:26)(cid:41)(cid:25)(cid:2)(cid:58)(cid:58)(cid:37)(cid:16)(cid:34)(cid:33,,10787.0
,,18,,,Unknown,,cid:12)(cid:29)(cid:26)(cid:41)(cid:25)(cid:2)(cid:58)(cid:58)(cid:37)(cid:16)(cid:34)(cid:33,,10805.0
,,16,,,Unknown,,cid:12)(cid:29)(cid:26)(cid:41)(cid:25)(cid:2)(cid:58)(cid:58)(cid:37)(cid:16)(cid:34)(cid:33,,10821.0
,,9,,,Unknown,,cid:12)(cid:29)(cid:26)(cid:41)(cid:25)(cid:2)(cid:58)(cid:58)(cid:37)(cid:16)(cid:34)(cid:33,,10830.0
,,46,,,Unknown,,cid:12)(cid:29)(cid:26)(cid:41)(cid:25)(cid:2)(cid:58)(cid:58)(cid:37)(cid:16)(cid:34)(cid:33,,10876.0
,,3,,,Unknown,,cid:12)(cid:29)(cid:26)(cid:41)(cid:25)(cid:2)(cid:58)(cid:58)(cid:37)(cid:16)(cid:34)(cid:33,,10879.0
,,14,,,Unknown,,cid:12)(cid:29)(cid:26)(cid:41)(cid:25)(cid:2)(cid:58)(cid:58)(cid:37)(cid:16)(cid:34)(cid:33,,10893.0
,,2,,,Unknown,,cid:12)(cid:29)(cid:26)(cid:41)(cid:25)(cid:2)(cid:58)(cid:58)(cid:37)(cid:16)(cid:34)(cid:33,,10895.0
,,65,,,Unknown,,cid:12)(cid:29)(cid:26)(cid:41)(cid:25)(cid:2)(cid:58)(cid:58)(cid:37)(cid:16)(cid:34)(cid:33,,10960.0
,,39,,,Unknown,,cid:12)(cid:29)(cid:26)(cid:41)(cid:25)(cid:2)(cid:58)(cid:58)(cid:37)(cid:16)(cid:34)(cid:33,,10999.0
,,46,,,Unknown,,cid:12)(cid:29)(cid:26)(cid:41)(cid:25)(cid:2)(cid:58)(cid:58)(cid:37)(cid:16)(cid:34)(cid:33,,11045.0
,,2,,,Unknown,,cid:12)(cid:29)(cid:26)(cid:41)(cid:25)(cid:2)(cid:58)(cid:58)(cid:37)(cid:16)(cid:34)(cid:33,,11047.0
,,48,,,Unknown,,cid:12)(cid:29)(cid:26)(cid:41)(cid:25)(cid:2)(cid:58)(cid:58)(cid:37)(cid:16)(cid:34)(cid:33,,11095.0
,,46,,,Unknown,,cid:12)(cid:29)(cid:26)(cid:41)(cid:25)(cid:2)(cid:58)(cid:58)(cid:37)(cid:16)(cid:34)(cid:33,,11141.0
,,3,,,Unknown,,cid:12)(cid:29)(cid:26)(cid:41)(cid:25)(cid:2)(cid:58)(cid:58)(cid:37)(cid:16)(cid:34)(cid:33,,11144.0
,,65,,,Unknown,,cid:12)(cid:29)(cid:26)(cid:41)(cid:25)(cid:2)(cid:58)(cid:58)(cid:37)(cid:16)(cid:34)(cid:33,,11209.0
,,5,,,Unknown,,cid:12)(cid:29)(cid:26)(cid:41)(cid:25)(cid:2)(cid:58)(cid:58)(cid:37)(cid:16)(cid:34)(cid:33,,11214.0
,,10,,,Unknown,,cid:12)(cid:29)(cid:26)(cid:41)(cid:25)(cid:2)(cid:58)(cid:58)(cid:37)(cid:16)(cid:34)(cid:33,,11224.0
,,2,,,Unknown,,cid:12)(cid:29)(cid:26)(cid:41)(cid:25)(cid:2)(cid:58)(cid:58)(cid:37)(cid:16)(cid:34)(cid:33,,11226.0
,,12,,,Unknown,,cid:12)(cid:29)(cid:26)(cid:41)(cid:25)(cid:2)(cid:58)(cid:58)(cid:37)(cid:16)(cid:34)(cid:33,,11238.0
,,11,,,Unknown,,cid:12)(cid:29)(cid:26)(cid:41)(cid:25)(cid:2)(cid:58)(cid:58)(cid:37)(cid:16)(cid:34)(cid:33,,11249.0
,,4,,,Unknown,,cid:12)(cid:29)(cid:26)(cid:41)(cid:25)(cid:2)(cid:58)(cid:58)(cid:37)(cid:16)(cid:34)(cid:33,,11253.0
,,14,,,Unknown,,cid:12)(cid:29)(cid:26)(cid:41)(cid:25)(cid:2)(cid:58)(cid:58)(cid:37)(cid:16)(cid:34)(cid:33,,11267.0
,,11,,,Unknown,,cid:12)(cid:29)(cid:26)(cid:41)(cid:25)(cid:2)(cid:58)(cid:58)(cid:37)(cid:16)(cid:34)(cid:33,,11278.0
,,48,,,Unknown,,cid:12)(cid:29)(cid:26)(cid:41)(cid:25)(cid:2)(cid:58)(cid:58)(cid:37)(cid:16)(cid:34)(cid:33,,11326.0
,,48,,,Unknown,,cid:12)(cid:29)(cid:26)(cid:41)(cid:25)(cid:2)(cid:58)(cid:58)(cid:37)(cid:16)(cid:34)(cid:33,,11374.0
,,7,,,Unknown,,cid:12)(cid:29)(cid:26)(cid:41)(cid:25)(cid:2)(cid:58)(cid:58)(cid:37)(cid:16)(cid:34)(cid:33,,11381.0
,,5,,,Unknown,,cid:12)(cid:29)(cid:26)(cid:41)(cid:25)(cid:2)(cid:58)(cid:58)(cid:37)(cid:16)(cid:34)(cid:33,,11386.0
,,3,,,Unknown,,cid:12)(cid:29)(cid:26)(cid:41)(cid:25)(cid:2)(cid:58)(cid:58)(cid:37)(cid:16)(cid:34)(cid:33,,11389.0
,,9,,,Unknown,,cid:12)(cid:29)(cid:26)(cid:41)(cid:25)(cid:2)(cid:58)(cid:58)(cid:37)(cid:16)(cid:34)(cid:33,,11398.0
,,2,,,Unknown,,cid:12)(cid:29)(cid:26)(cid:41)(cid:25)(cid:2)(cid:58)(cid:58)(cid:37)(cid:16)(cid:34)(cid:33,,11400.0
,,28,,,Unknown,,cid:12)(cid:29)(cid:26)(cid:41)(cid:25)(cid:2)(cid:58)(cid:58)(cid:37)(cid:16)(cid:34)(cid:33,,11428.0
,,3,,,Unknown,,cid:12)(cid:29)(cid:26)(cid:41)(cid:25)(cid:2)(cid:58)(cid:58)(cid:37)(cid:16)(cid:34)(cid:33,,11431.0
,,15,,,Unknown,,cid:12)(cid:29)(cid:26)(cid:41)(cid:25)(cid:2)(cid:58)(cid:58)(cid:37)(cid:16)(cid:34)(cid:33,,11446.0
,,2,,,Unknown,,cid:12)(cid:29)(cid:26)(cid:41)(cid:25)(cid:2)(cid:58)(cid:58)(cid:37)(cid:16)(cid:34)(cid:33,,11448.0
,,1,,,Unknown,,cid:12)(cid:29)(cid:26)(cid:41)(cid:25)(cid:2)(cid:58)(cid:58)(cid:37)(cid:16)(cid:34)(cid:33,,11449.0
,,1,,,Unknown,,cid:12)(cid:29)(cid:26)(cid:41)(cid:25)(cid:2)(cid:58)(cid:58)(cid:37)(cid:16)(cid:34)(cid:33,,11450.0
,,19,,,Unknown,,cid:12)(cid:29)(cid:26)(cid:41)(cid:25)(cid:2)(cid:58)(cid:58)(cid:37)(cid:16)(cid:34)(cid:33,,11469.0
,,33,,,Unknown,,cid:12)(cid:29)(cid:26)(cid:41)(cid:25)(cid:2)(cid:58)(cid:58)(cid:37)(cid:16)(cid:34)(cid:33,,11502.0
,,32,,,Unknown,,cid:12)(cid:29)(cid:26)(cid:41)(cid:25)(cid:2)(cid:58)(cid:58)(cid:37)(cid:16)(cid:34)(cid:33,,11534.0
,,2,,,Unknown,,cid:12)(cid:29)(cid:26)(cid:41)(cid:25)(cid:2)(cid:58)(cid:58)(cid:37)(cid:16)(cid:34)(cid:33,,11536.0
,,44,,,Unknown,,cid:12)(cid:29)(cid:26)(cid:41)(cid:25)(cid:2)(cid:58)(cid:58)(cid:37)(cid:16)(cid:34)(cid:33,,11580.0
,,12,,,Unknown,,cid:12)(cid:29)(cid:26)(cid:41)(cid:25)(cid:2)(cid:58)(cid:58)(cid:37)(cid:16)(cid:34)(cid:33,,11592.0
,,29,,,Unknown,,cid:12)(cid:29)(cid:26)(cid:41)(cid:25)(cid:2)(cid:58)(cid:58)(cid:37)(cid:16)(cid:34)(cid:33,,11621.0
,,26,,,Unknown,,cid:12)(cid:29)(cid:26)(cid:41)(cid:25)(cid:2)(cid:58)(cid:58)(cid:37)(cid:16)(cid:34)(cid:33,,11647.0
,,41,,,Unknown,,cid:12)(cid:29)(cid:26)(cid:41)(cid:25)(cid:2)(cid:58)(cid:58)(cid:37)(cid:16)(cid:34)(cid:33,,11688.0
,,25,,,Unknown,,cid:12)(cid:29)(cid:26)(cid:41)(cid:25)(cid:2)(cid:58)(cid:58)(cid:37)(cid:16)(cid:34)(cid:33,,11713.0
,,2,,,Unknown,,cid:12)(cid:29)(cid:26)(cid:41)(cid:25)(cid:2)(cid:58)(cid:58)(cid:37)(cid:16)(cid:34)(cid:33,,11715.0
,,58,,,Unknown,,cid:12)(cid:29)(cid:26)(cid:41)(cid:25)(cid:2)(cid:58)(cid:58)(cid:37)(cid:16)(cid:34)(cid:33,,11773.0
,,58,,,Unknown,,cid:12)(cid:29)(cid:26)(cid:41)(cid:25)(cid:2)(cid:58)(cid:58)(cid:37)(cid:16)(cid:34)(cid:33,,11831.0
,,37,,,Unknown,,cid:12)(cid:29)(cid:26)(cid:41)(cid:25)(cid:2)(cid:58)(cid:58)(cid:37)(cid:16)(cid:34)(cid:33,,11868.0
,,16,,,Unknown,,cid:12)(cid:29)(cid:26)(cid:41)(cid:25)(cid:2)(cid:58)(cid:58)(cid:37)(cid:16)(cid:34)(cid:33,,11884.0
,,34,,,Unknown,,cid:12)(cid:29)(cid:26)(cid:41)(cid:25)(cid:2)(cid:58)(cid:58)(cid:37)(cid:16)(cid:34)(cid:33,,11918.0
,,33,,,Unknown,,cid:12)(cid:29)(cid:26)(cid:41)(cid:25)(cid:2)(cid:58)(cid:58)(cid:37)(cid:16)(cid:34)(cid:33,,11951.0
,,1,,,Unknown,,cid:12)(cid:29)(cid:26)(cid:41)(cid:25)(cid:2)(cid:58)(cid:58)(cid:37)(cid:16)(cid:34)(cid:33,,11952.0
,,36,,,Unknown,,cid:12)(cid:29)(cid:26)(cid:41)(cid:25)(cid:2)(cid:58)(cid:58)(cid:37)(cid:16)(cid:34)(cid:33,,11988.0
,,45,,,Unknown,,cid:12)(cid:29)(cid:26)(cid:41)(cid:25)(cid:2)(cid:58)(cid:58)(cid:37)(cid:16)(cid:34)(cid:33,,12033.0
,,18,,,Unknown,,cid:12)(cid:29)(cid:26)(cid:41)(cid:25)(cid:2)(cid:58)(cid:58)(cid:37)(cid:16)(cid:34)(cid:33,,12051.0
,,16,,,Unknown,,cid:12)(cid:29)(cid:26)(cid:41)(cid:25)(cid:2)(cid:58)(cid:58)(cid:37)(cid:16)(cid:34)(cid:33,,12067.0
,,10,,,Unknown,,cid:12)(cid:29)(cid:26)(cid:41)(cid:25)(cid:2)(cid:58)(cid:58)(cid:37)(cid:16)(cid:34)(cid:33,,12077.0
,,11,,,Unknown,,cid:12)(cid:29)(cid:26)(cid:41)(cid:25)(cid:2)(cid:58)(cid:58)(cid:37)(cid:16)(cid:34)(cid:33,,12088.0
,,10,,,Unknown,,cid:12)(cid:29)(cid:26)(cid:41)(cid:25)(cid:2)(cid:58)(cid:58)(cid:37)(cid:16)(cid:34)(cid:33,,12098.0
,,46,,,Unknown,,cid:12)(cid:29)(cid:26)(cid:41)(cid:25)(cid:2)(cid:58)(cid:58)(cid:37)(cid:16)(cid:34)(cid:33,,12144.0
,,14,,,Unknown,,cid:12)(cid:29)(cid:26)(cid:41)(cid:25)(cid:2)(cid:58)(cid:58)(cid:37)(cid:16)(cid:34)(cid:33,,12158.0
,,2,,,Unknown,,cid:12)(cid:29)(cid:26)(cid:41)(cid:25)(cid:2)(cid:58)(cid:58)(cid:37)(cid:16)(cid:34)(cid:33,,12160.0
,,12,,,Unknown,,cid:12)(cid:29)(cid:26)(cid:41)(cid:25)(cid:2)(cid:58)(cid:58)(cid:37)(cid:16)(cid:34)(cid:33,,12172.0
,,11,,,Unknown,,cid:12)(cid:29)(cid:26)(cid:41)(cid:25)(cid:2)(cid:58)(cid:58)(cid:37)(cid:16)(cid:34)(cid:33,,12183.0
,,4,,,Unknown,,cid:12)(cid:29)(cid:26)(cid:41)(cid:25)(cid:2)(cid:58)(cid:58)(cid:37)(cid:16)(cid:34)(cid:33,,12187.0
,,14,,,Unknown,,cid:12)(cid:29)(cid:26)(cid:41)(cid:25)(cid:2)(cid:58)(cid:58)(cid:37)(cid:16)(cid:34)(cid:33,,12201.0
,,11,,,Unknown,,cid:12)(cid:29)(cid:26)(cid:41)(cid:25)(cid:2)(cid:58)(cid:58)(cid:37)(cid:16)(cid:34)(cid:33,,12212.0
,,48,,,Unknown,,cid:12)(cid:29)(cid:26)(cid:41)(cid:25)(cid:2)(cid:58)(cid:58)(cid:37)(cid:16)(cid:34)(cid:33,,12260.0
,,48,,,Unknown,,cid:12)(cid:29)(cid:26)(cid:41)(cid:25)(cid:2)(cid:58)(cid:58)(cid:37)(cid:16)(cid:34)(cid:33,,12308.0
,,7,,,Unknown,,cid:12)(cid:29)(cid:26)(cid:41)(cid:25)(cid:2)(cid:58)(cid:58)(cid:37)(cid:16)(cid:34)(cid:33,,12315.0
,,5,,,Unknown,,cid:12)(cid:29)(cid:26)(cid:41)(cid:25)(cid:2)(cid:58)(cid:58)(cid:37)(cid:16)(cid:34)(cid:33,,12320.0
,,3,,,Unknown,,cid:12)(cid:29)(cid:26)(cid:41)(cid:25)(cid:2)(cid:58)(cid:58)(cid:37)(cid:16)(cid:34)(cid:33,,12323.0
,,9,,,Unknown,,cid:12)(cid:29)(cid:26)(cid:41)(cid:25)(cid:2)(cid:58)(cid:58)(cid:37)(cid:16)(cid:34)(cid:33,,12332.0
,,2,,,Unknown,,cid:12)(cid:29)(cid:26)(cid:41)(cid:25)(cid:2)(cid:58)(cid:58)(cid:37)(cid:16)(cid:34)(cid:33,,12334.0
,,28,,,Unknown,,cid:12)(cid:29)(cid:26)(cid:41)(cid:25)(cid:2)(cid:58)(cid:58)(cid:37)(cid:16)(cid:34)(cid:33,,12362.0
,,3,,,Unknown,,cid:12)(cid:29)(cid:26)(cid:41)(cid:25)(cid:2)(cid:58)(cid:58)(cid:37)(cid:16)(cid:34)(cid:33,,12365.0
,,15,,,Unknown,,cid:12)(cid:29)(cid:26)(cid:41)(cid:25)(cid:2)(cid:58)(cid:58)(cid:37)(cid:16)(cid:34)(cid:33,,12380.0
,,2,,,Unknown,,cid:12)(cid:29)(cid:26)(cid:41)(cid:25)(cid:2)(cid:58)(cid:58)(cid:37)(cid:16)(cid:34)(cid:33,,12382.0
,,34,,,Unknown,,cid:12)(cid:29)(cid:26)(cid:41)(cid:25)(cid:2)(cid:58)(cid:58)(cid:37)(cid:16)(cid:34)(cid:33,,12416.0
,,36,,,Unknown,,cid:12)(cid:29)(cid:26)(cid:41)(cid:25)(cid:2)(cid:58)(cid:58)(cid:37)(cid:16)(cid:34)(cid:33,,12452.0
,,19,,,Unknown,,cid:12)(cid:29)(cid:26)(cid:41)(cid:25)(cid:2)(cid:58)(cid:58)(cid:37)(cid:16)(cid:34)(cid:33,,12471.0
,,32,,,Unknown,,cid:12)(cid:29)(cid:26)(cid:41)(cid:25)(cid:2)(cid:58)(cid:58)(cid:37)(cid:16)(cid:34)(cid:33,,12503.0
,,1,,,Unknown,,cid:12)(cid:29)(cid:26)(cid:41)(cid:25)(cid:2)(cid:58)(cid:58)(cid:37)(cid:16)(cid:34)(cid:33,,12504.0
,,2,,,Unknown,,cid:12)(cid:29)(cid:26)(cid:41)(cid:25)(cid:2)(cid:58)(cid:58)(cid:37)(cid:16)(cid:34)(cid:33,,12506.0
,,44,,,Unknown,,cid:12)(cid:29)(cid:26)(cid:41)(cid:25)(cid:2)(cid:58)(cid:58)(cid:37)(cid:16)(cid:34)(cid:33,,12550.0
,,12,,,Unknown,,cid:12)(cid:29)(cid:26)(cid:41)(cid:25)(cid:2)(cid:58)(cid:58)(cid:37)(cid:16)(cid:34)(cid:33,,12562.0
,,29,,,Unknown,,cid:12)(cid:29)(cid:26)(cid:41)(cid:25)(cid:2)(cid:58)(cid:58)(cid:37)(cid:16)(cid:34)(cid:33,,12591.0
,,26,,,Unknown,,cid:12)(cid:29)(cid:26)(cid:41)(cid:25)(cid:2)(cid:58)(cid:58)(cid:37)(cid:16)(cid:34)(cid:33,,12617.0
,,41,,,Unknown,,cid:12)(cid:29)(cid:26)(cid:41)(cid:25)(cid:2)(cid:58)(cid:58)(cid:37)(cid:16)(cid:34)(cid:33,,12658.0
,,25,,,Unknown,,cid:12)(cid:29)(cid:26)(cid:41)(cid:25)(cid:2)(cid:58)(cid:58)(cid:37)(cid:16)(cid:34)(cid:33,,12683.0
,,2,,,Unknown,,cid:12)(cid:29)(cid:26)(cid:41)(cid:25)(cid:2)(cid:58)(cid:58)(cid:37)(cid:16)(cid:34)(cid:33,,12685.0
,,58,,,Unknown,,cid:12)(cid:29)(cid:26)(cid:41)(cid:25)(cid:2)(cid:58)(cid:58)(cid:37)(cid:16)(cid:34)(cid:33,,12743.0
,,58,,,Unknown,,cid:12)(cid:29)(cid:26)(cid:41)(cid:25)(cid:2)(cid:58)(cid:58)(cid:37)(cid:16)(cid:34)(cid:33,,12801.0
,,37,,,Unknown,,cid:12)(cid:29)(cid:26)(cid:41)(cid:25)(cid:2)(cid:58)(cid:58)(cid:37)(cid:16)(cid:34)(cid:33,,12838.0
,,16,,,Unknown,,cid:12)(cid:29)(cid:26)(cid:41)(cid:25)(cid:2)(cid:58)(cid:58)(cid:37)(cid:16)(cid:34)(cid:33,,12854.0
,,34,,,Unknown,,cid:12)(cid:29)(cid:26)(cid:41)(cid:25)(cid:2)(cid:58)(cid:58)(cid:37)(cid:16)(cid:34)(cid:33,,12888.0
,,33,,,Unknown,,cid:12)(cid:29)(cid:26)(cid:41)(cid:25)(cid:2)(cid:58)(cid:58)(cid:37)(cid:16)(cid:34)(cid:33,,12921.0
,,1,,,Unknown,,cid:12)(cid:29)(cid:26)(cid:41)(cid:25)(cid:2)(cid:58)(cid:58)(cid:37)(cid:16)(cid:34)(cid:33,,12922.0
,,36,,,Unknown,,cid:12)(cid:29)(cid:26)(cid:41)(cid:25)(cid:2)(cid:58)(cid:58)(cid:37)(cid:16)(cid:34)(cid:33,,12958.0
,,45,,,Unknown,,cid:12)(cid:29)(cid:26)(cid:41)(cid:25)(cid:2)(cid:58)(cid:58)(cid:37)(cid:16)(cid:34)(cid:33,,13003.0
,,18,,,Unknown,,cid:12)(cid:29)(cid:26)(cid:41)(cid:25)(cid:2)(cid:58)(cid:58)(cid:37)(cid:16)(cid:34)(cid:33,,13021.0
,,16,,,Unknown,,cid:12)(cid:29)(cid:26)(cid:41)(cid:25)(cid:2)(cid:58)(cid:58)(cid:37)(cid:16)(cid:34)(cid:33,,13037.0
,,10,,,Unknown,,cid:12)(cid:29)(cid:26)(cid:41)(cid:25)(cid:2)(cid:58)(cid:58)(cid:37)(cid:16)(cid:34)(cid:33,,13047.0
,,11,,,Unknown,,cid:12)(cid:29)(cid:26)(cid:41)(cid:25)(cid:2)(cid:58)(cid:58)(cid:37)(cid:16)(cid:34)(cid:33,,13058.0
,,10,,,Unknown,,cid:12)(cid:29)(cid:26)(cid:41)(cid:25)(cid:2)(cid:58)(cid:58)(cid:37)(cid:16)(cid:34)(cid:33,,13068.0
,,46,,,Unknown,,cid:12)(cid:29)(cid:26)(cid:41)(cid:25)(cid:2)(cid:58)(cid:58)(cid:37)(cid:16)(cid:34)(cid:33,,13114.0
,,14,,,Unknown,,cid:12)(cid:29)(cid:26)(cid:41)(cid:25)(cid:2)(cid:58)(cid:58)(cid:37)(cid:16)(cid:34)(cid:33,,13128.0
,,2,,,Unknown,,cid:12)(cid:29)(cid:26)(cid:41)(cid:25)(cid:2)(cid:58)(cid:58)(cid:37)(cid:16)(cid:34)(cid:33,,13130.0
,,12,,,Unknown,,cid:12)(cid:29)(cid:26)(cid:41)(cid:25)(cid:2)(cid:58)(cid:58)(cid:37)(cid:16)(cid:34)(cid:33,,13142.0
,,11,,,Unknown,,cid:12)(cid:29)(cid:26)(cid:41)(cid:25)(cid:2)(cid:58)(cid:58)(cid:37)(cid:16)(cid:34)(cid:33,,13153.0
,,4,,,Unknown,,cid:12)(cid:29)(cid:26)(cid:41)(cid:25)(cid:2)(cid:58)(cid:58)(cid:37)(cid:16)(cid:34)(cid:33,,13157.0
,,14,,,Unknown,,cid:12)(cid:29)(cid:26)(cid:41)(cid:25)(cid:2)(cid:58)(cid:58)(cid:37)(cid:16)(cid:34)(cid:33,,13171.0
,,11,,,Unknown,,cid:12)(cid:29)(cid:26)(cid:41)(cid:25)(cid:2)(cid:58)(cid:58)(cid:37)(cid:16)(cid:34)(cid:33,,13182.0
,,48,,,Unknown,,cid:12)(cid:29)(cid:26)(cid:41)(cid:25)(cid:2)(cid:58)(cid:58)(cid:37)(cid:16)(cid:34)(cid:33,,13230.0
,,48,,,Unknown,,cid:12)(cid:29)(cid:26)(cid:41)(cid:25)(cid:2)(cid:58)(cid:58)(cid:37)(cid:16)(cid:34)(cid:33,,13278.0
,,7,,,Unknown,,cid:12)(cid:29)(cid:26)(cid:41)(cid:25)(cid:2)(cid:58)(cid:58)(cid:37)(cid:16)(cid:34)(cid:33,,13285.0
,,5,,,Unknown,,cid:12)(cid:29)(cid:26)(cid:41)(cid:25)(cid:2)(cid:58)(cid:58)(cid:37)(cid:16)(cid:34)(cid:33,,13290.0
,,3,,,Unknown,,cid:12)(cid:29)(cid:26)(cid:41)(cid:25)(cid:2)(cid:58)(cid:58)(cid:37)(cid:16)(cid:34)(cid:33,,13293.0
,,9,,,Unknown,,cid:12)(cid:29)(cid:26)(cid:41)(cid:25)(cid:2)(cid:58)(cid:58)(cid:37)(cid:16)(cid:34)(cid:33,,13302.0
,,2,,,Unknown,,cid:12)(cid:29)(cid:26)(cid:41)(cid:25)(cid:2)(cid:58)(cid:58)(cid:37)(cid:16)(cid:34)(cid:33,,13304.0
,,28,,,Unknown,,cid:12)(cid:29)(cid:26)(cid:41)(cid:25)(cid:2)(cid:58)(cid:58)(cid:37)(cid:16)(cid:34)(cid:33,,13332.0
,,3,,,Unknown,,cid:12)(cid:29)(cid:26)(cid:41)(cid:25)(cid:2)(cid:58)(cid:58)(cid:37)(cid:16)(cid:34)(cid:33,,13335.0
,,15,,,Unknown,,cid:12)(cid:29)(cid:26)(cid:41)(cid:25)(cid:2)(cid:58)(cid:58)(cid:37)(cid:16)(cid:34)(cid:33,,13350.0
,,2,,,Unknown,,cid:12)(cid:29)(cid:26)(cid:41)(cid:25)(cid:2)(cid:58)(cid:58)(cid:37)(cid:16)(cid:34)(cid:33,,13352.0
,,34,,,Unknown,,cid:12)(cid:29)(cid:26)(cid:41)(cid:25)(cid:2)(cid:58)(cid:58)(cid:37)(cid:16)(cid:34)(cid:33,,13386.0
,,18,,,Unknown,,cid:12)(cid:29)(cid:26)(cid:41)(cid:25)(cid:2)(cid:58)(cid:58)(cid:37)(cid:16)(cid:34)(cid:33,,13404.0
,,19,,,Unknown,,cid:12)(cid:29)(cid:26)(cid:41)(cid:25)(cid:2)(cid:58)(cid:58)(cid:37)(cid:16)(cid:34)(cid:33,,13423.0
,,18,,,Unknown,,cid:12)(cid:29)(cid:26)(cid:41)(cid:25)(cid:2)(cid:58)(cid:58)(cid:37)(cid:16)(cid:34)(cid:33,,13441.0
,,17,,,Unknown,,cid:12)(cid:29)(cid:26)(cid:41)(cid:25)(cid:2)(cid:58)(cid:58)(cid:37)(cid:16)(cid:34)(cid:33,,13458.0
,,2,,,Unknown,,cid:12)(cid:29)(cid:26)(cid:41)(cid:25)(cid:2)(cid:58)(cid:58)(cid:37)(cid:16)(cid:34)(cid:33,,13460.0
,,44,,,Unknown,,cid:12)(cid:29)(cid:26)(cid:41)(cid:25)(cid:2)(cid:58)(cid:58)(cid:37)(cid:16)(cid:34)(cid:33,,13504.0
,,12,,,Unknown,,cid:12)(cid:29)(cid:26)(cid:41)(cid:25)(cid:2)(cid:58)(cid:58)(cid:37)(cid:16)(cid:34)(cid:33,,13516.0
,,29,,,Unknown,,cid:12)(cid:29)(cid:26)(cid:41)(cid:25)(cid:2)(cid:58)(cid:58)(cid:37)(cid:16)(cid:34)(cid:33,,13545.0
,,26,,,Unknown,,cid:12)(cid:29)(cid:26)(cid:41)(cid:25)(cid:2)(cid:58)(cid:58)(cid:37)(cid:16)(cid:34)(cid:33,,13571.0
,,41,,,Unknown,,cid:12)(cid:29)(cid:26)(cid:41)(cid:25)(cid:2)(cid:58)(cid:58)(cid:37)(cid:16)(cid:34)(cid:33,,13612.0
,,25,,,Unknown,,cid:12)(cid:29)(cid:26)(cid:41)(cid:25)(cid:2)(cid:58)(cid:58)(cid:37)(cid:16)(cid:34)(cid:33,,13637.0
,,2,,,Unknown,,cid:12)(cid:29)(cid:26)(cid:41)(cid:25)(cid:2)(cid:58)(cid:58)(cid:37)(cid:16)(cid:34)(cid:33,,13639.0
,,58,,,Unknown,,cid:12)(cid:29)(cid:26)(cid:41)(cid:25)(cid:2)(cid:58)(cid:58)(cid:37)(cid:16)(cid:34)(cid:33,,13697.0
,,58,,,Unknown,,cid:12)(cid:29)(cid:26)(cid:41)(cid:25)(cid:2)(cid:58)(cid:58)(cid:37)(cid:16)(cid:34)(cid:33,,13755.0
,,18,,,Unknown,,cid:12)(cid:29)(cid:26)(cid:41)(cid:25)(cid:2)(cid:58)(cid:58)(cid:37)(cid:16)(cid:34)(cid:33,,13773.0
,,1,,,Unknown,,cid:12)(cid:29)(cid:26)(cid:41)(cid:25)(cid:2)(cid:58)(cid:58)(cid:37)(cid:16)(cid:34)(cid:33,,13774.0
,,1,,,Unknown,,cid:12)(cid:29)(cid:26)(cid:41)(cid:25)(cid:2)(cid:58)(cid:58)(cid:37)(cid:16)(cid:34)(cid:33,,13775.0
,,37,,,Unknown,,cid:12)(cid:29)(cid:26)(cid:41)(cid:25)(cid:2)(cid:58)(cid:58)(cid:37)(cid:16)(cid:34)(cid:33,,13812.0
,,1,,,Unknown,,cid:12)(cid:29)(cid:26)(cid:41)(cid:25)(cid:2)(cid:58)(cid:58)(cid:37)(cid:16)(cid:34)(cid:33,,13813.0
,,36,,,Unknown,,cid:12)(cid:29)(cid:26)(cid:41)(cid:25)(cid:2)(cid:58)(cid:58)(cid:37)(cid:16)(cid:34)(cid:33,,13849.0
,,45,,,Unknown,,cid:12)(cid:29)(cid:26)(cid:41)(cid:25)(cid:2)(cid:58)(cid:58)(cid:37)(cid:16)(cid:34)(cid:33,,13894.0
,,18,,,Unknown,,cid:12)(cid:29)(cid:26)(cid:41)(cid:25)(cid:2)(cid:58)(cid:58)(cid:37)(cid:16)(cid:34)(cid:33,,13912.0
,,16,,,Unknown,,cid:12)(cid:29)(cid:26)(cid:41)(cid:25)(cid:2)(cid:58)(cid:58)(cid:37)(cid:16)(cid:34)(cid:33,,13928.0
,,39,,,Unknown,,cid:12)(cid:29)(cid:26)(cid:41)(cid:25)(cid:2)(cid:58)(cid:58)(cid:37)(cid:16)(cid:34)(cid:33,,13967.0
,,7,,,Unknown,,cid:12)(cid:29)(cid:26)(cid:41)(cid:25)(cid:2)(cid:58)(cid:58)(cid:37)(cid:16)(cid:34)(cid:33,,13974.0
,,5,,,Unknown,,cid:12)(cid:29)(cid:26)(cid:41)(cid:25)(cid:2)(cid:58)(cid:58)(cid:37)(cid:16)(cid:34)(cid:33,,13979.0
,,12,,,Unknown,,cid:12)(cid:29)(cid:26)(cid:41)(cid:25)(cid:2)(cid:58)(cid:58)(cid:37)(cid:16)(cid:34)(cid:33,,13991.0
,,5,,,Unknown,,cid:12)(cid:29)(cid:26)(cid:41)(cid:25)(cid:2)(cid:58)(cid:58)(cid:37)(cid:16)(cid:34)(cid:33,,13996.0
,,9,,,Unknown,,cid:12)(cid:29)(cid:26)(cid:41)(cid:25)(cid:2)(cid:58)(cid:58)(cid:37)(cid:16)(cid:34)(cid:33,,14005.0
,,2,,,Unknown,,cid:12)(cid:29)(cid:26)(cid:41)(cid:25)(cid:2)(cid:58)(cid:58)(cid:37)(cid:16)(cid:34)(cid:33,,14007.0
,,50,,,Unknown,,cid:12)(cid:29)(cid:26)(cid:41)(cid:25)(cid:2)(cid:58)(cid:58)(cid:37)(cid:16)(cid:34)(cid:33,,14057.0
,,5,,,Unknown,,cid:12)(cid:29)(cid:26)(cid:41)(cid:25)(cid:2)(cid:58)(cid:58)(cid:37)(cid:16)(cid:34)(cid:33,,14062.0
,,10,,,Unknown,,cid:12)(cid:29)(cid:26)(cid:41)(cid:25)(cid:2)(cid:58)(cid:58)(cid:37)(cid:16)(cid:34)(cid:33,,14072.0
,,46,,,Unknown,,cid:12)(cid:29)(cid:26)(cid:41)(cid:25)(cid:2)(cid:58)(cid:58)(cid:37)(cid:16)(cid:34)(cid:33,,14118.0
,,12,,,Unknown,,cid:12)(cid:29)(cid:26)(cid:41)(cid:25)(cid:2)(cid:58)(cid:58)(cid:37)(cid:16)(cid:34)(cid:33,,14130.0
,,13,,,Unknown,,cid:12)(cid:29)(cid:26)(cid:41)(cid:25)(cid:2)(cid:58)(cid:58)(cid:37)(cid:16)(cid:34)(cid:33,,14143.0
,,2,,,Unknown,,cid:12)(cid:29)(cid:26)(cid:41)(cid:25)(cid:2)(cid:58)(cid:58)(cid:37)(cid:16)(cid:34)(cid:33,,14145.0
,,48,,,Unknown,,cid:12)(cid:29)(cid:26)(cid:41)(cid:25)(cid:2)(cid:58)(cid:58)(cid:37)(cid:16)(cid:34)(cid:33,,14193.0
,,11,,,Unknown,,cid:12)(cid:29)(cid:26)(cid:41)(cid:25)(cid:2)(cid:58)(cid:58)(cid:37)(cid:16)(cid:34)(cid:33,,14204.0
,,4,,,Unknown,,cid:12)(cid:29)(cid:26)(cid:41)(cid:25)(cid:2)(cid:58)(cid:58)(cid:37)(cid:16)(cid:34)(cid:33,,14208.0
,,3,,,Unknown,,cid:12)(cid:29)(cid:26)(cid:41)(cid:25)(cid:2)(cid:58)(cid:58)(cid:37)(cid:16)(cid:34)(cid:33,,14211.0
,,11,,,Unknown,,cid:12)(cid:29)(cid:26)(cid:41)(cid:25)(cid:2)(cid:58)(cid:58)(cid:37)(cid:16)(cid:34)(cid:33,,14222.0
,,4,,,Unknown,,cid:12)(cid:29)(cid:26)(cid:41)(cid:25)(cid:2)(cid:58)(cid:58)(cid:37)(cid:16)(cid:34)(cid:33,,14226.0
,,40,,,Unknown,,cid:12)(cid:29)(cid:26)(cid:41)(cid:25)(cid:2)(cid:58)(cid:58)(cid:37)(cid:16)(cid:34)(cid:33,,14266.0
,,2,,,Unknown,,cid:12)(cid:29)(cid:26)(cid:41)(cid:25)(cid:2)(cid:58)(cid:58)(cid:37)(cid:16)(cid:34)(cid:33,,14268.0
,,28,,,Unknown,,cid:12)(cid:29)(cid:26)(cid:41)(cid:25)(cid:2)(cid:58)(cid:58)(cid:37)(cid:16)(cid:34)(cid:33,,14296.0
,,3,,,Unknown,,cid:12)(cid:29)(cid:26)(cid:41)(cid:25)(cid:2)(cid:58)(cid:58)(cid:37)(cid:16)(cid:34)(cid:33,,14299.0
,,15,,,Unknown,,cid:12)(cid:29)(cid:26)(cid:41)(cid:25)(cid:2)(cid:58)(cid:58)(cid:37)(cid:16)(cid:34)(cid:33,,14314.0
,,2,,,Unknown,,cid:12)(cid:29)(cid:26)(cid:41)(cid:25)(cid:2)(cid:58)(cid:58)(cid:37)(cid:16)(cid:34)(cid:33,,14316.0
,,32,,,Unknown,,cid:12)(cid:29)(cid:26)(cid:41)(cid:25)(cid:2)(cid:58)(cid:58)(cid:37)(cid:16)(cid:34)(cid:33,,14348.0
,,36,,,Unknown,,cid:12)(cid:29)(cid:26)(cid:41)(cid:25)(cid:2)(cid:58)(cid:58)(cid:37)(cid:16)(cid:34)(cid:33,,14384.0
,,19,,,Unknown,,cid:12)(cid:29)(cid:26)(cid:41)(cid:25)(cid:2)(cid:58)(cid:58)(cid:37)(cid:16)(cid:34)(cid:33,,14403.0
,,18,,,Unknown,,cid:12)(cid:29)(cid:26)(cid:41)(cid:25)(cid:2)(cid:58)(cid:58)(cid:37)(cid:16)(cid:34)(cid:33,,14421.0
,,18,,,Unknown,,cid:12)(cid:29)(cid:26)(cid:41)(cid:25)(cid:2)(cid:58)(cid:58)(cid:37)(cid:16)(cid:34)(cid:33,,14439.0
,,2,,,Unknown,,cid:12)(cid:29)(cid:26)(cid:41)(cid:25)(cid:2)(cid:58)(cid:58)(cid:37)(cid:16)(cid:34)(cid:33,,14441.0
,,44,,,Unknown,,cid:12)(cid:29)(cid:26)(cid:41)(cid:25)(cid:2)(cid:58)(cid:58)(cid:37)(cid:16)(cid:34)(cid:33,,14485.0
,,12,,,Unknown,,cid:12)(cid:29)(cid:26)(cid:41)(cid:25)(cid:2)(cid:58)(cid:58)(cid:37)(cid:16)(cid:34)(cid:33,,14497.0
,,29,,,Unknown,,cid:12)(cid:29)(cid:26)(cid:41)(cid:25)(cid:2)(cid:58)(cid:58)(cid:37)(cid:16)(cid:34)(cid:33,,14526.0
,,26,,,Unknown,,cid:12)(cid:29)(cid:26)(cid:41)(cid:25)(cid:2)(cid:58)(cid:58)(cid:37)(cid:16)(cid:34)(cid:33,,14552.0
,,41,,,Unknown,,cid:12)(cid:29)(cid:26)(cid:41)(cid:25)(cid:2)(cid:58)(cid:58)(cid:37)(cid:16)(cid:34)(cid:33,,14593.0
,,25,,,Unknown,,cid:12)(cid:29)(cid:26)(cid:41)(cid:25)(cid:2)(cid:58)(cid:58)(cid:37)(cid:16)(cid:34)(cid:33,,14618.0
,,2,,,Unknown,,cid:12)(cid:29)(cid:26)(cid:41)(cid:25)(cid:2)(cid:58)(cid:58)(cid:37)(cid:16)(cid:34)(cid:33,,14620.0
,,58,,,Unknown,,cid:12)(cid:29)(cid:26)(cid:41)(cid:25)(cid:2)(cid:58)(cid:58)(cid:37)(cid:16)(cid:34)(cid:33,,14678.0
,,58,,,Unknown,,cid:12)(cid:29)(cid:26)(cid:41)(cid:25)(cid:2)(cid:58)(cid:58)(cid:37)(cid:16)(cid:34)(cid:33,,14736.0
,,18,,,Unknown,,cid:12)(cid:29)(cid:26)(cid:41)(cid:25)(cid:2)(cid:58)(cid:58)(cid:37)(cid:16)(cid:34)(cid:33,,14754.0
,,1,,,Unknown,,cid:12)(cid:29)(cid:26)(cid:41)(cid:25)(cid:2)(cid:58)(cid:58)(cid:37)(cid:16)(cid:34)(cid:33,,14755.0
,,1,,,Unknown,,cid:12)(cid:29)(cid:26)(cid:41)(cid:25)(cid:2)(cid:58)(cid:58)(cid:37)(cid:16)(cid:34)(cid:33,,14756.0
,,37,,,Unknown,,cid:12)(cid:29)(cid:26)(cid:41)(cid:25)(cid:2)(cid:58)(cid:58)(cid:37)(cid:16)(cid:34)(cid:33,,14793.0
,,1,,,Unknown,,cid:12)(cid:29)(cid:26)(cid:41)(cid:25)(cid:2)(cid:58)(cid:58)(cid:37)(cid:16)(cid:34)(cid:33,,14794.0
,,36,,,Unknown,,cid:12)(cid:29)(cid:26)(cid:41)(cid:25)(cid:2)(cid:58)(cid:58)(cid:37)(cid:16)(cid:34)(cid:33,,14830.0
,,45,,,Unknown,,cid:12)(cid:29)(cid:26)(cid:41)(cid:25)(cid:2)(cid:58)(cid:58)(cid:37)(cid:16)(cid:34)(cid:33,,14875.0
,,18,,,Unknown,,cid:12)(cid:29)(cid:26)(cid:41)(cid:25)(cid:2)(cid:58)(cid:58)(cid:37)(cid:16)(cid:34)(cid:33,,14893.0
,,16,,,Unknown,,cid:12)(cid:29)(cid:26)(cid:41)(cid:25)(cid:2)(cid:58)(cid:58)(cid:37)(cid:16)(cid:34)(cid:33,,14909.0
,,14,,,Unknown,,cid:12)(cid:29)(cid:26)(cid:41)(cid:25)(cid:2)(cid:58)(cid:58)(cid:37)(cid:16)(cid:34)(cid:33,,14923.0
,,5,,,Unknown,,cid:12)(cid:29)(cid:26)(cid:41)(cid:25)(cid:2)(cid:58)(cid:58)(cid:37)(cid:16)(cid:34)(cid:33,,14928.0
,,12,,,Unknown,,cid:12)(cid:29)(cid:26)(cid:41)(cid:25)(cid:2)(cid:58)(cid:58)(cid:37)(cid:16)(cid:34)(cid:33,,14940.0
,,14,,,Unknown,,cid:12)(cid:29)(cid:26)(cid:41)(cid:25)(cid:2)(cid:58)(cid:58)(cid:37)(cid:16)(cid:34)(cid:33,,14954.0
,,5,,,Unknown,,cid:12)(cid:29)(cid:26)(cid:41)(cid:25)(cid:2)(cid:58)(cid:58)(cid:37)(cid:16)(cid:34)(cid:33,,14959.0
,,3,,,Unknown,,cid:12)(cid:29)(cid:26)(cid:41)(cid:25)(cid:2)(cid:58)(cid:58)(cid:37)(cid:16)(cid:34)(cid:33,,14962.0
,,12,,,Unknown,,cid:12)(cid:29)(cid:26)(cid:41)(cid:25)(cid:2)(cid:58)(cid:58)(cid:37)(cid:16)(cid:34)(cid:33,,14974.0
,,2,,,Unknown,,cid:12)(cid:29)(cid:26)(cid:41)(cid:25)(cid:2)(cid:58)(cid:58)(cid:37)(cid:16)(cid:34)(cid:33,,14976.0
,,50,,,Unknown,,cid:12)(cid:29)(cid:26)(cid:41)(cid:25)(cid:2)(cid:58)(cid:58)(cid:37)(cid:16)(cid:34)(cid:33,,15026.0
,,7,,,Unknown,,cid:12)(cid:29)(cid:26)(cid:41)(cid:25)(cid:2)(cid:58)(cid:58)(cid:37)(cid:16)(cid:34)(cid:33,,15033.0
,,9,,,Unknown,,cid:12)(cid:29)(cid:26)(cid:41)(cid:25)(cid:2)(cid:58)(cid:58)(cid:37)(cid:16)(cid:34)(cid:33,,15042.0
,,10,,,Unknown,,cid:12)(cid:29)(cid:26)(cid:41)(cid:25)(cid:2)(cid:58)(cid:58)(cid:37)(cid:16)(cid:34)(cid:33,,15052.0
,,3,,,Unknown,,cid:12)(cid:29)(cid:26)(cid:41)(cid:25)(cid:2)(cid:58)(cid:58)(cid:37)(cid:16)(cid:34)(cid:33,,15055.0
,,2,,,Unknown,,cid:12)(cid:29)(cid:26)(cid:41)(cid:25)(cid:2)(cid:58)(cid:58)(cid:37)(cid:16)(cid:34)(cid:33,,15057.0
,,12,,,Unknown,,cid:12)(cid:29)(cid:26)(cid:41)(cid:25)(cid:2)(cid:58)(cid:58)(cid:37)(cid:16)(cid:34)(cid:33,,15069.0
,,11,,,Unknown,,cid:12)(cid:29)(cid:26)(cid:41)(cid:25)(cid:2)(cid:58)(cid:58)(cid:37)(cid:16)(cid:34)(cid:33,,15080.0
,,4,,,Unknown,,cid:12)(cid:29)(cid:26)(cid:41)(cid:25)(cid:2)(cid:58)(cid:58)(cid:37)(cid:16)(cid:34)(cid:33,,15084.0
,,14,,,Unknown,,cid:12)(cid:29)(cid:26)(cid:41)(cid:25)(cid:2)(cid:58)(cid:58)(cid:37)(cid:16)(cid:34)(cid:33,,15098.0
,,11,,,Unknown,,cid:12)(cid:29)(cid:26)(cid:41)(cid:25)(cid:2)(cid:58)(cid:58)(cid:37)(cid:16)(cid:34)(cid:33,,15109.0
,,48,,,Unknown,,cid:12)(cid:29)(cid:26)(cid:41)(cid:25)(cid:2)(cid:58)(cid:58)(cid:37)(cid:16)(cid:34)(cid:33,,15157.0
,,48,,,Unknown,,cid:12)(cid:29)(cid:26)(cid:41)(cid:25)(cid:2)(cid:58)(cid:58)(cid:37)(cid:16)(cid:34)(cid:33,,15205.0
,,7,,,Unknown,,cid:12)(cid:29)(cid:26)(cid:41)(cid:25)(cid:2)(cid:58)(cid:58)(cid:37)(cid:16)(cid:34)(cid:33,,15212.0
,,5,,,Unknown,,cid:12)(cid:29)(cid:26)(cid:41)(cid:25)(cid:2)(cid:58)(cid:58)(cid:37)(cid:16)(cid:34)(cid:33,,15217.0
,,3,,,Unknown,,cid:12)(cid:29)(cid:26)(cid:41)(cid:25)(cid:2)(cid:58)(cid:58)(cid:37)(cid:16)(cid:34)(cid:33,,15220.0
,,2,,,Unknown,,cid:12)(cid:29)(cid:26)(cid:41)(cid:25)(cid:2)(cid:58)(cid:58)(cid:37)(cid:16)(cid:34)(cid:33,,15222.0
,,28,,,Unknown,,cid:12)(cid:29)(cid:26)(cid:41)(cid:25)(cid:2)(cid:58)(cid:58)(cid:37)(cid:16)(cid:34)(cid:33,,15250.0
,,3,,,Unknown,,cid:12)(cid:29)(cid:26)(cid:41)(cid:25)(cid:2)(cid:58)(cid:58)(cid:37)(cid:16)(cid:34)(cid:33,,15253.0
,,15,,,Unknown,,cid:12)(cid:29)(cid:26)(cid:41)(cid:25)(cid:2)(cid:58)(cid:58)(cid:37)(cid:16)(cid:34)(cid:33,,15268.0
,,2,,,Unknown,,cid:12)(cid:29)(cid:26)(cid:41)(cid:25)(cid:2)(cid:58)(cid:58)(cid:37)(cid:16)(cid:34)(cid:33,,15270.0
,,35,,,Unknown,,cid:12)(cid:29)(cid:26)(cid:41)(cid:25)(cid:2)(cid:58)(cid:58)(cid:37)(cid:16)(cid:34)(cid:33,,15305.0
,,32,,,Unknown,,cid:12)(cid:29)(cid:26)(cid:41)(cid:25)(cid:2)(cid:58)(cid:58)(cid:37)(cid:16)(cid:34)(cid:33,,15337.0
,,19,,,Unknown,,cid:12)(cid:29)(cid:26)(cid:41)(cid:25)(cid:2)(cid:58)(cid:58)(cid:37)(cid:16)(cid:34)(cid:33,,15356.0
,,34,,,Unknown,,cid:12)(cid:29)(cid:26)(cid:41)(cid:25)(cid:2)(cid:58)(cid:58)(cid:37)(cid:16)(cid:34)(cid:33,,15390.0
,,33,,,Unknown,,cid:12)(cid:29)(cid:26)(cid:41)(cid:25)(cid:2)(cid:58)(cid:58)(cid:37)(cid:16)(cid:34)(cid:33,,15423.0
,,2,,,Unknown,,cid:12)(cid:29)(cid:26)(cid:41)(cid:25)(cid:2)(cid:58)(cid:58)(cid:37)(cid:16)(cid:34)(cid:33,,15425.0
,,44,,,Unknown,,cid:12)(cid:29)(cid:26)(cid:41)(cid:25)(cid:2)(cid:58)(cid:58)(cid:37)(cid:16)(cid:34)(cid:33,,15469.0
,,12,,,Unknown,,cid:12)(cid:29)(cid:26)(cid:41)(cid:25)(cid:2)(cid:58)(cid:58)(cid:37)(cid:16)(cid:34)(cid:33,,15481.0
,,29,,,Unknown,,cid:12)(cid:29)(cid:26)(cid:41)(cid:25)(cid:2)(cid:58)(cid:58)(cid:37)(cid:16)(cid:34)(cid:33,,15510.0
,,26,,,Unknown,,cid:12)(cid:29)(cid:26)(cid:41)(cid:25)(cid:2)(cid:58)(cid:58)(cid:37)(cid:16)(cid:34)(cid:33,,15536.0
,,41,,,Unknown,,cid:12)(cid:29)(cid:26)(cid:41)(cid:25)(cid:2)(cid:58)(cid:58)(cid:37)(cid:16)(cid:34)(cid:33,,15577.0
,,25,,,Unknown,,cid:12)(cid:29)(cid:26)(cid:41)(cid:25)(cid:2)(cid:58)(cid:58)(cid:37)(cid:16)(cid:34)(cid:33,,15602.0
,,2,,,Unknown,,cid:12)(cid:29)(cid:26)(cid:41)(cid:25)(cid:2)(cid:58)(cid:58)(cid:37)(cid:16)(cid:34)(cid:33,,15604.0
,,58,,,Unknown,,cid:12)(cid:29)(cid:26)(cid:41)(cid:25)(cid:2)(cid:58)(cid:58)(cid:37)(cid:16)(cid:34)(cid:33,,15662.0
,,58,,,Unknown,,cid:12)(cid:29)(cid:26)(cid:41)(cid:25)(cid:2)(cid:58)(cid:58)(cid:37)(cid:16)(cid:34)(cid:33,,15720.0
,,37,,,Unknown,,cid:12)(cid:29)(cid:26)(cid:41)(cid:25)(cid:2)(cid:58)(cid:58)(cid:37)(cid:16)(cid:34)(cid:33,,15757.0
,,16,,,Unknown,,cid:12)(cid:29)(cid:26)(cid:41)(cid:25)(cid:2)(cid:58)(cid:58)(cid:37)(cid:16)(cid:34)(cid:33,,15773.0
,,34,,,Unknown,,cid:12)(cid:29)(cid:26)(cid:41)(cid:25)(cid:2)(cid:58)(cid:58)(cid:37)(cid:16)(cid:34)(cid:33,,15807.0
,,33,,,Unknown,,cid:12)(cid:29)(cid:26)(cid:41)(cid:25)(cid:2)(cid:58)(cid:58)(cid:37)(cid:16)(cid:34)(cid:33,,15840.0
,,1,,,Unknown,,cid:12)(cid:29)(cid:26)(cid:41)(cid:25)(cid:2)(cid:58)(cid:58)(cid:37)(cid:16)(cid:34)(cid:33,,15841.0
,,36,,,Unknown,,cid:12)(cid:29)(cid:26)(cid:41)(cid:25)(cid:2)(cid:58)(cid:58)(cid:37)(cid:16)(cid:34)(cid:33,,15877.0
,,45,,,Unknown,,cid:12)(cid:29)(cid:26)(cid:41)(cid:25)(cid:2)(cid:58)(cid:58)(cid:37)(cid:16)(cid:34)(cid:33,,15922.0
,,18,,,Unknown,,cid:12)(cid:29)(cid:26)(cid:41)(cid:25)(cid:2)(cid:58)(cid:58)(cid:37)(cid:16)(cid:34)(cid:33,,15940.0
,,16,,,Unknown,,cid:12)(cid:29)(cid:26)(cid:41)(cid:25)(cid:2)(cid:58)(cid:58)(cid:37)(cid:16)(cid:34)(cid:33,,15956.0
,,9,,,Unknown,,cid:12)(cid:29)(cid:26)(cid:41)(cid:25)(cid:2)(cid:58)(cid:58)(cid:37)(cid:16)(cid:34)(cid:33,,15965.0
,,46,,,Unknown,,cid:12)(cid:29)(cid:26)(cid:41)(cid:25)(cid:2)(cid:58)(cid:58)(cid:37)(cid:16)(cid:34)(cid:33,,16011.0
,,3,,,Unknown,,cid:12)(cid:29)(cid:26)(cid:41)(cid:25)(cid:2)(cid:58)(cid:58)(cid:37)(cid:16)(cid:34)(cid:33,,16014.0
,,14,,,Unknown,,cid:12)(cid:29)(cid:26)(cid:41)(cid:25)(cid:2)(cid:58)(cid:58)(cid:37)(cid:16)(cid:34)(cid:33,,16028.0
,,2,,,Unknown,,cid:12)(cid:29)(cid:26)(cid:41)(cid:25)(cid:2)(cid:58)(cid:58)(cid:37)(cid:16)(cid:34)(cid:33,,16030.0
,,65,,,Unknown,,cid:12)(cid:29)(cid:26)(cid:41)(cid:25)(cid:2)(cid:58)(cid:58)(cid:37)(cid:16)(cid:34)(cid:33,,16095.0
,,39,,,Unknown,,cid:12)(cid:29)(cid:26)(cid:41)(cid:25)(cid:2)(cid:58)(cid:58)(cid:37)(cid:16)(cid:34)(cid:33,,16134.0
,,46,,,Unknown,,cid:12)(cid:29)(cid:26)(cid:41)(cid:25)(cid:2)(cid:58)(cid:58)(cid:37)(cid:16)(cid:34)(cid:33,,16180.0
,,2,,,Unknown,,cid:12)(cid:29)(cid:26)(cid:41)(cid:25)(cid:2)(cid:58)(cid:58)(cid:37)(cid:16)(cid:34)(cid:33,,16182.0
,,48,,,Unknown,,cid:12)(cid:29)(cid:26)(cid:41)(cid:25)(cid:2)(cid:58)(cid:58)(cid:37)(cid:16)(cid:34)(cid:33,,16230.0
,,46,,,Unknown,,cid:12)(cid:29)(cid:26)(cid:41)(cid:25)(cid:2)(cid:58)(cid:58)(cid:37)(cid:16)(cid:34)(cid:33,,16276.0
,,3,,,Unknown,,cid:12)(cid:29)(cid:26)(cid:41)(cid:25)(cid:2)(cid:58)(cid:58)(cid:37)(cid:16)(cid:34)(cid:33,,16279.0
,,65,,,Unknown,,cid:12)(cid:29)(cid:26)(cid:41)(cid:25)(cid:2)(cid:58)(cid:58)(cid:37)(cid:16)(cid:34)(cid:33,,16344.0
,,5,,,Unknown,,cid:12)(cid:29)(cid:26)(cid:41)(cid:25)(cid:2)(cid:58)(cid:58)(cid:37)(cid:16)(cid:34)(cid:33,,16349.0
,,10,,,Unknown,,cid:12)(cid:29)(cid:26)(cid:41)(cid:25)(cid:2)(cid:58)(cid:58)(cid:37)(cid:16)(cid:34)(cid:33,,16359.0
,,2,,,Unknown,,cid:12)(cid:29)(cid:26)(cid:41)(cid:25)(cid:2)(cid:58)(cid:58)(cid:37)(cid:16)(cid:34)(cid:33,,16361.0
,,12,,,Unknown,,cid:12)(cid:29)(cid:26)(cid:41)(cid:25)(cid:2)(cid:58)(cid:58)(cid:37)(cid:16)(cid:34)(cid:33,,16373.0
,,11,,,Unknown,,cid:12)(cid:29)(cid:26)(cid:41)(cid:25)(cid:2)(cid:58)(cid:58)(cid:37)(cid:16)(cid:34)(cid:33,,16384.0
,,4,,,Unknown,,cid:12)(cid:29)(cid:26)(cid:41)(cid:25)(cid:2)(cid:58)(cid:58)(cid:37)(cid:16)(cid:34)(cid:33,,16388.0
,,14,,,Unknown,,cid:12)(cid:29)(cid:26)(cid:41)(cid:25)(cid:2)(cid:58)(cid:58)(cid:37)(cid:16)(cid:34)(cid:33,,16402.0
,,11,,,Unknown,,cid:12)(cid:29)(cid:26)(cid:41)(cid:25)(cid:2)(cid:58)(cid:58)(cid:37)(cid:16)(cid:34)(cid:33,,16413.0
,,48,,,Unknown,,cid:12)(cid:29)(cid:26)(cid:41)(cid:25)(cid:2)(cid:58)(cid:58)(cid:37)(cid:16)(cid:34)(cid:33,,16461.0
,,48,,,Unknown,,cid:12)(cid:29)(cid:26)(cid:41)(cid:25)(cid:2)(cid:58)(cid:58)(cid:37)(cid:16)(cid:34)(cid:33,,16509.0
,,7,,,Unknown,,cid:12)(cid:29)(cid:26)(cid:41)(cid:25)(cid:2)(cid:58)(cid:58)(cid:37)(cid:16)(cid:34)(cid:33,,16516.0
,,5,,,Unknown,,cid:12)(cid:29)(cid:26)(cid:41)(cid:25)(cid:2)(cid:58)(cid:58)(cid:37)(cid:16)(cid:34)(cid:33,,16521.0
,,3,,,Unknown,,cid:12)(cid:29)(cid:26)(cid:41)(cid:25)(cid:2)(cid:58)(cid:58)(cid:37)(cid:16)(cid:34)(cid:33,,16524.0
,,9,,,Unknown,,cid:12)(cid:29)(cid:26)(cid:41)(cid:25)(cid:2)(cid:58)(cid:58)(cid:37)(cid:16)(cid:34)(cid:33,,16533.0
,,2,,,Unknown,,cid:12)(cid:29)(cid:26)(cid:41)(cid:25)(cid:2)(cid:58)(cid:58)(cid:37)(cid:16)(cid:34)(cid:33,,16535.0
,,28,,,Unknown,,cid:12)(cid:29)(cid:26)(cid:41)(cid:25)(cid:2)(cid:58)(cid:58)(cid:37)(cid:16)(cid:34)(cid:33,,16563.0
,,3,,,Unknown,,cid:12)(cid:29)(cid:26)(cid:41)(cid:25)(cid:2)(cid:58)(cid:58)(cid:37)(cid:16)(cid:34)(cid:33,,16566.0
,,15,,,Unknown,,cid:12)(cid:29)(cid:26)(cid:41)(cid:25)(cid:2)(cid:58)(cid:58)(cid:37)(cid:16)(cid:34)(cid:33,,16581.0
,,2,,,Unknown,,cid:12)(cid:29)(cid:26)(cid:41)(cid:25)(cid:2)(cid:58)(cid:58)(cid:37)(cid:16)(cid:34)(cid:33,,16583.0
,,1,,,Unknown,,cid:12)(cid:29)(cid:26)(cid:41)(cid:25)(cid:2)(cid:58)(cid:58)(cid:37)(cid:16)(cid:34)(cid:33,,16584.0
,,37,,,Unknown,,cid:12)(cid:29)(cid:26)(cid:41)(cid:25)(cid:2)(cid:58)(cid:58)(cid:37)(cid:16)(cid:34)(cid:33,,16621.0
,,19,,,Unknown,,cid:12)(cid:29)(cid:26)(cid:41)(cid:25)(cid:2)(cid:58)(cid:58)(cid:37)(cid:16)(cid:34)(cid:33,,16640.0
,,32,,,Unknown,,cid:12)(cid:29)(cid:26)(cid:41)(cid:25)(cid:2)(cid:58)(cid:58)(cid:37)(cid:16)(cid:34)(cid:33,,16672.0
,,33,,,Unknown,,cid:12)(cid:29)(cid:26)(cid:41)(cid:25)(cid:2)(cid:58)(cid:58)(cid:37)(cid:16)(cid:34)(cid:33,,16705.0
,,2,,,Unknown,,cid:12)(cid:29)(cid:26)(cid:41)(cid:25)(cid:2)(cid:58)(cid:58)(cid:37)(cid:16)(cid:34)(cid:33,,16707.0
,,44,,,Unknown,,cid:12)(cid:29)(cid:26)(cid:41)(cid:25)(cid:2)(cid:58)(cid:58)(cid:37)(cid:16)(cid:34)(cid:33,,16751.0
,,12,,,Unknown,,cid:12)(cid:29)(cid:26)(cid:41)(cid:25)(cid:2)(cid:58)(cid:58)(cid:37)(cid:16)(cid:34)(cid:33,,16763.0
,,29,,,Unknown,,cid:12)(cid:29)(cid:26)(cid:41)(cid:25)(cid:2)(cid:58)(cid:58)(cid:37)(cid:16)(cid:34)(cid:33,,16792.0
,,26,,,Unknown,,cid:12)(cid:29)(cid:26)(cid:41)(cid:25)(cid:2)(cid:58)(cid:58)(cid:37)(cid:16)(cid:34)(cid:33,,16818.0
,,41,,,Unknown,,cid:12)(cid:29)(cid:26)(cid:41)(cid:25)(cid:2)(cid:58)(cid:58)(cid:37)(cid:16)(cid:34)(cid:33,,16859.0
,,25,,,Unknown,,cid:12)(cid:29)(cid:26)(cid:41)(cid:25)(cid:2)(cid:58)(cid:58)(cid:37)(cid:16)(cid:34)(cid:33,,16884.0
,,2,,,Unknown,,cid:12)(cid:29)(cid:26)(cid:41)(cid:25)(cid:2)(cid:58)(cid:58)(cid:37)(cid:16)(cid:34)(cid:33,,16886.0
,,58,,,Unknown,,cid:12)(cid:29)(cid:26)(cid:41)(cid:25)(cid:2)(cid:58)(cid:58)(cid:37)(cid:16)(cid:34)(cid:33,,16944.0
,,58,,,Unknown,,cid:12)(cid:29)(cid:26)(cid:41)(cid:25)(cid:2)(cid:58)(cid:58)(cid:37)(cid:16)(cid:34)(cid:33,,17002.0
,,37,,,Unknown,,cid:12)(cid:29)(cid:26)(cid:41)(cid:25)(cid:2)(cid:58)(cid:58)(cid:37)(cid:16)(cid:34)(cid:33,,17039.0
,,16,,,Unknown,,cid:12)(cid:29)(cid:26)(cid:41)(cid:25)(cid:2)(cid:58)(cid:58)(cid:37)(cid:16)(cid:34)(cid:33,,17055.0
,,34,,,Unknown,,cid:12)(cid:29)(cid:26)(cid:41)(cid:25)(cid:2)(cid:58)(cid:58)(cid:37)(cid:16)(cid:34)(cid:33,,17089.0
,,33,,,Unknown,,cid:12)(cid:29)(cid:26)(cid:41)(cid:25)(cid:2)(cid:58)(cid:58)(cid:37)(cid:16)(cid:34)(cid:33,,17122.0
,,1,,,Unknown,,cid:12)(cid:29)(cid:26)(cid:41)(cid:25)(cid:2)(cid:58)(cid:58)(cid:37)(cid:16)(cid:34)(cid:33,,17123.0
,,16,,,Unknown,,cid:12)(cid:29)(cid:26)(cid:41)(cid:25)(cid:2)(cid:58)(cid:58)(cid:37)(cid:16)(cid:34)(cid:33,,17139.0
,,45,,,Unknown,,cid:12)(cid:29)(cid:26)(cid:41)(cid:25)(cid:2)(cid:58)(cid:58)(cid:37)(cid:16)(cid:34)(cid:33,,17184.0
,,18,,,Unknown,,cid:12)(cid:29)(cid:26)(cid:41)(cid:25)(cid:2)(cid:58)(cid:58)(cid:37)(cid:16)(cid:34)(cid:33,,17202.0
,,16,,,Unknown,,cid:12)(cid:29)(cid:26)(cid:41)(cid:25)(cid:2)(cid:58)(cid:58)(cid:37)(cid:16)(cid:34)(cid:33,,17218.0
,,39,,,Unknown,,cid:12)(cid:29)(cid:26)(cid:41)(cid:25)(cid:2)(cid:58)(cid:58)(cid:37)(cid:16)(cid:34)(cid:33,,17257.0
,,3,,,Unknown,,cid:12)(cid:29)(cid:26)(cid:41)(cid:25)(cid:2)(cid:58)(cid:58)(cid:37)(cid:16)(cid:34)(cid:33,,17260.0
,,7,,,Unknown,,cid:12)(cid:29)(cid:26)(cid:41)(cid:25)(cid:2)(cid:58)(cid:58)(cid:37)(cid:16)(cid:34)(cid:33,,17267.0
,,48,,,Unknown,,cid:12)(cid:29)(cid:26)(cid:41)(cid:25)(cid:2)(cid:58)(cid:58)(cid:37)(cid:16)(cid:34)(cid:33,,17315.0
,,46,,,Unknown,,cid:12)(cid:29)(cid:26)(cid:41)(cid:25)(cid:2)(cid:58)(cid:58)(cid:37)(cid:16)(cid:34)(cid:33,,17361.0
,,3,,,Unknown,,cid:12)(cid:29)(cid:26)(cid:41)(cid:25)(cid:2)(cid:58)(cid:58)(cid:37)(cid:16)(cid:34)(cid:33,,17364.0
,,65,,,Unknown,,cid:12)(cid:29)(cid:26)(cid:41)(cid:25)(cid:2)(cid:58)(cid:58)(cid:37)(cid:16)(cid:34)(cid:33,,17429.0
,,2,,,Unknown,,cid:12)(cid:29)(cid:26)(cid:41)(cid:25)(cid:2)(cid:58)(cid:58)(cid:37)(cid:16)(cid:34)(cid:33,,17431.0
,,9,,,Unknown,,cid:12)(cid:29)(cid:26)(cid:41)(cid:25)(cid:2)(cid:58)(cid:58)(cid:37)(cid:16)(cid:34)(cid:33,,17440.0
,,5,,,Unknown,,cid:12)(cid:29)(cid:26)(cid:41)(cid:25)(cid:2)(cid:58)(cid:58)(cid:37)(cid:16)(cid:34)(cid:33,,17445.0
,,3,,,Unknown,,cid:12)(cid:29)(cid:26)(cid:41)(cid:25)(cid:2)(cid:58)(cid:58)(cid:37)(cid:16)(cid:34)(cid:33,,17448.0
,,3,,,Unknown,,cid:12)(cid:29)(cid:26)(cid:41)(cid:25)(cid:2)(cid:58)(cid:58)(cid:37)(cid:16)(cid:34)(cid:33,,17451.0
,,7,,,Unknown,,cid:12)(cid:29)(cid:26)(cid:41)(cid:25)(cid:2)(cid:58)(cid:58)(cid:37)(cid:16)(cid:34)(cid:33,,17458.0
,,9,,,Unknown,,cid:12)(cid:29)(cid:26)(cid:41)(cid:25)(cid:2)(cid:58)(cid:58)(cid:37)(cid:16)(cid:34)(cid:33,,17467.0
,,2,,,Unknown,,cid:12)(cid:29)(cid:26)(cid:41)(cid:25)(cid:2)(cid:58)(cid:58)(cid:37)(cid:16)(cid:34)(cid:33,,17469.0
,,9,,,Unknown,,cid:12)(cid:29)(cid:26)(cid:41)(cid:25)(cid:2)(cid:58)(cid:58)(cid:37)(cid:16)(cid:34)(cid:33,,17478.0
,,5,,,Unknown,,cid:12)(cid:29)(cid:26)(cid:41)(cid:25)(cid:2)(cid:58)(cid:58)(cid:37)(cid:16)(cid:34)(cid:33,,17483.0
,,3,,,Unknown,,cid:12)(cid:29)(cid:26)(cid:41)(cid:25)(cid:2)(cid:58)(cid:58)(cid:37)(cid:16)(cid:34)(cid:33,,17486.0
,,3,,,Unknown,,cid:12)(cid:29)(cid:26)(cid:41)(cid:25)(cid:2)(cid:58)(cid:58)(cid:37)(cid:16)(cid:34)(cid:33,,17489.0
,,7,,,Unknown,,cid:12)(cid:29)(cid:26)(cid:41)(cid:25)(cid:2)(cid:58)(cid:58)(cid:37)(cid:16)(cid:34)(cid:33,,17496.0
,,9,,,Unknown,,cid:12)(cid:29)(cid:26)(cid:41)(cid:25)(cid:2)(cid:58)(cid:58)(cid:37)(cid:16)(cid:34)(cid:33,,17505.0
,,2,,,Unknown,,cid:12)(cid:29)(cid:26)(cid:41)(cid:25)(cid:2)(cid:58)(cid:58)(cid:37)(cid:16)(cid:34)(cid:33,,17507.0
,,28,,,Unknown,,cid:12)(cid:29)(cid:26)(cid:41)(cid:25)(cid:2)(cid:58)(cid:58)(cid:37)(cid:16)(cid:34)(cid:33,,17535.0
,,3,,,Unknown,,cid:12)(cid:29)(cid:26)(cid:41)(cid:25)(cid:2)(cid:58)(cid:58)(cid:37)(cid:16)(cid:34)(cid:33,,17538.0
,,15,,,Unknown,,cid:12)(cid:29)(cid:26)(cid:41)(cid:25)(cid:2)(cid:58)(cid:58)(cid:37)(cid:16)(cid:34)(cid:33,,17553.0
,,2,,,Unknown,,cid:12)(cid:29)(cid:26)(cid:41)(cid:25)(cid:2)(cid:58)(cid:58)(cid:37)(cid:16)(cid:34)(cid:33,,17555.0
,,17,,,Unknown,,cid:12)(cid:29)(cid:26)(cid:41)(cid:25)(cid:2)(cid:58)(cid:58)(cid:37)(cid:16)(cid:34)(cid:33,,17572.0
,,18,,,Unknown,,cid:12)(cid:29)(cid:26)(cid:41)(cid:25)(cid:2)(cid:58)(cid:58)(cid:37)(cid:16)(cid:34)(cid:33,,17590.0
,,18,,,Unknown,,cid:12)(cid:29)(cid:26)(cid:41)(cid:25)(cid:2)(cid:58)(cid:58)(cid:37)(cid:16)(cid:34)(cid:33,,17608.0
,,19,,,Unknown,,cid:12)(cid:29)(cid:26)(cid:41)(cid:25)(cid:2)(cid:58)(cid:58)(cid:37)(cid:16)(cid:34)(cid:33,,17627.0
,,18,,,Unknown,,cid:12)(cid:29)(cid:26)(cid:41)(cid:25)(cid:2)(cid:58)(cid:58)(cid:37)(cid:16)(cid:34)(cid:33,,17645.0
,,18,,,Unknown,,cid:12)(cid:29)(cid:26)(cid:41)(cid:25)(cid:2)(cid:58)(cid:58)(cid:37)(cid:16)(cid:34)(cid:33,,17663.0
,,2,,,Unknown,,cid:12)(cid:29)(cid:26)(cid:41)(cid:25)(cid:2)(cid:58)(cid:58)(cid:37)(cid:16)(cid:34)(cid:33,,17665.0
,,44,,,Unknown,,cid:12)(cid:29)(cid:26)(cid:41)(cid:25)(cid:2)(cid:58)(cid:58)(cid:37)(cid:16)(cid:34)(cid:33,,17709.0
,,12,,,Unknown,,cid:12)(cid:29)(cid:26)(cid:41)(cid:25)(cid:2)(cid:58)(cid:58)(cid:37)(cid:16)(cid:34)(cid:33,,17721.0
,,29,,,Unknown,,cid:12)(cid:29)(cid:26)(cid:41)(cid:25)(cid:2)(cid:58)(cid:58)(cid:37)(cid:16)(cid:34)(cid:33,,17750.0
,,26,,,Unknown,,cid:12)(cid:29)(cid:26)(cid:41)(cid:25)(cid:2)(cid:58)(cid:58)(cid:37)(cid:16)(cid:34)(cid:33,,17776.0
,,41,,,Unknown,,cid:12)(cid:29)(cid:26)(cid:41)(cid:25)(cid:2)(cid:58)(cid:58)(cid:37)(cid:16)(cid:34)(cid:33,,17817.0
,,25,,,Unknown,,cid:12)(cid:29)(cid:26)(cid:41)(cid:25)(cid:2)(cid:58)(cid:58)(cid:37)(cid:16)(cid:34)(cid:33,,17842.0
,,2,,,Unknown,,cid:12)(cid:29)(cid:26)(cid:41)(cid:25)(cid:2)(cid:58)(cid:58)(cid:37)(cid:16)(cid:34)(cid:33,,17844.0
,,58,,,Unknown,,cid:12)(cid:29)(cid:26)(cid:41)(cid:25)(cid:2)(cid:58)(cid:58)(cid:37)(cid:16)(cid:34)(cid:33,,17902.0
,,58,,,Unknown,,cid:12)(cid:29)(cid:26)(cid:41)(cid:25)(cid:2)(cid:58)(cid:58)(cid:37)(cid:16)(cid:34)(cid:33,,17960.0
,,37,,,Unknown,,cid:12)(cid:29)(cid:26)(cid:41)(cid:25)(cid:2)(cid:58)(cid:58)(cid:37)(cid:16)(cid:34)(cid:33,,17997.0
,,16,,,Unknown,,cid:12)(cid:29)(cid:26)(cid:41)(cid:25)(cid:2)(cid:58)(cid:58)(cid:37)(cid:16)(cid:34)(cid:33,,18013.0
,,34,,,Unknown,,cid:12)(cid:29)(cid:26)(cid:41)(cid:25)(cid:2)(cid:58)(cid:58)(cid:37)(cid:16)(cid:34)(cid:33,,18047.0
,,33,,,Unknown,,cid:12)(cid:29)(cid:26)(cid:41)(cid:25)(cid:2)(cid:58)(cid:58)(cid:37)(cid:16)(cid:34)(cid:33,,18080.0
,,1,,,Unknown,,cid:12)(cid:29)(cid:26)(cid:41)(cid:25)(cid:2)(cid:58)(cid:58)(cid:37)(cid:16)(cid:34)(cid:33,,18081.0
,,16,,,Unknown,,cid:12)(cid:29)(cid:26)(cid:41)(cid:25)(cid:2)(cid:58)(cid:58)(cid:37)(cid:16)(cid:34)(cid:33,,18097.0
,,45,,,Unknown,,cid:12)(cid:29)(cid:26)(cid:41)(cid:25)(cid:2)(cid:58)(cid:58)(cid:37)(cid:16)(cid:34)(cid:33,,18142.0
,,18,,,Unknown,,cid:12)(cid:29)(cid:26)(cid:41)(cid:25)(cid:2)(cid:58)(cid:58)(cid:37)(cid:16)(cid:34)(cid:33,,18160.0
,,16,,,Unknown,,cid:12)(cid:29)(cid:26)(cid:41)(cid:25)(cid:2)(cid:58)(cid:58)(cid:37)(cid:16)(cid:34)(cid:33,,18176.0
,,47,,,Unknown,,cid:12)(cid:29)(cid:26)(cid:41)(cid:25)(cid:2)(cid:58)(cid:58)(cid:37)(cid:16)(cid:34)(cid:33,,18223.0
,,11,,,Unknown,,cid:12)(cid:29)(cid:26)(cid:41)(cid:25)(cid:2)(cid:58)(cid:58)(cid:37)(cid:16)(cid:34)(cid:33,,18234.0
,,4,,,Unknown,,cid:12)(cid:29)(cid:26)(cid:41)(cid:25)(cid:2)(cid:58)(cid:58)(cid:37)(cid:16)(cid:34)(cid:33,,18238.0
,,49,,,Unknown,,cid:12)(cid:29)(cid:26)(cid:41)(cid:25)(cid:2)(cid:58)(cid:58)(cid:37)(cid:16)(cid:34)(cid:33,,18287.0
,,64,,,Unknown,,cid:12)(cid:29)(cid:26)(cid:41)(cid:25)(cid:2)(cid:58)(cid:58)(cid:37)(cid:16)(cid:34)(cid:33,,18351.0
,,10,,,Unknown,,cid:12)(cid:29)(cid:26)(cid:41)(cid:25)(cid:2)(cid:58)(cid:58)(cid:37)(cid:16)(cid:34)(cid:33,,18361.0
,,5,,,Unknown,,cid:12)(cid:29)(cid:26)(cid:41)(cid:25)(cid:2)(cid:58)(cid:58)(cid:37)(cid:16)(cid:34)(cid:33,,18366.0
,,14,,,Unknown,,cid:12)(cid:29)(cid:26)(cid:41)(cid:25)(cid:2)(cid:58)(cid:58)(cid:37)(cid:16)(cid:34)(cid:33,,18380.0
,,2,,,Unknown,,cid:12)(cid:29)(cid:26)(cid:41)(cid:25)(cid:2)(cid:58)(cid:58)(cid:37)(cid:16)(cid:34)(cid:33,,18382.0
,,9,,,Unknown,,cid:12)(cid:29)(cid:26)(cid:41)(cid:25)(cid:2)(cid:58)(cid:58)(cid:37)(cid:16)(cid:34)(cid:33,,18391.0
,,66,,,Unknown,,cid:12)(cid:29)(cid:26)(cid:41)(cid:25)(cid:2)(cid:58)(cid:58)(cid:37)(cid:16)(cid:34)(cid:33,,18457.0
,,7,,,Unknown,,cid:12)(cid:29)(cid:26)(cid:41)(cid:25)(cid:2)(cid:58)(cid:58)(cid:37)(cid:16)(cid:34)(cid:33,,18464.0
,,2,,,Unknown,,cid:12)(cid:29)(cid:26)(cid:41)(cid:25)(cid:2)(cid:58)(cid:58)(cid:37)(cid:16)(cid:34)(cid:33,,18466.0
,,48,,,Unknown,,cid:12)(cid:29)(cid:26)(cid:41)(cid:25)(cid:2)(cid:58)(cid:58)(cid:37)(cid:16)(cid:34)(cid:33,,18514.0
,,5,,,Unknown,,cid:12)(cid:29)(cid:26)(cid:41)(cid:25)(cid:2)(cid:58)(cid:58)(cid:37)(cid:16)(cid:34)(cid:33,,18519.0
,,4,,,Unknown,,cid:12)(cid:29)(cid:26)(cid:41)(cid:25)(cid:2)(cid:58)(cid:58)(cid:37)(cid:16)(cid:34)(cid:33,,18523.0
,,50,,,Unknown,,cid:12)(cid:29)(cid:26)(cid:41)(cid:25)(cid:2)(cid:58)(cid:58)(cid:37)(cid:16)(cid:34)(cid:33,,18573.0
,,11,,,Unknown,,cid:12)(cid:29)(cid:26)(cid:41)(cid:25)(cid:2)(cid:58)(cid:58)(cid:37)(cid:16)(cid:34)(cid:33,,18584.0
,,8,,,Unknown,,cid:12)(cid:29)(cid:26)(cid:41)(cid:25)(cid:2)(cid:58)(cid:58)(cid:37)(cid:16)(cid:34)(cid:33,,18592.0
,,2,,,Unknown,,cid:12)(cid:29)(cid:26)(cid:41)(cid:25)(cid:2)(cid:58)(cid:58)(cid:37)(cid:16)(cid:34)(cid:33,,18594.0
,,14,,,Unknown,,cid:12)(cid:29)(cid:26)(cid:41)(cid:25)(cid:2)(cid:58)(cid:58)(cid:37)(cid:16)(cid:34)(cid:33,,18608.0
,,46,,,Unknown,,cid:12)(cid:29)(cid:26)(cid:41)(cid:25)(cid:2)(cid:58)(cid:58)(cid:37)(cid:16)(cid:34)(cid:33,,18654.0
,,2,,,Unknown,,cid:12)(cid:29)(cid:26)(cid:41)(cid:25)(cid:2)(cid:58)(cid:58)(cid:37)(cid:16)(cid:34)(cid:33,,18656.0
,,28,,,Unknown,,cid:12)(cid:29)(cid:26)(cid:41)(cid:25)(cid:2)(cid:58)(cid:58)(cid:37)(cid:16)(cid:34)(cid:33,,18684.0
,,11,,,Unknown,,cid:12)(cid:29)(cid:26)(cid:41)(cid:25)(cid:2)(cid:58)(cid:58)(cid:37)(cid:16)(cid:34)(cid:33,,18695.0
,,3,,,Unknown,,cid:12)(cid:29)(cid:26)(cid:41)(cid:25)(cid:2)(cid:58)(cid:58)(cid:37)(cid:16)(cid:34)(cid:33,,18698.0
,,2,,,Unknown,,cid:12)(cid:29)(cid:26)(cid:41)(cid:25)(cid:2)(cid:58)(cid:58)(cid:37)(cid:16)(cid:34)(cid:33,,18700.0
,,28,,,Unknown,,cid:12)(cid:29)(cid:26)(cid:41)(cid:25)(cid:2)(cid:58)(cid:58)(cid:37)(cid:16)(cid:34)(cid:33,,18728.0
,,3,,,Unknown,,cid:12)(cid:29)(cid:26)(cid:41)(cid:25)(cid:2)(cid:58)(cid:58)(cid:37)(cid:16)(cid:34)(cid:33,,18731.0
,,15,,,Unknown,,cid:12)(cid:29)(cid:26)(cid:41)(cid:25)(cid:2)(cid:58)(cid:58)(cid:37)(cid:16)(cid:34)(cid:33,,18746.0
,,2,,,Unknown,,cid:12)(cid:29)(cid:26)(cid:41)(cid:25)(cid:2)(cid:58)(cid:58)(cid:37)(cid:16)(cid:34)(cid:33,,18748.0
,,37,,,Unknown,,cid:12)(cid:29)(cid:26)(cid:41)(cid:25)(cid:2)(cid:58)(cid:58)(cid:37)(cid:16)(cid:34)(cid:33,,18785.0
,,33,,,Unknown,,cid:12)(cid:29)(cid:26)(cid:41)(cid:25)(cid:2)(cid:58)(cid:58)(cid:37)(cid:16)(cid:34)(cid:33,,18818.0
,,19,,,Unknown,,cid:12)(cid:29)(cid:26)(cid:41)(cid:25)(cid:2)(cid:58)(cid:58)(cid:37)(cid:16)(cid:34)(cid:33,,18837.0
,,33,,,Unknown,,cid:12)(cid:29)(cid:26)(cid:41)(cid:25)(cid:2)(cid:58)(cid:58)(cid:37)(cid:16)(cid:34)(cid:33,,18870.0
,,33,,,Unknown,,cid:12)(cid:29)(cid:26)(cid:41)(cid:25)(cid:2)(cid:58)(cid:58)(cid:37)(cid:16)(cid:34)(cid:33,,18903.0
,,2,,,Unknown,,cid:12)(cid:29)(cid:26)(cid:41)(cid:25)(cid:2)(cid:58)(cid:58)(cid:37)(cid:16)(cid:34)(cid:33,,18905.0
,,44,,,Unknown,,cid:12)(cid:29)(cid:26)(cid:41)(cid:25)(cid:2)(cid:58)(cid:58)(cid:37)(cid:16)(cid:34)(cid:33,,18949.0
,,12,,,Unknown,,cid:12)(cid:29)(cid:26)(cid:41)(cid:25)(cid:2)(cid:58)(cid:58)(cid:37)(cid:16)(cid:34)(cid:33,,18961.0
,,29,,,Unknown,,cid:12)(cid:29)(cid:26)(cid:41)(cid:25)(cid:2)(cid:58)(cid:58)(cid:37)(cid:16)(cid:34)(cid:33,,18990.0
,,26,,,Unknown,,cid:12)(cid:29)(cid:26)(cid:41)(cid:25)(cid:2)(cid:58)(cid:58)(cid:37)(cid:16)(cid:34)(cid:33,,19016.0
,,41,,,Unknown,,cid:12)(cid:29)(cid:26)(cid:41)(cid:25)(cid:2)(cid:58)(cid:58)(cid:37)(cid:16)(cid:34)(cid:33,,19057.0
,,25,,,Unknown,,cid:12)(cid:29)(cid:26)(cid:41)(cid:25)(cid:2)(cid:58)(cid:58)(cid:37)(cid:16)(cid:34)(cid:33,,19082.0
,,2,,,Unknown,,cid:12)(cid:29)(cid:26)(cid:41)(cid:25)(cid:2)(cid:58)(cid:58)(cid:37)(cid:16)(cid:34)(cid:33,,19084.0
,,58,,,Unknown,,cid:12)(cid:29)(cid:26)(cid:41)(cid:25)(cid:2)(cid:58)(cid:58)(cid:37)(cid:16)(cid:34)(cid:33,,19142.0
,,58,,,Unknown,,cid:12)(cid:29)(cid:26)(cid:41)(cid:25)(cid:2)(cid:58)(cid:58)(cid:37)(cid:16)(cid:34)(cid:33,,19200.0
,,37,,,Unknown,,cid:12)(cid:29)(cid:26)(cid:41)(cid:25)(cid:2)(cid:58)(cid:58)(cid:37)(cid:16)(cid:34)(cid:33,,19237.0
,,16,,,Unknown,,cid:12)(cid:29)(cid:26)(cid:41)(cid:25)(cid:2)(cid:58)(cid:58)(cid:37)(cid:16)(cid:34)(cid:33,,19253.0
,,34,,,Unknown,,cid:12)(cid:29)(cid:26)(cid:41)(cid:25)(cid:2)(cid:58)(cid:58)(cid:37)(cid:16)(cid:34)(cid:33,,19287.0
,,33,,,Unknown,,cid:12)(cid:29)(cid:26)(cid:41)(cid:25)(cid:2)(cid:58)(cid:58)(cid:37)(cid:16)(cid:34)(cid:33,,19320.0
,,1,,,Unknown,,cid:12)(cid:29)(cid:26)(cid:41)(cid:25)(cid:2)(cid:58)(cid:58)(cid:37)(cid:16)(cid:34)(cid:33,,19321.0
,,16,,,Unknown,,cid:12)(cid:29)(cid:26)(cid:41)(cid:25)(cid:2)(cid:58)(cid:58)(cid:37)(cid:16)(cid:34)(cid:33,,19337.0
,,45,,,Unknown,,cid:12)(cid:29)(cid:26)(cid:41)(cid:25)(cid:2)(cid:58)(cid:58)(cid:37)(cid:16)(cid:34)(cid:33,,19382.0
,,18,,,Unknown,,cid:12)(cid:29)(cid:26)(cid:41)(cid:25)(cid:2)(cid:58)(cid:58)(cid:37)(cid:16)(cid:34)(cid:33,,19400.0
,,16,,,Unknown,,cid:12)(cid:29)(cid:26)(cid:41)(cid:25)(cid:2)(cid:58)(cid:58)(cid:37)(cid:16)(cid:34)(cid:33,,19416.0
,,47,,,Unknown,,cid:12)(cid:29)(cid:26)(cid:41)(cid:25)(cid:2)(cid:58)(cid:58)(cid:37)(cid:16)(cid:34)(cid:33,,19463.0
,,11,,,Unknown,,cid:12)(cid:29)(cid:26)(cid:41)(cid:25)(cid:2)(cid:58)(cid:58)(cid:37)(cid:16)(cid:34)(cid:33,,19474.0
,,4,,,Unknown,,cid:12)(cid:29)(cid:26)(cid:41)(cid:25)(cid:2)(cid:58)(cid:58)(cid:37)(cid:16)(cid:34)(cid:33,,19478.0
,,49,,,Unknown,,cid:12)(cid:29)(cid:26)(cid:41)(cid:25)(cid:2)(cid:58)(cid:58)(cid:37)(cid:16)(cid:34)(cid:33,,19527.0
,,64,,,Unknown,,cid:12)(cid:29)(cid:26)(cid:41)(cid:25)(cid:2)(cid:58)(cid:58)(cid:37)(cid:16)(cid:34)(cid:33,,19591.0
,,10,,,Unknown,,cid:12)(cid:29)(cid:26)(cid:41)(cid:25)(cid:2)(cid:58)(cid:58)(cid:37)(cid:16)(cid:34)(cid:33,,19601.0
,,5,,,Unknown,,cid:12)(cid:29)(cid:26)(cid:41)(cid:25)(cid:2)(cid:58)(cid:58)(cid:37)(cid:16)(cid:34)(cid:33,,19606.0
,,14,,,Unknown,,cid:12)(cid:29)(cid:26)(cid:41)(cid:25)(cid:2)(cid:58)(cid:58)(cid:37)(cid:16)(cid:34)(cid:33,,19620.0
,,2,,,Unknown,,cid:12)(cid:29)(cid:26)(cid:41)(cid:25)(cid:2)(cid:58)(cid:58)(cid:37)(cid:16)(cid:34)(cid:33,,19622.0
,,9,,,Unknown,,cid:12)(cid:29)(cid:26)(cid:41)(cid:25)(cid:2)(cid:58)(cid:58)(cid:37)(cid:16)(cid:34)(cid:33,,19631.0
,,66,,,Unknown,,cid:12)(cid:29)(cid:26)(cid:41)(cid:25)(cid:2)(cid:58)(cid:58)(cid:37)(cid:16)(cid:34)(cid:33,,19697.0
,,7,,,Unknown,,cid:12)(cid:29)(cid:26)(cid:41)(cid:25)(cid:2)(cid:58)(cid:58)(cid:37)(cid:16)(cid:34)(cid:33,,19704.0
,,2,,,Unknown,,cid:12)(cid:29)(cid:26)(cid:41)(cid:25)(cid:2)(cid:58)(cid:58)(cid:37)(cid:16)(cid:34)(cid:33,,19706.0
,,48,,,Unknown,,cid:12)(cid:29)(cid:26)(cid:41)(cid:25)(cid:2)(cid:58)(cid:58)(cid:37)(cid:16)(cid:34)(cid:33,,19754.0
,,5,,,Unknown,,cid:12)(cid:29)(cid:26)(cid:41)(cid:25)(cid:2)(cid:58)(cid:58)(cid:37)(cid:16)(cid:34)(cid:33,,19759.0
,,4,,,Unknown,,cid:12)(cid:29)(cid:26)(cid:41)(cid:25)(cid:2)(cid:58)(cid:58)(cid:37)(cid:16)(cid:34)(cid:33,,19763.0
,,50,,,Unknown,,cid:12)(cid:29)(cid:26)(cid:41)(cid:25)(cid:2)(cid:58)(cid:58)(cid:37)(cid:16)(cid:34)(cid:33,,19813.0
,,11,,,Unknown,,cid:12)(cid:29)(cid:26)(cid:41)(cid:25)(cid:2)(cid:58)(cid:58)(cid:37)(cid:16)(cid:34)(cid:33,,19824.0
,,8,,,Unknown,,cid:12)(cid:29)(cid:26)(cid:41)(cid:25)(cid:2)(cid:58)(cid:58)(cid:37)(cid:16)(cid:34)(cid:33,,19832.0
,,2,,,Unknown,,cid:12)(cid:29)(cid:26)(cid:41)(cid:25)(cid:2)(cid:58)(cid:58)(cid:37)(cid:16)(cid:34)(cid:33,,19834.0
,,14,,,Unknown,,cid:12)(cid:29)(cid:26)(cid:41)(cid:25)(cid:2)(cid:58)(cid:58)(cid:37)(cid:16)(cid:34)(cid:33,,19848.0
,,46,,,Unknown,,cid:12)(cid:29)(cid:26)(cid:41)(cid:25)(cid:2)(cid:58)(cid:58)(cid:37)(cid:16)(cid:34)(cid:33,,19894.0
,,2,,,Unknown,,cid:12)(cid:29)(cid:26)(cid:41)(cid:25)(cid:2)(cid:58)(cid:58)(cid:37)(cid:16)(cid:34)(cid:33,,19896.0
,,28,,,Unknown,,cid:12)(cid:29)(cid:26)(cid:41)(cid:25)(cid:2)(cid:58)(cid:58)(cid:37)(cid:16)(cid:34)(cid:33,,19924.0
,,11,,,Unknown,,cid:12)(cid:29)(cid:26)(cid:41)(cid:25)(cid:2)(cid:58)(cid:58)(cid:37)(cid:16)(cid:34)(cid:33,,19935.0
,,3,,,Unknown,,cid:12)(cid:29)(cid:26)(cid:41)(cid:25)(cid:2)(cid:58)(cid:58)(cid:37)(cid:16)(cid:34)(cid:33,,19938.0
,,2,,,Unknown,,cid:12)(cid:29)(cid:26)(cid:41)(cid:25)(cid:2)(cid:58)(cid:58)(cid:37)(cid:16)(cid:34)(cid:33,,19940.0
,,28,,,Unknown,,cid:12)(cid:29)(cid:26)(cid:41)(cid:25)(cid:2)(cid:58)(cid:58)(cid:37)(cid:16)(cid:34)(cid:33,,19968.0
,,3,,,Unknown,,cid:12)(cid:29)(cid:26)(cid:41)(cid:25)(cid:2)(cid:58)(cid:58)(cid:37)(cid:16)(cid:34)(cid:33,,19971.0
,,15,,,Unknown,,cid:12)(cid:29)(cid:26)(cid:41)(cid:25)(cid:2)(cid:58)(cid:58)(cid:37)(cid:16)(cid:34)(cid:33,,19986.0
,,2,,,Unknown,,cid:12)(cid:29)(cid:26)(cid:41)(cid:25)(cid:2)(cid:58)(cid:58)(cid:37)(cid:16)(cid:34)(cid:33,,19988.0
,,16,,,Unknown,,cid:12)(cid:29)(cid:26)(cid:41)(cid:25)(cid:2)(cid:58)(cid:58)(cid:37)(cid:16)(cid:34)(cid:33,,20004.0
,,18,,,Unknown,,cid:12)(cid:29)(cid:26)(cid:41)(cid:25)(cid:2)(cid:58)(cid:58)(cid:37)(cid:16)(cid:34)(cid:33,,20022.0
,,19,,,Unknown,,cid:12)(cid:29)(cid:26)(cid:41)(cid:25)(cid:2)(cid:58)(cid:58)(cid:37)(cid:16)(cid:34)(cid:33,,20041.0
,,33,,,Unknown,,cid:12)(cid:29)(cid:26)(cid:41)(cid:25)(cid:2)(cid:58)(cid:58)(cid:37)(cid:16)(cid:34)(cid:33,,20074.0
,,33,,,Unknown,,cid:12)(cid:29)(cid:26)(cid:41)(cid:25)(cid:2)(cid:58)(cid:58)(cid:37)(cid:16)(cid:34)(cid:33,,20107.0
,,2,,,Unknown,,cid:12)(cid:29)(cid:26)(cid:41)(cid:25)(cid:2)(cid:58)(cid:58)(cid:37)(cid:16)(cid:34)(cid:33,,20109.0
,,44,,,Unknown,,cid:12)(cid:29)(cid:26)(cid:41)(cid:25)(cid:2)(cid:58)(cid:58)(cid:37)(cid:16)(cid:34)(cid:33,,20153.0
,,12,,,Unknown,,cid:12)(cid:29)(cid:26)(cid:41)(cid:25)(cid:2)(cid:58)(cid:58)(cid:37)(cid:16)(cid:34)(cid:33,,20165.0
,,29,,,Unknown,,cid:12)(cid:29)(cid:26)(cid:41)(cid:25)(cid:2)(cid:58)(cid:58)(cid:37)(cid:16)(cid:34)(cid:33,,20194.0
,,26,,,Unknown,,cid:12)(cid:29)(cid:26)(cid:41)(cid:25)(cid:2)(cid:58)(cid:58)(cid:37)(cid:16)(cid:34)(cid:33,,20220.0
,,41,,,Unknown,,cid:12)(cid:29)(cid:26)(cid:41)(cid:25)(cid:2)(cid:58)(cid:58)(cid:37)(cid:16)(cid:34)(cid:33,,20261.0
,,25,,,Unknown,,cid:12)(cid:29)(cid:26)(cid:41)(cid:25)(cid:2)(cid:58)(cid:58)(cid:37)(cid:16)(cid:34)(cid:33,,20286.0
,,2,,,Unknown,,cid:12)(cid:29)(cid:26)(cid:41)(cid:25)(cid:2)(cid:58)(cid:58)(cid:37)(cid:16)(cid:34)(cid:33,,20288.0
,,58,,,Unknown,,cid:12)(cid:29)(cid:26)(cid:41)(cid:25)(cid:2)(cid:58)(cid:58)(cid:37)(cid:16)(cid:34)(cid:33,,20346.0
,,58,,,Unknown,,cid:12)(cid:29)(cid:26)(cid:41)(cid:25)(cid:2)(cid:58)(cid:58)(cid:37)(cid:16)(cid:34)(cid:33,,20404.0
,,37,,,Unknown,,cid:12)(cid:29)(cid:26)(cid:41)(cid:25)(cid:2)(cid:58)(cid:58)(cid:37)(cid:16)(cid:34)(cid:33,,20441.0
,,16,,,Unknown,,cid:12)(cid:29)(cid:26)(cid:41)(cid:25)(cid:2)(cid:58)(cid:58)(cid:37)(cid:16)(cid:34)(cid:33,,20457.0
,,34,,,Unknown,,cid:12)(cid:29)(cid:26)(cid:41)(cid:25)(cid:2)(cid:58)(cid:58)(cid:37)(cid:16)(cid:34)(cid:33,,20491.0
,,33,,,Unknown,,cid:12)(cid:29)(cid:26)(cid:41)(cid:25)(cid:2)(cid:58)(cid:58)(cid:37)(cid:16)(cid:34)(cid:33,,20524.0
,,1,,,Unknown,,cid:12)(cid:29)(cid:26)(cid:41)(cid:25)(cid:2)(cid:58)(cid:58)(cid:37)(cid:16)(cid:34)(cid:33,,20525.0
,,16,,,Unknown,,cid:12)(cid:29)(cid:26)(cid:41)(cid:25)(cid:2)(cid:58)(cid:58)(cid:37)(cid:16)(cid:34)(cid:33,,20541.0
,,45,,,Unknown,,cid:12)(cid:29)(cid:26)(cid:41)(cid:25)(cid:2)(cid:58)(cid:58)(cid:37)(cid:16)(cid:34)(cid:33,,20586.0
,,18,,,Unknown,,cid:12)(cid:29)(cid:26)(cid:41)(cid:25)(cid:2)(cid:58)(cid:58)(cid:37)(cid:16)(cid:34)(cid:33,,20604.0
,,16,,,Unknown,,cid:12)(cid:29)(cid:26)(cid:41)(cid:25)(cid:2)(cid:58)(cid:58)(cid:37)(cid:16)(cid:34)(cid:33,,20620.0
,,47,,,Unknown,,cid:12)(cid:29)(cid:26)(cid:41)(cid:25)(cid:2)(cid:58)(cid:58)(cid:37)(cid:16)(cid:34)(cid:33,,20667.0
,,11,,,Unknown,,cid:12)(cid:29)(cid:26)(cid:41)(cid:25)(cid:2)(cid:58)(cid:58)(cid:37)(cid:16)(cid:34)(cid:33,,20678.0
,,4,,,Unknown,,cid:12)(cid:29)(cid:26)(cid:41)(cid:25)(cid:2)(cid:58)(cid:58)(cid:37)(cid:16)(cid:34)(cid:33,,20682.0
,,49,,,Unknown,,cid:12)(cid:29)(cid:26)(cid:41)(cid:25)(cid:2)(cid:58)(cid:58)(cid:37)(cid:16)(cid:34)(cid:33,,20731.0
,,64,,,Unknown,,cid:12)(cid:29)(cid:26)(cid:41)(cid:25)(cid:2)(cid:58)(cid:58)(cid:37)(cid:16)(cid:34)(cid:33,,20795.0
,,10,,,Unknown,,cid:12)(cid:29)(cid:26)(cid:41)(cid:25)(cid:2)(cid:58)(cid:58)(cid:37)(cid:16)(cid:34)(cid:33,,20805.0
,,5,,,Unknown,,cid:12)(cid:29)(cid:26)(cid:41)(cid:25)(cid:2)(cid:58)(cid:58)(cid:37)(cid:16)(cid:34)(cid:33,,20810.0
,,14,,,Unknown,,cid:12)(cid:29)(cid:26)(cid:41)(cid:25)(cid:2)(cid:58)(cid:58)(cid:37)(cid:16)(cid:34)(cid:33,,20824.0
,,2,,,Unknown,,cid:12)(cid:29)(cid:26)(cid:41)(cid:25)(cid:2)(cid:58)(cid:58)(cid:37)(cid:16)(cid:34)(cid:33,,20826.0
,,9,,,Unknown,,cid:12)(cid:29)(cid:26)(cid:41)(cid:25)(cid:2)(cid:58)(cid:58)(cid:37)(cid:16)(cid:34)(cid:33,,20835.0
,,66,,,Unknown,,cid:12)(cid:29)(cid:26)(cid:41)(cid:25)(cid:2)(cid:58)(cid:58)(cid:37)(cid:16)(cid:34)(cid:33,,20901.0
,,7,,,Unknown,,cid:12)(cid:29)(cid:26)(cid:41)(cid:25)(cid:2)(cid:58)(cid:58)(cid:37)(cid:16)(cid:34)(cid:33,,20908.0
,,2,,,Unknown,,cid:12)(cid:29)(cid:26)(cid:41)(cid:25)(cid:2)(cid:58)(cid:58)(cid:37)(cid:16)(cid:34)(cid:33,,20910.0
,,48,,,Unknown,,cid:12)(cid:29)(cid:26)(cid:41)(cid:25)(cid:2)(cid:58)(cid:58)(cid:37)(cid:16)(cid:34)(cid:33,,20958.0
,,5,,,Unknown,,cid:12)(cid:29)(cid:26)(cid:41)(cid:25)(cid:2)(cid:58)(cid:58)(cid:37)(cid:16)(cid:34)(cid:33,,20963.0
,,4,,,Unknown,,cid:12)(cid:29)(cid:26)(cid:41)(cid:25)(cid:2)(cid:58)(cid:58)(cid:37)(cid:16)(cid:34)(cid:33,,20967.0
,,50,,,Unknown,,cid:12)(cid:29)(cid:26)(cid:41)(cid:25)(cid:2)(cid:58)(cid:58)(cid:37)(cid:16)(cid:34)(cid:33,,21017.0
,,11,,,Unknown,,cid:12)(cid:29)(cid:26)(cid:41)(cid:25)(cid:2)(cid:58)(cid:58)(cid:37)(cid:16)(cid:34)(cid:33,,21028.0
,,8,,,Unknown,,cid:12)(cid:29)(cid:26)(cid:41)(cid:25)(cid:2)(cid:58)(cid:58)(cid:37)(cid:16)(cid:34)(cid:33,,21036.0
,,2,,,Unknown,,cid:12)(cid:29)(cid:26)(cid:41)(cid:25)(cid:2)(cid:58)(cid:58)(cid:37)(cid:16)(cid:34)(cid:33,,21038.0
,,14,,,Unknown,,cid:12)(cid:29)(cid:26)(cid:41)(cid:25)(cid:2)(cid:58)(cid:58)(cid:37)(cid:16)(cid:34)(cid:33,,21052.0
,,46,,,Unknown,,cid:12)(cid:29)(cid:26)(cid:41)(cid:25)(cid:2)(cid:58)(cid:58)(cid:37)(cid:16)(cid:34)(cid:33,,21098.0
,,2,,,Unknown,,cid:12)(cid:29)(cid:26)(cid:41)(cid:25)(cid:2)(cid:58)(cid:58)(cid:37)(cid:16)(cid:34)(cid:33,,21100.0
,,28,,,Unknown,,cid:12)(cid:29)(cid:26)(cid:41)(cid:25)(cid:2)(cid:58)(cid:58)(cid:37)(cid:16)(cid:34)(cid:33,,21128.0
,,11,,,Unknown,,cid:12)(cid:29)(cid:26)(cid:41)(cid:25)(cid:2)(cid:58)(cid:58)(cid:37)(cid:16)(cid:34)(cid:33,,21139.0
,,3,,,Unknown,,cid:12)(cid:29)(cid:26)(cid:41)(cid:25)(cid:2)(cid:58)(cid:58)(cid:37)(cid:16)(cid:34)(cid:33,,21142.0
,,2,,,Unknown,,cid:12)(cid:29)(cid:26)(cid:41)(cid:25)(cid:2)(cid:58)(cid:58)(cid:37)(cid:16)(cid:34)(cid:33,,21144.0
,,28,,,Unknown,,cid:12)(cid:29)(cid:26)(cid:41)(cid:25)(cid:2)(cid:58)(cid:58)(cid:37)(cid:16)(cid:34)(cid:33,,21172.0
,,3,,,Unknown,,cid:12)(cid:29)(cid:26)(cid:41)(cid:25)(cid:2)(cid:58)(cid:58)(cid:37)(cid:16)(cid:34)(cid:33,,21175.0
,,15,,,Unknown,,cid:12)(cid:29)(cid:26)(cid:41)(cid:25)(cid:2)(cid:58)(cid:58)(cid:37)(cid:16)(cid:34)(cid:33,,21190.0
,,2,,,Unknown,,cid:12)(cid:29)(cid:26)(cid:41)(cid:25)(cid:2)(cid:58)(cid:58)(cid:37)(cid:16)(cid:34)(cid:33,,21192.0
,,35,,,Unknown,,cid:12)(cid:29)(cid:26)(cid:41)(cid:25)(cid:2)(cid:58)(cid:58)(cid:37)(cid:16)(cid:34)(cid:33,,21227.0
,,37,,,Unknown,,cid:12)(cid:29)(cid:26)(cid:41)(cid:25)(cid:2)(cid:58)(cid:58)(cid:37)(cid:16)(cid:34)(cid:33,,21264.0
,,19,,,Unknown,,cid:12)(cid:29)(cid:26)(cid:41)(cid:25)(cid:2)(cid:58)(cid:58)(cid:37)(cid:16)(cid:34)(cid:33,,21283.0
,,1,,,Unknown,,cid:12)(cid:29)(cid:26)(cid:41)(cid:25)(cid:2)(cid:58)(cid:58)(cid:37)(cid:16)(cid:34)(cid:33,,21284.0
,,18,,,Unknown,,cid:12)(cid:29)(cid:26)(cid:41)(cid:25)(cid:2)(cid:58)(cid:58)(cid:37)(cid:16)(cid:34)(cid:33,,21302.0
,,2,,,Unknown,,cid:12)(cid:29)(cid:26)(cid:41)(cid:25)(cid:2)(cid:58)(cid:58)(cid:37)(cid:16)(cid:34)(cid:33,,21304.0
,,44,,,Unknown,,cid:12)(cid:29)(cid:26)(cid:41)(cid:25)(cid:2)(cid:58)(cid:58)(cid:37)(cid:16)(cid:34)(cid:33,,21348.0
,,12,,,Unknown,,cid:12)(cid:29)(cid:26)(cid:41)(cid:25)(cid:2)(cid:58)(cid:58)(cid:37)(cid:16)(cid:34)(cid:33,,21360.0
,,29,,,Unknown,,cid:12)(cid:29)(cid:26)(cid:41)(cid:25)(cid:2)(cid:58)(cid:58)(cid:37)(cid:16)(cid:34)(cid:33,,21389.0
,,26,,,Unknown,,cid:12)(cid:29)(cid:26)(cid:41)(cid:25)(cid:2)(cid:58)(cid:58)(cid:37)(cid:16)(cid:34)(cid:33,,21415.0
,,41,,,Unknown,,cid:12)(cid:29)(cid:26)(cid:41)(cid:25)(cid:2)(cid:58)(cid:58)(cid:37)(cid:16)(cid:34)(cid:33,,21456.0
,,25,,,Unknown,,cid:12)(cid:29)(cid:26)(cid:41)(cid:25)(cid:2)(cid:58)(cid:58)(cid:37)(cid:16)(cid:34)(cid:33,,21481.0
,,2,,,Unknown,,cid:12)(cid:29)(cid:26)(cid:41)(cid:25)(cid:2)(cid:58)(cid:58)(cid:37)(cid:16)(cid:34)(cid:33,,21483.0
,,58,,,Unknown,,cid:12)(cid:29)(cid:26)(cid:41)(cid:25)(cid:2)(cid:58)(cid:58)(cid:37)(cid:16)(cid:34)(cid:33,,21541.0
,,58,,,Unknown,,cid:12)(cid:29)(cid:26)(cid:41)(cid:25)(cid:2)(cid:58)(cid:58)(cid:37)(cid:16)(cid:34)(cid:33,,21599.0
,,37,,,Unknown,,cid:12)(cid:29)(cid:26)(cid:41)(cid:25)(cid:2)(cid:58)(cid:58)(cid:37)(cid:16)(cid:34)(cid:33,,21636.0
,,16,,,Unknown,,cid:12)(cid:29)(cid:26)(cid:41)(cid:25)(cid:2)(cid:58)(cid:58)(cid:37)(cid:16)(cid:34)(cid:33,,21652.0
,,34,,,Unknown,,cid:12)(cid:29)(cid:26)(cid:41)(cid:25)(cid:2)(cid:58)(cid:58)(cid:37)(cid:16)(cid:34)(cid:33,,21686.0
,,33,,,Unknown,,cid:12)(cid:29)(cid:26)(cid:41)(cid:25)(cid:2)(cid:58)(cid:58)(cid:37)(cid:16)(cid:34)(cid:33,,21719.0
,,1,,,Unknown,,cid:12)(cid:29)(cid:26)(cid:41)(cid:25)(cid:2)(cid:58)(cid:58)(cid:37)(cid:16)(cid:34)(cid:33,,21720.0
,,16,,,Unknown,,cid:12)(cid:29)(cid:26)(cid:41)(cid:25)(cid:2)(cid:58)(cid:58)(cid:37)(cid:16)(cid:34)(cid:33,,21736.0
,,45,,,Unknown,,cid:12)(cid:29)(cid:26)(cid:41)(cid:25)(cid:2)(cid:58)(cid:58)(cid:37)(cid:16)(cid:34)(cid:33,,21781.0
,,18,,,Unknown,,cid:12)(cid:29)(cid:26)(cid:41)(cid:25)(cid:2)(cid:58)(cid:58)(cid:37)(cid:16)(cid:34)(cid:33,,21799.0
,,16,,,Unknown,,cid:12)(cid:29)(cid:26)(cid:41)(cid:25)(cid:2)(cid:58)(cid:58)(cid:37)(cid:16)(cid:34)(cid:33,,21815.0
,,14,,,Unknown,,cid:12)(cid:29)(cid:26)(cid:41)(cid:25)(cid:2)(cid:58)(cid:58)(cid:37)(cid:16)(cid:34)(cid:33,,21829.0
,,5,,,Unknown,,cid:12)(cid:29)(cid:26)(cid:41)(cid:25)(cid:2)(cid:58)(cid:58)(cid:37)(cid:16)(cid:34)(cid:33,,21834.0
,,12,,,Unknown,,cid:12)(cid:29)(cid:26)(cid:41)(cid:25)(cid:2)(cid:58)(cid:58)(cid:37)(cid:16)(cid:34)(cid:33,,21846.0
,,14,,,Unknown,,cid:12)(cid:29)(cid:26)(cid:41)(cid:25)(cid:2)(cid:58)(cid:58)(cid:37)(cid:16)(cid:34)(cid:33,,21860.0
,,5,,,Unknown,,cid:12)(cid:29)(cid:26)(cid:41)(cid:25)(cid:2)(cid:58)(cid:58)(cid:37)(cid:16)(cid:34)(cid:33,,21865.0
,,3,,,Unknown,,cid:12)(cid:29)(cid:26)(cid:41)(cid:25)(cid:2)(cid:58)(cid:58)(cid:37)(cid:16)(cid:34)(cid:33,,21868.0
,,12,,,Unknown,,cid:12)(cid:29)(cid:26)(cid:41)(cid:25)(cid:2)(cid:58)(cid:58)(cid:37)(cid:16)(cid:34)(cid:33,,21880.0
,,2,,,Unknown,,cid:12)(cid:29)(cid:26)(cid:41)(cid:25)(cid:2)(cid:58)(cid:58)(cid:37)(cid:16)(cid:34)(cid:33,,21882.0
,,50,,,Unknown,,cid:12)(cid:29)(cid:26)(cid:41)(cid:25)(cid:2)(cid:58)(cid:58)(cid:37)(cid:16)(cid:34)(cid:33,,21932.0
,,7,,,Unknown,,cid:12)(cid:29)(cid:26)(cid:41)(cid:25)(cid:2)(cid:58)(cid:58)(cid:37)(cid:16)(cid:34)(cid:33,,21939.0
,,9,,,Unknown,,cid:12)(cid:29)(cid:26)(cid:41)(cid:25)(cid:2)(cid:58)(cid:58)(cid:37)(cid:16)(cid:34)(cid:33,,21948.0
,,10,,,Unknown,,cid:12)(cid:29)(cid:26)(cid:41)(cid:25)(cid:2)(cid:58)(cid:58)(cid:37)(cid:16)(cid:34)(cid:33,,21958.0
,,3,,,Unknown,,cid:12)(cid:29)(cid:26)(cid:41)(cid:25)(cid:2)(cid:58)(cid:58)(cid:37)(cid:16)(cid:34)(cid:33,,21961.0
,,2,,,Unknown,,cid:12)(cid:29)(cid:26)(cid:41)(cid:25)(cid:2)(cid:58)(cid:58)(cid:37)(cid:16)(cid:34)(cid:33,,21963.0
,,12,,,Unknown,,cid:12)(cid:29)(cid:26)(cid:41)(cid:25)(cid:2)(cid:58)(cid:58)(cid:37)(cid:16)(cid:34)(cid:33,,21975.0
,,11,,,Unknown,,cid:12)(cid:29)(cid:26)(cid:41)(cid:25)(cid:2)(cid:58)(cid:58)(cid:37)(cid:16)(cid:34)(cid:33,,21986.0
,,4,,,Unknown,,cid:12)(cid:29)(cid:26)(cid:41)(cid:25)(cid:2)(cid:58)(cid:58)(cid:37)(cid:16)(cid:34)(cid:33,,21990.0
,,14,,,Unknown,,cid:12)(cid:29)(cid:26)(cid:41)(cid:25)(cid:2)(cid:58)(cid:58)(cid:37)(cid:16)(cid:34)(cid:33,,22004.0
,,11,,,Unknown,,cid:12)(cid:29)(cid:26)(cid:41)(cid:25)(cid:2)(cid:58)(cid:58)(cid:37)(cid:16)(cid:34)(cid:33,,22015.0
,,48,,,Unknown,,cid:12)(cid:29)(cid:26)(cid:41)(cid:25)(cid:2)(cid:58)(cid:58)(cid:37)(cid:16)(cid:34)(cid:33,,22063.0
,,48,,,Unknown,,cid:12)(cid:29)(cid:26)(cid:41)(cid:25)(cid:2)(cid:58)(cid:58)(cid:37)(cid:16)(cid:34)(cid:33,,22111.0
,,7,,,Unknown,,cid:12)(cid:29)(cid:26)(cid:41)(cid:25)(cid:2)(cid:58)(cid:58)(cid:37)(cid:16)(cid:34)(cid:33,,22118.0
,,5,,,Unknown,,cid:12)(cid:29)(cid:26)(cid:41)(cid:25)(cid:2)(cid:58)(cid:58)(cid:37)(cid:16)(cid:34)(cid:33,,22123.0
,,3,,,Unknown,,cid:12)(cid:29)(cid:26)(cid:41)(cid:25)(cid:2)(cid:58)(cid:58)(cid:37)(cid:16)(cid:34)(cid:33,,22126.0
,,2,,,Unknown,,cid:12)(cid:29)(cid:26)(cid:41)(cid:25)(cid:2)(cid:58)(cid:58)(cid:37)(cid:16)(cid:34)(cid:33,,22128.0
,,28,,,Unknown,,cid:12)(cid:29)(cid:26)(cid:41)(cid:25)(cid:2)(cid:58)(cid:58)(cid:37)(cid:16)(cid:34)(cid:33,,22156.0
,,3,,,Unknown,,cid:12)(cid:29)(cid:26)(cid:41)(cid:25)(cid:2)(cid:58)(cid:58)(cid:37)(cid:16)(cid:34)(cid:33,,22159.0
,,15,,,Unknown,,cid:12)(cid:29)(cid:26)(cid:41)(cid:25)(cid:2)(cid:58)(cid:58)(cid:37)(cid:16)(cid:34)(cid:33,,22174.0
,,2,,,Unknown,,cid:12)(cid:29)(cid:26)(cid:41)(cid:25)(cid:2)(cid:58)(cid:58)(cid:37)(cid:16)(cid:34)(cid:33,,22176.0
,,17,,,Unknown,,cid:12)(cid:29)(cid:26)(cid:41)(cid:25)(cid:2)(cid:58)(cid:58)(cid:37)(cid:16)(cid:34)(cid:33,,22193.0
,,18,,,Unknown,,cid:12)(cid:29)(cid:26)(cid:41)(cid:25)(cid:2)(cid:58)(cid:58)(cid:37)(cid:16)(cid:34)(cid:33,,22211.0
,,18,,,Unknown,,cid:12)(cid:29)(cid:26)(cid:41)(cid:25)(cid:2)(cid:58)(cid:58)(cid:37)(cid:16)(cid:34)(cid:33,,22229.0
,,19,,,Unknown,,cid:12)(cid:29)(cid:26)(cid:41)(cid:25)(cid:2)(cid:58)(cid:58)(cid:37)(cid:16)(cid:34)(cid:33,,22248.0
,,18,,,Unknown,,cid:12)(cid:29)(cid:26)(cid:41)(cid:25)(cid:2)(cid:58)(cid:58)(cid:37)(cid:16)(cid:34)(cid:33,,22266.0
,,18,,,Unknown,,cid:12)(cid:29)(cid:26)(cid:41)(cid:25)(cid:2)(cid:58)(cid:58)(cid:37)(cid:16)(cid:34)(cid:33,,22284.0
,,2,,,Unknown,,cid:12)(cid:29)(cid:26)(cid:41)(cid:25)(cid:2)(cid:58)(cid:58)(cid:37)(cid:16)(cid:34)(cid:33,,22286.0
,,44,,,Unknown,,cid:12)(cid:29)(cid:26)(cid:41)(cid:25)(cid:2)(cid:58)(cid:58)(cid:37)(cid:16)(cid:34)(cid:33,,22330.0
,,12,,,Unknown,,cid:12)(cid:29)(cid:26)(cid:41)(cid:25)(cid:2)(cid:58)(cid:58)(cid:37)(cid:16)(cid:34)(cid:33,,22342.0
,,29,,,Unknown,,cid:12)(cid:29)(cid:26)(cid:41)(cid:25)(cid:2)(cid:58)(cid:58)(cid:37)(cid:16)(cid:34)(cid:33,,22371.0
,,26,,,Unknown,,cid:12)(cid:29)(cid:26)(cid:41)(cid:25)(cid:2)(cid:58)(cid:58)(cid:37)(cid:16)(cid:34)(cid:33,,22397.0
,,41,,,Unknown,,cid:12)(cid:29)(cid:26)(cid:41)(cid:25)(cid:2)(cid:58)(cid:58)(cid:37)(cid:16)(cid:34)(cid:33,,22438.0
,,25,,,Unknown,,cid:12)(cid:29)(cid:26)(cid:41)(cid:25)(cid:2)(cid:58)(cid:58)(cid:37)(cid:16)(cid:34)(cid:33,,22463.0
,,2,,,Unknown,,cid:12)(cid:29)(cid:26)(cid:41)(cid:25)(cid:2)(cid:58)(cid:58)(cid:37)(cid:16)(cid:34)(cid:33,,22465.0
,,58,,,Unknown,,cid:12)(cid:29)(cid:26)(cid:41)(cid:25)(cid:2)(cid:58)(cid:58)(cid:37)(cid:16)(cid:34)(cid:33,,22523.0
,,58,,,Unknown,,cid:12)(cid:29)(cid:26)(cid:41)(cid:25)(cid:2)(cid:58)(cid:58)(cid:37)(cid:16)(cid:34)(cid:33,,22581.0
,,18,,,Unknown,,cid:12)(cid:29)(cid:26)(cid:41)(cid:25)(cid:2)(cid:58)(cid:58)(cid:37)(cid:16)(cid:34)(cid:33,,22599.0
,,1,,,Unknown,,cid:12)(cid:29)(cid:26)(cid:41)(cid:25)(cid:2)(cid:58)(cid:58)(cid:37)(cid:16)(cid:34)(cid:33,,22600.0
,,1,,,Unknown,,cid:12)(cid:29)(cid:26)(cid:41)(cid:25)(cid:2)(cid:58)(cid:58)(cid:37)(cid:16)(cid:34)(cid:33,,22601.0
,,37,,,Unknown,,cid:12)(cid:29)(cid:26)(cid:41)(cid:25)(cid:2)(cid:58)(cid:58)(cid:37)(cid:16)(cid:34)(cid:33,,22638.0
,,1,,,Unknown,,cid:12)(cid:29)(cid:26)(cid:41)(cid:25)(cid:2)(cid:58)(cid:58)(cid:37)(cid:16)(cid:34)(cid:33,,22639.0
,,16,,,Unknown,,cid:12)(cid:29)(cid:26)(cid:41)(cid:25)(cid:2)(cid:58)(cid:58)(cid:37)(cid:16)(cid:34)(cid:33,,22655.0
,,45,,,Unknown,,cid:12)(cid:29)(cid:26)(cid:41)(cid:25)(cid:2)(cid:58)(cid:58)(cid:37)(cid:16)(cid:34)(cid:33,,22700.0
,,18,,,Unknown,,cid:12)(cid:29)(cid:26)(cid:41)(cid:25)(cid:2)(cid:58)(cid:58)(cid:37)(cid:16)(cid:34)(cid:33,,22718.0
,,16,,,Unknown,,cid:12)(cid:29)(cid:26)(cid:41)(cid:25)(cid:2)(cid:58)(cid:58)(cid:37)(cid:16)(cid:34)(cid:33,,22734.0
,,14,,,Unknown,,cid:12)(cid:29)(cid:26)(cid:41)(cid:25)(cid:2)(cid:58)(cid:58)(cid:37)(cid:16)(cid:34)(cid:33,,22748.0
,,5,,,Unknown,,cid:12)(cid:29)(cid:26)(cid:41)(cid:25)(cid:2)(cid:58)(cid:58)(cid:37)(cid:16)(cid:34)(cid:33,,22753.0
,,12,,,Unknown,,cid:12)(cid:29)(cid:26)(cid:41)(cid:25)(cid:2)(cid:58)(cid:58)(cid:37)(cid:16)(cid:34)(cid:33,,22765.0
,,14,,,Unknown,,cid:12)(cid:29)(cid:26)(cid:41)(cid:25)(cid:2)(cid:58)(cid:58)(cid:37)(cid:16)(cid:34)(cid:33,,22779.0
,,5,,,Unknown,,cid:12)(cid:29)(cid:26)(cid:41)(cid:25)(cid:2)(cid:58)(cid:58)(cid:37)(cid:16)(cid:34)(cid:33,,22784.0
,,3,,,Unknown,,cid:12)(cid:29)(cid:26)(cid:41)(cid:25)(cid:2)(cid:58)(cid:58)(cid:37)(cid:16)(cid:34)(cid:33,,22787.0
,,12,,,Unknown,,cid:12)(cid:29)(cid:26)(cid:41)(cid:25)(cid:2)(cid:58)(cid:58)(cid:37)(cid:16)(cid:34)(cid:33,,22799.0
,,2,,,Unknown,,cid:12)(cid:29)(cid:26)(cid:41)(cid:25)(cid:2)(cid:58)(cid:58)(cid:37)(cid:16)(cid:34)(cid:33,,22801.0
,,50,,,Unknown,,cid:12)(cid:29)(cid:26)(cid:41)(cid:25)(cid:2)(cid:58)(cid:58)(cid:37)(cid:16)(cid:34)(cid:33,,22851.0
,,7,,,Unknown,,cid:12)(cid:29)(cid:26)(cid:41)(cid:25)(cid:2)(cid:58)(cid:58)(cid:37)(cid:16)(cid:34)(cid:33,,22858.0
,,9,,,Unknown,,cid:12)(cid:29)(cid:26)(cid:41)(cid:25)(cid:2)(cid:58)(cid:58)(cid:37)(cid:16)(cid:34)(cid:33,,22867.0
,,10,,,Unknown,,cid:12)(cid:29)(cid:26)(cid:41)(cid:25)(cid:2)(cid:58)(cid:58)(cid:37)(cid:16)(cid:34)(cid:33,,22877.0
,,3,,,Unknown,,cid:12)(cid:29)(cid:26)(cid:41)(cid:25)(cid:2)(cid:58)(cid:58)(cid:37)(cid:16)(cid:34)(cid:33,,22880.0
,,2,,,Unknown,,cid:12)(cid:29)(cid:26)(cid:41)(cid:25)(cid:2)(cid:58)(cid:58)(cid:37)(cid:16)(cid:34)(cid:33,,22882.0
,,12,,,Unknown,,cid:12)(cid:29)(cid:26)(cid:41)(cid:25)(cid:2)(cid:58)(cid:58)(cid:37)(cid:16)(cid:34)(cid:33,,22894.0
,,11,,,Unknown,,cid:12)(cid:29)(cid:26)(cid:41)(cid:25)(cid:2)(cid:58)(cid:58)(cid:37)(cid:16)(cid:34)(cid:33,,22905.0
,,4,,,Unknown,,cid:12)(cid:29)(cid:26)(cid:41)(cid:25)(cid:2)(cid:58)(cid:58)(cid:37)(cid:16)(cid:34)(cid:33,,22909.0
,,14,,,Unknown,,cid:12)(cid:29)(cid:26)(cid:41)(cid:25)(cid:2)(cid:58)(cid:58)(cid:37)(cid:16)(cid:34)(cid:33,,22923.0
,,11,,,Unknown,,cid:12)(cid:29)(cid:26)(cid:41)(cid:25)(cid:2)(cid:58)(cid:58)(cid:37)(cid:16)(cid:34)(cid:33,,22934.0
,,48,,,Unknown,,cid:12)(cid:29)(cid:26)(cid:41)(cid:25)(cid:2)(cid:58)(cid:58)(cid:37)(cid:16)(cid:34)(cid:33,,22982.0
,,48,,,Unknown,,cid:12)(cid:29)(cid:26)(cid:41)(cid:25)(cid:2)(cid:58)(cid:58)(cid:37)(cid:16)(cid:34)(cid:33,,23030.0
,,7,,,Unknown,,cid:12)(cid:29)(cid:26)(cid:41)(cid:25)(cid:2)(cid:58)(cid:58)(cid:37)(cid:16)(cid:34)(cid:33,,23037.0
,,5,,,Unknown,,cid:12)(cid:29)(cid:26)(cid:41)(cid:25)(cid:2)(cid:58)(cid:58)(cid:37)(cid:16)(cid:34)(cid:33,,23042.0
,,3,,,Unknown,,cid:12)(cid:29)(cid:26)(cid:41)(cid:25)(cid:2)(cid:58)(cid:58)(cid:37)(cid:16)(cid:34)(cid:33,,23045.0
,,2,,,Unknown,,cid:12)(cid:29)(cid:26)(cid:41)(cid:25)(cid:2)(cid:58)(cid:58)(cid:37)(cid:16)(cid:34)(cid:33,,23047.0
,,28,,,Unknown,,cid:12)(cid:29)(cid:26)(cid:41)(cid:25)(cid:2)(cid:58)(cid:58)(cid:37)(cid:16)(cid:34)(cid:33,,23075.0
,,3,,,Unknown,,cid:12)(cid:29)(cid:26)(cid:41)(cid:25)(cid:2)(cid:58)(cid:58)(cid:37)(cid:16)(cid:34)(cid:33,,23078.0
,,15,,,Unknown,,cid:12)(cid:29)(cid:26)(cid:41)(cid:25)(cid:2)(cid:58)(cid:58)(cid:37)(cid:16)(cid:34)(cid:33,,23093.0
,,2,,,Unknown,,cid:12)(cid:29)(cid:26)(cid:41)(cid:25)(cid:2)(cid:58)(cid:58)(cid:37)(cid:16)(cid:34)(cid:33,,23095.0
,,17,,,Unknown,,cid:12)(cid:29)(cid:26)(cid:41)(cid:25)(cid:2)(cid:58)(cid:58)(cid:37)(cid:16)(cid:34)(cid:33,,23112.0
,,37,,,Unknown,,cid:12)(cid:29)(cid:26)(cid:41)(cid:25)(cid:2)(cid:58)(cid:58)(cid:37)(cid:16)(cid:34)(cid:33,,23149.0
,,36,,,Unknown,,cid:12)(cid:29)(cid:26)(cid:41)(cid:25)(cid:2)(cid:58)(cid:58)(cid:37)(cid:16)(cid:34)(cid:33,,23185.0
,,19,,,Unknown,,cid:12)(cid:29)(cid:26)(cid:41)(cid:25)(cid:2)(cid:58)(cid:58)(cid:37)(cid:16)(cid:34)(cid:33,,23204.0
,,36,,,Unknown,,cid:12)(cid:29)(cid:26)(cid:41)(cid:25)(cid:2)(cid:58)(cid:58)(cid:37)(cid:16)(cid:34)(cid:33,,23240.0
,,18,,,Unknown,,cid:12)(cid:29)(cid:26)(cid:41)(cid:25)(cid:2)(cid:58)(cid:58)(cid:37)(cid:16)(cid:34)(cid:33,,23258.0
,,2,,,Unknown,,cid:12)(cid:29)(cid:26)(cid:41)(cid:25)(cid:2)(cid:58)(cid:58)(cid:37)(cid:16)(cid:34)(cid:33,,23260.0
,,44,,,Unknown,,cid:12)(cid:29)(cid:26)(cid:41)(cid:25)(cid:2)(cid:58)(cid:58)(cid:37)(cid:16)(cid:34)(cid:33,,23304.0
,,12,,,Unknown,,cid:12)(cid:29)(cid:26)(cid:41)(cid:25)(cid:2)(cid:58)(cid:58)(cid:37)(cid:16)(cid:34)(cid:33,,23316.0
,,29,,,Unknown,,cid:12)(cid:29)(cid:26)(cid:41)(cid:25)(cid:2)(cid:58)(cid:58)(cid:37)(cid:16)(cid:34)(cid:33,,23345.0
,,26,,,Unknown,,cid:12)(cid:29)(cid:26)(cid:41)(cid:25)(cid:2)(cid:58)(cid:58)(cid:37)(cid:16)(cid:34)(cid:33,,23371.0
,,41,,,Unknown,,cid:12)(cid:29)(cid:26)(cid:41)(cid:25)(cid:2)(cid:58)(cid:58)(cid:37)(cid:16)(cid:34)(cid:33,,23412.0
,,25,,,Unknown,,cid:12)(cid:29)(cid:26)(cid:41)(cid:25)(cid:2)(cid:58)(cid:58)(cid:37)(cid:16)(cid:34)(cid:33,,23437.0
,,2,,,Unknown,,cid:12)(cid:29)(cid:26)(cid:41)(cid:25)(cid:2)(cid:58)(cid:58)(cid:37)(cid:16)(cid:34)(cid:33,,23439.0
,,58,,,Unknown,,cid:12)(cid:29)(cid:26)(cid:41)(cid:25)(cid:2)(cid:58)(cid:58)(cid:37)(cid:16)(cid:34)(cid:33,,23497.0
,,58,,,Unknown,,cid:12)(cid:29)(cid:26)(cid:41)(cid:25)(cid:2)(cid:58)(cid:58)(cid:37)(cid:16)(cid:34)(cid:33,,23555.0
,,37,,,Unknown,,cid:12)(cid:29)(cid:26)(cid:41)(cid:25)(cid:2)(cid:58)(cid:58)(cid:37)(cid:16)(cid:34)(cid:33,,23592.0
,,16,,,Unknown,,cid:12)(cid:29)(cid:26)(cid:41)(cid:25)(cid:2)(cid:58)(cid:58)(cid:37)(cid:16)(cid:34)(cid:33,,23608.0
,,34,,,Unknown,,cid:12)(cid:29)(cid:26)(cid:41)(cid:25)(cid:2)(cid:58)(cid:58)(cid:37)(cid:16)(cid:34)(cid:33,,23642.0
,,33,,,Unknown,,cid:12)(cid:29)(cid:26)(cid:41)(cid:25)(cid:2)(cid:58)(cid:58)(cid:37)(cid:16)(cid:34)(cid:33,,23675.0
,,1,,,Unknown,,cid:12)(cid:29)(cid:26)(cid:41)(cid:25)(cid:2)(cid:58)(cid:58)(cid:37)(cid:16)(cid:34)(cid:33,,23676.0
,,16,,,Unknown,,cid:12)(cid:29)(cid:26)(cid:41)(cid:25)(cid:2)(cid:58)(cid:58)(cid:37)(cid:16)(cid:34)(cid:33,,23692.0
,,45,,,Unknown,,cid:12)(cid:29)(cid:26)(cid:41)(cid:25)(cid:2)(cid:58)(cid:58)(cid:37)(cid:16)(cid:34)(cid:33,,23737.0
,,18,,,Unknown,,cid:12)(cid:29)(cid:26)(cid:41)(cid:25)(cid:2)(cid:58)(cid:58)(cid:37)(cid:16)(cid:34)(cid:33,,23755.0
,,16,,,Unknown,,cid:12)(cid:29)(cid:26)(cid:41)(cid:25)(cid:2)(cid:58)(cid:58)(cid:37)(cid:16)(cid:34)(cid:33,,23771.0
,,65,,,Unknown,,cid:12)(cid:29)(cid:26)(cid:41)(cid:25)(cid:2)(cid:58)(cid:58)(cid:37)(cid:16)(cid:34)(cid:33,,23836.0
,,28,,,Unknown,,cid:12)(cid:29)(cid:26)(cid:41)(cid:25)(cid:2)(cid:58)(cid:58)(cid:37)(cid:16)(cid:34)(cid:33,,23864.0
,,12,,,Unknown,,cid:12)(cid:29)(cid:26)(cid:41)(cid:25)(cid:2)(cid:58)(cid:58)(cid:37)(cid:16)(cid:34)(cid:33,,23876.0
,,2,,,Unknown,,cid:12)(cid:29)(cid:26)(cid:41)(cid:25)(cid:2)(cid:58)(cid:58)(cid:37)(cid:16)(cid:34)(cid:33,,23878.0
,,48,,,Unknown,,cid:12)(cid:29)(cid:26)(cid:41)(cid:25)(cid:2)(cid:58)(cid:58)(cid:37)(cid:16)(cid:34)(cid:33,,23926.0
,,5,,,Unknown,,cid:12)(cid:29)(cid:26)(cid:41)(cid:25)(cid:2)(cid:58)(cid:58)(cid:37)(cid:16)(cid:34)(cid:33,,23931.0
,,46,,,Unknown,,cid:12)(cid:29)(cid:26)(cid:41)(cid:25)(cid:2)(cid:58)(cid:58)(cid:37)(cid:16)(cid:34)(cid:33,,23977.0
,,4,,,Unknown,,cid:12)(cid:29)(cid:26)(cid:41)(cid:25)(cid:2)(cid:58)(cid:58)(cid:37)(cid:16)(cid:34)(cid:33,,23981.0
,,40,,,Unknown,,cid:12)(cid:29)(cid:26)(cid:41)(cid:25)(cid:2)(cid:58)(cid:58)(cid:37)(cid:16)(cid:34)(cid:33,,24021.0
,,2,,,Unknown,,cid:12)(cid:29)(cid:26)(cid:41)(cid:25)(cid:2)(cid:58)(cid:58)(cid:37)(cid:16)(cid:34)(cid:33,,24023.0
,,48,,,Unknown,,cid:12)(cid:29)(cid:26)(cid:41)(cid:25)(cid:2)(cid:58)(cid:58)(cid:37)(cid:16)(cid:34)(cid:33,,24071.0
,,5,,,Unknown,,cid:12)(cid:29)(cid:26)(cid:41)(cid:25)(cid:2)(cid:58)(cid:58)(cid:37)(cid:16)(cid:34)(cid:33,,24076.0
,,46,,,Unknown,,cid:12)(cid:29)(cid:26)(cid:41)(cid:25)(cid:2)(cid:58)(cid:58)(cid:37)(cid:16)(cid:34)(cid:33,,24122.0
,,4,,,Unknown,,cid:12)(cid:29)(cid:26)(cid:41)(cid:25)(cid:2)(cid:58)(cid:58)(cid:37)(cid:16)(cid:34)(cid:33,,24126.0
,,40,,,Unknown,,cid:12)(cid:29)(cid:26)(cid:41)(cid:25)(cid:2)(cid:58)(cid:58)(cid:37)(cid:16)(cid:34)(cid:33,,24166.0
,,2,,,Unknown,,cid:12)(cid:29)(cid:26)(cid:41)(cid:25)(cid:2)(cid:58)(cid:58)(cid:37)(cid:16)(cid:34)(cid:33,,24168.0
,,28,,,Unknown,,cid:12)(cid:29)(cid:26)(cid:41)(cid:25)(cid:2)(cid:58)(cid:58)(cid:37)(cid:16)(cid:34)(cid:33,,24196.0
,,3,,,Unknown,,cid:12)(cid:29)(cid:26)(cid:41)(cid:25)(cid:2)(cid:58)(cid:58)(cid:37)(cid:16)(cid:34)(cid:33,,24199.0
,,15,,,Unknown,,cid:12)(cid:29)(cid:26)(cid:41)(cid:25)(cid:2)(cid:58)(cid:58)(cid:37)(cid:16)(cid:34)(cid:33,,24214.0
,,2,,,Unknown,,cid:12)(cid:29)(cid:26)(cid:41)(cid:25)(cid:2)(cid:58)(cid:58)(cid:37)(cid:16)(cid:34)(cid:33,,24216.0
,,17,,,Unknown,,cid:12)(cid:29)(cid:26)(cid:41)(cid:25)(cid:2)(cid:58)(cid:58)(cid:37)(cid:16)(cid:34)(cid:33,,24233.0
,,18,,,Unknown,,cid:12)(cid:29)(cid:26)(cid:41)(cid:25)(cid:2)(cid:58)(cid:58)(cid:37)(cid:16)(cid:34)(cid:33,,24251.0
,,33,,,Unknown,,cid:12)(cid:29)(cid:26)(cid:41)(cid:25)(cid:2)(cid:58)(cid:58)(cid:37)(cid:16)(cid:34)(cid:33,,24284.0
,,19,,,Unknown,,cid:12)(cid:29)(cid:26)(cid:41)(cid:25)(cid:2)(cid:58)(cid:58)(cid:37)(cid:16)(cid:34)(cid:33,,24303.0
,,32,,,Unknown,,cid:12)(cid:29)(cid:26)(cid:41)(cid:25)(cid:2)(cid:58)(cid:58)(cid:37)(cid:16)(cid:34)(cid:33,,24335.0
,,18,,,Unknown,,cid:12)(cid:29)(cid:26)(cid:41)(cid:25)(cid:2)(cid:58)(cid:58)(cid:37)(cid:16)(cid:34)(cid:33,,24353.0
,,2,,,Unknown,,cid:12)(cid:29)(cid:26)(cid:41)(cid:25)(cid:2)(cid:58)(cid:58)(cid:37)(cid:16)(cid:34)(cid:33,,24355.0
,,44,,,Unknown,,cid:12)(cid:29)(cid:26)(cid:41)(cid:25)(cid:2)(cid:58)(cid:58)(cid:37)(cid:16)(cid:34)(cid:33,,24399.0
,,12,,,Unknown,,cid:12)(cid:29)(cid:26)(cid:41)(cid:25)(cid:2)(cid:58)(cid:58)(cid:37)(cid:16)(cid:34)(cid:33,,24411.0
,,29,,,Unknown,,cid:12)(cid:29)(cid:26)(cid:41)(cid:25)(cid:2)(cid:58)(cid:58)(cid:37)(cid:16)(cid:34)(cid:33,,24440.0
,,26,,,Unknown,,cid:12)(cid:29)(cid:26)(cid:41)(cid:25)(cid:2)(cid:58)(cid:58)(cid:37)(cid:16)(cid:34)(cid:33,,24466.0
,,41,,,Unknown,,cid:12)(cid:29)(cid:26)(cid:41)(cid:25)(cid:2)(cid:58)(cid:58)(cid:37)(cid:16)(cid:34)(cid:33,,24507.0
,,25,,,Unknown,,cid:12)(cid:29)(cid:26)(cid:41)(cid:25)(cid:2)(cid:58)(cid:58)(cid:37)(cid:16)(cid:34)(cid:33,,24532.0
,,2,,,Unknown,,cid:12)(cid:29)(cid:26)(cid:41)(cid:25)(cid:2)(cid:58)(cid:58)(cid:37)(cid:16)(cid:34)(cid:33,,24534.0
,,58,,,Unknown,,cid:12)(cid:29)(cid:26)(cid:41)(cid:25)(cid:2)(cid:58)(cid:58)(cid:37)(cid:16)(cid:34)(cid:33,,24592.0
,,58,,,Unknown,,cid:12)(cid:29)(cid:26)(cid:41)(cid:25)(cid:2)(cid:58)(cid:58)(cid:37)(cid:16)(cid:34)(cid:33,,24650.0
,,37,,,Unknown,,cid:12)(cid:29)(cid:26)(cid:41)(cid:25)(cid:2)(cid:58)(cid:58)(cid:37)(cid:16)(cid:34)(cid:33,,24687.0
,,16,,,Unknown,,cid:12)(cid:29)(cid:26)(cid:41)(cid:25)(cid:2)(cid:58)(cid:58)(cid:37)(cid:16)(cid:34)(cid:33,,24703.0
,,34,,,Unknown,,cid:12)(cid:29)(cid:26)(cid:41)(cid:25)(cid:2)(cid:58)(cid:58)(cid:37)(cid:16)(cid:34)(cid:33,,24737.0
,,33,,,Unknown,,cid:12)(cid:29)(cid:26)(cid:41)(cid:25)(cid:2)(cid:58)(cid:58)(cid:37)(cid:16)(cid:34)(cid:33,,24770.0
,,1,,,Unknown,,cid:12)(cid:29)(cid:26)(cid:41)(cid:25)(cid:2)(cid:58)(cid:58)(cid:37)(cid:16)(cid:34)(cid:33,,24771.0
,,35,,,Unknown,,cid:12)(cid:29)(cid:26)(cid:41)(cid:25)(cid:2)(cid:58)(cid:58)(cid:37)(cid:16)(cid:34)(cid:33,,24806.0
,,45,,,Unknown,,cid:12)(cid:29)(cid:26)(cid:41)(cid:25)(cid:2)(cid:58)(cid:58)(cid:37)(cid:16)(cid:34)(cid:33,,24851.0
,,18,,,Unknown,,cid:12)(cid:29)(cid:26)(cid:41)(cid:25)(cid:2)(cid:58)(cid:58)(cid:37)(cid:16)(cid:34)(cid:33,,24869.0
,,16,,,Unknown,,cid:12)(cid:29)(cid:26)(cid:41)(cid:25)(cid:2)(cid:58)(cid:58)(cid:37)(cid:16)(cid:34)(cid:33,,24885.0
,,9,,,Unknown,,cid:12)(cid:29)(cid:26)(cid:41)(cid:25)(cid:2)(cid:58)(cid:58)(cid:37)(cid:16)(cid:34)(cid:33,,24894.0
,,46,,,Unknown,,cid:12)(cid:29)(cid:26)(cid:41)(cid:25)(cid:2)(cid:58)(cid:58)(cid:37)(cid:16)(cid:34)(cid:33,,24940.0
,,8,,,Unknown,,cid:12)(cid:29)(cid:26)(cid:41)(cid:25)(cid:2)(cid:58)(cid:58)(cid:37)(cid:16)(cid:34)(cid:33,,24948.0
,,5,,,Unknown,,cid:12)(cid:29)(cid:26)(cid:41)(cid:25)(cid:2)(cid:58)(cid:58)(cid:37)(cid:16)(cid:34)(cid:33,,24953.0
,,28,,,Unknown,,cid:12)(cid:29)(cid:26)(cid:41)(cid:25)(cid:2)(cid:58)(cid:58)(cid:37)(cid:16)(cid:34)(cid:33,,24981.0
,,2,,,Unknown,,cid:12)(cid:29)(cid:26)(cid:41)(cid:25)(cid:2)(cid:58)(cid:58)(cid:37)(cid:16)(cid:34)(cid:33,,24983.0
,,9,,,Unknown,,cid:12)(cid:29)(cid:26)(cid:41)(cid:25)(cid:2)(cid:58)(cid:58)(cid:37)(cid:16)(cid:34)(cid:33,,24992.0
,,5,,,Unknown,,cid:12)(cid:29)(cid:26)(cid:41)(cid:25)(cid:2)(cid:58)(cid:58)(cid:37)(cid:16)(cid:34)(cid:33,,24997.0
,,8,,,Unknown,,cid:12)(cid:29)(cid:26)(cid:41)(cid:25)(cid:2)(cid:58)(cid:58)(cid:37)(cid:16)(cid:34)(cid:33,,25005.0
,,14,,,Unknown,,cid:12)(cid:29)(cid:26)(cid:41)(cid:25)(cid:2)(cid:58)(cid:58)(cid:37)(cid:16)(cid:34)(cid:33,,25019.0
,,7,,,Unknown,,cid:12)(cid:29)(cid:26)(cid:41)(cid:25)(cid:2)(cid:58)(cid:58)(cid:37)(cid:16)(cid:34)(cid:33,,25026.0
,,9,,,Unknown,,cid:12)(cid:29)(cid:26)(cid:41)(cid:25)(cid:2)(cid:58)(cid:58)(cid:37)(cid:16)(cid:34)(cid:33,,25035.0
,,2,,,Unknown,,cid:12)(cid:29)(cid:26)(cid:41)(cid:25)(cid:2)(cid:58)(cid:58)(cid:37)(cid:16)(cid:34)(cid:33,,25037.0
,,28,,,Unknown,,cid:12)(cid:29)(cid:26)(cid:41)(cid:25)(cid:2)(cid:58)(cid:58)(cid:37)(cid:16)(cid:34)(cid:33,,25065.0
,,3,,,Unknown,,cid:12)(cid:29)(cid:26)(cid:41)(cid:25)(cid:2)(cid:58)(cid:58)(cid:37)(cid:16)(cid:34)(cid:33,,25068.0
,,15,,,Unknown,,cid:12)(cid:29)(cid:26)(cid:41)(cid:25)(cid:2)(cid:58)(cid:58)(cid:37)(cid:16)(cid:34)(cid:33,,25083.0
,,2,,,Unknown,,cid:12)(cid:29)(cid:26)(cid:41)(cid:25)(cid:2)(cid:58)(cid:58)(cid:37)(cid:16)(cid:34)(cid:33,,25085.0
,,1,,,Unknown,,cid:12)(cid:29)(cid:26)(cid:41)(cid:25)(cid:2)(cid:58)(cid:58)(cid:37)(cid:16)(cid:34)(cid:33,,25086.0
,,19,,,Unknown,,cid:12)(cid:29)(cid:26)(cid:41)(cid:25)(cid:2)(cid:58)(cid:58)(cid:37)(cid:16)(cid:34)(cid:33,,25105.0
,,37,,,Unknown,,cid:12)(cid:29)(cid:26)(cid:41)(cid:25)(cid:2)(cid:58)(cid:58)(cid:37)(cid:16)(cid:34)(cid:33,,25142.0
,,18,,,Unknown,,cid:12)(cid:29)(cid:26)(cid:41)(cid:25)(cid:2)(cid:58)(cid:58)(cid:37)(cid:16)(cid:34)(cid:33,,25160.0
,,2,,,Unknown,,cid:12)(cid:29)(cid:26)(cid:41)(cid:25)(cid:2)(cid:58)(cid:58)(cid:37)(cid:16)(cid:34)(cid:33,,25162.0
,,44,,,Unknown,,cid:12)(cid:29)(cid:26)(cid:41)(cid:25)(cid:2)(cid:58)(cid:58)(cid:37)(cid:16)(cid:34)(cid:33,,25206.0
,,12,,,Unknown,,cid:12)(cid:29)(cid:26)(cid:41)(cid:25)(cid:2)(cid:58)(cid:58)(cid:37)(cid:16)(cid:34)(cid:33,,25218.0
,,29,,,Unknown,,cid:12)(cid:29)(cid:26)(cid:41)(cid:25)(cid:2)(cid:58)(cid:58)(cid:37)(cid:16)(cid:34)(cid:33,,25247.0
,,26,,,Unknown,,cid:12)(cid:29)(cid:26)(cid:41)(cid:25)(cid:2)(cid:58)(cid:58)(cid:37)(cid:16)(cid:34)(cid:33,,25273.0
,,41,,,Unknown,,cid:12)(cid:29)(cid:26)(cid:41)(cid:25)(cid:2)(cid:58)(cid:58)(cid:37)(cid:16)(cid:34)(cid:33,,25314.0
,,25,,,Unknown,,cid:12)(cid:29)(cid:26)(cid:41)(cid:25)(cid:2)(cid:58)(cid:58)(cid:37)(cid:16)(cid:34)(cid:33,,25339.0
,,2,,,Unknown,,cid:12)(cid:29)(cid:26)(cid:41)(cid:25)(cid:2)(cid:58)(cid:58)(cid:37)(cid:16)(cid:34)(cid:33,,25341.0
,,58,,,Unknown,,cid:12)(cid:29)(cid:26)(cid:41)(cid:25)(cid:2)(cid:58)(cid:58)(cid:37)(cid:16)(cid:34)(cid:33,,25399.0
,,58,,,Unknown,,cid:12)(cid:29)(cid:26)(cid:41)(cid:25)(cid:2)(cid:58)(cid:58)(cid:37)(cid:16)(cid:34)(cid:33,,25457.0
,,37,,,Unknown,,cid:12)(cid:29)(cid:26)(cid:41)(cid:25)(cid:2)(cid:58)(cid:58)(cid:37)(cid:16)(cid:34)(cid:33,,25494.0
,,16,,,Unknown,,cid:12)(cid:29)(cid:26)(cid:41)(cid:25)(cid:2)(cid:58)(cid:58)(cid:37)(cid:16)(cid:34)(cid:33,,25510.0
,,34,,,Unknown,,cid:12)(cid:29)(cid:26)(cid:41)(cid:25)(cid:2)(cid:58)(cid:58)(cid:37)(cid:16)(cid:34)(cid:33,,25544.0
,,33,,,Unknown,,cid:12)(cid:29)(cid:26)(cid:41)(cid:25)(cid:2)(cid:58)(cid:58)(cid:37)(cid:16)(cid:34)(cid:33,,25577.0
,,1,,,Unknown,,cid:12)(cid:29)(cid:26)(cid:41)(cid:25)(cid:2)(cid:58)(cid:58)(cid:37)(cid:16)(cid:34)(cid:33,,25578.0
,,35,,,Unknown,,cid:12)(cid:29)(cid:26)(cid:41)(cid:25)(cid:2)(cid:58)(cid:58)(cid:37)(cid:16)(cid:34)(cid:33,,25613.0
,,45,,,Unknown,,cid:12)(cid:29)(cid:26)(cid:41)(cid:25)(cid:2)(cid:58)(cid:58)(cid:37)(cid:16)(cid:34)(cid:33,,25658.0
,,18,,,Unknown,,cid:12)(cid:29)(cid:26)(cid:41)(cid:25)(cid:2)(cid:58)(cid:58)(cid:37)(cid:16)(cid:34)(cid:33,,25676.0
,,16,,,Unknown,,cid:12)(cid:29)(cid:26)(cid:41)(cid:25)(cid:2)(cid:58)(cid:58)(cid:37)(cid:16)(cid:34)(cid:33,,25692.0
,,9,,,Unknown,,cid:12)(cid:29)(cid:26)(cid:41)(cid:25)(cid:2)(cid:58)(cid:58)(cid:37)(cid:16)(cid:34)(cid:33,,25701.0
,,46,,,Unknown,,cid:12)(cid:29)(cid:26)(cid:41)(cid:25)(cid:2)(cid:58)(cid:58)(cid:37)(cid:16)(cid:34)(cid:33,,25747.0
,,8,,,Unknown,,cid:12)(cid:29)(cid:26)(cid:41)(cid:25)(cid:2)(cid:58)(cid:58)(cid:37)(cid:16)(cid:34)(cid:33,,25755.0
,,5,,,Unknown,,cid:12)(cid:29)(cid:26)(cid:41)(cid:25)(cid:2)(cid:58)(cid:58)(cid:37)(cid:16)(cid:34)(cid:33,,25760.0
,,28,,,Unknown,,cid:12)(cid:29)(cid:26)(cid:41)(cid:25)(cid:2)(cid:58)(cid:58)(cid:37)(cid:16)(cid:34)(cid:33,,25788.0
,,2,,,Unknown,,cid:12)(cid:29)(cid:26)(cid:41)(cid:25)(cid:2)(cid:58)(cid:58)(cid:37)(cid:16)(cid:34)(cid:33,,25790.0
,,9,,,Unknown,,cid:12)(cid:29)(cid:26)(cid:41)(cid:25)(cid:2)(cid:58)(cid:58)(cid:37)(cid:16)(cid:34)(cid:33,,25799.0
,,5,,,Unknown,,cid:12)(cid:29)(cid:26)(cid:41)(cid:25)(cid:2)(cid:58)(cid:58)(cid:37)(cid:16)(cid:34)(cid:33,,25804.0
,,8,,,Unknown,,cid:12)(cid:29)(cid:26)(cid:41)(cid:25)(cid:2)(cid:58)(cid:58)(cid:37)(cid:16)(cid:34)(cid:33,,25812.0
,,14,,,Unknown,,cid:12)(cid:29)(cid:26)(cid:41)(cid:25)(cid:2)(cid:58)(cid:58)(cid:37)(cid:16)(cid:34)(cid:33,,25826.0
,,7,,,Unknown,,cid:12)(cid:29)(cid:26)(cid:41)(cid:25)(cid:2)(cid:58)(cid:58)(cid:37)(cid:16)(cid:34)(cid:33,,25833.0
,,9,,,Unknown,,cid:12)(cid:29)(cid:26)(cid:41)(cid:25)(cid:2)(cid:58)(cid:58)(cid:37)(cid:16)(cid:34)(cid:33,,25842.0
,,2,,,Unknown,,cid:12)(cid:29)(cid:26)(cid:41)(cid:25)(cid:2)(cid:58)(cid:58)(cid:37)(cid:16)(cid:34)(cid:33,,25844.0
,,28,,,Unknown,,cid:12)(cid:29)(cid:26)(cid:41)(cid:25)(cid:2)(cid:58)(cid:58)(cid:37)(cid:16)(cid:34)(cid:33,,25872.0
,,3,,,Unknown,,cid:12)(cid:29)(cid:26)(cid:41)(cid:25)(cid:2)(cid:58)(cid:58)(cid:37)(cid:16)(cid:34)(cid:33,,25875.0
,,15,,,Unknown,,cid:12)(cid:29)(cid:26)(cid:41)(cid:25)(cid:2)(cid:58)(cid:58)(cid:37)(cid:16)(cid:34)(cid:33,,25890.0
,,2,,,Unknown,,cid:12)(cid:29)(cid:26)(cid:41)(cid:25)(cid:2)(cid:58)(cid:58)(cid:37)(cid:16)(cid:34)(cid:33,,25892.0
,,1,,,Unknown,,cid:12)(cid:29)(cid:26)(cid:41)(cid:25)(cid:2)(cid:58)(cid:58)(cid:37)(cid:16)(cid:34)(cid:33,,25893.0
,,19,,,Unknown,,cid:12)(cid:29)(cid:26)(cid:41)(cid:25)(cid:2)(cid:58)(cid:58)(cid:37)(cid:16)(cid:34)(cid:33,,25912.0
,,37,,,Unknown,,cid:12)(cid:29)(cid:26)(cid:41)(cid:25)(cid:2)(cid:58)(cid:58)(cid:37)(cid:16)(cid:34)(cid:33,,25949.0
,,18,,,Unknown,,cid:12)(cid:29)(cid:26)(cid:41)(cid:25)(cid:2)(cid:58)(cid:58)(cid:37)(cid:16)(cid:34)(cid:33,,25967.0
,,2,,,Unknown,,cid:12)(cid:29)(cid:26)(cid:41)(cid:25)(cid:2)(cid:58)(cid:58)(cid:37)(cid:16)(cid:34)(cid:33,,25969.0
,,44,,,Unknown,,cid:12)(cid:29)(cid:26)(cid:41)(cid:25)(cid:2)(cid:58)(cid:58)(cid:37)(cid:16)(cid:34)(cid:33,,26013.0
,,12,,,Unknown,,cid:12)(cid:29)(cid:26)(cid:41)(cid:25)(cid:2)(cid:58)(cid:58)(cid:37)(cid:16)(cid:34)(cid:33,,26025.0
,,29,,,Unknown,,cid:12)(cid:29)(cid:26)(cid:41)(cid:25)(cid:2)(cid:58)(cid:58)(cid:37)(cid:16)(cid:34)(cid:33,,26054.0
,,26,,,Unknown,,cid:12)(cid:29)(cid:26)(cid:41)(cid:25)(cid:2)(cid:58)(cid:58)(cid:37)(cid:16)(cid:34)(cid:33,,26080.0
,,41,,,Unknown,,cid:12)(cid:29)(cid:26)(cid:41)(cid:25)(cid:2)(cid:58)(cid:58)(cid:37)(cid:16)(cid:34)(cid:33,,26121.0
,,25,,,Unknown,,cid:12)(cid:29)(cid:26)(cid:41)(cid:25)(cid:2)(cid:58)(cid:58)(cid:37)(cid:16)(cid:34)(cid:33,,26146.0
,,2,,,Unknown,,cid:12)(cid:29)(cid:26)(cid:41)(cid:25)(cid:2)(cid:58)(cid:58)(cid:37)(cid:16)(cid:34)(cid:33,,26148.0
,,58,,,Unknown,,cid:12)(cid:29)(cid:26)(cid:41)(cid:25)(cid:2)(cid:58)(cid:58)(cid:37)(cid:16)(cid:34)(cid:33,,26206.0
,,58,,,Unknown,,cid:12)(cid:29)(cid:26)(cid:41)(cid:25)(cid:2)(cid:58)(cid:58)(cid:37)(cid:16)(cid:34)(cid:33,,26264.0
,,37,,,Unknown,,cid:12)(cid:29)(cid:26)(cid:41)(cid:25)(cid:2)(cid:58)(cid:58)(cid:37)(cid:16)(cid:34)(cid:33,,26301.0
,,16,,,Unknown,,cid:12)(cid:29)(cid:26)(cid:41)(cid:25)(cid:2)(cid:58)(cid:58)(cid:37)(cid:16)(cid:34)(cid:33,,26317.0
,,34,,,Unknown,,cid:12)(cid:29)(cid:26)(cid:41)(cid:25)(cid:2)(cid:58)(cid:58)(cid:37)(cid:16)(cid:34)(cid:33,,26351.0
,,33,,,Unknown,,cid:12)(cid:29)(cid:26)(cid:41)(cid:25)(cid:2)(cid:58)(cid:58)(cid:37)(cid:16)(cid:34)(cid:33,,26384.0
,,1,,,Unknown,,cid:50)(cid:5)(cid:14)(cid:7)(cid:12)(cid:5)(cid:9)(cid:2)(cid:16)(cid:16)(cid:2)(cid:12)(cid:11)(cid:4)(cid:14)(cid:11)(cid:48)(cid:48)(cid:7)(cid:5)(cid:3)(cid:9)(cid:2)(cid:28)(cid:3,,1.0
,,33,,,Unknown,,cid:50)(cid:5)(cid:14)(cid:7)(cid:12)(cid:5)(cid:9)(cid:2)(cid:16)(cid:16)(cid:2)(cid:12)(cid:11)(cid:4)(cid:14)(cid:11)(cid:48)(cid:48)(cid:7)(cid:5)(cid:3)(cid:9)(cid:2)(cid:28)(cid:3,,34.0
,,45,,,Unknown,,cid:50)(cid:5)(cid:14)(cid:7)(cid:12)(cid:5)(cid:9)(cid:2)(cid:16)(cid:16)(cid:2)(cid:12)(cid:11)(cid:4)(cid:14)(cid:11)(cid:48)(cid:48)(cid:7)(cid:5)(cid:3)(cid:9)(cid:2)(cid:28)(cid:3,,79.0
,,18,,,Unknown,,cid:50)(cid:5)(cid:14)(cid:7)(cid:12)(cid:5)(cid:9)(cid:2)(cid:16)(cid:16)(cid:2)(cid:12)(cid:11)(cid:4)(cid:14)(cid:11)(cid:48)(cid:48)(cid:7)(cid:5)(cid:3)(cid:9)(cid:2)(cid:28)(cid:3,,97.0
,,16,,,Unknown,,cid:50)(cid:5)(cid:14)(cid:7)(cid:12)(cid:5)(cid:9)(cid:2)(cid:16)(cid:16)(cid:2)(cid:12)(cid:11)(cid:4)(cid:14)(cid:11)(cid:48)(cid:48)(cid:7)(cid:5)(cid:3)(cid:9)(cid:2)(cid:28)(cid:3,,113.0
,,50,,,Unknown,,cid:50)(cid:5)(cid:14)(cid:7)(cid:12)(cid:5)(cid:9)(cid:2)(cid:16)(cid:16)(cid:2)(cid:12)(cid:11)(cid:4)(cid:14)(cid:11)(cid:48)(cid:48)(cid:7)(cid:5)(cid:3)(cid:9)(cid:2)(cid:28)(cid:3,,163.0
,,5,,,Unknown,,cid:50)(cid:5)(cid:14)(cid:7)(cid:12)(cid:5)(cid:9)(cid:2)(cid:16)(cid:16)(cid:2)(cid:12)(cid:11)(cid:4)(cid:14)(cid:11)(cid:48)(cid:48)(cid:7)(cid:5)(cid:3)(cid:9)(cid:2)(cid:28)(cid:3,,168.0
,,14,,,Unknown,,cid:50)(cid:5)(cid:14)(cid:7)(cid:12)(cid:5)(cid:9)(cid:2)(cid:16)(cid:16)(cid:2)(cid:12)(cid:11)(cid:4)(cid:14)(cid:11)(cid:48)(cid:48)(cid:7)(cid:5)(cid:3)(cid:9)(cid:2)(cid:28)(cid:3,,182.0
,,7,,,Unknown,,cid:50)(cid:5)(cid:14)(cid:7)(cid:12)(cid:5)(cid:9)(cid:2)(cid:16)(cid:16)(cid:2)(cid:12)(cid:11)(cid:4)(cid:14)(cid:11)(cid:48)(cid:48)(cid:7)(cid:5)(cid:3)(cid:9)(cid:2)(cid:28)(cid:3,,189.0
,,12,,,Unknown,,cid:50)(cid:5)(cid:14)(cid:7)(cid:12)(cid:5)(cid:9)(cid:2)(cid:16)(cid:16)(cid:2)(cid:12)(cid:11)(cid:4)(cid:14)(cid:11)(cid:48)(cid:48)(cid:7)(cid:5)(cid:3)(cid:9)(cid:2)(cid:28)(cid:3,,201.0
,,5,,,Unknown,,cid:50)(cid:5)(cid:14)(cid:7)(cid:12)(cid:5)(cid:9)(cid:2)(cid:16)(cid:16)(cid:2)(cid:12)(cid:11)(cid:4)(cid:14)(cid:11)(cid:48)(cid:48)(cid:7)(cid:5)(cid:3)(cid:9)(cid:2)(cid:28)(cid:3,,206.0
,,9,,,Unknown,,cid:50)(cid:5)(cid:14)(cid:7)(cid:12)(cid:5)(cid:9)(cid:2)(cid:16)(cid:16)(cid:2)(cid:12)(cid:11)(cid:4)(cid:14)(cid:11)(cid:48)(cid:48)(cid:7)(cid:5)(cid:3)(cid:9)(cid:2)(cid:28)(cid:3,,215.0
,,2,,,Unknown,,cid:50)(cid:5)(cid:14)(cid:7)(cid:12)(cid:5)(cid:9)(cid:2)(cid:16)(cid:16)(cid:2)(cid:12)(cid:11)(cid:4)(cid:14)(cid:11)(cid:48)(cid:48)(cid:7)(cid:5)(cid:3)(cid:9)(cid:2)(cid:28)(cid:3,,217.0
,,16,,,Unknown,,cid:50)(cid:5)(cid:14)(cid:7)(cid:12)(cid:5)(cid:9)(cid:2)(cid:16)(cid:16)(cid:2)(cid:12)(cid:11)(cid:4)(cid:14)(cid:11)(cid:48)(cid:48)(cid:7)(cid:5)(cid:3)(cid:9)(cid:2)(cid:28)(cid:3,,233.0
,,16,,,Unknown,,cid:50)(cid:5)(cid:14)(cid:7)(cid:12)(cid:5)(cid:9)(cid:2)(cid:16)(cid:16)(cid:2)(cid:12)(cid:11)(cid:4)(cid:14)(cid:11)(cid:48)(cid:48)(cid:7)(cid:5)(cid:3)(cid:9)(cid:2)(cid:28)(cid:3,,249.0
,,2,,,Unknown,,cid:50)(cid:5)(cid:14)(cid:7)(cid:12)(cid:5)(cid:9)(cid:2)(cid:16)(cid:16)(cid:2)(cid:12)(cid:11)(cid:4)(cid:14)(cid:11)(cid:48)(cid:48)(cid:7)(cid:5)(cid:3)(cid:9)(cid:2)(cid:28)(cid:3,,251.0
,,12,,,Unknown,,cid:50)(cid:5)(cid:14)(cid:7)(cid:12)(cid:5)(cid:9)(cid:2)(cid:16)(cid:16)(cid:2)(cid:12)(cid:11)(cid:4)(cid:14)(cid:11)(cid:48)(cid:48)(cid:7)(cid:5)(cid:3)(cid:9)(cid:2)(cid:28)(cid:3,,263.0
,,11,,,Unknown,,cid:50)(cid:5)(cid:14)(cid:7)(cid:12)(cid:5)(cid:9)(cid:2)(cid:16)(cid:16)(cid:2)(cid:12)(cid:11)(cid:4)(cid:14)(cid:11)(cid:48)(cid:48)(cid:7)(cid:5)(cid:3)(cid:9)(cid:2)(cid:28)(cid:3,,274.0
,,4,,,Unknown,,cid:50)(cid:5)(cid:14)(cid:7)(cid:12)(cid:5)(cid:9)(cid:2)(cid:16)(cid:16)(cid:2)(cid:12)(cid:11)(cid:4)(cid:14)(cid:11)(cid:48)(cid:48)(cid:7)(cid:5)(cid:3)(cid:9)(cid:2)(cid:28)(cid:3,,278.0
,,14,,,Unknown,,cid:50)(cid:5)(cid:14)(cid:7)(cid:12)(cid:5)(cid:9)(cid:2)(cid:16)(cid:16)(cid:2)(cid:12)(cid:11)(cid:4)(cid:14)(cid:11)(cid:48)(cid:48)(cid:7)(cid:5)(cid:3)(cid:9)(cid:2)(cid:28)(cid:3,,292.0
,,11,,,Unknown,,cid:50)(cid:5)(cid:14)(cid:7)(cid:12)(cid:5)(cid:9)(cid:2)(cid:16)(cid:16)(cid:2)(cid:12)(cid:11)(cid:4)(cid:14)(cid:11)(cid:48)(cid:48)(cid:7)(cid:5)(cid:3)(cid:9)(cid:2)(cid:28)(cid:3,,303.0
,,48,,,Unknown,,cid:50)(cid:5)(cid:14)(cid:7)(cid:12)(cid:5)(cid:9)(cid:2)(cid:16)(cid:16)(cid:2)(cid:12)(cid:11)(cid:4)(cid:14)(cid:11)(cid:48)(cid:48)(cid:7)(cid:5)(cid:3)(cid:9)(cid:2)(cid:28)(cid:3,,351.0
,,48,,,Unknown,,cid:50)(cid:5)(cid:14)(cid:7)(cid:12)(cid:5)(cid:9)(cid:2)(cid:16)(cid:16)(cid:2)(cid:12)(cid:11)(cid:4)(cid:14)(cid:11)(cid:48)(cid:48)(cid:7)(cid:5)(cid:3)(cid:9)(cid:2)(cid:28)(cid:3,,399.0
,,7,,,Unknown,,cid:50)(cid:5)(cid:14)(cid:7)(cid:12)(cid:5)(cid:9)(cid:2)(cid:16)(cid:16)(cid:2)(cid:12)(cid:11)(cid:4)(cid:14)(cid:11)(cid:48)(cid:48)(cid:7)(cid:5)(cid:3)(cid:9)(cid:2)(cid:28)(cid:3,,406.0
,,5,,,Unknown,,cid:50)(cid:5)(cid:14)(cid:7)(cid:12)(cid:5)(cid:9)(cid:2)(cid:16)(cid:16)(cid:2)(cid:12)(cid:11)(cid:4)(cid:14)(cid:11)(cid:48)(cid:48)(cid:7)(cid:5)(cid:3)(cid:9)(cid:2)(cid:28)(cid:3,,411.0
,,3,,,Unknown,,cid:50)(cid:5)(cid:14)(cid:7)(cid:12)(cid:5)(cid:9)(cid:2)(cid:16)(cid:16)(cid:2)(cid:12)(cid:11)(cid:4)(cid:14)(cid:11)(cid:48)(cid:48)(cid:7)(cid:5)(cid:3)(cid:9)(cid:2)(cid:28)(cid:3,,414.0
,,9,,,Unknown,,cid:50)(cid:5)(cid:14)(cid:7)(cid:12)(cid:5)(cid:9)(cid:2)(cid:16)(cid:16)(cid:2)(cid:12)(cid:11)(cid:4)(cid:14)(cid:11)(cid:48)(cid:48)(cid:7)(cid:5)(cid:3)(cid:9)(cid:2)(cid:28)(cid:3,,423.0
,,2,,,Unknown,,cid:50)(cid:5)(cid:14)(cid:7)(cid:12)(cid:5)(cid:9)(cid:2)(cid:16)(cid:16)(cid:2)(cid:12)(cid:11)(cid:4)(cid:14)(cid:11)(cid:48)(cid:48)(cid:7)(cid:5)(cid:3)(cid:9)(cid:2)(cid:28)(cid:3,,425.0
,,28,,,Unknown,,cid:50)(cid:5)(cid:14)(cid:7)(cid:12)(cid:5)(cid:9)(cid:2)(cid:16)(cid:16)(cid:2)(cid:12)(cid:11)(cid:4)(cid:14)(cid:11)(cid:48)(cid:48)(cid:7)(cid:5)(cid:3)(cid:9)(cid:2)(cid:28)(cid:3,,453.0
,,3,,,Unknown,,cid:50)(cid:5)(cid:14)(cid:7)(cid:12)(cid:5)(cid:9)(cid:2)(cid:16)(cid:16)(cid:2)(cid:12)(cid:11)(cid:4)(cid:14)(cid:11)(cid:48)(cid:48)(cid:7)(cid:5)(cid:3)(cid:9)(cid:2)(cid:28)(cid:3,,456.0
,,15,,,Unknown,,cid:50)(cid:5)(cid:14)(cid:7)(cid:12)(cid:5)(cid:9)(cid:2)(cid:16)(cid:16)(cid:2)(cid:12)(cid:11)(cid:4)(cid:14)(cid:11)(cid:48)(cid:48)(cid:7)(cid:5)(cid:3)(cid:9)(cid:2)(cid:28)(cid:3,,471.0
,,2,,,Unknown,,cid:50)(cid:5)(cid:14)(cid:7)(cid:12)(cid:5)(cid:9)(cid:2)(cid:16)(cid:16)(cid:2)(cid:12)(cid:11)(cid:4)(cid:14)(cid:11)(cid:48)(cid:48)(cid:7)(cid:5)(cid:3)(cid:9)(cid:2)(cid:28)(cid:3,,473.0
,,17,,,Unknown,,cid:50)(cid:5)(cid:14)(cid:7)(cid:12)(cid:5)(cid:9)(cid:2)(cid:16)(cid:16)(cid:2)(cid:12)(cid:11)(cid:4)(cid:14)(cid:11)(cid:48)(cid:48)(cid:7)(cid:5)(cid:3)(cid:9)(cid:2)(cid:28)(cid:3,,490.0
,,17,,,Unknown,,cid:50)(cid:5)(cid:14)(cid:7)(cid:12)(cid:5)(cid:9)(cid:2)(cid:16)(cid:16)(cid:2)(cid:12)(cid:11)(cid:4)(cid:14)(cid:11)(cid:48)(cid:48)(cid:7)(cid:5)(cid:3)(cid:9)(cid:2)(cid:28)(cid:3,,507.0
,,19,,,Unknown,,cid:50)(cid:5)(cid:14)(cid:7)(cid:12)(cid:5)(cid:9)(cid:2)(cid:16)(cid:16)(cid:2)(cid:12)(cid:11)(cid:4)(cid:14)(cid:11)(cid:48)(cid:48)(cid:7)(cid:5)(cid:3)(cid:9)(cid:2)(cid:28)(cid:3,,526.0
,,34,,,Unknown,,cid:50)(cid:5)(cid:14)(cid:7)(cid:12)(cid:5)(cid:9)(cid:2)(cid:16)(cid:16)(cid:2)(cid:12)(cid:11)(cid:4)(cid:14)(cid:11)(cid:48)(cid:48)(cid:7)(cid:5)(cid:3)(cid:9)(cid:2)(cid:28)(cid:3,,560.0
,,18,,,Unknown,,cid:50)(cid:5)(cid:14)(cid:7)(cid:12)(cid:5)(cid:9)(cid:2)(cid:16)(cid:16)(cid:2)(cid:12)(cid:11)(cid:4)(cid:14)(cid:11)(cid:48)(cid:48)(cid:7)(cid:5)(cid:3)(cid:9)(cid:2)(cid:28)(cid:3,,578.0
,,2,,,Unknown,,cid:50)(cid:5)(cid:14)(cid:7)(cid:12)(cid:5)(cid:9)(cid:2)(cid:16)(cid:16)(cid:2)(cid:12)(cid:11)(cid:4)(cid:14)(cid:11)(cid:48)(cid:48)(cid:7)(cid:5)(cid:3)(cid:9)(cid:2)(cid:28)(cid:3,,580.0
,,44,,,Unknown,,cid:50)(cid:5)(cid:14)(cid:7)(cid:12)(cid:5)(cid:9)(cid:2)(cid:16)(cid:16)(cid:2)(cid:12)(cid:11)(cid:4)(cid:14)(cid:11)(cid:48)(cid:48)(cid:7)(cid:5)(cid:3)(cid:9)(cid:2)(cid:28)(cid:3,,624.0
,,12,,,Unknown,,cid:50)(cid:5)(cid:14)(cid:7)(cid:12)(cid:5)(cid:9)(cid:2)(cid:16)(cid:16)(cid:2)(cid:12)(cid:11)(cid:4)(cid:14)(cid:11)(cid:48)(cid:48)(cid:7)(cid:5)(cid:3)(cid:9)(cid:2)(cid:28)(cid:3,,636.0
,,29,,,Unknown,,cid:50)(cid:5)(cid:14)(cid:7)(cid:12)(cid:5)(cid:9)(cid:2)(cid:16)(cid:16)(cid:2)(cid:12)(cid:11)(cid:4)(cid:14)(cid:11)(cid:48)(cid:48)(cid:7)(cid:5)(cid:3)(cid:9)(cid:2)(cid:28)(cid:3,,665.0
,,26,,,Unknown,,cid:50)(cid:5)(cid:14)(cid:7)(cid:12)(cid:5)(cid:9)(cid:2)(cid:16)(cid:16)(cid:2)(cid:12)(cid:11)(cid:4)(cid:14)(cid:11)(cid:48)(cid:48)(cid:7)(cid:5)(cid:3)(cid:9)(cid:2)(cid:28)(cid:3,,691.0
,,41,,,Unknown,,cid:50)(cid:5)(cid:14)(cid:7)(cid:12)(cid:5)(cid:9)(cid:2)(cid:16)(cid:16)(cid:2)(cid:12)(cid:11)(cid:4)(cid:14)(cid:11)(cid:48)(cid:48)(cid:7)(cid:5)(cid:3)(cid:9)(cid:2)(cid:28)(cid:3,,732.0
,,25,,,Unknown,,cid:50)(cid:5)(cid:14)(cid:7)(cid:12)(cid:5)(cid:9)(cid:2)(cid:16)(cid:16)(cid:2)(cid:12)(cid:11)(cid:4)(cid:14)(cid:11)(cid:48)(cid:48)(cid:7)(cid:5)(cid:3)(cid:9)(cid:2)(cid:28)(cid:3,,757.0
,,2,,,Unknown,,cid:50)(cid:5)(cid:14)(cid:7)(cid:12)(cid:5)(cid:9)(cid:2)(cid:16)(cid:16)(cid:2)(cid:12)(cid:11)(cid:4)(cid:14)(cid:11)(cid:48)(cid:48)(cid:7)(cid:5)(cid:3)(cid:9)(cid:2)(cid:28)(cid:3,,759.0
,,58,,,Unknown,,cid:50)(cid:5)(cid:14)(cid:7)(cid:12)(cid:5)(cid:9)(cid:2)(cid:16)(cid:16)(cid:2)(cid:12)(cid:11)(cid:4)(cid:14)(cid:11)(cid:48)(cid:48)(cid:7)(cid:5)(cid:3)(cid:9)(cid:2)(cid:28)(cid:3,,817.0
,,58,,,Unknown,,cid:50)(cid:5)(cid:14)(cid:7)(cid:12)(cid:5)(cid:9)(cid:2)(cid:16)(cid:16)(cid:2)(cid:12)(cid:11)(cid:4)(cid:14)(cid:11)(cid:48)(cid:48)(cid:7)(cid:5)(cid:3)(cid:9)(cid:2)(cid:28)(cid:3,,875.0
,,18,,,Unknown,,cid:50)(cid:5)(cid:14)(cid:7)(cid:12)(cid:5)(cid:9)(cid:2)(cid:16)(cid:16)(cid:2)(cid:12)(cid:11)(cid:4)(cid:14)(cid:11)(cid:48)(cid:48)(cid:7)(cid:5)(cid:3)(cid:9)(cid:2)(cid:28)(cid:3,,893.0
,,1,,,Unknown,,cid:50)(cid:5)(cid:14)(cid:7)(cid:12)(cid:5)(cid:9)(cid:2)(cid:16)(cid:16)(cid:2)(cid:12)(cid:11)(cid:4)(cid:14)(cid:11)(cid:48)(cid:48)(cid:7)(cid:5)(cid:3)(cid:9)(cid:2)(cid:28)(cid:3,,894.0
,,1,,,Unknown,,cid:50)(cid:5)(cid:14)(cid:7)(cid:12)(cid:5)(cid:9)(cid:2)(cid:16)(cid:16)(cid:2)(cid:12)(cid:11)(cid:4)(cid:14)(cid:11)(cid:48)(cid:48)(cid:7)(cid:5)(cid:3)(cid:9)(cid:2)(cid:28)(cid:3,,895.0
,,37,,,Unknown,,cid:50)(cid:5)(cid:14)(cid:7)(cid:12)(cid:5)(cid:9)(cid:2)(cid:16)(cid:16)(cid:2)(cid:12)(cid:11)(cid:4)(cid:14)(cid:11)(cid:48)(cid:48)(cid:7)(cid:5)(cid:3)(cid:9)(cid:2)(cid:28)(cid:3,,932.0
,,37,,,Unknown,,cid:50)(cid:5)(cid:14)(cid:7)(cid:12)(cid:5)(cid:9)(cid:2)(cid:16)(cid:16)(cid:2)(cid:12)(cid:11)(cid:4)(cid:14)(cid:11)(cid:48)(cid:48)(cid:7)(cid:5)(cid:3)(cid:9)(cid:2)(cid:28)(cid:3,,969.0
,,18,,,Unknown,,cid:50)(cid:5)(cid:14)(cid:7)(cid:12)(cid:5)(cid:9)(cid:2)(cid:16)(cid:16)(cid:2)(cid:12)(cid:11)(cid:4)(cid:14)(cid:11)(cid:48)(cid:48)(cid:7)(cid:5)(cid:3)(cid:9)(cid:2)(cid:28)(cid:3,,987.0
,,45,,,Unknown,,cid:50)(cid:5)(cid:14)(cid:7)(cid:12)(cid:5)(cid:9)(cid:2)(cid:16)(cid:16)(cid:2)(cid:12)(cid:11)(cid:4)(cid:14)(cid:11)(cid:48)(cid:48)(cid:7)(cid:5)(cid:3)(cid:9)(cid:2)(cid:28)(cid:3,,1032.0
,,18,,,Unknown,,cid:50)(cid:5)(cid:14)(cid:7)(cid:12)(cid:5)(cid:9)(cid:2)(cid:16)(cid:16)(cid:2)(cid:12)(cid:11)(cid:4)(cid:14)(cid:11)(cid:48)(cid:48)(cid:7)(cid:5)(cid:3)(cid:9)(cid:2)(cid:28)(cid:3,,1050.0
,,16,,,Unknown,,cid:50)(cid:5)(cid:14)(cid:7)(cid:12)(cid:5)(cid:9)(cid:2)(cid:16)(cid:16)(cid:2)(cid:12)(cid:11)(cid:4)(cid:14)(cid:11)(cid:48)(cid:48)(cid:7)(cid:5)(cid:3)(cid:9)(cid:2)(cid:28)(cid:3,,1066.0
,,12,,,Unknown,,cid:50)(cid:5)(cid:14)(cid:7)(cid:12)(cid:5)(cid:9)(cid:2)(cid:16)(cid:16)(cid:2)(cid:12)(cid:11)(cid:4)(cid:14)(cid:11)(cid:48)(cid:48)(cid:7)(cid:5)(cid:3)(cid:9)(cid:2)(cid:28)(cid:3,,1078.0
,,46,,,Unknown,,cid:50)(cid:5)(cid:14)(cid:7)(cid:12)(cid:5)(cid:9)(cid:2)(cid:16)(cid:16)(cid:2)(cid:12)(cid:11)(cid:4)(cid:14)(cid:11)(cid:48)(cid:48)(cid:7)(cid:5)(cid:3)(cid:9)(cid:2)(cid:28)(cid:3,,1124.0
,,3,,,Unknown,,cid:50)(cid:5)(cid:14)(cid:7)(cid:12)(cid:5)(cid:9)(cid:2)(cid:16)(cid:16)(cid:2)(cid:12)(cid:11)(cid:4)(cid:14)(cid:11)(cid:48)(cid:48)(cid:7)(cid:5)(cid:3)(cid:9)(cid:2)(cid:28)(cid:3,,1127.0
,,3,,,Unknown,,cid:50)(cid:5)(cid:14)(cid:7)(cid:12)(cid:5)(cid:9)(cid:2)(cid:16)(cid:16)(cid:2)(cid:12)(cid:11)(cid:4)(cid:14)(cid:11)(cid:48)(cid:48)(cid:7)(cid:5)(cid:3)(cid:9)(cid:2)(cid:28)(cid:3,,1130.0
,,5,,,Unknown,,cid:50)(cid:5)(cid:14)(cid:7)(cid:12)(cid:5)(cid:9)(cid:2)(cid:16)(cid:16)(cid:2)(cid:12)(cid:11)(cid:4)(cid:14)(cid:11)(cid:48)(cid:48)(cid:7)(cid:5)(cid:3)(cid:9)(cid:2)(cid:28)(cid:3,,1135.0
,,28,,,Unknown,,cid:50)(cid:5)(cid:14)(cid:7)(cid:12)(cid:5)(cid:9)(cid:2)(cid:16)(cid:16)(cid:2)(cid:12)(cid:11)(cid:4)(cid:14)(cid:11)(cid:48)(cid:48)(cid:7)(cid:5)(cid:3)(cid:9)(cid:2)(cid:28)(cid:3,,1163.0
,,11,,,Unknown,,cid:50)(cid:5)(cid:14)(cid:7)(cid:12)(cid:5)(cid:9)(cid:2)(cid:16)(cid:16)(cid:2)(cid:12)(cid:11)(cid:4)(cid:14)(cid:11)(cid:48)(cid:48)(cid:7)(cid:5)(cid:3)(cid:9)(cid:2)(cid:28)(cid:3,,1174.0
,,4,,,Unknown,,cid:50)(cid:5)(cid:14)(cid:7)(cid:12)(cid:5)(cid:9)(cid:2)(cid:16)(cid:16)(cid:2)(cid:12)(cid:11)(cid:4)(cid:14)(cid:11)(cid:48)(cid:48)(cid:7)(cid:5)(cid:3)(cid:9)(cid:2)(cid:28)(cid:3,,1178.0
,,3,,,Unknown,,cid:50)(cid:5)(cid:14)(cid:7)(cid:12)(cid:5)(cid:9)(cid:2)(cid:16)(cid:16)(cid:2)(cid:12)(cid:11)(cid:4)(cid:14)(cid:11)(cid:48)(cid:48)(cid:7)(cid:5)(cid:3)(cid:9)(cid:2)(cid:28)(cid:3,,1181.0
,,2,,,Unknown,,cid:50)(cid:5)(cid:14)(cid:7)(cid:12)(cid:5)(cid:9)(cid:2)(cid:16)(cid:16)(cid:2)(cid:12)(cid:11)(cid:4)(cid:14)(cid:11)(cid:48)(cid:48)(cid:7)(cid:5)(cid:3)(cid:9)(cid:2)(cid:28)(cid:3,,1183.0
,,48,,,Unknown,,cid:50)(cid:5)(cid:14)(cid:7)(cid:12)(cid:5)(cid:9)(cid:2)(cid:16)(cid:16)(cid:2)(cid:12)(cid:11)(cid:4)(cid:14)(cid:11)(cid:48)(cid:48)(cid:7)(cid:5)(cid:3)(cid:9)(cid:2)(cid:28)(cid:3,,1231.0
,,46,,,Unknown,,cid:50)(cid:5)(cid:14)(cid:7)(cid:12)(cid:5)(cid:9)(cid:2)(cid:16)(cid:16)(cid:2)(cid:12)(cid:11)(cid:4)(cid:14)(cid:11)(cid:48)(cid:48)(cid:7)(cid:5)(cid:3)(cid:9)(cid:2)(cid:28)(cid:3,,1277.0
,,3,,,Unknown,,cid:50)(cid:5)(cid:14)(cid:7)(cid:12)(cid:5)(cid:9)(cid:2)(cid:16)(cid:16)(cid:2)(cid:12)(cid:11)(cid:4)(cid:14)(cid:11)(cid:48)(cid:48)(cid:7)(cid:5)(cid:3)(cid:9)(cid:2)(cid:28)(cid:3,,1280.0
,,65,,,Unknown,,cid:50)(cid:5)(cid:14)(cid:7)(cid:12)(cid:5)(cid:9)(cid:2)(cid:16)(cid:16)(cid:2)(cid:12)(cid:11)(cid:4)(cid:14)(cid:11)(cid:48)(cid:48)(cid:7)(cid:5)(cid:3)(cid:9)(cid:2)(cid:28)(cid:3,,1345.0
,,5,,,Unknown,,cid:50)(cid:5)(cid:14)(cid:7)(cid:12)(cid:5)(cid:9)(cid:2)(cid:16)(cid:16)(cid:2)(cid:12)(cid:11)(cid:4)(cid:14)(cid:11)(cid:48)(cid:48)(cid:7)(cid:5)(cid:3)(cid:9)(cid:2)(cid:28)(cid:3,,1350.0
,,2,,,Unknown,,cid:50)(cid:5)(cid:14)(cid:7)(cid:12)(cid:5)(cid:9)(cid:2)(cid:16)(cid:16)(cid:2)(cid:12)(cid:11)(cid:4)(cid:14)(cid:11)(cid:48)(cid:48)(cid:7)(cid:5)(cid:3)(cid:9)(cid:2)(cid:28)(cid:3,,1352.0
,,3,,,Unknown,,cid:50)(cid:5)(cid:14)(cid:7)(cid:12)(cid:5)(cid:9)(cid:2)(cid:16)(cid:16)(cid:2)(cid:12)(cid:11)(cid:4)(cid:14)(cid:11)(cid:48)(cid:48)(cid:7)(cid:5)(cid:3)(cid:9)(cid:2)(cid:28)(cid:3,,1355.0
,,5,,,Unknown,,cid:50)(cid:5)(cid:14)(cid:7)(cid:12)(cid:5)(cid:9)(cid:2)(cid:16)(cid:16)(cid:2)(cid:12)(cid:11)(cid:4)(cid:14)(cid:11)(cid:48)(cid:48)(cid:7)(cid:5)(cid:3)(cid:9)(cid:2)(cid:28)(cid:3,,1360.0
,,47,,,Unknown,,cid:50)(cid:5)(cid:14)(cid:7)(cid:12)(cid:5)(cid:9)(cid:2)(cid:16)(cid:16)(cid:2)(cid:12)(cid:11)(cid:4)(cid:14)(cid:11)(cid:48)(cid:48)(cid:7)(cid:5)(cid:3)(cid:9)(cid:2)(cid:28)(cid:3,,1407.0
,,46,,,Unknown,,cid:50)(cid:5)(cid:14)(cid:7)(cid:12)(cid:5)(cid:9)(cid:2)(cid:16)(cid:16)(cid:2)(cid:12)(cid:11)(cid:4)(cid:14)(cid:11)(cid:48)(cid:48)(cid:7)(cid:5)(cid:3)(cid:9)(cid:2)(cid:28)(cid:3,,1453.0
,,7,,,Unknown,,cid:50)(cid:5)(cid:14)(cid:7)(cid:12)(cid:5)(cid:9)(cid:2)(cid:16)(cid:16)(cid:2)(cid:12)(cid:11)(cid:4)(cid:14)(cid:11)(cid:48)(cid:48)(cid:7)(cid:5)(cid:3)(cid:9)(cid:2)(cid:28)(cid:3,,1460.0
,,9,,,Unknown,,cid:50)(cid:5)(cid:14)(cid:7)(cid:12)(cid:5)(cid:9)(cid:2)(cid:16)(cid:16)(cid:2)(cid:12)(cid:11)(cid:4)(cid:14)(cid:11)(cid:48)(cid:48)(cid:7)(cid:5)(cid:3)(cid:9)(cid:2)(cid:28)(cid:3,,1469.0
,,2,,,Unknown,,cid:50)(cid:5)(cid:14)(cid:7)(cid:12)(cid:5)(cid:9)(cid:2)(cid:16)(cid:16)(cid:2)(cid:12)(cid:11)(cid:4)(cid:14)(cid:11)(cid:48)(cid:48)(cid:7)(cid:5)(cid:3)(cid:9)(cid:2)(cid:28)(cid:3,,1471.0
,,28,,,Unknown,,cid:50)(cid:5)(cid:14)(cid:7)(cid:12)(cid:5)(cid:9)(cid:2)(cid:16)(cid:16)(cid:2)(cid:12)(cid:11)(cid:4)(cid:14)(cid:11)(cid:48)(cid:48)(cid:7)(cid:5)(cid:3)(cid:9)(cid:2)(cid:28)(cid:3,,1499.0
,,3,,,Unknown,,cid:50)(cid:5)(cid:14)(cid:7)(cid:12)(cid:5)(cid:9)(cid:2)(cid:16)(cid:16)(cid:2)(cid:12)(cid:11)(cid:4)(cid:14)(cid:11)(cid:48)(cid:48)(cid:7)(cid:5)(cid:3)(cid:9)(cid:2)(cid:28)(cid:3,,1502.0
,,15,,,Unknown,,cid:50)(cid:5)(cid:14)(cid:7)(cid:12)(cid:5)(cid:9)(cid:2)(cid:16)(cid:16)(cid:2)(cid:12)(cid:11)(cid:4)(cid:14)(cid:11)(cid:48)(cid:48)(cid:7)(cid:5)(cid:3)(cid:9)(cid:2)(cid:28)(cid:3,,1517.0
,,2,,,Unknown,,cid:50)(cid:5)(cid:14)(cid:7)(cid:12)(cid:5)(cid:9)(cid:2)(cid:16)(cid:16)(cid:2)(cid:12)(cid:11)(cid:4)(cid:14)(cid:11)(cid:48)(cid:48)(cid:7)(cid:5)(cid:3)(cid:9)(cid:2)(cid:28)(cid:3,,1519.0
,,17,,,Unknown,,cid:50)(cid:5)(cid:14)(cid:7)(cid:12)(cid:5)(cid:9)(cid:2)(cid:16)(cid:16)(cid:2)(cid:12)(cid:11)(cid:4)(cid:14)(cid:11)(cid:48)(cid:48)(cid:7)(cid:5)(cid:3)(cid:9)(cid:2)(cid:28)(cid:3,,1536.0
,,32,,,Unknown,,cid:50)(cid:5)(cid:14)(cid:7)(cid:12)(cid:5)(cid:9)(cid:2)(cid:16)(cid:16)(cid:2)(cid:12)(cid:11)(cid:4)(cid:14)(cid:11)(cid:48)(cid:48)(cid:7)(cid:5)(cid:3)(cid:9)(cid:2)(cid:28)(cid:3,,1568.0
,,19,,,Unknown,,cid:50)(cid:5)(cid:14)(cid:7)(cid:12)(cid:5)(cid:9)(cid:2)(cid:16)(cid:16)(cid:2)(cid:12)(cid:11)(cid:4)(cid:14)(cid:11)(cid:48)(cid:48)(cid:7)(cid:5)(cid:3)(cid:9)(cid:2)(cid:28)(cid:3,,1587.0
,,18,,,Unknown,,cid:50)(cid:5)(cid:14)(cid:7)(cid:12)(cid:5)(cid:9)(cid:2)(cid:16)(cid:16)(cid:2)(cid:12)(cid:11)(cid:4)(cid:14)(cid:11)(cid:48)(cid:48)(cid:7)(cid:5)(cid:3)(cid:9)(cid:2)(cid:28)(cid:3,,1605.0
,,18,,,Unknown,,cid:50)(cid:5)(cid:14)(cid:7)(cid:12)(cid:5)(cid:9)(cid:2)(cid:16)(cid:16)(cid:2)(cid:12)(cid:11)(cid:4)(cid:14)(cid:11)(cid:48)(cid:48)(cid:7)(cid:5)(cid:3)(cid:9)(cid:2)(cid:28)(cid:3,,1623.0
,,2,,,Unknown,,cid:50)(cid:5)(cid:14)(cid:7)(cid:12)(cid:5)(cid:9)(cid:2)(cid:16)(cid:16)(cid:2)(cid:12)(cid:11)(cid:4)(cid:14)(cid:11)(cid:48)(cid:48)(cid:7)(cid:5)(cid:3)(cid:9)(cid:2)(cid:28)(cid:3,,1625.0
,,44,,,Unknown,,cid:50)(cid:5)(cid:14)(cid:7)(cid:12)(cid:5)(cid:9)(cid:2)(cid:16)(cid:16)(cid:2)(cid:12)(cid:11)(cid:4)(cid:14)(cid:11)(cid:48)(cid:48)(cid:7)(cid:5)(cid:3)(cid:9)(cid:2)(cid:28)(cid:3,,1669.0
,,12,,,Unknown,,cid:50)(cid:5)(cid:14)(cid:7)(cid:12)(cid:5)(cid:9)(cid:2)(cid:16)(cid:16)(cid:2)(cid:12)(cid:11)(cid:4)(cid:14)(cid:11)(cid:48)(cid:48)(cid:7)(cid:5)(cid:3)(cid:9)(cid:2)(cid:28)(cid:3,,1681.0
,,29,,,Unknown,,cid:50)(cid:5)(cid:14)(cid:7)(cid:12)(cid:5)(cid:9)(cid:2)(cid:16)(cid:16)(cid:2)(cid:12)(cid:11)(cid:4)(cid:14)(cid:11)(cid:48)(cid:48)(cid:7)(cid:5)(cid:3)(cid:9)(cid:2)(cid:28)(cid:3,,1710.0
,,26,,,Unknown,,cid:50)(cid:5)(cid:14)(cid:7)(cid:12)(cid:5)(cid:9)(cid:2)(cid:16)(cid:16)(cid:2)(cid:12)(cid:11)(cid:4)(cid:14)(cid:11)(cid:48)(cid:48)(cid:7)(cid:5)(cid:3)(cid:9)(cid:2)(cid:28)(cid:3,,1736.0
,,41,,,Unknown,,cid:50)(cid:5)(cid:14)(cid:7)(cid:12)(cid:5)(cid:9)(cid:2)(cid:16)(cid:16)(cid:2)(cid:12)(cid:11)(cid:4)(cid:14)(cid:11)(cid:48)(cid:48)(cid:7)(cid:5)(cid:3)(cid:9)(cid:2)(cid:28)(cid:3,,1777.0
,,25,,,Unknown,,cid:50)(cid:5)(cid:14)(cid:7)(cid:12)(cid:5)(cid:9)(cid:2)(cid:16)(cid:16)(cid:2)(cid:12)(cid:11)(cid:4)(cid:14)(cid:11)(cid:48)(cid:48)(cid:7)(cid:5)(cid:3)(cid:9)(cid:2)(cid:28)(cid:3,,1802.0
,,2,,,Unknown,,cid:50)(cid:5)(cid:14)(cid:7)(cid:12)(cid:5)(cid:9)(cid:2)(cid:16)(cid:16)(cid:2)(cid:12)(cid:11)(cid:4)(cid:14)(cid:11)(cid:48)(cid:48)(cid:7)(cid:5)(cid:3)(cid:9)(cid:2)(cid:28)(cid:3,,1804.0
,,58,,,Unknown,,cid:50)(cid:5)(cid:14)(cid:7)(cid:12)(cid:5)(cid:9)(cid:2)(cid:16)(cid:16)(cid:2)(cid:12)(cid:11)(cid:4)(cid:14)(cid:11)(cid:48)(cid:48)(cid:7)(cid:5)(cid:3)(cid:9)(cid:2)(cid:28)(cid:3,,1862.0
,,58,,,Unknown,,cid:50)(cid:5)(cid:14)(cid:7)(cid:12)(cid:5)(cid:9)(cid:2)(cid:16)(cid:16)(cid:2)(cid:12)(cid:11)(cid:4)(cid:14)(cid:11)(cid:48)(cid:48)(cid:7)(cid:5)(cid:3)(cid:9)(cid:2)(cid:28)(cid:3,,1920.0
,,18,,,Unknown,,cid:50)(cid:5)(cid:14)(cid:7)(cid:12)(cid:5)(cid:9)(cid:2)(cid:16)(cid:16)(cid:2)(cid:12)(cid:11)(cid:4)(cid:14)(cid:11)(cid:48)(cid:48)(cid:7)(cid:5)(cid:3)(cid:9)(cid:2)(cid:28)(cid:3,,1938.0
,,1,,,Unknown,,cid:50)(cid:5)(cid:14)(cid:7)(cid:12)(cid:5)(cid:9)(cid:2)(cid:16)(cid:16)(cid:2)(cid:12)(cid:11)(cid:4)(cid:14)(cid:11)(cid:48)(cid:48)(cid:7)(cid:5)(cid:3)(cid:9)(cid:2)(cid:28)(cid:3,,1939.0
,,1,,,Unknown,,cid:50)(cid:5)(cid:14)(cid:7)(cid:12)(cid:5)(cid:9)(cid:2)(cid:16)(cid:16)(cid:2)(cid:12)(cid:11)(cid:4)(cid:14)(cid:11)(cid:48)(cid:48)(cid:7)(cid:5)(cid:3)(cid:9)(cid:2)(cid:28)(cid:3,,1940.0
,,37,,,Unknown,,cid:50)(cid:5)(cid:14)(cid:7)(cid:12)(cid:5)(cid:9)(cid:2)(cid:16)(cid:16)(cid:2)(cid:12)(cid:11)(cid:4)(cid:14)(cid:11)(cid:48)(cid:48)(cid:7)(cid:5)(cid:3)(cid:9)(cid:2)(cid:28)(cid:3,,1977.0
,,37,,,Unknown,,cid:50)(cid:5)(cid:14)(cid:7)(cid:12)(cid:5)(cid:9)(cid:2)(cid:16)(cid:16)(cid:2)(cid:12)(cid:11)(cid:4)(cid:14)(cid:11)(cid:48)(cid:48)(cid:7)(cid:5)(cid:3)(cid:9)(cid:2)(cid:28)(cid:3,,2014.0
,,18,,,Unknown,,cid:50)(cid:5)(cid:14)(cid:7)(cid:12)(cid:5)(cid:9)(cid:2)(cid:16)(cid:16)(cid:2)(cid:12)(cid:11)(cid:4)(cid:14)(cid:11)(cid:48)(cid:48)(cid:7)(cid:5)(cid:3)(cid:9)(cid:2)(cid:28)(cid:3,,2032.0
,,45,,,Unknown,,cid:50)(cid:5)(cid:14)(cid:7)(cid:12)(cid:5)(cid:9)(cid:2)(cid:16)(cid:16)(cid:2)(cid:12)(cid:11)(cid:4)(cid:14)(cid:11)(cid:48)(cid:48)(cid:7)(cid:5)(cid:3)(cid:9)(cid:2)(cid:28)(cid:3,,2077.0
,,18,,,Unknown,,cid:50)(cid:5)(cid:14)(cid:7)(cid:12)(cid:5)(cid:9)(cid:2)(cid:16)(cid:16)(cid:2)(cid:12)(cid:11)(cid:4)(cid:14)(cid:11)(cid:48)(cid:48)(cid:7)(cid:5)(cid:3)(cid:9)(cid:2)(cid:28)(cid:3,,2095.0
,,16,,,Unknown,,cid:50)(cid:5)(cid:14)(cid:7)(cid:12)(cid:5)(cid:9)(cid:2)(cid:16)(cid:16)(cid:2)(cid:12)(cid:11)(cid:4)(cid:14)(cid:11)(cid:48)(cid:48)(cid:7)(cid:5)(cid:3)(cid:9)(cid:2)(cid:28)(cid:3,,2111.0
,,14,,,Unknown,,cid:50)(cid:5)(cid:14)(cid:7)(cid:12)(cid:5)(cid:9)(cid:2)(cid:16)(cid:16)(cid:2)(cid:12)(cid:11)(cid:4)(cid:14)(cid:11)(cid:48)(cid:48)(cid:7)(cid:5)(cid:3)(cid:9)(cid:2)(cid:28)(cid:3,,2125.0
,,7,,,Unknown,,cid:50)(cid:5)(cid:14)(cid:7)(cid:12)(cid:5)(cid:9)(cid:2)(cid:16)(cid:16)(cid:2)(cid:12)(cid:11)(cid:4)(cid:14)(cid:11)(cid:48)(cid:48)(cid:7)(cid:5)(cid:3)(cid:9)(cid:2)(cid:28)(cid:3,,2132.0
,,14,,,Unknown,,cid:50)(cid:5)(cid:14)(cid:7)(cid:12)(cid:5)(cid:9)(cid:2)(cid:16)(cid:16)(cid:2)(cid:12)(cid:11)(cid:4)(cid:14)(cid:11)(cid:48)(cid:48)(cid:7)(cid:5)(cid:3)(cid:9)(cid:2)(cid:28)(cid:3,,2146.0
,,46,,,Unknown,,cid:50)(cid:5)(cid:14)(cid:7)(cid:12)(cid:5)(cid:9)(cid:2)(cid:16)(cid:16)(cid:2)(cid:12)(cid:11)(cid:4)(cid:14)(cid:11)(cid:48)(cid:48)(cid:7)(cid:5)(cid:3)(cid:9)(cid:2)(cid:28)(cid:3,,2192.0
,,9,,,Unknown,,cid:50)(cid:5)(cid:14)(cid:7)(cid:12)(cid:5)(cid:9)(cid:2)(cid:16)(cid:16)(cid:2)(cid:12)(cid:11)(cid:4)(cid:14)(cid:11)(cid:48)(cid:48)(cid:7)(cid:5)(cid:3)(cid:9)(cid:2)(cid:28)(cid:3,,2201.0
,,2,,,Unknown,,cid:50)(cid:5)(cid:14)(cid:7)(cid:12)(cid:5)(cid:9)(cid:2)(cid:16)(cid:16)(cid:2)(cid:12)(cid:11)(cid:4)(cid:14)(cid:11)(cid:48)(cid:48)(cid:7)(cid:5)(cid:3)(cid:9)(cid:2)(cid:28)(cid:3,,2203.0
,,48,,,Unknown,,cid:50)(cid:5)(cid:14)(cid:7)(cid:12)(cid:5)(cid:9)(cid:2)(cid:16)(cid:16)(cid:2)(cid:12)(cid:11)(cid:4)(cid:14)(cid:11)(cid:48)(cid:48)(cid:7)(cid:5)(cid:3)(cid:9)(cid:2)(cid:28)(cid:3,,2251.0
,,46,,,Unknown,,cid:50)(cid:5)(cid:14)(cid:7)(cid:12)(cid:5)(cid:9)(cid:2)(cid:16)(cid:16)(cid:2)(cid:12)(cid:11)(cid:4)(cid:14)(cid:11)(cid:48)(cid:48)(cid:7)(cid:5)(cid:3)(cid:9)(cid:2)(cid:28)(cid:3,,2297.0
,,3,,,Unknown,,cid:50)(cid:5)(cid:14)(cid:7)(cid:12)(cid:5)(cid:9)(cid:2)(cid:16)(cid:16)(cid:2)(cid:12)(cid:11)(cid:4)(cid:14)(cid:11)(cid:48)(cid:48)(cid:7)(cid:5)(cid:3)(cid:9)(cid:2)(cid:28)(cid:3,,2300.0
,,65,,,Unknown,,cid:50)(cid:5)(cid:14)(cid:7)(cid:12)(cid:5)(cid:9)(cid:2)(cid:16)(cid:16)(cid:2)(cid:12)(cid:11)(cid:4)(cid:14)(cid:11)(cid:48)(cid:48)(cid:7)(cid:5)(cid:3)(cid:9)(cid:2)(cid:28)(cid:3,,2365.0
,,5,,,Unknown,,cid:50)(cid:5)(cid:14)(cid:7)(cid:12)(cid:5)(cid:9)(cid:2)(cid:16)(cid:16)(cid:2)(cid:12)(cid:11)(cid:4)(cid:14)(cid:11)(cid:48)(cid:48)(cid:7)(cid:5)(cid:3)(cid:9)(cid:2)(cid:28)(cid:3,,2370.0
,,10,,,Unknown,,cid:50)(cid:5)(cid:14)(cid:7)(cid:12)(cid:5)(cid:9)(cid:2)(cid:16)(cid:16)(cid:2)(cid:12)(cid:11)(cid:4)(cid:14)(cid:11)(cid:48)(cid:48)(cid:7)(cid:5)(cid:3)(cid:9)(cid:2)(cid:28)(cid:3,,2380.0
,,2,,,Unknown,,cid:50)(cid:5)(cid:14)(cid:7)(cid:12)(cid:5)(cid:9)(cid:2)(cid:16)(cid:16)(cid:2)(cid:12)(cid:11)(cid:4)(cid:14)(cid:11)(cid:48)(cid:48)(cid:7)(cid:5)(cid:3)(cid:9)(cid:2)(cid:28)(cid:3,,2382.0
,,39,,,Unknown,,cid:50)(cid:5)(cid:14)(cid:7)(cid:12)(cid:5)(cid:9)(cid:2)(cid:16)(cid:16)(cid:2)(cid:12)(cid:11)(cid:4)(cid:14)(cid:11)(cid:48)(cid:48)(cid:7)(cid:5)(cid:3)(cid:9)(cid:2)(cid:28)(cid:3,,2421.0
,,11,,,Unknown,,cid:50)(cid:5)(cid:14)(cid:7)(cid:12)(cid:5)(cid:9)(cid:2)(cid:16)(cid:16)(cid:2)(cid:12)(cid:11)(cid:4)(cid:14)(cid:11)(cid:48)(cid:48)(cid:7)(cid:5)(cid:3)(cid:9)(cid:2)(cid:28)(cid:3,,2432.0
,,7,,,Unknown,,cid:50)(cid:5)(cid:14)(cid:7)(cid:12)(cid:5)(cid:9)(cid:2)(cid:16)(cid:16)(cid:2)(cid:12)(cid:11)(cid:4)(cid:14)(cid:11)(cid:48)(cid:48)(cid:7)(cid:5)(cid:3)(cid:9)(cid:2)(cid:28)(cid:3,,2439.0
,,64,,,Unknown,,cid:50)(cid:5)(cid:14)(cid:7)(cid:12)(cid:5)(cid:9)(cid:2)(cid:16)(cid:16)(cid:2)(cid:12)(cid:11)(cid:4)(cid:14)(cid:11)(cid:48)(cid:48)(cid:7)(cid:5)(cid:3)(cid:9)(cid:2)(cid:28)(cid:3,,2503.0
,,8,,,Unknown,,cid:50)(cid:5)(cid:14)(cid:7)(cid:12)(cid:5)(cid:9)(cid:2)(cid:16)(cid:16)(cid:2)(cid:12)(cid:11)(cid:4)(cid:14)(cid:11)(cid:48)(cid:48)(cid:7)(cid:5)(cid:3)(cid:9)(cid:2)(cid:28)(cid:3,,2511.0
,,49,,,Unknown,,cid:50)(cid:5)(cid:14)(cid:7)(cid:12)(cid:5)(cid:9)(cid:2)(cid:16)(cid:16)(cid:2)(cid:12)(cid:11)(cid:4)(cid:14)(cid:11)(cid:48)(cid:48)(cid:7)(cid:5)(cid:3)(cid:9)(cid:2)(cid:28)(cid:3,,2560.0
,,2,,,Unknown,,cid:50)(cid:5)(cid:14)(cid:7)(cid:12)(cid:5)(cid:9)(cid:2)(cid:16)(cid:16)(cid:2)(cid:12)(cid:11)(cid:4)(cid:14)(cid:11)(cid:48)(cid:48)(cid:7)(cid:5)(cid:3)(cid:9)(cid:2)(cid:28)(cid:3,,2562.0
,,28,,,Unknown,,cid:50)(cid:5)(cid:14)(cid:7)(cid:12)(cid:5)(cid:9)(cid:2)(cid:16)(cid:16)(cid:2)(cid:12)(cid:11)(cid:4)(cid:14)(cid:11)(cid:48)(cid:48)(cid:7)(cid:5)(cid:3)(cid:9)(cid:2)(cid:28)(cid:3,,2590.0
,,3,,,Unknown,,cid:50)(cid:5)(cid:14)(cid:7)(cid:12)(cid:5)(cid:9)(cid:2)(cid:16)(cid:16)(cid:2)(cid:12)(cid:11)(cid:4)(cid:14)(cid:11)(cid:48)(cid:48)(cid:7)(cid:5)(cid:3)(cid:9)(cid:2)(cid:28)(cid:3,,2593.0
,,15,,,Unknown,,cid:50)(cid:5)(cid:14)(cid:7)(cid:12)(cid:5)(cid:9)(cid:2)(cid:16)(cid:16)(cid:2)(cid:12)(cid:11)(cid:4)(cid:14)(cid:11)(cid:48)(cid:48)(cid:7)(cid:5)(cid:3)(cid:9)(cid:2)(cid:28)(cid:3,,2608.0
,,2,,,Unknown,,cid:50)(cid:5)(cid:14)(cid:7)(cid:12)(cid:5)(cid:9)(cid:2)(cid:16)(cid:16)(cid:2)(cid:12)(cid:11)(cid:4)(cid:14)(cid:11)(cid:48)(cid:48)(cid:7)(cid:5)(cid:3)(cid:9)(cid:2)(cid:28)(cid:3,,2610.0
,,36,,,Unknown,,cid:50)(cid:5)(cid:14)(cid:7)(cid:12)(cid:5)(cid:9)(cid:2)(cid:16)(cid:16)(cid:2)(cid:12)(cid:11)(cid:4)(cid:14)(cid:11)(cid:48)(cid:48)(cid:7)(cid:5)(cid:3)(cid:9)(cid:2)(cid:28)(cid:3,,2646.0
,,34,,,Unknown,,cid:50)(cid:5)(cid:14)(cid:7)(cid:12)(cid:5)(cid:9)(cid:2)(cid:16)(cid:16)(cid:2)(cid:12)(cid:11)(cid:4)(cid:14)(cid:11)(cid:48)(cid:48)(cid:7)(cid:5)(cid:3)(cid:9)(cid:2)(cid:28)(cid:3,,2680.0
,,19,,,Unknown,,cid:50)(cid:5)(cid:14)(cid:7)(cid:12)(cid:5)(cid:9)(cid:2)(cid:16)(cid:16)(cid:2)(cid:12)(cid:11)(cid:4)(cid:14)(cid:11)(cid:48)(cid:48)(cid:7)(cid:5)(cid:3)(cid:9)(cid:2)(cid:28)(cid:3,,2699.0
,,37,,,Unknown,,cid:50)(cid:5)(cid:14)(cid:7)(cid:12)(cid:5)(cid:9)(cid:2)(cid:16)(cid:16)(cid:2)(cid:12)(cid:11)(cid:4)(cid:14)(cid:11)(cid:48)(cid:48)(cid:7)(cid:5)(cid:3)(cid:9)(cid:2)(cid:28)(cid:3,,2736.0
,,1,,,Unknown,,cid:50)(cid:5)(cid:14)(cid:7)(cid:12)(cid:5)(cid:9)(cid:2)(cid:16)(cid:16)(cid:2)(cid:12)(cid:11)(cid:4)(cid:14)(cid:11)(cid:48)(cid:48)(cid:7)(cid:5)(cid:3)(cid:9)(cid:2)(cid:28)(cid:3,,2737.0
,,2,,,Unknown,,cid:50)(cid:5)(cid:14)(cid:7)(cid:12)(cid:5)(cid:9)(cid:2)(cid:16)(cid:16)(cid:2)(cid:12)(cid:11)(cid:4)(cid:14)(cid:11)(cid:48)(cid:48)(cid:7)(cid:5)(cid:3)(cid:9)(cid:2)(cid:28)(cid:3,,2739.0
,,44,,,Unknown,,cid:50)(cid:5)(cid:14)(cid:7)(cid:12)(cid:5)(cid:9)(cid:2)(cid:16)(cid:16)(cid:2)(cid:12)(cid:11)(cid:4)(cid:14)(cid:11)(cid:48)(cid:48)(cid:7)(cid:5)(cid:3)(cid:9)(cid:2)(cid:28)(cid:3,,2783.0
,,12,,,Unknown,,cid:50)(cid:5)(cid:14)(cid:7)(cid:12)(cid:5)(cid:9)(cid:2)(cid:16)(cid:16)(cid:2)(cid:12)(cid:11)(cid:4)(cid:14)(cid:11)(cid:48)(cid:48)(cid:7)(cid:5)(cid:3)(cid:9)(cid:2)(cid:28)(cid:3,,2795.0
,,29,,,Unknown,,cid:50)(cid:5)(cid:14)(cid:7)(cid:12)(cid:5)(cid:9)(cid:2)(cid:16)(cid:16)(cid:2)(cid:12)(cid:11)(cid:4)(cid:14)(cid:11)(cid:48)(cid:48)(cid:7)(cid:5)(cid:3)(cid:9)(cid:2)(cid:28)(cid:3,,2824.0
,,26,,,Unknown,,cid:50)(cid:5)(cid:14)(cid:7)(cid:12)(cid:5)(cid:9)(cid:2)(cid:16)(cid:16)(cid:2)(cid:12)(cid:11)(cid:4)(cid:14)(cid:11)(cid:48)(cid:48)(cid:7)(cid:5)(cid:3)(cid:9)(cid:2)(cid:28)(cid:3,,2850.0
,,41,,,Unknown,,cid:50)(cid:5)(cid:14)(cid:7)(cid:12)(cid:5)(cid:9)(cid:2)(cid:16)(cid:16)(cid:2)(cid:12)(cid:11)(cid:4)(cid:14)(cid:11)(cid:48)(cid:48)(cid:7)(cid:5)(cid:3)(cid:9)(cid:2)(cid:28)(cid:3,,2891.0
,,25,,,Unknown,,cid:50)(cid:5)(cid:14)(cid:7)(cid:12)(cid:5)(cid:9)(cid:2)(cid:16)(cid:16)(cid:2)(cid:12)(cid:11)(cid:4)(cid:14)(cid:11)(cid:48)(cid:48)(cid:7)(cid:5)(cid:3)(cid:9)(cid:2)(cid:28)(cid:3,,2916.0
,,2,,,Unknown,,cid:50)(cid:5)(cid:14)(cid:7)(cid:12)(cid:5)(cid:9)(cid:2)(cid:16)(cid:16)(cid:2)(cid:12)(cid:11)(cid:4)(cid:14)(cid:11)(cid:48)(cid:48)(cid:7)(cid:5)(cid:3)(cid:9)(cid:2)(cid:28)(cid:3,,2918.0
,,58,,,Unknown,,cid:50)(cid:5)(cid:14)(cid:7)(cid:12)(cid:5)(cid:9)(cid:2)(cid:16)(cid:16)(cid:2)(cid:12)(cid:11)(cid:4)(cid:14)(cid:11)(cid:48)(cid:48)(cid:7)(cid:5)(cid:3)(cid:9)(cid:2)(cid:28)(cid:3,,2976.0
,,58,,,Unknown,,cid:50)(cid:5)(cid:14)(cid:7)(cid:12)(cid:5)(cid:9)(cid:2)(cid:16)(cid:16)(cid:2)(cid:12)(cid:11)(cid:4)(cid:14)(cid:11)(cid:48)(cid:48)(cid:7)(cid:5)(cid:3)(cid:9)(cid:2)(cid:28)(cid:3,,3034.0
,,18,,,Unknown,,cid:50)(cid:5)(cid:14)(cid:7)(cid:12)(cid:5)(cid:9)(cid:2)(cid:16)(cid:16)(cid:2)(cid:12)(cid:11)(cid:4)(cid:14)(cid:11)(cid:48)(cid:48)(cid:7)(cid:5)(cid:3)(cid:9)(cid:2)(cid:28)(cid:3,,3052.0
,,1,,,Unknown,,cid:50)(cid:5)(cid:14)(cid:7)(cid:12)(cid:5)(cid:9)(cid:2)(cid:16)(cid:16)(cid:2)(cid:12)(cid:11)(cid:4)(cid:14)(cid:11)(cid:48)(cid:48)(cid:7)(cid:5)(cid:3)(cid:9)(cid:2)(cid:28)(cid:3,,3053.0
,,1,,,Unknown,,cid:50)(cid:5)(cid:14)(cid:7)(cid:12)(cid:5)(cid:9)(cid:2)(cid:16)(cid:16)(cid:2)(cid:12)(cid:11)(cid:4)(cid:14)(cid:11)(cid:48)(cid:48)(cid:7)(cid:5)(cid:3)(cid:9)(cid:2)(cid:28)(cid:3,,3054.0
,,37,,,Unknown,,cid:50)(cid:5)(cid:14)(cid:7)(cid:12)(cid:5)(cid:9)(cid:2)(cid:16)(cid:16)(cid:2)(cid:12)(cid:11)(cid:4)(cid:14)(cid:11)(cid:48)(cid:48)(cid:7)(cid:5)(cid:3)(cid:9)(cid:2)(cid:28)(cid:3,,3091.0
,,37,,,Unknown,,cid:50)(cid:5)(cid:14)(cid:7)(cid:12)(cid:5)(cid:9)(cid:2)(cid:16)(cid:16)(cid:2)(cid:12)(cid:11)(cid:4)(cid:14)(cid:11)(cid:48)(cid:48)(cid:7)(cid:5)(cid:3)(cid:9)(cid:2)(cid:28)(cid:3,,3128.0
,,18,,,Unknown,,cid:50)(cid:5)(cid:14)(cid:7)(cid:12)(cid:5)(cid:9)(cid:2)(cid:16)(cid:16)(cid:2)(cid:12)(cid:11)(cid:4)(cid:14)(cid:11)(cid:48)(cid:48)(cid:7)(cid:5)(cid:3)(cid:9)(cid:2)(cid:28)(cid:3,,3146.0
,,45,,,Unknown,,cid:50)(cid:5)(cid:14)(cid:7)(cid:12)(cid:5)(cid:9)(cid:2)(cid:16)(cid:16)(cid:2)(cid:12)(cid:11)(cid:4)(cid:14)(cid:11)(cid:48)(cid:48)(cid:7)(cid:5)(cid:3)(cid:9)(cid:2)(cid:28)(cid:3,,3191.0
,,18,,,Unknown,,cid:50)(cid:5)(cid:14)(cid:7)(cid:12)(cid:5)(cid:9)(cid:2)(cid:16)(cid:16)(cid:2)(cid:12)(cid:11)(cid:4)(cid:14)(cid:11)(cid:48)(cid:48)(cid:7)(cid:5)(cid:3)(cid:9)(cid:2)(cid:28)(cid:3,,3209.0
,,16,,,Unknown,,cid:50)(cid:5)(cid:14)(cid:7)(cid:12)(cid:5)(cid:9)(cid:2)(cid:16)(cid:16)(cid:2)(cid:12)(cid:11)(cid:4)(cid:14)(cid:11)(cid:48)(cid:48)(cid:7)(cid:5)(cid:3)(cid:9)(cid:2)(cid:28)(cid:3,,3225.0
,,12,,,Unknown,,cid:50)(cid:5)(cid:14)(cid:7)(cid:12)(cid:5)(cid:9)(cid:2)(cid:16)(cid:16)(cid:2)(cid:12)(cid:11)(cid:4)(cid:14)(cid:11)(cid:48)(cid:48)(cid:7)(cid:5)(cid:3)(cid:9)(cid:2)(cid:28)(cid:3,,3237.0
,,46,,,Unknown,,cid:50)(cid:5)(cid:14)(cid:7)(cid:12)(cid:5)(cid:9)(cid:2)(cid:16)(cid:16)(cid:2)(cid:12)(cid:11)(cid:4)(cid:14)(cid:11)(cid:48)(cid:48)(cid:7)(cid:5)(cid:3)(cid:9)(cid:2)(cid:28)(cid:3,,3283.0
,,28,,,Unknown,,cid:50)(cid:5)(cid:14)(cid:7)(cid:12)(cid:5)(cid:9)(cid:2)(cid:16)(cid:16)(cid:2)(cid:12)(cid:11)(cid:4)(cid:14)(cid:11)(cid:48)(cid:48)(cid:7)(cid:5)(cid:3)(cid:9)(cid:2)(cid:28)(cid:3,,3311.0
,,5,,,Unknown,,cid:50)(cid:5)(cid:14)(cid:7)(cid:12)(cid:5)(cid:9)(cid:2)(cid:16)(cid:16)(cid:2)(cid:12)(cid:11)(cid:4)(cid:14)(cid:11)(cid:48)(cid:48)(cid:7)(cid:5)(cid:3)(cid:9)(cid:2)(cid:28)(cid:3,,3316.0
,,2,,,Unknown,,cid:50)(cid:5)(cid:14)(cid:7)(cid:12)(cid:5)(cid:9)(cid:2)(cid:16)(cid:16)(cid:2)(cid:12)(cid:11)(cid:4)(cid:14)(cid:11)(cid:48)(cid:48)(cid:7)(cid:5)(cid:3)(cid:9)(cid:2)(cid:28)(cid:3,,3318.0
,,50,,,Unknown,,cid:50)(cid:5)(cid:14)(cid:7)(cid:12)(cid:5)(cid:9)(cid:2)(cid:16)(cid:16)(cid:2)(cid:12)(cid:11)(cid:4)(cid:14)(cid:11)(cid:48)(cid:48)(cid:7)(cid:5)(cid:3)(cid:9)(cid:2)(cid:28)(cid:3,,3368.0
,,5,,,Unknown,,cid:50)(cid:5)(cid:14)(cid:7)(cid:12)(cid:5)(cid:9)(cid:2)(cid:16)(cid:16)(cid:2)(cid:12)(cid:11)(cid:4)(cid:14)(cid:11)(cid:48)(cid:48)(cid:7)(cid:5)(cid:3)(cid:9)(cid:2)(cid:28)(cid:3,,3373.0
,,2,,,Unknown,,cid:50)(cid:5)(cid:14)(cid:7)(cid:12)(cid:5)(cid:9)(cid:2)(cid:16)(cid:16)(cid:2)(cid:12)(cid:11)(cid:4)(cid:14)(cid:11)(cid:48)(cid:48)(cid:7)(cid:5)(cid:3)(cid:9)(cid:2)(cid:28)(cid:3,,3375.0
,,14,,,Unknown,,cid:50)(cid:5)(cid:14)(cid:7)(cid:12)(cid:5)(cid:9)(cid:2)(cid:16)(cid:16)(cid:2)(cid:12)(cid:11)(cid:4)(cid:14)(cid:11)(cid:48)(cid:48)(cid:7)(cid:5)(cid:3)(cid:9)(cid:2)(cid:28)(cid:3,,3389.0
,,69,,,Unknown,,cid:50)(cid:5)(cid:14)(cid:7)(cid:12)(cid:5)(cid:9)(cid:2)(cid:16)(cid:16)(cid:2)(cid:12)(cid:11)(cid:4)(cid:14)(cid:11)(cid:48)(cid:48)(cid:7)(cid:5)(cid:3)(cid:9)(cid:2)(cid:28)(cid:3,,3458.0
,,5,,,Unknown,,cid:50)(cid:5)(cid:14)(cid:7)(cid:12)(cid:5)(cid:9)(cid:2)(cid:16)(cid:16)(cid:2)(cid:12)(cid:11)(cid:4)(cid:14)(cid:11)(cid:48)(cid:48)(cid:7)(cid:5)(cid:3)(cid:9)(cid:2)(cid:28)(cid:3,,3463.0
,,12,,,Unknown,,cid:50)(cid:5)(cid:14)(cid:7)(cid:12)(cid:5)(cid:9)(cid:2)(cid:16)(cid:16)(cid:2)(cid:12)(cid:11)(cid:4)(cid:14)(cid:11)(cid:48)(cid:48)(cid:7)(cid:5)(cid:3)(cid:9)(cid:2)(cid:28)(cid:3,,3475.0
,,4,,,Unknown,,cid:50)(cid:5)(cid:14)(cid:7)(cid:12)(cid:5)(cid:9)(cid:2)(cid:16)(cid:16)(cid:2)(cid:12)(cid:11)(cid:4)(cid:14)(cid:11)(cid:48)(cid:48)(cid:7)(cid:5)(cid:3)(cid:9)(cid:2)(cid:28)(cid:3,,3479.0
,,2,,,Unknown,,cid:50)(cid:5)(cid:14)(cid:7)(cid:12)(cid:5)(cid:9)(cid:2)(cid:16)(cid:16)(cid:2)(cid:12)(cid:11)(cid:4)(cid:14)(cid:11)(cid:48)(cid:48)(cid:7)(cid:5)(cid:3)(cid:9)(cid:2)(cid:28)(cid:3,,3481.0
,,14,,,Unknown,,cid:50)(cid:5)(cid:14)(cid:7)(cid:12)(cid:5)(cid:9)(cid:2)(cid:16)(cid:16)(cid:2)(cid:12)(cid:11)(cid:4)(cid:14)(cid:11)(cid:48)(cid:48)(cid:7)(cid:5)(cid:3)(cid:9)(cid:2)(cid:28)(cid:3,,3495.0
,,46,,,Unknown,,cid:50)(cid:5)(cid:14)(cid:7)(cid:12)(cid:5)(cid:9)(cid:2)(cid:16)(cid:16)(cid:2)(cid:12)(cid:11)(cid:4)(cid:14)(cid:11)(cid:48)(cid:48)(cid:7)(cid:5)(cid:3)(cid:9)(cid:2)(cid:28)(cid:3,,3541.0
,,2,,,Unknown,,cid:50)(cid:5)(cid:14)(cid:7)(cid:12)(cid:5)(cid:9)(cid:2)(cid:16)(cid:16)(cid:2)(cid:12)(cid:11)(cid:4)(cid:14)(cid:11)(cid:48)(cid:48)(cid:7)(cid:5)(cid:3)(cid:9)(cid:2)(cid:28)(cid:3,,3543.0
,,28,,,Unknown,,cid:50)(cid:5)(cid:14)(cid:7)(cid:12)(cid:5)(cid:9)(cid:2)(cid:16)(cid:16)(cid:2)(cid:12)(cid:11)(cid:4)(cid:14)(cid:11)(cid:48)(cid:48)(cid:7)(cid:5)(cid:3)(cid:9)(cid:2)(cid:28)(cid:3,,3571.0
,,5,,,Unknown,,cid:50)(cid:5)(cid:14)(cid:7)(cid:12)(cid:5)(cid:9)(cid:2)(cid:16)(cid:16)(cid:2)(cid:12)(cid:11)(cid:4)(cid:14)(cid:11)(cid:48)(cid:48)(cid:7)(cid:5)(cid:3)(cid:9)(cid:2)(cid:28)(cid:3,,3576.0
,,3,,,Unknown,,cid:50)(cid:5)(cid:14)(cid:7)(cid:12)(cid:5)(cid:9)(cid:2)(cid:16)(cid:16)(cid:2)(cid:12)(cid:11)(cid:4)(cid:14)(cid:11)(cid:48)(cid:48)(cid:7)(cid:5)(cid:3)(cid:9)(cid:2)(cid:28)(cid:3,,3579.0
,,10,,,Unknown,,cid:50)(cid:5)(cid:14)(cid:7)(cid:12)(cid:5)(cid:9)(cid:2)(cid:16)(cid:16)(cid:2)(cid:12)(cid:11)(cid:4)(cid:14)(cid:11)(cid:48)(cid:48)(cid:7)(cid:5)(cid:3)(cid:9)(cid:2)(cid:28)(cid:3,,3589.0
,,5,,,Unknown,,cid:50)(cid:5)(cid:14)(cid:7)(cid:12)(cid:5)(cid:9)(cid:2)(cid:16)(cid:16)(cid:2)(cid:12)(cid:11)(cid:4)(cid:14)(cid:11)(cid:48)(cid:48)(cid:7)(cid:5)(cid:3)(cid:9)(cid:2)(cid:28)(cid:3,,3594.0
,,2,,,Unknown,,cid:50)(cid:5)(cid:14)(cid:7)(cid:12)(cid:5)(cid:9)(cid:2)(cid:16)(cid:16)(cid:2)(cid:12)(cid:11)(cid:4)(cid:14)(cid:11)(cid:48)(cid:48)(cid:7)(cid:5)(cid:3)(cid:9)(cid:2)(cid:28)(cid:3,,3596.0
,,64,,,Unknown,,cid:50)(cid:5)(cid:14)(cid:7)(cid:12)(cid:5)(cid:9)(cid:2)(cid:16)(cid:16)(cid:2)(cid:12)(cid:11)(cid:4)(cid:14)(cid:11)(cid:48)(cid:48)(cid:7)(cid:5)(cid:3)(cid:9)(cid:2)(cid:28)(cid:3,,3660.0
,,46,,,Unknown,,cid:50)(cid:5)(cid:14)(cid:7)(cid:12)(cid:5)(cid:9)(cid:2)(cid:16)(cid:16)(cid:2)(cid:12)(cid:11)(cid:4)(cid:14)(cid:11)(cid:48)(cid:48)(cid:7)(cid:5)(cid:3)(cid:9)(cid:2)(cid:28)(cid:3,,3706.0
,,4,,,Unknown,,cid:50)(cid:5)(cid:14)(cid:7)(cid:12)(cid:5)(cid:9)(cid:2)(cid:16)(cid:16)(cid:2)(cid:12)(cid:11)(cid:4)(cid:14)(cid:11)(cid:48)(cid:48)(cid:7)(cid:5)(cid:3)(cid:9)(cid:2)(cid:28)(cid:3,,3710.0
,,12,,,Unknown,,cid:50)(cid:5)(cid:14)(cid:7)(cid:12)(cid:5)(cid:9)(cid:2)(cid:16)(cid:16)(cid:2)(cid:12)(cid:11)(cid:4)(cid:14)(cid:11)(cid:48)(cid:48)(cid:7)(cid:5)(cid:3)(cid:9)(cid:2)(cid:28)(cid:3,,3722.0
,,2,,,Unknown,,cid:50)(cid:5)(cid:14)(cid:7)(cid:12)(cid:5)(cid:9)(cid:2)(cid:16)(cid:16)(cid:2)(cid:12)(cid:11)(cid:4)(cid:14)(cid:11)(cid:48)(cid:48)(cid:7)(cid:5)(cid:3)(cid:9)(cid:2)(cid:28)(cid:3,,3724.0
,,28,,,Unknown,,cid:50)(cid:5)(cid:14)(cid:7)(cid:12)(cid:5)(cid:9)(cid:2)(cid:16)(cid:16)(cid:2)(cid:12)(cid:11)(cid:4)(cid:14)(cid:11)(cid:48)(cid:48)(cid:7)(cid:5)(cid:3)(cid:9)(cid:2)(cid:28)(cid:3,,3752.0
,,3,,,Unknown,,cid:50)(cid:5)(cid:14)(cid:7)(cid:12)(cid:5)(cid:9)(cid:2)(cid:16)(cid:16)(cid:2)(cid:12)(cid:11)(cid:4)(cid:14)(cid:11)(cid:48)(cid:48)(cid:7)(cid:5)(cid:3)(cid:9)(cid:2)(cid:28)(cid:3,,3755.0
,,15,,,Unknown,,cid:50)(cid:5)(cid:14)(cid:7)(cid:12)(cid:5)(cid:9)(cid:2)(cid:16)(cid:16)(cid:2)(cid:12)(cid:11)(cid:4)(cid:14)(cid:11)(cid:48)(cid:48)(cid:7)(cid:5)(cid:3)(cid:9)(cid:2)(cid:28)(cid:3,,3770.0
,,2,,,Unknown,,cid:50)(cid:5)(cid:14)(cid:7)(cid:12)(cid:5)(cid:9)(cid:2)(cid:16)(cid:16)(cid:2)(cid:12)(cid:11)(cid:4)(cid:14)(cid:11)(cid:48)(cid:48)(cid:7)(cid:5)(cid:3)(cid:9)(cid:2)(cid:28)(cid:3,,3772.0
,,37,,,Unknown,,cid:50)(cid:5)(cid:14)(cid:7)(cid:12)(cid:5)(cid:9)(cid:2)(cid:16)(cid:16)(cid:2)(cid:12)(cid:11)(cid:4)(cid:14)(cid:11)(cid:48)(cid:48)(cid:7)(cid:5)(cid:3)(cid:9)(cid:2)(cid:28)(cid:3,,3809.0
,,18,,,Unknown,,cid:50)(cid:5)(cid:14)(cid:7)(cid:12)(cid:5)(cid:9)(cid:2)(cid:16)(cid:16)(cid:2)(cid:12)(cid:11)(cid:4)(cid:14)(cid:11)(cid:48)(cid:48)(cid:7)(cid:5)(cid:3)(cid:9)(cid:2)(cid:28)(cid:3,,3827.0
,,19,,,Unknown,,cid:50)(cid:5)(cid:14)(cid:7)(cid:12)(cid:5)(cid:9)(cid:2)(cid:16)(cid:16)(cid:2)(cid:12)(cid:11)(cid:4)(cid:14)(cid:11)(cid:48)(cid:48)(cid:7)(cid:5)(cid:3)(cid:9)(cid:2)(cid:28)(cid:3,,3846.0
,,34,,,Unknown,,cid:50)(cid:5)(cid:14)(cid:7)(cid:12)(cid:5)(cid:9)(cid:2)(cid:16)(cid:16)(cid:2)(cid:12)(cid:11)(cid:4)(cid:14)(cid:11)(cid:48)(cid:48)(cid:7)(cid:5)(cid:3)(cid:9)(cid:2)(cid:28)(cid:3,,3880.0
,,18,,,Unknown,,cid:50)(cid:5)(cid:14)(cid:7)(cid:12)(cid:5)(cid:9)(cid:2)(cid:16)(cid:16)(cid:2)(cid:12)(cid:11)(cid:4)(cid:14)(cid:11)(cid:48)(cid:48)(cid:7)(cid:5)(cid:3)(cid:9)(cid:2)(cid:28)(cid:3,,3898.0
,,2,,,Unknown,,cid:50)(cid:5)(cid:14)(cid:7)(cid:12)(cid:5)(cid:9)(cid:2)(cid:16)(cid:16)(cid:2)(cid:12)(cid:11)(cid:4)(cid:14)(cid:11)(cid:48)(cid:48)(cid:7)(cid:5)(cid:3)(cid:9)(cid:2)(cid:28)(cid:3,,3900.0
,,44,,,Unknown,,cid:50)(cid:5)(cid:14)(cid:7)(cid:12)(cid:5)(cid:9)(cid:2)(cid:16)(cid:16)(cid:2)(cid:12)(cid:11)(cid:4)(cid:14)(cid:11)(cid:48)(cid:48)(cid:7)(cid:5)(cid:3)(cid:9)(cid:2)(cid:28)(cid:3,,3944.0
,,12,,,Unknown,,cid:50)(cid:5)(cid:14)(cid:7)(cid:12)(cid:5)(cid:9)(cid:2)(cid:16)(cid:16)(cid:2)(cid:12)(cid:11)(cid:4)(cid:14)(cid:11)(cid:48)(cid:48)(cid:7)(cid:5)(cid:3)(cid:9)(cid:2)(cid:28)(cid:3,,3956.0
,,29,,,Unknown,,cid:50)(cid:5)(cid:14)(cid:7)(cid:12)(cid:5)(cid:9)(cid:2)(cid:16)(cid:16)(cid:2)(cid:12)(cid:11)(cid:4)(cid:14)(cid:11)(cid:48)(cid:48)(cid:7)(cid:5)(cid:3)(cid:9)(cid:2)(cid:28)(cid:3,,3985.0
,,26,,,Unknown,,cid:50)(cid:5)(cid:14)(cid:7)(cid:12)(cid:5)(cid:9)(cid:2)(cid:16)(cid:16)(cid:2)(cid:12)(cid:11)(cid:4)(cid:14)(cid:11)(cid:48)(cid:48)(cid:7)(cid:5)(cid:3)(cid:9)(cid:2)(cid:28)(cid:3,,4011.0
,,41,,,Unknown,,cid:50)(cid:5)(cid:14)(cid:7)(cid:12)(cid:5)(cid:9)(cid:2)(cid:16)(cid:16)(cid:2)(cid:12)(cid:11)(cid:4)(cid:14)(cid:11)(cid:48)(cid:48)(cid:7)(cid:5)(cid:3)(cid:9)(cid:2)(cid:28)(cid:3,,4052.0
,,25,,,Unknown,,cid:50)(cid:5)(cid:14)(cid:7)(cid:12)(cid:5)(cid:9)(cid:2)(cid:16)(cid:16)(cid:2)(cid:12)(cid:11)(cid:4)(cid:14)(cid:11)(cid:48)(cid:48)(cid:7)(cid:5)(cid:3)(cid:9)(cid:2)(cid:28)(cid:3,,4077.0
,,2,,,Unknown,,cid:50)(cid:5)(cid:14)(cid:7)(cid:12)(cid:5)(cid:9)(cid:2)(cid:16)(cid:16)(cid:2)(cid:12)(cid:11)(cid:4)(cid:14)(cid:11)(cid:48)(cid:48)(cid:7)(cid:5)(cid:3)(cid:9)(cid:2)(cid:28)(cid:3,,4079.0
,,58,,,Unknown,,cid:50)(cid:5)(cid:14)(cid:7)(cid:12)(cid:5)(cid:9)(cid:2)(cid:16)(cid:16)(cid:2)(cid:12)(cid:11)(cid:4)(cid:14)(cid:11)(cid:48)(cid:48)(cid:7)(cid:5)(cid:3)(cid:9)(cid:2)(cid:28)(cid:3,,4137.0
,,58,,,Unknown,,cid:50)(cid:5)(cid:14)(cid:7)(cid:12)(cid:5)(cid:9)(cid:2)(cid:16)(cid:16)(cid:2)(cid:12)(cid:11)(cid:4)(cid:14)(cid:11)(cid:48)(cid:48)(cid:7)(cid:5)(cid:3)(cid:9)(cid:2)(cid:28)(cid:3,,4195.0
,,18,,,Unknown,,cid:50)(cid:5)(cid:14)(cid:7)(cid:12)(cid:5)(cid:9)(cid:2)(cid:16)(cid:16)(cid:2)(cid:12)(cid:11)(cid:4)(cid:14)(cid:11)(cid:48)(cid:48)(cid:7)(cid:5)(cid:3)(cid:9)(cid:2)(cid:28)(cid:3,,4213.0
,,1,,,Unknown,,cid:50)(cid:5)(cid:14)(cid:7)(cid:12)(cid:5)(cid:9)(cid:2)(cid:16)(cid:16)(cid:2)(cid:12)(cid:11)(cid:4)(cid:14)(cid:11)(cid:48)(cid:48)(cid:7)(cid:5)(cid:3)(cid:9)(cid:2)(cid:28)(cid:3,,4214.0
,,1,,,Unknown,,cid:50)(cid:5)(cid:14)(cid:7)(cid:12)(cid:5)(cid:9)(cid:2)(cid:16)(cid:16)(cid:2)(cid:12)(cid:11)(cid:4)(cid:14)(cid:11)(cid:48)(cid:48)(cid:7)(cid:5)(cid:3)(cid:9)(cid:2)(cid:28)(cid:3,,4215.0
,,37,,,Unknown,,cid:50)(cid:5)(cid:14)(cid:7)(cid:12)(cid:5)(cid:9)(cid:2)(cid:16)(cid:16)(cid:2)(cid:12)(cid:11)(cid:4)(cid:14)(cid:11)(cid:48)(cid:48)(cid:7)(cid:5)(cid:3)(cid:9)(cid:2)(cid:28)(cid:3,,4252.0
,,37,,,Unknown,,cid:50)(cid:5)(cid:14)(cid:7)(cid:12)(cid:5)(cid:9)(cid:2)(cid:16)(cid:16)(cid:2)(cid:12)(cid:11)(cid:4)(cid:14)(cid:11)(cid:48)(cid:48)(cid:7)(cid:5)(cid:3)(cid:9)(cid:2)(cid:28)(cid:3,,4289.0
,,18,,,Unknown,,cid:50)(cid:5)(cid:14)(cid:7)(cid:12)(cid:5)(cid:9)(cid:2)(cid:16)(cid:16)(cid:2)(cid:12)(cid:11)(cid:4)(cid:14)(cid:11)(cid:48)(cid:48)(cid:7)(cid:5)(cid:3)(cid:9)(cid:2)(cid:28)(cid:3,,4307.0
,,45,,,Unknown,,cid:50)(cid:5)(cid:14)(cid:7)(cid:12)(cid:5)(cid:9)(cid:2)(cid:16)(cid:16)(cid:2)(cid:12)(cid:11)(cid:4)(cid:14)(cid:11)(cid:48)(cid:48)(cid:7)(cid:5)(cid:3)(cid:9)(cid:2)(cid:28)(cid:3,,4352.0
,,18,,,Unknown,,cid:50)(cid:5)(cid:14)(cid:7)(cid:12)(cid:5)(cid:9)(cid:2)(cid:16)(cid:16)(cid:2)(cid:12)(cid:11)(cid:4)(cid:14)(cid:11)(cid:48)(cid:48)(cid:7)(cid:5)(cid:3)(cid:9)(cid:2)(cid:28)(cid:3,,4370.0
,,16,,,Unknown,,cid:50)(cid:5)(cid:14)(cid:7)(cid:12)(cid:5)(cid:9)(cid:2)(cid:16)(cid:16)(cid:2)(cid:12)(cid:11)(cid:4)(cid:14)(cid:11)(cid:48)(cid:48)(cid:7)(cid:5)(cid:3)(cid:9)(cid:2)(cid:28)(cid:3,,4386.0
,,10,,,Unknown,,cid:50)(cid:5)(cid:14)(cid:7)(cid:12)(cid:5)(cid:9)(cid:2)(cid:16)(cid:16)(cid:2)(cid:12)(cid:11)(cid:4)(cid:14)(cid:11)(cid:48)(cid:48)(cid:7)(cid:5)(cid:3)(cid:9)(cid:2)(cid:28)(cid:3,,4396.0
,,11,,,Unknown,,cid:50)(cid:5)(cid:14)(cid:7)(cid:12)(cid:5)(cid:9)(cid:2)(cid:16)(cid:16)(cid:2)(cid:12)(cid:11)(cid:4)(cid:14)(cid:11)(cid:48)(cid:48)(cid:7)(cid:5)(cid:3)(cid:9)(cid:2)(cid:28)(cid:3,,4407.0
,,10,,,Unknown,,cid:50)(cid:5)(cid:14)(cid:7)(cid:12)(cid:5)(cid:9)(cid:2)(cid:16)(cid:16)(cid:2)(cid:12)(cid:11)(cid:4)(cid:14)(cid:11)(cid:48)(cid:48)(cid:7)(cid:5)(cid:3)(cid:9)(cid:2)(cid:28)(cid:3,,4417.0
,,46,,,Unknown,,cid:50)(cid:5)(cid:14)(cid:7)(cid:12)(cid:5)(cid:9)(cid:2)(cid:16)(cid:16)(cid:2)(cid:12)(cid:11)(cid:4)(cid:14)(cid:11)(cid:48)(cid:48)(cid:7)(cid:5)(cid:3)(cid:9)(cid:2)(cid:28)(cid:3,,4463.0
,,14,,,Unknown,,cid:50)(cid:5)(cid:14)(cid:7)(cid:12)(cid:5)(cid:9)(cid:2)(cid:16)(cid:16)(cid:2)(cid:12)(cid:11)(cid:4)(cid:14)(cid:11)(cid:48)(cid:48)(cid:7)(cid:5)(cid:3)(cid:9)(cid:2)(cid:28)(cid:3,,4477.0
,,2,,,Unknown,,cid:50)(cid:5)(cid:14)(cid:7)(cid:12)(cid:5)(cid:9)(cid:2)(cid:16)(cid:16)(cid:2)(cid:12)(cid:11)(cid:4)(cid:14)(cid:11)(cid:48)(cid:48)(cid:7)(cid:5)(cid:3)(cid:9)(cid:2)(cid:28)(cid:3,,4479.0
,,12,,,Unknown,,cid:50)(cid:5)(cid:14)(cid:7)(cid:12)(cid:5)(cid:9)(cid:2)(cid:16)(cid:16)(cid:2)(cid:12)(cid:11)(cid:4)(cid:14)(cid:11)(cid:48)(cid:48)(cid:7)(cid:5)(cid:3)(cid:9)(cid:2)(cid:28)(cid:3,,4491.0
,,11,,,Unknown,,cid:50)(cid:5)(cid:14)(cid:7)(cid:12)(cid:5)(cid:9)(cid:2)(cid:16)(cid:16)(cid:2)(cid:12)(cid:11)(cid:4)(cid:14)(cid:11)(cid:48)(cid:48)(cid:7)(cid:5)(cid:3)(cid:9)(cid:2)(cid:28)(cid:3,,4502.0
,,4,,,Unknown,,cid:50)(cid:5)(cid:14)(cid:7)(cid:12)(cid:5)(cid:9)(cid:2)(cid:16)(cid:16)(cid:2)(cid:12)(cid:11)(cid:4)(cid:14)(cid:11)(cid:48)(cid:48)(cid:7)(cid:5)(cid:3)(cid:9)(cid:2)(cid:28)(cid:3,,4506.0
,,14,,,Unknown,,cid:50)(cid:5)(cid:14)(cid:7)(cid:12)(cid:5)(cid:9)(cid:2)(cid:16)(cid:16)(cid:2)(cid:12)(cid:11)(cid:4)(cid:14)(cid:11)(cid:48)(cid:48)(cid:7)(cid:5)(cid:3)(cid:9)(cid:2)(cid:28)(cid:3,,4520.0
,,11,,,Unknown,,cid:50)(cid:5)(cid:14)(cid:7)(cid:12)(cid:5)(cid:9)(cid:2)(cid:16)(cid:16)(cid:2)(cid:12)(cid:11)(cid:4)(cid:14)(cid:11)(cid:48)(cid:48)(cid:7)(cid:5)(cid:3)(cid:9)(cid:2)(cid:28)(cid:3,,4531.0
,,48,,,Unknown,,cid:50)(cid:5)(cid:14)(cid:7)(cid:12)(cid:5)(cid:9)(cid:2)(cid:16)(cid:16)(cid:2)(cid:12)(cid:11)(cid:4)(cid:14)(cid:11)(cid:48)(cid:48)(cid:7)(cid:5)(cid:3)(cid:9)(cid:2)(cid:28)(cid:3,,4579.0
,,48,,,Unknown,,cid:50)(cid:5)(cid:14)(cid:7)(cid:12)(cid:5)(cid:9)(cid:2)(cid:16)(cid:16)(cid:2)(cid:12)(cid:11)(cid:4)(cid:14)(cid:11)(cid:48)(cid:48)(cid:7)(cid:5)(cid:3)(cid:9)(cid:2)(cid:28)(cid:3,,4627.0
,,7,,,Unknown,,cid:50)(cid:5)(cid:14)(cid:7)(cid:12)(cid:5)(cid:9)(cid:2)(cid:16)(cid:16)(cid:2)(cid:12)(cid:11)(cid:4)(cid:14)(cid:11)(cid:48)(cid:48)(cid:7)(cid:5)(cid:3)(cid:9)(cid:2)(cid:28)(cid:3,,4634.0
,,5,,,Unknown,,cid:50)(cid:5)(cid:14)(cid:7)(cid:12)(cid:5)(cid:9)(cid:2)(cid:16)(cid:16)(cid:2)(cid:12)(cid:11)(cid:4)(cid:14)(cid:11)(cid:48)(cid:48)(cid:7)(cid:5)(cid:3)(cid:9)(cid:2)(cid:28)(cid:3,,4639.0
,,3,,,Unknown,,cid:50)(cid:5)(cid:14)(cid:7)(cid:12)(cid:5)(cid:9)(cid:2)(cid:16)(cid:16)(cid:2)(cid:12)(cid:11)(cid:4)(cid:14)(cid:11)(cid:48)(cid:48)(cid:7)(cid:5)(cid:3)(cid:9)(cid:2)(cid:28)(cid:3,,4642.0
,,9,,,Unknown,,cid:50)(cid:5)(cid:14)(cid:7)(cid:12)(cid:5)(cid:9)(cid:2)(cid:16)(cid:16)(cid:2)(cid:12)(cid:11)(cid:4)(cid:14)(cid:11)(cid:48)(cid:48)(cid:7)(cid:5)(cid:3)(cid:9)(cid:2)(cid:28)(cid:3,,4651.0
,,2,,,Unknown,,cid:50)(cid:5)(cid:14)(cid:7)(cid:12)(cid:5)(cid:9)(cid:2)(cid:16)(cid:16)(cid:2)(cid:12)(cid:11)(cid:4)(cid:14)(cid:11)(cid:48)(cid:48)(cid:7)(cid:5)(cid:3)(cid:9)(cid:2)(cid:28)(cid:3,,4653.0
,,28,,,Unknown,,cid:50)(cid:5)(cid:14)(cid:7)(cid:12)(cid:5)(cid:9)(cid:2)(cid:16)(cid:16)(cid:2)(cid:12)(cid:11)(cid:4)(cid:14)(cid:11)(cid:48)(cid:48)(cid:7)(cid:5)(cid:3)(cid:9)(cid:2)(cid:28)(cid:3,,4681.0
,,3,,,Unknown,,cid:50)(cid:5)(cid:14)(cid:7)(cid:12)(cid:5)(cid:9)(cid:2)(cid:16)(cid:16)(cid:2)(cid:12)(cid:11)(cid:4)(cid:14)(cid:11)(cid:48)(cid:48)(cid:7)(cid:5)(cid:3)(cid:9)(cid:2)(cid:28)(cid:3,,4684.0
,,15,,,Unknown,,cid:50)(cid:5)(cid:14)(cid:7)(cid:12)(cid:5)(cid:9)(cid:2)(cid:16)(cid:16)(cid:2)(cid:12)(cid:11)(cid:4)(cid:14)(cid:11)(cid:48)(cid:48)(cid:7)(cid:5)(cid:3)(cid:9)(cid:2)(cid:28)(cid:3,,4699.0
,,2,,,Unknown,,cid:50)(cid:5)(cid:14)(cid:7)(cid:12)(cid:5)(cid:9)(cid:2)(cid:16)(cid:16)(cid:2)(cid:12)(cid:11)(cid:4)(cid:14)(cid:11)(cid:48)(cid:48)(cid:7)(cid:5)(cid:3)(cid:9)(cid:2)(cid:28)(cid:3,,4701.0
,,36,,,Unknown,,cid:50)(cid:5)(cid:14)(cid:7)(cid:12)(cid:5)(cid:9)(cid:2)(cid:16)(cid:16)(cid:2)(cid:12)(cid:11)(cid:4)(cid:14)(cid:11)(cid:48)(cid:48)(cid:7)(cid:5)(cid:3)(cid:9)(cid:2)(cid:28)(cid:3,,4737.0
,,18,,,Unknown,,cid:50)(cid:5)(cid:14)(cid:7)(cid:12)(cid:5)(cid:9)(cid:2)(cid:16)(cid:16)(cid:2)(cid:12)(cid:11)(cid:4)(cid:14)(cid:11)(cid:48)(cid:48)(cid:7)(cid:5)(cid:3)(cid:9)(cid:2)(cid:28)(cid:3,,4755.0
,,19,,,Unknown,,cid:50)(cid:5)(cid:14)(cid:7)(cid:12)(cid:5)(cid:9)(cid:2)(cid:16)(cid:16)(cid:2)(cid:12)(cid:11)(cid:4)(cid:14)(cid:11)(cid:48)(cid:48)(cid:7)(cid:5)(cid:3)(cid:9)(cid:2)(cid:28)(cid:3,,4774.0
,,18,,,Unknown,,cid:50)(cid:5)(cid:14)(cid:7)(cid:12)(cid:5)(cid:9)(cid:2)(cid:16)(cid:16)(cid:2)(cid:12)(cid:11)(cid:4)(cid:14)(cid:11)(cid:48)(cid:48)(cid:7)(cid:5)(cid:3)(cid:9)(cid:2)(cid:28)(cid:3,,4792.0
,,1,,,Unknown,,cid:50)(cid:5)(cid:14)(cid:7)(cid:12)(cid:5)(cid:9)(cid:2)(cid:16)(cid:16)(cid:2)(cid:12)(cid:11)(cid:4)(cid:14)(cid:11)(cid:48)(cid:48)(cid:7)(cid:5)(cid:3)(cid:9)(cid:2)(cid:28)(cid:3,,4793.0
,,2,,,Unknown,,cid:50)(cid:5)(cid:14)(cid:7)(cid:12)(cid:5)(cid:9)(cid:2)(cid:16)(cid:16)(cid:2)(cid:12)(cid:11)(cid:4)(cid:14)(cid:11)(cid:48)(cid:48)(cid:7)(cid:5)(cid:3)(cid:9)(cid:2)(cid:28)(cid:3,,4795.0
,,44,,,Unknown,,cid:50)(cid:5)(cid:14)(cid:7)(cid:12)(cid:5)(cid:9)(cid:2)(cid:16)(cid:16)(cid:2)(cid:12)(cid:11)(cid:4)(cid:14)(cid:11)(cid:48)(cid:48)(cid:7)(cid:5)(cid:3)(cid:9)(cid:2)(cid:28)(cid:3,,4839.0
,,12,,,Unknown,,cid:50)(cid:5)(cid:14)(cid:7)(cid:12)(cid:5)(cid:9)(cid:2)(cid:16)(cid:16)(cid:2)(cid:12)(cid:11)(cid:4)(cid:14)(cid:11)(cid:48)(cid:48)(cid:7)(cid:5)(cid:3)(cid:9)(cid:2)(cid:28)(cid:3,,4851.0
,,29,,,Unknown,,cid:50)(cid:5)(cid:14)(cid:7)(cid:12)(cid:5)(cid:9)(cid:2)(cid:16)(cid:16)(cid:2)(cid:12)(cid:11)(cid:4)(cid:14)(cid:11)(cid:48)(cid:48)(cid:7)(cid:5)(cid:3)(cid:9)(cid:2)(cid:28)(cid:3,,4880.0
,,26,,,Unknown,,cid:50)(cid:5)(cid:14)(cid:7)(cid:12)(cid:5)(cid:9)(cid:2)(cid:16)(cid:16)(cid:2)(cid:12)(cid:11)(cid:4)(cid:14)(cid:11)(cid:48)(cid:48)(cid:7)(cid:5)(cid:3)(cid:9)(cid:2)(cid:28)(cid:3,,4906.0
,,41,,,Unknown,,cid:50)(cid:5)(cid:14)(cid:7)(cid:12)(cid:5)(cid:9)(cid:2)(cid:16)(cid:16)(cid:2)(cid:12)(cid:11)(cid:4)(cid:14)(cid:11)(cid:48)(cid:48)(cid:7)(cid:5)(cid:3)(cid:9)(cid:2)(cid:28)(cid:3,,4947.0
,,25,,,Unknown,,cid:50)(cid:5)(cid:14)(cid:7)(cid:12)(cid:5)(cid:9)(cid:2)(cid:16)(cid:16)(cid:2)(cid:12)(cid:11)(cid:4)(cid:14)(cid:11)(cid:48)(cid:48)(cid:7)(cid:5)(cid:3)(cid:9)(cid:2)(cid:28)(cid:3,,4972.0
,,2,,,Unknown,,cid:50)(cid:5)(cid:14)(cid:7)(cid:12)(cid:5)(cid:9)(cid:2)(cid:16)(cid:16)(cid:2)(cid:12)(cid:11)(cid:4)(cid:14)(cid:11)(cid:48)(cid:48)(cid:7)(cid:5)(cid:3)(cid:9)(cid:2)(cid:28)(cid:3,,4974.0
,,58,,,Unknown,,cid:50)(cid:5)(cid:14)(cid:7)(cid:12)(cid:5)(cid:9)(cid:2)(cid:16)(cid:16)(cid:2)(cid:12)(cid:11)(cid:4)(cid:14)(cid:11)(cid:48)(cid:48)(cid:7)(cid:5)(cid:3)(cid:9)(cid:2)(cid:28)(cid:3,,5032.0
,,58,,,Unknown,,cid:50)(cid:5)(cid:14)(cid:7)(cid:12)(cid:5)(cid:9)(cid:2)(cid:16)(cid:16)(cid:2)(cid:12)(cid:11)(cid:4)(cid:14)(cid:11)(cid:48)(cid:48)(cid:7)(cid:5)(cid:3)(cid:9)(cid:2)(cid:28)(cid:3,,5090.0
,,18,,,Unknown,,cid:50)(cid:5)(cid:14)(cid:7)(cid:12)(cid:5)(cid:9)(cid:2)(cid:16)(cid:16)(cid:2)(cid:12)(cid:11)(cid:4)(cid:14)(cid:11)(cid:48)(cid:48)(cid:7)(cid:5)(cid:3)(cid:9)(cid:2)(cid:28)(cid:3,,5108.0
,,1,,,Unknown,,cid:50)(cid:5)(cid:14)(cid:7)(cid:12)(cid:5)(cid:9)(cid:2)(cid:16)(cid:16)(cid:2)(cid:12)(cid:11)(cid:4)(cid:14)(cid:11)(cid:48)(cid:48)(cid:7)(cid:5)(cid:3)(cid:9)(cid:2)(cid:28)(cid:3,,5109.0
,,1,,,Unknown,,cid:50)(cid:5)(cid:14)(cid:7)(cid:12)(cid:5)(cid:9)(cid:2)(cid:16)(cid:16)(cid:2)(cid:12)(cid:11)(cid:4)(cid:14)(cid:11)(cid:48)(cid:48)(cid:7)(cid:5)(cid:3)(cid:9)(cid:2)(cid:28)(cid:3,,5110.0
,,37,,,Unknown,,cid:50)(cid:5)(cid:14)(cid:7)(cid:12)(cid:5)(cid:9)(cid:2)(cid:16)(cid:16)(cid:2)(cid:12)(cid:11)(cid:4)(cid:14)(cid:11)(cid:48)(cid:48)(cid:7)(cid:5)(cid:3)(cid:9)(cid:2)(cid:28)(cid:3,,5147.0
,,37,,,Unknown,,cid:50)(cid:5)(cid:14)(cid:7)(cid:12)(cid:5)(cid:9)(cid:2)(cid:16)(cid:16)(cid:2)(cid:12)(cid:11)(cid:4)(cid:14)(cid:11)(cid:48)(cid:48)(cid:7)(cid:5)(cid:3)(cid:9)(cid:2)(cid:28)(cid:3,,5184.0
,,17,,,Unknown,,cid:50)(cid:5)(cid:14)(cid:7)(cid:12)(cid:5)(cid:9)(cid:2)(cid:16)(cid:16)(cid:2)(cid:12)(cid:11)(cid:4)(cid:14)(cid:11)(cid:48)(cid:48)(cid:7)(cid:5)(cid:3)(cid:9)(cid:2)(cid:28)(cid:3,,5201.0
,,45,,,Unknown,,cid:50)(cid:5)(cid:14)(cid:7)(cid:12)(cid:5)(cid:9)(cid:2)(cid:16)(cid:16)(cid:2)(cid:12)(cid:11)(cid:4)(cid:14)(cid:11)(cid:48)(cid:48)(cid:7)(cid:5)(cid:3)(cid:9)(cid:2)(cid:28)(cid:3,,5246.0
,,18,,,Unknown,,cid:50)(cid:5)(cid:14)(cid:7)(cid:12)(cid:5)(cid:9)(cid:2)(cid:16)(cid:16)(cid:2)(cid:12)(cid:11)(cid:4)(cid:14)(cid:11)(cid:48)(cid:48)(cid:7)(cid:5)(cid:3)(cid:9)(cid:2)(cid:28)(cid:3,,5264.0
,,16,,,Unknown,,cid:50)(cid:5)(cid:14)(cid:7)(cid:12)(cid:5)(cid:9)(cid:2)(cid:16)(cid:16)(cid:2)(cid:12)(cid:11)(cid:4)(cid:14)(cid:11)(cid:48)(cid:48)(cid:7)(cid:5)(cid:3)(cid:9)(cid:2)(cid:28)(cid:3,,5280.0
,,10,,,Unknown,,cid:50)(cid:5)(cid:14)(cid:7)(cid:12)(cid:5)(cid:9)(cid:2)(cid:16)(cid:16)(cid:2)(cid:12)(cid:11)(cid:4)(cid:14)(cid:11)(cid:48)(cid:48)(cid:7)(cid:5)(cid:3)(cid:9)(cid:2)(cid:28)(cid:3,,5290.0
,,11,,,Unknown,,cid:50)(cid:5)(cid:14)(cid:7)(cid:12)(cid:5)(cid:9)(cid:2)(cid:16)(cid:16)(cid:2)(cid:12)(cid:11)(cid:4)(cid:14)(cid:11)(cid:48)(cid:48)(cid:7)(cid:5)(cid:3)(cid:9)(cid:2)(cid:28)(cid:3,,5301.0
,,10,,,Unknown,,cid:50)(cid:5)(cid:14)(cid:7)(cid:12)(cid:5)(cid:9)(cid:2)(cid:16)(cid:16)(cid:2)(cid:12)(cid:11)(cid:4)(cid:14)(cid:11)(cid:48)(cid:48)(cid:7)(cid:5)(cid:3)(cid:9)(cid:2)(cid:28)(cid:3,,5311.0
,,46,,,Unknown,,cid:50)(cid:5)(cid:14)(cid:7)(cid:12)(cid:5)(cid:9)(cid:2)(cid:16)(cid:16)(cid:2)(cid:12)(cid:11)(cid:4)(cid:14)(cid:11)(cid:48)(cid:48)(cid:7)(cid:5)(cid:3)(cid:9)(cid:2)(cid:28)(cid:3,,5357.0
,,14,,,Unknown,,cid:50)(cid:5)(cid:14)(cid:7)(cid:12)(cid:5)(cid:9)(cid:2)(cid:16)(cid:16)(cid:2)(cid:12)(cid:11)(cid:4)(cid:14)(cid:11)(cid:48)(cid:48)(cid:7)(cid:5)(cid:3)(cid:9)(cid:2)(cid:28)(cid:3,,5371.0
,,2,,,Unknown,,cid:50)(cid:5)(cid:14)(cid:7)(cid:12)(cid:5)(cid:9)(cid:2)(cid:16)(cid:16)(cid:2)(cid:12)(cid:11)(cid:4)(cid:14)(cid:11)(cid:48)(cid:48)(cid:7)(cid:5)(cid:3)(cid:9)(cid:2)(cid:28)(cid:3,,5373.0
,,12,,,Unknown,,cid:50)(cid:5)(cid:14)(cid:7)(cid:12)(cid:5)(cid:9)(cid:2)(cid:16)(cid:16)(cid:2)(cid:12)(cid:11)(cid:4)(cid:14)(cid:11)(cid:48)(cid:48)(cid:7)(cid:5)(cid:3)(cid:9)(cid:2)(cid:28)(cid:3,,5385.0
,,11,,,Unknown,,cid:50)(cid:5)(cid:14)(cid:7)(cid:12)(cid:5)(cid:9)(cid:2)(cid:16)(cid:16)(cid:2)(cid:12)(cid:11)(cid:4)(cid:14)(cid:11)(cid:48)(cid:48)(cid:7)(cid:5)(cid:3)(cid:9)(cid:2)(cid:28)(cid:3,,5396.0
,,4,,,Unknown,,cid:50)(cid:5)(cid:14)(cid:7)(cid:12)(cid:5)(cid:9)(cid:2)(cid:16)(cid:16)(cid:2)(cid:12)(cid:11)(cid:4)(cid:14)(cid:11)(cid:48)(cid:48)(cid:7)(cid:5)(cid:3)(cid:9)(cid:2)(cid:28)(cid:3,,5400.0
,,14,,,Unknown,,cid:50)(cid:5)(cid:14)(cid:7)(cid:12)(cid:5)(cid:9)(cid:2)(cid:16)(cid:16)(cid:2)(cid:12)(cid:11)(cid:4)(cid:14)(cid:11)(cid:48)(cid:48)(cid:7)(cid:5)(cid:3)(cid:9)(cid:2)(cid:28)(cid:3,,5414.0
,,11,,,Unknown,,cid:50)(cid:5)(cid:14)(cid:7)(cid:12)(cid:5)(cid:9)(cid:2)(cid:16)(cid:16)(cid:2)(cid:12)(cid:11)(cid:4)(cid:14)(cid:11)(cid:48)(cid:48)(cid:7)(cid:5)(cid:3)(cid:9)(cid:2)(cid:28)(cid:3,,5425.0
,,48,,,Unknown,,cid:50)(cid:5)(cid:14)(cid:7)(cid:12)(cid:5)(cid:9)(cid:2)(cid:16)(cid:16)(cid:2)(cid:12)(cid:11)(cid:4)(cid:14)(cid:11)(cid:48)(cid:48)(cid:7)(cid:5)(cid:3)(cid:9)(cid:2)(cid:28)(cid:3,,5473.0
,,48,,,Unknown,,cid:50)(cid:5)(cid:14)(cid:7)(cid:12)(cid:5)(cid:9)(cid:2)(cid:16)(cid:16)(cid:2)(cid:12)(cid:11)(cid:4)(cid:14)(cid:11)(cid:48)(cid:48)(cid:7)(cid:5)(cid:3)(cid:9)(cid:2)(cid:28)(cid:3,,5521.0
,,7,,,Unknown,,cid:50)(cid:5)(cid:14)(cid:7)(cid:12)(cid:5)(cid:9)(cid:2)(cid:16)(cid:16)(cid:2)(cid:12)(cid:11)(cid:4)(cid:14)(cid:11)(cid:48)(cid:48)(cid:7)(cid:5)(cid:3)(cid:9)(cid:2)(cid:28)(cid:3,,5528.0
,,5,,,Unknown,,cid:50)(cid:5)(cid:14)(cid:7)(cid:12)(cid:5)(cid:9)(cid:2)(cid:16)(cid:16)(cid:2)(cid:12)(cid:11)(cid:4)(cid:14)(cid:11)(cid:48)(cid:48)(cid:7)(cid:5)(cid:3)(cid:9)(cid:2)(cid:28)(cid:3,,5533.0
,,3,,,Unknown,,cid:50)(cid:5)(cid:14)(cid:7)(cid:12)(cid:5)(cid:9)(cid:2)(cid:16)(cid:16)(cid:2)(cid:12)(cid:11)(cid:4)(cid:14)(cid:11)(cid:48)(cid:48)(cid:7)(cid:5)(cid:3)(cid:9)(cid:2)(cid:28)(cid:3,,5536.0
,,9,,,Unknown,,cid:50)(cid:5)(cid:14)(cid:7)(cid:12)(cid:5)(cid:9)(cid:2)(cid:16)(cid:16)(cid:2)(cid:12)(cid:11)(cid:4)(cid:14)(cid:11)(cid:48)(cid:48)(cid:7)(cid:5)(cid:3)(cid:9)(cid:2)(cid:28)(cid:3,,5545.0
,,2,,,Unknown,,cid:50)(cid:5)(cid:14)(cid:7)(cid:12)(cid:5)(cid:9)(cid:2)(cid:16)(cid:16)(cid:2)(cid:12)(cid:11)(cid:4)(cid:14)(cid:11)(cid:48)(cid:48)(cid:7)(cid:5)(cid:3)(cid:9)(cid:2)(cid:28)(cid:3,,5547.0
,,28,,,Unknown,,cid:50)(cid:5)(cid:14)(cid:7)(cid:12)(cid:5)(cid:9)(cid:2)(cid:16)(cid:16)(cid:2)(cid:12)(cid:11)(cid:4)(cid:14)(cid:11)(cid:48)(cid:48)(cid:7)(cid:5)(cid:3)(cid:9)(cid:2)(cid:28)(cid:3,,5575.0
,,3,,,Unknown,,cid:50)(cid:5)(cid:14)(cid:7)(cid:12)(cid:5)(cid:9)(cid:2)(cid:16)(cid:16)(cid:2)(cid:12)(cid:11)(cid:4)(cid:14)(cid:11)(cid:48)(cid:48)(cid:7)(cid:5)(cid:3)(cid:9)(cid:2)(cid:28)(cid:3,,5578.0
,,15,,,Unknown,,cid:50)(cid:5)(cid:14)(cid:7)(cid:12)(cid:5)(cid:9)(cid:2)(cid:16)(cid:16)(cid:2)(cid:12)(cid:11)(cid:4)(cid:14)(cid:11)(cid:48)(cid:48)(cid:7)(cid:5)(cid:3)(cid:9)(cid:2)(cid:28)(cid:3,,5593.0
,,2,,,Unknown,,cid:50)(cid:5)(cid:14)(cid:7)(cid:12)(cid:5)(cid:9)(cid:2)(cid:16)(cid:16)(cid:2)(cid:12)(cid:11)(cid:4)(cid:14)(cid:11)(cid:48)(cid:48)(cid:7)(cid:5)(cid:3)(cid:9)(cid:2)(cid:28)(cid:3,,5595.0
,,34,,,Unknown,,cid:50)(cid:5)(cid:14)(cid:7)(cid:12)(cid:5)(cid:9)(cid:2)(cid:16)(cid:16)(cid:2)(cid:12)(cid:11)(cid:4)(cid:14)(cid:11)(cid:48)(cid:48)(cid:7)(cid:5)(cid:3)(cid:9)(cid:2)(cid:28)(cid:3,,5629.0
,,18,,,Unknown,,cid:50)(cid:5)(cid:14)(cid:7)(cid:12)(cid:5)(cid:9)(cid:2)(cid:16)(cid:16)(cid:2)(cid:12)(cid:11)(cid:4)(cid:14)(cid:11)(cid:48)(cid:48)(cid:7)(cid:5)(cid:3)(cid:9)(cid:2)(cid:28)(cid:3,,5647.0
,,19,,,Unknown,,cid:50)(cid:5)(cid:14)(cid:7)(cid:12)(cid:5)(cid:9)(cid:2)(cid:16)(cid:16)(cid:2)(cid:12)(cid:11)(cid:4)(cid:14)(cid:11)(cid:48)(cid:48)(cid:7)(cid:5)(cid:3)(cid:9)(cid:2)(cid:28)(cid:3,,5666.0
,,18,,,Unknown,,cid:50)(cid:5)(cid:14)(cid:7)(cid:12)(cid:5)(cid:9)(cid:2)(cid:16)(cid:16)(cid:2)(cid:12)(cid:11)(cid:4)(cid:14)(cid:11)(cid:48)(cid:48)(cid:7)(cid:5)(cid:3)(cid:9)(cid:2)(cid:28)(cid:3,,5684.0
,,17,,,Unknown,,cid:50)(cid:5)(cid:14)(cid:7)(cid:12)(cid:5)(cid:9)(cid:2)(cid:16)(cid:16)(cid:2)(cid:12)(cid:11)(cid:4)(cid:14)(cid:11)(cid:48)(cid:48)(cid:7)(cid:5)(cid:3)(cid:9)(cid:2)(cid:28)(cid:3,,5701.0
,,2,,,Unknown,,cid:50)(cid:5)(cid:14)(cid:7)(cid:12)(cid:5)(cid:9)(cid:2)(cid:16)(cid:16)(cid:2)(cid:12)(cid:11)(cid:4)(cid:14)(cid:11)(cid:48)(cid:48)(cid:7)(cid:5)(cid:3)(cid:9)(cid:2)(cid:28)(cid:3,,5703.0
,,44,,,Unknown,,cid:50)(cid:5)(cid:14)(cid:7)(cid:12)(cid:5)(cid:9)(cid:2)(cid:16)(cid:16)(cid:2)(cid:12)(cid:11)(cid:4)(cid:14)(cid:11)(cid:48)(cid:48)(cid:7)(cid:5)(cid:3)(cid:9)(cid:2)(cid:28)(cid:3,,5747.0
,,12,,,Unknown,,cid:50)(cid:5)(cid:14)(cid:7)(cid:12)(cid:5)(cid:9)(cid:2)(cid:16)(cid:16)(cid:2)(cid:12)(cid:11)(cid:4)(cid:14)(cid:11)(cid:48)(cid:48)(cid:7)(cid:5)(cid:3)(cid:9)(cid:2)(cid:28)(cid:3,,5759.0
,,29,,,Unknown,,cid:50)(cid:5)(cid:14)(cid:7)(cid:12)(cid:5)(cid:9)(cid:2)(cid:16)(cid:16)(cid:2)(cid:12)(cid:11)(cid:4)(cid:14)(cid:11)(cid:48)(cid:48)(cid:7)(cid:5)(cid:3)(cid:9)(cid:2)(cid:28)(cid:3,,5788.0
,,26,,,Unknown,,cid:50)(cid:5)(cid:14)(cid:7)(cid:12)(cid:5)(cid:9)(cid:2)(cid:16)(cid:16)(cid:2)(cid:12)(cid:11)(cid:4)(cid:14)(cid:11)(cid:48)(cid:48)(cid:7)(cid:5)(cid:3)(cid:9)(cid:2)(cid:28)(cid:3,,5814.0
,,41,,,Unknown,,cid:50)(cid:5)(cid:14)(cid:7)(cid:12)(cid:5)(cid:9)(cid:2)(cid:16)(cid:16)(cid:2)(cid:12)(cid:11)(cid:4)(cid:14)(cid:11)(cid:48)(cid:48)(cid:7)(cid:5)(cid:3)(cid:9)(cid:2)(cid:28)(cid:3,,5855.0
,,25,,,Unknown,,cid:50)(cid:5)(cid:14)(cid:7)(cid:12)(cid:5)(cid:9)(cid:2)(cid:16)(cid:16)(cid:2)(cid:12)(cid:11)(cid:4)(cid:14)(cid:11)(cid:48)(cid:48)(cid:7)(cid:5)(cid:3)(cid:9)(cid:2)(cid:28)(cid:3,,5880.0
,,2,,,Unknown,,cid:50)(cid:5)(cid:14)(cid:7)(cid:12)(cid:5)(cid:9)(cid:2)(cid:16)(cid:16)(cid:2)(cid:12)(cid:11)(cid:4)(cid:14)(cid:11)(cid:48)(cid:48)(cid:7)(cid:5)(cid:3)(cid:9)(cid:2)(cid:28)(cid:3,,5882.0
,,58,,,Unknown,,cid:50)(cid:5)(cid:14)(cid:7)(cid:12)(cid:5)(cid:9)(cid:2)(cid:16)(cid:16)(cid:2)(cid:12)(cid:11)(cid:4)(cid:14)(cid:11)(cid:48)(cid:48)(cid:7)(cid:5)(cid:3)(cid:9)(cid:2)(cid:28)(cid:3,,5940.0
,,58,,,Unknown,,cid:50)(cid:5)(cid:14)(cid:7)(cid:12)(cid:5)(cid:9)(cid:2)(cid:16)(cid:16)(cid:2)(cid:12)(cid:11)(cid:4)(cid:14)(cid:11)(cid:48)(cid:48)(cid:7)(cid:5)(cid:3)(cid:9)(cid:2)(cid:28)(cid:3,,5998.0
,,37,,,Unknown,,cid:50)(cid:5)(cid:14)(cid:7)(cid:12)(cid:5)(cid:9)(cid:2)(cid:16)(cid:16)(cid:2)(cid:12)(cid:11)(cid:4)(cid:14)(cid:11)(cid:48)(cid:48)(cid:7)(cid:5)(cid:3)(cid:9)(cid:2)(cid:28)(cid:3,,6035.0
,,16,,,Unknown,,cid:50)(cid:5)(cid:14)(cid:7)(cid:12)(cid:5)(cid:9)(cid:2)(cid:16)(cid:16)(cid:2)(cid:12)(cid:11)(cid:4)(cid:14)(cid:11)(cid:48)(cid:48)(cid:7)(cid:5)(cid:3)(cid:9)(cid:2)(cid:28)(cid:3,,6051.0
,,34,,,Unknown,,cid:50)(cid:5)(cid:14)(cid:7)(cid:12)(cid:5)(cid:9)(cid:2)(cid:16)(cid:16)(cid:2)(cid:12)(cid:11)(cid:4)(cid:14)(cid:11)(cid:48)(cid:48)(cid:7)(cid:5)(cid:3)(cid:9)(cid:2)(cid:28)(cid:3,,6085.0
,,33,,,Unknown,,cid:50)(cid:5)(cid:14)(cid:7)(cid:12)(cid:5)(cid:9)(cid:2)(cid:16)(cid:16)(cid:2)(cid:12)(cid:11)(cid:4)(cid:14)(cid:11)(cid:48)(cid:48)(cid:7)(cid:5)(cid:3)(cid:9)(cid:2)(cid:28)(cid:3,,6118.0
01/06/2021,,04,,,Unknown,,INTERMARCHE,MC DONALD'S COULOMMIER,4.0
30/06/2021,,06,,,Unknown,,INTERMARCHE,CAFE DE,10.0
,,"42,65",,,Unknown,,INTERMARCHE,FRANCE,4275.0
,,04,,,Unknown,,INTERMARCHE,ETABUISSEMENTS TONY,4279.0
,,06,,,Unknown,,INTERMARCHE,lahaye,4285.0
,,"48,80",,,Unknown,,INTERMARCHE,TEMPLIERS,9165.0
,,04,,,Unknown,,INTERMARCHE,SAGEB PKG,9169.0
,,06,,,Unknown,,INTERMARCHE,VEDE,9175.0
,,"9,76",,,Unknown,,INTERMARCHE,CAFE DE,10151.0
,,05,,,Unknown,,INTERMARCHE,Gaucher,10156.0
,,06,,,Unknown,,INTERMARCHE,EG BP SUBWAY BONDY,10162.0
,,"1,80",,,Unknown,,INTERMARCHE,bini,10342.0
,,05,,,Unknown,,INTERMARCHE,TEMPLIERS,10347.0
,,06,,,Unknown,,INTERMARCHE,CAFE DE,10353.0
,,"50,01",,,Unknown,,INTERMARCHE,ECU LA FERTE,15354.0
,,07,,,Unknown,,INTERMARCHE,EGB,15361.0
,,06,,,Unknown,,INTERMARCHE,,15367.0
,,302,,,Unknown,,INTERMARCHE,,15669.0
,,"58 902,21",,,Unknown,,INTERMARCHE,,5905890.0
,,07,,,Unknown,,INTERMARCHE,,5905897.0
,,06,,,Unknown,,INTERMARCHE,,5905903.0
,,"28 760,00",,,Unknown,,INTERMARCHE,,8781903.0
,,07,,,Unknown,,INTERMARCHE,,8781910.0
,,06,,,Unknown,,INTERMARCHE,,8781916.0
,,"20,30",,,Unknown,,INTERMARCHE,,8783946.0
,,07,,,Unknown,,INTERMARCHE,,8783953.0
,,06,,,Unknown,,INTERMARCHE,,8783959.0
,,"41,35",,,Unknown,,INTERMARCHE,,8788094.0
,,07,,,Unknown,,INTERMARCHE,,8788101.0
,,06,,,Unknown,,INTERMARCHE,,8788107.0
,,"38,50",,,Unknown,,INTERMARCHE,,8791957.0
,,07,,,Unknown,,INTERMARCHE,,8791964.0
,,06,,,Unknown,,INTERMARCHE,,8791970.0
,,"28,79",,,Unknown,,INTERMARCHE,,8794849.0
,,07,,,Unknown,,INTERMARCHE,,8794856.0
,,06,,,Unknown,,INTERMARCHE,,8794862.0
,,"2,00",,,Unknown,,INTERMARCHE,,8795062.0
,,07,,,Unknown,,INTERMARCHE,,8795069.0
,,06,,,Unknown,,INTERMARCHE,,8795075.0
,,"23,90",,,Unknown,,INTERMARCHE,,8797465.0
,,07,,,Unknown,,INTERMARCHE,,8797472.0
,,06,,,Unknown,,INTERMARCHE,,8797478.0
,,"12,10",,,Unknown,,INTERMARCHE,,8798688.0
,,08,,,Unknown,,INTERMARCHE,,8798696.0
,,06,,,Unknown,,INTERMARCHE,,8798702.0
,,"38,40",,,Unknown,,INTERMARCHE,,8802542.0
,,08,,,Unknown,,INTERMARCHE,,8802550.0
,,06,,,Unknown,,INTERMARCHE,,8802556.0
,,"8,77",,,Unknown,,INTERMARCHE,,8803433.0
,,08,,,Unknown,,INTERMARCHE,,8803441.0
,,06,,,Unknown,,INTERMARCHE,,8803447.0
,,"96,74",,,Unknown,,INTERMARCHE,,8813121.0
,,08,,,Unknown,,INTERMARCHE,,8813129.0
,,06,,,Unknown,,INTERMARCHE,,8813135.0
,,"11,20",,,Unknown,,INTERMARCHE,,8814255.0
,,08,,,Unknown,,INTERMARCHE,,8814263.0
,,06,,,Unknown,,INTERMARCHE,,8814269.0
,,"3,80",,,Unknown,,INTERMARCHE,,8814649.0
,,08,,,Unknown,,INTERMARCHE,,8814657.0
,,06,,,Unknown,,INTERMARCHE,,8814663.0
,,"60,28",,,Unknown,,INTERMARCHE,,8820691.0
,,09,,,Unknown,,INTERMARCHE,,8820700.0
,,06,,,Unknown,,INTERMARCHE,,8820706.0
,,"10 000,00",,,Unknown,,INTERMARCHE,,9820706.0
,,09,,,Unknown,,INTERMARCHE,,9820715.0
,,06,,,Unknown,,INTERMARCHE,,9820721.0
,,"13,20",,,Unknown,,INTERMARCHE,,9822041.0
,,09,,,Unknown,,INTERMARCHE,,9822050.0
,,06,,,Unknown,,INTERMARCHE,,9822056.0
,,"25,30",,,Unknown,,INTERMARCHE,,9824586.0
,,09,,,Unknown,,INTERMARCHE,,9824595.0
,,06,,,Unknown,,INTERMARCHE,,9824601.0
,,"25,05",,,Unknown,,INTERMARCHE,,9827106.0
,,09,,,Unknown,,INTERMARCHE,,9827115.0
,,06,,,Unknown,,INTERMARCHE,,9827121.0
,,"100,00",,,Unknown,,INTERMARCHE,,9837121.0
,,01,,,Unknown,,INTERMARCHE,,9837122.0
,,06,,,Unknown,,INTERMARCHE,,9837128.0
,,30,,,Unknown,,INTERMARCHE,,9837158.0
,,06,,,Unknown,,INTERMARCHE,,9837164.0
,,205,,,Unknown,,INTERMARCHE,,9837369.0
,,2,,,Unknown,,INTERMARCHE,,9837371.0
,,5,,,Unknown,,INTERMARCHE,,9837376.0
01/06/2021,,09,,,POS,,Coulommiers FR,SARL KPA MARKET COULOMMIERS FR,9.0
30/06/2021,,06,,,POS,,Coulommiers FR,P072205253,15.0
,,"31,73",,,POS,,Coulommiers FR,SANEF AUTOROUTE,3188.0
,,10,,,POS,,Coulommiers FR,LECLERC,3198.0
,,06,,,POS,,Coulommiers FR,COULOMMIERS FR,3204.0
,,"66,98",,,POS,,Coulommiers FR,COULOMMIERS FR,9902.0
,,10,,,POS,,Coulommiers FR,SARL KPA MARKET,9912.0
,,06,,,POS,,Coulommiers FR,CAFE DE,9918.0
,,15,,,POS,,Coulommiers FR,ECU LA FERTE,9933.0
,,00,,,POS,,Coulommiers FR,LECLERC,9933.0
,,11,,,POS,,Coulommiers FR,MR BRICOLAGE COULOMMIERS,9944.0
,,06,,,POS,,Coulommiers FR,LA POSTE 779240,9950.0
,,"111,35",,,POS,,Coulommiers FR,EGB,21085.0
,,11,,,POS,,Coulommiers FR,,21096.0
,,06,,,POS,,Coulommiers FR,,21102.0
,,"44,17",,,POS,,Coulommiers FR,,25519.0
,,11,,,POS,,Coulommiers FR,,25530.0
,,06,,,POS,,Coulommiers FR,,25536.0
,,"30,50",,,POS,,Coulommiers FR,,28586.0
,,11,,,POS,,Coulommiers FR,,28597.0
,,06,,,POS,,Coulommiers FR,,28603.0
,,"2,30",,,POS,,Coulommiers FR,,28833.0
,,12,,,POS,,Coulommiers FR,,28845.0
,,06,,,POS,,Coulommiers FR,,28851.0
,,"50,01",,,POS,,Coulommiers FR,,33852.0
,,12,,,POS,,Coulommiers FR,,33864.0
,,06,,,POS,,Coulommiers FR,,33870.0
,,"2,30",,,POS,,Coulommiers FR,,34100.0
,,12,,,POS,,Coulommiers FR,,34112.0
,,06,,,POS,,Coulommiers FR,,34118.0
,,"66,51",,,POS,,Coulommiers FR,,40769.0
,,12,,,POS,,Coulommiers FR,,40781.0
,,06,,,POS,,Coulommiers FR,,40787.0
,,"198,68",,,POS,,Coulommiers FR,,60655.0
,,12,,,POS,,Coulommiers FR,,60667.0
,,06,,,POS,,Coulommiers FR,,60673.0
,,"108,10",,,POS,,Coulommiers FR,,71483.0
,,12,,,POS,,Coulommiers FR,,71495.0
,,06,,,POS,,Coulommiers FR,,71501.0
,,"139,60",,,POS,,Coulommiers FR,,85461.0
,,12,,,POS,,Coulommiers FR,,85473.0
,,06,,,POS,,Coulommiers FR,,85479.0
,,"69,31",,,POS,,Coulommiers FR,,92410.0
,,12,,,POS,,Coulommiers FR,,92422.0
,,06,,,POS,,Coulommiers FR,,92428.0
,,"28,10",,,POS,,Coulommiers FR,,95238.0
,,12,,,POS,,Coulommiers FR,,95250.0
,,06,,,POS,,Coulommiers FR,,95256.0
,,"199,00",,,POS,,Coulommiers FR,,115156.0
,,13,,,POS,,Coulommiers FR,,115169.0
,,06,,,POS,,Coulommiers FR,,115175.0
,,"84,10",,,POS,,Coulommiers FR,,123585.0
,,13,,,POS,,Coulommiers FR,,123598.0
,,06,,,POS,,Coulommiers FR,,123604.0
,,"86,85",,,POS,,Coulommiers FR,,132289.0
,,14,,,POS,,Coulommiers FR,,132303.0
,,06,,,POS,,Coulommiers FR,,132309.0
,,"21,00",,,POS,,Coulommiers FR,,134409.0
,,14,,,POS,,Coulommiers FR,,134423.0
,,06,,,POS,,Coulommiers FR,,134429.0
,,"82,50",,,POS,,Coulommiers FR,,142679.0
,,14,,,POS,,Coulommiers FR,,142693.0
,,06,,,POS,,Coulommiers FR,,142699.0
,,"50,00",,,POS,,Coulommiers FR,,147699.0
,,15,,,POS,,Coulommiers FR,,147714.0
,,06,,,POS,,Coulommiers FR,,147720.0
,,"136,60",,,POS,,Coulommiers FR,,161380.0
,,15,,,POS,,Coulommiers FR,,161395.0
,,06,,,POS,,Coulommiers FR,,161401.0
,,"425,00",,,POS,,Coulommiers FR,,203901.0
,,15,,,POS,,Coulommiers FR,,203916.0
,,06,,,POS,,Coulommiers FR,,203922.0
,,"5,55",,,POS,,Coulommiers FR,,204477.0
,,01,,,POS,,Coulommiers FR,,204478.0
,,06,,,POS,,Coulommiers FR,,204484.0
,,30,,,POS,,Coulommiers FR,,204514.0
,,06,,,POS,,Coulommiers FR,,204520.0
,,205,,,POS,,Coulommiers FR,,204725.0
,,3,,,POS,,Coulommiers FR,,204728.0
,,5,,,POS,,Coulommiers FR,,204733.0
,,1,,,Unknown,,Banque Inconnue,cid:22)(cid:23)(cid:24,1.0
,,2,,,Unknown,,Banque Inconnue,cid:25)(cid:24)(cid:26)(cid:27)(cid:28)(cid:2)(cid:28)(cid:3)(cid:16)(cid:32)(cid:2)(cid:17)(cid:32)(cid:33)(cid:34)(cid:2)(cid:35)(cid:18)(cid:18)(cid:18)(cid:2)(cid:18)(cid:17)(cid:33)(cid:35)(cid:2)(cid:17)(cid:1)(cid:36)(cid:37)(cid:2)(cid:33)(cid:35)(cid:33)(cid:1)(cid:2)(cid:1)(cid:18)(cid:34,3.0
,,3,,,Unknown,,Banque Inconnue,cid:24)(cid:25)(cid:29)(cid:28)(cid:2)(cid:38)(cid:8)(cid:10)(cid:11)(cid:28)(cid:3)(cid:39)(cid:17)(cid:40)(cid:40)(cid:40,6.0
,,2,,,Unknown,,Banque Inconnue,,8.0
,,4,,,Unknown,,Banque Inconnue,,12.0
,,5,,,Unknown,,Banque Inconnue,,17.0
,,6,,,Unknown,,Banque Inconnue,,23.0
,,7,,,Unknown,,Banque Inconnue,,30.0
,,8,,,Unknown,,Banque Inconnue,,38.0
,,9,,,Unknown,,Banque Inconnue,,47.0
,,10,,,Unknown,,Banque Inconnue,,57.0
,,11,,,Unknown,,Banque Inconnue,,68.0
,,9,,,Unknown,,Banque Inconnue,,77.0
,,12,,,Unknown,,Banque Inconnue,,89.0
,,13,,,Unknown,,Banque Inconnue,,102.0
,,2,,,Unknown,,Banque Inconnue,,104.0
,,6,,,Unknown,,Banque Inconnue,,110.0
,,14,,,Unknown,,Banque Inconnue,,124.0
,,15,,,Unknown,,Banque Inconnue,,139.0
,,7,,,Unknown,,Banque Inconnue,,146.0
,,16,,,Unknown,,Banque Inconnue,,162.0
,,17,,,Unknown,,Banque Inconnue,,179.0
,,18,,,Unknown,,Banque Inconnue,,197.0
,,16,,,Unknown,,Banque Inconnue,,213.0
,,19,,,Unknown,,Banque Inconnue,,232.0
,,18,,,Unknown,,Banque Inconnue,,250.0
,,20,,,Unknown,,Banque Inconnue,,270.0
,,16,,,Unknown,,Banque Inconnue,,286.0
,,20,,,Unknown,,Banque Inconnue,,306.0
,,17,,,Unknown,,Banque Inconnue,,323.0
,,7,,,Unknown,,Banque Inconnue,,330.0
,,9,,,Unknown,,Banque Inconnue,,339.0
,,15,,,Unknown,,Banque Inconnue,,354.0
,,7,,,Unknown,,Banque Inconnue,,361.0
,,21,,,Unknown,,Banque Inconnue,,382.0
,,17,,,Unknown,,Banque Inconnue,,399.0
,,18,,,Unknown,,Banque Inconnue,,417.0
,,16,,,Unknown,,Banque Inconnue,,433.0
,,19,,,Unknown,,Banque Inconnue,,452.0
,,18,,,Unknown,,Banque Inconnue,,470.0
,,20,,,Unknown,,Banque Inconnue,,490.0
,,16,,,Unknown,,Banque Inconnue,,506.0
,,20,,,Unknown,,Banque Inconnue,,526.0
,,17,,,Unknown,,Banque Inconnue,,543.0
,,22,,,Unknown,,Banque Inconnue,,565.0
,,23,,,Unknown,,Banque Inconnue,,588.0
,,24,,,Unknown,,Banque Inconnue,,612.0
,,30,,,Unknown,,Banque Inconnue,,642.0
,,31,,,Unknown,,Banque Inconnue,,673.0
,,3,,,Unknown,,Banque Inconnue,,676.0
,,32,,,Unknown,,Banque Inconnue,,708.0
,,2,,,Unknown,,Banque Inconnue,,710.0
,,7,,,Unknown,,Banque Inconnue,,717.0
,,9,,,Unknown,,Banque Inconnue,,726.0
,,15,,,Unknown,,Banque Inconnue,,741.0
,,7,,,Unknown,,Banque Inconnue,,748.0
,,16,,,Unknown,,Banque Inconnue,,764.0
,,17,,,Unknown,,Banque Inconnue,,781.0
,,18,,,Unknown,,Banque Inconnue,,799.0
,,16,,,Unknown,,Banque Inconnue,,815.0
,,19,,,Unknown,,Banque Inconnue,,834.0
,,33,,,Unknown,,Banque Inconnue,,867.0
,,7,,,Unknown,,Banque Inconnue,,874.0
,,20,,,Unknown,,Banque Inconnue,,894.0
,,19,,,Unknown,,Banque Inconnue,,913.0
,,34,,,Unknown,,Banque Inconnue,,947.0
,,35,,,Unknown,,Banque Inconnue,,982.0
,,19,,,Unknown,,Banque Inconnue,,1001.0
,,7,,,Unknown,,Banque Inconnue,,1008.0
,,36,,,Unknown,,Banque Inconnue,,1044.0
,,1,,,Unknown,,Banque Inconnue,,1045.0
,,2,,,Unknown,,Banque Inconnue,,1047.0
,,3,,,Unknown,,Banque Inconnue,,1050.0
,,4,,,Unknown,,Banque Inconnue,,1054.0
,,5,,,Unknown,,Banque Inconnue,,1059.0
,,2,,,Unknown,,Banque Inconnue,,1061.0
,,6,,,Unknown,,Banque Inconnue,,1067.0
,,7,,,Unknown,,Banque Inconnue,,1074.0
,,8,,,Unknown,,Banque Inconnue,,1082.0
,,9,,,Unknown,,Banque Inconnue,,1091.0
,,10,,,Unknown,,Banque Inconnue,,1101.0
,,11,,,Unknown,,Banque Inconnue,,1112.0
,,8,,,Unknown,,Banque Inconnue,,1120.0
,,2,,,Unknown,,Banque Inconnue,,1122.0
,,12,,,Unknown,,Banque Inconnue,,1134.0
,,13,,,Unknown,,Banque Inconnue,,1147.0
,,4,,,Unknown,,Banque Inconnue,,1151.0
,,3,,,Unknown,,Banque Inconnue,,1154.0
,,12,,,Unknown,,Banque Inconnue,,1166.0
,,13,,,Unknown,,Banque Inconnue,,1179.0
,,7,,,Unknown,,Banque Inconnue,,1186.0
,,14,,,Unknown,,Banque Inconnue,,1200.0
,,14,,,Unknown,,Banque Inconnue,,1214.0
,,2,,,Unknown,,Banque Inconnue,,1216.0
,,15,,,Unknown,,Banque Inconnue,,1231.0
,,2,,,Unknown,,Banque Inconnue,,1233.0
,,5,,,Unknown,,Banque Inconnue,,1238.0
,,30,,,Unknown,,Banque Inconnue,,1268.0
,,41,,,Unknown,,Banque Inconnue,,1309.0
,,26,,,Unknown,,Banque Inconnue,,1335.0
,,42,,,Unknown,,Banque Inconnue,,1377.0
,,25,,,Unknown,,Banque Inconnue,,1402.0
,,27,,,Unknown,,Banque Inconnue,,1429.0
,,43,,,Unknown,,Banque Inconnue,,1472.0
,,2,,,Unknown,,Banque Inconnue,,1474.0
,,1,,,Unknown,,Banque Inconnue,,1475.0
,,34,,,Unknown,,Banque Inconnue,,1509.0
,,2,,,Unknown,,Banque Inconnue,,1511.0
,,1,,,Unknown,,Banque Inconnue,,1512.0
,,33,,,Unknown,,Banque Inconnue,,1545.0
,,34,,,Unknown,,Banque Inconnue,,1579.0
,,19,,,Unknown,,Banque Inconnue,,1598.0
,,18,,,Unknown,,Banque Inconnue,,1616.0
,,18,,,Unknown,,Banque Inconnue,,1634.0
,,2,,,Unknown,,Banque Inconnue,,1636.0
,,44,,,Unknown,,Banque Inconnue,,1680.0
,,16,,,Unknown,,Banque Inconnue,,1696.0
,,16,,,Unknown,,Banque Inconnue,,1712.0
,,17,,,Unknown,,Banque Inconnue,,1729.0
,,1,,,Unknown,,Banque Inconnue,,1730.0
,,18,,,Unknown,,Banque Inconnue,,1748.0
,,19,,,Unknown,,Banque Inconnue,,1767.0
,,2,,,Unknown,,Banque Inconnue,,1769.0
,,12,,,Unknown,,Banque Inconnue,,1781.0
,,20,,,Unknown,,Banque Inconnue,,1801.0
,,21,,,Unknown,,Banque Inconnue,,1822.0
,,22,,,Unknown,,Banque Inconnue,,1844.0
,,20,,,Unknown,,Banque Inconnue,,1864.0
,,23,,,Unknown,,Banque Inconnue,,1887.0
,,23,,,Unknown,,Banque Inconnue,,1910.0
,,24,,,Unknown,,Banque Inconnue,,1934.0
,,25,,,Unknown,,Banque Inconnue,,1959.0
,,26,,,Unknown,,Banque Inconnue,,1985.0
,,27,,,Unknown,,Banque Inconnue,,2012.0
,,19,,,Unknown,,Banque Inconnue,,2031.0
,,2,,,Unknown,,Banque Inconnue,,2033.0
,,28,,,Unknown,,Banque Inconnue,,2061.0
,,26,,,Unknown,,Banque Inconnue,,2087.0
,,29,,,Unknown,,Banque Inconnue,,2116.0
,,30,,,Unknown,,Banque Inconnue,,2146.0
,,31,,,Unknown,,Banque Inconnue,,2177.0
,,25,,,Unknown,,Banque Inconnue,,2202.0
,,9,,,Unknown,,Banque Inconnue,,2211.0
,,20,,,Unknown,,Banque Inconnue,,2231.0
,,26,,,Unknown,,Banque Inconnue,,2257.0
,,41,,,Unknown,,Banque Inconnue,,2298.0
,,24,,,Unknown,,Banque Inconnue,,2322.0
,,25,,,Unknown,,Banque Inconnue,,2347.0
,,27,,,Unknown,,Banque Inconnue,,2374.0
,,15,,,Unknown,,Banque Inconnue,,2389.0
,,2,,,Unknown,,Banque Inconnue,,2391.0
,,1,,,Unknown,,Banque Inconnue,,2392.0
,,37,,,Unknown,,Banque Inconnue,,2429.0
,,2,,,Unknown,,Banque Inconnue,,2431.0
,,1,,,Unknown,,Banque Inconnue,,2432.0
,,34,,,Unknown,,Banque Inconnue,,2466.0
,,33,,,Unknown,,Banque Inconnue,,2499.0
,,19,,,Unknown,,Banque Inconnue,,2518.0
,,35,,,Unknown,,Banque Inconnue,,2553.0
,,1,,,Unknown,,Banque Inconnue,,2554.0
,,2,,,Unknown,,Banque Inconnue,,2556.0
,,44,,,Unknown,,Banque Inconnue,,2600.0
,,25,,,Unknown,,Banque Inconnue,,2625.0
,,24,,,Unknown,,Banque Inconnue,,2649.0
,,26,,,Unknown,,Banque Inconnue,,2675.0
,,27,,,Unknown,,Banque Inconnue,,2702.0
,,28,,,Unknown,,Banque Inconnue,,2730.0
,,2,,,Unknown,,Banque Inconnue,,2732.0
,,28,,,Unknown,,Banque Inconnue,,2760.0
,,3,,,Unknown,,Banque Inconnue,,2763.0
,,16,,,Unknown,,Banque Inconnue,,2779.0
,,32,,,Unknown,,Banque Inconnue,,2811.0
,,2,,,Unknown,,Banque Inconnue,,2813.0
,,17,,,Unknown,,Banque Inconnue,,2830.0
,,32,,,Unknown,,Banque Inconnue,,2862.0
,,33,,,Unknown,,Banque Inconnue,,2895.0
,,34,,,Unknown,,Banque Inconnue,,2929.0
,,2,,,Unknown,,Banque Inconnue,,2931.0
,,35,,,Unknown,,Banque Inconnue,,2966.0
,,18,,,Unknown,,Banque Inconnue,,2984.0
,,18,,,Unknown,,Banque Inconnue,,3002.0
,,18,,,Unknown,,Banque Inconnue,,3020.0
,,2,,,Unknown,,Banque Inconnue,,3022.0
,,18,,,Unknown,,Banque Inconnue,,3040.0
,,17,,,Unknown,,Banque Inconnue,,3057.0
,,33,,,Unknown,,Banque Inconnue,,3090.0
,,35,,,Unknown,,Banque Inconnue,,3125.0
,,2,,,Unknown,,Banque Inconnue,,3127.0
,,17,,,Unknown,,Banque Inconnue,,3144.0
,,1,,,Unknown,,Banque Inconnue,,3145.0
,,36,,,Unknown,,Banque Inconnue,,3181.0
,,37,,,Unknown,,Banque Inconnue,,3218.0
,,2,,,Unknown,,Banque Inconnue,,3220.0
,,33,,,Unknown,,Banque Inconnue,,3253.0
,,35,,,Unknown,,Banque Inconnue,,3288.0
,,33,,,Unknown,,Banque Inconnue,,3321.0
,,1,,,Unknown,,Banque Inconnue,,3322.0
,,2,,,Unknown,,Banque Inconnue,,3324.0
,,1,,,Unknown,,Banque Inconnue,,3325.0
,,18,,,Unknown,,Banque Inconnue,,3343.0
,,34,,,Unknown,,Banque Inconnue,,3377.0
,,24,,,Unknown,,Banque Inconnue,,3401.0
,,25,,,Unknown,,Banque Inconnue,,3426.0
,,29,,,Unknown,,Banque Inconnue,,3455.0
,,28,,,Unknown,,Banque Inconnue,,3483.0
,,2,,,Unknown,,Banque Inconnue,,3485.0
,,38,,,Unknown,,Banque Inconnue,,3523.0
,,8,,,Unknown,,Banque Inconnue,,3531.0
,,10,,,Unknown,,Banque Inconnue,,3541.0
,,11,,,Unknown,,Banque Inconnue,,3552.0
,,28,,,Unknown,,Banque Inconnue,,3580.0
,,3,,,Unknown,,Banque Inconnue,,3583.0
,,39,,,Unknown,,Banque Inconnue,,3622.0
,,17,,,Unknown,,Banque Inconnue,,3639.0
,,40,,,Unknown,,Banque Inconnue,,3679.0
,,40,,,Unknown,,Banque Inconnue,,3719.0
,,40,,,Unknown,,Banque Inconnue,,3759.0
,,30,,,Unknown,,Banque Inconnue,,3789.0
,,31,,,Unknown,,Banque Inconnue,,3820.0
,,3,,,Unknown,,Banque Inconnue,,3823.0
,,32,,,Unknown,,Banque Inconnue,,3855.0
,,2,,,Unknown,,Banque Inconnue,,3857.0
,,7,,,Unknown,,Banque Inconnue,,3864.0
,,9,,,Unknown,,Banque Inconnue,,3873.0
,,15,,,Unknown,,Banque Inconnue,,3888.0
,,7,,,Unknown,,Banque Inconnue,,3895.0
,,21,,,Unknown,,Banque Inconnue,,3916.0
,,17,,,Unknown,,Banque Inconnue,,3933.0
,,18,,,Unknown,,Banque Inconnue,,3951.0
,,16,,,Unknown,,Banque Inconnue,,3967.0
,,19,,,Unknown,,Banque Inconnue,,3986.0
,,33,,,Unknown,,Banque Inconnue,,4019.0
,,7,,,Unknown,,Banque Inconnue,,4026.0
,,20,,,Unknown,,Banque Inconnue,,4046.0
,,7,,,Unknown,,Banque Inconnue,,4053.0
,,16,,,Unknown,,Banque Inconnue,,4069.0
,,37,,,Unknown,,Banque Inconnue,,4106.0
,,16,,,Unknown,,Banque Inconnue,,4122.0
,,34,,,Unknown,,Banque Inconnue,,4156.0
,,37,,,Unknown,,Banque Inconnue,,4193.0
,,21,,,Unknown,,Banque Inconnue,,4214.0
,,7,,,Unknown,,Banque Inconnue,,4221.0
,,36,,,Unknown,,Banque Inconnue,,4257.0
,,14,,,Unknown,,cid:12)(cid:29)(cid:26)(cid:41)(cid:25)(cid:2)(cid:53)(cid:53)(cid:37)(cid:16)(cid:34)(cid:33,cid:18)(cid:16)(cid:45)(cid:18)(cid:34,14.0
,,9,,,Unknown,,cid:12)(cid:29)(cid:26)(cid:41)(cid:25)(cid:2)(cid:53)(cid:53)(cid:37)(cid:16)(cid:34)(cid:33,cid:18)(cid:16)(cid:45)(cid:18)(cid:34,23.0
,,38,,,Unknown,,cid:12)(cid:29)(cid:26)(cid:41)(cid:25)(cid:2)(cid:53)(cid:53)(cid:37)(cid:16)(cid:34)(cid:33,cid:18)(cid:35)(cid:45)(cid:18)(cid:34,61.0
,,2,,,Unknown,,cid:12)(cid:29)(cid:26)(cid:41)(cid:25)(cid:2)(cid:53)(cid:53)(cid:37)(cid:16)(cid:34)(cid:33,cid:9)(cid:49)(cid:8)(cid:5)(cid:28)(cid:2)(cid:9)(cid:5)(cid:8)(cid:14)(cid:7)(cid:9)(cid:2)(cid:28)(cid:3,63.0
,,7,,,Unknown,,cid:12)(cid:29)(cid:26)(cid:41)(cid:25)(cid:2)(cid:53)(cid:53)(cid:37)(cid:16)(cid:34)(cid:33,cid:17)(cid:37)(cid:45)(cid:18)(cid:34,70.0
,,32,,,Unknown,,cid:12)(cid:29)(cid:26)(cid:41)(cid:25)(cid:2)(cid:53)(cid:53)(cid:37)(cid:16)(cid:34)(cid:33,cid:17)(cid:16)(cid:45)(cid:18)(cid:34,102.0
,,2,,,Unknown,,cid:12)(cid:29)(cid:26)(cid:41)(cid:25)(cid:2)(cid:53)(cid:53)(cid:37)(cid:16)(cid:34)(cid:33,cid:17)(cid:16)(cid:45)(cid:18)(cid:34,104.0
,,7,,,Unknown,,cid:12)(cid:29)(cid:26)(cid:41)(cid:25)(cid:2)(cid:53)(cid:53)(cid:37)(cid:16)(cid:34)(cid:33,cid:1)(cid:17)(cid:45)(cid:18)(cid:34,111.0
,,4,,,Unknown,,cid:12)(cid:29)(cid:26)(cid:41)(cid:25)(cid:2)(cid:53)(cid:53)(cid:37)(cid:16)(cid:34)(cid:33,cid:9)(cid:49)(cid:8)(cid:5)(cid:28)(cid:2)(cid:9)(cid:5)(cid:8)(cid:14)(cid:7)(cid:9)(cid:2)(cid:28)(cid:3,115.0
,,9,,,Unknown,,cid:12)(cid:29)(cid:26)(cid:41)(cid:25)(cid:2)(cid:53)(cid:53)(cid:37)(cid:16)(cid:34)(cid:33,cid:1)(cid:17)(cid:45)(cid:18)(cid:34,124.0
,,3,,,Unknown,,cid:12)(cid:29)(cid:26)(cid:41)(cid:25)(cid:2)(cid:53)(cid:53)(cid:37)(cid:16)(cid:34)(cid:33,cid:1)(cid:17)(cid:45)(cid:18)(cid:34,127.0
,,2,,,Unknown,,cid:12)(cid:29)(cid:26)(cid:41)(cid:25)(cid:2)(cid:53)(cid:53)(cid:37)(cid:16)(cid:34)(cid:33,cid:9)(cid:49)(cid:8)(cid:5)(cid:28)(cid:2)(cid:9)(cid:5)(cid:8)(cid:14)(cid:7)(cid:9)(cid:2)(cid:28)(cid:3,129.0
,,15,,,Unknown,,cid:12)(cid:29)(cid:26)(cid:41)(cid:25)(cid:2)(cid:53)(cid:53)(cid:37)(cid:16)(cid:34)(cid:33,cid:1)(cid:17)(cid:45)(cid:18)(cid:34,144.0
,,13,,,Unknown,,cid:12)(cid:29)(cid:26)(cid:41)(cid:25)(cid:2)(cid:53)(cid:53)(cid:37)(cid:16)(cid:34)(cid:33,cid:9)(cid:49)(cid:8)(cid:5)(cid:28)(cid:2)(cid:9)(cid:5)(cid:8)(cid:14)(cid:7)(cid:9)(cid:2)(cid:28)(cid:3,157.0
,,39,,,Unknown,,cid:12)(cid:29)(cid:26)(cid:41)(cid:25)(cid:2)(cid:53)(cid:53)(cid:37)(cid:16)(cid:34)(cid:33,cid:1)(cid:17)(cid:45)(cid:18)(cid:34,196.0
,,13,,,Unknown,,cid:12)(cid:29)(cid:26)(cid:41)(cid:25)(cid:2)(cid:53)(cid:53)(cid:37)(cid:16)(cid:34)(cid:33,cid:1)(cid:36)(cid:45)(cid:18)(cid:34,209.0
,,9,,,Unknown,,cid:12)(cid:29)(cid:26)(cid:41)(cid:25)(cid:2)(cid:53)(cid:53)(cid:37)(cid:16)(cid:34)(cid:33,cid:1)(cid:36)(cid:45)(cid:18)(cid:34,218.0
,,10,,,Unknown,,cid:12)(cid:29)(cid:26)(cid:41)(cid:25)(cid:2)(cid:53)(cid:53)(cid:37)(cid:16)(cid:34)(cid:33,cid:12)(cid:13)(cid:14)(cid:2)(cid:14)(cid:49)(cid:63)(cid:49)(cid:46)(cid:5)(cid:9)(cid:2)(cid:47)(cid:11)(cid:7)(cid:9)(cid:9)(cid:65)(cid:2)(cid:14)(cid:5)(cid:2)(cid:12)(cid:13)(cid:49)(cid:2)(cid:28)(cid:3,228.0
,,6,,,Unknown,,cid:12)(cid:29)(cid:26)(cid:41)(cid:25)(cid:2)(cid:53)(cid:53)(cid:37)(cid:16)(cid:34)(cid:33,cid:12)(cid:29)(cid:26)(cid:41)(cid:25)(cid:2)(cid:53)(cid:53)(cid:18)(cid:1)(cid:1)(cid:37,234.0
,,9,,,Unknown,,cid:12)(cid:29)(cid:26)(cid:41)(cid:25)(cid:2)(cid:53)(cid:53)(cid:37)(cid:16)(cid:34)(cid:33,,243.0
,,11,,,Unknown,,cid:12)(cid:29)(cid:26)(cid:41)(cid:25)(cid:2)(cid:53)(cid:53)(cid:37)(cid:16)(cid:34)(cid:33,,254.0
,,38,,,Unknown,,cid:12)(cid:29)(cid:26)(cid:41)(cid:25)(cid:2)(cid:53)(cid:53)(cid:37)(cid:16)(cid:34)(cid:33,,292.0
,,12,,,Unknown,,cid:12)(cid:29)(cid:26)(cid:41)(cid:25)(cid:2)(cid:53)(cid:53)(cid:37)(cid:16)(cid:34)(cid:33,,304.0
,,31,,,Unknown,,cid:12)(cid:29)(cid:26)(cid:41)(cid:25)(cid:2)(cid:53)(cid:53)(cid:37)(cid:16)(cid:34)(cid:33,,335.0
,,10,,,Unknown,,cid:12)(cid:29)(cid:26)(cid:41)(cid:25)(cid:2)(cid:53)(cid:53)(cid:37)(cid:16)(cid:34)(cid:33,,345.0
,,6,,,Unknown,,cid:12)(cid:29)(cid:26)(cid:41)(cid:25)(cid:2)(cid:53)(cid:53)(cid:37)(cid:16)(cid:34)(cid:33,,351.0
,,14,,,Unknown,,cid:12)(cid:29)(cid:26)(cid:41)(cid:25)(cid:2)(cid:53)(cid:53)(cid:37)(cid:16)(cid:34)(cid:33,,365.0
,,5,,,Unknown,,cid:12)(cid:29)(cid:26)(cid:41)(cid:25)(cid:2)(cid:53)(cid:53)(cid:37)(cid:16)(cid:34)(cid:33,,370.0
,,8,,,Unknown,,cid:12)(cid:29)(cid:26)(cid:41)(cid:25)(cid:2)(cid:53)(cid:53)(cid:37)(cid:16)(cid:34)(cid:33,,378.0
,,12,,,Unknown,,cid:12)(cid:29)(cid:26)(cid:41)(cid:25)(cid:2)(cid:53)(cid:53)(cid:37)(cid:16)(cid:34)(cid:33,,390.0
,,38,,,Unknown,,cid:12)(cid:29)(cid:26)(cid:41)(cid:25)(cid:2)(cid:53)(cid:53)(cid:37)(cid:16)(cid:34)(cid:33,,428.0
,,29,,,Unknown,,cid:12)(cid:29)(cid:26)(cid:41)(cid:25)(cid:2)(cid:53)(cid:53)(cid:37)(cid:16)(cid:34)(cid:33,,457.0
,,13,,,Unknown,,cid:12)(cid:29)(cid:26)(cid:41)(cid:25)(cid:2)(cid:53)(cid:53)(cid:37)(cid:16)(cid:34)(cid:33,,470.0
,,5,,,Unknown,,cid:12)(cid:29)(cid:26)(cid:41)(cid:25)(cid:2)(cid:53)(cid:53)(cid:37)(cid:16)(cid:34)(cid:33,,475.0
,,32,,,Unknown,,cid:12)(cid:29)(cid:26)(cid:41)(cid:25)(cid:2)(cid:53)(cid:53)(cid:37)(cid:16)(cid:34)(cid:33,,507.0
,,12,,,Unknown,,cid:12)(cid:29)(cid:26)(cid:41)(cid:25)(cid:2)(cid:53)(cid:53)(cid:37)(cid:16)(cid:34)(cid:33,,519.0
,,38,,,Unknown,,cid:12)(cid:29)(cid:26)(cid:41)(cid:25)(cid:2)(cid:53)(cid:53)(cid:37)(cid:16)(cid:34)(cid:33,,557.0
,,18,,,Unknown,,cid:12)(cid:29)(cid:26)(cid:41)(cid:25)(cid:2)(cid:53)(cid:53)(cid:37)(cid:16)(cid:34)(cid:33,,575.0
,,16,,,Unknown,,cid:12)(cid:29)(cid:26)(cid:41)(cid:25)(cid:2)(cid:53)(cid:53)(cid:37)(cid:16)(cid:34)(cid:33,,591.0
,,45,,,Unknown,,cid:12)(cid:29)(cid:26)(cid:41)(cid:25)(cid:2)(cid:53)(cid:53)(cid:37)(cid:16)(cid:34)(cid:33,,636.0
,,18,,,Unknown,,cid:12)(cid:29)(cid:26)(cid:41)(cid:25)(cid:2)(cid:53)(cid:53)(cid:37)(cid:16)(cid:34)(cid:33,,654.0
,,34,,,Unknown,,cid:12)(cid:29)(cid:26)(cid:41)(cid:25)(cid:2)(cid:53)(cid:53)(cid:37)(cid:16)(cid:34)(cid:33,,688.0
,,5,,,Unknown,,cid:12)(cid:29)(cid:26)(cid:41)(cid:25)(cid:2)(cid:53)(cid:53)(cid:37)(cid:16)(cid:34)(cid:33,,693.0
,,46,,,Unknown,,cid:12)(cid:29)(cid:26)(cid:41)(cid:25)(cid:2)(cid:53)(cid:53)(cid:37)(cid:16)(cid:34)(cid:33,,739.0
,,2,,,Unknown,,cid:12)(cid:29)(cid:26)(cid:41)(cid:25)(cid:2)(cid:53)(cid:53)(cid:37)(cid:16)(cid:34)(cid:33,,741.0
,,47,,,Unknown,,cid:12)(cid:29)(cid:26)(cid:41)(cid:25)(cid:2)(cid:53)(cid:53)(cid:37)(cid:16)(cid:34)(cid:33,,788.0
,,5,,,Unknown,,cid:12)(cid:29)(cid:26)(cid:41)(cid:25)(cid:2)(cid:53)(cid:53)(cid:37)(cid:16)(cid:34)(cid:33,,793.0
,,8,,,Unknown,,cid:12)(cid:29)(cid:26)(cid:41)(cid:25)(cid:2)(cid:53)(cid:53)(cid:37)(cid:16)(cid:34)(cid:33,,801.0
,,8,,,Unknown,,cid:12)(cid:29)(cid:26)(cid:41)(cid:25)(cid:2)(cid:53)(cid:53)(cid:37)(cid:16)(cid:34)(cid:33,,809.0
,,5,,,Unknown,,cid:12)(cid:29)(cid:26)(cid:41)(cid:25)(cid:2)(cid:53)(cid:53)(cid:37)(cid:16)(cid:34)(cid:33,,814.0
,,9,,,Unknown,,cid:12)(cid:29)(cid:26)(cid:41)(cid:25)(cid:2)(cid:53)(cid:53)(cid:37)(cid:16)(cid:34)(cid:33,,823.0
,,43,,,Unknown,,cid:12)(cid:29)(cid:26)(cid:41)(cid:25)(cid:2)(cid:53)(cid:53)(cid:37)(cid:16)(cid:34)(cid:33,,866.0
,,2,,,Unknown,,cid:12)(cid:29)(cid:26)(cid:41)(cid:25)(cid:2)(cid:53)(cid:53)(cid:37)(cid:16)(cid:34)(cid:33,,868.0
,,34,,,Unknown,,cid:12)(cid:29)(cid:26)(cid:41)(cid:25)(cid:2)(cid:53)(cid:53)(cid:37)(cid:16)(cid:34)(cid:33,,902.0
,,18,,,Unknown,,cid:12)(cid:29)(cid:26)(cid:41)(cid:25)(cid:2)(cid:53)(cid:53)(cid:37)(cid:16)(cid:34)(cid:33,,920.0
,,19,,,Unknown,,cid:12)(cid:29)(cid:26)(cid:41)(cid:25)(cid:2)(cid:53)(cid:53)(cid:37)(cid:16)(cid:34)(cid:33,,939.0
,,18,,,Unknown,,cid:12)(cid:29)(cid:26)(cid:41)(cid:25)(cid:2)(cid:53)(cid:53)(cid:37)(cid:16)(cid:34)(cid:33,,957.0
,,18,,,Unknown,,cid:12)(cid:29)(cid:26)(cid:41)(cid:25)(cid:2)(cid:53)(cid:53)(cid:37)(cid:16)(cid:34)(cid:33,,975.0
,,2,,,Unknown,,cid:12)(cid:29)(cid:26)(cid:41)(cid:25)(cid:2)(cid:53)(cid:53)(cid:37)(cid:16)(cid:34)(cid:33,,977.0
,,44,,,Unknown,,cid:12)(cid:29)(cid:26)(cid:41)(cid:25)(cid:2)(cid:53)(cid:53)(cid:37)(cid:16)(cid:34)(cid:33,,1021.0
,,48,,,Unknown,,cid:12)(cid:29)(cid:26)(cid:41)(cid:25)(cid:2)(cid:53)(cid:53)(cid:37)(cid:16)(cid:34)(cid:33,,1069.0
,,24,,,Unknown,,cid:12)(cid:29)(cid:26)(cid:41)(cid:25)(cid:2)(cid:53)(cid:53)(cid:37)(cid:16)(cid:34)(cid:33,,1093.0
,,26,,,Unknown,,cid:12)(cid:29)(cid:26)(cid:41)(cid:25)(cid:2)(cid:53)(cid:53)(cid:37)(cid:16)(cid:34)(cid:33,,1119.0
,,25,,,Unknown,,cid:12)(cid:29)(cid:26)(cid:41)(cid:25)(cid:2)(cid:53)(cid:53)(cid:37)(cid:16)(cid:34)(cid:33,,1144.0
,,23,,,Unknown,,cid:12)(cid:29)(cid:26)(cid:41)(cid:25)(cid:2)(cid:53)(cid:53)(cid:37)(cid:16)(cid:34)(cid:33,,1167.0
,,25,,,Unknown,,cid:12)(cid:29)(cid:26)(cid:41)(cid:25)(cid:2)(cid:53)(cid:53)(cid:37)(cid:16)(cid:34)(cid:33,,1192.0
,,30,,,Unknown,,cid:12)(cid:29)(cid:26)(cid:41)(cid:25)(cid:2)(cid:53)(cid:53)(cid:37)(cid:16)(cid:34)(cid:33,,1222.0
,,41,,,Unknown,,cid:12)(cid:29)(cid:26)(cid:41)(cid:25)(cid:2)(cid:53)(cid:53)(cid:37)(cid:16)(cid:34)(cid:33,,1263.0
,,18,,,Unknown,,cid:12)(cid:29)(cid:26)(cid:41)(cid:25)(cid:2)(cid:53)(cid:53)(cid:37)(cid:16)(cid:34)(cid:33,,1281.0
,,16,,,Unknown,,cid:12)(cid:29)(cid:26)(cid:41)(cid:25)(cid:2)(cid:53)(cid:53)(cid:37)(cid:16)(cid:34)(cid:33,,1297.0
,,45,,,Unknown,,cid:12)(cid:29)(cid:26)(cid:41)(cid:25)(cid:2)(cid:53)(cid:53)(cid:37)(cid:16)(cid:34)(cid:33,,1342.0
,,18,,,Unknown,,cid:12)(cid:29)(cid:26)(cid:41)(cid:25)(cid:2)(cid:53)(cid:53)(cid:37)(cid:16)(cid:34)(cid:33,,1360.0
,,34,,,Unknown,,cid:12)(cid:29)(cid:26)(cid:41)(cid:25)(cid:2)(cid:53)(cid:53)(cid:37)(cid:16)(cid:34)(cid:33,,1394.0
,,38,,,Unknown,,cid:12)(cid:29)(cid:26)(cid:41)(cid:25)(cid:2)(cid:53)(cid:53)(cid:37)(cid:16)(cid:34)(cid:33,,1432.0
,,20,,,Unknown,,cid:12)(cid:29)(cid:26)(cid:41)(cid:25)(cid:2)(cid:53)(cid:53)(cid:37)(cid:16)(cid:34)(cid:33,,1452.0
,,30,,,Unknown,,cid:12)(cid:29)(cid:26)(cid:41)(cid:25)(cid:2)(cid:53)(cid:53)(cid:37)(cid:16)(cid:34)(cid:33,,1482.0
,,41,,,Unknown,,cid:12)(cid:29)(cid:26)(cid:41)(cid:25)(cid:2)(cid:53)(cid:53)(cid:37)(cid:16)(cid:34)(cid:33,,1523.0
,,20,,,Unknown,,cid:12)(cid:29)(cid:26)(cid:41)(cid:25)(cid:2)(cid:53)(cid:53)(cid:37)(cid:16)(cid:34)(cid:33,,1543.0
,,15,,,Unknown,,cid:12)(cid:29)(cid:26)(cid:41)(cid:25)(cid:2)(cid:53)(cid:53)(cid:37)(cid:16)(cid:34)(cid:33,,1558.0
,,2,,,Unknown,,cid:12)(cid:29)(cid:26)(cid:41)(cid:25)(cid:2)(cid:53)(cid:53)(cid:37)(cid:16)(cid:34)(cid:33,,1560.0
,,36,,,Unknown,,cid:12)(cid:29)(cid:26)(cid:41)(cid:25)(cid:2)(cid:53)(cid:53)(cid:37)(cid:16)(cid:34)(cid:33,,1596.0
,,1,,,Unknown,,cid:12)(cid:29)(cid:26)(cid:41)(cid:25)(cid:2)(cid:53)(cid:53)(cid:37)(cid:16)(cid:34)(cid:33,,1597.0
,,19,,,Unknown,,cid:12)(cid:29)(cid:26)(cid:41)(cid:25)(cid:2)(cid:53)(cid:53)(cid:37)(cid:16)(cid:34)(cid:33,,1616.0
,,18,,,Unknown,,cid:12)(cid:29)(cid:26)(cid:41)(cid:25)(cid:2)(cid:53)(cid:53)(cid:37)(cid:16)(cid:34)(cid:33,,1634.0
,,18,,,Unknown,,cid:12)(cid:29)(cid:26)(cid:41)(cid:25)(cid:2)(cid:53)(cid:53)(cid:37)(cid:16)(cid:34)(cid:33,,1652.0
,,2,,,Unknown,,cid:12)(cid:29)(cid:26)(cid:41)(cid:25)(cid:2)(cid:53)(cid:53)(cid:37)(cid:16)(cid:34)(cid:33,,1654.0
,,44,,,Unknown,,cid:12)(cid:29)(cid:26)(cid:41)(cid:25)(cid:2)(cid:53)(cid:53)(cid:37)(cid:16)(cid:34)(cid:33,,1698.0
,,49,,,Unknown,,cid:12)(cid:29)(cid:26)(cid:41)(cid:25)(cid:2)(cid:53)(cid:53)(cid:37)(cid:16)(cid:34)(cid:33,,1747.0
,,50,,,Unknown,,cid:12)(cid:29)(cid:26)(cid:41)(cid:25)(cid:2)(cid:53)(cid:53)(cid:37)(cid:16)(cid:34)(cid:33,,1797.0
,,20,,,Unknown,,cid:12)(cid:29)(cid:26)(cid:41)(cid:25)(cid:2)(cid:53)(cid:53)(cid:37)(cid:16)(cid:34)(cid:33,,1817.0
,,30,,,Unknown,,cid:12)(cid:29)(cid:26)(cid:41)(cid:25)(cid:2)(cid:53)(cid:53)(cid:37)(cid:16)(cid:34)(cid:33,,1847.0
,,30,,,Unknown,,cid:12)(cid:29)(cid:26)(cid:41)(cid:25)(cid:2)(cid:53)(cid:53)(cid:37)(cid:16)(cid:34)(cid:33,,1877.0
,,25,,,Unknown,,cid:12)(cid:29)(cid:26)(cid:41)(cid:25)(cid:2)(cid:53)(cid:53)(cid:37)(cid:16)(cid:34)(cid:33,,1902.0
,,23,,,Unknown,,cid:12)(cid:29)(cid:26)(cid:41)(cid:25)(cid:2)(cid:53)(cid:53)(cid:37)(cid:16)(cid:34)(cid:33,,1925.0
,,25,,,Unknown,,cid:12)(cid:29)(cid:26)(cid:41)(cid:25)(cid:2)(cid:53)(cid:53)(cid:37)(cid:16)(cid:34)(cid:33,,1950.0
,,30,,,Unknown,,cid:12)(cid:29)(cid:26)(cid:41)(cid:25)(cid:2)(cid:53)(cid:53)(cid:37)(cid:16)(cid:34)(cid:33,,1980.0
,,41,,,Unknown,,cid:12)(cid:29)(cid:26)(cid:41)(cid:25)(cid:2)(cid:53)(cid:53)(cid:37)(cid:16)(cid:34)(cid:33,,2021.0
,,2,,,Unknown,,cid:12)(cid:29)(cid:26)(cid:41)(cid:25)(cid:2)(cid:53)(cid:53)(cid:37)(cid:16)(cid:34)(cid:33,,2023.0
,,45,,,Unknown,,cid:12)(cid:29)(cid:26)(cid:41)(cid:25)(cid:2)(cid:53)(cid:53)(cid:37)(cid:16)(cid:34)(cid:33,,2068.0
,,2,,,Unknown,,cid:12)(cid:29)(cid:26)(cid:41)(cid:25)(cid:2)(cid:53)(cid:53)(cid:37)(cid:16)(cid:34)(cid:33,,2070.0
,,28,,,Unknown,,cid:12)(cid:29)(cid:26)(cid:41)(cid:25)(cid:2)(cid:53)(cid:53)(cid:37)(cid:16)(cid:34)(cid:33,,2098.0
,,26,,,Unknown,,cid:12)(cid:29)(cid:26)(cid:41)(cid:25)(cid:2)(cid:53)(cid:53)(cid:37)(cid:16)(cid:34)(cid:33,,2124.0
,,29,,,Unknown,,cid:12)(cid:29)(cid:26)(cid:41)(cid:25)(cid:2)(cid:53)(cid:53)(cid:37)(cid:16)(cid:34)(cid:33,,2153.0
,,24,,,Unknown,,cid:12)(cid:29)(cid:26)(cid:41)(cid:25)(cid:2)(cid:53)(cid:53)(cid:37)(cid:16)(cid:34)(cid:33,,2177.0
,,27,,,Unknown,,cid:12)(cid:29)(cid:26)(cid:41)(cid:25)(cid:2)(cid:53)(cid:53)(cid:37)(cid:16)(cid:34)(cid:33,,2204.0
,,2,,,Unknown,,cid:12)(cid:29)(cid:26)(cid:41)(cid:25)(cid:2)(cid:53)(cid:53)(cid:37)(cid:16)(cid:34)(cid:33,,2206.0
,,29,,,Unknown,,cid:12)(cid:29)(cid:26)(cid:41)(cid:25)(cid:2)(cid:53)(cid:53)(cid:37)(cid:16)(cid:34)(cid:33,,2235.0
,,51,,,Unknown,,cid:12)(cid:29)(cid:26)(cid:41)(cid:25)(cid:2)(cid:53)(cid:53)(cid:37)(cid:16)(cid:34)(cid:33,,2286.0
,,51,,,Unknown,,cid:12)(cid:29)(cid:26)(cid:41)(cid:25)(cid:2)(cid:53)(cid:53)(cid:37)(cid:16)(cid:34)(cid:33,,2337.0
,,24,,,Unknown,,cid:12)(cid:29)(cid:26)(cid:41)(cid:25)(cid:2)(cid:53)(cid:53)(cid:37)(cid:16)(cid:34)(cid:33,,2361.0
,,41,,,Unknown,,cid:12)(cid:29)(cid:26)(cid:41)(cid:25)(cid:2)(cid:53)(cid:53)(cid:37)(cid:16)(cid:34)(cid:33,,2402.0
,,24,,,Unknown,,cid:12)(cid:29)(cid:26)(cid:41)(cid:25)(cid:2)(cid:53)(cid:53)(cid:37)(cid:16)(cid:34)(cid:33,,2426.0
,,20,,,Unknown,,cid:12)(cid:29)(cid:26)(cid:41)(cid:25)(cid:2)(cid:53)(cid:53)(cid:37)(cid:16)(cid:34)(cid:33,,2446.0
,,30,,,Unknown,,cid:12)(cid:29)(cid:26)(cid:41)(cid:25)(cid:2)(cid:53)(cid:53)(cid:37)(cid:16)(cid:34)(cid:33,,2476.0
,,30,,,Unknown,,cid:12)(cid:29)(cid:26)(cid:41)(cid:25)(cid:2)(cid:53)(cid:53)(cid:37)(cid:16)(cid:34)(cid:33,,2506.0
,,25,,,Unknown,,cid:12)(cid:29)(cid:26)(cid:41)(cid:25)(cid:2)(cid:53)(cid:53)(cid:37)(cid:16)(cid:34)(cid:33,,2531.0
,,22,,,Unknown,,cid:12)(cid:29)(cid:26)(cid:41)(cid:25)(cid:2)(cid:53)(cid:53)(cid:37)(cid:16)(cid:34)(cid:33,,2553.0
,,27,,,Unknown,,cid:12)(cid:29)(cid:26)(cid:41)(cid:25)(cid:2)(cid:53)(cid:53)(cid:37)(cid:16)(cid:34)(cid:33,,2580.0
,,18,,,Unknown,,cid:12)(cid:29)(cid:26)(cid:41)(cid:25)(cid:2)(cid:53)(cid:53)(cid:37)(cid:16)(cid:34)(cid:33,,2598.0
,,35,,,Unknown,,cid:12)(cid:29)(cid:26)(cid:41)(cid:25)(cid:2)(cid:53)(cid:53)(cid:37)(cid:16)(cid:34)(cid:33,,2633.0
,,45,,,Unknown,,cid:12)(cid:29)(cid:26)(cid:41)(cid:25)(cid:2)(cid:53)(cid:53)(cid:37)(cid:16)(cid:34)(cid:33,,2678.0
,,18,,,Unknown,,cid:12)(cid:29)(cid:26)(cid:41)(cid:25)(cid:2)(cid:53)(cid:53)(cid:37)(cid:16)(cid:34)(cid:33,,2696.0
,,34,,,Unknown,,cid:12)(cid:29)(cid:26)(cid:41)(cid:25)(cid:2)(cid:53)(cid:53)(cid:37)(cid:16)(cid:34)(cid:33,,2730.0
,,9,,,Unknown,,cid:12)(cid:29)(cid:26)(cid:41)(cid:25)(cid:2)(cid:53)(cid:53)(cid:37)(cid:16)(cid:34)(cid:33,,2739.0
,,49,,,Unknown,,cid:12)(cid:29)(cid:26)(cid:41)(cid:25)(cid:2)(cid:53)(cid:53)(cid:37)(cid:16)(cid:34)(cid:33,,2788.0
,,8,,,Unknown,,cid:12)(cid:29)(cid:26)(cid:41)(cid:25)(cid:2)(cid:53)(cid:53)(cid:37)(cid:16)(cid:34)(cid:33,,2796.0
,,5,,,Unknown,,cid:12)(cid:29)(cid:26)(cid:41)(cid:25)(cid:2)(cid:53)(cid:53)(cid:37)(cid:16)(cid:34)(cid:33,,2801.0
,,28,,,Unknown,,cid:12)(cid:29)(cid:26)(cid:41)(cid:25)(cid:2)(cid:53)(cid:53)(cid:37)(cid:16)(cid:34)(cid:33,,2829.0
,,2,,,Unknown,,cid:12)(cid:29)(cid:26)(cid:41)(cid:25)(cid:2)(cid:53)(cid:53)(cid:37)(cid:16)(cid:34)(cid:33,,2831.0
,,49,,,Unknown,,cid:12)(cid:29)(cid:26)(cid:41)(cid:25)(cid:2)(cid:53)(cid:53)(cid:37)(cid:16)(cid:34)(cid:33,,2880.0
,,4,,,Unknown,,cid:12)(cid:29)(cid:26)(cid:41)(cid:25)(cid:2)(cid:53)(cid:53)(cid:37)(cid:16)(cid:34)(cid:33,,2884.0
,,10,,,Unknown,,cid:12)(cid:29)(cid:26)(cid:41)(cid:25)(cid:2)(cid:53)(cid:53)(cid:37)(cid:16)(cid:34)(cid:33,,2894.0
,,11,,,Unknown,,cid:12)(cid:29)(cid:26)(cid:41)(cid:25)(cid:2)(cid:53)(cid:53)(cid:37)(cid:16)(cid:34)(cid:33,,2905.0
,,3,,,Unknown,,cid:12)(cid:29)(cid:26)(cid:41)(cid:25)(cid:2)(cid:53)(cid:53)(cid:37)(cid:16)(cid:34)(cid:33,,2908.0
,,11,,,Unknown,,cid:12)(cid:29)(cid:26)(cid:41)(cid:25)(cid:2)(cid:53)(cid:53)(cid:37)(cid:16)(cid:34)(cid:33,,2919.0
,,4,,,Unknown,,cid:12)(cid:29)(cid:26)(cid:41)(cid:25)(cid:2)(cid:53)(cid:53)(cid:37)(cid:16)(cid:34)(cid:33,,2923.0
,,10,,,Unknown,,cid:12)(cid:29)(cid:26)(cid:41)(cid:25)(cid:2)(cid:53)(cid:53)(cid:37)(cid:16)(cid:34)(cid:33,,2933.0
,,5,,,Unknown,,cid:12)(cid:29)(cid:26)(cid:41)(cid:25)(cid:2)(cid:53)(cid:53)(cid:37)(cid:16)(cid:34)(cid:33,,2938.0
,,2,,,Unknown,,cid:12)(cid:29)(cid:26)(cid:41)(cid:25)(cid:2)(cid:53)(cid:53)(cid:37)(cid:16)(cid:34)(cid:33,,2940.0
,,9,,,Unknown,,cid:12)(cid:29)(cid:26)(cid:41)(cid:25)(cid:2)(cid:53)(cid:53)(cid:37)(cid:16)(cid:34)(cid:33,,2949.0
,,5,,,Unknown,,cid:12)(cid:29)(cid:26)(cid:41)(cid:25)(cid:2)(cid:53)(cid:53)(cid:37)(cid:16)(cid:34)(cid:33,,2954.0
,,8,,,Unknown,,cid:12)(cid:29)(cid:26)(cid:41)(cid:25)(cid:2)(cid:53)(cid:53)(cid:37)(cid:16)(cid:34)(cid:33,,2962.0
,,14,,,Unknown,,cid:12)(cid:29)(cid:26)(cid:41)(cid:25)(cid:2)(cid:53)(cid:53)(cid:37)(cid:16)(cid:34)(cid:33,,2976.0
,,7,,,Unknown,,cid:12)(cid:29)(cid:26)(cid:41)(cid:25)(cid:2)(cid:53)(cid:53)(cid:37)(cid:16)(cid:34)(cid:33,,2983.0
,,9,,,Unknown,,cid:12)(cid:29)(cid:26)(cid:41)(cid:25)(cid:2)(cid:53)(cid:53)(cid:37)(cid:16)(cid:34)(cid:33,,2992.0
,,2,,,Unknown,,cid:12)(cid:29)(cid:26)(cid:41)(cid:25)(cid:2)(cid:53)(cid:53)(cid:37)(cid:16)(cid:34)(cid:33,,2994.0
,,12,,,Unknown,,cid:12)(cid:29)(cid:26)(cid:41)(cid:25)(cid:2)(cid:53)(cid:53)(cid:37)(cid:16)(cid:34)(cid:33,,3006.0
,,5,,,Unknown,,cid:12)(cid:29)(cid:26)(cid:41)(cid:25)(cid:2)(cid:53)(cid:53)(cid:37)(cid:16)(cid:34)(cid:33,,3011.0
,,52,,,Unknown,,cid:12)(cid:29)(cid:26)(cid:41)(cid:25)(cid:2)(cid:53)(cid:53)(cid:37)(cid:16)(cid:34)(cid:33,,3063.0
,,5,,,Unknown,,cid:12)(cid:29)(cid:26)(cid:41)(cid:25)(cid:2)(cid:53)(cid:53)(cid:37)(cid:16)(cid:34)(cid:33,,3068.0
,,40,,,Unknown,,cid:12)(cid:29)(cid:26)(cid:41)(cid:25)(cid:2)(cid:53)(cid:53)(cid:37)(cid:16)(cid:34)(cid:33,,3108.0
,,2,,,Unknown,,cid:12)(cid:29)(cid:26)(cid:41)(cid:25)(cid:2)(cid:53)(cid:53)(cid:37)(cid:16)(cid:34)(cid:33,,3110.0
,,28,,,Unknown,,cid:12)(cid:29)(cid:26)(cid:41)(cid:25)(cid:2)(cid:53)(cid:53)(cid:37)(cid:16)(cid:34)(cid:33,,3138.0
,,3,,,Unknown,,cid:12)(cid:29)(cid:26)(cid:41)(cid:25)(cid:2)(cid:53)(cid:53)(cid:37)(cid:16)(cid:34)(cid:33,,3141.0
,,15,,,Unknown,,cid:12)(cid:29)(cid:26)(cid:41)(cid:25)(cid:2)(cid:53)(cid:53)(cid:37)(cid:16)(cid:34)(cid:33,,3156.0
,,2,,,Unknown,,cid:12)(cid:29)(cid:26)(cid:41)(cid:25)(cid:2)(cid:53)(cid:53)(cid:37)(cid:16)(cid:34)(cid:33,,3158.0
,,1,,,Unknown,,cid:12)(cid:29)(cid:26)(cid:41)(cid:25)(cid:2)(cid:53)(cid:53)(cid:37)(cid:16)(cid:34)(cid:33,,3159.0
,,19,,,Unknown,,cid:12)(cid:29)(cid:26)(cid:41)(cid:25)(cid:2)(cid:53)(cid:53)(cid:37)(cid:16)(cid:34)(cid:33,,3178.0
,,37,,,Unknown,,cid:12)(cid:29)(cid:26)(cid:41)(cid:25)(cid:2)(cid:53)(cid:53)(cid:37)(cid:16)(cid:34)(cid:33,,3215.0
,,18,,,Unknown,,cid:12)(cid:29)(cid:26)(cid:41)(cid:25)(cid:2)(cid:53)(cid:53)(cid:37)(cid:16)(cid:34)(cid:33,,3233.0
,,2,,,Unknown,,cid:12)(cid:29)(cid:26)(cid:41)(cid:25)(cid:2)(cid:53)(cid:53)(cid:37)(cid:16)(cid:34)(cid:33,,3235.0
,,44,,,Unknown,,cid:12)(cid:29)(cid:26)(cid:41)(cid:25)(cid:2)(cid:53)(cid:53)(cid:37)(cid:16)(cid:34)(cid:33,,3279.0
,,12,,,Unknown,,cid:12)(cid:29)(cid:26)(cid:41)(cid:25)(cid:2)(cid:53)(cid:53)(cid:37)(cid:16)(cid:34)(cid:33,,3291.0
,,29,,,Unknown,,cid:12)(cid:29)(cid:26)(cid:41)(cid:25)(cid:2)(cid:53)(cid:53)(cid:37)(cid:16)(cid:34)(cid:33,,3320.0
,,26,,,Unknown,,cid:12)(cid:29)(cid:26)(cid:41)(cid:25)(cid:2)(cid:53)(cid:53)(cid:37)(cid:16)(cid:34)(cid:33,,3346.0
,,41,,,Unknown,,cid:12)(cid:29)(cid:26)(cid:41)(cid:25)(cid:2)(cid:53)(cid:53)(cid:37)(cid:16)(cid:34)(cid:33,,3387.0
,,25,,,Unknown,,cid:12)(cid:29)(cid:26)(cid:41)(cid:25)(cid:2)(cid:53)(cid:53)(cid:37)(cid:16)(cid:34)(cid:33,,3412.0
,,2,,,Unknown,,cid:12)(cid:29)(cid:26)(cid:41)(cid:25)(cid:2)(cid:53)(cid:53)(cid:37)(cid:16)(cid:34)(cid:33,,3414.0
,,53,,,Unknown,,cid:12)(cid:29)(cid:26)(cid:41)(cid:25)(cid:2)(cid:53)(cid:53)(cid:37)(cid:16)(cid:34)(cid:33,,3467.0
,,53,,,Unknown,,cid:12)(cid:29)(cid:26)(cid:41)(cid:25)(cid:2)(cid:53)(cid:53)(cid:37)(cid:16)(cid:34)(cid:33,,3520.0
,,37,,,Unknown,,cid:12)(cid:29)(cid:26)(cid:41)(cid:25)(cid:2)(cid:53)(cid:53)(cid:37)(cid:16)(cid:34)(cid:33,,3557.0
,,16,,,Unknown,,cid:12)(cid:29)(cid:26)(cid:41)(cid:25)(cid:2)(cid:53)(cid:53)(cid:37)(cid:16)(cid:34)(cid:33,,3573.0
,,34,,,Unknown,,cid:12)(cid:29)(cid:26)(cid:41)(cid:25)(cid:2)(cid:53)(cid:53)(cid:37)(cid:16)(cid:34)(cid:33,,3607.0
,,33,,,Unknown,,cid:12)(cid:29)(cid:26)(cid:41)(cid:25)(cid:2)(cid:53)(cid:53)(cid:37)(cid:16)(cid:34)(cid:33,,3640.0
,,18,,,Unknown,,cid:12)(cid:29)(cid:26)(cid:41)(cid:25)(cid:2)(cid:53)(cid:53)(cid:37)(cid:16)(cid:34)(cid:33,,3658.0
,,35,,,Unknown,,cid:12)(cid:29)(cid:26)(cid:41)(cid:25)(cid:2)(cid:53)(cid:53)(cid:37)(cid:16)(cid:34)(cid:33,,3693.0
,,45,,,Unknown,,cid:12)(cid:29)(cid:26)(cid:41)(cid:25)(cid:2)(cid:53)(cid:53)(cid:37)(cid:16)(cid:34)(cid:33,,3738.0
,,18,,,Unknown,,cid:12)(cid:29)(cid:26)(cid:41)(cid:25)(cid:2)(cid:53)(cid:53)(cid:37)(cid:16)(cid:34)(cid:33,,3756.0
,,34,,,Unknown,,cid:12)(cid:29)(cid:26)(cid:41)(cid:25)(cid:2)(cid:53)(cid:53)(cid:37)(cid:16)(cid:34)(cid:33,,3790.0
,,9,,,Unknown,,cid:12)(cid:29)(cid:26)(cid:41)(cid:25)(cid:2)(cid:53)(cid:53)(cid:37)(cid:16)(cid:34)(cid:33,,3799.0
,,49,,,Unknown,,cid:12)(cid:29)(cid:26)(cid:41)(cid:25)(cid:2)(cid:53)(cid:53)(cid:37)(cid:16)(cid:34)(cid:33,,3848.0
,,8,,,Unknown,,cid:12)(cid:29)(cid:26)(cid:41)(cid:25)(cid:2)(cid:53)(cid:53)(cid:37)(cid:16)(cid:34)(cid:33,,3856.0
,,5,,,Unknown,,cid:12)(cid:29)(cid:26)(cid:41)(cid:25)(cid:2)(cid:53)(cid:53)(cid:37)(cid:16)(cid:34)(cid:33,,3861.0
,,28,,,Unknown,,cid:12)(cid:29)(cid:26)(cid:41)(cid:25)(cid:2)(cid:53)(cid:53)(cid:37)(cid:16)(cid:34)(cid:33,,3889.0
,,2,,,Unknown,,cid:12)(cid:29)(cid:26)(cid:41)(cid:25)(cid:2)(cid:53)(cid:53)(cid:37)(cid:16)(cid:34)(cid:33,,3891.0
,,9,,,Unknown,,cid:12)(cid:29)(cid:26)(cid:41)(cid:25)(cid:2)(cid:53)(cid:53)(cid:37)(cid:16)(cid:34)(cid:33,,3900.0
,,5,,,Unknown,,cid:12)(cid:29)(cid:26)(cid:41)(cid:25)(cid:2)(cid:53)(cid:53)(cid:37)(cid:16)(cid:34)(cid:33,,3905.0
,,8,,,Unknown,,cid:12)(cid:29)(cid:26)(cid:41)(cid:25)(cid:2)(cid:53)(cid:53)(cid:37)(cid:16)(cid:34)(cid:33,,3913.0
,,14,,,Unknown,,cid:12)(cid:29)(cid:26)(cid:41)(cid:25)(cid:2)(cid:53)(cid:53)(cid:37)(cid:16)(cid:34)(cid:33,,3927.0
,,7,,,Unknown,,cid:12)(cid:29)(cid:26)(cid:41)(cid:25)(cid:2)(cid:53)(cid:53)(cid:37)(cid:16)(cid:34)(cid:33,,3934.0
,,9,,,Unknown,,cid:12)(cid:29)(cid:26)(cid:41)(cid:25)(cid:2)(cid:53)(cid:53)(cid:37)(cid:16)(cid:34)(cid:33,,3943.0
,,2,,,Unknown,,cid:12)(cid:29)(cid:26)(cid:41)(cid:25)(cid:2)(cid:53)(cid:53)(cid:37)(cid:16)(cid:34)(cid:33,,3945.0
,,28,,,Unknown,,cid:12)(cid:29)(cid:26)(cid:41)(cid:25)(cid:2)(cid:53)(cid:53)(cid:37)(cid:16)(cid:34)(cid:33,,3973.0
,,3,,,Unknown,,cid:12)(cid:29)(cid:26)(cid:41)(cid:25)(cid:2)(cid:53)(cid:53)(cid:37)(cid:16)(cid:34)(cid:33,,3976.0
,,15,,,Unknown,,cid:12)(cid:29)(cid:26)(cid:41)(cid:25)(cid:2)(cid:53)(cid:53)(cid:37)(cid:16)(cid:34)(cid:33,,3991.0
,,2,,,Unknown,,cid:12)(cid:29)(cid:26)(cid:41)(cid:25)(cid:2)(cid:53)(cid:53)(cid:37)(cid:16)(cid:34)(cid:33,,3993.0
,,1,,,Unknown,,cid:12)(cid:29)(cid:26)(cid:41)(cid:25)(cid:2)(cid:53)(cid:53)(cid:37)(cid:16)(cid:34)(cid:33,,3994.0
,,19,,,Unknown,,cid:12)(cid:29)(cid:26)(cid:41)(cid:25)(cid:2)(cid:53)(cid:53)(cid:37)(cid:16)(cid:34)(cid:33,,4013.0
,,37,,,Unknown,,cid:12)(cid:29)(cid:26)(cid:41)(cid:25)(cid:2)(cid:53)(cid:53)(cid:37)(cid:16)(cid:34)(cid:33,,4050.0
,,18,,,Unknown,,cid:12)(cid:29)(cid:26)(cid:41)(cid:25)(cid:2)(cid:53)(cid:53)(cid:37)(cid:16)(cid:34)(cid:33,,4068.0
,,2,,,Unknown,,cid:12)(cid:29)(cid:26)(cid:41)(cid:25)(cid:2)(cid:53)(cid:53)(cid:37)(cid:16)(cid:34)(cid:33,,4070.0
,,44,,,Unknown,,cid:12)(cid:29)(cid:26)(cid:41)(cid:25)(cid:2)(cid:53)(cid:53)(cid:37)(cid:16)(cid:34)(cid:33,,4114.0
,,12,,,Unknown,,cid:12)(cid:29)(cid:26)(cid:41)(cid:25)(cid:2)(cid:53)(cid:53)(cid:37)(cid:16)(cid:34)(cid:33,,4126.0
,,29,,,Unknown,,cid:12)(cid:29)(cid:26)(cid:41)(cid:25)(cid:2)(cid:53)(cid:53)(cid:37)(cid:16)(cid:34)(cid:33,,4155.0
,,26,,,Unknown,,cid:12)(cid:29)(cid:26)(cid:41)(cid:25)(cid:2)(cid:53)(cid:53)(cid:37)(cid:16)(cid:34)(cid:33,,4181.0
,,41,,,Unknown,,cid:12)(cid:29)(cid:26)(cid:41)(cid:25)(cid:2)(cid:53)(cid:53)(cid:37)(cid:16)(cid:34)(cid:33,,4222.0
,,25,,,Unknown,,cid:12)(cid:29)(cid:26)(cid:41)(cid:25)(cid:2)(cid:53)(cid:53)(cid:37)(cid:16)(cid:34)(cid:33,,4247.0
,,2,,,Unknown,,cid:12)(cid:29)(cid:26)(cid:41)(cid:25)(cid:2)(cid:53)(cid:53)(cid:37)(cid:16)(cid:34)(cid:33,,4249.0
,,53,,,Unknown,,cid:12)(cid:29)(cid:26)(cid:41)(cid:25)(cid:2)(cid:53)(cid:53)(cid:37)(cid:16)(cid:34)(cid:33,,4302.0
,,53,,,Unknown,,cid:12)(cid:29)(cid:26)(cid:41)(cid:25)(cid:2)(cid:53)(cid:53)(cid:37)(cid:16)(cid:34)(cid:33,,4355.0
,,37,,,Unknown,,cid:12)(cid:29)(cid:26)(cid:41)(cid:25)(cid:2)(cid:53)(cid:53)(cid:37)(cid:16)(cid:34)(cid:33,,4392.0
,,16,,,Unknown,,cid:12)(cid:29)(cid:26)(cid:41)(cid:25)(cid:2)(cid:53)(cid:53)(cid:37)(cid:16)(cid:34)(cid:33,,4408.0
,,34,,,Unknown,,cid:12)(cid:29)(cid:26)(cid:41)(cid:25)(cid:2)(cid:53)(cid:53)(cid:37)(cid:16)(cid:34)(cid:33,,4442.0
,,33,,,Unknown,,cid:12)(cid:29)(cid:26)(cid:41)(cid:25)(cid:2)(cid:53)(cid:53)(cid:37)(cid:16)(cid:34)(cid:33,,4475.0
,,17,,,Unknown,,cid:12)(cid:29)(cid:26)(cid:41)(cid:25)(cid:2)(cid:53)(cid:53)(cid:37)(cid:16)(cid:34)(cid:33,,4492.0
,,37,,,Unknown,,cid:12)(cid:29)(cid:26)(cid:41)(cid:25)(cid:2)(cid:53)(cid:53)(cid:37)(cid:16)(cid:34)(cid:33,,4529.0
,,45,,,Unknown,,cid:12)(cid:29)(cid:26)(cid:41)(cid:25)(cid:2)(cid:53)(cid:53)(cid:37)(cid:16)(cid:34)(cid:33,,4574.0
,,18,,,Unknown,,cid:12)(cid:29)(cid:26)(cid:41)(cid:25)(cid:2)(cid:53)(cid:53)(cid:37)(cid:16)(cid:34)(cid:33,,4592.0
,,34,,,Unknown,,cid:12)(cid:29)(cid:26)(cid:41)(cid:25)(cid:2)(cid:53)(cid:53)(cid:37)(cid:16)(cid:34)(cid:33,,4626.0
,,46,,,Unknown,,cid:12)(cid:29)(cid:26)(cid:41)(cid:25)(cid:2)(cid:53)(cid:53)(cid:37)(cid:16)(cid:34)(cid:33,,4672.0
,,54,,,Unknown,,cid:12)(cid:29)(cid:26)(cid:41)(cid:25)(cid:2)(cid:53)(cid:53)(cid:37)(cid:16)(cid:34)(cid:33,,4726.0
,,3,,,Unknown,,cid:12)(cid:29)(cid:26)(cid:41)(cid:25)(cid:2)(cid:53)(cid:53)(cid:37)(cid:16)(cid:34)(cid:33,,4729.0
,,49,,,Unknown,,cid:12)(cid:29)(cid:26)(cid:41)(cid:25)(cid:2)(cid:53)(cid:53)(cid:37)(cid:16)(cid:34)(cid:33,,4778.0
,,3,,,Unknown,,cid:12)(cid:29)(cid:26)(cid:41)(cid:25)(cid:2)(cid:53)(cid:53)(cid:37)(cid:16)(cid:34)(cid:33,,4781.0
,,52,,,Unknown,,cid:12)(cid:29)(cid:26)(cid:41)(cid:25)(cid:2)(cid:53)(cid:53)(cid:37)(cid:16)(cid:34)(cid:33,,4833.0
,,43,,,Unknown,,cid:12)(cid:29)(cid:26)(cid:41)(cid:25)(cid:2)(cid:53)(cid:53)(cid:37)(cid:16)(cid:34)(cid:33,,4876.0
,,2,,,Unknown,,cid:12)(cid:29)(cid:26)(cid:41)(cid:25)(cid:2)(cid:53)(cid:53)(cid:37)(cid:16)(cid:34)(cid:33,,4878.0
,,1,,,Unknown,,cid:12)(cid:29)(cid:26)(cid:41)(cid:25)(cid:2)(cid:53)(cid:53)(cid:37)(cid:16)(cid:34)(cid:33,,4879.0
,,36,,,Unknown,,cid:12)(cid:29)(cid:26)(cid:41)(cid:25)(cid:2)(cid:53)(cid:53)(cid:37)(cid:16)(cid:34)(cid:33,,4915.0
,,34,,,Unknown,,cid:12)(cid:29)(cid:26)(cid:41)(cid:25)(cid:2)(cid:53)(cid:53)(cid:37)(cid:16)(cid:34)(cid:33,,4949.0
,,19,,,Unknown,,cid:12)(cid:29)(cid:26)(cid:41)(cid:25)(cid:2)(cid:53)(cid:53)(cid:37)(cid:16)(cid:34)(cid:33,,4968.0
,,18,,,Unknown,,cid:12)(cid:29)(cid:26)(cid:41)(cid:25)(cid:2)(cid:53)(cid:53)(cid:37)(cid:16)(cid:34)(cid:33,,4986.0
,,18,,,Unknown,,cid:12)(cid:29)(cid:26)(cid:41)(cid:25)(cid:2)(cid:53)(cid:53)(cid:37)(cid:16)(cid:34)(cid:33,,5004.0
,,2,,,Unknown,,cid:12)(cid:29)(cid:26)(cid:41)(cid:25)(cid:2)(cid:53)(cid:53)(cid:37)(cid:16)(cid:34)(cid:33,,5006.0
,,44,,,Unknown,,cid:12)(cid:29)(cid:26)(cid:41)(cid:25)(cid:2)(cid:53)(cid:53)(cid:37)(cid:16)(cid:34)(cid:33,,5050.0
,,52,,,Unknown,,cid:12)(cid:29)(cid:26)(cid:41)(cid:25)(cid:2)(cid:53)(cid:53)(cid:37)(cid:16)(cid:34)(cid:33,,5102.0
,,42,,,Unknown,,cid:12)(cid:29)(cid:26)(cid:41)(cid:25)(cid:2)(cid:53)(cid:53)(cid:37)(cid:16)(cid:34)(cid:33,,5144.0
,,55,,,Unknown,,cid:12)(cid:29)(cid:26)(cid:41)(cid:25)(cid:2)(cid:53)(cid:53)(cid:37)(cid:16)(cid:34)(cid:33,,5199.0
,,56,,,Unknown,,cid:12)(cid:29)(cid:26)(cid:41)(cid:25)(cid:2)(cid:53)(cid:53)(cid:37)(cid:16)(cid:34)(cid:33,,5255.0
,,41,,,Unknown,,cid:12)(cid:29)(cid:26)(cid:41)(cid:25)(cid:2)(cid:53)(cid:53)(cid:37)(cid:16)(cid:34)(cid:33,,5296.0
,,2,,,Unknown,,cid:12)(cid:29)(cid:26)(cid:41)(cid:25)(cid:2)(cid:53)(cid:53)(cid:37)(cid:16)(cid:34)(cid:33,,5298.0
,,51,,,Unknown,,cid:12)(cid:29)(cid:26)(cid:41)(cid:25)(cid:2)(cid:53)(cid:53)(cid:37)(cid:16)(cid:34)(cid:33,,5349.0
,,25,,,Unknown,,cid:12)(cid:29)(cid:26)(cid:41)(cid:25)(cid:2)(cid:53)(cid:53)(cid:37)(cid:16)(cid:34)(cid:33,,5374.0
,,2,,,Unknown,,cid:12)(cid:29)(cid:26)(cid:41)(cid:25)(cid:2)(cid:53)(cid:53)(cid:37)(cid:16)(cid:34)(cid:33,,5376.0
,,31,,,Unknown,,cid:12)(cid:29)(cid:26)(cid:41)(cid:25)(cid:2)(cid:53)(cid:53)(cid:37)(cid:16)(cid:34)(cid:33,,5407.0
,,57,,,Unknown,,cid:12)(cid:29)(cid:26)(cid:41)(cid:25)(cid:2)(cid:53)(cid:53)(cid:37)(cid:16)(cid:34)(cid:33,,5464.0
,,58,,,Unknown,,cid:12)(cid:29)(cid:26)(cid:41)(cid:25)(cid:2)(cid:53)(cid:53)(cid:37)(cid:16)(cid:34)(cid:33,,5522.0
,,59,,,Unknown,,cid:12)(cid:29)(cid:26)(cid:41)(cid:25)(cid:2)(cid:53)(cid:53)(cid:37)(cid:16)(cid:34)(cid:33,,5581.0
,,21,,,Unknown,,cid:12)(cid:29)(cid:26)(cid:41)(cid:25)(cid:2)(cid:53)(cid:53)(cid:37)(cid:16)(cid:34)(cid:33,,5602.0
,,25,,,Unknown,,cid:12)(cid:29)(cid:26)(cid:41)(cid:25)(cid:2)(cid:53)(cid:53)(cid:37)(cid:16)(cid:34)(cid:33,,5627.0
,,17,,,Unknown,,cid:12)(cid:29)(cid:26)(cid:41)(cid:25)(cid:2)(cid:53)(cid:53)(cid:37)(cid:16)(cid:34)(cid:33,,5644.0
,,37,,,Unknown,,cid:12)(cid:29)(cid:26)(cid:41)(cid:25)(cid:2)(cid:53)(cid:53)(cid:37)(cid:16)(cid:34)(cid:33,,5681.0
,,45,,,Unknown,,cid:12)(cid:29)(cid:26)(cid:41)(cid:25)(cid:2)(cid:53)(cid:53)(cid:37)(cid:16)(cid:34)(cid:33,,5726.0
,,18,,,Unknown,,cid:12)(cid:29)(cid:26)(cid:41)(cid:25)(cid:2)(cid:53)(cid:53)(cid:37)(cid:16)(cid:34)(cid:33,,5744.0
,,34,,,Unknown,,cid:12)(cid:29)(cid:26)(cid:41)(cid:25)(cid:2)(cid:53)(cid:53)(cid:37)(cid:16)(cid:34)(cid:33,,5778.0
,,38,,,Unknown,,cid:12)(cid:29)(cid:26)(cid:41)(cid:25)(cid:2)(cid:53)(cid:53)(cid:37)(cid:16)(cid:34)(cid:33,,5816.0
,,20,,,Unknown,,cid:12)(cid:29)(cid:26)(cid:41)(cid:25)(cid:2)(cid:53)(cid:53)(cid:37)(cid:16)(cid:34)(cid:33,,5836.0
,,30,,,Unknown,,cid:12)(cid:29)(cid:26)(cid:41)(cid:25)(cid:2)(cid:53)(cid:53)(cid:37)(cid:16)(cid:34)(cid:33,,5866.0
,,41,,,Unknown,,cid:12)(cid:29)(cid:26)(cid:41)(cid:25)(cid:2)(cid:53)(cid:53)(cid:37)(cid:16)(cid:34)(cid:33,,5907.0
,,20,,,Unknown,,cid:12)(cid:29)(cid:26)(cid:41)(cid:25)(cid:2)(cid:53)(cid:53)(cid:37)(cid:16)(cid:34)(cid:33,,5927.0
,,15,,,Unknown,,cid:12)(cid:29)(cid:26)(cid:41)(cid:25)(cid:2)(cid:53)(cid:53)(cid:37)(cid:16)(cid:34)(cid:33,,5942.0
,,2,,,Unknown,,cid:12)(cid:29)(cid:26)(cid:41)(cid:25)(cid:2)(cid:53)(cid:53)(cid:37)(cid:16)(cid:34)(cid:33,,5944.0
,,1,,,Unknown,,cid:12)(cid:29)(cid:26)(cid:41)(cid:25)(cid:2)(cid:53)(cid:53)(cid:37)(cid:16)(cid:34)(cid:33,,5945.0
,,19,,,Unknown,,cid:12)(cid:29)(cid:26)(cid:41)(cid:25)(cid:2)(cid:53)(cid:53)(cid:37)(cid:16)(cid:34)(cid:33,,5964.0
,,36,,,Unknown,,cid:12)(cid:29)(cid:26)(cid:41)(cid:25)(cid:2)(cid:53)(cid:53)(cid:37)(cid:16)(cid:34)(cid:33,,6000.0
,,18,,,Unknown,,cid:12)(cid:29)(cid:26)(cid:41)(cid:25)(cid:2)(cid:53)(cid:53)(cid:37)(cid:16)(cid:34)(cid:33,,6018.0
,,2,,,Unknown,,cid:12)(cid:29)(cid:26)(cid:41)(cid:25)(cid:2)(cid:53)(cid:53)(cid:37)(cid:16)(cid:34)(cid:33,,6020.0
,,44,,,Unknown,,cid:12)(cid:29)(cid:26)(cid:41)(cid:25)(cid:2)(cid:53)(cid:53)(cid:37)(cid:16)(cid:34)(cid:33,,6064.0
,,49,,,Unknown,,cid:12)(cid:29)(cid:26)(cid:41)(cid:25)(cid:2)(cid:53)(cid:53)(cid:37)(cid:16)(cid:34)(cid:33,,6113.0
,,50,,,Unknown,,cid:12)(cid:29)(cid:26)(cid:41)(cid:25)(cid:2)(cid:53)(cid:53)(cid:37)(cid:16)(cid:34)(cid:33,,6163.0
,,20,,,Unknown,,cid:12)(cid:29)(cid:26)(cid:41)(cid:25)(cid:2)(cid:53)(cid:53)(cid:37)(cid:16)(cid:34)(cid:33,,6183.0
,,30,,,Unknown,,cid:12)(cid:29)(cid:26)(cid:41)(cid:25)(cid:2)(cid:53)(cid:53)(cid:37)(cid:16)(cid:34)(cid:33,,6213.0
,,30,,,Unknown,,cid:12)(cid:29)(cid:26)(cid:41)(cid:25)(cid:2)(cid:53)(cid:53)(cid:37)(cid:16)(cid:34)(cid:33,,6243.0
,,25,,,Unknown,,cid:12)(cid:29)(cid:26)(cid:41)(cid:25)(cid:2)(cid:53)(cid:53)(cid:37)(cid:16)(cid:34)(cid:33,,6268.0
,,23,,,Unknown,,cid:12)(cid:29)(cid:26)(cid:41)(cid:25)(cid:2)(cid:53)(cid:53)(cid:37)(cid:16)(cid:34)(cid:33,,6291.0
,,25,,,Unknown,,cid:12)(cid:29)(cid:26)(cid:41)(cid:25)(cid:2)(cid:53)(cid:53)(cid:37)(cid:16)(cid:34)(cid:33,,6316.0
,,30,,,Unknown,,cid:12)(cid:29)(cid:26)(cid:41)(cid:25)(cid:2)(cid:53)(cid:53)(cid:37)(cid:16)(cid:34)(cid:33,,6346.0
,,41,,,Unknown,,cid:12)(cid:29)(cid:26)(cid:41)(cid:25)(cid:2)(cid:53)(cid:53)(cid:37)(cid:16)(cid:34)(cid:33,,6387.0
,,2,,,Unknown,,cid:12)(cid:29)(cid:26)(cid:41)(cid:25)(cid:2)(cid:53)(cid:53)(cid:37)(cid:16)(cid:34)(cid:33,,6389.0
,,45,,,Unknown,,cid:12)(cid:29)(cid:26)(cid:41)(cid:25)(cid:2)(cid:53)(cid:53)(cid:37)(cid:16)(cid:34)(cid:33,,6434.0
,,2,,,Unknown,,cid:12)(cid:29)(cid:26)(cid:41)(cid:25)(cid:2)(cid:53)(cid:53)(cid:37)(cid:16)(cid:34)(cid:33,,6436.0
,,28,,,Unknown,,cid:12)(cid:29)(cid:26)(cid:41)(cid:25)(cid:2)(cid:53)(cid:53)(cid:37)(cid:16)(cid:34)(cid:33,,6464.0
,,26,,,Unknown,,cid:12)(cid:29)(cid:26)(cid:41)(cid:25)(cid:2)(cid:53)(cid:53)(cid:37)(cid:16)(cid:34)(cid:33,,6490.0
,,29,,,Unknown,,cid:12)(cid:29)(cid:26)(cid:41)(cid:25)(cid:2)(cid:53)(cid:53)(cid:37)(cid:16)(cid:34)(cid:33,,6519.0
,,24,,,Unknown,,cid:12)(cid:29)(cid:26)(cid:41)(cid:25)(cid:2)(cid:53)(cid:53)(cid:37)(cid:16)(cid:34)(cid:33,,6543.0
,,27,,,Unknown,,cid:12)(cid:29)(cid:26)(cid:41)(cid:25)(cid:2)(cid:53)(cid:53)(cid:37)(cid:16)(cid:34)(cid:33,,6570.0
,,2,,,Unknown,,cid:12)(cid:29)(cid:26)(cid:41)(cid:25)(cid:2)(cid:53)(cid:53)(cid:37)(cid:16)(cid:34)(cid:33,,6572.0
,,29,,,Unknown,,cid:12)(cid:29)(cid:26)(cid:41)(cid:25)(cid:2)(cid:53)(cid:53)(cid:37)(cid:16)(cid:34)(cid:33,,6601.0
,,51,,,Unknown,,cid:12)(cid:29)(cid:26)(cid:41)(cid:25)(cid:2)(cid:53)(cid:53)(cid:37)(cid:16)(cid:34)(cid:33,,6652.0
,,51,,,Unknown,,cid:12)(cid:29)(cid:26)(cid:41)(cid:25)(cid:2)(cid:53)(cid:53)(cid:37)(cid:16)(cid:34)(cid:33,,6703.0
,,24,,,Unknown,,cid:12)(cid:29)(cid:26)(cid:41)(cid:25)(cid:2)(cid:53)(cid:53)(cid:37)(cid:16)(cid:34)(cid:33,,6727.0
,,41,,,Unknown,,cid:12)(cid:29)(cid:26)(cid:41)(cid:25)(cid:2)(cid:53)(cid:53)(cid:37)(cid:16)(cid:34)(cid:33,,6768.0
,,24,,,Unknown,,cid:12)(cid:29)(cid:26)(cid:41)(cid:25)(cid:2)(cid:53)(cid:53)(cid:37)(cid:16)(cid:34)(cid:33,,6792.0
,,20,,,Unknown,,cid:12)(cid:29)(cid:26)(cid:41)(cid:25)(cid:2)(cid:53)(cid:53)(cid:37)(cid:16)(cid:34)(cid:33,,6812.0
,,30,,,Unknown,,cid:12)(cid:29)(cid:26)(cid:41)(cid:25)(cid:2)(cid:53)(cid:53)(cid:37)(cid:16)(cid:34)(cid:33,,6842.0
,,30,,,Unknown,,cid:12)(cid:29)(cid:26)(cid:41)(cid:25)(cid:2)(cid:53)(cid:53)(cid:37)(cid:16)(cid:34)(cid:33,,6872.0
,,25,,,Unknown,,cid:12)(cid:29)(cid:26)(cid:41)(cid:25)(cid:2)(cid:53)(cid:53)(cid:37)(cid:16)(cid:34)(cid:33,,6897.0
,,22,,,Unknown,,cid:12)(cid:29)(cid:26)(cid:41)(cid:25)(cid:2)(cid:53)(cid:53)(cid:37)(cid:16)(cid:34)(cid:33,,6919.0
,,27,,,Unknown,,cid:12)(cid:29)(cid:26)(cid:41)(cid:25)(cid:2)(cid:53)(cid:53)(cid:37)(cid:16)(cid:34)(cid:33,,6946.0
,,17,,,Unknown,,cid:12)(cid:29)(cid:26)(cid:41)(cid:25)(cid:2)(cid:53)(cid:53)(cid:37)(cid:16)(cid:34)(cid:33,,6963.0
,,16,,,Unknown,,cid:12)(cid:29)(cid:26)(cid:41)(cid:25)(cid:2)(cid:53)(cid:53)(cid:37)(cid:16)(cid:34)(cid:33,,6979.0
,,45,,,Unknown,,cid:12)(cid:29)(cid:26)(cid:41)(cid:25)(cid:2)(cid:53)(cid:53)(cid:37)(cid:16)(cid:34)(cid:33,,7024.0
,,18,,,Unknown,,cid:12)(cid:29)(cid:26)(cid:41)(cid:25)(cid:2)(cid:53)(cid:53)(cid:37)(cid:16)(cid:34)(cid:33,,7042.0
,,34,,,Unknown,,cid:12)(cid:29)(cid:26)(cid:41)(cid:25)(cid:2)(cid:53)(cid:53)(cid:37)(cid:16)(cid:34)(cid:33,,7076.0
,,9,,,Unknown,,cid:12)(cid:29)(cid:26)(cid:41)(cid:25)(cid:2)(cid:53)(cid:53)(cid:37)(cid:16)(cid:34)(cid:33,,7085.0
,,13,,,Unknown,,cid:12)(cid:29)(cid:26)(cid:41)(cid:25)(cid:2)(cid:53)(cid:53)(cid:37)(cid:16)(cid:34)(cid:33,,7098.0
,,39,,,Unknown,,cid:12)(cid:29)(cid:26)(cid:41)(cid:25)(cid:2)(cid:53)(cid:53)(cid:37)(cid:16)(cid:34)(cid:33,,7137.0
,,60,,,Unknown,,cid:12)(cid:29)(cid:26)(cid:41)(cid:25)(cid:2)(cid:53)(cid:53)(cid:37)(cid:16)(cid:34)(cid:33,,7197.0
,,2,,,Unknown,,cid:12)(cid:29)(cid:26)(cid:41)(cid:25)(cid:2)(cid:53)(cid:53)(cid:37)(cid:16)(cid:34)(cid:33,,7199.0
,,47,,,Unknown,,cid:12)(cid:29)(cid:26)(cid:41)(cid:25)(cid:2)(cid:53)(cid:53)(cid:37)(cid:16)(cid:34)(cid:33,,7246.0
,,5,,,Unknown,,cid:12)(cid:29)(cid:26)(cid:41)(cid:25)(cid:2)(cid:53)(cid:53)(cid:37)(cid:16)(cid:34)(cid:33,,7251.0
,,60,,,Unknown,,cid:12)(cid:29)(cid:26)(cid:41)(cid:25)(cid:2)(cid:53)(cid:53)(cid:37)(cid:16)(cid:34)(cid:33,,7311.0
,,49,,,Unknown,,cid:12)(cid:29)(cid:26)(cid:41)(cid:25)(cid:2)(cid:53)(cid:53)(cid:37)(cid:16)(cid:34)(cid:33,,7360.0
,,2,,,Unknown,,cid:12)(cid:29)(cid:26)(cid:41)(cid:25)(cid:2)(cid:53)(cid:53)(cid:37)(cid:16)(cid:34)(cid:33,,7362.0
,,10,,,Unknown,,cid:12)(cid:29)(cid:26)(cid:41)(cid:25)(cid:2)(cid:53)(cid:53)(cid:37)(cid:16)(cid:34)(cid:33,,7372.0
,,3,,,Unknown,,cid:12)(cid:29)(cid:26)(cid:41)(cid:25)(cid:2)(cid:53)(cid:53)(cid:37)(cid:16)(cid:34)(cid:33,,7375.0
,,49,,,Unknown,,cid:12)(cid:29)(cid:26)(cid:41)(cid:25)(cid:2)(cid:53)(cid:53)(cid:37)(cid:16)(cid:34)(cid:33,,7424.0
,,52,,,Unknown,,cid:12)(cid:29)(cid:26)(cid:41)(cid:25)(cid:2)(cid:53)(cid:53)(cid:37)(cid:16)(cid:34)(cid:33,,7476.0
,,5,,,Unknown,,cid:12)(cid:29)(cid:26)(cid:41)(cid:25)(cid:2)(cid:53)(cid:53)(cid:37)(cid:16)(cid:34)(cid:33,,7481.0
,,2,,,Unknown,,cid:12)(cid:29)(cid:26)(cid:41)(cid:25)(cid:2)(cid:53)(cid:53)(cid:37)(cid:16)(cid:34)(cid:33,,7483.0
,,39,,,Unknown,,cid:12)(cid:29)(cid:26)(cid:41)(cid:25)(cid:2)(cid:53)(cid:53)(cid:37)(cid:16)(cid:34)(cid:33,,7522.0
,,26,,,Unknown,,cid:12)(cid:29)(cid:26)(cid:41)(cid:25)(cid:2)(cid:53)(cid:53)(cid:37)(cid:16)(cid:34)(cid:33,,7548.0
,,24,,,Unknown,,cid:12)(cid:29)(cid:26)(cid:41)(cid:25)(cid:2)(cid:53)(cid:53)(cid:37)(cid:16)(cid:34)(cid:33,,7572.0
,,27,,,Unknown,,cid:12)(cid:29)(cid:26)(cid:41)(cid:25)(cid:2)(cid:53)(cid:53)(cid:37)(cid:16)(cid:34)(cid:33,,7599.0
,,57,,,Unknown,,cid:12)(cid:29)(cid:26)(cid:41)(cid:25)(cid:2)(cid:53)(cid:53)(cid:37)(cid:16)(cid:34)(cid:33,,7656.0
,,41,,,Unknown,,cid:12)(cid:29)(cid:26)(cid:41)(cid:25)(cid:2)(cid:53)(cid:53)(cid:37)(cid:16)(cid:34)(cid:33,,7697.0
,,24,,,Unknown,,cid:12)(cid:29)(cid:26)(cid:41)(cid:25)(cid:2)(cid:53)(cid:53)(cid:37)(cid:16)(cid:34)(cid:33,,7721.0
,,30,,,Unknown,,cid:12)(cid:29)(cid:26)(cid:41)(cid:25)(cid:2)(cid:53)(cid:53)(cid:37)(cid:16)(cid:34)(cid:33,,7751.0
,,25,,,Unknown,,cid:12)(cid:29)(cid:26)(cid:41)(cid:25)(cid:2)(cid:53)(cid:53)(cid:37)(cid:16)(cid:34)(cid:33,,7776.0
,,2,,,Unknown,,cid:12)(cid:29)(cid:26)(cid:41)(cid:25)(cid:2)(cid:53)(cid:53)(cid:37)(cid:16)(cid:34)(cid:33,,7778.0
,,38,,,Unknown,,cid:12)(cid:29)(cid:26)(cid:41)(cid:25)(cid:2)(cid:53)(cid:53)(cid:37)(cid:16)(cid:34)(cid:33,,7816.0
,,61,,,Unknown,,cid:12)(cid:29)(cid:26)(cid:41)(cid:25)(cid:2)(cid:53)(cid:53)(cid:37)(cid:16)(cid:34)(cid:33,,7877.0
,,15,,,Unknown,,cid:12)(cid:29)(cid:26)(cid:41)(cid:25)(cid:2)(cid:53)(cid:53)(cid:37)(cid:16)(cid:34)(cid:33,,7892.0
,,2,,,Unknown,,cid:12)(cid:29)(cid:26)(cid:41)(cid:25)(cid:2)(cid:53)(cid:53)(cid:37)(cid:16)(cid:34)(cid:33,,7894.0
,,36,,,Unknown,,cid:12)(cid:29)(cid:26)(cid:41)(cid:25)(cid:2)(cid:53)(cid:53)(cid:37)(cid:16)(cid:34)(cid:33,,7930.0
,,17,,,Unknown,,cid:12)(cid:29)(cid:26)(cid:41)(cid:25)(cid:2)(cid:53)(cid:53)(cid:37)(cid:16)(cid:34)(cid:33,,7947.0
,,19,,,Unknown,,cid:12)(cid:29)(cid:26)(cid:41)(cid:25)(cid:2)(cid:53)(cid:53)(cid:37)(cid:16)(cid:34)(cid:33,,7966.0
,,33,,,Unknown,,cid:12)(cid:29)(cid:26)(cid:41)(cid:25)(cid:2)(cid:53)(cid:53)(cid:37)(cid:16)(cid:34)(cid:33,,7999.0
,,35,,,Unknown,,cid:12)(cid:29)(cid:26)(cid:41)(cid:25)(cid:2)(cid:53)(cid:53)(cid:37)(cid:16)(cid:34)(cid:33,,8034.0
,,2,,,Unknown,,cid:12)(cid:29)(cid:26)(cid:41)(cid:25)(cid:2)(cid:53)(cid:53)(cid:37)(cid:16)(cid:34)(cid:33,,8036.0
,,44,,,Unknown,,cid:12)(cid:29)(cid:26)(cid:41)(cid:25)(cid:2)(cid:53)(cid:53)(cid:37)(cid:16)(cid:34)(cid:33,,8080.0
,,12,,,Unknown,,cid:12)(cid:29)(cid:26)(cid:41)(cid:25)(cid:2)(cid:53)(cid:53)(cid:37)(cid:16)(cid:34)(cid:33,,8092.0
,,29,,,Unknown,,cid:12)(cid:29)(cid:26)(cid:41)(cid:25)(cid:2)(cid:53)(cid:53)(cid:37)(cid:16)(cid:34)(cid:33,,8121.0
,,26,,,Unknown,,cid:12)(cid:29)(cid:26)(cid:41)(cid:25)(cid:2)(cid:53)(cid:53)(cid:37)(cid:16)(cid:34)(cid:33,,8147.0
,,41,,,Unknown,,cid:12)(cid:29)(cid:26)(cid:41)(cid:25)(cid:2)(cid:53)(cid:53)(cid:37)(cid:16)(cid:34)(cid:33,,8188.0
,,25,,,Unknown,,cid:12)(cid:29)(cid:26)(cid:41)(cid:25)(cid:2)(cid:53)(cid:53)(cid:37)(cid:16)(cid:34)(cid:33,,8213.0
,,2,,,Unknown,,cid:12)(cid:29)(cid:26)(cid:41)(cid:25)(cid:2)(cid:53)(cid:53)(cid:37)(cid:16)(cid:34)(cid:33,,8215.0
,,53,,,Unknown,,cid:12)(cid:29)(cid:26)(cid:41)(cid:25)(cid:2)(cid:53)(cid:53)(cid:37)(cid:16)(cid:34)(cid:33,,8268.0
,,53,,,Unknown,,cid:12)(cid:29)(cid:26)(cid:41)(cid:25)(cid:2)(cid:53)(cid:53)(cid:37)(cid:16)(cid:34)(cid:33,,8321.0
,,18,,,Unknown,,cid:12)(cid:29)(cid:26)(cid:41)(cid:25)(cid:2)(cid:53)(cid:53)(cid:37)(cid:16)(cid:34)(cid:33,,8339.0
,,1,,,Unknown,,cid:12)(cid:29)(cid:26)(cid:41)(cid:25)(cid:2)(cid:53)(cid:53)(cid:37)(cid:16)(cid:34)(cid:33,,8340.0
,,1,,,Unknown,,cid:12)(cid:29)(cid:26)(cid:41)(cid:25)(cid:2)(cid:53)(cid:53)(cid:37)(cid:16)(cid:34)(cid:33,,8341.0
,,37,,,Unknown,,cid:12)(cid:29)(cid:26)(cid:41)(cid:25)(cid:2)(cid:53)(cid:53)(cid:37)(cid:16)(cid:34)(cid:33,,8378.0
,,17,,,Unknown,,cid:12)(cid:29)(cid:26)(cid:41)(cid:25)(cid:2)(cid:53)(cid:53)(cid:37)(cid:16)(cid:34)(cid:33,,8395.0
,,16,,,Unknown,,cid:12)(cid:29)(cid:26)(cid:41)(cid:25)(cid:2)(cid:53)(cid:53)(cid:37)(cid:16)(cid:34)(cid:33,,8411.0
,,45,,,Unknown,,cid:12)(cid:29)(cid:26)(cid:41)(cid:25)(cid:2)(cid:53)(cid:53)(cid:37)(cid:16)(cid:34)(cid:33,,8456.0
,,18,,,Unknown,,cid:12)(cid:29)(cid:26)(cid:41)(cid:25)(cid:2)(cid:53)(cid:53)(cid:37)(cid:16)(cid:34)(cid:33,,8474.0
,,34,,,Unknown,,cid:12)(cid:29)(cid:26)(cid:41)(cid:25)(cid:2)(cid:53)(cid:53)(cid:37)(cid:16)(cid:34)(cid:33,,8508.0
,,7,,,Unknown,,cid:12)(cid:29)(cid:26)(cid:41)(cid:25)(cid:2)(cid:53)(cid:53)(cid:37)(cid:16)(cid:34)(cid:33,,8515.0
,,39,,,Unknown,,cid:12)(cid:29)(cid:26)(cid:41)(cid:25)(cid:2)(cid:53)(cid:53)(cid:37)(cid:16)(cid:34)(cid:33,,8554.0
,,2,,,Unknown,,cid:12)(cid:29)(cid:26)(cid:41)(cid:25)(cid:2)(cid:53)(cid:53)(cid:37)(cid:16)(cid:34)(cid:33,,8556.0
,,60,,,Unknown,,cid:12)(cid:29)(cid:26)(cid:41)(cid:25)(cid:2)(cid:53)(cid:53)(cid:37)(cid:16)(cid:34)(cid:33,,8616.0
,,11,,,Unknown,,cid:12)(cid:29)(cid:26)(cid:41)(cid:25)(cid:2)(cid:53)(cid:53)(cid:37)(cid:16)(cid:34)(cid:33,,8627.0
,,9,,,Unknown,,cid:12)(cid:29)(cid:26)(cid:41)(cid:25)(cid:2)(cid:53)(cid:53)(cid:37)(cid:16)(cid:34)(cid:33,,8636.0
,,2,,,Unknown,,cid:12)(cid:29)(cid:26)(cid:41)(cid:25)(cid:2)(cid:53)(cid:53)(cid:37)(cid:16)(cid:34)(cid:33,,8638.0
,,9,,,Unknown,,cid:12)(cid:29)(cid:26)(cid:41)(cid:25)(cid:2)(cid:53)(cid:53)(cid:37)(cid:16)(cid:34)(cid:33,,8647.0
,,13,,,Unknown,,cid:12)(cid:29)(cid:26)(cid:41)(cid:25)(cid:2)(cid:53)(cid:53)(cid:37)(cid:16)(cid:34)(cid:33,,8660.0
,,39,,,Unknown,,cid:12)(cid:29)(cid:26)(cid:41)(cid:25)(cid:2)(cid:53)(cid:53)(cid:37)(cid:16)(cid:34)(cid:33,,8699.0
,,60,,,Unknown,,cid:12)(cid:29)(cid:26)(cid:41)(cid:25)(cid:2)(cid:53)(cid:53)(cid:37)(cid:16)(cid:34)(cid:33,,8759.0
,,2,,,Unknown,,cid:12)(cid:29)(cid:26)(cid:41)(cid:25)(cid:2)(cid:53)(cid:53)(cid:37)(cid:16)(cid:34)(cid:33,,8761.0
,,39,,,Unknown,,cid:12)(cid:29)(cid:26)(cid:41)(cid:25)(cid:2)(cid:53)(cid:53)(cid:37)(cid:16)(cid:34)(cid:33,,8800.0
,,3,,,Unknown,,cid:12)(cid:29)(cid:26)(cid:41)(cid:25)(cid:2)(cid:53)(cid:53)(cid:37)(cid:16)(cid:34)(cid:33,,8803.0
,,7,,,Unknown,,cid:12)(cid:29)(cid:26)(cid:41)(cid:25)(cid:2)(cid:53)(cid:53)(cid:37)(cid:16)(cid:34)(cid:33,,8810.0
,,9,,,Unknown,,cid:12)(cid:29)(cid:26)(cid:41)(cid:25)(cid:2)(cid:53)(cid:53)(cid:37)(cid:16)(cid:34)(cid:33,,8819.0
,,13,,,Unknown,,cid:12)(cid:29)(cid:26)(cid:41)(cid:25)(cid:2)(cid:53)(cid:53)(cid:37)(cid:16)(cid:34)(cid:33,,8832.0
,,10,,,Unknown,,cid:12)(cid:29)(cid:26)(cid:41)(cid:25)(cid:2)(cid:53)(cid:53)(cid:37)(cid:16)(cid:34)(cid:33,,8842.0
,,7,,,Unknown,,cid:12)(cid:29)(cid:26)(cid:41)(cid:25)(cid:2)(cid:53)(cid:53)(cid:37)(cid:16)(cid:34)(cid:33,,8849.0
,,8,,,Unknown,,cid:12)(cid:29)(cid:26)(cid:41)(cid:25)(cid:2)(cid:53)(cid:53)(cid:37)(cid:16)(cid:34)(cid:33,,8857.0
,,49,,,Unknown,,cid:12)(cid:29)(cid:26)(cid:41)(cid:25)(cid:2)(cid:53)(cid:53)(cid:37)(cid:16)(cid:34)(cid:33,,8906.0
,,2,,,Unknown,,cid:12)(cid:29)(cid:26)(cid:41)(cid:25)(cid:2)(cid:53)(cid:53)(cid:37)(cid:16)(cid:34)(cid:33,,8908.0
,,38,,,Unknown,,cid:12)(cid:29)(cid:26)(cid:41)(cid:25)(cid:2)(cid:53)(cid:53)(cid:37)(cid:16)(cid:34)(cid:33,,8946.0
,,61,,,Unknown,,cid:12)(cid:29)(cid:26)(cid:41)(cid:25)(cid:2)(cid:53)(cid:53)(cid:37)(cid:16)(cid:34)(cid:33,,9007.0
,,15,,,Unknown,,cid:12)(cid:29)(cid:26)(cid:41)(cid:25)(cid:2)(cid:53)(cid:53)(cid:37)(cid:16)(cid:34)(cid:33,,9022.0
,,2,,,Unknown,,cid:12)(cid:29)(cid:26)(cid:41)(cid:25)(cid:2)(cid:53)(cid:53)(cid:37)(cid:16)(cid:34)(cid:33,,9024.0
,,33,,,Unknown,,cid:12)(cid:29)(cid:26)(cid:41)(cid:25)(cid:2)(cid:53)(cid:53)(cid:37)(cid:16)(cid:34)(cid:33,,9057.0
,,34,,,Unknown,,cid:12)(cid:29)(cid:26)(cid:41)(cid:25)(cid:2)(cid:53)(cid:53)(cid:37)(cid:16)(cid:34)(cid:33,,9091.0
,,19,,,Unknown,,cid:12)(cid:29)(cid:26)(cid:41)(cid:25)(cid:2)(cid:53)(cid:53)(cid:37)(cid:16)(cid:34)(cid:33,,9110.0
,,18,,,Unknown,,cid:12)(cid:29)(cid:26)(cid:41)(cid:25)(cid:2)(cid:53)(cid:53)(cid:37)(cid:16)(cid:34)(cid:33,,9128.0
,,18,,,Unknown,,cid:12)(cid:29)(cid:26)(cid:41)(cid:25)(cid:2)(cid:53)(cid:53)(cid:37)(cid:16)(cid:34)(cid:33,,9146.0
,,2,,,Unknown,,cid:12)(cid:29)(cid:26)(cid:41)(cid:25)(cid:2)(cid:53)(cid:53)(cid:37)(cid:16)(cid:34)(cid:33,,9148.0
,,44,,,Unknown,,cid:12)(cid:29)(cid:26)(cid:41)(cid:25)(cid:2)(cid:53)(cid:53)(cid:37)(cid:16)(cid:34)(cid:33,,9192.0
,,12,,,Unknown,,cid:12)(cid:29)(cid:26)(cid:41)(cid:25)(cid:2)(cid:53)(cid:53)(cid:37)(cid:16)(cid:34)(cid:33,,9204.0
,,29,,,Unknown,,cid:12)(cid:29)(cid:26)(cid:41)(cid:25)(cid:2)(cid:53)(cid:53)(cid:37)(cid:16)(cid:34)(cid:33,,9233.0
,,26,,,Unknown,,cid:12)(cid:29)(cid:26)(cid:41)(cid:25)(cid:2)(cid:53)(cid:53)(cid:37)(cid:16)(cid:34)(cid:33,,9259.0
,,41,,,Unknown,,cid:12)(cid:29)(cid:26)(cid:41)(cid:25)(cid:2)(cid:53)(cid:53)(cid:37)(cid:16)(cid:34)(cid:33,,9300.0
,,25,,,Unknown,,cid:12)(cid:29)(cid:26)(cid:41)(cid:25)(cid:2)(cid:53)(cid:53)(cid:37)(cid:16)(cid:34)(cid:33,,9325.0
,,2,,,Unknown,,cid:12)(cid:29)(cid:26)(cid:41)(cid:25)(cid:2)(cid:53)(cid:53)(cid:37)(cid:16)(cid:34)(cid:33,,9327.0
,,53,,,Unknown,,cid:12)(cid:29)(cid:26)(cid:41)(cid:25)(cid:2)(cid:53)(cid:53)(cid:37)(cid:16)(cid:34)(cid:33,,9380.0
,,53,,,Unknown,,cid:12)(cid:29)(cid:26)(cid:41)(cid:25)(cid:2)(cid:53)(cid:53)(cid:37)(cid:16)(cid:34)(cid:33,,9433.0
,,18,,,Unknown,,cid:12)(cid:29)(cid:26)(cid:41)(cid:25)(cid:2)(cid:53)(cid:53)(cid:37)(cid:16)(cid:34)(cid:33,,9451.0
,,1,,,Unknown,,cid:12)(cid:29)(cid:26)(cid:41)(cid:25)(cid:2)(cid:53)(cid:53)(cid:37)(cid:16)(cid:34)(cid:33,,9452.0
,,1,,,Unknown,,cid:12)(cid:29)(cid:26)(cid:41)(cid:25)(cid:2)(cid:53)(cid:53)(cid:37)(cid:16)(cid:34)(cid:33,,9453.0
,,37,,,Unknown,,cid:12)(cid:29)(cid:26)(cid:41)(cid:25)(cid:2)(cid:53)(cid:53)(cid:37)(cid:16)(cid:34)(cid:33,,9490.0
,,17,,,Unknown,,cid:12)(cid:29)(cid:26)(cid:41)(cid:25)(cid:2)(cid:53)(cid:53)(cid:37)(cid:16)(cid:34)(cid:33,,9507.0
,,33,,,Unknown,,cid:12)(cid:29)(cid:26)(cid:41)(cid:25)(cid:2)(cid:53)(cid:53)(cid:37)(cid:16)(cid:34)(cid:33,,9540.0
,,45,,,Unknown,,cid:12)(cid:29)(cid:26)(cid:41)(cid:25)(cid:2)(cid:53)(cid:53)(cid:37)(cid:16)(cid:34)(cid:33,,9585.0
,,18,,,Unknown,,cid:12)(cid:29)(cid:26)(cid:41)(cid:25)(cid:2)(cid:53)(cid:53)(cid:37)(cid:16)(cid:34)(cid:33,,9603.0
,,34,,,Unknown,,cid:12)(cid:29)(cid:26)(cid:41)(cid:25)(cid:2)(cid:53)(cid:53)(cid:37)(cid:16)(cid:34)(cid:33,,9637.0
,,35,,,Unknown,,cid:12)(cid:29)(cid:26)(cid:41)(cid:25)(cid:2)(cid:53)(cid:53)(cid:37)(cid:16)(cid:34)(cid:33,,9672.0
,,17,,,Unknown,,cid:12)(cid:29)(cid:26)(cid:41)(cid:25)(cid:2)(cid:53)(cid:53)(cid:37)(cid:16)(cid:34)(cid:33,,9689.0
,,18,,,Unknown,,cid:12)(cid:29)(cid:26)(cid:41)(cid:25)(cid:2)(cid:53)(cid:53)(cid:37)(cid:16)(cid:34)(cid:33,,9707.0
,,2,,,Unknown,,cid:12)(cid:29)(cid:26)(cid:41)(cid:25)(cid:2)(cid:53)(cid:53)(cid:37)(cid:16)(cid:34)(cid:33,,9709.0
,,62,,,Unknown,,cid:12)(cid:29)(cid:26)(cid:41)(cid:25)(cid:2)(cid:53)(cid:53)(cid:37)(cid:16)(cid:34)(cid:33,,9771.0
,,49,,,Unknown,,cid:12)(cid:29)(cid:26)(cid:41)(cid:25)(cid:2)(cid:53)(cid:53)(cid:37)(cid:16)(cid:34)(cid:33,,9820.0
,,14,,,Unknown,,cid:12)(cid:29)(cid:26)(cid:41)(cid:25)(cid:2)(cid:53)(cid:53)(cid:37)(cid:16)(cid:34)(cid:33,,9834.0
,,7,,,Unknown,,cid:12)(cid:29)(cid:26)(cid:41)(cid:25)(cid:2)(cid:53)(cid:53)(cid:37)(cid:16)(cid:34)(cid:33,,9841.0
,,2,,,Unknown,,cid:12)(cid:29)(cid:26)(cid:41)(cid:25)(cid:2)(cid:53)(cid:53)(cid:37)(cid:16)(cid:34)(cid:33,,9843.0
,,39,,,Unknown,,cid:12)(cid:29)(cid:26)(cid:41)(cid:25)(cid:2)(cid:53)(cid:53)(cid:37)(cid:16)(cid:34)(cid:33,,9882.0
,,11,,,Unknown,,cid:12)(cid:29)(cid:26)(cid:41)(cid:25)(cid:2)(cid:53)(cid:53)(cid:37)(cid:16)(cid:34)(cid:33,,9893.0
,,61,,,Unknown,,cid:12)(cid:29)(cid:26)(cid:41)(cid:25)(cid:2)(cid:53)(cid:53)(cid:37)(cid:16)(cid:34)(cid:33,,9954.0
,,49,,,Unknown,,cid:12)(cid:29)(cid:26)(cid:41)(cid:25)(cid:2)(cid:53)(cid:53)(cid:37)(cid:16)(cid:34)(cid:33,,10003.0
,,3,,,Unknown,,cid:12)(cid:29)(cid:26)(cid:41)(cid:25)(cid:2)(cid:53)(cid:53)(cid:37)(cid:16)(cid:34)(cid:33,,10006.0
,,5,,,Unknown,,cid:12)(cid:29)(cid:26)(cid:41)(cid:25)(cid:2)(cid:53)(cid:53)(cid:37)(cid:16)(cid:34)(cid:33,,10011.0
,,63,,,Unknown,,cid:12)(cid:29)(cid:26)(cid:41)(cid:25)(cid:2)(cid:53)(cid:53)(cid:37)(cid:16)(cid:34)(cid:33,,10074.0
,,49,,,Unknown,,cid:12)(cid:29)(cid:26)(cid:41)(cid:25)(cid:2)(cid:53)(cid:53)(cid:37)(cid:16)(cid:34)(cid:33,,10123.0
,,12,,,Unknown,,cid:12)(cid:29)(cid:26)(cid:41)(cid:25)(cid:2)(cid:53)(cid:53)(cid:37)(cid:16)(cid:34)(cid:33,,10135.0
,,2,,,Unknown,,cid:12)(cid:29)(cid:26)(cid:41)(cid:25)(cid:2)(cid:53)(cid:53)(cid:37)(cid:16)(cid:34)(cid:33,,10137.0
,,39,,,Unknown,,cid:12)(cid:29)(cid:26)(cid:41)(cid:25)(cid:2)(cid:53)(cid:53)(cid:37)(cid:16)(cid:34)(cid:33,,10176.0
,,11,,,Unknown,,cid:12)(cid:29)(cid:26)(cid:41)(cid:25)(cid:2)(cid:53)(cid:53)(cid:37)(cid:16)(cid:34)(cid:33,,10187.0
,,61,,,Unknown,,cid:12)(cid:29)(cid:26)(cid:41)(cid:25)(cid:2)(cid:53)(cid:53)(cid:37)(cid:16)(cid:34)(cid:33,,10248.0
,,49,,,Unknown,,cid:12)(cid:29)(cid:26)(cid:41)(cid:25)(cid:2)(cid:53)(cid:53)(cid:37)(cid:16)(cid:34)(cid:33,,10297.0
,,3,,,Unknown,,cid:12)(cid:29)(cid:26)(cid:41)(cid:25)(cid:2)(cid:53)(cid:53)(cid:37)(cid:16)(cid:34)(cid:33,,10300.0
,,5,,,Unknown,,cid:12)(cid:29)(cid:26)(cid:41)(cid:25)(cid:2)(cid:53)(cid:53)(cid:37)(cid:16)(cid:34)(cid:33,,10305.0
,,63,,,Unknown,,cid:12)(cid:29)(cid:26)(cid:41)(cid:25)(cid:2)(cid:53)(cid:53)(cid:37)(cid:16)(cid:34)(cid:33,,10368.0
,,49,,,Unknown,,cid:12)(cid:29)(cid:26)(cid:41)(cid:25)(cid:2)(cid:53)(cid:53)(cid:37)(cid:16)(cid:34)(cid:33,,10417.0
,,12,,,Unknown,,cid:12)(cid:29)(cid:26)(cid:41)(cid:25)(cid:2)(cid:53)(cid:53)(cid:37)(cid:16)(cid:34)(cid:33,,10429.0
,,2,,,Unknown,,cid:12)(cid:29)(cid:26)(cid:41)(cid:25)(cid:2)(cid:53)(cid:53)(cid:37)(cid:16)(cid:34)(cid:33,,10431.0
,,3,,,Unknown,,cid:12)(cid:29)(cid:26)(cid:41)(cid:25)(cid:2)(cid:53)(cid:53)(cid:37)(cid:16)(cid:34)(cid:33,,10434.0
,,9,,,Unknown,,cid:12)(cid:29)(cid:26)(cid:41)(cid:25)(cid:2)(cid:53)(cid:53)(cid:37)(cid:16)(cid:34)(cid:33,,10443.0
,,15,,,Unknown,,cid:12)(cid:29)(cid:26)(cid:41)(cid:25)(cid:2)(cid:53)(cid:53)(cid:37)(cid:16)(cid:34)(cid:33,,10458.0
,,2,,,Unknown,,cid:12)(cid:29)(cid:26)(cid:41)(cid:25)(cid:2)(cid:53)(cid:53)(cid:37)(cid:16)(cid:34)(cid:33,,10460.0
,,17,,,Unknown,,cid:12)(cid:29)(cid:26)(cid:41)(cid:25)(cid:2)(cid:53)(cid:53)(cid:37)(cid:16)(cid:34)(cid:33,,10477.0
,,19,,,Unknown,,cid:12)(cid:29)(cid:26)(cid:41)(cid:25)(cid:2)(cid:53)(cid:53)(cid:37)(cid:16)(cid:34)(cid:33,,10496.0
,,16,,,Unknown,,cid:12)(cid:29)(cid:26)(cid:41)(cid:25)(cid:2)(cid:53)(cid:53)(cid:37)(cid:16)(cid:34)(cid:33,,10512.0
,,17,,,Unknown,,cid:12)(cid:29)(cid:26)(cid:41)(cid:25)(cid:2)(cid:53)(cid:53)(cid:37)(cid:16)(cid:34)(cid:33,,10529.0
,,2,,,Unknown,,cid:12)(cid:29)(cid:26)(cid:41)(cid:25)(cid:2)(cid:53)(cid:53)(cid:37)(cid:16)(cid:34)(cid:33,,10531.0
,,44,,,Unknown,,cid:12)(cid:29)(cid:26)(cid:41)(cid:25)(cid:2)(cid:53)(cid:53)(cid:37)(cid:16)(cid:34)(cid:33,,10575.0
,,17,,,Unknown,,cid:12)(cid:29)(cid:26)(cid:41)(cid:25)(cid:2)(cid:53)(cid:53)(cid:37)(cid:16)(cid:34)(cid:33,,10592.0
,,17,,,Unknown,,cid:12)(cid:29)(cid:26)(cid:41)(cid:25)(cid:2)(cid:53)(cid:53)(cid:37)(cid:16)(cid:34)(cid:33,,10609.0
,,32,,,Unknown,,cid:12)(cid:29)(cid:26)(cid:41)(cid:25)(cid:2)(cid:53)(cid:53)(cid:37)(cid:16)(cid:34)(cid:33,,10641.0
,,19,,,Unknown,,cid:12)(cid:29)(cid:26)(cid:41)(cid:25)(cid:2)(cid:53)(cid:53)(cid:37)(cid:16)(cid:34)(cid:33,,10660.0
,,33,,,Unknown,,cid:12)(cid:29)(cid:26)(cid:41)(cid:25)(cid:2)(cid:53)(cid:53)(cid:37)(cid:16)(cid:34)(cid:33,,10693.0
,,34,,,Unknown,,cid:12)(cid:29)(cid:26)(cid:41)(cid:25)(cid:2)(cid:53)(cid:53)(cid:37)(cid:16)(cid:34)(cid:33,,10727.0
,,33,,,Unknown,,cid:12)(cid:29)(cid:26)(cid:41)(cid:25)(cid:2)(cid:53)(cid:53)(cid:37)(cid:16)(cid:34)(cid:33,,10760.0
,,18,,,Unknown,,cid:12)(cid:29)(cid:26)(cid:41)(cid:25)(cid:2)(cid:53)(cid:53)(cid:37)(cid:16)(cid:34)(cid:33,,10778.0
,,32,,,Unknown,,cid:12)(cid:29)(cid:26)(cid:41)(cid:25)(cid:2)(cid:53)(cid:53)(cid:37)(cid:16)(cid:34)(cid:33,,10810.0
,,36,,,Unknown,,cid:12)(cid:29)(cid:26)(cid:41)(cid:25)(cid:2)(cid:53)(cid:53)(cid:37)(cid:16)(cid:34)(cid:33,,10846.0
,,37,,,Unknown,,cid:12)(cid:29)(cid:26)(cid:41)(cid:25)(cid:2)(cid:53)(cid:53)(cid:37)(cid:16)(cid:34)(cid:33,,10883.0
,,1,,,Unknown,,cid:12)(cid:29)(cid:26)(cid:41)(cid:25)(cid:2)(cid:53)(cid:53)(cid:37)(cid:16)(cid:34)(cid:33,,10884.0
,,16,,,Unknown,,cid:12)(cid:29)(cid:26)(cid:41)(cid:25)(cid:2)(cid:53)(cid:53)(cid:37)(cid:16)(cid:34)(cid:33,,10900.0
,,36,,,Unknown,,cid:12)(cid:29)(cid:26)(cid:41)(cid:25)(cid:2)(cid:53)(cid:53)(cid:37)(cid:16)(cid:34)(cid:33,,10936.0
,,35,,,Unknown,,cid:12)(cid:29)(cid:26)(cid:41)(cid:25)(cid:2)(cid:53)(cid:53)(cid:37)(cid:16)(cid:34)(cid:33,,10971.0
,,34,,,Unknown,,cid:12)(cid:29)(cid:26)(cid:41)(cid:25)(cid:2)(cid:53)(cid:53)(cid:37)(cid:16)(cid:34)(cid:33,,11005.0
,,2,,,Unknown,,cid:12)(cid:29)(cid:26)(cid:41)(cid:25)(cid:2)(cid:53)(cid:53)(cid:37)(cid:16)(cid:34)(cid:33,,11007.0
,,1,,,Unknown,,cid:12)(cid:29)(cid:26)(cid:41)(cid:25)(cid:2)(cid:53)(cid:53)(cid:37)(cid:16)(cid:34)(cid:33,,11008.0
,,2,,,Unknown,,cid:12)(cid:29)(cid:26)(cid:41)(cid:25)(cid:2)(cid:53)(cid:53)(cid:37)(cid:16)(cid:34)(cid:33,,11010.0
,,3,,,Unknown,,cid:12)(cid:29)(cid:26)(cid:41)(cid:25)(cid:2)(cid:53)(cid:53)(cid:37)(cid:16)(cid:34)(cid:33,,11013.0
,,2,,,Unknown,,cid:12)(cid:29)(cid:26)(cid:41)(cid:25)(cid:2)(cid:53)(cid:53)(cid:37)(cid:16)(cid:34)(cid:33,,11015.0
,,64,,,Unknown,,cid:12)(cid:29)(cid:26)(cid:41)(cid:25)(cid:2)(cid:53)(cid:53)(cid:37)(cid:16)(cid:34)(cid:33,,11079.0
,,2,,,Unknown,,cid:12)(cid:29)(cid:26)(cid:41)(cid:25)(cid:2)(cid:53)(cid:53)(cid:37)(cid:16)(cid:34)(cid:33,,11081.0
,,17,,,Unknown,,cid:12)(cid:29)(cid:26)(cid:41)(cid:25)(cid:2)(cid:53)(cid:53)(cid:37)(cid:16)(cid:34)(cid:33,,11098.0
,,19,,,Unknown,,cid:12)(cid:29)(cid:26)(cid:41)(cid:25)(cid:2)(cid:53)(cid:53)(cid:37)(cid:16)(cid:34)(cid:33,,11117.0
,,18,,,Unknown,,cid:12)(cid:29)(cid:26)(cid:41)(cid:25)(cid:2)(cid:53)(cid:53)(cid:37)(cid:16)(cid:34)(cid:33,,11135.0
,,18,,,Unknown,,cid:12)(cid:29)(cid:26)(cid:41)(cid:25)(cid:2)(cid:53)(cid:53)(cid:37)(cid:16)(cid:34)(cid:33,,11153.0
,,2,,,Unknown,,cid:12)(cid:29)(cid:26)(cid:41)(cid:25)(cid:2)(cid:53)(cid:53)(cid:37)(cid:16)(cid:34)(cid:33,,11155.0
,,44,,,Unknown,,cid:12)(cid:29)(cid:26)(cid:41)(cid:25)(cid:2)(cid:53)(cid:53)(cid:37)(cid:16)(cid:34)(cid:33,,11199.0
,,15,,,Unknown,,cid:12)(cid:29)(cid:26)(cid:41)(cid:25)(cid:2)(cid:53)(cid:53)(cid:37)(cid:16)(cid:34)(cid:33,,11214.0
,,2,,,Unknown,,cid:12)(cid:29)(cid:26)(cid:41)(cid:25)(cid:2)(cid:53)(cid:53)(cid:37)(cid:16)(cid:34)(cid:33,,11216.0
,,1,,,Unknown,,cid:12)(cid:29)(cid:26)(cid:41)(cid:25)(cid:2)(cid:53)(cid:53)(cid:37)(cid:16)(cid:34)(cid:33,,11217.0
,,18,,,Unknown,,cid:12)(cid:29)(cid:26)(cid:41)(cid:25)(cid:2)(cid:53)(cid:53)(cid:37)(cid:16)(cid:34)(cid:33,,11235.0
,,18,,,Unknown,,cid:12)(cid:29)(cid:26)(cid:41)(cid:25)(cid:2)(cid:53)(cid:53)(cid:37)(cid:16)(cid:34)(cid:33,,11253.0
,,19,,,Unknown,,cid:12)(cid:29)(cid:26)(cid:41)(cid:25)(cid:2)(cid:53)(cid:53)(cid:37)(cid:16)(cid:34)(cid:33,,11272.0
,,18,,,Unknown,,cid:12)(cid:29)(cid:26)(cid:41)(cid:25)(cid:2)(cid:53)(cid:53)(cid:37)(cid:16)(cid:34)(cid:33,,11290.0
,,18,,,Unknown,,cid:12)(cid:29)(cid:26)(cid:41)(cid:25)(cid:2)(cid:53)(cid:53)(cid:37)(cid:16)(cid:34)(cid:33,,11308.0
,,2,,,Unknown,,cid:12)(cid:29)(cid:26)(cid:41)(cid:25)(cid:2)(cid:53)(cid:53)(cid:37)(cid:16)(cid:34)(cid:33,,11310.0
,,1,,,Unknown,,cid:12)(cid:29)(cid:26)(cid:41)(cid:25)(cid:2)(cid:53)(cid:53)(cid:37)(cid:16)(cid:34)(cid:33,,11311.0
,,2,,,Unknown,,cid:12)(cid:29)(cid:26)(cid:41)(cid:25)(cid:2)(cid:53)(cid:53)(cid:37)(cid:16)(cid:34)(cid:33,,11313.0
,,3,,,Unknown,,cid:12)(cid:29)(cid:26)(cid:41)(cid:25)(cid:2)(cid:53)(cid:53)(cid:37)(cid:16)(cid:34)(cid:33,,11316.0
,,12,,,Unknown,,cid:12)(cid:29)(cid:26)(cid:41)(cid:25)(cid:2)(cid:53)(cid:53)(cid:37)(cid:16)(cid:34)(cid:33,,11328.0
,,29,,,Unknown,,cid:12)(cid:29)(cid:26)(cid:41)(cid:25)(cid:2)(cid:53)(cid:53)(cid:37)(cid:16)(cid:34)(cid:33,,11357.0
,,26,,,Unknown,,cid:12)(cid:29)(cid:26)(cid:41)(cid:25)(cid:2)(cid:53)(cid:53)(cid:37)(cid:16)(cid:34)(cid:33,,11383.0
,,41,,,Unknown,,cid:12)(cid:29)(cid:26)(cid:41)(cid:25)(cid:2)(cid:53)(cid:53)(cid:37)(cid:16)(cid:34)(cid:33,,11424.0
,,25,,,Unknown,,cid:12)(cid:29)(cid:26)(cid:41)(cid:25)(cid:2)(cid:53)(cid:53)(cid:37)(cid:16)(cid:34)(cid:33,,11449.0
,,2,,,Unknown,,cid:12)(cid:29)(cid:26)(cid:41)(cid:25)(cid:2)(cid:53)(cid:53)(cid:37)(cid:16)(cid:34)(cid:33,,11451.0
,,53,,,Unknown,,cid:12)(cid:29)(cid:26)(cid:41)(cid:25)(cid:2)(cid:53)(cid:53)(cid:37)(cid:16)(cid:34)(cid:33,,11504.0
,,53,,,Unknown,,cid:12)(cid:29)(cid:26)(cid:41)(cid:25)(cid:2)(cid:53)(cid:53)(cid:37)(cid:16)(cid:34)(cid:33,,11557.0
,,18,,,Unknown,,cid:12)(cid:29)(cid:26)(cid:41)(cid:25)(cid:2)(cid:53)(cid:53)(cid:37)(cid:16)(cid:34)(cid:33,,11575.0
,,1,,,Unknown,,cid:12)(cid:29)(cid:26)(cid:41)(cid:25)(cid:2)(cid:53)(cid:53)(cid:37)(cid:16)(cid:34)(cid:33,,11576.0
,,1,,,Unknown,,cid:12)(cid:29)(cid:26)(cid:41)(cid:25)(cid:2)(cid:53)(cid:53)(cid:37)(cid:16)(cid:34)(cid:33,,11577.0
,,37,,,Unknown,,cid:12)(cid:29)(cid:26)(cid:41)(cid:25)(cid:2)(cid:53)(cid:53)(cid:37)(cid:16)(cid:34)(cid:33,,11614.0
,,1,,,Unknown,,cid:12)(cid:29)(cid:26)(cid:41)(cid:25)(cid:2)(cid:53)(cid:53)(cid:37)(cid:16)(cid:34)(cid:33,,11615.0
,,18,,,Unknown,,cid:12)(cid:29)(cid:26)(cid:41)(cid:25)(cid:2)(cid:53)(cid:53)(cid:37)(cid:16)(cid:34)(cid:33,,11633.0
,,45,,,Unknown,,cid:12)(cid:29)(cid:26)(cid:41)(cid:25)(cid:2)(cid:53)(cid:53)(cid:37)(cid:16)(cid:34)(cid:33,,11678.0
,,18,,,Unknown,,cid:12)(cid:29)(cid:26)(cid:41)(cid:25)(cid:2)(cid:53)(cid:53)(cid:37)(cid:16)(cid:34)(cid:33,,11696.0
,,34,,,Unknown,,cid:12)(cid:29)(cid:26)(cid:41)(cid:25)(cid:2)(cid:53)(cid:53)(cid:37)(cid:16)(cid:34)(cid:33,,11730.0
,,3,,,Unknown,,cid:12)(cid:29)(cid:26)(cid:41)(cid:25)(cid:2)(cid:53)(cid:53)(cid:37)(cid:16)(cid:34)(cid:33,,11733.0
,,5,,,Unknown,,cid:12)(cid:29)(cid:26)(cid:41)(cid:25)(cid:2)(cid:53)(cid:53)(cid:37)(cid:16)(cid:34)(cid:33,,11738.0
,,9,,,Unknown,,cid:12)(cid:29)(cid:26)(cid:41)(cid:25)(cid:2)(cid:53)(cid:53)(cid:37)(cid:16)(cid:34)(cid:33,,11747.0
,,10,,,Unknown,,cid:12)(cid:29)(cid:26)(cid:41)(cid:25)(cid:2)(cid:53)(cid:53)(cid:37)(cid:16)(cid:34)(cid:33,,11757.0
,,49,,,Unknown,,cid:12)(cid:29)(cid:26)(cid:41)(cid:25)(cid:2)(cid:53)(cid:53)(cid:37)(cid:16)(cid:34)(cid:33,,11806.0
,,4,,,Unknown,,cid:12)(cid:29)(cid:26)(cid:41)(cid:25)(cid:2)(cid:53)(cid:53)(cid:37)(cid:16)(cid:34)(cid:33,,11810.0
,,3,,,Unknown,,cid:12)(cid:29)(cid:26)(cid:41)(cid:25)(cid:2)(cid:53)(cid:53)(cid:37)(cid:16)(cid:34)(cid:33,,11813.0
,,49,,,Unknown,,cid:12)(cid:29)(cid:26)(cid:41)(cid:25)(cid:2)(cid:53)(cid:53)(cid:37)(cid:16)(cid:34)(cid:33,,11862.0
,,8,,,Unknown,,cid:12)(cid:29)(cid:26)(cid:41)(cid:25)(cid:2)(cid:53)(cid:53)(cid:37)(cid:16)(cid:34)(cid:33,,11870.0
,,10,,,Unknown,,cid:12)(cid:29)(cid:26)(cid:41)(cid:25)(cid:2)(cid:53)(cid:53)(cid:37)(cid:16)(cid:34)(cid:33,,11880.0
,,2,,,Unknown,,cid:12)(cid:29)(cid:26)(cid:41)(cid:25)(cid:2)(cid:53)(cid:53)(cid:37)(cid:16)(cid:34)(cid:33,,11882.0
,,62,,,Unknown,,cid:12)(cid:29)(cid:26)(cid:41)(cid:25)(cid:2)(cid:53)(cid:53)(cid:37)(cid:16)(cid:34)(cid:33,,11944.0
,,12,,,Unknown,,cid:12)(cid:29)(cid:26)(cid:41)(cid:25)(cid:2)(cid:53)(cid:53)(cid:37)(cid:16)(cid:34)(cid:33,,11956.0
,,2,,,Unknown,,cid:12)(cid:29)(cid:26)(cid:41)(cid:25)(cid:2)(cid:53)(cid:53)(cid:37)(cid:16)(cid:34)(cid:33,,11958.0
,,52,,,Unknown,,cid:12)(cid:29)(cid:26)(cid:41)(cid:25)(cid:2)(cid:53)(cid:53)(cid:37)(cid:16)(cid:34)(cid:33,,12010.0
,,11,,,Unknown,,cid:12)(cid:29)(cid:26)(cid:41)(cid:25)(cid:2)(cid:53)(cid:53)(cid:37)(cid:16)(cid:34)(cid:33,,12021.0
,,2,,,Unknown,,cid:12)(cid:29)(cid:26)(cid:41)(cid:25)(cid:2)(cid:53)(cid:53)(cid:37)(cid:16)(cid:34)(cid:33,,12023.0
,,63,,,Unknown,,cid:12)(cid:29)(cid:26)(cid:41)(cid:25)(cid:2)(cid:53)(cid:53)(cid:37)(cid:16)(cid:34)(cid:33,,12086.0
,,5,,,Unknown,,cid:12)(cid:29)(cid:26)(cid:41)(cid:25)(cid:2)(cid:53)(cid:53)(cid:37)(cid:16)(cid:34)(cid:33,,12091.0
,,3,,,Unknown,,cid:12)(cid:29)(cid:26)(cid:41)(cid:25)(cid:2)(cid:53)(cid:53)(cid:37)(cid:16)(cid:34)(cid:33,,12094.0
,,52,,,Unknown,,cid:12)(cid:29)(cid:26)(cid:41)(cid:25)(cid:2)(cid:53)(cid:53)(cid:37)(cid:16)(cid:34)(cid:33,,12146.0
,,4,,,Unknown,,cid:12)(cid:29)(cid:26)(cid:41)(cid:25)(cid:2)(cid:53)(cid:53)(cid:37)(cid:16)(cid:34)(cid:33,,12150.0
,,8,,,Unknown,,cid:12)(cid:29)(cid:26)(cid:41)(cid:25)(cid:2)(cid:53)(cid:53)(cid:37)(cid:16)(cid:34)(cid:33,,12158.0
,,2,,,Unknown,,cid:12)(cid:29)(cid:26)(cid:41)(cid:25)(cid:2)(cid:53)(cid:53)(cid:37)(cid:16)(cid:34)(cid:33,,12160.0
,,28,,,Unknown,,cid:12)(cid:29)(cid:26)(cid:41)(cid:25)(cid:2)(cid:53)(cid:53)(cid:37)(cid:16)(cid:34)(cid:33,,12188.0
,,3,,,Unknown,,cid:12)(cid:29)(cid:26)(cid:41)(cid:25)(cid:2)(cid:53)(cid:53)(cid:37)(cid:16)(cid:34)(cid:33,,12191.0
,,15,,,Unknown,,cid:12)(cid:29)(cid:26)(cid:41)(cid:25)(cid:2)(cid:53)(cid:53)(cid:37)(cid:16)(cid:34)(cid:33,,12206.0
,,2,,,Unknown,,cid:12)(cid:29)(cid:26)(cid:41)(cid:25)(cid:2)(cid:53)(cid:53)(cid:37)(cid:16)(cid:34)(cid:33,,12208.0
,,37,,,Unknown,,cid:12)(cid:29)(cid:26)(cid:41)(cid:25)(cid:2)(cid:53)(cid:53)(cid:37)(cid:16)(cid:34)(cid:33,,12245.0
,,32,,,Unknown,,cid:12)(cid:29)(cid:26)(cid:41)(cid:25)(cid:2)(cid:53)(cid:53)(cid:37)(cid:16)(cid:34)(cid:33,,12277.0
,,19,,,Unknown,,cid:12)(cid:29)(cid:26)(cid:41)(cid:25)(cid:2)(cid:53)(cid:53)(cid:37)(cid:16)(cid:34)(cid:33,,12296.0
,,18,,,Unknown,,cid:12)(cid:29)(cid:26)(cid:41)(cid:25)(cid:2)(cid:53)(cid:53)(cid:37)(cid:16)(cid:34)(cid:33,,12314.0
,,34,,,Unknown,,cid:12)(cid:29)(cid:26)(cid:41)(cid:25)(cid:2)(cid:53)(cid:53)(cid:37)(cid:16)(cid:34)(cid:33,,12348.0
,,2,,,Unknown,,cid:12)(cid:29)(cid:26)(cid:41)(cid:25)(cid:2)(cid:53)(cid:53)(cid:37)(cid:16)(cid:34)(cid:33,,12350.0
,,44,,,Unknown,,cid:12)(cid:29)(cid:26)(cid:41)(cid:25)(cid:2)(cid:53)(cid:53)(cid:37)(cid:16)(cid:34)(cid:33,,12394.0
,,12,,,Unknown,,cid:12)(cid:29)(cid:26)(cid:41)(cid:25)(cid:2)(cid:53)(cid:53)(cid:37)(cid:16)(cid:34)(cid:33,,12406.0
,,29,,,Unknown,,cid:12)(cid:29)(cid:26)(cid:41)(cid:25)(cid:2)(cid:53)(cid:53)(cid:37)(cid:16)(cid:34)(cid:33,,12435.0
,,26,,,Unknown,,cid:12)(cid:29)(cid:26)(cid:41)(cid:25)(cid:2)(cid:53)(cid:53)(cid:37)(cid:16)(cid:34)(cid:33,,12461.0
,,41,,,Unknown,,cid:12)(cid:29)(cid:26)(cid:41)(cid:25)(cid:2)(cid:53)(cid:53)(cid:37)(cid:16)(cid:34)(cid:33,,12502.0
,,25,,,Unknown,,cid:12)(cid:29)(cid:26)(cid:41)(cid:25)(cid:2)(cid:53)(cid:53)(cid:37)(cid:16)(cid:34)(cid:33,,12527.0
,,2,,,Unknown,,cid:12)(cid:29)(cid:26)(cid:41)(cid:25)(cid:2)(cid:53)(cid:53)(cid:37)(cid:16)(cid:34)(cid:33,,12529.0
,,53,,,Unknown,,cid:12)(cid:29)(cid:26)(cid:41)(cid:25)(cid:2)(cid:53)(cid:53)(cid:37)(cid:16)(cid:34)(cid:33,,12582.0
,,53,,,Unknown,,cid:12)(cid:29)(cid:26)(cid:41)(cid:25)(cid:2)(cid:53)(cid:53)(cid:37)(cid:16)(cid:34)(cid:33,,12635.0
,,18,,,Unknown,,cid:12)(cid:29)(cid:26)(cid:41)(cid:25)(cid:2)(cid:53)(cid:53)(cid:37)(cid:16)(cid:34)(cid:33,,12653.0
,,1,,,Unknown,,cid:12)(cid:29)(cid:26)(cid:41)(cid:25)(cid:2)(cid:53)(cid:53)(cid:37)(cid:16)(cid:34)(cid:33,,12654.0
,,1,,,Unknown,,cid:12)(cid:29)(cid:26)(cid:41)(cid:25)(cid:2)(cid:53)(cid:53)(cid:37)(cid:16)(cid:34)(cid:33,,12655.0
,,37,,,Unknown,,cid:12)(cid:29)(cid:26)(cid:41)(cid:25)(cid:2)(cid:53)(cid:53)(cid:37)(cid:16)(cid:34)(cid:33,,12692.0
,,1,,,Unknown,,cid:12)(cid:29)(cid:26)(cid:41)(cid:25)(cid:2)(cid:53)(cid:53)(cid:37)(cid:16)(cid:34)(cid:33,,12693.0
,,17,,,Unknown,,cid:12)(cid:29)(cid:26)(cid:41)(cid:25)(cid:2)(cid:53)(cid:53)(cid:37)(cid:16)(cid:34)(cid:33,,12710.0
,,45,,,Unknown,,cid:12)(cid:29)(cid:26)(cid:41)(cid:25)(cid:2)(cid:53)(cid:53)(cid:37)(cid:16)(cid:34)(cid:33,,12755.0
,,18,,,Unknown,,cid:12)(cid:29)(cid:26)(cid:41)(cid:25)(cid:2)(cid:53)(cid:53)(cid:37)(cid:16)(cid:34)(cid:33,,12773.0
,,34,,,Unknown,,cid:12)(cid:29)(cid:26)(cid:41)(cid:25)(cid:2)(cid:53)(cid:53)(cid:37)(cid:16)(cid:34)(cid:33,,12807.0
,,9,,,Unknown,,cid:12)(cid:29)(cid:26)(cid:41)(cid:25)(cid:2)(cid:53)(cid:53)(cid:37)(cid:16)(cid:34)(cid:33,,12816.0
,,49,,,Unknown,,cid:12)(cid:29)(cid:26)(cid:41)(cid:25)(cid:2)(cid:53)(cid:53)(cid:37)(cid:16)(cid:34)(cid:33,,12865.0
,,8,,,Unknown,,cid:12)(cid:29)(cid:26)(cid:41)(cid:25)(cid:2)(cid:53)(cid:53)(cid:37)(cid:16)(cid:34)(cid:33,,12873.0
,,5,,,Unknown,,cid:12)(cid:29)(cid:26)(cid:41)(cid:25)(cid:2)(cid:53)(cid:53)(cid:37)(cid:16)(cid:34)(cid:33,,12878.0
,,28,,,Unknown,,cid:12)(cid:29)(cid:26)(cid:41)(cid:25)(cid:2)(cid:53)(cid:53)(cid:37)(cid:16)(cid:34)(cid:33,,12906.0
,,2,,,Unknown,,cid:12)(cid:29)(cid:26)(cid:41)(cid:25)(cid:2)(cid:53)(cid:53)(cid:37)(cid:16)(cid:34)(cid:33,,12908.0
,,9,,,Unknown,,cid:12)(cid:29)(cid:26)(cid:41)(cid:25)(cid:2)(cid:53)(cid:53)(cid:37)(cid:16)(cid:34)(cid:33,,12917.0
,,5,,,Unknown,,cid:12)(cid:29)(cid:26)(cid:41)(cid:25)(cid:2)(cid:53)(cid:53)(cid:37)(cid:16)(cid:34)(cid:33,,12922.0
,,8,,,Unknown,,cid:12)(cid:29)(cid:26)(cid:41)(cid:25)(cid:2)(cid:53)(cid:53)(cid:37)(cid:16)(cid:34)(cid:33,,12930.0
,,14,,,Unknown,,cid:12)(cid:29)(cid:26)(cid:41)(cid:25)(cid:2)(cid:53)(cid:53)(cid:37)(cid:16)(cid:34)(cid:33,,12944.0
,,7,,,Unknown,,cid:12)(cid:29)(cid:26)(cid:41)(cid:25)(cid:2)(cid:53)(cid:53)(cid:37)(cid:16)(cid:34)(cid:33,,12951.0
,,9,,,Unknown,,cid:12)(cid:29)(cid:26)(cid:41)(cid:25)(cid:2)(cid:53)(cid:53)(cid:37)(cid:16)(cid:34)(cid:33,,12960.0
,,2,,,Unknown,,cid:12)(cid:29)(cid:26)(cid:41)(cid:25)(cid:2)(cid:53)(cid:53)(cid:37)(cid:16)(cid:34)(cid:33,,12962.0
,,28,,,Unknown,,cid:12)(cid:29)(cid:26)(cid:41)(cid:25)(cid:2)(cid:53)(cid:53)(cid:37)(cid:16)(cid:34)(cid:33,,12990.0
,,3,,,Unknown,,cid:12)(cid:29)(cid:26)(cid:41)(cid:25)(cid:2)(cid:53)(cid:53)(cid:37)(cid:16)(cid:34)(cid:33,,12993.0
,,15,,,Unknown,,cid:12)(cid:29)(cid:26)(cid:41)(cid:25)(cid:2)(cid:53)(cid:53)(cid:37)(cid:16)(cid:34)(cid:33,,13008.0
,,2,,,Unknown,,cid:12)(cid:29)(cid:26)(cid:41)(cid:25)(cid:2)(cid:53)(cid:53)(cid:37)(cid:16)(cid:34)(cid:33,,13010.0
,,36,,,Unknown,,cid:12)(cid:29)(cid:26)(cid:41)(cid:25)(cid:2)(cid:53)(cid:53)(cid:37)(cid:16)(cid:34)(cid:33,,13046.0
,,19,,,Unknown,,cid:12)(cid:29)(cid:26)(cid:41)(cid:25)(cid:2)(cid:53)(cid:53)(cid:37)(cid:16)(cid:34)(cid:33,,13065.0
,,32,,,Unknown,,cid:12)(cid:29)(cid:26)(cid:41)(cid:25)(cid:2)(cid:53)(cid:53)(cid:37)(cid:16)(cid:34)(cid:33,,13097.0
,,18,,,Unknown,,cid:12)(cid:29)(cid:26)(cid:41)(cid:25)(cid:2)(cid:53)(cid:53)(cid:37)(cid:16)(cid:34)(cid:33,,13115.0
,,2,,,Unknown,,cid:12)(cid:29)(cid:26)(cid:41)(cid:25)(cid:2)(cid:53)(cid:53)(cid:37)(cid:16)(cid:34)(cid:33,,13117.0
,,44,,,Unknown,,cid:12)(cid:29)(cid:26)(cid:41)(cid:25)(cid:2)(cid:53)(cid:53)(cid:37)(cid:16)(cid:34)(cid:33,,13161.0
,,12,,,Unknown,,cid:12)(cid:29)(cid:26)(cid:41)(cid:25)(cid:2)(cid:53)(cid:53)(cid:37)(cid:16)(cid:34)(cid:33,,13173.0
,,29,,,Unknown,,cid:12)(cid:29)(cid:26)(cid:41)(cid:25)(cid:2)(cid:53)(cid:53)(cid:37)(cid:16)(cid:34)(cid:33,,13202.0
,,26,,,Unknown,,cid:12)(cid:29)(cid:26)(cid:41)(cid:25)(cid:2)(cid:53)(cid:53)(cid:37)(cid:16)(cid:34)(cid:33,,13228.0
,,41,,,Unknown,,cid:12)(cid:29)(cid:26)(cid:41)(cid:25)(cid:2)(cid:53)(cid:53)(cid:37)(cid:16)(cid:34)(cid:33,,13269.0
,,25,,,Unknown,,cid:12)(cid:29)(cid:26)(cid:41)(cid:25)(cid:2)(cid:53)(cid:53)(cid:37)(cid:16)(cid:34)(cid:33,,13294.0
,,2,,,Unknown,,cid:12)(cid:29)(cid:26)(cid:41)(cid:25)(cid:2)(cid:53)(cid:53)(cid:37)(cid:16)(cid:34)(cid:33,,13296.0
,,53,,,Unknown,,cid:12)(cid:29)(cid:26)(cid:41)(cid:25)(cid:2)(cid:53)(cid:53)(cid:37)(cid:16)(cid:34)(cid:33,,13349.0
,,53,,,Unknown,,cid:12)(cid:29)(cid:26)(cid:41)(cid:25)(cid:2)(cid:53)(cid:53)(cid:37)(cid:16)(cid:34)(cid:33,,13402.0
,,18,,,Unknown,,cid:12)(cid:29)(cid:26)(cid:41)(cid:25)(cid:2)(cid:53)(cid:53)(cid:37)(cid:16)(cid:34)(cid:33,,13420.0
,,1,,,Unknown,,cid:12)(cid:29)(cid:26)(cid:41)(cid:25)(cid:2)(cid:53)(cid:53)(cid:37)(cid:16)(cid:34)(cid:33,,13421.0
,,1,,,Unknown,,cid:12)(cid:29)(cid:26)(cid:41)(cid:25)(cid:2)(cid:53)(cid:53)(cid:37)(cid:16)(cid:34)(cid:33,,13422.0
,,37,,,Unknown,,cid:12)(cid:29)(cid:26)(cid:41)(cid:25)(cid:2)(cid:53)(cid:53)(cid:37)(cid:16)(cid:34)(cid:33,,13459.0
,,1,,,Unknown,,cid:12)(cid:29)(cid:26)(cid:41)(cid:25)(cid:2)(cid:53)(cid:53)(cid:37)(cid:16)(cid:34)(cid:33,,13460.0
,,17,,,Unknown,,cid:12)(cid:29)(cid:26)(cid:41)(cid:25)(cid:2)(cid:53)(cid:53)(cid:37)(cid:16)(cid:34)(cid:33,,13477.0
,,45,,,Unknown,,cid:12)(cid:29)(cid:26)(cid:41)(cid:25)(cid:2)(cid:53)(cid:53)(cid:37)(cid:16)(cid:34)(cid:33,,13522.0
,,18,,,Unknown,,cid:12)(cid:29)(cid:26)(cid:41)(cid:25)(cid:2)(cid:53)(cid:53)(cid:37)(cid:16)(cid:34)(cid:33,,13540.0
,,34,,,Unknown,,cid:12)(cid:29)(cid:26)(cid:41)(cid:25)(cid:2)(cid:53)(cid:53)(cid:37)(cid:16)(cid:34)(cid:33,,13574.0
,,9,,,Unknown,,cid:12)(cid:29)(cid:26)(cid:41)(cid:25)(cid:2)(cid:53)(cid:53)(cid:37)(cid:16)(cid:34)(cid:33,,13583.0
,,49,,,Unknown,,cid:12)(cid:29)(cid:26)(cid:41)(cid:25)(cid:2)(cid:53)(cid:53)(cid:37)(cid:16)(cid:34)(cid:33,,13632.0
,,8,,,Unknown,,cid:12)(cid:29)(cid:26)(cid:41)(cid:25)(cid:2)(cid:53)(cid:53)(cid:37)(cid:16)(cid:34)(cid:33,,13640.0
,,5,,,Unknown,,cid:12)(cid:29)(cid:26)(cid:41)(cid:25)(cid:2)(cid:53)(cid:53)(cid:37)(cid:16)(cid:34)(cid:33,,13645.0
,,28,,,Unknown,,cid:12)(cid:29)(cid:26)(cid:41)(cid:25)(cid:2)(cid:53)(cid:53)(cid:37)(cid:16)(cid:34)(cid:33,,13673.0
,,2,,,Unknown,,cid:12)(cid:29)(cid:26)(cid:41)(cid:25)(cid:2)(cid:53)(cid:53)(cid:37)(cid:16)(cid:34)(cid:33,,13675.0
,,49,,,Unknown,,cid:12)(cid:29)(cid:26)(cid:41)(cid:25)(cid:2)(cid:53)(cid:53)(cid:37)(cid:16)(cid:34)(cid:33,,13724.0
,,4,,,Unknown,,cid:12)(cid:29)(cid:26)(cid:41)(cid:25)(cid:2)(cid:53)(cid:53)(cid:37)(cid:16)(cid:34)(cid:33,,13728.0
,,10,,,Unknown,,cid:12)(cid:29)(cid:26)(cid:41)(cid:25)(cid:2)(cid:53)(cid:53)(cid:37)(cid:16)(cid:34)(cid:33,,13738.0
,,11,,,Unknown,,cid:12)(cid:29)(cid:26)(cid:41)(cid:25)(cid:2)(cid:53)(cid:53)(cid:37)(cid:16)(cid:34)(cid:33,,13749.0
,,3,,,Unknown,,cid:12)(cid:29)(cid:26)(cid:41)(cid:25)(cid:2)(cid:53)(cid:53)(cid:37)(cid:16)(cid:34)(cid:33,,13752.0
,,11,,,Unknown,,cid:12)(cid:29)(cid:26)(cid:41)(cid:25)(cid:2)(cid:53)(cid:53)(cid:37)(cid:16)(cid:34)(cid:33,,13763.0
,,4,,,Unknown,,cid:12)(cid:29)(cid:26)(cid:41)(cid:25)(cid:2)(cid:53)(cid:53)(cid:37)(cid:16)(cid:34)(cid:33,,13767.0
,,10,,,Unknown,,cid:12)(cid:29)(cid:26)(cid:41)(cid:25)(cid:2)(cid:53)(cid:53)(cid:37)(cid:16)(cid:34)(cid:33,,13777.0
,,5,,,Unknown,,cid:12)(cid:29)(cid:26)(cid:41)(cid:25)(cid:2)(cid:53)(cid:53)(cid:37)(cid:16)(cid:34)(cid:33,,13782.0
,,2,,,Unknown,,cid:12)(cid:29)(cid:26)(cid:41)(cid:25)(cid:2)(cid:53)(cid:53)(cid:37)(cid:16)(cid:34)(cid:33,,13784.0
,,9,,,Unknown,,cid:12)(cid:29)(cid:26)(cid:41)(cid:25)(cid:2)(cid:53)(cid:53)(cid:37)(cid:16)(cid:34)(cid:33,,13793.0
,,5,,,Unknown,,cid:12)(cid:29)(cid:26)(cid:41)(cid:25)(cid:2)(cid:53)(cid:53)(cid:37)(cid:16)(cid:34)(cid:33,,13798.0
,,8,,,Unknown,,cid:12)(cid:29)(cid:26)(cid:41)(cid:25)(cid:2)(cid:53)(cid:53)(cid:37)(cid:16)(cid:34)(cid:33,,13806.0
,,14,,,Unknown,,cid:12)(cid:29)(cid:26)(cid:41)(cid:25)(cid:2)(cid:53)(cid:53)(cid:37)(cid:16)(cid:34)(cid:33,,13820.0
,,7,,,Unknown,,cid:12)(cid:29)(cid:26)(cid:41)(cid:25)(cid:2)(cid:53)(cid:53)(cid:37)(cid:16)(cid:34)(cid:33,,13827.0
,,9,,,Unknown,,cid:12)(cid:29)(cid:26)(cid:41)(cid:25)(cid:2)(cid:53)(cid:53)(cid:37)(cid:16)(cid:34)(cid:33,,13836.0
,,2,,,Unknown,,cid:12)(cid:29)(cid:26)(cid:41)(cid:25)(cid:2)(cid:53)(cid:53)(cid:37)(cid:16)(cid:34)(cid:33,,13838.0
,,12,,,Unknown,,cid:12)(cid:29)(cid:26)(cid:41)(cid:25)(cid:2)(cid:53)(cid:53)(cid:37)(cid:16)(cid:34)(cid:33,,13850.0
,,5,,,Unknown,,cid:12)(cid:29)(cid:26)(cid:41)(cid:25)(cid:2)(cid:53)(cid:53)(cid:37)(cid:16)(cid:34)(cid:33,,13855.0
,,52,,,Unknown,,cid:12)(cid:29)(cid:26)(cid:41)(cid:25)(cid:2)(cid:53)(cid:53)(cid:37)(cid:16)(cid:34)(cid:33,,13907.0
,,5,,,Unknown,,cid:12)(cid:29)(cid:26)(cid:41)(cid:25)(cid:2)(cid:53)(cid:53)(cid:37)(cid:16)(cid:34)(cid:33,,13912.0
,,40,,,Unknown,,cid:12)(cid:29)(cid:26)(cid:41)(cid:25)(cid:2)(cid:53)(cid:53)(cid:37)(cid:16)(cid:34)(cid:33,,13952.0
,,2,,,Unknown,,cid:12)(cid:29)(cid:26)(cid:41)(cid:25)(cid:2)(cid:53)(cid:53)(cid:37)(cid:16)(cid:34)(cid:33,,13954.0
,,28,,,Unknown,,cid:12)(cid:29)(cid:26)(cid:41)(cid:25)(cid:2)(cid:53)(cid:53)(cid:37)(cid:16)(cid:34)(cid:33,,13982.0
,,3,,,Unknown,,cid:12)(cid:29)(cid:26)(cid:41)(cid:25)(cid:2)(cid:53)(cid:53)(cid:37)(cid:16)(cid:34)(cid:33,,13985.0
,,15,,,Unknown,,cid:12)(cid:29)(cid:26)(cid:41)(cid:25)(cid:2)(cid:53)(cid:53)(cid:37)(cid:16)(cid:34)(cid:33,,14000.0
,,2,,,Unknown,,cid:12)(cid:29)(cid:26)(cid:41)(cid:25)(cid:2)(cid:53)(cid:53)(cid:37)(cid:16)(cid:34)(cid:33,,14002.0
,,17,,,Unknown,,cid:12)(cid:29)(cid:26)(cid:41)(cid:25)(cid:2)(cid:53)(cid:53)(cid:37)(cid:16)(cid:34)(cid:33,,14019.0
,,34,,,Unknown,,cid:12)(cid:29)(cid:26)(cid:41)(cid:25)(cid:2)(cid:53)(cid:53)(cid:37)(cid:16)(cid:34)(cid:33,,14053.0
,,19,,,Unknown,,cid:12)(cid:29)(cid:26)(cid:41)(cid:25)(cid:2)(cid:53)(cid:53)(cid:37)(cid:16)(cid:34)(cid:33,,14072.0
,,16,,,Unknown,,cid:12)(cid:29)(cid:26)(cid:41)(cid:25)(cid:2)(cid:53)(cid:53)(cid:37)(cid:16)(cid:34)(cid:33,,14088.0
,,18,,,Unknown,,cid:12)(cid:29)(cid:26)(cid:41)(cid:25)(cid:2)(cid:53)(cid:53)(cid:37)(cid:16)(cid:34)(cid:33,,14106.0
,,2,,,Unknown,,cid:12)(cid:29)(cid:26)(cid:41)(cid:25)(cid:2)(cid:53)(cid:53)(cid:37)(cid:16)(cid:34)(cid:33,,14108.0
,,44,,,Unknown,,cid:12)(cid:29)(cid:26)(cid:41)(cid:25)(cid:2)(cid:53)(cid:53)(cid:37)(cid:16)(cid:34)(cid:33,,14152.0
,,12,,,Unknown,,cid:12)(cid:29)(cid:26)(cid:41)(cid:25)(cid:2)(cid:53)(cid:53)(cid:37)(cid:16)(cid:34)(cid:33,,14164.0
,,29,,,Unknown,,cid:12)(cid:29)(cid:26)(cid:41)(cid:25)(cid:2)(cid:53)(cid:53)(cid:37)(cid:16)(cid:34)(cid:33,,14193.0
,,26,,,Unknown,,cid:12)(cid:29)(cid:26)(cid:41)(cid:25)(cid:2)(cid:53)(cid:53)(cid:37)(cid:16)(cid:34)(cid:33,,14219.0
,,41,,,Unknown,,cid:12)(cid:29)(cid:26)(cid:41)(cid:25)(cid:2)(cid:53)(cid:53)(cid:37)(cid:16)(cid:34)(cid:33,,14260.0
,,25,,,Unknown,,cid:12)(cid:29)(cid:26)(cid:41)(cid:25)(cid:2)(cid:53)(cid:53)(cid:37)(cid:16)(cid:34)(cid:33,,14285.0
,,2,,,Unknown,,cid:12)(cid:29)(cid:26)(cid:41)(cid:25)(cid:2)(cid:53)(cid:53)(cid:37)(cid:16)(cid:34)(cid:33,,14287.0
,,53,,,Unknown,,cid:12)(cid:29)(cid:26)(cid:41)(cid:25)(cid:2)(cid:53)(cid:53)(cid:37)(cid:16)(cid:34)(cid:33,,14340.0
,,53,,,Unknown,,cid:12)(cid:29)(cid:26)(cid:41)(cid:25)(cid:2)(cid:53)(cid:53)(cid:37)(cid:16)(cid:34)(cid:33,,14393.0
,,18,,,Unknown,,cid:12)(cid:29)(cid:26)(cid:41)(cid:25)(cid:2)(cid:53)(cid:53)(cid:37)(cid:16)(cid:34)(cid:33,,14411.0
,,1,,,Unknown,,cid:12)(cid:29)(cid:26)(cid:41)(cid:25)(cid:2)(cid:53)(cid:53)(cid:37)(cid:16)(cid:34)(cid:33,,14412.0
,,1,,,Unknown,,cid:12)(cid:29)(cid:26)(cid:41)(cid:25)(cid:2)(cid:53)(cid:53)(cid:37)(cid:16)(cid:34)(cid:33,,14413.0
,,37,,,Unknown,,cid:12)(cid:29)(cid:26)(cid:41)(cid:25)(cid:2)(cid:53)(cid:53)(cid:37)(cid:16)(cid:34)(cid:33,,14450.0
,,1,,,Unknown,,cid:12)(cid:29)(cid:26)(cid:41)(cid:25)(cid:2)(cid:53)(cid:53)(cid:37)(cid:16)(cid:34)(cid:33,,14451.0
,,17,,,Unknown,,cid:12)(cid:29)(cid:26)(cid:41)(cid:25)(cid:2)(cid:53)(cid:53)(cid:37)(cid:16)(cid:34)(cid:33,,14468.0
,,45,,,Unknown,,cid:12)(cid:29)(cid:26)(cid:41)(cid:25)(cid:2)(cid:53)(cid:53)(cid:37)(cid:16)(cid:34)(cid:33,,14513.0
,,18,,,Unknown,,cid:12)(cid:29)(cid:26)(cid:41)(cid:25)(cid:2)(cid:53)(cid:53)(cid:37)(cid:16)(cid:34)(cid:33,,14531.0
,,34,,,Unknown,,cid:12)(cid:29)(cid:26)(cid:41)(cid:25)(cid:2)(cid:53)(cid:53)(cid:37)(cid:16)(cid:34)(cid:33,,14565.0
,,9,,,Unknown,,cid:12)(cid:29)(cid:26)(cid:41)(cid:25)(cid:2)(cid:53)(cid:53)(cid:37)(cid:16)(cid:34)(cid:33,,14574.0
,,49,,,Unknown,,cid:12)(cid:29)(cid:26)(cid:41)(cid:25)(cid:2)(cid:53)(cid:53)(cid:37)(cid:16)(cid:34)(cid:33,,14623.0
,,8,,,Unknown,,cid:12)(cid:29)(cid:26)(cid:41)(cid:25)(cid:2)(cid:53)(cid:53)(cid:37)(cid:16)(cid:34)(cid:33,,14631.0
,,5,,,Unknown,,cid:12)(cid:29)(cid:26)(cid:41)(cid:25)(cid:2)(cid:53)(cid:53)(cid:37)(cid:16)(cid:34)(cid:33,,14636.0
,,28,,,Unknown,,cid:12)(cid:29)(cid:26)(cid:41)(cid:25)(cid:2)(cid:53)(cid:53)(cid:37)(cid:16)(cid:34)(cid:33,,14664.0
,,2,,,Unknown,,cid:12)(cid:29)(cid:26)(cid:41)(cid:25)(cid:2)(cid:53)(cid:53)(cid:37)(cid:16)(cid:34)(cid:33,,14666.0
,,9,,,Unknown,,cid:12)(cid:29)(cid:26)(cid:41)(cid:25)(cid:2)(cid:53)(cid:53)(cid:37)(cid:16)(cid:34)(cid:33,,14675.0
,,5,,,Unknown,,cid:12)(cid:29)(cid:26)(cid:41)(cid:25)(cid:2)(cid:53)(cid:53)(cid:37)(cid:16)(cid:34)(cid:33,,14680.0
,,8,,,Unknown,,cid:12)(cid:29)(cid:26)(cid:41)(cid:25)(cid:2)(cid:53)(cid:53)(cid:37)(cid:16)(cid:34)(cid:33,,14688.0
,,14,,,Unknown,,cid:12)(cid:29)(cid:26)(cid:41)(cid:25)(cid:2)(cid:53)(cid:53)(cid:37)(cid:16)(cid:34)(cid:33,,14702.0
,,7,,,Unknown,,cid:12)(cid:29)(cid:26)(cid:41)(cid:25)(cid:2)(cid:53)(cid:53)(cid:37)(cid:16)(cid:34)(cid:33,,14709.0
,,9,,,Unknown,,cid:12)(cid:29)(cid:26)(cid:41)(cid:25)(cid:2)(cid:53)(cid:53)(cid:37)(cid:16)(cid:34)(cid:33,,14718.0
,,2,,,Unknown,,cid:12)(cid:29)(cid:26)(cid:41)(cid:25)(cid:2)(cid:53)(cid:53)(cid:37)(cid:16)(cid:34)(cid:33,,14720.0
,,28,,,Unknown,,cid:12)(cid:29)(cid:26)(cid:41)(cid:25)(cid:2)(cid:53)(cid:53)(cid:37)(cid:16)(cid:34)(cid:33,,14748.0
,,3,,,Unknown,,cid:12)(cid:29)(cid:26)(cid:41)(cid:25)(cid:2)(cid:53)(cid:53)(cid:37)(cid:16)(cid:34)(cid:33,,14751.0
,,15,,,Unknown,,cid:12)(cid:29)(cid:26)(cid:41)(cid:25)(cid:2)(cid:53)(cid:53)(cid:37)(cid:16)(cid:34)(cid:33,,14766.0
,,2,,,Unknown,,cid:12)(cid:29)(cid:26)(cid:41)(cid:25)(cid:2)(cid:53)(cid:53)(cid:37)(cid:16)(cid:34)(cid:33,,14768.0
,,33,,,Unknown,,cid:12)(cid:29)(cid:26)(cid:41)(cid:25)(cid:2)(cid:53)(cid:53)(cid:37)(cid:16)(cid:34)(cid:33,,14801.0
,,19,,,Unknown,,cid:12)(cid:29)(cid:26)(cid:41)(cid:25)(cid:2)(cid:53)(cid:53)(cid:37)(cid:16)(cid:34)(cid:33,,14820.0
,,17,,,Unknown,,cid:12)(cid:29)(cid:26)(cid:41)(cid:25)(cid:2)(cid:53)(cid:53)(cid:37)(cid:16)(cid:34)(cid:33,,14837.0
,,18,,,Unknown,,cid:12)(cid:29)(cid:26)(cid:41)(cid:25)(cid:2)(cid:53)(cid:53)(cid:37)(cid:16)(cid:34)(cid:33,,14855.0
,,2,,,Unknown,,cid:12)(cid:29)(cid:26)(cid:41)(cid:25)(cid:2)(cid:53)(cid:53)(cid:37)(cid:16)(cid:34)(cid:33,,14857.0
,,44,,,Unknown,,cid:12)(cid:29)(cid:26)(cid:41)(cid:25)(cid:2)(cid:53)(cid:53)(cid:37)(cid:16)(cid:34)(cid:33,,14901.0
,,12,,,Unknown,,cid:12)(cid:29)(cid:26)(cid:41)(cid:25)(cid:2)(cid:53)(cid:53)(cid:37)(cid:16)(cid:34)(cid:33,,14913.0
,,29,,,Unknown,,cid:12)(cid:29)(cid:26)(cid:41)(cid:25)(cid:2)(cid:53)(cid:53)(cid:37)(cid:16)(cid:34)(cid:33,,14942.0
,,26,,,Unknown,,cid:12)(cid:29)(cid:26)(cid:41)(cid:25)(cid:2)(cid:53)(cid:53)(cid:37)(cid:16)(cid:34)(cid:33,,14968.0
,,41,,,Unknown,,cid:12)(cid:29)(cid:26)(cid:41)(cid:25)(cid:2)(cid:53)(cid:53)(cid:37)(cid:16)(cid:34)(cid:33,,15009.0
,,25,,,Unknown,,cid:12)(cid:29)(cid:26)(cid:41)(cid:25)(cid:2)(cid:53)(cid:53)(cid:37)(cid:16)(cid:34)(cid:33,,15034.0
,,2,,,Unknown,,cid:12)(cid:29)(cid:26)(cid:41)(cid:25)(cid:2)(cid:53)(cid:53)(cid:37)(cid:16)(cid:34)(cid:33,,15036.0
,,53,,,Unknown,,cid:12)(cid:29)(cid:26)(cid:41)(cid:25)(cid:2)(cid:53)(cid:53)(cid:37)(cid:16)(cid:34)(cid:33,,15089.0
,,53,,,Unknown,,cid:12)(cid:29)(cid:26)(cid:41)(cid:25)(cid:2)(cid:53)(cid:53)(cid:37)(cid:16)(cid:34)(cid:33,,15142.0
,,18,,,Unknown,,cid:12)(cid:29)(cid:26)(cid:41)(cid:25)(cid:2)(cid:53)(cid:53)(cid:37)(cid:16)(cid:34)(cid:33,,15160.0
,,1,,,Unknown,,cid:12)(cid:29)(cid:26)(cid:41)(cid:25)(cid:2)(cid:53)(cid:53)(cid:37)(cid:16)(cid:34)(cid:33,,15161.0
,,1,,,Unknown,,cid:12)(cid:29)(cid:26)(cid:41)(cid:25)(cid:2)(cid:53)(cid:53)(cid:37)(cid:16)(cid:34)(cid:33,,15162.0
,,37,,,Unknown,,cid:12)(cid:29)(cid:26)(cid:41)(cid:25)(cid:2)(cid:53)(cid:53)(cid:37)(cid:16)(cid:34)(cid:33,,15199.0
,,1,,,Unknown,,cid:12)(cid:29)(cid:26)(cid:41)(cid:25)(cid:2)(cid:53)(cid:53)(cid:37)(cid:16)(cid:34)(cid:33,,15200.0
,,17,,,Unknown,,cid:12)(cid:29)(cid:26)(cid:41)(cid:25)(cid:2)(cid:53)(cid:53)(cid:37)(cid:16)(cid:34)(cid:33,,15217.0
,,45,,,Unknown,,cid:12)(cid:29)(cid:26)(cid:41)(cid:25)(cid:2)(cid:53)(cid:53)(cid:37)(cid:16)(cid:34)(cid:33,,15262.0
,,18,,,Unknown,,cid:12)(cid:29)(cid:26)(cid:41)(cid:25)(cid:2)(cid:53)(cid:53)(cid:37)(cid:16)(cid:34)(cid:33,,15280.0
,,34,,,Unknown,,cid:12)(cid:29)(cid:26)(cid:41)(cid:25)(cid:2)(cid:53)(cid:53)(cid:37)(cid:16)(cid:34)(cid:33,,15314.0
,,9,,,Unknown,,cid:12)(cid:29)(cid:26)(cid:41)(cid:25)(cid:2)(cid:53)(cid:53)(cid:37)(cid:16)(cid:34)(cid:33,,15323.0
,,49,,,Unknown,,cid:12)(cid:29)(cid:26)(cid:41)(cid:25)(cid:2)(cid:53)(cid:53)(cid:37)(cid:16)(cid:34)(cid:33,,15372.0
,,8,,,Unknown,,cid:12)(cid:29)(cid:26)(cid:41)(cid:25)(cid:2)(cid:53)(cid:53)(cid:37)(cid:16)(cid:34)(cid:33,,15380.0
,,5,,,Unknown,,cid:12)(cid:29)(cid:26)(cid:41)(cid:25)(cid:2)(cid:53)(cid:53)(cid:37)(cid:16)(cid:34)(cid:33,,15385.0
,,28,,,Unknown,,cid:12)(cid:29)(cid:26)(cid:41)(cid:25)(cid:2)(cid:53)(cid:53)(cid:37)(cid:16)(cid:34)(cid:33,,15413.0
,,2,,,Unknown,,cid:12)(cid:29)(cid:26)(cid:41)(cid:25)(cid:2)(cid:53)(cid:53)(cid:37)(cid:16)(cid:34)(cid:33,,15415.0
,,9,,,Unknown,,cid:12)(cid:29)(cid:26)(cid:41)(cid:25)(cid:2)(cid:53)(cid:53)(cid:37)(cid:16)(cid:34)(cid:33,,15424.0
,,5,,,Unknown,,cid:12)(cid:29)(cid:26)(cid:41)(cid:25)(cid:2)(cid:53)(cid:53)(cid:37)(cid:16)(cid:34)(cid:33,,15429.0
,,8,,,Unknown,,cid:12)(cid:29)(cid:26)(cid:41)(cid:25)(cid:2)(cid:53)(cid:53)(cid:37)(cid:16)(cid:34)(cid:33,,15437.0
,,14,,,Unknown,,cid:12)(cid:29)(cid:26)(cid:41)(cid:25)(cid:2)(cid:53)(cid:53)(cid:37)(cid:16)(cid:34)(cid:33,,15451.0
,,7,,,Unknown,,cid:12)(cid:29)(cid:26)(cid:41)(cid:25)(cid:2)(cid:53)(cid:53)(cid:37)(cid:16)(cid:34)(cid:33,,15458.0
,,9,,,Unknown,,cid:12)(cid:29)(cid:26)(cid:41)(cid:25)(cid:2)(cid:53)(cid:53)(cid:37)(cid:16)(cid:34)(cid:33,,15467.0
,,2,,,Unknown,,cid:12)(cid:29)(cid:26)(cid:41)(cid:25)(cid:2)(cid:53)(cid:53)(cid:37)(cid:16)(cid:34)(cid:33,,15469.0
,,28,,,Unknown,,cid:12)(cid:29)(cid:26)(cid:41)(cid:25)(cid:2)(cid:53)(cid:53)(cid:37)(cid:16)(cid:34)(cid:33,,15497.0
,,3,,,Unknown,,cid:12)(cid:29)(cid:26)(cid:41)(cid:25)(cid:2)(cid:53)(cid:53)(cid:37)(cid:16)(cid:34)(cid:33,,15500.0
,,15,,,Unknown,,cid:12)(cid:29)(cid:26)(cid:41)(cid:25)(cid:2)(cid:53)(cid:53)(cid:37)(cid:16)(cid:34)(cid:33,,15515.0
,,2,,,Unknown,,cid:12)(cid:29)(cid:26)(cid:41)(cid:25)(cid:2)(cid:53)(cid:53)(cid:37)(cid:16)(cid:34)(cid:33,,15517.0
,,34,,,Unknown,,cid:12)(cid:29)(cid:26)(cid:41)(cid:25)(cid:2)(cid:53)(cid:53)(cid:37)(cid:16)(cid:34)(cid:33,,15551.0
,,19,,,Unknown,,cid:12)(cid:29)(cid:26)(cid:41)(cid:25)(cid:2)(cid:53)(cid:53)(cid:37)(cid:16)(cid:34)(cid:33,,15570.0
,,1,,,Unknown,,cid:12)(cid:29)(cid:26)(cid:41)(cid:25)(cid:2)(cid:53)(cid:53)(cid:37)(cid:16)(cid:34)(cid:33,,15571.0
,,18,,,Unknown,,cid:12)(cid:29)(cid:26)(cid:41)(cid:25)(cid:2)(cid:53)(cid:53)(cid:37)(cid:16)(cid:34)(cid:33,,15589.0
,,2,,,Unknown,,cid:12)(cid:29)(cid:26)(cid:41)(cid:25)(cid:2)(cid:53)(cid:53)(cid:37)(cid:16)(cid:34)(cid:33,,15591.0
,,44,,,Unknown,,cid:12)(cid:29)(cid:26)(cid:41)(cid:25)(cid:2)(cid:53)(cid:53)(cid:37)(cid:16)(cid:34)(cid:33,,15635.0
,,12,,,Unknown,,cid:12)(cid:29)(cid:26)(cid:41)(cid:25)(cid:2)(cid:53)(cid:53)(cid:37)(cid:16)(cid:34)(cid:33,,15647.0
,,29,,,Unknown,,cid:12)(cid:29)(cid:26)(cid:41)(cid:25)(cid:2)(cid:53)(cid:53)(cid:37)(cid:16)(cid:34)(cid:33,,15676.0
,,26,,,Unknown,,cid:12)(cid:29)(cid:26)(cid:41)(cid:25)(cid:2)(cid:53)(cid:53)(cid:37)(cid:16)(cid:34)(cid:33,,15702.0
,,41,,,Unknown,,cid:12)(cid:29)(cid:26)(cid:41)(cid:25)(cid:2)(cid:53)(cid:53)(cid:37)(cid:16)(cid:34)(cid:33,,15743.0
,,25,,,Unknown,,cid:12)(cid:29)(cid:26)(cid:41)(cid:25)(cid:2)(cid:53)(cid:53)(cid:37)(cid:16)(cid:34)(cid:33,,15768.0
,,2,,,Unknown,,cid:12)(cid:29)(cid:26)(cid:41)(cid:25)(cid:2)(cid:53)(cid:53)(cid:37)(cid:16)(cid:34)(cid:33,,15770.0
,,53,,,Unknown,,cid:12)(cid:29)(cid:26)(cid:41)(cid:25)(cid:2)(cid:53)(cid:53)(cid:37)(cid:16)(cid:34)(cid:33,,15823.0
,,53,,,Unknown,,cid:12)(cid:29)(cid:26)(cid:41)(cid:25)(cid:2)(cid:53)(cid:53)(cid:37)(cid:16)(cid:34)(cid:33,,15876.0
,,18,,,Unknown,,cid:12)(cid:29)(cid:26)(cid:41)(cid:25)(cid:2)(cid:53)(cid:53)(cid:37)(cid:16)(cid:34)(cid:33,,15894.0
,,1,,,Unknown,,cid:12)(cid:29)(cid:26)(cid:41)(cid:25)(cid:2)(cid:53)(cid:53)(cid:37)(cid:16)(cid:34)(cid:33,,15895.0
,,1,,,Unknown,,cid:12)(cid:29)(cid:26)(cid:41)(cid:25)(cid:2)(cid:53)(cid:53)(cid:37)(cid:16)(cid:34)(cid:33,,15896.0
,,37,,,Unknown,,cid:12)(cid:29)(cid:26)(cid:41)(cid:25)(cid:2)(cid:53)(cid:53)(cid:37)(cid:16)(cid:34)(cid:33,,15933.0
,,1,,,Unknown,,cid:12)(cid:29)(cid:26)(cid:41)(cid:25)(cid:2)(cid:53)(cid:53)(cid:37)(cid:16)(cid:34)(cid:33,,15934.0
,,17,,,Unknown,,cid:12)(cid:29)(cid:26)(cid:41)(cid:25)(cid:2)(cid:53)(cid:53)(cid:37)(cid:16)(cid:34)(cid:33,,15951.0
,,45,,,Unknown,,cid:12)(cid:29)(cid:26)(cid:41)(cid:25)(cid:2)(cid:53)(cid:53)(cid:37)(cid:16)(cid:34)(cid:33,,15996.0
,,18,,,Unknown,,cid:12)(cid:29)(cid:26)(cid:41)(cid:25)(cid:2)(cid:53)(cid:53)(cid:37)(cid:16)(cid:34)(cid:33,,16014.0
,,34,,,Unknown,,cid:12)(cid:29)(cid:26)(cid:41)(cid:25)(cid:2)(cid:53)(cid:53)(cid:37)(cid:16)(cid:34)(cid:33,,16048.0
,,10,,,Unknown,,cid:12)(cid:29)(cid:26)(cid:41)(cid:25)(cid:2)(cid:53)(cid:53)(cid:37)(cid:16)(cid:34)(cid:33,,16058.0
,,11,,,Unknown,,cid:12)(cid:29)(cid:26)(cid:41)(cid:25)(cid:2)(cid:53)(cid:53)(cid:37)(cid:16)(cid:34)(cid:33,,16069.0
,,10,,,Unknown,,cid:12)(cid:29)(cid:26)(cid:41)(cid:25)(cid:2)(cid:53)(cid:53)(cid:37)(cid:16)(cid:34)(cid:33,,16079.0
,,49,,,Unknown,,cid:12)(cid:29)(cid:26)(cid:41)(cid:25)(cid:2)(cid:53)(cid:53)(cid:37)(cid:16)(cid:34)(cid:33,,16128.0
,,14,,,Unknown,,cid:12)(cid:29)(cid:26)(cid:41)(cid:25)(cid:2)(cid:53)(cid:53)(cid:37)(cid:16)(cid:34)(cid:33,,16142.0
,,2,,,Unknown,,cid:12)(cid:29)(cid:26)(cid:41)(cid:25)(cid:2)(cid:53)(cid:53)(cid:37)(cid:16)(cid:34)(cid:33,,16144.0
,,12,,,Unknown,,cid:12)(cid:29)(cid:26)(cid:41)(cid:25)(cid:2)(cid:53)(cid:53)(cid:37)(cid:16)(cid:34)(cid:33,,16156.0
,,11,,,Unknown,,cid:12)(cid:29)(cid:26)(cid:41)(cid:25)(cid:2)(cid:53)(cid:53)(cid:37)(cid:16)(cid:34)(cid:33,,16167.0
,,4,,,Unknown,,cid:12)(cid:29)(cid:26)(cid:41)(cid:25)(cid:2)(cid:53)(cid:53)(cid:37)(cid:16)(cid:34)(cid:33,,16171.0
,,14,,,Unknown,,cid:12)(cid:29)(cid:26)(cid:41)(cid:25)(cid:2)(cid:53)(cid:53)(cid:37)(cid:16)(cid:34)(cid:33,,16185.0
,,11,,,Unknown,,cid:12)(cid:29)(cid:26)(cid:41)(cid:25)(cid:2)(cid:53)(cid:53)(cid:37)(cid:16)(cid:34)(cid:33,,16196.0
,,62,,,Unknown,,cid:12)(cid:29)(cid:26)(cid:41)(cid:25)(cid:2)(cid:53)(cid:53)(cid:37)(cid:16)(cid:34)(cid:33,,16258.0
,,62,,,Unknown,,cid:12)(cid:29)(cid:26)(cid:41)(cid:25)(cid:2)(cid:53)(cid:53)(cid:37)(cid:16)(cid:34)(cid:33,,16320.0
,,7,,,Unknown,,cid:12)(cid:29)(cid:26)(cid:41)(cid:25)(cid:2)(cid:53)(cid:53)(cid:37)(cid:16)(cid:34)(cid:33,,16327.0
,,5,,,Unknown,,cid:12)(cid:29)(cid:26)(cid:41)(cid:25)(cid:2)(cid:53)(cid:53)(cid:37)(cid:16)(cid:34)(cid:33,,16332.0
,,3,,,Unknown,,cid:12)(cid:29)(cid:26)(cid:41)(cid:25)(cid:2)(cid:53)(cid:53)(cid:37)(cid:16)(cid:34)(cid:33,,16335.0
,,9,,,Unknown,,cid:12)(cid:29)(cid:26)(cid:41)(cid:25)(cid:2)(cid:53)(cid:53)(cid:37)(cid:16)(cid:34)(cid:33,,16344.0
,,2,,,Unknown,,cid:12)(cid:29)(cid:26)(cid:41)(cid:25)(cid:2)(cid:53)(cid:53)(cid:37)(cid:16)(cid:34)(cid:33,,16346.0
,,28,,,Unknown,,cid:12)(cid:29)(cid:26)(cid:41)(cid:25)(cid:2)(cid:53)(cid:53)(cid:37)(cid:16)(cid:34)(cid:33,,16374.0
,,3,,,Unknown,,cid:12)(cid:29)(cid:26)(cid:41)(cid:25)(cid:2)(cid:53)(cid:53)(cid:37)(cid:16)(cid:34)(cid:33,,16377.0
,,15,,,Unknown,,cid:12)(cid:29)(cid:26)(cid:41)(cid:25)(cid:2)(cid:53)(cid:53)(cid:37)(cid:16)(cid:34)(cid:33,,16392.0
,,2,,,Unknown,,cid:12)(cid:29)(cid:26)(cid:41)(cid:25)(cid:2)(cid:53)(cid:53)(cid:37)(cid:16)(cid:34)(cid:33,,16394.0
,,17,,,Unknown,,cid:12)(cid:29)(cid:26)(cid:41)(cid:25)(cid:2)(cid:53)(cid:53)(cid:37)(cid:16)(cid:34)(cid:33,,16411.0
,,37,,,Unknown,,cid:12)(cid:29)(cid:26)(cid:41)(cid:25)(cid:2)(cid:53)(cid:53)(cid:37)(cid:16)(cid:34)(cid:33,,16448.0
,,19,,,Unknown,,cid:12)(cid:29)(cid:26)(cid:41)(cid:25)(cid:2)(cid:53)(cid:53)(cid:37)(cid:16)(cid:34)(cid:33,,16467.0
,,34,,,Unknown,,cid:12)(cid:29)(cid:26)(cid:41)(cid:25)(cid:2)(cid:53)(cid:53)(cid:37)(cid:16)(cid:34)(cid:33,,16501.0
,,36,,,Unknown,,cid:12)(cid:29)(cid:26)(cid:41)(cid:25)(cid:2)(cid:53)(cid:53)(cid:37)(cid:16)(cid:34)(cid:33,,16537.0
,,2,,,Unknown,,cid:12)(cid:29)(cid:26)(cid:41)(cid:25)(cid:2)(cid:53)(cid:53)(cid:37)(cid:16)(cid:34)(cid:33,,16539.0
,,44,,,Unknown,,cid:12)(cid:29)(cid:26)(cid:41)(cid:25)(cid:2)(cid:53)(cid:53)(cid:37)(cid:16)(cid:34)(cid:33,,16583.0
,,12,,,Unknown,,cid:12)(cid:29)(cid:26)(cid:41)(cid:25)(cid:2)(cid:53)(cid:53)(cid:37)(cid:16)(cid:34)(cid:33,,16595.0
,,29,,,Unknown,,cid:12)(cid:29)(cid:26)(cid:41)(cid:25)(cid:2)(cid:53)(cid:53)(cid:37)(cid:16)(cid:34)(cid:33,,16624.0
,,26,,,Unknown,,cid:12)(cid:29)(cid:26)(cid:41)(cid:25)(cid:2)(cid:53)(cid:53)(cid:37)(cid:16)(cid:34)(cid:33,,16650.0
,,41,,,Unknown,,cid:12)(cid:29)(cid:26)(cid:41)(cid:25)(cid:2)(cid:53)(cid:53)(cid:37)(cid:16)(cid:34)(cid:33,,16691.0
,,25,,,Unknown,,cid:12)(cid:29)(cid:26)(cid:41)(cid:25)(cid:2)(cid:53)(cid:53)(cid:37)(cid:16)(cid:34)(cid:33,,16716.0
,,2,,,Unknown,,cid:12)(cid:29)(cid:26)(cid:41)(cid:25)(cid:2)(cid:53)(cid:53)(cid:37)(cid:16)(cid:34)(cid:33,,16718.0
,,53,,,Unknown,,cid:12)(cid:29)(cid:26)(cid:41)(cid:25)(cid:2)(cid:53)(cid:53)(cid:37)(cid:16)(cid:34)(cid:33,,16771.0
,,53,,,Unknown,,cid:12)(cid:29)(cid:26)(cid:41)(cid:25)(cid:2)(cid:53)(cid:53)(cid:37)(cid:16)(cid:34)(cid:33,,16824.0
,,18,,,Unknown,,cid:12)(cid:29)(cid:26)(cid:41)(cid:25)(cid:2)(cid:53)(cid:53)(cid:37)(cid:16)(cid:34)(cid:33,,16842.0
,,1,,,Unknown,,cid:12)(cid:29)(cid:26)(cid:41)(cid:25)(cid:2)(cid:53)(cid:53)(cid:37)(cid:16)(cid:34)(cid:33,,16843.0
,,1,,,Unknown,,cid:12)(cid:29)(cid:26)(cid:41)(cid:25)(cid:2)(cid:53)(cid:53)(cid:37)(cid:16)(cid:34)(cid:33,,16844.0
,,37,,,Unknown,,cid:12)(cid:29)(cid:26)(cid:41)(cid:25)(cid:2)(cid:53)(cid:53)(cid:37)(cid:16)(cid:34)(cid:33,,16881.0
,,1,,,Unknown,,cid:12)(cid:29)(cid:26)(cid:41)(cid:25)(cid:2)(cid:53)(cid:53)(cid:37)(cid:16)(cid:34)(cid:33,,16882.0
,,36,,,Unknown,,cid:12)(cid:29)(cid:26)(cid:41)(cid:25)(cid:2)(cid:53)(cid:53)(cid:37)(cid:16)(cid:34)(cid:33,,16918.0
,,45,,,Unknown,,cid:12)(cid:29)(cid:26)(cid:41)(cid:25)(cid:2)(cid:53)(cid:53)(cid:37)(cid:16)(cid:34)(cid:33,,16963.0
,,18,,,Unknown,,cid:12)(cid:29)(cid:26)(cid:41)(cid:25)(cid:2)(cid:53)(cid:53)(cid:37)(cid:16)(cid:34)(cid:33,,16981.0
,,34,,,Unknown,,cid:12)(cid:29)(cid:26)(cid:41)(cid:25)(cid:2)(cid:53)(cid:53)(cid:37)(cid:16)(cid:34)(cid:33,,17015.0
,,10,,,Unknown,,cid:12)(cid:29)(cid:26)(cid:41)(cid:25)(cid:2)(cid:53)(cid:53)(cid:37)(cid:16)(cid:34)(cid:33,,17025.0
,,49,,,Unknown,,cid:12)(cid:29)(cid:26)(cid:41)(cid:25)(cid:2)(cid:53)(cid:53)(cid:37)(cid:16)(cid:34)(cid:33,,17074.0
,,47,,,Unknown,,cid:12)(cid:29)(cid:26)(cid:41)(cid:25)(cid:2)(cid:53)(cid:53)(cid:37)(cid:16)(cid:34)(cid:33,,17121.0
,,49,,,Unknown,,cid:12)(cid:29)(cid:26)(cid:41)(cid:25)(cid:2)(cid:53)(cid:53)(cid:37)(cid:16)(cid:34)(cid:33,,17170.0
,,12,,,Unknown,,cid:12)(cid:29)(cid:26)(cid:41)(cid:25)(cid:2)(cid:53)(cid:53)(cid:37)(cid:16)(cid:34)(cid:33,,17182.0
,,2,,,Unknown,,cid:12)(cid:29)(cid:26)(cid:41)(cid:25)(cid:2)(cid:53)(cid:53)(cid:37)(cid:16)(cid:34)(cid:33,,17184.0
,,14,,,Unknown,,cid:12)(cid:29)(cid:26)(cid:41)(cid:25)(cid:2)(cid:53)(cid:53)(cid:37)(cid:16)(cid:34)(cid:33,,17198.0
,,5,,,Unknown,,cid:12)(cid:29)(cid:26)(cid:41)(cid:25)(cid:2)(cid:53)(cid:53)(cid:37)(cid:16)(cid:34)(cid:33,,17203.0
,,2,,,Unknown,,cid:12)(cid:29)(cid:26)(cid:41)(cid:25)(cid:2)(cid:53)(cid:53)(cid:37)(cid:16)(cid:34)(cid:33,,17205.0
,,12,,,Unknown,,cid:12)(cid:29)(cid:26)(cid:41)(cid:25)(cid:2)(cid:53)(cid:53)(cid:37)(cid:16)(cid:34)(cid:33,,17217.0
,,5,,,Unknown,,cid:12)(cid:29)(cid:26)(cid:41)(cid:25)(cid:2)(cid:53)(cid:53)(cid:37)(cid:16)(cid:34)(cid:33,,17222.0
,,14,,,Unknown,,cid:12)(cid:29)(cid:26)(cid:41)(cid:25)(cid:2)(cid:53)(cid:53)(cid:37)(cid:16)(cid:34)(cid:33,,17236.0
,,10,,,Unknown,,cid:12)(cid:29)(cid:26)(cid:41)(cid:25)(cid:2)(cid:53)(cid:53)(cid:37)(cid:16)(cid:34)(cid:33,,17246.0
,,7,,,Unknown,,cid:12)(cid:29)(cid:26)(cid:41)(cid:25)(cid:2)(cid:53)(cid:53)(cid:37)(cid:16)(cid:34)(cid:33,,17253.0
,,12,,,Unknown,,cid:12)(cid:29)(cid:26)(cid:41)(cid:25)(cid:2)(cid:53)(cid:53)(cid:37)(cid:16)(cid:34)(cid:33,,17265.0
,,2,,,Unknown,,cid:12)(cid:29)(cid:26)(cid:41)(cid:25)(cid:2)(cid:53)(cid:53)(cid:37)(cid:16)(cid:34)(cid:33,,17267.0
,,12,,,Unknown,,cid:12)(cid:29)(cid:26)(cid:41)(cid:25)(cid:2)(cid:53)(cid:53)(cid:37)(cid:16)(cid:34)(cid:33,,17279.0
,,11,,,Unknown,,cid:12)(cid:29)(cid:26)(cid:41)(cid:25)(cid:2)(cid:53)(cid:53)(cid:37)(cid:16)(cid:34)(cid:33,,17290.0
,,4,,,Unknown,,cid:12)(cid:29)(cid:26)(cid:41)(cid:25)(cid:2)(cid:53)(cid:53)(cid:37)(cid:16)(cid:34)(cid:33,,17294.0
,,14,,,Unknown,,cid:12)(cid:29)(cid:26)(cid:41)(cid:25)(cid:2)(cid:53)(cid:53)(cid:37)(cid:16)(cid:34)(cid:33,,17308.0
,,11,,,Unknown,,cid:12)(cid:29)(cid:26)(cid:41)(cid:25)(cid:2)(cid:53)(cid:53)(cid:37)(cid:16)(cid:34)(cid:33,,17319.0
,,62,,,Unknown,,cid:12)(cid:29)(cid:26)(cid:41)(cid:25)(cid:2)(cid:53)(cid:53)(cid:37)(cid:16)(cid:34)(cid:33,,17381.0
,,62,,,Unknown,,cid:12)(cid:29)(cid:26)(cid:41)(cid:25)(cid:2)(cid:53)(cid:53)(cid:37)(cid:16)(cid:34)(cid:33,,17443.0
,,7,,,Unknown,,cid:12)(cid:29)(cid:26)(cid:41)(cid:25)(cid:2)(cid:53)(cid:53)(cid:37)(cid:16)(cid:34)(cid:33,,17450.0
,,5,,,Unknown,,cid:12)(cid:29)(cid:26)(cid:41)(cid:25)(cid:2)(cid:53)(cid:53)(cid:37)(cid:16)(cid:34)(cid:33,,17455.0
,,3,,,Unknown,,cid:12)(cid:29)(cid:26)(cid:41)(cid:25)(cid:2)(cid:53)(cid:53)(cid:37)(cid:16)(cid:34)(cid:33,,17458.0
,,9,,,Unknown,,cid:12)(cid:29)(cid:26)(cid:41)(cid:25)(cid:2)(cid:53)(cid:53)(cid:37)(cid:16)(cid:34)(cid:33,,17467.0
,,2,,,Unknown,,cid:12)(cid:29)(cid:26)(cid:41)(cid:25)(cid:2)(cid:53)(cid:53)(cid:37)(cid:16)(cid:34)(cid:33,,17469.0
,,28,,,Unknown,,cid:12)(cid:29)(cid:26)(cid:41)(cid:25)(cid:2)(cid:53)(cid:53)(cid:37)(cid:16)(cid:34)(cid:33,,17497.0
,,3,,,Unknown,,cid:12)(cid:29)(cid:26)(cid:41)(cid:25)(cid:2)(cid:53)(cid:53)(cid:37)(cid:16)(cid:34)(cid:33,,17500.0
,,15,,,Unknown,,cid:12)(cid:29)(cid:26)(cid:41)(cid:25)(cid:2)(cid:53)(cid:53)(cid:37)(cid:16)(cid:34)(cid:33,,17515.0
,,2,,,Unknown,,cid:12)(cid:29)(cid:26)(cid:41)(cid:25)(cid:2)(cid:53)(cid:53)(cid:37)(cid:16)(cid:34)(cid:33,,17517.0
,,33,,,Unknown,,cid:12)(cid:29)(cid:26)(cid:41)(cid:25)(cid:2)(cid:53)(cid:53)(cid:37)(cid:16)(cid:34)(cid:33,,17550.0
,,19,,,Unknown,,cid:12)(cid:29)(cid:26)(cid:41)(cid:25)(cid:2)(cid:53)(cid:53)(cid:37)(cid:16)(cid:34)(cid:33,,17569.0
,,36,,,Unknown,,cid:12)(cid:29)(cid:26)(cid:41)(cid:25)(cid:2)(cid:53)(cid:53)(cid:37)(cid:16)(cid:34)(cid:33,,17605.0
,,18,,,Unknown,,cid:12)(cid:29)(cid:26)(cid:41)(cid:25)(cid:2)(cid:53)(cid:53)(cid:37)(cid:16)(cid:34)(cid:33,,17623.0
,,2,,,Unknown,,cid:12)(cid:29)(cid:26)(cid:41)(cid:25)(cid:2)(cid:53)(cid:53)(cid:37)(cid:16)(cid:34)(cid:33,,17625.0
,,44,,,Unknown,,cid:12)(cid:29)(cid:26)(cid:41)(cid:25)(cid:2)(cid:53)(cid:53)(cid:37)(cid:16)(cid:34)(cid:33,,17669.0
,,12,,,Unknown,,cid:12)(cid:29)(cid:26)(cid:41)(cid:25)(cid:2)(cid:53)(cid:53)(cid:37)(cid:16)(cid:34)(cid:33,,17681.0
,,29,,,Unknown,,cid:12)(cid:29)(cid:26)(cid:41)(cid:25)(cid:2)(cid:53)(cid:53)(cid:37)(cid:16)(cid:34)(cid:33,,17710.0
,,26,,,Unknown,,cid:12)(cid:29)(cid:26)(cid:41)(cid:25)(cid:2)(cid:53)(cid:53)(cid:37)(cid:16)(cid:34)(cid:33,,17736.0
,,41,,,Unknown,,cid:12)(cid:29)(cid:26)(cid:41)(cid:25)(cid:2)(cid:53)(cid:53)(cid:37)(cid:16)(cid:34)(cid:33,,17777.0
,,25,,,Unknown,,cid:12)(cid:29)(cid:26)(cid:41)(cid:25)(cid:2)(cid:53)(cid:53)(cid:37)(cid:16)(cid:34)(cid:33,,17802.0
,,2,,,Unknown,,cid:12)(cid:29)(cid:26)(cid:41)(cid:25)(cid:2)(cid:53)(cid:53)(cid:37)(cid:16)(cid:34)(cid:33,,17804.0
,,53,,,Unknown,,cid:12)(cid:29)(cid:26)(cid:41)(cid:25)(cid:2)(cid:53)(cid:53)(cid:37)(cid:16)(cid:34)(cid:33,,17857.0
,,53,,,Unknown,,cid:12)(cid:29)(cid:26)(cid:41)(cid:25)(cid:2)(cid:53)(cid:53)(cid:37)(cid:16)(cid:34)(cid:33,,17910.0
,,18,,,Unknown,,cid:12)(cid:29)(cid:26)(cid:41)(cid:25)(cid:2)(cid:53)(cid:53)(cid:37)(cid:16)(cid:34)(cid:33,,17928.0
,,1,,,Unknown,,cid:12)(cid:29)(cid:26)(cid:41)(cid:25)(cid:2)(cid:53)(cid:53)(cid:37)(cid:16)(cid:34)(cid:33,,17929.0
,,1,,,Unknown,,cid:12)(cid:29)(cid:26)(cid:41)(cid:25)(cid:2)(cid:53)(cid:53)(cid:37)(cid:16)(cid:34)(cid:33,,17930.0
,,37,,,Unknown,,cid:12)(cid:29)(cid:26)(cid:41)(cid:25)(cid:2)(cid:53)(cid:53)(cid:37)(cid:16)(cid:34)(cid:33,,17967.0
,,1,,,Unknown,,cid:12)(cid:29)(cid:26)(cid:41)(cid:25)(cid:2)(cid:53)(cid:53)(cid:37)(cid:16)(cid:34)(cid:33,,17968.0
,,36,,,Unknown,,cid:12)(cid:29)(cid:26)(cid:41)(cid:25)(cid:2)(cid:53)(cid:53)(cid:37)(cid:16)(cid:34)(cid:33,,18004.0
,,45,,,Unknown,,cid:12)(cid:29)(cid:26)(cid:41)(cid:25)(cid:2)(cid:53)(cid:53)(cid:37)(cid:16)(cid:34)(cid:33,,18049.0
,,18,,,Unknown,,cid:12)(cid:29)(cid:26)(cid:41)(cid:25)(cid:2)(cid:53)(cid:53)(cid:37)(cid:16)(cid:34)(cid:33,,18067.0
,,34,,,Unknown,,cid:12)(cid:29)(cid:26)(cid:41)(cid:25)(cid:2)(cid:53)(cid:53)(cid:37)(cid:16)(cid:34)(cid:33,,18101.0
,,12,,,Unknown,,cid:12)(cid:29)(cid:26)(cid:41)(cid:25)(cid:2)(cid:53)(cid:53)(cid:37)(cid:16)(cid:34)(cid:33,,18113.0
,,13,,,Unknown,,cid:12)(cid:29)(cid:26)(cid:41)(cid:25)(cid:2)(cid:53)(cid:53)(cid:37)(cid:16)(cid:34)(cid:33,,18126.0
,,14,,,Unknown,,cid:12)(cid:29)(cid:26)(cid:41)(cid:25)(cid:2)(cid:53)(cid:53)(cid:37)(cid:16)(cid:34)(cid:33,,18140.0
,,2,,,Unknown,,cid:12)(cid:29)(cid:26)(cid:41)(cid:25)(cid:2)(cid:53)(cid:53)(cid:37)(cid:16)(cid:34)(cid:33,,18142.0
,,14,,,Unknown,,cid:12)(cid:29)(cid:26)(cid:41)(cid:25)(cid:2)(cid:53)(cid:53)(cid:37)(cid:16)(cid:34)(cid:33,,18156.0
,,49,,,Unknown,,cid:12)(cid:29)(cid:26)(cid:41)(cid:25)(cid:2)(cid:53)(cid:53)(cid:37)(cid:16)(cid:34)(cid:33,,18205.0
,,63,,,Unknown,,cid:12)(cid:29)(cid:26)(cid:41)(cid:25)(cid:2)(cid:53)(cid:53)(cid:37)(cid:16)(cid:34)(cid:33,,18268.0
,,49,,,Unknown,,cid:12)(cid:29)(cid:26)(cid:41)(cid:25)(cid:2)(cid:53)(cid:53)(cid:37)(cid:16)(cid:34)(cid:33,,18317.0
,,46,,,Unknown,,cid:12)(cid:29)(cid:26)(cid:41)(cid:25)(cid:2)(cid:53)(cid:53)(cid:37)(cid:16)(cid:34)(cid:33,,18363.0
,,5,,,Unknown,,cid:12)(cid:29)(cid:26)(cid:41)(cid:25)(cid:2)(cid:53)(cid:53)(cid:37)(cid:16)(cid:34)(cid:33,,18368.0
,,9,,,Unknown,,cid:12)(cid:29)(cid:26)(cid:41)(cid:25)(cid:2)(cid:53)(cid:53)(cid:37)(cid:16)(cid:34)(cid:33,,18377.0
,,2,,,Unknown,,cid:12)(cid:29)(cid:26)(cid:41)(cid:25)(cid:2)(cid:53)(cid:53)(cid:37)(cid:16)(cid:34)(cid:33,,18379.0
,,47,,,Unknown,,cid:12)(cid:29)(cid:26)(cid:41)(cid:25)(cid:2)(cid:53)(cid:53)(cid:37)(cid:16)(cid:34)(cid:33,,18426.0
,,11,,,Unknown,,cid:12)(cid:29)(cid:26)(cid:41)(cid:25)(cid:2)(cid:53)(cid:53)(cid:37)(cid:16)(cid:34)(cid:33,,18437.0
,,7,,,Unknown,,cid:12)(cid:29)(cid:26)(cid:41)(cid:25)(cid:2)(cid:53)(cid:53)(cid:37)(cid:16)(cid:34)(cid:33,,18444.0
,,9,,,Unknown,,cid:12)(cid:29)(cid:26)(cid:41)(cid:25)(cid:2)(cid:53)(cid:53)(cid:37)(cid:16)(cid:34)(cid:33,,18453.0
,,9,,,Unknown,,cid:12)(cid:29)(cid:26)(cid:41)(cid:25)(cid:2)(cid:53)(cid:53)(cid:37)(cid:16)(cid:34)(cid:33,,18462.0
,,65,,,Unknown,,cid:12)(cid:29)(cid:26)(cid:41)(cid:25)(cid:2)(cid:53)(cid:53)(cid:37)(cid:16)(cid:34)(cid:33,,18527.0
,,2,,,Unknown,,cid:12)(cid:29)(cid:26)(cid:41)(cid:25)(cid:2)(cid:53)(cid:53)(cid:37)(cid:16)(cid:34)(cid:33,,18529.0
,,14,,,Unknown,,cid:12)(cid:29)(cid:26)(cid:41)(cid:25)(cid:2)(cid:53)(cid:53)(cid:37)(cid:16)(cid:34)(cid:33,,18543.0
,,5,,,Unknown,,cid:12)(cid:29)(cid:26)(cid:41)(cid:25)(cid:2)(cid:53)(cid:53)(cid:37)(cid:16)(cid:34)(cid:33,,18548.0
,,2,,,Unknown,,cid:12)(cid:29)(cid:26)(cid:41)(cid:25)(cid:2)(cid:53)(cid:53)(cid:37)(cid:16)(cid:34)(cid:33,,18550.0
,,12,,,Unknown,,cid:12)(cid:29)(cid:26)(cid:41)(cid:25)(cid:2)(cid:53)(cid:53)(cid:37)(cid:16)(cid:34)(cid:33,,18562.0
,,13,,,Unknown,,cid:12)(cid:29)(cid:26)(cid:41)(cid:25)(cid:2)(cid:53)(cid:53)(cid:37)(cid:16)(cid:34)(cid:33,,18575.0
,,49,,,Unknown,,cid:12)(cid:29)(cid:26)(cid:41)(cid:25)(cid:2)(cid:53)(cid:53)(cid:37)(cid:16)(cid:34)(cid:33,,18624.0
,,2,,,Unknown,,cid:12)(cid:29)(cid:26)(cid:41)(cid:25)(cid:2)(cid:53)(cid:53)(cid:37)(cid:16)(cid:34)(cid:33,,18626.0
,,28,,,Unknown,,cid:12)(cid:29)(cid:26)(cid:41)(cid:25)(cid:2)(cid:53)(cid:53)(cid:37)(cid:16)(cid:34)(cid:33,,18654.0
,,3,,,Unknown,,cid:12)(cid:29)(cid:26)(cid:41)(cid:25)(cid:2)(cid:53)(cid:53)(cid:37)(cid:16)(cid:34)(cid:33,,18657.0
,,15,,,Unknown,,cid:12)(cid:29)(cid:26)(cid:41)(cid:25)(cid:2)(cid:53)(cid:53)(cid:37)(cid:16)(cid:34)(cid:33,,18672.0
,,2,,,Unknown,,cid:12)(cid:29)(cid:26)(cid:41)(cid:25)(cid:2)(cid:53)(cid:53)(cid:37)(cid:16)(cid:34)(cid:33,,18674.0
,,17,,,Unknown,,cid:12)(cid:29)(cid:26)(cid:41)(cid:25)(cid:2)(cid:53)(cid:53)(cid:37)(cid:16)(cid:34)(cid:33,,18691.0
,,18,,,Unknown,,cid:12)(cid:29)(cid:26)(cid:41)(cid:25)(cid:2)(cid:53)(cid:53)(cid:37)(cid:16)(cid:34)(cid:33,,18709.0
,,19,,,Unknown,,cid:12)(cid:29)(cid:26)(cid:41)(cid:25)(cid:2)(cid:53)(cid:53)(cid:37)(cid:16)(cid:34)(cid:33,,18728.0
,,18,,,Unknown,,cid:12)(cid:29)(cid:26)(cid:41)(cid:25)(cid:2)(cid:53)(cid:53)(cid:37)(cid:16)(cid:34)(cid:33,,18746.0
,,18,,,Unknown,,cid:12)(cid:29)(cid:26)(cid:41)(cid:25)(cid:2)(cid:53)(cid:53)(cid:37)(cid:16)(cid:34)(cid:33,,18764.0
,,2,,,Unknown,,cid:12)(cid:29)(cid:26)(cid:41)(cid:25)(cid:2)(cid:53)(cid:53)(cid:37)(cid:16)(cid:34)(cid:33,,18766.0
,,44,,,Unknown,,cid:12)(cid:29)(cid:26)(cid:41)(cid:25)(cid:2)(cid:53)(cid:53)(cid:37)(cid:16)(cid:34)(cid:33,,18810.0
,,12,,,Unknown,,cid:12)(cid:29)(cid:26)(cid:41)(cid:25)(cid:2)(cid:53)(cid:53)(cid:37)(cid:16)(cid:34)(cid:33,,18822.0
,,29,,,Unknown,,cid:12)(cid:29)(cid:26)(cid:41)(cid:25)(cid:2)(cid:53)(cid:53)(cid:37)(cid:16)(cid:34)(cid:33,,18851.0
,,26,,,Unknown,,cid:12)(cid:29)(cid:26)(cid:41)(cid:25)(cid:2)(cid:53)(cid:53)(cid:37)(cid:16)(cid:34)(cid:33,,18877.0
,,41,,,Unknown,,cid:12)(cid:29)(cid:26)(cid:41)(cid:25)(cid:2)(cid:53)(cid:53)(cid:37)(cid:16)(cid:34)(cid:33,,18918.0
,,25,,,Unknown,,cid:12)(cid:29)(cid:26)(cid:41)(cid:25)(cid:2)(cid:53)(cid:53)(cid:37)(cid:16)(cid:34)(cid:33,,18943.0
,,2,,,Unknown,,cid:12)(cid:29)(cid:26)(cid:41)(cid:25)(cid:2)(cid:53)(cid:53)(cid:37)(cid:16)(cid:34)(cid:33,,18945.0
,,53,,,Unknown,,cid:12)(cid:29)(cid:26)(cid:41)(cid:25)(cid:2)(cid:53)(cid:53)(cid:37)(cid:16)(cid:34)(cid:33,,18998.0
,,53,,,Unknown,,cid:12)(cid:29)(cid:26)(cid:41)(cid:25)(cid:2)(cid:53)(cid:53)(cid:37)(cid:16)(cid:34)(cid:33,,19051.0
,,18,,,Unknown,,cid:12)(cid:29)(cid:26)(cid:41)(cid:25)(cid:2)(cid:53)(cid:53)(cid:37)(cid:16)(cid:34)(cid:33,,19069.0
,,1,,,Unknown,,cid:12)(cid:29)(cid:26)(cid:41)(cid:25)(cid:2)(cid:53)(cid:53)(cid:37)(cid:16)(cid:34)(cid:33,,19070.0
,,1,,,Unknown,,cid:12)(cid:29)(cid:26)(cid:41)(cid:25)(cid:2)(cid:53)(cid:53)(cid:37)(cid:16)(cid:34)(cid:33,,19071.0
,,37,,,Unknown,,cid:12)(cid:29)(cid:26)(cid:41)(cid:25)(cid:2)(cid:53)(cid:53)(cid:37)(cid:16)(cid:34)(cid:33,,19108.0
,,1,,,Unknown,,cid:12)(cid:29)(cid:26)(cid:41)(cid:25)(cid:2)(cid:53)(cid:53)(cid:37)(cid:16)(cid:34)(cid:33,cid:1)(cid:34)(cid:45)(cid:18)(cid:34,1.0
,,34,,,Unknown,,cid:12)(cid:29)(cid:26)(cid:41)(cid:25)(cid:2)(cid:53)(cid:53)(cid:37)(cid:16)(cid:34)(cid:33,cid:1)(cid:34)(cid:45)(cid:18)(cid:34,35.0
,,45,,,Unknown,,cid:12)(cid:29)(cid:26)(cid:41)(cid:25)(cid:2)(cid:53)(cid:53)(cid:37)(cid:16)(cid:34)(cid:33,cid:1)(cid:32)(cid:45)(cid:18)(cid:34,80.0
,,18,,,Unknown,,cid:12)(cid:29)(cid:26)(cid:41)(cid:25)(cid:2)(cid:53)(cid:53)(cid:37)(cid:16)(cid:34)(cid:33,cid:1)(cid:32)(cid:45)(cid:18)(cid:34,98.0
,,34,,,Unknown,,cid:12)(cid:29)(cid:26)(cid:41)(cid:25)(cid:2)(cid:53)(cid:53)(cid:37)(cid:16)(cid:34)(cid:33,cid:1)(cid:16)(cid:45)(cid:18)(cid:34,132.0
,,5,,,Unknown,,cid:12)(cid:29)(cid:26)(cid:41)(cid:25)(cid:2)(cid:53)(cid:53)(cid:37)(cid:16)(cid:34)(cid:33,cid:12)(cid:11)(cid:8)(cid:28)(cid:11)(cid:3)(cid:49)(cid:62)(cid:49)(cid:2)(cid:8)(cid:49)(cid:8)(cid:10)(cid:5)(cid:4)(cid:7)(cid:14)(cid:2)(cid:14)(cid:2)(cid:28)(cid:3,137.0
,,10,,,Unknown,,cid:12)(cid:29)(cid:26)(cid:41)(cid:25)(cid:2)(cid:53)(cid:53)(cid:37)(cid:16)(cid:34)(cid:33,cid:1)(cid:16)(cid:45)(cid:18)(cid:34,147.0
,,49,,,Unknown,,cid:12)(cid:29)(cid:26)(cid:41)(cid:25)(cid:2)(cid:53)(cid:53)(cid:37)(cid:16)(cid:34)(cid:33,cid:1)(cid:16)(cid:45)(cid:18)(cid:34,196.0
,,47,,,Unknown,,cid:12)(cid:29)(cid:26)(cid:41)(cid:25)(cid:2)(cid:53)(cid:53)(cid:37)(cid:16)(cid:34)(cid:33,cid:1)(cid:16)(cid:45)(cid:18)(cid:34,243.0
,,14,,,Unknown,,cid:12)(cid:29)(cid:26)(cid:41)(cid:25)(cid:2)(cid:53)(cid:53)(cid:37)(cid:16)(cid:34)(cid:33,cid:9)(cid:49)(cid:8)(cid:5)(cid:28)(cid:2)(cid:9)(cid:5)(cid:8)(cid:14)(cid:7)(cid:9)(cid:2)(cid:28)(cid:3,257.0
,,7,,,Unknown,,cid:12)(cid:29)(cid:26)(cid:41)(cid:25)(cid:2)(cid:53)(cid:53)(cid:37)(cid:16)(cid:34)(cid:33,cid:9)(cid:21)(cid:23)(cid:4)(cid:55)(cid:2)(cid:53)(cid:62)(cid:11)(cid:10)(cid:11)(cid:47)(cid:3)(cid:7)(cid:5)(cid:2)(cid:39)(cid:3)(cid:11)(cid:63)(cid:7)(cid:2)(cid:39)(cid:11)(cid:7)(cid:46)(cid:8)(cid:65)(cid:2)(cid:28)(cid:3,264.0
,,9,,,Unknown,,cid:12)(cid:29)(cid:26)(cid:41)(cid:25)(cid:2)(cid:53)(cid:53)(cid:37)(cid:16)(cid:34)(cid:33,cid:1)(cid:33)(cid:45)(cid:18)(cid:34,273.0
,,9,,,Unknown,,cid:12)(cid:29)(cid:26)(cid:41)(cid:25)(cid:2)(cid:53)(cid:53)(cid:37)(cid:16)(cid:34)(cid:33,cid:1)(cid:33)(cid:45)(cid:18)(cid:34,282.0
,,5,,,Unknown,,cid:12)(cid:29)(cid:26)(cid:41)(cid:25)(cid:2)(cid:53)(cid:53)(cid:37)(cid:16)(cid:34)(cid:33,cid:1)(cid:33)(cid:45)(cid:18)(cid:34,287.0
,,62,,,Unknown,,cid:12)(cid:29)(cid:26)(cid:41)(cid:25)(cid:2)(cid:53)(cid:53)(cid:37)(cid:16)(cid:34)(cid:33,cid:1)(cid:33)(cid:45)(cid:18)(cid:34,349.0
,,5,,,Unknown,,cid:12)(cid:29)(cid:26)(cid:41)(cid:25)(cid:2)(cid:53)(cid:53)(cid:37)(cid:16)(cid:34)(cid:33,cid:1)(cid:33)(cid:45)(cid:18)(cid:34,354.0
,,8,,,Unknown,,cid:12)(cid:29)(cid:26)(cid:41)(cid:25)(cid:2)(cid:53)(cid:53)(cid:37)(cid:16)(cid:34)(cid:33,cid:7)(cid:8)(cid:10)(cid:5)(cid:3)(cid:9)(cid:39)(cid:11)(cid:3)(cid:10)(cid:2)(cid:12)(cid:11)(cid:4)(cid:14)(cid:11)(cid:62)(cid:62)(cid:7)(cid:5)(cid:3)(cid:9)(cid:2)(cid:28)(cid:3,362.0
,,10,,,Unknown,,cid:12)(cid:29)(cid:26)(cid:41)(cid:25)(cid:2)(cid:53)(cid:53)(cid:37)(cid:16)(cid:34)(cid:33,,372.0
,,9,,,Unknown,,cid:12)(cid:29)(cid:26)(cid:41)(cid:25)(cid:2)(cid:53)(cid:53)(cid:37)(cid:16)(cid:34)(cid:33,,381.0
,,2,,,Unknown,,cid:12)(cid:29)(cid:26)(cid:41)(cid:25)(cid:2)(cid:53)(cid:53)(cid:37)(cid:16)(cid:34)(cid:33,,383.0
,,10,,,Unknown,,cid:12)(cid:29)(cid:26)(cid:41)(cid:25)(cid:2)(cid:53)(cid:53)(cid:37)(cid:16)(cid:34)(cid:33,,393.0
,,11,,,Unknown,,cid:12)(cid:29)(cid:26)(cid:41)(cid:25)(cid:2)(cid:53)(cid:53)(cid:37)(cid:16)(cid:34)(cid:33,,404.0
,,8,,,Unknown,,cid:12)(cid:29)(cid:26)(cid:41)(cid:25)(cid:2)(cid:53)(cid:53)(cid:37)(cid:16)(cid:34)(cid:33,,412.0
,,65,,,Unknown,,cid:12)(cid:29)(cid:26)(cid:41)(cid:25)(cid:2)(cid:53)(cid:53)(cid:37)(cid:16)(cid:34)(cid:33,,477.0
,,2,,,Unknown,,cid:12)(cid:29)(cid:26)(cid:41)(cid:25)(cid:2)(cid:53)(cid:53)(cid:37)(cid:16)(cid:34)(cid:33,,479.0
,,13,,,Unknown,,cid:12)(cid:29)(cid:26)(cid:41)(cid:25)(cid:2)(cid:53)(cid:53)(cid:37)(cid:16)(cid:34)(cid:33,,492.0
,,5,,,Unknown,,cid:12)(cid:29)(cid:26)(cid:41)(cid:25)(cid:2)(cid:53)(cid:53)(cid:37)(cid:16)(cid:34)(cid:33,,497.0
,,8,,,Unknown,,cid:12)(cid:29)(cid:26)(cid:41)(cid:25)(cid:2)(cid:53)(cid:53)(cid:37)(cid:16)(cid:34)(cid:33,,505.0
,,3,,,Unknown,,cid:12)(cid:29)(cid:26)(cid:41)(cid:25)(cid:2)(cid:53)(cid:53)(cid:37)(cid:16)(cid:34)(cid:33,,508.0
,,65,,,Unknown,,cid:12)(cid:29)(cid:26)(cid:41)(cid:25)(cid:2)(cid:53)(cid:53)(cid:37)(cid:16)(cid:34)(cid:33,,573.0
,,43,,,Unknown,,cid:12)(cid:29)(cid:26)(cid:41)(cid:25)(cid:2)(cid:53)(cid:53)(cid:37)(cid:16)(cid:34)(cid:33,,616.0
,,2,,,Unknown,,cid:12)(cid:29)(cid:26)(cid:41)(cid:25)(cid:2)(cid:53)(cid:53)(cid:37)(cid:16)(cid:34)(cid:33,,618.0
,,1,,,Unknown,,cid:12)(cid:29)(cid:26)(cid:41)(cid:25)(cid:2)(cid:53)(cid:53)(cid:37)(cid:16)(cid:34)(cid:33,,619.0
,,34,,,Unknown,,cid:12)(cid:29)(cid:26)(cid:41)(cid:25)(cid:2)(cid:53)(cid:53)(cid:37)(cid:16)(cid:34)(cid:33,,653.0
,,2,,,Unknown,,cid:12)(cid:29)(cid:26)(cid:41)(cid:25)(cid:2)(cid:53)(cid:53)(cid:37)(cid:16)(cid:34)(cid:33,,655.0
,,18,,,Unknown,,cid:12)(cid:29)(cid:26)(cid:41)(cid:25)(cid:2)(cid:53)(cid:53)(cid:37)(cid:16)(cid:34)(cid:33,,673.0
,,18,,,Unknown,,cid:12)(cid:29)(cid:26)(cid:41)(cid:25)(cid:2)(cid:53)(cid:53)(cid:37)(cid:16)(cid:34)(cid:33,,691.0
,,18,,,Unknown,,cid:12)(cid:29)(cid:26)(cid:41)(cid:25)(cid:2)(cid:53)(cid:53)(cid:37)(cid:16)(cid:34)(cid:33,,709.0
,,19,,,Unknown,,cid:12)(cid:29)(cid:26)(cid:41)(cid:25)(cid:2)(cid:53)(cid:53)(cid:37)(cid:16)(cid:34)(cid:33,,728.0
,,18,,,Unknown,,cid:12)(cid:29)(cid:26)(cid:41)(cid:25)(cid:2)(cid:53)(cid:53)(cid:37)(cid:16)(cid:34)(cid:33,,746.0
,,18,,,Unknown,,cid:12)(cid:29)(cid:26)(cid:41)(cid:25)(cid:2)(cid:53)(cid:53)(cid:37)(cid:16)(cid:34)(cid:33,,764.0
,,2,,,Unknown,,cid:12)(cid:29)(cid:26)(cid:41)(cid:25)(cid:2)(cid:53)(cid:53)(cid:37)(cid:16)(cid:34)(cid:33,,766.0
,,44,,,Unknown,,cid:12)(cid:29)(cid:26)(cid:41)(cid:25)(cid:2)(cid:53)(cid:53)(cid:37)(cid:16)(cid:34)(cid:33,,810.0
,,63,,,Unknown,,cid:12)(cid:29)(cid:26)(cid:41)(cid:25)(cid:2)(cid:53)(cid:53)(cid:37)(cid:16)(cid:34)(cid:33,,873.0
,,7,,,Unknown,,cid:12)(cid:29)(cid:26)(cid:41)(cid:25)(cid:2)(cid:53)(cid:53)(cid:37)(cid:16)(cid:34)(cid:33,,880.0
,,3,,,Unknown,,cid:12)(cid:29)(cid:26)(cid:41)(cid:25)(cid:2)(cid:53)(cid:53)(cid:37)(cid:16)(cid:34)(cid:33,,883.0
,,5,,,Unknown,,cid:12)(cid:29)(cid:26)(cid:41)(cid:25)(cid:2)(cid:53)(cid:53)(cid:37)(cid:16)(cid:34)(cid:33,,888.0
,,62,,,Unknown,,cid:12)(cid:29)(cid:26)(cid:41)(cid:25)(cid:2)(cid:53)(cid:53)(cid:37)(cid:16)(cid:34)(cid:33,,950.0
,,5,,,Unknown,,cid:12)(cid:29)(cid:26)(cid:41)(cid:25)(cid:2)(cid:53)(cid:53)(cid:37)(cid:16)(cid:34)(cid:33,,955.0
,,8,,,Unknown,,cid:12)(cid:29)(cid:26)(cid:41)(cid:25)(cid:2)(cid:53)(cid:53)(cid:37)(cid:16)(cid:34)(cid:33,,963.0
,,10,,,Unknown,,cid:12)(cid:29)(cid:26)(cid:41)(cid:25)(cid:2)(cid:53)(cid:53)(cid:37)(cid:16)(cid:34)(cid:33,,973.0
,,2,,,Unknown,,cid:12)(cid:29)(cid:26)(cid:41)(cid:25)(cid:2)(cid:53)(cid:53)(cid:37)(cid:16)(cid:34)(cid:33,,975.0
,,5,,,Unknown,,cid:12)(cid:29)(cid:26)(cid:41)(cid:25)(cid:2)(cid:53)(cid:53)(cid:37)(cid:16)(cid:34)(cid:33,,980.0
,,46,,,Unknown,,cid:12)(cid:29)(cid:26)(cid:41)(cid:25)(cid:2)(cid:53)(cid:53)(cid:37)(cid:16)(cid:34)(cid:33,,1026.0
,,47,,,Unknown,,cid:12)(cid:29)(cid:26)(cid:41)(cid:25)(cid:2)(cid:53)(cid:53)(cid:37)(cid:16)(cid:34)(cid:33,,1073.0
,,1,,,Unknown,,cid:12)(cid:29)(cid:26)(cid:41)(cid:25)(cid:2)(cid:53)(cid:53)(cid:37)(cid:16)(cid:34)(cid:33,,1074.0
,,34,,,Unknown,,cid:12)(cid:29)(cid:26)(cid:41)(cid:25)(cid:2)(cid:53)(cid:53)(cid:37)(cid:16)(cid:34)(cid:33,,1108.0
,,45,,,Unknown,,cid:12)(cid:29)(cid:26)(cid:41)(cid:25)(cid:2)(cid:53)(cid:53)(cid:37)(cid:16)(cid:34)(cid:33,,1153.0
,,18,,,Unknown,,cid:12)(cid:29)(cid:26)(cid:41)(cid:25)(cid:2)(cid:53)(cid:53)(cid:37)(cid:16)(cid:34)(cid:33,,1171.0
,,34,,,Unknown,,cid:12)(cid:29)(cid:26)(cid:41)(cid:25)(cid:2)(cid:53)(cid:53)(cid:37)(cid:16)(cid:34)(cid:33,,1205.0
,,62,,,Unknown,,cid:12)(cid:29)(cid:26)(cid:41)(cid:25)(cid:2)(cid:53)(cid:53)(cid:37)(cid:16)(cid:34)(cid:33,,1267.0
,,12,,,Unknown,,cid:12)(cid:29)(cid:26)(cid:41)(cid:25)(cid:2)(cid:53)(cid:53)(cid:37)(cid:16)(cid:34)(cid:33,,1279.0
,,2,,,Unknown,,cid:12)(cid:29)(cid:26)(cid:41)(cid:25)(cid:2)(cid:53)(cid:53)(cid:37)(cid:16)(cid:34)(cid:33,,1281.0
,,52,,,Unknown,,cid:12)(cid:29)(cid:26)(cid:41)(cid:25)(cid:2)(cid:53)(cid:53)(cid:37)(cid:16)(cid:34)(cid:33,,1333.0
,,11,,,Unknown,,cid:12)(cid:29)(cid:26)(cid:41)(cid:25)(cid:2)(cid:53)(cid:53)(cid:37)(cid:16)(cid:34)(cid:33,,1344.0
,,8,,,Unknown,,cid:12)(cid:29)(cid:26)(cid:41)(cid:25)(cid:2)(cid:53)(cid:53)(cid:37)(cid:16)(cid:34)(cid:33,,1352.0
,,49,,,Unknown,,cid:12)(cid:29)(cid:26)(cid:41)(cid:25)(cid:2)(cid:53)(cid:53)(cid:37)(cid:16)(cid:34)(cid:33,,1401.0
,,14,,,Unknown,,cid:12)(cid:29)(cid:26)(cid:41)(cid:25)(cid:2)(cid:53)(cid:53)(cid:37)(cid:16)(cid:34)(cid:33,,1415.0
,,52,,,Unknown,,cid:12)(cid:29)(cid:26)(cid:41)(cid:25)(cid:2)(cid:53)(cid:53)(cid:37)(cid:16)(cid:34)(cid:33,,1467.0
,,68,,,Unknown,,cid:12)(cid:29)(cid:26)(cid:41)(cid:25)(cid:2)(cid:53)(cid:53)(cid:37)(cid:16)(cid:34)(cid:33,,1535.0
,,9,,,Unknown,,cid:12)(cid:29)(cid:26)(cid:41)(cid:25)(cid:2)(cid:53)(cid:53)(cid:37)(cid:16)(cid:34)(cid:33,,1544.0
,,2,,,Unknown,,cid:12)(cid:29)(cid:26)(cid:41)(cid:25)(cid:2)(cid:53)(cid:53)(cid:37)(cid:16)(cid:34)(cid:33,,1546.0
,,12,,,Unknown,,cid:12)(cid:29)(cid:26)(cid:41)(cid:25)(cid:2)(cid:53)(cid:53)(cid:37)(cid:16)(cid:34)(cid:33,,1558.0
,,11,,,Unknown,,cid:12)(cid:29)(cid:26)(cid:41)(cid:25)(cid:2)(cid:53)(cid:53)(cid:37)(cid:16)(cid:34)(cid:33,,1569.0
,,4,,,Unknown,,cid:12)(cid:29)(cid:26)(cid:41)(cid:25)(cid:2)(cid:53)(cid:53)(cid:37)(cid:16)(cid:34)(cid:33,,1573.0
,,14,,,Unknown,,cid:12)(cid:29)(cid:26)(cid:41)(cid:25)(cid:2)(cid:53)(cid:53)(cid:37)(cid:16)(cid:34)(cid:33,,1587.0
,,11,,,Unknown,,cid:12)(cid:29)(cid:26)(cid:41)(cid:25)(cid:2)(cid:53)(cid:53)(cid:37)(cid:16)(cid:34)(cid:33,,1598.0
,,62,,,Unknown,,cid:12)(cid:29)(cid:26)(cid:41)(cid:25)(cid:2)(cid:53)(cid:53)(cid:37)(cid:16)(cid:34)(cid:33,,1660.0
,,62,,,Unknown,,cid:12)(cid:29)(cid:26)(cid:41)(cid:25)(cid:2)(cid:53)(cid:53)(cid:37)(cid:16)(cid:34)(cid:33,,1722.0
,,7,,,Unknown,,cid:12)(cid:29)(cid:26)(cid:41)(cid:25)(cid:2)(cid:53)(cid:53)(cid:37)(cid:16)(cid:34)(cid:33,,1729.0
,,5,,,Unknown,,cid:12)(cid:29)(cid:26)(cid:41)(cid:25)(cid:2)(cid:53)(cid:53)(cid:37)(cid:16)(cid:34)(cid:33,,1734.0
,,3,,,Unknown,,cid:12)(cid:29)(cid:26)(cid:41)(cid:25)(cid:2)(cid:53)(cid:53)(cid:37)(cid:16)(cid:34)(cid:33,,1737.0
,,2,,,Unknown,,cid:12)(cid:29)(cid:26)(cid:41)(cid:25)(cid:2)(cid:53)(cid:53)(cid:37)(cid:16)(cid:34)(cid:33,,1739.0
,,28,,,Unknown,,cid:12)(cid:29)(cid:26)(cid:41)(cid:25)(cid:2)(cid:53)(cid:53)(cid:37)(cid:16)(cid:34)(cid:33,,1767.0
,,3,,,Unknown,,cid:12)(cid:29)(cid:26)(cid:41)(cid:25)(cid:2)(cid:53)(cid:53)(cid:37)(cid:16)(cid:34)(cid:33,,1770.0
,,15,,,Unknown,,cid:12)(cid:29)(cid:26)(cid:41)(cid:25)(cid:2)(cid:53)(cid:53)(cid:37)(cid:16)(cid:34)(cid:33,,1785.0
,,2,,,Unknown,,cid:12)(cid:29)(cid:26)(cid:41)(cid:25)(cid:2)(cid:53)(cid:53)(cid:37)(cid:16)(cid:34)(cid:33,,1787.0
,,17,,,Unknown,,cid:12)(cid:29)(cid:26)(cid:41)(cid:25)(cid:2)(cid:53)(cid:53)(cid:37)(cid:16)(cid:34)(cid:33,,1804.0
,,36,,,Unknown,,cid:12)(cid:29)(cid:26)(cid:41)(cid:25)(cid:2)(cid:53)(cid:53)(cid:37)(cid:16)(cid:34)(cid:33,,1840.0
,,19,,,Unknown,,cid:12)(cid:29)(cid:26)(cid:41)(cid:25)(cid:2)(cid:53)(cid:53)(cid:37)(cid:16)(cid:34)(cid:33,,1859.0
,,36,,,Unknown,,cid:12)(cid:29)(cid:26)(cid:41)(cid:25)(cid:2)(cid:53)(cid:53)(cid:37)(cid:16)(cid:34)(cid:33,,1895.0
,,18,,,Unknown,,cid:12)(cid:29)(cid:26)(cid:41)(cid:25)(cid:2)(cid:53)(cid:53)(cid:37)(cid:16)(cid:34)(cid:33,,1913.0
,,2,,,Unknown,,cid:12)(cid:29)(cid:26)(cid:41)(cid:25)(cid:2)(cid:53)(cid:53)(cid:37)(cid:16)(cid:34)(cid:33,,1915.0
,,44,,,Unknown,,cid:12)(cid:29)(cid:26)(cid:41)(cid:25)(cid:2)(cid:53)(cid:53)(cid:37)(cid:16)(cid:34)(cid:33,,1959.0
,,12,,,Unknown,,cid:12)(cid:29)(cid:26)(cid:41)(cid:25)(cid:2)(cid:53)(cid:53)(cid:37)(cid:16)(cid:34)(cid:33,,1971.0
,,29,,,Unknown,,cid:12)(cid:29)(cid:26)(cid:41)(cid:25)(cid:2)(cid:53)(cid:53)(cid:37)(cid:16)(cid:34)(cid:33,,2000.0
,,26,,,Unknown,,cid:12)(cid:29)(cid:26)(cid:41)(cid:25)(cid:2)(cid:53)(cid:53)(cid:37)(cid:16)(cid:34)(cid:33,,2026.0
,,41,,,Unknown,,cid:12)(cid:29)(cid:26)(cid:41)(cid:25)(cid:2)(cid:53)(cid:53)(cid:37)(cid:16)(cid:34)(cid:33,,2067.0
,,25,,,Unknown,,cid:12)(cid:29)(cid:26)(cid:41)(cid:25)(cid:2)(cid:53)(cid:53)(cid:37)(cid:16)(cid:34)(cid:33,,2092.0
,,2,,,Unknown,,cid:12)(cid:29)(cid:26)(cid:41)(cid:25)(cid:2)(cid:53)(cid:53)(cid:37)(cid:16)(cid:34)(cid:33,,2094.0
,,53,,,Unknown,,cid:12)(cid:29)(cid:26)(cid:41)(cid:25)(cid:2)(cid:53)(cid:53)(cid:37)(cid:16)(cid:34)(cid:33,,2147.0
,,53,,,Unknown,,cid:12)(cid:29)(cid:26)(cid:41)(cid:25)(cid:2)(cid:53)(cid:53)(cid:37)(cid:16)(cid:34)(cid:33,,2200.0
,,37,,,Unknown,,cid:12)(cid:29)(cid:26)(cid:41)(cid:25)(cid:2)(cid:53)(cid:53)(cid:37)(cid:16)(cid:34)(cid:33,,2237.0
,,16,,,Unknown,,cid:12)(cid:29)(cid:26)(cid:41)(cid:25)(cid:2)(cid:53)(cid:53)(cid:37)(cid:16)(cid:34)(cid:33,,2253.0
,,34,,,Unknown,,cid:12)(cid:29)(cid:26)(cid:41)(cid:25)(cid:2)(cid:53)(cid:53)(cid:37)(cid:16)(cid:34)(cid:33,,2287.0
,,33,,,Unknown,,cid:12)(cid:29)(cid:26)(cid:41)(cid:25)(cid:2)(cid:53)(cid:53)(cid:37)(cid:16)(cid:34)(cid:33,,2320.0
,,1,,,Unknown,,cid:12)(cid:29)(cid:26)(cid:41)(cid:25)(cid:2)(cid:53)(cid:53)(cid:37)(cid:16)(cid:34)(cid:33,,2321.0
,,32,,,Unknown,,cid:12)(cid:29)(cid:26)(cid:41)(cid:25)(cid:2)(cid:53)(cid:53)(cid:37)(cid:16)(cid:34)(cid:33,,2353.0
,,45,,,Unknown,,cid:12)(cid:29)(cid:26)(cid:41)(cid:25)(cid:2)(cid:53)(cid:53)(cid:37)(cid:16)(cid:34)(cid:33,,2398.0
,,18,,,Unknown,,cid:12)(cid:29)(cid:26)(cid:41)(cid:25)(cid:2)(cid:53)(cid:53)(cid:37)(cid:16)(cid:34)(cid:33,,2416.0
,,34,,,Unknown,,cid:12)(cid:29)(cid:26)(cid:41)(cid:25)(cid:2)(cid:53)(cid:53)(cid:37)(cid:16)(cid:34)(cid:33,,2450.0
,,25,,,Unknown,,cid:12)(cid:29)(cid:26)(cid:41)(cid:25)(cid:2)(cid:53)(cid:53)(cid:37)(cid:16)(cid:34)(cid:33,,2475.0
,,21,,,Unknown,,cid:12)(cid:29)(cid:26)(cid:41)(cid:25)(cid:2)(cid:53)(cid:53)(cid:37)(cid:16)(cid:34)(cid:33,,2496.0
,,26,,,Unknown,,cid:12)(cid:29)(cid:26)(cid:41)(cid:25)(cid:2)(cid:53)(cid:53)(cid:37)(cid:16)(cid:34)(cid:33,,2522.0
,,22,,,Unknown,,cid:12)(cid:29)(cid:26)(cid:41)(cid:25)(cid:2)(cid:53)(cid:53)(cid:37)(cid:16)(cid:34)(cid:33,,2544.0
,,2,,,Unknown,,cid:12)(cid:29)(cid:26)(cid:41)(cid:25)(cid:2)(cid:53)(cid:53)(cid:37)(cid:16)(cid:34)(cid:33,,2546.0
,,69,,,Unknown,,cid:12)(cid:29)(cid:26)(cid:41)(cid:25)(cid:2)(cid:53)(cid:53)(cid:37)(cid:16)(cid:34)(cid:33,,2615.0
,,25,,,Unknown,,cid:12)(cid:29)(cid:26)(cid:41)(cid:25)(cid:2)(cid:53)(cid:53)(cid:37)(cid:16)(cid:34)(cid:33,,2640.0
,,70,,,Unknown,,cid:12)(cid:29)(cid:26)(cid:41)(cid:25)(cid:2)(cid:53)(cid:53)(cid:37)(cid:16)(cid:34)(cid:33,,2710.0
,,25,,,Unknown,,cid:12)(cid:29)(cid:26)(cid:41)(cid:25)(cid:2)(cid:53)(cid:53)(cid:37)(cid:16)(cid:34)(cid:33,,2735.0
,,69,,,Unknown,,cid:12)(cid:29)(cid:26)(cid:41)(cid:25)(cid:2)(cid:53)(cid:53)(cid:37)(cid:16)(cid:34)(cid:33,,2804.0
,,25,,,Unknown,,cid:12)(cid:29)(cid:26)(cid:41)(cid:25)(cid:2)(cid:53)(cid:53)(cid:37)(cid:16)(cid:34)(cid:33,,2829.0
,,30,,,Unknown,,cid:12)(cid:29)(cid:26)(cid:41)(cid:25)(cid:2)(cid:53)(cid:53)(cid:37)(cid:16)(cid:34)(cid:33,,2859.0
,,15,,,Unknown,,cid:12)(cid:29)(cid:26)(cid:41)(cid:25)(cid:2)(cid:53)(cid:53)(cid:37)(cid:16)(cid:34)(cid:33,,2874.0
,,2,,,Unknown,,cid:12)(cid:29)(cid:26)(cid:41)(cid:25)(cid:2)(cid:53)(cid:53)(cid:37)(cid:16)(cid:34)(cid:33,,2876.0
,,17,,,Unknown,,cid:12)(cid:29)(cid:26)(cid:41)(cid:25)(cid:2)(cid:53)(cid:53)(cid:37)(cid:16)(cid:34)(cid:33,,2893.0
,,2,,,Unknown,,cid:12)(cid:29)(cid:26)(cid:41)(cid:25)(cid:2)(cid:53)(cid:53)(cid:37)(cid:16)(cid:34)(cid:33,,2895.0
,,18,,,Unknown,,cid:12)(cid:29)(cid:26)(cid:41)(cid:25)(cid:2)(cid:53)(cid:53)(cid:37)(cid:16)(cid:34)(cid:33,,2913.0
,,32,,,Unknown,,cid:12)(cid:29)(cid:26)(cid:41)(cid:25)(cid:2)(cid:53)(cid:53)(cid:37)(cid:16)(cid:34)(cid:33,,2945.0
,,17,,,Unknown,,cid:12)(cid:29)(cid:26)(cid:41)(cid:25)(cid:2)(cid:53)(cid:53)(cid:37)(cid:16)(cid:34)(cid:33,,2962.0
,,19,,,Unknown,,cid:12)(cid:29)(cid:26)(cid:41)(cid:25)(cid:2)(cid:53)(cid:53)(cid:37)(cid:16)(cid:34)(cid:33,,2981.0
,,18,,,Unknown,,cid:12)(cid:29)(cid:26)(cid:41)(cid:25)(cid:2)(cid:53)(cid:53)(cid:37)(cid:16)(cid:34)(cid:33,,2999.0
,,1,,,Unknown,,cid:12)(cid:29)(cid:26)(cid:41)(cid:25)(cid:2)(cid:53)(cid:53)(cid:37)(cid:16)(cid:34)(cid:33,,3000.0
,,2,,,Unknown,,cid:12)(cid:29)(cid:26)(cid:41)(cid:25)(cid:2)(cid:53)(cid:53)(cid:37)(cid:16)(cid:34)(cid:33,,3002.0
,,44,,,Unknown,,cid:12)(cid:29)(cid:26)(cid:41)(cid:25)(cid:2)(cid:53)(cid:53)(cid:37)(cid:16)(cid:34)(cid:33,,3046.0
,,71,,,Unknown,,cid:12)(cid:29)(cid:26)(cid:41)(cid:25)(cid:2)(cid:53)(cid:53)(cid:37)(cid:16)(cid:34)(cid:33,,3117.0
,,29,,,Unknown,,cid:12)(cid:29)(cid:26)(cid:41)(cid:25)(cid:2)(cid:53)(cid:53)(cid:37)(cid:16)(cid:34)(cid:33,,3146.0
,,31,,,Unknown,,cid:12)(cid:29)(cid:26)(cid:41)(cid:25)(cid:2)(cid:53)(cid:53)(cid:37)(cid:16)(cid:34)(cid:33,,3177.0
,,41,,,Unknown,,cid:12)(cid:29)(cid:26)(cid:41)(cid:25)(cid:2)(cid:53)(cid:53)(cid:37)(cid:16)(cid:34)(cid:33,,3218.0
,,21,,,Unknown,,cid:12)(cid:29)(cid:26)(cid:41)(cid:25)(cid:2)(cid:53)(cid:53)(cid:37)(cid:16)(cid:34)(cid:33,,3239.0
,,26,,,Unknown,,cid:12)(cid:29)(cid:26)(cid:41)(cid:25)(cid:2)(cid:53)(cid:53)(cid:37)(cid:16)(cid:34)(cid:33,,3265.0
,,25,,,Unknown,,cid:12)(cid:29)(cid:26)(cid:41)(cid:25)(cid:2)(cid:53)(cid:53)(cid:37)(cid:16)(cid:34)(cid:33,,3290.0
,,2,,,Unknown,,cid:12)(cid:29)(cid:26)(cid:41)(cid:25)(cid:2)(cid:53)(cid:53)(cid:37)(cid:16)(cid:34)(cid:33,,3292.0
,,51,,,Unknown,,cid:12)(cid:29)(cid:26)(cid:41)(cid:25)(cid:2)(cid:53)(cid:53)(cid:37)(cid:16)(cid:34)(cid:33,,3343.0
,,25,,,Unknown,,cid:12)(cid:29)(cid:26)(cid:41)(cid:25)(cid:2)(cid:53)(cid:53)(cid:37)(cid:16)(cid:34)(cid:33,,3368.0
,,50,,,Unknown,,cid:12)(cid:29)(cid:26)(cid:41)(cid:25)(cid:2)(cid:53)(cid:53)(cid:37)(cid:16)(cid:34)(cid:33,,3418.0
,,29,,,Unknown,,cid:12)(cid:29)(cid:26)(cid:41)(cid:25)(cid:2)(cid:53)(cid:53)(cid:37)(cid:16)(cid:34)(cid:33,,3447.0
,,26,,,Unknown,,cid:12)(cid:29)(cid:26)(cid:41)(cid:25)(cid:2)(cid:53)(cid:53)(cid:37)(cid:16)(cid:34)(cid:33,,3473.0
,,51,,,Unknown,,cid:12)(cid:29)(cid:26)(cid:41)(cid:25)(cid:2)(cid:53)(cid:53)(cid:37)(cid:16)(cid:34)(cid:33,,3524.0
,,29,,,Unknown,,cid:12)(cid:29)(cid:26)(cid:41)(cid:25)(cid:2)(cid:53)(cid:53)(cid:37)(cid:16)(cid:34)(cid:33,,3553.0
,,69,,,Unknown,,cid:12)(cid:29)(cid:26)(cid:41)(cid:25)(cid:2)(cid:53)(cid:53)(cid:37)(cid:16)(cid:34)(cid:33,,3622.0
,,25,,,Unknown,,cid:12)(cid:29)(cid:26)(cid:41)(cid:25)(cid:2)(cid:53)(cid:53)(cid:37)(cid:16)(cid:34)(cid:33,,3647.0
,,1,,,Unknown,,cid:12)(cid:29)(cid:26)(cid:41)(cid:25)(cid:2)(cid:53)(cid:53)(cid:37)(cid:16)(cid:34)(cid:33,,3648.0
,,32,,,Unknown,,cid:12)(cid:29)(cid:26)(cid:41)(cid:25)(cid:2)(cid:53)(cid:53)(cid:37)(cid:16)(cid:34)(cid:33,,3680.0
,,45,,,Unknown,,cid:12)(cid:29)(cid:26)(cid:41)(cid:25)(cid:2)(cid:53)(cid:53)(cid:37)(cid:16)(cid:34)(cid:33,,3725.0
,,18,,,Unknown,,cid:12)(cid:29)(cid:26)(cid:41)(cid:25)(cid:2)(cid:53)(cid:53)(cid:37)(cid:16)(cid:34)(cid:33,,3743.0
,,34,,,Unknown,,cid:12)(cid:29)(cid:26)(cid:41)(cid:25)(cid:2)(cid:53)(cid:53)(cid:37)(cid:16)(cid:34)(cid:33,,3777.0
,,14,,,Unknown,,cid:12)(cid:29)(cid:26)(cid:41)(cid:25)(cid:2)(cid:53)(cid:53)(cid:37)(cid:16)(cid:34)(cid:33,,3791.0
,,5,,,Unknown,,cid:12)(cid:29)(cid:26)(cid:41)(cid:25)(cid:2)(cid:53)(cid:53)(cid:37)(cid:16)(cid:34)(cid:33,,3796.0
,,9,,,Unknown,,cid:12)(cid:29)(cid:26)(cid:41)(cid:25)(cid:2)(cid:53)(cid:53)(cid:37)(cid:16)(cid:34)(cid:33,,3805.0
,,2,,,Unknown,,cid:12)(cid:29)(cid:26)(cid:41)(cid:25)(cid:2)(cid:53)(cid:53)(cid:37)(cid:16)(cid:34)(cid:33,,3807.0
,,10,,,Unknown,,cid:12)(cid:29)(cid:26)(cid:41)(cid:25)(cid:2)(cid:53)(cid:53)(cid:37)(cid:16)(cid:34)(cid:33,,3817.0
,,5,,,Unknown,,cid:12)(cid:29)(cid:26)(cid:41)(cid:25)(cid:2)(cid:53)(cid:53)(cid:37)(cid:16)(cid:34)(cid:33,,3822.0
,,62,,,Unknown,,cid:12)(cid:29)(cid:26)(cid:41)(cid:25)(cid:2)(cid:53)(cid:53)(cid:37)(cid:16)(cid:34)(cid:33,,3884.0
,,39,,,Unknown,,cid:12)(cid:29)(cid:26)(cid:41)(cid:25)(cid:2)(cid:53)(cid:53)(cid:37)(cid:16)(cid:34)(cid:33,,3923.0
,,14,,,Unknown,,cid:12)(cid:29)(cid:26)(cid:41)(cid:25)(cid:2)(cid:53)(cid:53)(cid:37)(cid:16)(cid:34)(cid:33,,3937.0
,,7,,,Unknown,,cid:12)(cid:29)(cid:26)(cid:41)(cid:25)(cid:2)(cid:53)(cid:53)(cid:37)(cid:16)(cid:34)(cid:33,,3944.0
,,5,,,Unknown,,cid:12)(cid:29)(cid:26)(cid:41)(cid:25)(cid:2)(cid:53)(cid:53)(cid:37)(cid:16)(cid:34)(cid:33,,3949.0
,,3,,,Unknown,,cid:12)(cid:29)(cid:26)(cid:41)(cid:25)(cid:2)(cid:53)(cid:53)(cid:37)(cid:16)(cid:34)(cid:33,,3952.0
,,9,,,Unknown,,cid:12)(cid:29)(cid:26)(cid:41)(cid:25)(cid:2)(cid:53)(cid:53)(cid:37)(cid:16)(cid:34)(cid:33,,3961.0
,,2,,,Unknown,,cid:12)(cid:29)(cid:26)(cid:41)(cid:25)(cid:2)(cid:53)(cid:53)(cid:37)(cid:16)(cid:34)(cid:33,,3963.0
,,12,,,Unknown,,cid:12)(cid:29)(cid:26)(cid:41)(cid:25)(cid:2)(cid:53)(cid:53)(cid:37)(cid:16)(cid:34)(cid:33,,3975.0
,,11,,,Unknown,,cid:12)(cid:29)(cid:26)(cid:41)(cid:25)(cid:2)(cid:53)(cid:53)(cid:37)(cid:16)(cid:34)(cid:33,,3986.0
,,4,,,Unknown,,cid:12)(cid:29)(cid:26)(cid:41)(cid:25)(cid:2)(cid:53)(cid:53)(cid:37)(cid:16)(cid:34)(cid:33,,3990.0
,,14,,,Unknown,,cid:12)(cid:29)(cid:26)(cid:41)(cid:25)(cid:2)(cid:53)(cid:53)(cid:37)(cid:16)(cid:34)(cid:33,,4004.0
,,11,,,Unknown,,cid:12)(cid:29)(cid:26)(cid:41)(cid:25)(cid:2)(cid:53)(cid:53)(cid:37)(cid:16)(cid:34)(cid:33,,4015.0
,,62,,,Unknown,,cid:12)(cid:29)(cid:26)(cid:41)(cid:25)(cid:2)(cid:53)(cid:53)(cid:37)(cid:16)(cid:34)(cid:33,,4077.0
,,62,,,Unknown,,cid:12)(cid:29)(cid:26)(cid:41)(cid:25)(cid:2)(cid:53)(cid:53)(cid:37)(cid:16)(cid:34)(cid:33,,4139.0
,,7,,,Unknown,,cid:12)(cid:29)(cid:26)(cid:41)(cid:25)(cid:2)(cid:53)(cid:53)(cid:37)(cid:16)(cid:34)(cid:33,,4146.0
,,5,,,Unknown,,cid:12)(cid:29)(cid:26)(cid:41)(cid:25)(cid:2)(cid:53)(cid:53)(cid:37)(cid:16)(cid:34)(cid:33,,4151.0
,,3,,,Unknown,,cid:12)(cid:29)(cid:26)(cid:41)(cid:25)(cid:2)(cid:53)(cid:53)(cid:37)(cid:16)(cid:34)(cid:33,,4154.0
,,2,,,Unknown,,cid:12)(cid:29)(cid:26)(cid:41)(cid:25)(cid:2)(cid:53)(cid:53)(cid:37)(cid:16)(cid:34)(cid:33,,4156.0
,,28,,,Unknown,,cid:12)(cid:29)(cid:26)(cid:41)(cid:25)(cid:2)(cid:53)(cid:53)(cid:37)(cid:16)(cid:34)(cid:33,,4184.0
,,3,,,Unknown,,cid:12)(cid:29)(cid:26)(cid:41)(cid:25)(cid:2)(cid:53)(cid:53)(cid:37)(cid:16)(cid:34)(cid:33,,4187.0
,,15,,,Unknown,,cid:12)(cid:29)(cid:26)(cid:41)(cid:25)(cid:2)(cid:53)(cid:53)(cid:37)(cid:16)(cid:34)(cid:33,,4202.0
,,2,,,Unknown,,cid:12)(cid:29)(cid:26)(cid:41)(cid:25)(cid:2)(cid:53)(cid:53)(cid:37)(cid:16)(cid:34)(cid:33,,4204.0
,,37,,,Unknown,,cid:12)(cid:29)(cid:26)(cid:41)(cid:25)(cid:2)(cid:53)(cid:53)(cid:37)(cid:16)(cid:34)(cid:33,,4241.0
,,19,,,Unknown,,cid:12)(cid:29)(cid:26)(cid:41)(cid:25)(cid:2)(cid:53)(cid:53)(cid:37)(cid:16)(cid:34)(cid:33,,4260.0
,,35,,,Unknown,,cid:12)(cid:29)(cid:26)(cid:41)(cid:25)(cid:2)(cid:53)(cid:53)(cid:37)(cid:16)(cid:34)(cid:33,,4295.0
,,18,,,Unknown,,cid:12)(cid:29)(cid:26)(cid:41)(cid:25)(cid:2)(cid:53)(cid:53)(cid:37)(cid:16)(cid:34)(cid:33,,4313.0
,,2,,,Unknown,,cid:12)(cid:29)(cid:26)(cid:41)(cid:25)(cid:2)(cid:53)(cid:53)(cid:37)(cid:16)(cid:34)(cid:33,,4315.0
,,44,,,Unknown,,cid:12)(cid:29)(cid:26)(cid:41)(cid:25)(cid:2)(cid:53)(cid:53)(cid:37)(cid:16)(cid:34)(cid:33,,4359.0
,,12,,,Unknown,,cid:12)(cid:29)(cid:26)(cid:41)(cid:25)(cid:2)(cid:53)(cid:53)(cid:37)(cid:16)(cid:34)(cid:33,,4371.0
,,29,,,Unknown,,cid:12)(cid:29)(cid:26)(cid:41)(cid:25)(cid:2)(cid:53)(cid:53)(cid:37)(cid:16)(cid:34)(cid:33,,4400.0
,,26,,,Unknown,,cid:12)(cid:29)(cid:26)(cid:41)(cid:25)(cid:2)(cid:53)(cid:53)(cid:37)(cid:16)(cid:34)(cid:33,,4426.0
,,41,,,Unknown,,cid:12)(cid:29)(cid:26)(cid:41)(cid:25)(cid:2)(cid:53)(cid:53)(cid:37)(cid:16)(cid:34)(cid:33,,4467.0
,,25,,,Unknown,,cid:12)(cid:29)(cid:26)(cid:41)(cid:25)(cid:2)(cid:53)(cid:53)(cid:37)(cid:16)(cid:34)(cid:33,,4492.0
,,2,,,Unknown,,cid:12)(cid:29)(cid:26)(cid:41)(cid:25)(cid:2)(cid:53)(cid:53)(cid:37)(cid:16)(cid:34)(cid:33,,4494.0
,,53,,,Unknown,,cid:12)(cid:29)(cid:26)(cid:41)(cid:25)(cid:2)(cid:53)(cid:53)(cid:37)(cid:16)(cid:34)(cid:33,,4547.0
,,53,,,Unknown,,cid:12)(cid:29)(cid:26)(cid:41)(cid:25)(cid:2)(cid:53)(cid:53)(cid:37)(cid:16)(cid:34)(cid:33,,4600.0
,,37,,,Unknown,,cid:12)(cid:29)(cid:26)(cid:41)(cid:25)(cid:2)(cid:53)(cid:53)(cid:37)(cid:16)(cid:34)(cid:33,,4637.0
,,16,,,Unknown,,cid:12)(cid:29)(cid:26)(cid:41)(cid:25)(cid:2)(cid:53)(cid:53)(cid:37)(cid:16)(cid:34)(cid:33,,4653.0
,,34,,,Unknown,,cid:12)(cid:29)(cid:26)(cid:41)(cid:25)(cid:2)(cid:53)(cid:53)(cid:37)(cid:16)(cid:34)(cid:33,,4687.0
,,33,,,Unknown,,cid:12)(cid:29)(cid:26)(cid:41)(cid:25)(cid:2)(cid:53)(cid:53)(cid:37)(cid:16)(cid:34)(cid:33,,4720.0
,,1,,,Unknown,,cid:12)(cid:29)(cid:26)(cid:41)(cid:25)(cid:2)(cid:53)(cid:53)(cid:37)(cid:16)(cid:34)(cid:33,,4721.0
,,32,,,Unknown,,cid:12)(cid:29)(cid:26)(cid:41)(cid:25)(cid:2)(cid:53)(cid:53)(cid:37)(cid:16)(cid:34)(cid:33,,4753.0
,,45,,,Unknown,,cid:12)(cid:29)(cid:26)(cid:41)(cid:25)(cid:2)(cid:53)(cid:53)(cid:37)(cid:16)(cid:34)(cid:33,,4798.0
,,18,,,Unknown,,cid:12)(cid:29)(cid:26)(cid:41)(cid:25)(cid:2)(cid:53)(cid:53)(cid:37)(cid:16)(cid:34)(cid:33,,4816.0
,,34,,,Unknown,,cid:12)(cid:29)(cid:26)(cid:41)(cid:25)(cid:2)(cid:53)(cid:53)(cid:37)(cid:16)(cid:34)(cid:33,,4850.0
,,10,,,Unknown,,cid:12)(cid:29)(cid:26)(cid:41)(cid:25)(cid:2)(cid:53)(cid:53)(cid:37)(cid:16)(cid:34)(cid:33,,4860.0
,,11,,,Unknown,,cid:12)(cid:29)(cid:26)(cid:41)(cid:25)(cid:2)(cid:53)(cid:53)(cid:37)(cid:16)(cid:34)(cid:33,,4871.0
,,10,,,Unknown,,cid:12)(cid:29)(cid:26)(cid:41)(cid:25)(cid:2)(cid:53)(cid:53)(cid:37)(cid:16)(cid:34)(cid:33,,4881.0
,,49,,,Unknown,,cid:12)(cid:29)(cid:26)(cid:41)(cid:25)(cid:2)(cid:53)(cid:53)(cid:37)(cid:16)(cid:34)(cid:33,,4930.0
,,14,,,Unknown,,cid:12)(cid:29)(cid:26)(cid:41)(cid:25)(cid:2)(cid:53)(cid:53)(cid:37)(cid:16)(cid:34)(cid:33,,4944.0
,,2,,,Unknown,,cid:12)(cid:29)(cid:26)(cid:41)(cid:25)(cid:2)(cid:53)(cid:53)(cid:37)(cid:16)(cid:34)(cid:33,,4946.0
,,12,,,Unknown,,cid:12)(cid:29)(cid:26)(cid:41)(cid:25)(cid:2)(cid:53)(cid:53)(cid:37)(cid:16)(cid:34)(cid:33,,4958.0
,,11,,,Unknown,,cid:12)(cid:29)(cid:26)(cid:41)(cid:25)(cid:2)(cid:53)(cid:53)(cid:37)(cid:16)(cid:34)(cid:33,,4969.0
,,4,,,Unknown,,cid:12)(cid:29)(cid:26)(cid:41)(cid:25)(cid:2)(cid:53)(cid:53)(cid:37)(cid:16)(cid:34)(cid:33,,4973.0
,,14,,,Unknown,,cid:12)(cid:29)(cid:26)(cid:41)(cid:25)(cid:2)(cid:53)(cid:53)(cid:37)(cid:16)(cid:34)(cid:33,,4987.0
,,11,,,Unknown,,cid:12)(cid:29)(cid:26)(cid:41)(cid:25)(cid:2)(cid:53)(cid:53)(cid:37)(cid:16)(cid:34)(cid:33,,4998.0
,,62,,,Unknown,,cid:12)(cid:29)(cid:26)(cid:41)(cid:25)(cid:2)(cid:53)(cid:53)(cid:37)(cid:16)(cid:34)(cid:33,,5060.0
,,62,,,Unknown,,cid:12)(cid:29)(cid:26)(cid:41)(cid:25)(cid:2)(cid:53)(cid:53)(cid:37)(cid:16)(cid:34)(cid:33,,5122.0
,,7,,,Unknown,,cid:12)(cid:29)(cid:26)(cid:41)(cid:25)(cid:2)(cid:53)(cid:53)(cid:37)(cid:16)(cid:34)(cid:33,,5129.0
,,5,,,Unknown,,cid:12)(cid:29)(cid:26)(cid:41)(cid:25)(cid:2)(cid:53)(cid:53)(cid:37)(cid:16)(cid:34)(cid:33,,5134.0
,,3,,,Unknown,,cid:12)(cid:29)(cid:26)(cid:41)(cid:25)(cid:2)(cid:53)(cid:53)(cid:37)(cid:16)(cid:34)(cid:33,,5137.0
,,9,,,Unknown,,cid:12)(cid:29)(cid:26)(cid:41)(cid:25)(cid:2)(cid:53)(cid:53)(cid:37)(cid:16)(cid:34)(cid:33,,5146.0
,,2,,,Unknown,,cid:12)(cid:29)(cid:26)(cid:41)(cid:25)(cid:2)(cid:53)(cid:53)(cid:37)(cid:16)(cid:34)(cid:33,,5148.0
,,28,,,Unknown,,cid:12)(cid:29)(cid:26)(cid:41)(cid:25)(cid:2)(cid:53)(cid:53)(cid:37)(cid:16)(cid:34)(cid:33,,5176.0
,,3,,,Unknown,,cid:12)(cid:29)(cid:26)(cid:41)(cid:25)(cid:2)(cid:53)(cid:53)(cid:37)(cid:16)(cid:34)(cid:33,,5179.0
,,15,,,Unknown,,cid:12)(cid:29)(cid:26)(cid:41)(cid:25)(cid:2)(cid:53)(cid:53)(cid:37)(cid:16)(cid:34)(cid:33,,5194.0
,,2,,,Unknown,,cid:12)(cid:29)(cid:26)(cid:41)(cid:25)(cid:2)(cid:53)(cid:53)(cid:37)(cid:16)(cid:34)(cid:33,,5196.0
,,33,,,Unknown,,cid:12)(cid:29)(cid:26)(cid:41)(cid:25)(cid:2)(cid:53)(cid:53)(cid:37)(cid:16)(cid:34)(cid:33,,5229.0
,,36,,,Unknown,,cid:12)(cid:29)(cid:26)(cid:41)(cid:25)(cid:2)(cid:53)(cid:53)(cid:37)(cid:16)(cid:34)(cid:33,,5265.0
,,19,,,Unknown,,cid:12)(cid:29)(cid:26)(cid:41)(cid:25)(cid:2)(cid:53)(cid:53)(cid:37)(cid:16)(cid:34)(cid:33,,5284.0
,,18,,,Unknown,,cid:12)(cid:29)(cid:26)(cid:41)(cid:25)(cid:2)(cid:53)(cid:53)(cid:37)(cid:16)(cid:34)(cid:33,,5302.0
,,18,,,Unknown,,cid:12)(cid:29)(cid:26)(cid:41)(cid:25)(cid:2)(cid:53)(cid:53)(cid:37)(cid:16)(cid:34)(cid:33,,5320.0
,,2,,,Unknown,,cid:12)(cid:29)(cid:26)(cid:41)(cid:25)(cid:2)(cid:53)(cid:53)(cid:37)(cid:16)(cid:34)(cid:33,,5322.0
,,44,,,Unknown,,cid:12)(cid:29)(cid:26)(cid:41)(cid:25)(cid:2)(cid:53)(cid:53)(cid:37)(cid:16)(cid:34)(cid:33,,5366.0
,,12,,,Unknown,,cid:12)(cid:29)(cid:26)(cid:41)(cid:25)(cid:2)(cid:53)(cid:53)(cid:37)(cid:16)(cid:34)(cid:33,,5378.0
,,29,,,Unknown,,cid:12)(cid:29)(cid:26)(cid:41)(cid:25)(cid:2)(cid:53)(cid:53)(cid:37)(cid:16)(cid:34)(cid:33,,5407.0
,,26,,,Unknown,,cid:12)(cid:29)(cid:26)(cid:41)(cid:25)(cid:2)(cid:53)(cid:53)(cid:37)(cid:16)(cid:34)(cid:33,,5433.0
,,41,,,Unknown,,cid:12)(cid:29)(cid:26)(cid:41)(cid:25)(cid:2)(cid:53)(cid:53)(cid:37)(cid:16)(cid:34)(cid:33,,5474.0
,,25,,,Unknown,,cid:12)(cid:29)(cid:26)(cid:41)(cid:25)(cid:2)(cid:53)(cid:53)(cid:37)(cid:16)(cid:34)(cid:33,,5499.0
,,2,,,Unknown,,cid:12)(cid:29)(cid:26)(cid:41)(cid:25)(cid:2)(cid:53)(cid:53)(cid:37)(cid:16)(cid:34)(cid:33,,5501.0
,,53,,,Unknown,,cid:12)(cid:29)(cid:26)(cid:41)(cid:25)(cid:2)(cid:53)(cid:53)(cid:37)(cid:16)(cid:34)(cid:33,,5554.0
,,53,,,Unknown,,cid:12)(cid:29)(cid:26)(cid:41)(cid:25)(cid:2)(cid:53)(cid:53)(cid:37)(cid:16)(cid:34)(cid:33,,5607.0
,,18,,,Unknown,,cid:12)(cid:29)(cid:26)(cid:41)(cid:25)(cid:2)(cid:53)(cid:53)(cid:37)(cid:16)(cid:34)(cid:33,,5625.0
,,1,,,Unknown,,cid:12)(cid:29)(cid:26)(cid:41)(cid:25)(cid:2)(cid:53)(cid:53)(cid:37)(cid:16)(cid:34)(cid:33,,5626.0
,,1,,,Unknown,,cid:12)(cid:29)(cid:26)(cid:41)(cid:25)(cid:2)(cid:53)(cid:53)(cid:37)(cid:16)(cid:34)(cid:33,,5627.0
,,37,,,Unknown,,cid:12)(cid:29)(cid:26)(cid:41)(cid:25)(cid:2)(cid:53)(cid:53)(cid:37)(cid:16)(cid:34)(cid:33,,5664.0
,,1,,,Unknown,,cid:12)(cid:29)(cid:26)(cid:41)(cid:25)(cid:2)(cid:53)(cid:53)(cid:37)(cid:16)(cid:34)(cid:33,,5665.0
,,16,,,Unknown,,cid:12)(cid:29)(cid:26)(cid:41)(cid:25)(cid:2)(cid:53)(cid:53)(cid:37)(cid:16)(cid:34)(cid:33,,5681.0
,,45,,,Unknown,,cid:12)(cid:29)(cid:26)(cid:41)(cid:25)(cid:2)(cid:53)(cid:53)(cid:37)(cid:16)(cid:34)(cid:33,,5726.0
,,18,,,Unknown,,cid:12)(cid:29)(cid:26)(cid:41)(cid:25)(cid:2)(cid:53)(cid:53)(cid:37)(cid:16)(cid:34)(cid:33,,5744.0
,,34,,,Unknown,,cid:12)(cid:29)(cid:26)(cid:41)(cid:25)(cid:2)(cid:53)(cid:53)(cid:37)(cid:16)(cid:34)(cid:33,,5778.0
,,12,,,Unknown,,cid:12)(cid:29)(cid:26)(cid:41)(cid:25)(cid:2)(cid:53)(cid:53)(cid:37)(cid:16)(cid:34)(cid:33,,5790.0
,,11,,,Unknown,,cid:12)(cid:29)(cid:26)(cid:41)(cid:25)(cid:2)(cid:53)(cid:53)(cid:37)(cid:16)(cid:34)(cid:33,,5801.0
,,8,,,Unknown,,cid:12)(cid:29)(cid:26)(cid:41)(cid:25)(cid:2)(cid:53)(cid:53)(cid:37)(cid:16)(cid:34)(cid:33,,5809.0
,,28,,,Unknown,,cid:12)(cid:29)(cid:26)(cid:41)(cid:25)(cid:2)(cid:53)(cid:53)(cid:37)(cid:16)(cid:34)(cid:33,,5837.0
,,11,,,Unknown,,cid:12)(cid:29)(cid:26)(cid:41)(cid:25)(cid:2)(cid:53)(cid:53)(cid:37)(cid:16)(cid:34)(cid:33,,5848.0
,,3,,,Unknown,,cid:12)(cid:29)(cid:26)(cid:41)(cid:25)(cid:2)(cid:53)(cid:53)(cid:37)(cid:16)(cid:34)(cid:33,,5851.0
,,49,,,Unknown,,cid:12)(cid:29)(cid:26)(cid:41)(cid:25)(cid:2)(cid:53)(cid:53)(cid:37)(cid:16)(cid:34)(cid:33,,5900.0
,,62,,,Unknown,,cid:12)(cid:29)(cid:26)(cid:41)(cid:25)(cid:2)(cid:53)(cid:53)(cid:37)(cid:16)(cid:34)(cid:33,,5962.0
,,49,,,Unknown,,cid:12)(cid:29)(cid:26)(cid:41)(cid:25)(cid:2)(cid:53)(cid:53)(cid:37)(cid:16)(cid:34)(cid:33,,6011.0
,,2,,,Unknown,,cid:12)(cid:29)(cid:26)(cid:41)(cid:25)(cid:2)(cid:53)(cid:53)(cid:37)(cid:16)(cid:34)(cid:33,,6013.0
,,8,,,Unknown,,cid:12)(cid:29)(cid:26)(cid:41)(cid:25)(cid:2)(cid:53)(cid:53)(cid:37)(cid:16)(cid:34)(cid:33,,6021.0
,,49,,,Unknown,,cid:12)(cid:29)(cid:26)(cid:41)(cid:25)(cid:2)(cid:53)(cid:53)(cid:37)(cid:16)(cid:34)(cid:33,,6070.0
,,8,,,Unknown,,cid:12)(cid:29)(cid:26)(cid:41)(cid:25)(cid:2)(cid:53)(cid:53)(cid:37)(cid:16)(cid:34)(cid:33,,6078.0
,,10,,,Unknown,,cid:12)(cid:29)(cid:26)(cid:41)(cid:25)(cid:2)(cid:53)(cid:53)(cid:37)(cid:16)(cid:34)(cid:33,,6088.0
,,5,,,Unknown,,cid:12)(cid:29)(cid:26)(cid:41)(cid:25)(cid:2)(cid:53)(cid:53)(cid:37)(cid:16)(cid:34)(cid:33,,6093.0
,,4,,,Unknown,,cid:12)(cid:29)(cid:26)(cid:41)(cid:25)(cid:2)(cid:53)(cid:53)(cid:37)(cid:16)(cid:34)(cid:33,,6097.0
,,7,,,Unknown,,cid:12)(cid:29)(cid:26)(cid:41)(cid:25)(cid:2)(cid:53)(cid:53)(cid:37)(cid:16)(cid:34)(cid:33,,6104.0
,,14,,,Unknown,,cid:12)(cid:29)(cid:26)(cid:41)(cid:25)(cid:2)(cid:53)(cid:53)(cid:37)(cid:16)(cid:34)(cid:33,,6118.0
,,2,,,Unknown,,cid:12)(cid:29)(cid:26)(cid:41)(cid:25)(cid:2)(cid:53)(cid:53)(cid:37)(cid:16)(cid:34)(cid:33,,6120.0
,,14,,,Unknown,,cid:12)(cid:29)(cid:26)(cid:41)(cid:25)(cid:2)(cid:53)(cid:53)(cid:37)(cid:16)(cid:34)(cid:33,,6134.0
,,2,,,Unknown,,cid:12)(cid:29)(cid:26)(cid:41)(cid:25)(cid:2)(cid:53)(cid:53)(cid:37)(cid:16)(cid:34)(cid:33,,6136.0
,,28,,,Unknown,,cid:12)(cid:29)(cid:26)(cid:41)(cid:25)(cid:2)(cid:53)(cid:53)(cid:37)(cid:16)(cid:34)(cid:33,,6164.0
,,3,,,Unknown,,cid:12)(cid:29)(cid:26)(cid:41)(cid:25)(cid:2)(cid:53)(cid:53)(cid:37)(cid:16)(cid:34)(cid:33,,6167.0
,,15,,,Unknown,,cid:12)(cid:29)(cid:26)(cid:41)(cid:25)(cid:2)(cid:53)(cid:53)(cid:37)(cid:16)(cid:34)(cid:33,,6182.0
,,2,,,Unknown,,cid:12)(cid:29)(cid:26)(cid:41)(cid:25)(cid:2)(cid:53)(cid:53)(cid:37)(cid:16)(cid:34)(cid:33,,6184.0
,,34,,,Unknown,,cid:12)(cid:29)(cid:26)(cid:41)(cid:25)(cid:2)(cid:53)(cid:53)(cid:37)(cid:16)(cid:34)(cid:33,,6218.0
,,33,,,Unknown,,cid:12)(cid:29)(cid:26)(cid:41)(cid:25)(cid:2)(cid:53)(cid:53)(cid:37)(cid:16)(cid:34)(cid:33,,6251.0
,,33,,,Unknown,,cid:12)(cid:29)(cid:26)(cid:41)(cid:25)(cid:2)(cid:53)(cid:53)(cid:37)(cid:16)(cid:34)(cid:33,,6284.0
,,19,,,Unknown,,cid:12)(cid:29)(cid:26)(cid:41)(cid:25)(cid:2)(cid:53)(cid:53)(cid:37)(cid:16)(cid:34)(cid:33,,6303.0
,,34,,,Unknown,,cid:12)(cid:29)(cid:26)(cid:41)(cid:25)(cid:2)(cid:53)(cid:53)(cid:37)(cid:16)(cid:34)(cid:33,,6337.0
,,34,,,Unknown,,cid:12)(cid:29)(cid:26)(cid:41)(cid:25)(cid:2)(cid:53)(cid:53)(cid:37)(cid:16)(cid:34)(cid:33,,6371.0
,,2,,,Unknown,,cid:12)(cid:29)(cid:26)(cid:41)(cid:25)(cid:2)(cid:53)(cid:53)(cid:37)(cid:16)(cid:34)(cid:33,,6373.0
,,44,,,Unknown,,cid:12)(cid:29)(cid:26)(cid:41)(cid:25)(cid:2)(cid:53)(cid:53)(cid:37)(cid:16)(cid:34)(cid:33,,6417.0
,,12,,,Unknown,,cid:12)(cid:29)(cid:26)(cid:41)(cid:25)(cid:2)(cid:53)(cid:53)(cid:37)(cid:16)(cid:34)(cid:33,,6429.0
,,29,,,Unknown,,cid:12)(cid:29)(cid:26)(cid:41)(cid:25)(cid:2)(cid:53)(cid:53)(cid:37)(cid:16)(cid:34)(cid:33,,6458.0
,,26,,,Unknown,,cid:12)(cid:29)(cid:26)(cid:41)(cid:25)(cid:2)(cid:53)(cid:53)(cid:37)(cid:16)(cid:34)(cid:33,,6484.0
,,41,,,Unknown,,cid:12)(cid:29)(cid:26)(cid:41)(cid:25)(cid:2)(cid:53)(cid:53)(cid:37)(cid:16)(cid:34)(cid:33,,6525.0
,,25,,,Unknown,,cid:12)(cid:29)(cid:26)(cid:41)(cid:25)(cid:2)(cid:53)(cid:53)(cid:37)(cid:16)(cid:34)(cid:33,,6550.0
,,2,,,Unknown,,cid:12)(cid:29)(cid:26)(cid:41)(cid:25)(cid:2)(cid:53)(cid:53)(cid:37)(cid:16)(cid:34)(cid:33,,6552.0
,,53,,,Unknown,,cid:12)(cid:29)(cid:26)(cid:41)(cid:25)(cid:2)(cid:53)(cid:53)(cid:37)(cid:16)(cid:34)(cid:33,,6605.0
,,53,,,Unknown,,cid:12)(cid:29)(cid:26)(cid:41)(cid:25)(cid:2)(cid:53)(cid:53)(cid:37)(cid:16)(cid:34)(cid:33,,6658.0
,,18,,,Unknown,,cid:12)(cid:29)(cid:26)(cid:41)(cid:25)(cid:2)(cid:53)(cid:53)(cid:37)(cid:16)(cid:34)(cid:33,,6676.0
,,1,,,Unknown,,cid:12)(cid:29)(cid:26)(cid:41)(cid:25)(cid:2)(cid:53)(cid:53)(cid:37)(cid:16)(cid:34)(cid:33,,6677.0
,,1,,,Unknown,,cid:12)(cid:29)(cid:26)(cid:41)(cid:25)(cid:2)(cid:53)(cid:53)(cid:37)(cid:16)(cid:34)(cid:33,,6678.0
,,37,,,Unknown,,cid:12)(cid:29)(cid:26)(cid:41)(cid:25)(cid:2)(cid:53)(cid:53)(cid:37)(cid:16)(cid:34)(cid:33,,6715.0
,,1,,,Unknown,,cid:12)(cid:29)(cid:26)(cid:41)(cid:25)(cid:2)(cid:53)(cid:53)(cid:37)(cid:16)(cid:34)(cid:33,,6716.0
,,16,,,Unknown,,cid:12)(cid:29)(cid:26)(cid:41)(cid:25)(cid:2)(cid:53)(cid:53)(cid:37)(cid:16)(cid:34)(cid:33,,6732.0
,,45,,,Unknown,,cid:12)(cid:29)(cid:26)(cid:41)(cid:25)(cid:2)(cid:53)(cid:53)(cid:37)(cid:16)(cid:34)(cid:33,,6777.0
,,18,,,Unknown,,cid:12)(cid:29)(cid:26)(cid:41)(cid:25)(cid:2)(cid:53)(cid:53)(cid:37)(cid:16)(cid:34)(cid:33,,6795.0
,,34,,,Unknown,,cid:12)(cid:29)(cid:26)(cid:41)(cid:25)(cid:2)(cid:53)(cid:53)(cid:37)(cid:16)(cid:34)(cid:33,,6829.0
,,11,,,Unknown,,cid:12)(cid:29)(cid:26)(cid:41)(cid:25)(cid:2)(cid:53)(cid:53)(cid:37)(cid:16)(cid:34)(cid:33,,6840.0
,,3,,,Unknown,,cid:12)(cid:29)(cid:26)(cid:41)(cid:25)(cid:2)(cid:53)(cid:53)(cid:37)(cid:16)(cid:34)(cid:33,,6843.0
,,49,,,Unknown,,cid:12)(cid:29)(cid:26)(cid:41)(cid:25)(cid:2)(cid:53)(cid:53)(cid:37)(cid:16)(cid:34)(cid:33,,6892.0
,,8,,,Unknown,,cid:12)(cid:29)(cid:26)(cid:41)(cid:25)(cid:2)(cid:53)(cid:53)(cid:37)(cid:16)(cid:34)(cid:33,,6900.0
,,46,,,Unknown,,cid:12)(cid:29)(cid:26)(cid:41)(cid:25)(cid:2)(cid:53)(cid:53)(cid:37)(cid:16)(cid:34)(cid:33,,6946.0
,,5,,,Unknown,,cid:12)(cid:29)(cid:26)(cid:41)(cid:25)(cid:2)(cid:53)(cid:53)(cid:37)(cid:16)(cid:34)(cid:33,,6951.0
,,2,,,Unknown,,cid:12)(cid:29)(cid:26)(cid:41)(cid:25)(cid:2)(cid:53)(cid:53)(cid:37)(cid:16)(cid:34)(cid:33,,6953.0
,,28,,,Unknown,,cid:12)(cid:29)(cid:26)(cid:41)(cid:25)(cid:2)(cid:53)(cid:53)(cid:37)(cid:16)(cid:34)(cid:33,,6981.0
,,49,,,Unknown,,cid:12)(cid:29)(cid:26)(cid:41)(cid:25)(cid:2)(cid:53)(cid:53)(cid:37)(cid:16)(cid:34)(cid:33,,7030.0
,,12,,,Unknown,,cid:12)(cid:29)(cid:26)(cid:41)(cid:25)(cid:2)(cid:53)(cid:53)(cid:37)(cid:16)(cid:34)(cid:33,,7042.0
,,10,,,Unknown,,cid:12)(cid:29)(cid:26)(cid:41)(cid:25)(cid:2)(cid:53)(cid:53)(cid:37)(cid:16)(cid:34)(cid:33,,7052.0
,,2,,,Unknown,,cid:12)(cid:29)(cid:26)(cid:41)(cid:25)(cid:2)(cid:53)(cid:53)(cid:37)(cid:16)(cid:34)(cid:33,,7054.0
,,16,,,Unknown,,cid:12)(cid:29)(cid:26)(cid:41)(cid:25)(cid:2)(cid:53)(cid:53)(cid:37)(cid:16)(cid:34)(cid:33,,7070.0
,,36,,,Unknown,,cid:12)(cid:29)(cid:26)(cid:41)(cid:25)(cid:2)(cid:53)(cid:53)(cid:37)(cid:16)(cid:34)(cid:33,,7106.0
,,2,,,Unknown,,cid:12)(cid:29)(cid:26)(cid:41)(cid:25)(cid:2)(cid:53)(cid:53)(cid:37)(cid:16)(cid:34)(cid:33,,7108.0
,,39,,,Unknown,,cid:12)(cid:29)(cid:26)(cid:41)(cid:25)(cid:2)(cid:53)(cid:53)(cid:37)(cid:16)(cid:34)(cid:33,,7147.0
,,49,,,Unknown,,cid:12)(cid:29)(cid:26)(cid:41)(cid:25)(cid:2)(cid:53)(cid:53)(cid:37)(cid:16)(cid:34)(cid:33,,7196.0
,,3,,,Unknown,,cid:12)(cid:29)(cid:26)(cid:41)(cid:25)(cid:2)(cid:53)(cid:53)(cid:37)(cid:16)(cid:34)(cid:33,,7199.0
,,7,,,Unknown,,cid:12)(cid:29)(cid:26)(cid:41)(cid:25)(cid:2)(cid:53)(cid:53)(cid:37)(cid:16)(cid:34)(cid:33,,7206.0
,,9,,,Unknown,,cid:12)(cid:29)(cid:26)(cid:41)(cid:25)(cid:2)(cid:53)(cid:53)(cid:37)(cid:16)(cid:34)(cid:33,,7215.0
,,2,,,Unknown,,cid:12)(cid:29)(cid:26)(cid:41)(cid:25)(cid:2)(cid:53)(cid:53)(cid:37)(cid:16)(cid:34)(cid:33,,7217.0
,,28,,,Unknown,,cid:12)(cid:29)(cid:26)(cid:41)(cid:25)(cid:2)(cid:53)(cid:53)(cid:37)(cid:16)(cid:34)(cid:33,,7245.0
,,3,,,Unknown,,cid:12)(cid:29)(cid:26)(cid:41)(cid:25)(cid:2)(cid:53)(cid:53)(cid:37)(cid:16)(cid:34)(cid:33,,7248.0
,,15,,,Unknown,,cid:12)(cid:29)(cid:26)(cid:41)(cid:25)(cid:2)(cid:53)(cid:53)(cid:37)(cid:16)(cid:34)(cid:33,,7263.0
,,2,,,Unknown,,cid:12)(cid:29)(cid:26)(cid:41)(cid:25)(cid:2)(cid:53)(cid:53)(cid:37)(cid:16)(cid:34)(cid:33,,7265.0
,,32,,,Unknown,,cid:12)(cid:29)(cid:26)(cid:41)(cid:25)(cid:2)(cid:53)(cid:53)(cid:37)(cid:16)(cid:34)(cid:33,,7297.0
,,36,,,Unknown,,cid:12)(cid:29)(cid:26)(cid:41)(cid:25)(cid:2)(cid:53)(cid:53)(cid:37)(cid:16)(cid:34)(cid:33,,7333.0
,,19,,,Unknown,,cid:12)(cid:29)(cid:26)(cid:41)(cid:25)(cid:2)(cid:53)(cid:53)(cid:37)(cid:16)(cid:34)(cid:33,,7352.0
,,33,,,Unknown,,cid:12)(cid:29)(cid:26)(cid:41)(cid:25)(cid:2)(cid:53)(cid:53)(cid:37)(cid:16)(cid:34)(cid:33,,7385.0
,,33,,,Unknown,,cid:12)(cid:29)(cid:26)(cid:41)(cid:25)(cid:2)(cid:53)(cid:53)(cid:37)(cid:16)(cid:34)(cid:33,,7418.0
,,2,,,Unknown,,cid:12)(cid:29)(cid:26)(cid:41)(cid:25)(cid:2)(cid:53)(cid:53)(cid:37)(cid:16)(cid:34)(cid:33,,7420.0
,,44,,,Unknown,,cid:12)(cid:29)(cid:26)(cid:41)(cid:25)(cid:2)(cid:53)(cid:53)(cid:37)(cid:16)(cid:34)(cid:33,,7464.0
,,12,,,Unknown,,cid:12)(cid:29)(cid:26)(cid:41)(cid:25)(cid:2)(cid:53)(cid:53)(cid:37)(cid:16)(cid:34)(cid:33,,7476.0
,,29,,,Unknown,,cid:12)(cid:29)(cid:26)(cid:41)(cid:25)(cid:2)(cid:53)(cid:53)(cid:37)(cid:16)(cid:34)(cid:33,,7505.0
,,26,,,Unknown,,cid:12)(cid:29)(cid:26)(cid:41)(cid:25)(cid:2)(cid:53)(cid:53)(cid:37)(cid:16)(cid:34)(cid:33,,7531.0
,,41,,,Unknown,,cid:12)(cid:29)(cid:26)(cid:41)(cid:25)(cid:2)(cid:53)(cid:53)(cid:37)(cid:16)(cid:34)(cid:33,,7572.0
,,25,,,Unknown,,cid:12)(cid:29)(cid:26)(cid:41)(cid:25)(cid:2)(cid:53)(cid:53)(cid:37)(cid:16)(cid:34)(cid:33,,7597.0
,,2,,,Unknown,,cid:12)(cid:29)(cid:26)(cid:41)(cid:25)(cid:2)(cid:53)(cid:53)(cid:37)(cid:16)(cid:34)(cid:33,,7599.0
,,53,,,Unknown,,cid:12)(cid:29)(cid:26)(cid:41)(cid:25)(cid:2)(cid:53)(cid:53)(cid:37)(cid:16)(cid:34)(cid:33,,7652.0
,,53,,,Unknown,,cid:12)(cid:29)(cid:26)(cid:41)(cid:25)(cid:2)(cid:53)(cid:53)(cid:37)(cid:16)(cid:34)(cid:33,,7705.0
,,37,,,Unknown,,cid:12)(cid:29)(cid:26)(cid:41)(cid:25)(cid:2)(cid:53)(cid:53)(cid:37)(cid:16)(cid:34)(cid:33,,7742.0
,,16,,,Unknown,,cid:12)(cid:29)(cid:26)(cid:41)(cid:25)(cid:2)(cid:53)(cid:53)(cid:37)(cid:16)(cid:34)(cid:33,,7758.0
,,34,,,Unknown,,cid:12)(cid:29)(cid:26)(cid:41)(cid:25)(cid:2)(cid:53)(cid:53)(cid:37)(cid:16)(cid:34)(cid:33,,7792.0
,,33,,,Unknown,,cid:12)(cid:29)(cid:26)(cid:41)(cid:25)(cid:2)(cid:53)(cid:53)(cid:37)(cid:16)(cid:34)(cid:33,,7825.0
,,1,,,Unknown,,cid:12)(cid:29)(cid:26)(cid:41)(cid:25)(cid:2)(cid:53)(cid:53)(cid:37)(cid:16)(cid:34)(cid:33,,7826.0
,,16,,,Unknown,,cid:12)(cid:29)(cid:26)(cid:41)(cid:25)(cid:2)(cid:53)(cid:53)(cid:37)(cid:16)(cid:34)(cid:33,,7842.0
,,45,,,Unknown,,cid:12)(cid:29)(cid:26)(cid:41)(cid:25)(cid:2)(cid:53)(cid:53)(cid:37)(cid:16)(cid:34)(cid:33,,7887.0
,,18,,,Unknown,,cid:12)(cid:29)(cid:26)(cid:41)(cid:25)(cid:2)(cid:53)(cid:53)(cid:37)(cid:16)(cid:34)(cid:33,,7905.0
,,34,,,Unknown,,cid:12)(cid:29)(cid:26)(cid:41)(cid:25)(cid:2)(cid:53)(cid:53)(cid:37)(cid:16)(cid:34)(cid:33,,7939.0
,,49,,,Unknown,,cid:12)(cid:29)(cid:26)(cid:41)(cid:25)(cid:2)(cid:53)(cid:53)(cid:37)(cid:16)(cid:34)(cid:33,,7988.0
,,52,,,Unknown,,cid:12)(cid:29)(cid:26)(cid:41)(cid:25)(cid:2)(cid:53)(cid:53)(cid:37)(cid:16)(cid:34)(cid:33,,8040.0
,,2,,,Unknown,,cid:12)(cid:29)(cid:26)(cid:41)(cid:25)(cid:2)(cid:53)(cid:53)(cid:37)(cid:16)(cid:34)(cid:33,,8042.0
,,47,,,Unknown,,cid:12)(cid:29)(cid:26)(cid:41)(cid:25)(cid:2)(cid:53)(cid:53)(cid:37)(cid:16)(cid:34)(cid:33,,8089.0
,,39,,,Unknown,,cid:12)(cid:29)(cid:26)(cid:41)(cid:25)(cid:2)(cid:53)(cid:53)(cid:37)(cid:16)(cid:34)(cid:33,,8128.0
,,8,,,Unknown,,cid:12)(cid:29)(cid:26)(cid:41)(cid:25)(cid:2)(cid:53)(cid:53)(cid:37)(cid:16)(cid:34)(cid:33,,8136.0
,,2,,,Unknown,,cid:12)(cid:29)(cid:26)(cid:41)(cid:25)(cid:2)(cid:53)(cid:53)(cid:37)(cid:16)(cid:34)(cid:33,,8138.0
,,12,,,Unknown,,cid:12)(cid:29)(cid:26)(cid:41)(cid:25)(cid:2)(cid:53)(cid:53)(cid:37)(cid:16)(cid:34)(cid:33,,8150.0
,,11,,,Unknown,,cid:12)(cid:29)(cid:26)(cid:41)(cid:25)(cid:2)(cid:53)(cid:53)(cid:37)(cid:16)(cid:34)(cid:33,,8161.0
,,4,,,Unknown,,cid:12)(cid:29)(cid:26)(cid:41)(cid:25)(cid:2)(cid:53)(cid:53)(cid:37)(cid:16)(cid:34)(cid:33,,8165.0
,,14,,,Unknown,,cid:12)(cid:29)(cid:26)(cid:41)(cid:25)(cid:2)(cid:53)(cid:53)(cid:37)(cid:16)(cid:34)(cid:33,,8179.0
,,11,,,Unknown,,cid:12)(cid:29)(cid:26)(cid:41)(cid:25)(cid:2)(cid:53)(cid:53)(cid:37)(cid:16)(cid:34)(cid:33,,8190.0
,,62,,,Unknown,,cid:12)(cid:29)(cid:26)(cid:41)(cid:25)(cid:2)(cid:53)(cid:53)(cid:37)(cid:16)(cid:34)(cid:33,,8252.0
,,62,,,Unknown,,cid:12)(cid:29)(cid:26)(cid:41)(cid:25)(cid:2)(cid:53)(cid:53)(cid:37)(cid:16)(cid:34)(cid:33,,8314.0
,,7,,,Unknown,,cid:12)(cid:29)(cid:26)(cid:41)(cid:25)(cid:2)(cid:53)(cid:53)(cid:37)(cid:16)(cid:34)(cid:33,,8321.0
,,5,,,Unknown,,cid:12)(cid:29)(cid:26)(cid:41)(cid:25)(cid:2)(cid:53)(cid:53)(cid:37)(cid:16)(cid:34)(cid:33,,8326.0
,,3,,,Unknown,,cid:12)(cid:29)(cid:26)(cid:41)(cid:25)(cid:2)(cid:53)(cid:53)(cid:37)(cid:16)(cid:34)(cid:33,,8329.0
,,9,,,Unknown,,cid:12)(cid:29)(cid:26)(cid:41)(cid:25)(cid:2)(cid:53)(cid:53)(cid:37)(cid:16)(cid:34)(cid:33,,8338.0
,,2,,,Unknown,,cid:12)(cid:29)(cid:26)(cid:41)(cid:25)(cid:2)(cid:53)(cid:53)(cid:37)(cid:16)(cid:34)(cid:33,,8340.0
,,28,,,Unknown,,cid:12)(cid:29)(cid:26)(cid:41)(cid:25)(cid:2)(cid:53)(cid:53)(cid:37)(cid:16)(cid:34)(cid:33,,8368.0
,,3,,,Unknown,,cid:12)(cid:29)(cid:26)(cid:41)(cid:25)(cid:2)(cid:53)(cid:53)(cid:37)(cid:16)(cid:34)(cid:33,,8371.0
,,15,,,Unknown,,cid:12)(cid:29)(cid:26)(cid:41)(cid:25)(cid:2)(cid:53)(cid:53)(cid:37)(cid:16)(cid:34)(cid:33,,8386.0
,,2,,,Unknown,,cid:12)(cid:29)(cid:26)(cid:41)(cid:25)(cid:2)(cid:53)(cid:53)(cid:37)(cid:16)(cid:34)(cid:33,,8388.0
,,35,,,Unknown,,cid:12)(cid:29)(cid:26)(cid:41)(cid:25)(cid:2)(cid:53)(cid:53)(cid:37)(cid:16)(cid:34)(cid:33,,8423.0
,,18,,,Unknown,,cid:12)(cid:29)(cid:26)(cid:41)(cid:25)(cid:2)(cid:53)(cid:53)(cid:37)(cid:16)(cid:34)(cid:33,,8441.0
,,19,,,Unknown,,cid:12)(cid:29)(cid:26)(cid:41)(cid:25)(cid:2)(cid:53)(cid:53)(cid:37)(cid:16)(cid:34)(cid:33,,8460.0
,,33,,,Unknown,,cid:12)(cid:29)(cid:26)(cid:41)(cid:25)(cid:2)(cid:53)(cid:53)(cid:37)(cid:16)(cid:34)(cid:33,,8493.0
,,35,,,Unknown,,cid:12)(cid:29)(cid:26)(cid:41)(cid:25)(cid:2)(cid:53)(cid:53)(cid:37)(cid:16)(cid:34)(cid:33,,8528.0
,,2,,,Unknown,,cid:12)(cid:29)(cid:26)(cid:41)(cid:25)(cid:2)(cid:53)(cid:53)(cid:37)(cid:16)(cid:34)(cid:33,,8530.0
,,44,,,Unknown,,cid:12)(cid:29)(cid:26)(cid:41)(cid:25)(cid:2)(cid:53)(cid:53)(cid:37)(cid:16)(cid:34)(cid:33,,8574.0
,,12,,,Unknown,,cid:12)(cid:29)(cid:26)(cid:41)(cid:25)(cid:2)(cid:53)(cid:53)(cid:37)(cid:16)(cid:34)(cid:33,,8586.0
,,29,,,Unknown,,cid:12)(cid:29)(cid:26)(cid:41)(cid:25)(cid:2)(cid:53)(cid:53)(cid:37)(cid:16)(cid:34)(cid:33,,8615.0
,,26,,,Unknown,,cid:12)(cid:29)(cid:26)(cid:41)(cid:25)(cid:2)(cid:53)(cid:53)(cid:37)(cid:16)(cid:34)(cid:33,,8641.0
,,41,,,Unknown,,cid:12)(cid:29)(cid:26)(cid:41)(cid:25)(cid:2)(cid:53)(cid:53)(cid:37)(cid:16)(cid:34)(cid:33,,8682.0
,,25,,,Unknown,,cid:12)(cid:29)(cid:26)(cid:41)(cid:25)(cid:2)(cid:53)(cid:53)(cid:37)(cid:16)(cid:34)(cid:33,,8707.0
,,2,,,Unknown,,cid:12)(cid:29)(cid:26)(cid:41)(cid:25)(cid:2)(cid:53)(cid:53)(cid:37)(cid:16)(cid:34)(cid:33,,8709.0
,,53,,,Unknown,,cid:12)(cid:29)(cid:26)(cid:41)(cid:25)(cid:2)(cid:53)(cid:53)(cid:37)(cid:16)(cid:34)(cid:33,,8762.0
,,53,,,Unknown,,cid:12)(cid:29)(cid:26)(cid:41)(cid:25)(cid:2)(cid:53)(cid:53)(cid:37)(cid:16)(cid:34)(cid:33,,8815.0
,,18,,,Unknown,,cid:12)(cid:29)(cid:26)(cid:41)(cid:25)(cid:2)(cid:53)(cid:53)(cid:37)(cid:16)(cid:34)(cid:33,,8833.0
,,1,,,Unknown,,cid:12)(cid:29)(cid:26)(cid:41)(cid:25)(cid:2)(cid:53)(cid:53)(cid:37)(cid:16)(cid:34)(cid:33,,8834.0
,,1,,,Unknown,,cid:12)(cid:29)(cid:26)(cid:41)(cid:25)(cid:2)(cid:53)(cid:53)(cid:37)(cid:16)(cid:34)(cid:33,,8835.0
,,37,,,Unknown,,cid:12)(cid:29)(cid:26)(cid:41)(cid:25)(cid:2)(cid:53)(cid:53)(cid:37)(cid:16)(cid:34)(cid:33,,8872.0
,,1,,,Unknown,,cid:12)(cid:29)(cid:26)(cid:41)(cid:25)(cid:2)(cid:53)(cid:53)(cid:37)(cid:16)(cid:34)(cid:33,,8873.0
,,16,,,Unknown,,cid:12)(cid:29)(cid:26)(cid:41)(cid:25)(cid:2)(cid:53)(cid:53)(cid:37)(cid:16)(cid:34)(cid:33,,8889.0
,,45,,,Unknown,,cid:12)(cid:29)(cid:26)(cid:41)(cid:25)(cid:2)(cid:53)(cid:53)(cid:37)(cid:16)(cid:34)(cid:33,,8934.0
,,18,,,Unknown,,cid:12)(cid:29)(cid:26)(cid:41)(cid:25)(cid:2)(cid:53)(cid:53)(cid:37)(cid:16)(cid:34)(cid:33,,8952.0
,,34,,,Unknown,,cid:12)(cid:29)(cid:26)(cid:41)(cid:25)(cid:2)(cid:53)(cid:53)(cid:37)(cid:16)(cid:34)(cid:33,,8986.0
,,10,,,Unknown,,cid:12)(cid:29)(cid:26)(cid:41)(cid:25)(cid:2)(cid:53)(cid:53)(cid:37)(cid:16)(cid:34)(cid:33,,8996.0
,,7,,,Unknown,,cid:12)(cid:29)(cid:26)(cid:41)(cid:25)(cid:2)(cid:53)(cid:53)(cid:37)(cid:16)(cid:34)(cid:33,,9003.0
,,14,,,Unknown,,cid:12)(cid:29)(cid:26)(cid:41)(cid:25)(cid:2)(cid:53)(cid:53)(cid:37)(cid:16)(cid:34)(cid:33,,9017.0
,,7,,,Unknown,,cid:12)(cid:29)(cid:26)(cid:41)(cid:25)(cid:2)(cid:53)(cid:53)(cid:37)(cid:16)(cid:34)(cid:33,,9024.0
,,14,,,Unknown,,cid:12)(cid:29)(cid:26)(cid:41)(cid:25)(cid:2)(cid:53)(cid:53)(cid:37)(cid:16)(cid:34)(cid:33,,9038.0
,,49,,,Unknown,,cid:12)(cid:29)(cid:26)(cid:41)(cid:25)(cid:2)(cid:53)(cid:53)(cid:37)(cid:16)(cid:34)(cid:33,,9087.0
,,2,,,Unknown,,cid:12)(cid:29)(cid:26)(cid:41)(cid:25)(cid:2)(cid:53)(cid:53)(cid:37)(cid:16)(cid:34)(cid:33,,9089.0
,,9,,,Unknown,,cid:12)(cid:29)(cid:26)(cid:41)(cid:25)(cid:2)(cid:53)(cid:53)(cid:37)(cid:16)(cid:34)(cid:33,,9098.0
,,49,,,Unknown,,cid:12)(cid:29)(cid:26)(cid:41)(cid:25)(cid:2)(cid:53)(cid:53)(cid:37)(cid:16)(cid:34)(cid:33,,9147.0
,,3,,,Unknown,,cid:12)(cid:29)(cid:26)(cid:41)(cid:25)(cid:2)(cid:53)(cid:53)(cid:37)(cid:16)(cid:34)(cid:33,,9150.0
,,14,,,Unknown,,cid:12)(cid:29)(cid:26)(cid:41)(cid:25)(cid:2)(cid:53)(cid:53)(cid:37)(cid:16)(cid:34)(cid:33,,9164.0
,,2,,,Unknown,,cid:12)(cid:29)(cid:26)(cid:41)(cid:25)(cid:2)(cid:53)(cid:53)(cid:37)(cid:16)(cid:34)(cid:33,,9166.0
,,9,,,Unknown,,cid:12)(cid:29)(cid:26)(cid:41)(cid:25)(cid:2)(cid:53)(cid:53)(cid:37)(cid:16)(cid:34)(cid:33,,9175.0
,,10,,,Unknown,,cid:12)(cid:29)(cid:26)(cid:41)(cid:25)(cid:2)(cid:53)(cid:53)(cid:37)(cid:16)(cid:34)(cid:33,,9185.0
,,2,,,Unknown,,cid:12)(cid:29)(cid:26)(cid:41)(cid:25)(cid:2)(cid:53)(cid:53)(cid:37)(cid:16)(cid:34)(cid:33,,9187.0
,,46,,,Unknown,,cid:12)(cid:29)(cid:26)(cid:41)(cid:25)(cid:2)(cid:53)(cid:53)(cid:37)(cid:16)(cid:34)(cid:33,,9233.0
,,5,,,Unknown,,cid:12)(cid:29)(cid:26)(cid:41)(cid:25)(cid:2)(cid:53)(cid:53)(cid:37)(cid:16)(cid:34)(cid:33,,9238.0
,,3,,,Unknown,,cid:12)(cid:29)(cid:26)(cid:41)(cid:25)(cid:2)(cid:53)(cid:53)(cid:37)(cid:16)(cid:34)(cid:33,,9241.0
,,62,,,Unknown,,cid:12)(cid:29)(cid:26)(cid:41)(cid:25)(cid:2)(cid:53)(cid:53)(cid:37)(cid:16)(cid:34)(cid:33,,9303.0
,,49,,,Unknown,,cid:12)(cid:29)(cid:26)(cid:41)(cid:25)(cid:2)(cid:53)(cid:53)(cid:37)(cid:16)(cid:34)(cid:33,,9352.0
,,7,,,Unknown,,cid:12)(cid:29)(cid:26)(cid:41)(cid:25)(cid:2)(cid:53)(cid:53)(cid:37)(cid:16)(cid:34)(cid:33,,9359.0
,,8,,,Unknown,,cid:12)(cid:29)(cid:26)(cid:41)(cid:25)(cid:2)(cid:53)(cid:53)(cid:37)(cid:16)(cid:34)(cid:33,,9367.0
,,2,,,Unknown,,cid:12)(cid:29)(cid:26)(cid:41)(cid:25)(cid:2)(cid:53)(cid:53)(cid:37)(cid:16)(cid:34)(cid:33,,9369.0
,,9,,,Unknown,,cid:12)(cid:29)(cid:26)(cid:41)(cid:25)(cid:2)(cid:53)(cid:53)(cid:37)(cid:16)(cid:34)(cid:33,,9378.0
,,4,,,Unknown,,cid:12)(cid:29)(cid:26)(cid:41)(cid:25)(cid:2)(cid:53)(cid:53)(cid:37)(cid:16)(cid:34)(cid:33,,9382.0
,,2,,,Unknown,,cid:12)(cid:29)(cid:26)(cid:41)(cid:25)(cid:2)(cid:53)(cid:53)(cid:37)(cid:16)(cid:34)(cid:33,,9384.0
,,28,,,Unknown,,cid:12)(cid:29)(cid:26)(cid:41)(cid:25)(cid:2)(cid:53)(cid:53)(cid:37)(cid:16)(cid:34)(cid:33,,9412.0
,,3,,,Unknown,,cid:12)(cid:29)(cid:26)(cid:41)(cid:25)(cid:2)(cid:53)(cid:53)(cid:37)(cid:16)(cid:34)(cid:33,,9415.0
,,15,,,Unknown,,cid:12)(cid:29)(cid:26)(cid:41)(cid:25)(cid:2)(cid:53)(cid:53)(cid:37)(cid:16)(cid:34)(cid:33,,9430.0
,,2,,,Unknown,,cid:12)(cid:29)(cid:26)(cid:41)(cid:25)(cid:2)(cid:53)(cid:53)(cid:37)(cid:16)(cid:34)(cid:33,,9432.0
,,16,,,Unknown,,cid:12)(cid:29)(cid:26)(cid:41)(cid:25)(cid:2)(cid:53)(cid:53)(cid:37)(cid:16)(cid:34)(cid:33,,9448.0
,,19,,,Unknown,,cid:12)(cid:29)(cid:26)(cid:41)(cid:25)(cid:2)(cid:53)(cid:53)(cid:37)(cid:16)(cid:34)(cid:33,,9467.0
,,18,,,Unknown,,cid:12)(cid:29)(cid:26)(cid:41)(cid:25)(cid:2)(cid:53)(cid:53)(cid:37)(cid:16)(cid:34)(cid:33,,9485.0
,,18,,,Unknown,,cid:12)(cid:29)(cid:26)(cid:41)(cid:25)(cid:2)(cid:53)(cid:53)(cid:37)(cid:16)(cid:34)(cid:33,,9503.0
,,2,,,Unknown,,cid:12)(cid:29)(cid:26)(cid:41)(cid:25)(cid:2)(cid:53)(cid:53)(cid:37)(cid:16)(cid:34)(cid:33,,9505.0
,,44,,,Unknown,,cid:12)(cid:29)(cid:26)(cid:41)(cid:25)(cid:2)(cid:53)(cid:53)(cid:37)(cid:16)(cid:34)(cid:33,,9549.0
,,12,,,Unknown,,cid:12)(cid:29)(cid:26)(cid:41)(cid:25)(cid:2)(cid:53)(cid:53)(cid:37)(cid:16)(cid:34)(cid:33,,9561.0
,,29,,,Unknown,,cid:12)(cid:29)(cid:26)(cid:41)(cid:25)(cid:2)(cid:53)(cid:53)(cid:37)(cid:16)(cid:34)(cid:33,,9590.0
,,26,,,Unknown,,cid:12)(cid:29)(cid:26)(cid:41)(cid:25)(cid:2)(cid:53)(cid:53)(cid:37)(cid:16)(cid:34)(cid:33,,9616.0
,,41,,,Unknown,,cid:12)(cid:29)(cid:26)(cid:41)(cid:25)(cid:2)(cid:53)(cid:53)(cid:37)(cid:16)(cid:34)(cid:33,,9657.0
,,25,,,Unknown,,cid:12)(cid:29)(cid:26)(cid:41)(cid:25)(cid:2)(cid:53)(cid:53)(cid:37)(cid:16)(cid:34)(cid:33,,9682.0
,,2,,,Unknown,,cid:12)(cid:29)(cid:26)(cid:41)(cid:25)(cid:2)(cid:53)(cid:53)(cid:37)(cid:16)(cid:34)(cid:33,,9684.0
,,53,,,Unknown,,cid:12)(cid:29)(cid:26)(cid:41)(cid:25)(cid:2)(cid:53)(cid:53)(cid:37)(cid:16)(cid:34)(cid:33,,9737.0
,,53,,,Unknown,,cid:12)(cid:29)(cid:26)(cid:41)(cid:25)(cid:2)(cid:53)(cid:53)(cid:37)(cid:16)(cid:34)(cid:33,,9790.0
,,18,,,Unknown,,cid:12)(cid:29)(cid:26)(cid:41)(cid:25)(cid:2)(cid:53)(cid:53)(cid:37)(cid:16)(cid:34)(cid:33,,9808.0
,,1,,,Unknown,,cid:12)(cid:29)(cid:26)(cid:41)(cid:25)(cid:2)(cid:53)(cid:53)(cid:37)(cid:16)(cid:34)(cid:33,,9809.0
,,1,,,Unknown,,cid:12)(cid:29)(cid:26)(cid:41)(cid:25)(cid:2)(cid:53)(cid:53)(cid:37)(cid:16)(cid:34)(cid:33,,9810.0
,,37,,,Unknown,,cid:12)(cid:29)(cid:26)(cid:41)(cid:25)(cid:2)(cid:53)(cid:53)(cid:37)(cid:16)(cid:34)(cid:33,,9847.0
,,1,,,Unknown,,cid:12)(cid:29)(cid:26)(cid:41)(cid:25)(cid:2)(cid:53)(cid:53)(cid:37)(cid:16)(cid:34)(cid:33,,9848.0
,,35,,,Unknown,,cid:12)(cid:29)(cid:26)(cid:41)(cid:25)(cid:2)(cid:53)(cid:53)(cid:37)(cid:16)(cid:34)(cid:33,,9883.0
,,45,,,Unknown,,cid:12)(cid:29)(cid:26)(cid:41)(cid:25)(cid:2)(cid:53)(cid:53)(cid:37)(cid:16)(cid:34)(cid:33,,9928.0
,,18,,,Unknown,,cid:12)(cid:29)(cid:26)(cid:41)(cid:25)(cid:2)(cid:53)(cid:53)(cid:37)(cid:16)(cid:34)(cid:33,,9946.0
,,34,,,Unknown,,cid:12)(cid:29)(cid:26)(cid:41)(cid:25)(cid:2)(cid:53)(cid:53)(cid:37)(cid:16)(cid:34)(cid:33,,9980.0
,,14,,,Unknown,,cid:12)(cid:29)(cid:26)(cid:41)(cid:25)(cid:2)(cid:53)(cid:53)(cid:37)(cid:16)(cid:34)(cid:33,,9994.0
,,5,,,Unknown,,cid:12)(cid:29)(cid:26)(cid:41)(cid:25)(cid:2)(cid:53)(cid:53)(cid:37)(cid:16)(cid:34)(cid:33,,9999.0
,,12,,,Unknown,,cid:12)(cid:29)(cid:26)(cid:41)(cid:25)(cid:2)(cid:53)(cid:53)(cid:37)(cid:16)(cid:34)(cid:33,,10011.0
,,14,,,Unknown,,cid:12)(cid:29)(cid:26)(cid:41)(cid:25)(cid:2)(cid:53)(cid:53)(cid:37)(cid:16)(cid:34)(cid:33,,10025.0
,,5,,,Unknown,,cid:12)(cid:29)(cid:26)(cid:41)(cid:25)(cid:2)(cid:53)(cid:53)(cid:37)(cid:16)(cid:34)(cid:33,,10030.0
,,3,,,Unknown,,cid:12)(cid:29)(cid:26)(cid:41)(cid:25)(cid:2)(cid:53)(cid:53)(cid:37)(cid:16)(cid:34)(cid:33,,10033.0
,,12,,,Unknown,,cid:12)(cid:29)(cid:26)(cid:41)(cid:25)(cid:2)(cid:53)(cid:53)(cid:37)(cid:16)(cid:34)(cid:33,,10045.0
,,2,,,Unknown,,cid:12)(cid:29)(cid:26)(cid:41)(cid:25)(cid:2)(cid:53)(cid:53)(cid:37)(cid:16)(cid:34)(cid:33,,10047.0
,,52,,,Unknown,,cid:12)(cid:29)(cid:26)(cid:41)(cid:25)(cid:2)(cid:53)(cid:53)(cid:37)(cid:16)(cid:34)(cid:33,,10099.0
,,7,,,Unknown,,cid:12)(cid:29)(cid:26)(cid:41)(cid:25)(cid:2)(cid:53)(cid:53)(cid:37)(cid:16)(cid:34)(cid:33,,10106.0
,,9,,,Unknown,,cid:12)(cid:29)(cid:26)(cid:41)(cid:25)(cid:2)(cid:53)(cid:53)(cid:37)(cid:16)(cid:34)(cid:33,,10115.0
,,10,,,Unknown,,cid:12)(cid:29)(cid:26)(cid:41)(cid:25)(cid:2)(cid:53)(cid:53)(cid:37)(cid:16)(cid:34)(cid:33,,10125.0
,,3,,,Unknown,,cid:12)(cid:29)(cid:26)(cid:41)(cid:25)(cid:2)(cid:53)(cid:53)(cid:37)(cid:16)(cid:34)(cid:33,,10128.0
,,2,,,Unknown,,cid:12)(cid:29)(cid:26)(cid:41)(cid:25)(cid:2)(cid:53)(cid:53)(cid:37)(cid:16)(cid:34)(cid:33,,10130.0
,,12,,,Unknown,,cid:12)(cid:29)(cid:26)(cid:41)(cid:25)(cid:2)(cid:53)(cid:53)(cid:37)(cid:16)(cid:34)(cid:33,,10142.0
,,11,,,Unknown,,cid:12)(cid:29)(cid:26)(cid:41)(cid:25)(cid:2)(cid:53)(cid:53)(cid:37)(cid:16)(cid:34)(cid:33,,10153.0
,,4,,,Unknown,,cid:12)(cid:29)(cid:26)(cid:41)(cid:25)(cid:2)(cid:53)(cid:53)(cid:37)(cid:16)(cid:34)(cid:33,,10157.0
,,14,,,Unknown,,cid:12)(cid:29)(cid:26)(cid:41)(cid:25)(cid:2)(cid:53)(cid:53)(cid:37)(cid:16)(cid:34)(cid:33,,10171.0
,,11,,,Unknown,,cid:12)(cid:29)(cid:26)(cid:41)(cid:25)(cid:2)(cid:53)(cid:53)(cid:37)(cid:16)(cid:34)(cid:33,,10182.0
,,62,,,Unknown,,cid:12)(cid:29)(cid:26)(cid:41)(cid:25)(cid:2)(cid:53)(cid:53)(cid:37)(cid:16)(cid:34)(cid:33,,10244.0
,,62,,,Unknown,,cid:12)(cid:29)(cid:26)(cid:41)(cid:25)(cid:2)(cid:53)(cid:53)(cid:37)(cid:16)(cid:34)(cid:33,,10306.0
,,7,,,Unknown,,cid:12)(cid:29)(cid:26)(cid:41)(cid:25)(cid:2)(cid:53)(cid:53)(cid:37)(cid:16)(cid:34)(cid:33,,10313.0
,,5,,,Unknown,,cid:12)(cid:29)(cid:26)(cid:41)(cid:25)(cid:2)(cid:53)(cid:53)(cid:37)(cid:16)(cid:34)(cid:33,,10318.0
,,3,,,Unknown,,cid:12)(cid:29)(cid:26)(cid:41)(cid:25)(cid:2)(cid:53)(cid:53)(cid:37)(cid:16)(cid:34)(cid:33,,10321.0
,,2,,,Unknown,,cid:12)(cid:29)(cid:26)(cid:41)(cid:25)(cid:2)(cid:53)(cid:53)(cid:37)(cid:16)(cid:34)(cid:33,,10323.0
,,28,,,Unknown,,cid:12)(cid:29)(cid:26)(cid:41)(cid:25)(cid:2)(cid:53)(cid:53)(cid:37)(cid:16)(cid:34)(cid:33,,10351.0
,,3,,,Unknown,,cid:12)(cid:29)(cid:26)(cid:41)(cid:25)(cid:2)(cid:53)(cid:53)(cid:37)(cid:16)(cid:34)(cid:33,,10354.0
,,15,,,Unknown,,cid:12)(cid:29)(cid:26)(cid:41)(cid:25)(cid:2)(cid:53)(cid:53)(cid:37)(cid:16)(cid:34)(cid:33,,10369.0
,,2,,,Unknown,,cid:12)(cid:29)(cid:26)(cid:41)(cid:25)(cid:2)(cid:53)(cid:53)(cid:37)(cid:16)(cid:34)(cid:33,,10371.0
,,17,,,Unknown,,cid:12)(cid:29)(cid:26)(cid:41)(cid:25)(cid:2)(cid:53)(cid:53)(cid:37)(cid:16)(cid:34)(cid:33,,10388.0
,,35,,,Unknown,,cid:12)(cid:29)(cid:26)(cid:41)(cid:25)(cid:2)(cid:53)(cid:53)(cid:37)(cid:16)(cid:34)(cid:33,,10423.0
,,17,,,Unknown,,cid:12)(cid:29)(cid:26)(cid:41)(cid:25)(cid:2)(cid:53)(cid:53)(cid:37)(cid:16)(cid:34)(cid:33,,10440.0
,,19,,,Unknown,,cid:12)(cid:29)(cid:26)(cid:41)(cid:25)(cid:2)(cid:53)(cid:53)(cid:37)(cid:16)(cid:34)(cid:33,,10459.0
,,36,,,Unknown,,cid:12)(cid:29)(cid:26)(cid:41)(cid:25)(cid:2)(cid:53)(cid:53)(cid:37)(cid:16)(cid:34)(cid:33,,10495.0
,,34,,,Unknown,,cid:12)(cid:29)(cid:26)(cid:41)(cid:25)(cid:2)(cid:53)(cid:53)(cid:37)(cid:16)(cid:34)(cid:33,,10529.0
,,2,,,Unknown,,cid:12)(cid:29)(cid:26)(cid:41)(cid:25)(cid:2)(cid:53)(cid:53)(cid:37)(cid:16)(cid:34)(cid:33,,10531.0
,,44,,,Unknown,,cid:12)(cid:29)(cid:26)(cid:41)(cid:25)(cid:2)(cid:53)(cid:53)(cid:37)(cid:16)(cid:34)(cid:33,,10575.0
,,12,,,Unknown,,cid:12)(cid:29)(cid:26)(cid:41)(cid:25)(cid:2)(cid:53)(cid:53)(cid:37)(cid:16)(cid:34)(cid:33,,10587.0
,,29,,,Unknown,,cid:12)(cid:29)(cid:26)(cid:41)(cid:25)(cid:2)(cid:53)(cid:53)(cid:37)(cid:16)(cid:34)(cid:33,,10616.0
,,26,,,Unknown,,cid:12)(cid:29)(cid:26)(cid:41)(cid:25)(cid:2)(cid:53)(cid:53)(cid:37)(cid:16)(cid:34)(cid:33,,10642.0
,,41,,,Unknown,,cid:12)(cid:29)(cid:26)(cid:41)(cid:25)(cid:2)(cid:53)(cid:53)(cid:37)(cid:16)(cid:34)(cid:33,,10683.0
,,25,,,Unknown,,cid:12)(cid:29)(cid:26)(cid:41)(cid:25)(cid:2)(cid:53)(cid:53)(cid:37)(cid:16)(cid:34)(cid:33,,10708.0
,,2,,,Unknown,,cid:12)(cid:29)(cid:26)(cid:41)(cid:25)(cid:2)(cid:53)(cid:53)(cid:37)(cid:16)(cid:34)(cid:33,,10710.0
,,53,,,Unknown,,cid:12)(cid:29)(cid:26)(cid:41)(cid:25)(cid:2)(cid:53)(cid:53)(cid:37)(cid:16)(cid:34)(cid:33,,10763.0
,,53,,,Unknown,,cid:12)(cid:29)(cid:26)(cid:41)(cid:25)(cid:2)(cid:53)(cid:53)(cid:37)(cid:16)(cid:34)(cid:33,,10816.0
,,37,,,Unknown,,cid:12)(cid:29)(cid:26)(cid:41)(cid:25)(cid:2)(cid:53)(cid:53)(cid:37)(cid:16)(cid:34)(cid:33,,10853.0
,,16,,,Unknown,,cid:12)(cid:29)(cid:26)(cid:41)(cid:25)(cid:2)(cid:53)(cid:53)(cid:37)(cid:16)(cid:34)(cid:33,,10869.0
,,34,,,Unknown,,cid:12)(cid:29)(cid:26)(cid:41)(cid:25)(cid:2)(cid:53)(cid:53)(cid:37)(cid:16)(cid:34)(cid:33,,10903.0
,,33,,,Unknown,,cid:12)(cid:29)(cid:26)(cid:41)(cid:25)(cid:2)(cid:53)(cid:53)(cid:37)(cid:16)(cid:34)(cid:33,,10936.0
,,1,,,Unknown,,cid:12)(cid:29)(cid:26)(cid:41)(cid:25)(cid:2)(cid:53)(cid:53)(cid:37)(cid:16)(cid:34)(cid:33,,10937.0
,,35,,,Unknown,,cid:12)(cid:29)(cid:26)(cid:41)(cid:25)(cid:2)(cid:53)(cid:53)(cid:37)(cid:16)(cid:34)(cid:33,,10972.0
,,45,,,Unknown,,cid:12)(cid:29)(cid:26)(cid:41)(cid:25)(cid:2)(cid:53)(cid:53)(cid:37)(cid:16)(cid:34)(cid:33,,11017.0
,,18,,,Unknown,,cid:12)(cid:29)(cid:26)(cid:41)(cid:25)(cid:2)(cid:53)(cid:53)(cid:37)(cid:16)(cid:34)(cid:33,,11035.0
,,34,,,Unknown,,cid:12)(cid:29)(cid:26)(cid:41)(cid:25)(cid:2)(cid:53)(cid:53)(cid:37)(cid:16)(cid:34)(cid:33,,11069.0
,,10,,,Unknown,,cid:12)(cid:29)(cid:26)(cid:41)(cid:25)(cid:2)(cid:53)(cid:53)(cid:37)(cid:16)(cid:34)(cid:33,,11079.0
,,5,,,Unknown,,cid:12)(cid:29)(cid:26)(cid:41)(cid:25)(cid:2)(cid:53)(cid:53)(cid:37)(cid:16)(cid:34)(cid:33,,11084.0
,,14,,,Unknown,,cid:12)(cid:29)(cid:26)(cid:41)(cid:25)(cid:2)(cid:53)(cid:53)(cid:37)(cid:16)(cid:34)(cid:33,,11098.0
,,2,,,Unknown,,cid:12)(cid:29)(cid:26)(cid:41)(cid:25)(cid:2)(cid:53)(cid:53)(cid:37)(cid:16)(cid:34)(cid:33,,11100.0
,,62,,,Unknown,,cid:12)(cid:29)(cid:26)(cid:41)(cid:25)(cid:2)(cid:53)(cid:53)(cid:37)(cid:16)(cid:34)(cid:33,,11162.0
,,2,,,Unknown,,cid:12)(cid:29)(cid:26)(cid:41)(cid:25)(cid:2)(cid:53)(cid:53)(cid:37)(cid:16)(cid:34)(cid:33,,11164.0
,,62,,,Unknown,,cid:12)(cid:29)(cid:26)(cid:41)(cid:25)(cid:2)(cid:53)(cid:53)(cid:37)(cid:16)(cid:34)(cid:33,,11226.0
,,5,,,Unknown,,cid:12)(cid:29)(cid:26)(cid:41)(cid:25)(cid:2)(cid:53)(cid:53)(cid:37)(cid:16)(cid:34)(cid:33,,11231.0
,,4,,,Unknown,,cid:12)(cid:29)(cid:26)(cid:41)(cid:25)(cid:2)(cid:53)(cid:53)(cid:37)(cid:16)(cid:34)(cid:33,,11235.0
,,52,,,Unknown,,cid:12)(cid:29)(cid:26)(cid:41)(cid:25)(cid:2)(cid:53)(cid:53)(cid:37)(cid:16)(cid:34)(cid:33,,11287.0
,,11,,,Unknown,,cid:12)(cid:29)(cid:26)(cid:41)(cid:25)(cid:2)(cid:53)(cid:53)(cid:37)(cid:16)(cid:34)(cid:33,,11298.0
,,8,,,Unknown,,cid:12)(cid:29)(cid:26)(cid:41)(cid:25)(cid:2)(cid:53)(cid:53)(cid:37)(cid:16)(cid:34)(cid:33,,11306.0
,,2,,,Unknown,,cid:12)(cid:29)(cid:26)(cid:41)(cid:25)(cid:2)(cid:53)(cid:53)(cid:37)(cid:16)(cid:34)(cid:33,,11308.0
,,14,,,Unknown,,cid:12)(cid:29)(cid:26)(cid:41)(cid:25)(cid:2)(cid:53)(cid:53)(cid:37)(cid:16)(cid:34)(cid:33,,11322.0
,,49,,,Unknown,,cid:12)(cid:29)(cid:26)(cid:41)(cid:25)(cid:2)(cid:53)(cid:53)(cid:37)(cid:16)(cid:34)(cid:33,,11371.0
,,2,,,Unknown,,cid:12)(cid:29)(cid:26)(cid:41)(cid:25)(cid:2)(cid:53)(cid:53)(cid:37)(cid:16)(cid:34)(cid:33,,11373.0
,,28,,,Unknown,,cid:12)(cid:29)(cid:26)(cid:41)(cid:25)(cid:2)(cid:53)(cid:53)(cid:37)(cid:16)(cid:34)(cid:33,,11401.0
,,11,,,Unknown,,cid:12)(cid:29)(cid:26)(cid:41)(cid:25)(cid:2)(cid:53)(cid:53)(cid:37)(cid:16)(cid:34)(cid:33,,11412.0
,,3,,,Unknown,,cid:12)(cid:29)(cid:26)(cid:41)(cid:25)(cid:2)(cid:53)(cid:53)(cid:37)(cid:16)(cid:34)(cid:33,,11415.0
,,2,,,Unknown,,cid:12)(cid:29)(cid:26)(cid:41)(cid:25)(cid:2)(cid:53)(cid:53)(cid:37)(cid:16)(cid:34)(cid:33,,11417.0
,,28,,,Unknown,,cid:12)(cid:29)(cid:26)(cid:41)(cid:25)(cid:2)(cid:53)(cid:53)(cid:37)(cid:16)(cid:34)(cid:33,,11445.0
,,3,,,Unknown,,cid:12)(cid:29)(cid:26)(cid:41)(cid:25)(cid:2)(cid:53)(cid:53)(cid:37)(cid:16)(cid:34)(cid:33,,11448.0
,,15,,,Unknown,,cid:12)(cid:29)(cid:26)(cid:41)(cid:25)(cid:2)(cid:53)(cid:53)(cid:37)(cid:16)(cid:34)(cid:33,,11463.0
,,2,,,Unknown,,cid:12)(cid:29)(cid:26)(cid:41)(cid:25)(cid:2)(cid:53)(cid:53)(cid:37)(cid:16)(cid:34)(cid:33,,11465.0
,,16,,,Unknown,,cid:12)(cid:29)(cid:26)(cid:41)(cid:25)(cid:2)(cid:53)(cid:53)(cid:37)(cid:16)(cid:34)(cid:33,,11481.0
,,18,,,Unknown,,cid:12)(cid:29)(cid:26)(cid:41)(cid:25)(cid:2)(cid:53)(cid:53)(cid:37)(cid:16)(cid:34)(cid:33,,11499.0
,,19,,,Unknown,,cid:12)(cid:29)(cid:26)(cid:41)(cid:25)(cid:2)(cid:53)(cid:53)(cid:37)(cid:16)(cid:34)(cid:33,,11518.0
,,33,,,Unknown,,cid:12)(cid:29)(cid:26)(cid:41)(cid:25)(cid:2)(cid:53)(cid:53)(cid:37)(cid:16)(cid:34)(cid:33,,11551.0
,,33,,,Unknown,,cid:12)(cid:29)(cid:26)(cid:41)(cid:25)(cid:2)(cid:53)(cid:53)(cid:37)(cid:16)(cid:34)(cid:33,,11584.0
,,2,,,Unknown,,cid:12)(cid:29)(cid:26)(cid:41)(cid:25)(cid:2)(cid:53)(cid:53)(cid:37)(cid:16)(cid:34)(cid:33,,11586.0
,,44,,,Unknown,,cid:12)(cid:29)(cid:26)(cid:41)(cid:25)(cid:2)(cid:53)(cid:53)(cid:37)(cid:16)(cid:34)(cid:33,,11630.0
,,12,,,Unknown,,cid:12)(cid:29)(cid:26)(cid:41)(cid:25)(cid:2)(cid:53)(cid:53)(cid:37)(cid:16)(cid:34)(cid:33,,11642.0
,,29,,,Unknown,,cid:12)(cid:29)(cid:26)(cid:41)(cid:25)(cid:2)(cid:53)(cid:53)(cid:37)(cid:16)(cid:34)(cid:33,,11671.0
,,26,,,Unknown,,cid:12)(cid:29)(cid:26)(cid:41)(cid:25)(cid:2)(cid:53)(cid:53)(cid:37)(cid:16)(cid:34)(cid:33,,11697.0
,,41,,,Unknown,,cid:12)(cid:29)(cid:26)(cid:41)(cid:25)(cid:2)(cid:53)(cid:53)(cid:37)(cid:16)(cid:34)(cid:33,,11738.0
,,25,,,Unknown,,cid:12)(cid:29)(cid:26)(cid:41)(cid:25)(cid:2)(cid:53)(cid:53)(cid:37)(cid:16)(cid:34)(cid:33,,11763.0
,,2,,,Unknown,,cid:12)(cid:29)(cid:26)(cid:41)(cid:25)(cid:2)(cid:53)(cid:53)(cid:37)(cid:16)(cid:34)(cid:33,,11765.0
,,53,,,Unknown,,cid:12)(cid:29)(cid:26)(cid:41)(cid:25)(cid:2)(cid:53)(cid:53)(cid:37)(cid:16)(cid:34)(cid:33,,11818.0
,,53,,,Unknown,,cid:12)(cid:29)(cid:26)(cid:41)(cid:25)(cid:2)(cid:53)(cid:53)(cid:37)(cid:16)(cid:34)(cid:33,,11871.0
,,37,,,Unknown,,cid:12)(cid:29)(cid:26)(cid:41)(cid:25)(cid:2)(cid:53)(cid:53)(cid:37)(cid:16)(cid:34)(cid:33,,11908.0
,,16,,,Unknown,,cid:12)(cid:29)(cid:26)(cid:41)(cid:25)(cid:2)(cid:53)(cid:53)(cid:37)(cid:16)(cid:34)(cid:33,,11924.0
,,34,,,Unknown,,cid:12)(cid:29)(cid:26)(cid:41)(cid:25)(cid:2)(cid:53)(cid:53)(cid:37)(cid:16)(cid:34)(cid:33,,11958.0
,,33,,,Unknown,,cid:12)(cid:29)(cid:26)(cid:41)(cid:25)(cid:2)(cid:53)(cid:53)(cid:37)(cid:16)(cid:34)(cid:33,,11991.0
,,1,,,Unknown,,cid:12)(cid:29)(cid:26)(cid:41)(cid:25)(cid:2)(cid:53)(cid:53)(cid:37)(cid:16)(cid:34)(cid:33,,11992.0
,,35,,,Unknown,,cid:12)(cid:29)(cid:26)(cid:41)(cid:25)(cid:2)(cid:53)(cid:53)(cid:37)(cid:16)(cid:34)(cid:33,,12027.0
,,45,,,Unknown,,cid:12)(cid:29)(cid:26)(cid:41)(cid:25)(cid:2)(cid:53)(cid:53)(cid:37)(cid:16)(cid:34)(cid:33,,12072.0
,,18,,,Unknown,,cid:12)(cid:29)(cid:26)(cid:41)(cid:25)(cid:2)(cid:53)(cid:53)(cid:37)(cid:16)(cid:34)(cid:33,,12090.0
,,34,,,Unknown,,cid:12)(cid:29)(cid:26)(cid:41)(cid:25)(cid:2)(cid:53)(cid:53)(cid:37)(cid:16)(cid:34)(cid:33,,12124.0
,,10,,,Unknown,,cid:12)(cid:29)(cid:26)(cid:41)(cid:25)(cid:2)(cid:53)(cid:53)(cid:37)(cid:16)(cid:34)(cid:33,,12134.0
,,11,,,Unknown,,cid:12)(cid:29)(cid:26)(cid:41)(cid:25)(cid:2)(cid:53)(cid:53)(cid:37)(cid:16)(cid:34)(cid:33,,12145.0
,,10,,,Unknown,,cid:12)(cid:29)(cid:26)(cid:41)(cid:25)(cid:2)(cid:53)(cid:53)(cid:37)(cid:16)(cid:34)(cid:33,,12155.0
,,49,,,Unknown,,cid:12)(cid:29)(cid:26)(cid:41)(cid:25)(cid:2)(cid:53)(cid:53)(cid:37)(cid:16)(cid:34)(cid:33,,12204.0
,,14,,,Unknown,,cid:12)(cid:29)(cid:26)(cid:41)(cid:25)(cid:2)(cid:53)(cid:53)(cid:37)(cid:16)(cid:34)(cid:33,,12218.0
,,2,,,Unknown,,cid:12)(cid:29)(cid:26)(cid:41)(cid:25)(cid:2)(cid:53)(cid:53)(cid:37)(cid:16)(cid:34)(cid:33,,12220.0
,,12,,,Unknown,,cid:12)(cid:29)(cid:26)(cid:41)(cid:25)(cid:2)(cid:53)(cid:53)(cid:37)(cid:16)(cid:34)(cid:33,,12232.0
,,11,,,Unknown,,cid:12)(cid:29)(cid:26)(cid:41)(cid:25)(cid:2)(cid:53)(cid:53)(cid:37)(cid:16)(cid:34)(cid:33,,12243.0
,,4,,,Unknown,,cid:12)(cid:29)(cid:26)(cid:41)(cid:25)(cid:2)(cid:53)(cid:53)(cid:37)(cid:16)(cid:34)(cid:33,,12247.0
,,14,,,Unknown,,cid:12)(cid:29)(cid:26)(cid:41)(cid:25)(cid:2)(cid:53)(cid:53)(cid:37)(cid:16)(cid:34)(cid:33,,12261.0
,,11,,,Unknown,,cid:12)(cid:29)(cid:26)(cid:41)(cid:25)(cid:2)(cid:53)(cid:53)(cid:37)(cid:16)(cid:34)(cid:33,,12272.0
,,62,,,Unknown,,cid:12)(cid:29)(cid:26)(cid:41)(cid:25)(cid:2)(cid:53)(cid:53)(cid:37)(cid:16)(cid:34)(cid:33,,12334.0
,,62,,,Unknown,,cid:12)(cid:29)(cid:26)(cid:41)(cid:25)(cid:2)(cid:53)(cid:53)(cid:37)(cid:16)(cid:34)(cid:33,,12396.0
,,7,,,Unknown,,cid:12)(cid:29)(cid:26)(cid:41)(cid:25)(cid:2)(cid:53)(cid:53)(cid:37)(cid:16)(cid:34)(cid:33,,12403.0
,,5,,,Unknown,,cid:12)(cid:29)(cid:26)(cid:41)(cid:25)(cid:2)(cid:53)(cid:53)(cid:37)(cid:16)(cid:34)(cid:33,,12408.0
,,3,,,Unknown,,cid:12)(cid:29)(cid:26)(cid:41)(cid:25)(cid:2)(cid:53)(cid:53)(cid:37)(cid:16)(cid:34)(cid:33,,12411.0
,,9,,,Unknown,,cid:12)(cid:29)(cid:26)(cid:41)(cid:25)(cid:2)(cid:53)(cid:53)(cid:37)(cid:16)(cid:34)(cid:33,,12420.0
,,2,,,Unknown,,cid:12)(cid:29)(cid:26)(cid:41)(cid:25)(cid:2)(cid:53)(cid:53)(cid:37)(cid:16)(cid:34)(cid:33,,12422.0
,,28,,,Unknown,,cid:12)(cid:29)(cid:26)(cid:41)(cid:25)(cid:2)(cid:53)(cid:53)(cid:37)(cid:16)(cid:34)(cid:33,,12450.0
,,3,,,Unknown,,cid:12)(cid:29)(cid:26)(cid:41)(cid:25)(cid:2)(cid:53)(cid:53)(cid:37)(cid:16)(cid:34)(cid:33,,12453.0
,,15,,,Unknown,,cid:12)(cid:29)(cid:26)(cid:41)(cid:25)(cid:2)(cid:53)(cid:53)(cid:37)(cid:16)(cid:34)(cid:33,,12468.0
,,2,,,Unknown,,cid:12)(cid:29)(cid:26)(cid:41)(cid:25)(cid:2)(cid:53)(cid:53)(cid:37)(cid:16)(cid:34)(cid:33,,12470.0
,,17,,,Unknown,,cid:12)(cid:29)(cid:26)(cid:41)(cid:25)(cid:2)(cid:53)(cid:53)(cid:37)(cid:16)(cid:34)(cid:33,,12487.0
,,17,,,Unknown,,cid:12)(cid:29)(cid:26)(cid:41)(cid:25)(cid:2)(cid:53)(cid:53)(cid:37)(cid:16)(cid:34)(cid:33,,12504.0
,,33,,,Unknown,,cid:12)(cid:29)(cid:26)(cid:41)(cid:25)(cid:2)(cid:53)(cid:53)(cid:37)(cid:16)(cid:34)(cid:33,,12537.0
,,19,,,Unknown,,cid:12)(cid:29)(cid:26)(cid:41)(cid:25)(cid:2)(cid:53)(cid:53)(cid:37)(cid:16)(cid:34)(cid:33,,12556.0
,,33,,,Unknown,,cid:12)(cid:29)(cid:26)(cid:41)(cid:25)(cid:2)(cid:53)(cid:53)(cid:37)(cid:16)(cid:34)(cid:33,,12589.0
,,33,,,Unknown,,cid:12)(cid:29)(cid:26)(cid:41)(cid:25)(cid:2)(cid:53)(cid:53)(cid:37)(cid:16)(cid:34)(cid:33,,12622.0
,,2,,,Unknown,,cid:12)(cid:29)(cid:26)(cid:41)(cid:25)(cid:2)(cid:53)(cid:53)(cid:37)(cid:16)(cid:34)(cid:33,,12624.0
,,44,,,Unknown,,cid:12)(cid:29)(cid:26)(cid:41)(cid:25)(cid:2)(cid:53)(cid:53)(cid:37)(cid:16)(cid:34)(cid:33,,12668.0
,,12,,,Unknown,,cid:12)(cid:29)(cid:26)(cid:41)(cid:25)(cid:2)(cid:53)(cid:53)(cid:37)(cid:16)(cid:34)(cid:33,,12680.0
,,29,,,Unknown,,cid:12)(cid:29)(cid:26)(cid:41)(cid:25)(cid:2)(cid:53)(cid:53)(cid:37)(cid:16)(cid:34)(cid:33,,12709.0
,,26,,,Unknown,,cid:12)(cid:29)(cid:26)(cid:41)(cid:25)(cid:2)(cid:53)(cid:53)(cid:37)(cid:16)(cid:34)(cid:33,,12735.0
,,41,,,Unknown,,cid:12)(cid:29)(cid:26)(cid:41)(cid:25)(cid:2)(cid:53)(cid:53)(cid:37)(cid:16)(cid:34)(cid:33,,12776.0
,,25,,,Unknown,,cid:12)(cid:29)(cid:26)(cid:41)(cid:25)(cid:2)(cid:53)(cid:53)(cid:37)(cid:16)(cid:34)(cid:33,,12801.0
,,2,,,Unknown,,cid:12)(cid:29)(cid:26)(cid:41)(cid:25)(cid:2)(cid:53)(cid:53)(cid:37)(cid:16)(cid:34)(cid:33,,12803.0
,,53,,,Unknown,,cid:12)(cid:29)(cid:26)(cid:41)(cid:25)(cid:2)(cid:53)(cid:53)(cid:37)(cid:16)(cid:34)(cid:33,,12856.0
,,53,,,Unknown,,cid:12)(cid:29)(cid:26)(cid:41)(cid:25)(cid:2)(cid:53)(cid:53)(cid:37)(cid:16)(cid:34)(cid:33,,12909.0
,,18,,,Unknown,,cid:12)(cid:29)(cid:26)(cid:41)(cid:25)(cid:2)(cid:53)(cid:53)(cid:37)(cid:16)(cid:34)(cid:33,,12927.0
,,1,,,Unknown,,cid:12)(cid:29)(cid:26)(cid:41)(cid:25)(cid:2)(cid:53)(cid:53)(cid:37)(cid:16)(cid:34)(cid:33,,12928.0
,,1,,,Unknown,,cid:12)(cid:29)(cid:26)(cid:41)(cid:25)(cid:2)(cid:53)(cid:53)(cid:37)(cid:16)(cid:34)(cid:33,,12929.0
,,37,,,Unknown,,cid:12)(cid:29)(cid:26)(cid:41)(cid:25)(cid:2)(cid:53)(cid:53)(cid:37)(cid:16)(cid:34)(cid:33,,12966.0
,,1,,,Unknown,,cid:12)(cid:29)(cid:26)(cid:41)(cid:25)(cid:2)(cid:53)(cid:53)(cid:37)(cid:16)(cid:34)(cid:33,,12967.0
,,35,,,Unknown,,cid:12)(cid:29)(cid:26)(cid:41)(cid:25)(cid:2)(cid:53)(cid:53)(cid:37)(cid:16)(cid:34)(cid:33,,13002.0
,,45,,,Unknown,,cid:12)(cid:29)(cid:26)(cid:41)(cid:25)(cid:2)(cid:53)(cid:53)(cid:37)(cid:16)(cid:34)(cid:33,,13047.0
,,18,,,Unknown,,cid:12)(cid:29)(cid:26)(cid:41)(cid:25)(cid:2)(cid:53)(cid:53)(cid:37)(cid:16)(cid:34)(cid:33,,13065.0
,,34,,,Unknown,,cid:12)(cid:29)(cid:26)(cid:41)(cid:25)(cid:2)(cid:53)(cid:53)(cid:37)(cid:16)(cid:34)(cid:33,,13099.0
,,10,,,Unknown,,cid:12)(cid:29)(cid:26)(cid:41)(cid:25)(cid:2)(cid:53)(cid:53)(cid:37)(cid:16)(cid:34)(cid:33,,13109.0
,,5,,,Unknown,,cid:12)(cid:29)(cid:26)(cid:41)(cid:25)(cid:2)(cid:53)(cid:53)(cid:37)(cid:16)(cid:34)(cid:33,,13114.0
,,14,,,Unknown,,cid:12)(cid:29)(cid:26)(cid:41)(cid:25)(cid:2)(cid:53)(cid:53)(cid:37)(cid:16)(cid:34)(cid:33,,13128.0
,,2,,,Unknown,,cid:12)(cid:29)(cid:26)(cid:41)(cid:25)(cid:2)(cid:53)(cid:53)(cid:37)(cid:16)(cid:34)(cid:33,,13130.0
,,62,,,Unknown,,cid:12)(cid:29)(cid:26)(cid:41)(cid:25)(cid:2)(cid:53)(cid:53)(cid:37)(cid:16)(cid:34)(cid:33,,13192.0
,,2,,,Unknown,,cid:12)(cid:29)(cid:26)(cid:41)(cid:25)(cid:2)(cid:53)(cid:53)(cid:37)(cid:16)(cid:34)(cid:33,,13194.0
,,62,,,Unknown,,cid:12)(cid:29)(cid:26)(cid:41)(cid:25)(cid:2)(cid:53)(cid:53)(cid:37)(cid:16)(cid:34)(cid:33,,13256.0
,,5,,,Unknown,,cid:12)(cid:29)(cid:26)(cid:41)(cid:25)(cid:2)(cid:53)(cid:53)(cid:37)(cid:16)(cid:34)(cid:33,,13261.0
,,4,,,Unknown,,cid:12)(cid:29)(cid:26)(cid:41)(cid:25)(cid:2)(cid:53)(cid:53)(cid:37)(cid:16)(cid:34)(cid:33,,13265.0
,,52,,,Unknown,,cid:12)(cid:29)(cid:26)(cid:41)(cid:25)(cid:2)(cid:53)(cid:53)(cid:37)(cid:16)(cid:34)(cid:33,,13317.0
,,11,,,Unknown,,cid:12)(cid:29)(cid:26)(cid:41)(cid:25)(cid:2)(cid:53)(cid:53)(cid:37)(cid:16)(cid:34)(cid:33,,13328.0
,,8,,,Unknown,,cid:12)(cid:29)(cid:26)(cid:41)(cid:25)(cid:2)(cid:53)(cid:53)(cid:37)(cid:16)(cid:34)(cid:33,,13336.0
,,2,,,Unknown,,cid:12)(cid:29)(cid:26)(cid:41)(cid:25)(cid:2)(cid:53)(cid:53)(cid:37)(cid:16)(cid:34)(cid:33,,13338.0
,,14,,,Unknown,,cid:12)(cid:29)(cid:26)(cid:41)(cid:25)(cid:2)(cid:53)(cid:53)(cid:37)(cid:16)(cid:34)(cid:33,,13352.0
,,49,,,Unknown,,cid:12)(cid:29)(cid:26)(cid:41)(cid:25)(cid:2)(cid:53)(cid:53)(cid:37)(cid:16)(cid:34)(cid:33,,13401.0
,,2,,,Unknown,,cid:12)(cid:29)(cid:26)(cid:41)(cid:25)(cid:2)(cid:53)(cid:53)(cid:37)(cid:16)(cid:34)(cid:33,,13403.0
,,28,,,Unknown,,cid:12)(cid:29)(cid:26)(cid:41)(cid:25)(cid:2)(cid:53)(cid:53)(cid:37)(cid:16)(cid:34)(cid:33,,13431.0
,,11,,,Unknown,,cid:12)(cid:29)(cid:26)(cid:41)(cid:25)(cid:2)(cid:53)(cid:53)(cid:37)(cid:16)(cid:34)(cid:33,,13442.0
,,3,,,Unknown,,cid:12)(cid:29)(cid:26)(cid:41)(cid:25)(cid:2)(cid:53)(cid:53)(cid:37)(cid:16)(cid:34)(cid:33,,13445.0
,,2,,,Unknown,,cid:12)(cid:29)(cid:26)(cid:41)(cid:25)(cid:2)(cid:53)(cid:53)(cid:37)(cid:16)(cid:34)(cid:33,,13447.0
,,28,,,Unknown,,cid:12)(cid:29)(cid:26)(cid:41)(cid:25)(cid:2)(cid:53)(cid:53)(cid:37)(cid:16)(cid:34)(cid:33,,13475.0
,,3,,,Unknown,,cid:12)(cid:29)(cid:26)(cid:41)(cid:25)(cid:2)(cid:53)(cid:53)(cid:37)(cid:16)(cid:34)(cid:33,,13478.0
,,15,,,Unknown,,cid:12)(cid:29)(cid:26)(cid:41)(cid:25)(cid:2)(cid:53)(cid:53)(cid:37)(cid:16)(cid:34)(cid:33,,13493.0
,,2,,,Unknown,,cid:12)(cid:29)(cid:26)(cid:41)(cid:25)(cid:2)(cid:53)(cid:53)(cid:37)(cid:16)(cid:34)(cid:33,,13495.0
,,37,,,Unknown,,cid:12)(cid:29)(cid:26)(cid:41)(cid:25)(cid:2)(cid:53)(cid:53)(cid:37)(cid:16)(cid:34)(cid:33,,13532.0
,,33,,,Unknown,,cid:12)(cid:29)(cid:26)(cid:41)(cid:25)(cid:2)(cid:53)(cid:53)(cid:37)(cid:16)(cid:34)(cid:33,,13565.0
,,19,,,Unknown,,cid:12)(cid:29)(cid:26)(cid:41)(cid:25)(cid:2)(cid:53)(cid:53)(cid:37)(cid:16)(cid:34)(cid:33,,13584.0
,,33,,,Unknown,,cid:12)(cid:29)(cid:26)(cid:41)(cid:25)(cid:2)(cid:53)(cid:53)(cid:37)(cid:16)(cid:34)(cid:33,,13617.0
,,33,,,Unknown,,cid:12)(cid:29)(cid:26)(cid:41)(cid:25)(cid:2)(cid:53)(cid:53)(cid:37)(cid:16)(cid:34)(cid:33,,13650.0
,,2,,,Unknown,,cid:12)(cid:29)(cid:26)(cid:41)(cid:25)(cid:2)(cid:53)(cid:53)(cid:37)(cid:16)(cid:34)(cid:33,,13652.0
,,44,,,Unknown,,cid:12)(cid:29)(cid:26)(cid:41)(cid:25)(cid:2)(cid:53)(cid:53)(cid:37)(cid:16)(cid:34)(cid:33,,13696.0
,,12,,,Unknown,,cid:12)(cid:29)(cid:26)(cid:41)(cid:25)(cid:2)(cid:53)(cid:53)(cid:37)(cid:16)(cid:34)(cid:33,,13708.0
,,29,,,Unknown,,cid:12)(cid:29)(cid:26)(cid:41)(cid:25)(cid:2)(cid:53)(cid:53)(cid:37)(cid:16)(cid:34)(cid:33,,13737.0
,,26,,,Unknown,,cid:12)(cid:29)(cid:26)(cid:41)(cid:25)(cid:2)(cid:53)(cid:53)(cid:37)(cid:16)(cid:34)(cid:33,,13763.0
,,41,,,Unknown,,cid:12)(cid:29)(cid:26)(cid:41)(cid:25)(cid:2)(cid:53)(cid:53)(cid:37)(cid:16)(cid:34)(cid:33,,13804.0
,,25,,,Unknown,,cid:12)(cid:29)(cid:26)(cid:41)(cid:25)(cid:2)(cid:53)(cid:53)(cid:37)(cid:16)(cid:34)(cid:33,,13829.0
,,2,,,Unknown,,cid:12)(cid:29)(cid:26)(cid:41)(cid:25)(cid:2)(cid:53)(cid:53)(cid:37)(cid:16)(cid:34)(cid:33,,13831.0
,,53,,,Unknown,,cid:12)(cid:29)(cid:26)(cid:41)(cid:25)(cid:2)(cid:53)(cid:53)(cid:37)(cid:16)(cid:34)(cid:33,,13884.0
,,53,,,Unknown,,cid:12)(cid:29)(cid:26)(cid:41)(cid:25)(cid:2)(cid:53)(cid:53)(cid:37)(cid:16)(cid:34)(cid:33,,13937.0
,,37,,,Unknown,,cid:12)(cid:29)(cid:26)(cid:41)(cid:25)(cid:2)(cid:53)(cid:53)(cid:37)(cid:16)(cid:34)(cid:33,,13974.0
,,16,,,Unknown,,cid:12)(cid:29)(cid:26)(cid:41)(cid:25)(cid:2)(cid:53)(cid:53)(cid:37)(cid:16)(cid:34)(cid:33,,13990.0
,,34,,,Unknown,,cid:12)(cid:29)(cid:26)(cid:41)(cid:25)(cid:2)(cid:53)(cid:53)(cid:37)(cid:16)(cid:34)(cid:33,,14024.0
,,33,,,Unknown,,cid:12)(cid:29)(cid:26)(cid:41)(cid:25)(cid:2)(cid:53)(cid:53)(cid:37)(cid:16)(cid:34)(cid:33,,14057.0
,,1,,,Unknown,,cid:12)(cid:29)(cid:26)(cid:41)(cid:25)(cid:2)(cid:53)(cid:53)(cid:37)(cid:16)(cid:34)(cid:33,,14058.0
,,35,,,Unknown,,cid:12)(cid:29)(cid:26)(cid:41)(cid:25)(cid:2)(cid:53)(cid:53)(cid:37)(cid:16)(cid:34)(cid:33,,14093.0
,,45,,,Unknown,,cid:12)(cid:29)(cid:26)(cid:41)(cid:25)(cid:2)(cid:53)(cid:53)(cid:37)(cid:16)(cid:34)(cid:33,,14138.0
,,18,,,Unknown,,cid:12)(cid:29)(cid:26)(cid:41)(cid:25)(cid:2)(cid:53)(cid:53)(cid:37)(cid:16)(cid:34)(cid:33,,14156.0
,,34,,,Unknown,,cid:12)(cid:29)(cid:26)(cid:41)(cid:25)(cid:2)(cid:53)(cid:53)(cid:37)(cid:16)(cid:34)(cid:33,,14190.0
,,27,,,Unknown,,cid:12)(cid:29)(cid:26)(cid:41)(cid:25)(cid:2)(cid:53)(cid:53)(cid:37)(cid:16)(cid:34)(cid:33,,14217.0
,,29,,,Unknown,,cid:12)(cid:29)(cid:26)(cid:41)(cid:25)(cid:2)(cid:53)(cid:53)(cid:37)(cid:16)(cid:34)(cid:33,,14246.0
,,26,,,Unknown,,cid:12)(cid:29)(cid:26)(cid:41)(cid:25)(cid:2)(cid:53)(cid:53)(cid:37)(cid:16)(cid:34)(cid:33,,14272.0
,,22,,,Unknown,,cid:12)(cid:29)(cid:26)(cid:41)(cid:25)(cid:2)(cid:53)(cid:53)(cid:37)(cid:16)(cid:34)(cid:33,,14294.0
,,2,,,Unknown,,cid:12)(cid:29)(cid:26)(cid:41)(cid:25)(cid:2)(cid:53)(cid:53)(cid:37)(cid:16)(cid:34)(cid:33,,14296.0
,,27,,,Unknown,,cid:12)(cid:29)(cid:26)(cid:41)(cid:25)(cid:2)(cid:53)(cid:53)(cid:37)(cid:16)(cid:34)(cid:33,,14323.0
,,72,,,Unknown,,cid:12)(cid:29)(cid:26)(cid:41)(cid:25)(cid:2)(cid:53)(cid:53)(cid:37)(cid:16)(cid:34)(cid:33,,14395.0
,,22,,,Unknown,,cid:12)(cid:29)(cid:26)(cid:41)(cid:25)(cid:2)(cid:53)(cid:53)(cid:37)(cid:16)(cid:34)(cid:33,,14417.0
,,48,,,Unknown,,cid:12)(cid:29)(cid:26)(cid:41)(cid:25)(cid:2)(cid:53)(cid:53)(cid:37)(cid:16)(cid:34)(cid:33,,14465.0
,,25,,,Unknown,,cid:12)(cid:29)(cid:26)(cid:41)(cid:25)(cid:2)(cid:53)(cid:53)(cid:37)(cid:16)(cid:34)(cid:33,,14490.0
,,73,,,Unknown,,cid:12)(cid:29)(cid:26)(cid:41)(cid:25)(cid:2)(cid:53)(cid:53)(cid:37)(cid:16)(cid:34)(cid:33,,14563.0
,,55,,,Unknown,,cid:12)(cid:29)(cid:26)(cid:41)(cid:25)(cid:2)(cid:53)(cid:53)(cid:37)(cid:16)(cid:34)(cid:33,,14618.0
,,20,,,Unknown,,cid:12)(cid:29)(cid:26)(cid:41)(cid:25)(cid:2)(cid:53)(cid:53)(cid:37)(cid:16)(cid:34)(cid:33,,14638.0
,,26,,,Unknown,,cid:12)(cid:29)(cid:26)(cid:41)(cid:25)(cid:2)(cid:53)(cid:53)(cid:37)(cid:16)(cid:34)(cid:33,,14664.0
,,41,,,Unknown,,cid:12)(cid:29)(cid:26)(cid:41)(cid:25)(cid:2)(cid:53)(cid:53)(cid:37)(cid:16)(cid:34)(cid:33,,14705.0
,,15,,,Unknown,,cid:12)(cid:29)(cid:26)(cid:41)(cid:25)(cid:2)(cid:53)(cid:53)(cid:37)(cid:16)(cid:34)(cid:33,,14720.0
,,2,,,Unknown,,cid:12)(cid:29)(cid:26)(cid:41)(cid:25)(cid:2)(cid:53)(cid:53)(cid:37)(cid:16)(cid:34)(cid:33,,14722.0
,,1,,,Unknown,,cid:12)(cid:29)(cid:26)(cid:41)(cid:25)(cid:2)(cid:53)(cid:53)(cid:37)(cid:16)(cid:34)(cid:33,,14723.0
,,18,,,Unknown,,cid:12)(cid:29)(cid:26)(cid:41)(cid:25)(cid:2)(cid:53)(cid:53)(cid:37)(cid:16)(cid:34)(cid:33,,14741.0
,,2,,,Unknown,,cid:12)(cid:29)(cid:26)(cid:41)(cid:25)(cid:2)(cid:53)(cid:53)(cid:37)(cid:16)(cid:34)(cid:33,,14743.0
,,18,,,Unknown,,cid:12)(cid:29)(cid:26)(cid:41)(cid:25)(cid:2)(cid:53)(cid:53)(cid:37)(cid:16)(cid:34)(cid:33,,14761.0
,,18,,,Unknown,,cid:12)(cid:29)(cid:26)(cid:41)(cid:25)(cid:2)(cid:53)(cid:53)(cid:37)(cid:16)(cid:34)(cid:33,,14779.0
,,18,,,Unknown,,cid:12)(cid:29)(cid:26)(cid:41)(cid:25)(cid:2)(cid:53)(cid:53)(cid:37)(cid:16)(cid:34)(cid:33,,14797.0
,,19,,,Unknown,,cid:12)(cid:29)(cid:26)(cid:41)(cid:25)(cid:2)(cid:53)(cid:53)(cid:37)(cid:16)(cid:34)(cid:33,,14816.0
,,18,,,Unknown,,cid:12)(cid:29)(cid:26)(cid:41)(cid:25)(cid:2)(cid:53)(cid:53)(cid:37)(cid:16)(cid:34)(cid:33,,14834.0
,,18,,,Unknown,,cid:12)(cid:29)(cid:26)(cid:41)(cid:25)(cid:2)(cid:53)(cid:53)(cid:37)(cid:16)(cid:34)(cid:33,,14852.0
,,2,,,Unknown,,cid:12)(cid:29)(cid:26)(cid:41)(cid:25)(cid:2)(cid:53)(cid:53)(cid:37)(cid:16)(cid:34)(cid:33,,14854.0
,,44,,,Unknown,,cid:12)(cid:29)(cid:26)(cid:41)(cid:25)(cid:2)(cid:53)(cid:53)(cid:37)(cid:16)(cid:34)(cid:33,,14898.0
,,55,,,Unknown,,cid:12)(cid:29)(cid:26)(cid:41)(cid:25)(cid:2)(cid:53)(cid:53)(cid:37)(cid:16)(cid:34)(cid:33,,14953.0
,,29,,,Unknown,,cid:12)(cid:29)(cid:26)(cid:41)(cid:25)(cid:2)(cid:53)(cid:53)(cid:37)(cid:16)(cid:34)(cid:33,,14982.0
,,24,,,Unknown,,cid:12)(cid:29)(cid:26)(cid:41)(cid:25)(cid:2)(cid:53)(cid:53)(cid:37)(cid:16)(cid:34)(cid:33,,15006.0
,,25,,,Unknown,,cid:12)(cid:29)(cid:26)(cid:41)(cid:25)(cid:2)(cid:53)(cid:53)(cid:37)(cid:16)(cid:34)(cid:33,,15031.0
,,23,,,Unknown,,cid:12)(cid:29)(cid:26)(cid:41)(cid:25)(cid:2)(cid:53)(cid:53)(cid:37)(cid:16)(cid:34)(cid:33,,15054.0
,,25,,,Unknown,,cid:12)(cid:29)(cid:26)(cid:41)(cid:25)(cid:2)(cid:53)(cid:53)(cid:37)(cid:16)(cid:34)(cid:33,,15079.0
,,30,,,Unknown,,cid:12)(cid:29)(cid:26)(cid:41)(cid:25)(cid:2)(cid:53)(cid:53)(cid:37)(cid:16)(cid:34)(cid:33,,15109.0
,,41,,,Unknown,,cid:12)(cid:29)(cid:26)(cid:41)(cid:25)(cid:2)(cid:53)(cid:53)(cid:37)(cid:16)(cid:34)(cid:33,,15150.0
,,2,,,Unknown,,cid:12)(cid:29)(cid:26)(cid:41)(cid:25)(cid:2)(cid:53)(cid:53)(cid:37)(cid:16)(cid:34)(cid:33,,15152.0
,,50,,,Unknown,,cid:12)(cid:29)(cid:26)(cid:41)(cid:25)(cid:2)(cid:53)(cid:53)(cid:37)(cid:16)(cid:34)(cid:33,,15202.0
,,20,,,Unknown,,cid:12)(cid:29)(cid:26)(cid:41)(cid:25)(cid:2)(cid:53)(cid:53)(cid:37)(cid:16)(cid:34)(cid:33,,15222.0
,,24,,,Unknown,,cid:12)(cid:29)(cid:26)(cid:41)(cid:25)(cid:2)(cid:53)(cid:53)(cid:37)(cid:16)(cid:34)(cid:33,,15246.0
,,27,,,Unknown,,cid:12)(cid:29)(cid:26)(cid:41)(cid:25)(cid:2)(cid:53)(cid:53)(cid:37)(cid:16)(cid:34)(cid:33,,15273.0
,,1,,,Unknown,,cid:12)(cid:29)(cid:26)(cid:41)(cid:25)(cid:2)(cid:53)(cid:53)(cid:37)(cid:16)(cid:34)(cid:33,,15274.0
,,35,,,Unknown,,cid:12)(cid:29)(cid:26)(cid:41)(cid:25)(cid:2)(cid:53)(cid:53)(cid:37)(cid:16)(cid:34)(cid:33,,15309.0
,,45,,,Unknown,,cid:12)(cid:29)(cid:26)(cid:41)(cid:25)(cid:2)(cid:53)(cid:53)(cid:37)(cid:16)(cid:34)(cid:33,,15354.0
,,18,,,Unknown,,cid:12)(cid:29)(cid:26)(cid:41)(cid:25)(cid:2)(cid:53)(cid:53)(cid:37)(cid:16)(cid:34)(cid:33,,15372.0
,,34,,,Unknown,,cid:12)(cid:29)(cid:26)(cid:41)(cid:25)(cid:2)(cid:53)(cid:53)(cid:37)(cid:16)(cid:34)(cid:33,,15406.0
,,5,,,Unknown,,cid:12)(cid:29)(cid:26)(cid:41)(cid:25)(cid:2)(cid:53)(cid:53)(cid:37)(cid:16)(cid:34)(cid:33,,15411.0
,,74,,,Unknown,,cid:12)(cid:29)(cid:26)(cid:41)(cid:25)(cid:2)(cid:53)(cid:53)(cid:37)(cid:16)(cid:34)(cid:33,,15485.0
,,14,,,Unknown,,cid:12)(cid:29)(cid:26)(cid:41)(cid:25)(cid:2)(cid:53)(cid:53)(cid:37)(cid:16)(cid:34)(cid:33,,15499.0
,,5,,,Unknown,,cid:12)(cid:29)(cid:26)(cid:41)(cid:25)(cid:2)(cid:53)(cid:53)(cid:37)(cid:16)(cid:34)(cid:33,,15504.0
,,12,,,Unknown,,cid:12)(cid:29)(cid:26)(cid:41)(cid:25)(cid:2)(cid:53)(cid:53)(cid:37)(cid:16)(cid:34)(cid:33,,15516.0
,,14,,,Unknown,,cid:12)(cid:29)(cid:26)(cid:41)(cid:25)(cid:2)(cid:53)(cid:53)(cid:37)(cid:16)(cid:34)(cid:33,,15530.0
,,5,,,Unknown,,cid:12)(cid:29)(cid:26)(cid:41)(cid:25)(cid:2)(cid:53)(cid:53)(cid:37)(cid:16)(cid:34)(cid:33,,15535.0
,,3,,,Unknown,,cid:12)(cid:29)(cid:26)(cid:41)(cid:25)(cid:2)(cid:53)(cid:53)(cid:37)(cid:16)(cid:34)(cid:33,,15538.0
,,12,,,Unknown,,cid:12)(cid:29)(cid:26)(cid:41)(cid:25)(cid:2)(cid:53)(cid:53)(cid:37)(cid:16)(cid:34)(cid:33,,15550.0
,,2,,,Unknown,,cid:12)(cid:29)(cid:26)(cid:41)(cid:25)(cid:2)(cid:53)(cid:53)(cid:37)(cid:16)(cid:34)(cid:33,,15552.0
,,39,,,Unknown,,cid:12)(cid:29)(cid:26)(cid:41)(cid:25)(cid:2)(cid:53)(cid:53)(cid:37)(cid:16)(cid:34)(cid:33,,15591.0
,,3,,,Unknown,,cid:12)(cid:29)(cid:26)(cid:41)(cid:25)(cid:2)(cid:53)(cid:53)(cid:37)(cid:16)(cid:34)(cid:33,,15594.0
,,11,,,Unknown,,cid:12)(cid:29)(cid:26)(cid:41)(cid:25)(cid:2)(cid:53)(cid:53)(cid:37)(cid:16)(cid:34)(cid:33,,15605.0
,,63,,,Unknown,,cid:12)(cid:29)(cid:26)(cid:41)(cid:25)(cid:2)(cid:53)(cid:53)(cid:37)(cid:16)(cid:34)(cid:33,,15668.0
,,7,,,Unknown,,cid:12)(cid:29)(cid:26)(cid:41)(cid:25)(cid:2)(cid:53)(cid:53)(cid:37)(cid:16)(cid:34)(cid:33,,15675.0
,,8,,,Unknown,,cid:12)(cid:29)(cid:26)(cid:41)(cid:25)(cid:2)(cid:53)(cid:53)(cid:37)(cid:16)(cid:34)(cid:33,,15683.0
,,9,,,Unknown,,cid:12)(cid:29)(cid:26)(cid:41)(cid:25)(cid:2)(cid:53)(cid:53)(cid:37)(cid:16)(cid:34)(cid:33,,15692.0
,,2,,,Unknown,,cid:12)(cid:29)(cid:26)(cid:41)(cid:25)(cid:2)(cid:53)(cid:53)(cid:37)(cid:16)(cid:34)(cid:33,,15694.0
,,28,,,Unknown,,cid:12)(cid:29)(cid:26)(cid:41)(cid:25)(cid:2)(cid:53)(cid:53)(cid:37)(cid:16)(cid:34)(cid:33,,15722.0
,,3,,,Unknown,,cid:12)(cid:29)(cid:26)(cid:41)(cid:25)(cid:2)(cid:53)(cid:53)(cid:37)(cid:16)(cid:34)(cid:33,,15725.0
,,15,,,Unknown,,cid:12)(cid:29)(cid:26)(cid:41)(cid:25)(cid:2)(cid:53)(cid:53)(cid:37)(cid:16)(cid:34)(cid:33,,15740.0
,,2,,,Unknown,,cid:12)(cid:29)(cid:26)(cid:41)(cid:25)(cid:2)(cid:53)(cid:53)(cid:37)(cid:16)(cid:34)(cid:33,,15742.0
,,17,,,Unknown,,cid:12)(cid:29)(cid:26)(cid:41)(cid:25)(cid:2)(cid:53)(cid:53)(cid:37)(cid:16)(cid:34)(cid:33,,15759.0
,,34,,,Unknown,,cid:12)(cid:29)(cid:26)(cid:41)(cid:25)(cid:2)(cid:53)(cid:53)(cid:37)(cid:16)(cid:34)(cid:33,,15793.0
,,19,,,Unknown,,cid:12)(cid:29)(cid:26)(cid:41)(cid:25)(cid:2)(cid:53)(cid:53)(cid:37)(cid:16)(cid:34)(cid:33,,15812.0
,,36,,,Unknown,,cid:12)(cid:29)(cid:26)(cid:41)(cid:25)(cid:2)(cid:53)(cid:53)(cid:37)(cid:16)(cid:34)(cid:33,,15848.0
,,34,,,Unknown,,cid:12)(cid:29)(cid:26)(cid:41)(cid:25)(cid:2)(cid:53)(cid:53)(cid:37)(cid:16)(cid:34)(cid:33,,15882.0
,,2,,,Unknown,,cid:12)(cid:29)(cid:26)(cid:41)(cid:25)(cid:2)(cid:53)(cid:53)(cid:37)(cid:16)(cid:34)(cid:33,,15884.0
,,44,,,Unknown,,cid:12)(cid:29)(cid:26)(cid:41)(cid:25)(cid:2)(cid:53)(cid:53)(cid:37)(cid:16)(cid:34)(cid:33,,15928.0
,,12,,,Unknown,,cid:12)(cid:29)(cid:26)(cid:41)(cid:25)(cid:2)(cid:53)(cid:53)(cid:37)(cid:16)(cid:34)(cid:33,,15940.0
,,29,,,Unknown,,cid:12)(cid:29)(cid:26)(cid:41)(cid:25)(cid:2)(cid:53)(cid:53)(cid:37)(cid:16)(cid:34)(cid:33,,15969.0
,,26,,,Unknown,,cid:12)(cid:29)(cid:26)(cid:41)(cid:25)(cid:2)(cid:53)(cid:53)(cid:37)(cid:16)(cid:34)(cid:33,,15995.0
,,41,,,Unknown,,cid:12)(cid:29)(cid:26)(cid:41)(cid:25)(cid:2)(cid:53)(cid:53)(cid:37)(cid:16)(cid:34)(cid:33,,16036.0
,,25,,,Unknown,,cid:12)(cid:29)(cid:26)(cid:41)(cid:25)(cid:2)(cid:53)(cid:53)(cid:37)(cid:16)(cid:34)(cid:33,,16061.0
,,2,,,Unknown,,cid:12)(cid:29)(cid:26)(cid:41)(cid:25)(cid:2)(cid:53)(cid:53)(cid:37)(cid:16)(cid:34)(cid:33,,16063.0
,,53,,,Unknown,,cid:12)(cid:29)(cid:26)(cid:41)(cid:25)(cid:2)(cid:53)(cid:53)(cid:37)(cid:16)(cid:34)(cid:33,,16116.0
,,53,,,Unknown,,cid:12)(cid:29)(cid:26)(cid:41)(cid:25)(cid:2)(cid:53)(cid:53)(cid:37)(cid:16)(cid:34)(cid:33,,16169.0
,,18,,,Unknown,,cid:12)(cid:29)(cid:26)(cid:41)(cid:25)(cid:2)(cid:53)(cid:53)(cid:37)(cid:16)(cid:34)(cid:33,,16187.0
,,1,,,Unknown,,cid:12)(cid:29)(cid:26)(cid:41)(cid:25)(cid:2)(cid:53)(cid:53)(cid:37)(cid:16)(cid:34)(cid:33,,16188.0
,,1,,,Unknown,,cid:12)(cid:29)(cid:26)(cid:41)(cid:25)(cid:2)(cid:53)(cid:53)(cid:37)(cid:16)(cid:34)(cid:33,,16189.0
,,37,,,Unknown,,cid:12)(cid:29)(cid:26)(cid:41)(cid:25)(cid:2)(cid:53)(cid:53)(cid:37)(cid:16)(cid:34)(cid:33,,16226.0
,,1,,,Unknown,,cid:12)(cid:29)(cid:26)(cid:41)(cid:25)(cid:2)(cid:53)(cid:53)(cid:37)(cid:16)(cid:34)(cid:33,,16227.0
,,35,,,Unknown,,cid:12)(cid:29)(cid:26)(cid:41)(cid:25)(cid:2)(cid:53)(cid:53)(cid:37)(cid:16)(cid:34)(cid:33,,16262.0
,,45,,,Unknown,,cid:12)(cid:29)(cid:26)(cid:41)(cid:25)(cid:2)(cid:53)(cid:53)(cid:37)(cid:16)(cid:34)(cid:33,,16307.0
,,18,,,Unknown,,cid:12)(cid:29)(cid:26)(cid:41)(cid:25)(cid:2)(cid:53)(cid:53)(cid:37)(cid:16)(cid:34)(cid:33,,16325.0
,,34,,,Unknown,,cid:12)(cid:29)(cid:26)(cid:41)(cid:25)(cid:2)(cid:53)(cid:53)(cid:37)(cid:16)(cid:34)(cid:33,,16359.0
,,9,,,Unknown,,cid:12)(cid:29)(cid:26)(cid:41)(cid:25)(cid:2)(cid:53)(cid:53)(cid:37)(cid:16)(cid:34)(cid:33,,16368.0
,,49,,,Unknown,,cid:12)(cid:29)(cid:26)(cid:41)(cid:25)(cid:2)(cid:53)(cid:53)(cid:37)(cid:16)(cid:34)(cid:33,,16417.0
,,8,,,Unknown,,cid:12)(cid:29)(cid:26)(cid:41)(cid:25)(cid:2)(cid:53)(cid:53)(cid:37)(cid:16)(cid:34)(cid:33,,16425.0
,,5,,,Unknown,,cid:12)(cid:29)(cid:26)(cid:41)(cid:25)(cid:2)(cid:53)(cid:53)(cid:37)(cid:16)(cid:34)(cid:33,,16430.0
,,28,,,Unknown,,cid:12)(cid:29)(cid:26)(cid:41)(cid:25)(cid:2)(cid:53)(cid:53)(cid:37)(cid:16)(cid:34)(cid:33,,16458.0
,,2,,,Unknown,,cid:12)(cid:29)(cid:26)(cid:41)(cid:25)(cid:2)(cid:53)(cid:53)(cid:37)(cid:16)(cid:34)(cid:33,,16460.0
,,9,,,Unknown,,cid:12)(cid:29)(cid:26)(cid:41)(cid:25)(cid:2)(cid:53)(cid:53)(cid:37)(cid:16)(cid:34)(cid:33,,16469.0
,,5,,,Unknown,,cid:12)(cid:29)(cid:26)(cid:41)(cid:25)(cid:2)(cid:53)(cid:53)(cid:37)(cid:16)(cid:34)(cid:33,,16474.0
,,8,,,Unknown,,cid:12)(cid:29)(cid:26)(cid:41)(cid:25)(cid:2)(cid:53)(cid:53)(cid:37)(cid:16)(cid:34)(cid:33,,16482.0
,,14,,,Unknown,,cid:12)(cid:29)(cid:26)(cid:41)(cid:25)(cid:2)(cid:53)(cid:53)(cid:37)(cid:16)(cid:34)(cid:33,,16496.0
,,7,,,Unknown,,cid:12)(cid:29)(cid:26)(cid:41)(cid:25)(cid:2)(cid:53)(cid:53)(cid:37)(cid:16)(cid:34)(cid:33,,16503.0
,,9,,,Unknown,,cid:12)(cid:29)(cid:26)(cid:41)(cid:25)(cid:2)(cid:53)(cid:53)(cid:37)(cid:16)(cid:34)(cid:33,,16512.0
,,2,,,Unknown,,cid:12)(cid:29)(cid:26)(cid:41)(cid:25)(cid:2)(cid:53)(cid:53)(cid:37)(cid:16)(cid:34)(cid:33,,16514.0
,,28,,,Unknown,,cid:12)(cid:29)(cid:26)(cid:41)(cid:25)(cid:2)(cid:53)(cid:53)(cid:37)(cid:16)(cid:34)(cid:33,,16542.0
,,3,,,Unknown,,cid:12)(cid:29)(cid:26)(cid:41)(cid:25)(cid:2)(cid:53)(cid:53)(cid:37)(cid:16)(cid:34)(cid:33,,16545.0
,,15,,,Unknown,,cid:12)(cid:29)(cid:26)(cid:41)(cid:25)(cid:2)(cid:53)(cid:53)(cid:37)(cid:16)(cid:34)(cid:33,,16560.0
,,2,,,Unknown,,cid:12)(cid:29)(cid:26)(cid:41)(cid:25)(cid:2)(cid:53)(cid:53)(cid:37)(cid:16)(cid:34)(cid:33,,16562.0
,,37,,,Unknown,,cid:12)(cid:29)(cid:26)(cid:41)(cid:25)(cid:2)(cid:53)(cid:53)(cid:37)(cid:16)(cid:34)(cid:33,,16599.0
,,19,,,Unknown,,cid:12)(cid:29)(cid:26)(cid:41)(cid:25)(cid:2)(cid:53)(cid:53)(cid:37)(cid:16)(cid:34)(cid:33,,16618.0
,,34,,,Unknown,,cid:12)(cid:29)(cid:26)(cid:41)(cid:25)(cid:2)(cid:53)(cid:53)(cid:37)(cid:16)(cid:34)(cid:33,,16652.0
,,18,,,Unknown,,cid:12)(cid:29)(cid:26)(cid:41)(cid:25)(cid:2)(cid:53)(cid:53)(cid:37)(cid:16)(cid:34)(cid:33,,16670.0
,,2,,,Unknown,,cid:12)(cid:29)(cid:26)(cid:41)(cid:25)(cid:2)(cid:53)(cid:53)(cid:37)(cid:16)(cid:34)(cid:33,,16672.0
,,44,,,Unknown,,cid:12)(cid:29)(cid:26)(cid:41)(cid:25)(cid:2)(cid:53)(cid:53)(cid:37)(cid:16)(cid:34)(cid:33,,16716.0
,,12,,,Unknown,,cid:12)(cid:29)(cid:26)(cid:41)(cid:25)(cid:2)(cid:53)(cid:53)(cid:37)(cid:16)(cid:34)(cid:33,,16728.0
,,29,,,Unknown,,cid:12)(cid:29)(cid:26)(cid:41)(cid:25)(cid:2)(cid:53)(cid:53)(cid:37)(cid:16)(cid:34)(cid:33,,16757.0
,,26,,,Unknown,,cid:12)(cid:29)(cid:26)(cid:41)(cid:25)(cid:2)(cid:53)(cid:53)(cid:37)(cid:16)(cid:34)(cid:33,,16783.0
,,41,,,Unknown,,cid:12)(cid:29)(cid:26)(cid:41)(cid:25)(cid:2)(cid:53)(cid:53)(cid:37)(cid:16)(cid:34)(cid:33,,16824.0
,,25,,,Unknown,,cid:12)(cid:29)(cid:26)(cid:41)(cid:25)(cid:2)(cid:53)(cid:53)(cid:37)(cid:16)(cid:34)(cid:33,,16849.0
,,2,,,Unknown,,cid:12)(cid:29)(cid:26)(cid:41)(cid:25)(cid:2)(cid:53)(cid:53)(cid:37)(cid:16)(cid:34)(cid:33,,16851.0
,,53,,,Unknown,,cid:12)(cid:29)(cid:26)(cid:41)(cid:25)(cid:2)(cid:53)(cid:53)(cid:37)(cid:16)(cid:34)(cid:33,,16904.0
,,53,,,Unknown,,cid:12)(cid:29)(cid:26)(cid:41)(cid:25)(cid:2)(cid:53)(cid:53)(cid:37)(cid:16)(cid:34)(cid:33,,16957.0
,,18,,,Unknown,,cid:12)(cid:29)(cid:26)(cid:41)(cid:25)(cid:2)(cid:53)(cid:53)(cid:37)(cid:16)(cid:34)(cid:33,,16975.0
,,1,,,Unknown,,cid:12)(cid:29)(cid:26)(cid:41)(cid:25)(cid:2)(cid:53)(cid:53)(cid:37)(cid:16)(cid:34)(cid:33,,16976.0
,,1,,,Unknown,,cid:12)(cid:29)(cid:26)(cid:41)(cid:25)(cid:2)(cid:53)(cid:53)(cid:37)(cid:16)(cid:34)(cid:33,,16977.0
,,37,,,Unknown,,cid:12)(cid:29)(cid:26)(cid:41)(cid:25)(cid:2)(cid:53)(cid:53)(cid:37)(cid:16)(cid:34)(cid:33,,17014.0
,,1,,,Unknown,,cid:12)(cid:29)(cid:26)(cid:41)(cid:25)(cid:2)(cid:53)(cid:53)(cid:37)(cid:16)(cid:34)(cid:33,,17015.0
,,35,,,Unknown,,cid:12)(cid:29)(cid:26)(cid:41)(cid:25)(cid:2)(cid:53)(cid:53)(cid:37)(cid:16)(cid:34)(cid:33,,17050.0
,,45,,,Unknown,,cid:12)(cid:29)(cid:26)(cid:41)(cid:25)(cid:2)(cid:53)(cid:53)(cid:37)(cid:16)(cid:34)(cid:33,,17095.0
,,18,,,Unknown,,cid:12)(cid:29)(cid:26)(cid:41)(cid:25)(cid:2)(cid:53)(cid:53)(cid:37)(cid:16)(cid:34)(cid:33,,17113.0
,,34,,,Unknown,,cid:12)(cid:29)(cid:26)(cid:41)(cid:25)(cid:2)(cid:53)(cid:53)(cid:37)(cid:16)(cid:34)(cid:33,,17147.0
,,14,,,Unknown,,cid:12)(cid:29)(cid:26)(cid:41)(cid:25)(cid:2)(cid:53)(cid:53)(cid:37)(cid:16)(cid:34)(cid:33,,17161.0
,,5,,,Unknown,,cid:12)(cid:29)(cid:26)(cid:41)(cid:25)(cid:2)(cid:53)(cid:53)(cid:37)(cid:16)(cid:34)(cid:33,,17166.0
,,12,,,Unknown,,cid:12)(cid:29)(cid:26)(cid:41)(cid:25)(cid:2)(cid:53)(cid:53)(cid:37)(cid:16)(cid:34)(cid:33,,17178.0
,,14,,,Unknown,,cid:12)(cid:29)(cid:26)(cid:41)(cid:25)(cid:2)(cid:53)(cid:53)(cid:37)(cid:16)(cid:34)(cid:33,,17192.0
,,5,,,Unknown,,cid:12)(cid:29)(cid:26)(cid:41)(cid:25)(cid:2)(cid:53)(cid:53)(cid:37)(cid:16)(cid:34)(cid:33,,17197.0
,,3,,,Unknown,,cid:12)(cid:29)(cid:26)(cid:41)(cid:25)(cid:2)(cid:53)(cid:53)(cid:37)(cid:16)(cid:34)(cid:33,,17200.0
,,12,,,Unknown,,cid:12)(cid:29)(cid:26)(cid:41)(cid:25)(cid:2)(cid:53)(cid:53)(cid:37)(cid:16)(cid:34)(cid:33,,17212.0
,,2,,,Unknown,,cid:12)(cid:29)(cid:26)(cid:41)(cid:25)(cid:2)(cid:53)(cid:53)(cid:37)(cid:16)(cid:34)(cid:33,,17214.0
,,28,,,Unknown,,cid:12)(cid:29)(cid:26)(cid:41)(cid:25)(cid:2)(cid:53)(cid:53)(cid:37)(cid:16)(cid:34)(cid:33,,17242.0
,,5,,,Unknown,,cid:12)(cid:29)(cid:26)(cid:41)(cid:25)(cid:2)(cid:53)(cid:53)(cid:37)(cid:16)(cid:34)(cid:33,,17247.0
,,3,,,Unknown,,cid:12)(cid:29)(cid:26)(cid:41)(cid:25)(cid:2)(cid:53)(cid:53)(cid:37)(cid:16)(cid:34)(cid:33,,17250.0
,,10,,,Unknown,,cid:12)(cid:29)(cid:26)(cid:41)(cid:25)(cid:2)(cid:53)(cid:53)(cid:37)(cid:16)(cid:34)(cid:33,,17260.0
,,5,,,Unknown,,cid:12)(cid:29)(cid:26)(cid:41)(cid:25)(cid:2)(cid:53)(cid:53)(cid:37)(cid:16)(cid:34)(cid:33,,17265.0
,,2,,,Unknown,,cid:12)(cid:29)(cid:26)(cid:41)(cid:25)(cid:2)(cid:53)(cid:53)(cid:37)(cid:16)(cid:34)(cid:33,,17267.0
,,14,,,Unknown,,cid:12)(cid:29)(cid:26)(cid:41)(cid:25)(cid:2)(cid:53)(cid:53)(cid:37)(cid:16)(cid:34)(cid:33,,17281.0
,,49,,,Unknown,,cid:12)(cid:29)(cid:26)(cid:41)(cid:25)(cid:2)(cid:53)(cid:53)(cid:37)(cid:16)(cid:34)(cid:33,,17330.0
,,2,,,Unknown,,cid:12)(cid:29)(cid:26)(cid:41)(cid:25)(cid:2)(cid:53)(cid:53)(cid:37)(cid:16)(cid:34)(cid:33,,17332.0
,,28,,,Unknown,,cid:12)(cid:29)(cid:26)(cid:41)(cid:25)(cid:2)(cid:53)(cid:53)(cid:37)(cid:16)(cid:34)(cid:33,,17360.0
,,5,,,Unknown,,cid:12)(cid:29)(cid:26)(cid:41)(cid:25)(cid:2)(cid:53)(cid:53)(cid:37)(cid:16)(cid:34)(cid:33,,17365.0
,,3,,,Unknown,,cid:12)(cid:29)(cid:26)(cid:41)(cid:25)(cid:2)(cid:53)(cid:53)(cid:37)(cid:16)(cid:34)(cid:33,,17368.0
,,10,,,Unknown,,cid:12)(cid:29)(cid:26)(cid:41)(cid:25)(cid:2)(cid:53)(cid:53)(cid:37)(cid:16)(cid:34)(cid:33,,17378.0
,,5,,,Unknown,,cid:12)(cid:29)(cid:26)(cid:41)(cid:25)(cid:2)(cid:53)(cid:53)(cid:37)(cid:16)(cid:34)(cid:33,,17383.0
,,2,,,Unknown,,cid:12)(cid:29)(cid:26)(cid:41)(cid:25)(cid:2)(cid:53)(cid:53)(cid:37)(cid:16)(cid:34)(cid:33,,17385.0
,,9,,,Unknown,,cid:12)(cid:29)(cid:26)(cid:41)(cid:25)(cid:2)(cid:53)(cid:53)(cid:37)(cid:16)(cid:34)(cid:33,,17394.0
,,2,,,Unknown,,cid:12)(cid:29)(cid:26)(cid:41)(cid:25)(cid:2)(cid:53)(cid:53)(cid:37)(cid:16)(cid:34)(cid:33,,17396.0
,,28,,,Unknown,,cid:12)(cid:29)(cid:26)(cid:41)(cid:25)(cid:2)(cid:53)(cid:53)(cid:37)(cid:16)(cid:34)(cid:33,,17424.0
,,3,,,Unknown,,cid:12)(cid:29)(cid:26)(cid:41)(cid:25)(cid:2)(cid:53)(cid:53)(cid:37)(cid:16)(cid:34)(cid:33,,17427.0
,,15,,,Unknown,,cid:12)(cid:29)(cid:26)(cid:41)(cid:25)(cid:2)(cid:53)(cid:53)(cid:37)(cid:16)(cid:34)(cid:33,,17442.0
,,2,,,Unknown,,cid:12)(cid:29)(cid:26)(cid:41)(cid:25)(cid:2)(cid:53)(cid:53)(cid:37)(cid:16)(cid:34)(cid:33,,17444.0
,,37,,,Unknown,,cid:12)(cid:29)(cid:26)(cid:41)(cid:25)(cid:2)(cid:53)(cid:53)(cid:37)(cid:16)(cid:34)(cid:33,,17481.0
,,18,,,Unknown,,cid:12)(cid:29)(cid:26)(cid:41)(cid:25)(cid:2)(cid:53)(cid:53)(cid:37)(cid:16)(cid:34)(cid:33,,17499.0
,,19,,,Unknown,,cid:12)(cid:29)(cid:26)(cid:41)(cid:25)(cid:2)(cid:53)(cid:53)(cid:37)(cid:16)(cid:34)(cid:33,,17518.0
,,16,,,Unknown,,cid:12)(cid:29)(cid:26)(cid:41)(cid:25)(cid:2)(cid:53)(cid:53)(cid:37)(cid:16)(cid:34)(cid:33,,17534.0
,,1,,,Unknown,,cid:12)(cid:29)(cid:26)(cid:41)(cid:25)(cid:2)(cid:53)(cid:53)(cid:37)(cid:16)(cid:34)(cid:33,,17535.0
,,2,,,Unknown,,cid:12)(cid:29)(cid:26)(cid:41)(cid:25)(cid:2)(cid:53)(cid:53)(cid:37)(cid:16)(cid:34)(cid:33,,17537.0
,,44,,,Unknown,,cid:12)(cid:29)(cid:26)(cid:41)(cid:25)(cid:2)(cid:53)(cid:53)(cid:37)(cid:16)(cid:34)(cid:33,,17581.0
,,12,,,Unknown,,cid:12)(cid:29)(cid:26)(cid:41)(cid:25)(cid:2)(cid:53)(cid:53)(cid:37)(cid:16)(cid:34)(cid:33,,17593.0
,,29,,,Unknown,,cid:12)(cid:29)(cid:26)(cid:41)(cid:25)(cid:2)(cid:53)(cid:53)(cid:37)(cid:16)(cid:34)(cid:33,,17622.0
,,26,,,Unknown,,cid:12)(cid:29)(cid:26)(cid:41)(cid:25)(cid:2)(cid:53)(cid:53)(cid:37)(cid:16)(cid:34)(cid:33,,17648.0
,,41,,,Unknown,,cid:12)(cid:29)(cid:26)(cid:41)(cid:25)(cid:2)(cid:53)(cid:53)(cid:37)(cid:16)(cid:34)(cid:33,,17689.0
,,25,,,Unknown,,cid:12)(cid:29)(cid:26)(cid:41)(cid:25)(cid:2)(cid:53)(cid:53)(cid:37)(cid:16)(cid:34)(cid:33,,17714.0
,,2,,,Unknown,,cid:12)(cid:29)(cid:26)(cid:41)(cid:25)(cid:2)(cid:53)(cid:53)(cid:37)(cid:16)(cid:34)(cid:33,,17716.0
,,53,,,Unknown,,cid:12)(cid:29)(cid:26)(cid:41)(cid:25)(cid:2)(cid:53)(cid:53)(cid:37)(cid:16)(cid:34)(cid:33,,17769.0
,,53,,,Unknown,,cid:12)(cid:29)(cid:26)(cid:41)(cid:25)(cid:2)(cid:53)(cid:53)(cid:37)(cid:16)(cid:34)(cid:33,,17822.0
,,18,,,Unknown,,cid:12)(cid:29)(cid:26)(cid:41)(cid:25)(cid:2)(cid:53)(cid:53)(cid:37)(cid:16)(cid:34)(cid:33,,17840.0
,,1,,,Unknown,,cid:12)(cid:29)(cid:26)(cid:41)(cid:25)(cid:2)(cid:53)(cid:53)(cid:37)(cid:16)(cid:34)(cid:33,,17841.0
,,1,,,Unknown,,cid:12)(cid:29)(cid:26)(cid:41)(cid:25)(cid:2)(cid:53)(cid:53)(cid:37)(cid:16)(cid:34)(cid:33,,17842.0
,,37,,,Unknown,,cid:12)(cid:29)(cid:26)(cid:41)(cid:25)(cid:2)(cid:53)(cid:53)(cid:37)(cid:16)(cid:34)(cid:33,,17879.0
,,1,,,Unknown,,cid:12)(cid:29)(cid:26)(cid:41)(cid:25)(cid:2)(cid:53)(cid:53)(cid:37)(cid:16)(cid:34)(cid:33,,17880.0
,,35,,,Unknown,,cid:12)(cid:29)(cid:26)(cid:41)(cid:25)(cid:2)(cid:53)(cid:53)(cid:37)(cid:16)(cid:34)(cid:33,,17915.0
,,45,,,Unknown,,cid:12)(cid:29)(cid:26)(cid:41)(cid:25)(cid:2)(cid:53)(cid:53)(cid:37)(cid:16)(cid:34)(cid:33,,17960.0
,,18,,,Unknown,,cid:12)(cid:29)(cid:26)(cid:41)(cid:25)(cid:2)(cid:53)(cid:53)(cid:37)(cid:16)(cid:34)(cid:33,,17978.0
,,34,,,Unknown,,cid:12)(cid:29)(cid:26)(cid:41)(cid:25)(cid:2)(cid:53)(cid:53)(cid:37)(cid:16)(cid:34)(cid:33,,18012.0
,,9,,,Unknown,,cid:12)(cid:29)(cid:26)(cid:41)(cid:25)(cid:2)(cid:53)(cid:53)(cid:37)(cid:16)(cid:34)(cid:33,,18021.0
,,21,,,Unknown,,cid:12)(cid:29)(cid:26)(cid:41)(cid:25)(cid:2)(cid:53)(cid:53)(cid:37)(cid:16)(cid:34)(cid:33,,18042.0
,,23,,,Unknown,,cid:12)(cid:29)(cid:26)(cid:41)(cid:25)(cid:2)(cid:53)(cid:53)(cid:37)(cid:16)(cid:34)(cid:33,,18065.0
,,4,,,Unknown,,cid:12)(cid:29)(cid:26)(cid:41)(cid:25)(cid:2)(cid:53)(cid:53)(cid:37)(cid:16)(cid:34)(cid:33,,18069.0
,,55,,,Unknown,,cid:12)(cid:29)(cid:26)(cid:41)(cid:25)(cid:2)(cid:53)(cid:53)(cid:37)(cid:16)(cid:34)(cid:33,,18124.0
,,2,,,Unknown,,cid:12)(cid:29)(cid:26)(cid:41)(cid:25)(cid:2)(cid:53)(cid:53)(cid:37)(cid:16)(cid:34)(cid:33,,18126.0
,,53,,,Unknown,,cid:12)(cid:29)(cid:26)(cid:41)(cid:25)(cid:2)(cid:53)(cid:53)(cid:37)(cid:16)(cid:34)(cid:33,,18179.0
,,62,,,Unknown,,cid:12)(cid:29)(cid:26)(cid:41)(cid:25)(cid:2)(cid:53)(cid:53)(cid:37)(cid:16)(cid:34)(cid:33,,18241.0
,,11,,,Unknown,,cid:12)(cid:29)(cid:26)(cid:41)(cid:25)(cid:2)(cid:53)(cid:53)(cid:37)(cid:16)(cid:34)(cid:33,,18252.0
,,10,,,Unknown,,cid:12)(cid:29)(cid:26)(cid:41)(cid:25)(cid:2)(cid:53)(cid:53)(cid:37)(cid:16)(cid:34)(cid:33,,18262.0
,,11,,,Unknown,,cid:12)(cid:29)(cid:26)(cid:41)(cid:25)(cid:2)(cid:53)(cid:53)(cid:37)(cid:16)(cid:34)(cid:33,,18273.0
,,47,,,Unknown,,cid:12)(cid:29)(cid:26)(cid:41)(cid:25)(cid:2)(cid:53)(cid:53)(cid:37)(cid:16)(cid:34)(cid:33,,18320.0
,,3,,,Unknown,,cid:12)(cid:29)(cid:26)(cid:41)(cid:25)(cid:2)(cid:53)(cid:53)(cid:37)(cid:16)(cid:34)(cid:33,,18323.0
,,7,,,Unknown,,cid:12)(cid:29)(cid:26)(cid:41)(cid:25)(cid:2)(cid:53)(cid:53)(cid:37)(cid:16)(cid:34)(cid:33,,18330.0
,,5,,,Unknown,,cid:12)(cid:29)(cid:26)(cid:41)(cid:25)(cid:2)(cid:53)(cid:53)(cid:37)(cid:16)(cid:34)(cid:33,,18335.0
,,2,,,Unknown,,cid:12)(cid:29)(cid:26)(cid:41)(cid:25)(cid:2)(cid:53)(cid:53)(cid:37)(cid:16)(cid:34)(cid:33,,18337.0
,,39,,,Unknown,,cid:12)(cid:29)(cid:26)(cid:41)(cid:25)(cid:2)(cid:53)(cid:53)(cid:37)(cid:16)(cid:34)(cid:33,,18376.0
,,3,,,Unknown,,cid:12)(cid:29)(cid:26)(cid:41)(cid:25)(cid:2)(cid:53)(cid:53)(cid:37)(cid:16)(cid:34)(cid:33,,18379.0
,,11,,,Unknown,,cid:12)(cid:29)(cid:26)(cid:41)(cid:25)(cid:2)(cid:53)(cid:53)(cid:37)(cid:16)(cid:34)(cid:33,,18390.0
,,63,,,Unknown,,cid:12)(cid:29)(cid:26)(cid:41)(cid:25)(cid:2)(cid:53)(cid:53)(cid:37)(cid:16)(cid:34)(cid:33,,18453.0
,,7,,,Unknown,,cid:12)(cid:29)(cid:26)(cid:41)(cid:25)(cid:2)(cid:53)(cid:53)(cid:37)(cid:16)(cid:34)(cid:33,,18460.0
,,2,,,Unknown,,cid:12)(cid:29)(cid:26)(cid:41)(cid:25)(cid:2)(cid:53)(cid:53)(cid:37)(cid:16)(cid:34)(cid:33,,18462.0
,,39,,,Unknown,,cid:12)(cid:29)(cid:26)(cid:41)(cid:25)(cid:2)(cid:53)(cid:53)(cid:37)(cid:16)(cid:34)(cid:33,,18501.0
,,11,,,Unknown,,cid:12)(cid:29)(cid:26)(cid:41)(cid:25)(cid:2)(cid:53)(cid:53)(cid:37)(cid:16)(cid:34)(cid:33,,18512.0
,,7,,,Unknown,,cid:12)(cid:29)(cid:26)(cid:41)(cid:25)(cid:2)(cid:53)(cid:53)(cid:37)(cid:16)(cid:34)(cid:33,,18519.0
,,46,,,Unknown,,cid:12)(cid:29)(cid:26)(cid:41)(cid:25)(cid:2)(cid:53)(cid:53)(cid:37)(cid:16)(cid:34)(cid:33,,18565.0
,,8,,,Unknown,,cid:12)(cid:29)(cid:26)(cid:41)(cid:25)(cid:2)(cid:53)(cid:53)(cid:37)(cid:16)(cid:34)(cid:33,,18573.0
,,65,,,Unknown,,cid:12)(cid:29)(cid:26)(cid:41)(cid:25)(cid:2)(cid:53)(cid:53)(cid:37)(cid:16)(cid:34)(cid:33,,18638.0
,,2,,,Unknown,,cid:12)(cid:29)(cid:26)(cid:41)(cid:25)(cid:2)(cid:53)(cid:53)(cid:37)(cid:16)(cid:34)(cid:33,,18640.0
,,28,,,Unknown,,cid:12)(cid:29)(cid:26)(cid:41)(cid:25)(cid:2)(cid:53)(cid:53)(cid:37)(cid:16)(cid:34)(cid:33,,18668.0
,,3,,,Unknown,,cid:12)(cid:29)(cid:26)(cid:41)(cid:25)(cid:2)(cid:53)(cid:53)(cid:37)(cid:16)(cid:34)(cid:33,,18671.0
,,15,,,Unknown,,cid:12)(cid:29)(cid:26)(cid:41)(cid:25)(cid:2)(cid:53)(cid:53)(cid:37)(cid:16)(cid:34)(cid:33,,18686.0
,,2,,,Unknown,,cid:12)(cid:29)(cid:26)(cid:41)(cid:25)(cid:2)(cid:53)(cid:53)(cid:37)(cid:16)(cid:34)(cid:33,,18688.0
,,37,,,Unknown,,cid:12)(cid:29)(cid:26)(cid:41)(cid:25)(cid:2)(cid:53)(cid:53)(cid:37)(cid:16)(cid:34)(cid:33,,18725.0
,,37,,,Unknown,,cid:12)(cid:29)(cid:26)(cid:41)(cid:25)(cid:2)(cid:53)(cid:53)(cid:37)(cid:16)(cid:34)(cid:33,,18762.0
,,19,,,Unknown,,cid:12)(cid:29)(cid:26)(cid:41)(cid:25)(cid:2)(cid:53)(cid:53)(cid:37)(cid:16)(cid:34)(cid:33,,18781.0
,,17,,,Unknown,,cid:12)(cid:29)(cid:26)(cid:41)(cid:25)(cid:2)(cid:53)(cid:53)(cid:37)(cid:16)(cid:34)(cid:33,,18798.0
,,37,,,Unknown,,cid:12)(cid:29)(cid:26)(cid:41)(cid:25)(cid:2)(cid:53)(cid:53)(cid:37)(cid:16)(cid:34)(cid:33,,18835.0
,,2,,,Unknown,,cid:12)(cid:29)(cid:26)(cid:41)(cid:25)(cid:2)(cid:53)(cid:53)(cid:37)(cid:16)(cid:34)(cid:33,,18837.0
,,44,,,Unknown,,cid:12)(cid:29)(cid:26)(cid:41)(cid:25)(cid:2)(cid:53)(cid:53)(cid:37)(cid:16)(cid:34)(cid:33,,18881.0
,,12,,,Unknown,,cid:12)(cid:29)(cid:26)(cid:41)(cid:25)(cid:2)(cid:53)(cid:53)(cid:37)(cid:16)(cid:34)(cid:33,,18893.0
,,29,,,Unknown,,cid:12)(cid:29)(cid:26)(cid:41)(cid:25)(cid:2)(cid:53)(cid:53)(cid:37)(cid:16)(cid:34)(cid:33,,18922.0
,,26,,,Unknown,,cid:12)(cid:29)(cid:26)(cid:41)(cid:25)(cid:2)(cid:53)(cid:53)(cid:37)(cid:16)(cid:34)(cid:33,,18948.0
,,41,,,Unknown,,cid:12)(cid:29)(cid:26)(cid:41)(cid:25)(cid:2)(cid:53)(cid:53)(cid:37)(cid:16)(cid:34)(cid:33,,18989.0
,,25,,,Unknown,,cid:12)(cid:29)(cid:26)(cid:41)(cid:25)(cid:2)(cid:53)(cid:53)(cid:37)(cid:16)(cid:34)(cid:33,,19014.0
,,2,,,Unknown,,cid:12)(cid:29)(cid:26)(cid:41)(cid:25)(cid:2)(cid:53)(cid:53)(cid:37)(cid:16)(cid:34)(cid:33,,19016.0
,,53,,,Unknown,,cid:12)(cid:29)(cid:26)(cid:41)(cid:25)(cid:2)(cid:53)(cid:53)(cid:37)(cid:16)(cid:34)(cid:33,,19069.0
,,53,,,Unknown,,cid:12)(cid:29)(cid:26)(cid:41)(cid:25)(cid:2)(cid:53)(cid:53)(cid:37)(cid:16)(cid:34)(cid:33,,19122.0
,,18,,,Unknown,,cid:12)(cid:29)(cid:26)(cid:41)(cid:25)(cid:2)(cid:53)(cid:53)(cid:37)(cid:16)(cid:34)(cid:33,,19140.0
,,1,,,Unknown,,cid:12)(cid:29)(cid:26)(cid:41)(cid:25)(cid:2)(cid:53)(cid:53)(cid:37)(cid:16)(cid:34)(cid:33,,19141.0
,,1,,,Unknown,,cid:12)(cid:29)(cid:26)(cid:41)(cid:25)(cid:2)(cid:53)(cid:53)(cid:37)(cid:16)(cid:34)(cid:33,,19142.0
,,37,,,Unknown,,cid:12)(cid:29)(cid:26)(cid:41)(cid:25)(cid:2)(cid:53)(cid:53)(cid:37)(cid:16)(cid:34)(cid:33,,19179.0
,,1,,,Unknown,,cid:12)(cid:29)(cid:26)(cid:41)(cid:25)(cid:2)(cid:53)(cid:53)(cid:37)(cid:16)(cid:34)(cid:33,,19180.0
,,33,,,Unknown,,cid:12)(cid:29)(cid:26)(cid:41)(cid:25)(cid:2)(cid:53)(cid:53)(cid:37)(cid:16)(cid:34)(cid:33,,19213.0
,,45,,,Unknown,,cid:12)(cid:29)(cid:26)(cid:41)(cid:25)(cid:2)(cid:53)(cid:53)(cid:37)(cid:16)(cid:34)(cid:33,,19258.0
,,18,,,Unknown,,cid:12)(cid:29)(cid:26)(cid:41)(cid:25)(cid:2)(cid:53)(cid:53)(cid:37)(cid:16)(cid:34)(cid:33,,19276.0
,,34,,,Unknown,,cid:12)(cid:29)(cid:26)(cid:41)(cid:25)(cid:2)(cid:53)(cid:53)(cid:37)(cid:16)(cid:34)(cid:33,,19310.0
,,12,,,Unknown,,cid:12)(cid:29)(cid:26)(cid:41)(cid:25)(cid:2)(cid:53)(cid:53)(cid:37)(cid:16)(cid:34)(cid:33,,19322.0
,,49,,,Unknown,,cid:12)(cid:29)(cid:26)(cid:41)(cid:25)(cid:2)(cid:53)(cid:53)(cid:37)(cid:16)(cid:34)(cid:33,,19371.0
,,28,,,Unknown,,cid:12)(cid:29)(cid:26)(cid:41)(cid:25)(cid:2)(cid:53)(cid:53)(cid:37)(cid:16)(cid:34)(cid:33,,19399.0
,,5,,,Unknown,,cid:12)(cid:29)(cid:26)(cid:41)(cid:25)(cid:2)(cid:53)(cid:53)(cid:37)(cid:16)(cid:34)(cid:33,,19404.0
,,2,,,Unknown,,cid:12)(cid:29)(cid:26)(cid:41)(cid:25)(cid:2)(cid:53)(cid:53)(cid:37)(cid:16)(cid:34)(cid:33,,19406.0
,,52,,,Unknown,,cid:12)(cid:29)(cid:26)(cid:41)(cid:25)(cid:2)(cid:53)(cid:53)(cid:37)(cid:16)(cid:34)(cid:33,,19458.0
,,5,,,Unknown,,cid:12)(cid:29)(cid:26)(cid:41)(cid:25)(cid:2)(cid:53)(cid:53)(cid:37)(cid:16)(cid:34)(cid:33,,19463.0
,,2,,,Unknown,,cid:12)(cid:29)(cid:26)(cid:41)(cid:25)(cid:2)(cid:53)(cid:53)(cid:37)(cid:16)(cid:34)(cid:33,,19465.0
,,14,,,Unknown,,cid:12)(cid:29)(cid:26)(cid:41)(cid:25)(cid:2)(cid:53)(cid:53)(cid:37)(cid:16)(cid:34)(cid:33,,19479.0
,,68,,,Unknown,,cid:12)(cid:29)(cid:26)(cid:41)(cid:25)(cid:2)(cid:53)(cid:53)(cid:37)(cid:16)(cid:34)(cid:33,,19547.0
,,5,,,Unknown,,cid:12)(cid:29)(cid:26)(cid:41)(cid:25)(cid:2)(cid:53)(cid:53)(cid:37)(cid:16)(cid:34)(cid:33,,19552.0
,,12,,,Unknown,,cid:12)(cid:29)(cid:26)(cid:41)(cid:25)(cid:2)(cid:53)(cid:53)(cid:37)(cid:16)(cid:34)(cid:33,,19564.0
,,4,,,Unknown,,cid:12)(cid:29)(cid:26)(cid:41)(cid:25)(cid:2)(cid:53)(cid:53)(cid:37)(cid:16)(cid:34)(cid:33,,19568.0
,,2,,,Unknown,,cid:12)(cid:29)(cid:26)(cid:41)(cid:25)(cid:2)(cid:53)(cid:53)(cid:37)(cid:16)(cid:34)(cid:33,,19570.0
,,14,,,Unknown,,cid:12)(cid:29)(cid:26)(cid:41)(cid:25)(cid:2)(cid:53)(cid:53)(cid:37)(cid:16)(cid:34)(cid:33,,19584.0
,,49,,,Unknown,,cid:12)(cid:29)(cid:26)(cid:41)(cid:25)(cid:2)(cid:53)(cid:53)(cid:37)(cid:16)(cid:34)(cid:33,,19633.0
,,2,,,Unknown,,cid:12)(cid:29)(cid:26)(cid:41)(cid:25)(cid:2)(cid:53)(cid:53)(cid:37)(cid:16)(cid:34)(cid:33,,19635.0
,,28,,,Unknown,,cid:12)(cid:29)(cid:26)(cid:41)(cid:25)(cid:2)(cid:53)(cid:53)(cid:37)(cid:16)(cid:34)(cid:33,,19663.0
,,5,,,Unknown,,cid:12)(cid:29)(cid:26)(cid:41)(cid:25)(cid:2)(cid:53)(cid:53)(cid:37)(cid:16)(cid:34)(cid:33,,19668.0
,,3,,,Unknown,,cid:12)(cid:29)(cid:26)(cid:41)(cid:25)(cid:2)(cid:53)(cid:53)(cid:37)(cid:16)(cid:34)(cid:33,,19671.0
,,10,,,Unknown,,cid:12)(cid:29)(cid:26)(cid:41)(cid:25)(cid:2)(cid:53)(cid:53)(cid:37)(cid:16)(cid:34)(cid:33,,19681.0
,,5,,,Unknown,,cid:12)(cid:29)(cid:26)(cid:41)(cid:25)(cid:2)(cid:53)(cid:53)(cid:37)(cid:16)(cid:34)(cid:33,,19686.0
,,2,,,Unknown,,cid:12)(cid:29)(cid:26)(cid:41)(cid:25)(cid:2)(cid:53)(cid:53)(cid:37)(cid:16)(cid:34)(cid:33,,19688.0
,,46,,,Unknown,,cid:12)(cid:29)(cid:26)(cid:41)(cid:25)(cid:2)(cid:53)(cid:53)(cid:37)(cid:16)(cid:34)(cid:33,,19734.0
,,49,,,Unknown,,cid:12)(cid:29)(cid:26)(cid:41)(cid:25)(cid:2)(cid:53)(cid:53)(cid:37)(cid:16)(cid:34)(cid:33,,19783.0
,,4,,,Unknown,,cid:12)(cid:29)(cid:26)(cid:41)(cid:25)(cid:2)(cid:53)(cid:53)(cid:37)(cid:16)(cid:34)(cid:33,,19787.0
,,12,,,Unknown,,cid:12)(cid:29)(cid:26)(cid:41)(cid:25)(cid:2)(cid:53)(cid:53)(cid:37)(cid:16)(cid:34)(cid:33,,19799.0
,,2,,,Unknown,,cid:12)(cid:29)(cid:26)(cid:41)(cid:25)(cid:2)(cid:53)(cid:53)(cid:37)(cid:16)(cid:34)(cid:33,,19801.0
,,28,,,Unknown,,cid:12)(cid:29)(cid:26)(cid:41)(cid:25)(cid:2)(cid:53)(cid:53)(cid:37)(cid:16)(cid:34)(cid:33,,19829.0
,,3,,,Unknown,,cid:12)(cid:29)(cid:26)(cid:41)(cid:25)(cid:2)(cid:53)(cid:53)(cid:37)(cid:16)(cid:34)(cid:33,,19832.0
,,15,,,Unknown,,cid:12)(cid:29)(cid:26)(cid:41)(cid:25)(cid:2)(cid:53)(cid:53)(cid:37)(cid:16)(cid:34)(cid:33,,19847.0
,,2,,,Unknown,,cid:12)(cid:29)(cid:26)(cid:41)(cid:25)(cid:2)(cid:53)(cid:53)(cid:37)(cid:16)(cid:34)(cid:33,,19849.0
,,1,,,Unknown,,cid:12)(cid:29)(cid:26)(cid:41)(cid:25)(cid:2)(cid:53)(cid:53)(cid:37)(cid:16)(cid:34)(cid:33,,19850.0
,,34,,,Unknown,,cid:12)(cid:29)(cid:26)(cid:41)(cid:25)(cid:2)(cid:53)(cid:53)(cid:37)(cid:16)(cid:34)(cid:33,,19884.0
,,19,,,Unknown,,cid:12)(cid:29)(cid:26)(cid:41)(cid:25)(cid:2)(cid:53)(cid:53)(cid:37)(cid:16)(cid:34)(cid:33,,19903.0
,,34,,,Unknown,,cid:12)(cid:29)(cid:26)(cid:41)(cid:25)(cid:2)(cid:53)(cid:53)(cid:37)(cid:16)(cid:34)(cid:33,,19937.0
,,18,,,Unknown,,cid:12)(cid:29)(cid:26)(cid:41)(cid:25)(cid:2)(cid:53)(cid:53)(cid:37)(cid:16)(cid:34)(cid:33,,19955.0
,,2,,,Unknown,,cid:12)(cid:29)(cid:26)(cid:41)(cid:25)(cid:2)(cid:53)(cid:53)(cid:37)(cid:16)(cid:34)(cid:33,,19957.0
,,44,,,Unknown,,cid:12)(cid:29)(cid:26)(cid:41)(cid:25)(cid:2)(cid:53)(cid:53)(cid:37)(cid:16)(cid:34)(cid:33,,20001.0
,,12,,,Unknown,,cid:12)(cid:29)(cid:26)(cid:41)(cid:25)(cid:2)(cid:53)(cid:53)(cid:37)(cid:16)(cid:34)(cid:33,,20013.0
,,29,,,Unknown,,cid:12)(cid:29)(cid:26)(cid:41)(cid:25)(cid:2)(cid:53)(cid:53)(cid:37)(cid:16)(cid:34)(cid:33,,20042.0
,,26,,,Unknown,,cid:12)(cid:29)(cid:26)(cid:41)(cid:25)(cid:2)(cid:53)(cid:53)(cid:37)(cid:16)(cid:34)(cid:33,,20068.0
,,41,,,Unknown,,cid:12)(cid:29)(cid:26)(cid:41)(cid:25)(cid:2)(cid:53)(cid:53)(cid:37)(cid:16)(cid:34)(cid:33,,20109.0
,,25,,,Unknown,,cid:12)(cid:29)(cid:26)(cid:41)(cid:25)(cid:2)(cid:53)(cid:53)(cid:37)(cid:16)(cid:34)(cid:33,,20134.0
,,2,,,Unknown,,cid:12)(cid:29)(cid:26)(cid:41)(cid:25)(cid:2)(cid:53)(cid:53)(cid:37)(cid:16)(cid:34)(cid:33,,20136.0
,,53,,,Unknown,,cid:12)(cid:29)(cid:26)(cid:41)(cid:25)(cid:2)(cid:53)(cid:53)(cid:37)(cid:16)(cid:34)(cid:33,,20189.0
,,53,,,Unknown,,cid:12)(cid:29)(cid:26)(cid:41)(cid:25)(cid:2)(cid:53)(cid:53)(cid:37)(cid:16)(cid:34)(cid:33,,20242.0
,,18,,,Unknown,,cid:12)(cid:29)(cid:26)(cid:41)(cid:25)(cid:2)(cid:53)(cid:53)(cid:37)(cid:16)(cid:34)(cid:33,,20260.0
,,1,,,Unknown,,cid:12)(cid:29)(cid:26)(cid:41)(cid:25)(cid:2)(cid:53)(cid:53)(cid:37)(cid:16)(cid:34)(cid:33,,20261.0
,,1,,,Unknown,,cid:12)(cid:29)(cid:26)(cid:41)(cid:25)(cid:2)(cid:53)(cid:53)(cid:37)(cid:16)(cid:34)(cid:33,,20262.0
,,37,,,Unknown,,cid:12)(cid:29)(cid:26)(cid:41)(cid:25)(cid:2)(cid:53)(cid:53)(cid:37)(cid:16)(cid:34)(cid:33,,20299.0
,,1,,,Unknown,,cid:12)(cid:29)(cid:26)(cid:41)(cid:25)(cid:2)(cid:53)(cid:53)(cid:37)(cid:16)(cid:34)(cid:33,,20300.0
,,33,,,Unknown,,cid:12)(cid:29)(cid:26)(cid:41)(cid:25)(cid:2)(cid:53)(cid:53)(cid:37)(cid:16)(cid:34)(cid:33,,20333.0
,,45,,,Unknown,,cid:12)(cid:29)(cid:26)(cid:41)(cid:25)(cid:2)(cid:53)(cid:53)(cid:37)(cid:16)(cid:34)(cid:33,,20378.0
,,18,,,Unknown,,cid:12)(cid:29)(cid:26)(cid:41)(cid:25)(cid:2)(cid:53)(cid:53)(cid:37)(cid:16)(cid:34)(cid:33,,20396.0
,,34,,,Unknown,,cid:12)(cid:29)(cid:26)(cid:41)(cid:25)(cid:2)(cid:53)(cid:53)(cid:37)(cid:16)(cid:34)(cid:33,,20430.0
,,11,,,Unknown,,cid:12)(cid:29)(cid:26)(cid:41)(cid:25)(cid:2)(cid:53)(cid:53)(cid:37)(cid:16)(cid:34)(cid:33,,20441.0
,,39,,,Unknown,,cid:12)(cid:29)(cid:26)(cid:41)(cid:25)(cid:2)(cid:53)(cid:53)(cid:37)(cid:16)(cid:34)(cid:33,,20480.0
,,13,,,Unknown,,cid:12)(cid:29)(cid:26)(cid:41)(cid:25)(cid:2)(cid:53)(cid:53)(cid:37)(cid:16)(cid:34)(cid:33,,20493.0
,,2,,,Unknown,,cid:12)(cid:29)(cid:26)(cid:41)(cid:25)(cid:2)(cid:53)(cid:53)(cid:37)(cid:16)(cid:34)(cid:33,,20495.0
,,12,,,Unknown,,cid:12)(cid:29)(cid:26)(cid:41)(cid:25)(cid:2)(cid:53)(cid:53)(cid:37)(cid:16)(cid:34)(cid:33,,20507.0
,,11,,,Unknown,,cid:12)(cid:29)(cid:26)(cid:41)(cid:25)(cid:2)(cid:53)(cid:53)(cid:37)(cid:16)(cid:34)(cid:33,,20518.0
,,4,,,Unknown,,cid:12)(cid:29)(cid:26)(cid:41)(cid:25)(cid:2)(cid:53)(cid:53)(cid:37)(cid:16)(cid:34)(cid:33,,20522.0
,,14,,,Unknown,,cid:12)(cid:29)(cid:26)(cid:41)(cid:25)(cid:2)(cid:53)(cid:53)(cid:37)(cid:16)(cid:34)(cid:33,,20536.0
,,11,,,Unknown,,cid:12)(cid:29)(cid:26)(cid:41)(cid:25)(cid:2)(cid:53)(cid:53)(cid:37)(cid:16)(cid:34)(cid:33,,20547.0
,,62,,,Unknown,,cid:12)(cid:29)(cid:26)(cid:41)(cid:25)(cid:2)(cid:53)(cid:53)(cid:37)(cid:16)(cid:34)(cid:33,,20609.0
,,62,,,Unknown,,cid:12)(cid:29)(cid:26)(cid:41)(cid:25)(cid:2)(cid:53)(cid:53)(cid:37)(cid:16)(cid:34)(cid:33,,20671.0
,,7,,,Unknown,,cid:12)(cid:29)(cid:26)(cid:41)(cid:25)(cid:2)(cid:53)(cid:53)(cid:37)(cid:16)(cid:34)(cid:33,,20678.0
,,5,,,Unknown,,cid:12)(cid:29)(cid:26)(cid:41)(cid:25)(cid:2)(cid:53)(cid:53)(cid:37)(cid:16)(cid:34)(cid:33,,20683.0
,,3,,,Unknown,,cid:12)(cid:29)(cid:26)(cid:41)(cid:25)(cid:2)(cid:53)(cid:53)(cid:37)(cid:16)(cid:34)(cid:33,,20686.0
,,9,,,Unknown,,cid:12)(cid:29)(cid:26)(cid:41)(cid:25)(cid:2)(cid:53)(cid:53)(cid:37)(cid:16)(cid:34)(cid:33,,20695.0
,,2,,,Unknown,,cid:12)(cid:29)(cid:26)(cid:41)(cid:25)(cid:2)(cid:53)(cid:53)(cid:37)(cid:16)(cid:34)(cid:33,,20697.0
,,12,,,Unknown,,cid:12)(cid:29)(cid:26)(cid:41)(cid:25)(cid:2)(cid:53)(cid:53)(cid:37)(cid:16)(cid:34)(cid:33,,20709.0
,,11,,,Unknown,,cid:12)(cid:29)(cid:26)(cid:41)(cid:25)(cid:2)(cid:53)(cid:53)(cid:37)(cid:16)(cid:34)(cid:33,,20720.0
,,4,,,Unknown,,cid:12)(cid:29)(cid:26)(cid:41)(cid:25)(cid:2)(cid:53)(cid:53)(cid:37)(cid:16)(cid:34)(cid:33,,20724.0
,,14,,,Unknown,,cid:12)(cid:29)(cid:26)(cid:41)(cid:25)(cid:2)(cid:53)(cid:53)(cid:37)(cid:16)(cid:34)(cid:33,,20738.0
,,11,,,Unknown,,cid:12)(cid:29)(cid:26)(cid:41)(cid:25)(cid:2)(cid:53)(cid:53)(cid:37)(cid:16)(cid:34)(cid:33,,20749.0
,,62,,,Unknown,,cid:12)(cid:29)(cid:26)(cid:41)(cid:25)(cid:2)(cid:53)(cid:53)(cid:37)(cid:16)(cid:34)(cid:33,,20811.0
,,62,,,Unknown,,cid:12)(cid:29)(cid:26)(cid:41)(cid:25)(cid:2)(cid:53)(cid:53)(cid:37)(cid:16)(cid:34)(cid:33,,20873.0
,,7,,,Unknown,,cid:12)(cid:29)(cid:26)(cid:41)(cid:25)(cid:2)(cid:53)(cid:53)(cid:37)(cid:16)(cid:34)(cid:33,,20880.0
,,5,,,Unknown,,cid:12)(cid:29)(cid:26)(cid:41)(cid:25)(cid:2)(cid:53)(cid:53)(cid:37)(cid:16)(cid:34)(cid:33,,20885.0
,,3,,,Unknown,,cid:12)(cid:29)(cid:26)(cid:41)(cid:25)(cid:2)(cid:53)(cid:53)(cid:37)(cid:16)(cid:34)(cid:33,,20888.0
,,9,,,Unknown,,cid:12)(cid:29)(cid:26)(cid:41)(cid:25)(cid:2)(cid:53)(cid:53)(cid:37)(cid:16)(cid:34)(cid:33,,20897.0
,,2,,,Unknown,,cid:12)(cid:29)(cid:26)(cid:41)(cid:25)(cid:2)(cid:53)(cid:53)(cid:37)(cid:16)(cid:34)(cid:33,,20899.0
,,28,,,Unknown,,cid:12)(cid:29)(cid:26)(cid:41)(cid:25)(cid:2)(cid:53)(cid:53)(cid:37)(cid:16)(cid:34)(cid:33,,20927.0
,,3,,,Unknown,,cid:12)(cid:29)(cid:26)(cid:41)(cid:25)(cid:2)(cid:53)(cid:53)(cid:37)(cid:16)(cid:34)(cid:33,,20930.0
,,15,,,Unknown,,cid:12)(cid:29)(cid:26)(cid:41)(cid:25)(cid:2)(cid:53)(cid:53)(cid:37)(cid:16)(cid:34)(cid:33,,20945.0
,,2,,,Unknown,,cid:12)(cid:29)(cid:26)(cid:41)(cid:25)(cid:2)(cid:53)(cid:53)(cid:37)(cid:16)(cid:34)(cid:33,,20947.0
,,36,,,Unknown,,cid:12)(cid:29)(cid:26)(cid:41)(cid:25)(cid:2)(cid:53)(cid:53)(cid:37)(cid:16)(cid:34)(cid:33,,20983.0
,,37,,,Unknown,,cid:12)(cid:29)(cid:26)(cid:41)(cid:25)(cid:2)(cid:53)(cid:53)(cid:37)(cid:16)(cid:34)(cid:33,,21020.0
,,19,,,Unknown,,cid:12)(cid:29)(cid:26)(cid:41)(cid:25)(cid:2)(cid:53)(cid:53)(cid:37)(cid:16)(cid:34)(cid:33,,21039.0
,,34,,,Unknown,,cid:12)(cid:29)(cid:26)(cid:41)(cid:25)(cid:2)(cid:53)(cid:53)(cid:37)(cid:16)(cid:34)(cid:33,,21073.0
,,35,,,Unknown,,cid:12)(cid:29)(cid:26)(cid:41)(cid:25)(cid:2)(cid:53)(cid:53)(cid:37)(cid:16)(cid:34)(cid:33,,21108.0
,,2,,,Unknown,,cid:12)(cid:29)(cid:26)(cid:41)(cid:25)(cid:2)(cid:53)(cid:53)(cid:37)(cid:16)(cid:34)(cid:33,,21110.0
,,44,,,Unknown,,cid:12)(cid:29)(cid:26)(cid:41)(cid:25)(cid:2)(cid:53)(cid:53)(cid:37)(cid:16)(cid:34)(cid:33,,21154.0
,,12,,,Unknown,,cid:12)(cid:29)(cid:26)(cid:41)(cid:25)(cid:2)(cid:53)(cid:53)(cid:37)(cid:16)(cid:34)(cid:33,,21166.0
,,29,,,Unknown,,cid:12)(cid:29)(cid:26)(cid:41)(cid:25)(cid:2)(cid:53)(cid:53)(cid:37)(cid:16)(cid:34)(cid:33,,21195.0
,,26,,,Unknown,,cid:12)(cid:29)(cid:26)(cid:41)(cid:25)(cid:2)(cid:53)(cid:53)(cid:37)(cid:16)(cid:34)(cid:33,,21221.0
,,41,,,Unknown,,cid:12)(cid:29)(cid:26)(cid:41)(cid:25)(cid:2)(cid:53)(cid:53)(cid:37)(cid:16)(cid:34)(cid:33,,21262.0
,,25,,,Unknown,,cid:12)(cid:29)(cid:26)(cid:41)(cid:25)(cid:2)(cid:53)(cid:53)(cid:37)(cid:16)(cid:34)(cid:33,,21287.0
,,2,,,Unknown,,cid:12)(cid:29)(cid:26)(cid:41)(cid:25)(cid:2)(cid:53)(cid:53)(cid:37)(cid:16)(cid:34)(cid:33,,21289.0
,,53,,,Unknown,,cid:12)(cid:29)(cid:26)(cid:41)(cid:25)(cid:2)(cid:53)(cid:53)(cid:37)(cid:16)(cid:34)(cid:33,,21342.0
,,53,,,Unknown,,cid:12)(cid:29)(cid:26)(cid:41)(cid:25)(cid:2)(cid:53)(cid:53)(cid:37)(cid:16)(cid:34)(cid:33,,21395.0
,,37,,,Unknown,,cid:12)(cid:29)(cid:26)(cid:41)(cid:25)(cid:2)(cid:53)(cid:53)(cid:37)(cid:16)(cid:34)(cid:33,,21432.0
,,16,,,Unknown,,cid:12)(cid:29)(cid:26)(cid:41)(cid:25)(cid:2)(cid:53)(cid:53)(cid:37)(cid:16)(cid:34)(cid:33,,21448.0
,,34,,,Unknown,,cid:12)(cid:29)(cid:26)(cid:41)(cid:25)(cid:2)(cid:53)(cid:53)(cid:37)(cid:16)(cid:34)(cid:33,,21482.0
,,33,,,Unknown,,cid:12)(cid:29)(cid:26)(cid:41)(cid:25)(cid:2)(cid:53)(cid:53)(cid:37)(cid:16)(cid:34)(cid:33,,21515.0
,,1,,,Unknown,,cid:12)(cid:29)(cid:26)(cid:41)(cid:25)(cid:2)(cid:53)(cid:53)(cid:37)(cid:16)(cid:34)(cid:33,,21516.0
,,33,,,Unknown,,cid:12)(cid:29)(cid:26)(cid:41)(cid:25)(cid:2)(cid:53)(cid:53)(cid:37)(cid:16)(cid:34)(cid:33,,21549.0
,,45,,,Unknown,,cid:12)(cid:29)(cid:26)(cid:41)(cid:25)(cid:2)(cid:53)(cid:53)(cid:37)(cid:16)(cid:34)(cid:33,,21594.0
,,18,,,Unknown,,cid:12)(cid:29)(cid:26)(cid:41)(cid:25)(cid:2)(cid:53)(cid:53)(cid:37)(cid:16)(cid:34)(cid:33,,21612.0
,,34,,,Unknown,,cid:12)(cid:29)(cid:26)(cid:41)(cid:25)(cid:2)(cid:53)(cid:53)(cid:37)(cid:16)(cid:34)(cid:33,,21646.0
,,11,,,Unknown,,cid:12)(cid:29)(cid:26)(cid:41)(cid:25)(cid:2)(cid:53)(cid:53)(cid:37)(cid:16)(cid:34)(cid:33,,21657.0
,,39,,,Unknown,,cid:12)(cid:29)(cid:26)(cid:41)(cid:25)(cid:2)(cid:53)(cid:53)(cid:37)(cid:16)(cid:34)(cid:33,,21696.0
,,13,,,Unknown,,cid:12)(cid:29)(cid:26)(cid:41)(cid:25)(cid:2)(cid:53)(cid:53)(cid:37)(cid:16)(cid:34)(cid:33,,21709.0
,,2,,,Unknown,,cid:12)(cid:29)(cid:26)(cid:41)(cid:25)(cid:2)(cid:53)(cid:53)(cid:37)(cid:16)(cid:34)(cid:33,,21711.0
,,12,,,Unknown,,cid:12)(cid:29)(cid:26)(cid:41)(cid:25)(cid:2)(cid:53)(cid:53)(cid:37)(cid:16)(cid:34)(cid:33,,21723.0
,,11,,,Unknown,,cid:12)(cid:29)(cid:26)(cid:41)(cid:25)(cid:2)(cid:53)(cid:53)(cid:37)(cid:16)(cid:34)(cid:33,,21734.0
,,4,,,Unknown,,cid:12)(cid:29)(cid:26)(cid:41)(cid:25)(cid:2)(cid:53)(cid:53)(cid:37)(cid:16)(cid:34)(cid:33,,21738.0
,,14,,,Unknown,,cid:12)(cid:29)(cid:26)(cid:41)(cid:25)(cid:2)(cid:53)(cid:53)(cid:37)(cid:16)(cid:34)(cid:33,,21752.0
,,11,,,Unknown,,cid:12)(cid:29)(cid:26)(cid:41)(cid:25)(cid:2)(cid:53)(cid:53)(cid:37)(cid:16)(cid:34)(cid:33,,21763.0
,,62,,,Unknown,,cid:12)(cid:29)(cid:26)(cid:41)(cid:25)(cid:2)(cid:53)(cid:53)(cid:37)(cid:16)(cid:34)(cid:33,,21825.0
,,62,,,Unknown,,cid:12)(cid:29)(cid:26)(cid:41)(cid:25)(cid:2)(cid:53)(cid:53)(cid:37)(cid:16)(cid:34)(cid:33,,21887.0
,,7,,,Unknown,,cid:12)(cid:29)(cid:26)(cid:41)(cid:25)(cid:2)(cid:53)(cid:53)(cid:37)(cid:16)(cid:34)(cid:33,,21894.0
,,5,,,Unknown,,cid:12)(cid:29)(cid:26)(cid:41)(cid:25)(cid:2)(cid:53)(cid:53)(cid:37)(cid:16)(cid:34)(cid:33,,21899.0
,,3,,,Unknown,,cid:12)(cid:29)(cid:26)(cid:41)(cid:25)(cid:2)(cid:53)(cid:53)(cid:37)(cid:16)(cid:34)(cid:33,,21902.0
,,9,,,Unknown,,cid:12)(cid:29)(cid:26)(cid:41)(cid:25)(cid:2)(cid:53)(cid:53)(cid:37)(cid:16)(cid:34)(cid:33,,21911.0
,,2,,,Unknown,,cid:12)(cid:29)(cid:26)(cid:41)(cid:25)(cid:2)(cid:53)(cid:53)(cid:37)(cid:16)(cid:34)(cid:33,,21913.0
,,12,,,Unknown,,cid:12)(cid:29)(cid:26)(cid:41)(cid:25)(cid:2)(cid:53)(cid:53)(cid:37)(cid:16)(cid:34)(cid:33,,21925.0
,,11,,,Unknown,,cid:12)(cid:29)(cid:26)(cid:41)(cid:25)(cid:2)(cid:53)(cid:53)(cid:37)(cid:16)(cid:34)(cid:33,,21936.0
,,4,,,Unknown,,cid:12)(cid:29)(cid:26)(cid:41)(cid:25)(cid:2)(cid:53)(cid:53)(cid:37)(cid:16)(cid:34)(cid:33,,21940.0
,,14,,,Unknown,,cid:12)(cid:29)(cid:26)(cid:41)(cid:25)(cid:2)(cid:53)(cid:53)(cid:37)(cid:16)(cid:34)(cid:33,,21954.0
,,11,,,Unknown,,cid:12)(cid:29)(cid:26)(cid:41)(cid:25)(cid:2)(cid:53)(cid:53)(cid:37)(cid:16)(cid:34)(cid:33,,21965.0
,,62,,,Unknown,,cid:12)(cid:29)(cid:26)(cid:41)(cid:25)(cid:2)(cid:53)(cid:53)(cid:37)(cid:16)(cid:34)(cid:33,,22027.0
,,62,,,Unknown,,cid:12)(cid:29)(cid:26)(cid:41)(cid:25)(cid:2)(cid:53)(cid:53)(cid:37)(cid:16)(cid:34)(cid:33,,22089.0
,,7,,,Unknown,,cid:12)(cid:29)(cid:26)(cid:41)(cid:25)(cid:2)(cid:53)(cid:53)(cid:37)(cid:16)(cid:34)(cid:33,,22096.0
,,5,,,Unknown,,cid:12)(cid:29)(cid:26)(cid:41)(cid:25)(cid:2)(cid:53)(cid:53)(cid:37)(cid:16)(cid:34)(cid:33,,22101.0
,,3,,,Unknown,,cid:12)(cid:29)(cid:26)(cid:41)(cid:25)(cid:2)(cid:53)(cid:53)(cid:37)(cid:16)(cid:34)(cid:33,,22104.0
,,9,,,Unknown,,cid:12)(cid:29)(cid:26)(cid:41)(cid:25)(cid:2)(cid:53)(cid:53)(cid:37)(cid:16)(cid:34)(cid:33,,22113.0
,,2,,,Unknown,,cid:12)(cid:29)(cid:26)(cid:41)(cid:25)(cid:2)(cid:53)(cid:53)(cid:37)(cid:16)(cid:34)(cid:33,,22115.0
,,28,,,Unknown,,cid:12)(cid:29)(cid:26)(cid:41)(cid:25)(cid:2)(cid:53)(cid:53)(cid:37)(cid:16)(cid:34)(cid:33,,22143.0
,,3,,,Unknown,,cid:12)(cid:29)(cid:26)(cid:41)(cid:25)(cid:2)(cid:53)(cid:53)(cid:37)(cid:16)(cid:34)(cid:33,,22146.0
,,15,,,Unknown,,cid:12)(cid:29)(cid:26)(cid:41)(cid:25)(cid:2)(cid:53)(cid:53)(cid:37)(cid:16)(cid:34)(cid:33,,22161.0
,,2,,,Unknown,,cid:12)(cid:29)(cid:26)(cid:41)(cid:25)(cid:2)(cid:53)(cid:53)(cid:37)(cid:16)(cid:34)(cid:33,,22163.0
,,1,,,Unknown,,cid:12)(cid:29)(cid:26)(cid:41)(cid:25)(cid:2)(cid:53)(cid:53)(cid:37)(cid:16)(cid:34)(cid:33,,22164.0
,,17,,,Unknown,,cid:12)(cid:29)(cid:26)(cid:41)(cid:25)(cid:2)(cid:53)(cid:53)(cid:37)(cid:16)(cid:34)(cid:33,,22181.0
,,34,,,Unknown,,cid:12)(cid:29)(cid:26)(cid:41)(cid:25)(cid:2)(cid:53)(cid:53)(cid:37)(cid:16)(cid:34)(cid:33,,22215.0
,,19,,,Unknown,,cid:12)(cid:29)(cid:26)(cid:41)(cid:25)(cid:2)(cid:53)(cid:53)(cid:37)(cid:16)(cid:34)(cid:33,,22234.0
,,32,,,Unknown,,cid:12)(cid:29)(cid:26)(cid:41)(cid:25)(cid:2)(cid:53)(cid:53)(cid:37)(cid:16)(cid:34)(cid:33,,22266.0
,,33,,,Unknown,,cid:12)(cid:29)(cid:26)(cid:41)(cid:25)(cid:2)(cid:53)(cid:53)(cid:37)(cid:16)(cid:34)(cid:33,,22299.0
,,2,,,Unknown,,cid:12)(cid:29)(cid:26)(cid:41)(cid:25)(cid:2)(cid:53)(cid:53)(cid:37)(cid:16)(cid:34)(cid:33,,22301.0
,,44,,,Unknown,,cid:12)(cid:29)(cid:26)(cid:41)(cid:25)(cid:2)(cid:53)(cid:53)(cid:37)(cid:16)(cid:34)(cid:33,,22345.0
,,12,,,Unknown,,cid:12)(cid:29)(cid:26)(cid:41)(cid:25)(cid:2)(cid:53)(cid:53)(cid:37)(cid:16)(cid:34)(cid:33,,22357.0
,,29,,,Unknown,,cid:12)(cid:29)(cid:26)(cid:41)(cid:25)(cid:2)(cid:53)(cid:53)(cid:37)(cid:16)(cid:34)(cid:33,,22386.0
,,26,,,Unknown,,cid:12)(cid:29)(cid:26)(cid:41)(cid:25)(cid:2)(cid:53)(cid:53)(cid:37)(cid:16)(cid:34)(cid:33,,22412.0
,,41,,,Unknown,,cid:12)(cid:29)(cid:26)(cid:41)(cid:25)(cid:2)(cid:53)(cid:53)(cid:37)(cid:16)(cid:34)(cid:33,,22453.0
,,25,,,Unknown,,cid:12)(cid:29)(cid:26)(cid:41)(cid:25)(cid:2)(cid:53)(cid:53)(cid:37)(cid:16)(cid:34)(cid:33,,22478.0
,,2,,,Unknown,,cid:12)(cid:29)(cid:26)(cid:41)(cid:25)(cid:2)(cid:53)(cid:53)(cid:37)(cid:16)(cid:34)(cid:33,,22480.0
,,53,,,Unknown,,cid:12)(cid:29)(cid:26)(cid:41)(cid:25)(cid:2)(cid:53)(cid:53)(cid:37)(cid:16)(cid:34)(cid:33,,22533.0
,,53,,,Unknown,,cid:12)(cid:29)(cid:26)(cid:41)(cid:25)(cid:2)(cid:53)(cid:53)(cid:37)(cid:16)(cid:34)(cid:33,,22586.0
,,37,,,Unknown,,cid:12)(cid:29)(cid:26)(cid:41)(cid:25)(cid:2)(cid:53)(cid:53)(cid:37)(cid:16)(cid:34)(cid:33,,22623.0
,,16,,,Unknown,,cid:12)(cid:29)(cid:26)(cid:41)(cid:25)(cid:2)(cid:53)(cid:53)(cid:37)(cid:16)(cid:34)(cid:33,,22639.0
,,34,,,Unknown,,cid:12)(cid:29)(cid:26)(cid:41)(cid:25)(cid:2)(cid:53)(cid:53)(cid:37)(cid:16)(cid:34)(cid:33,,22673.0
,,33,,,Unknown,,cid:12)(cid:29)(cid:26)(cid:41)(cid:25)(cid:2)(cid:53)(cid:53)(cid:37)(cid:16)(cid:34)(cid:33,,22706.0
,,1,,,Unknown,,cid:12)(cid:29)(cid:26)(cid:41)(cid:25)(cid:2)(cid:53)(cid:53)(cid:37)(cid:16)(cid:34)(cid:33,,22707.0
,,33,,,Unknown,,cid:12)(cid:29)(cid:26)(cid:41)(cid:25)(cid:2)(cid:53)(cid:53)(cid:37)(cid:16)(cid:34)(cid:33,,22740.0
,,45,,,Unknown,,cid:12)(cid:29)(cid:26)(cid:41)(cid:25)(cid:2)(cid:53)(cid:53)(cid:37)(cid:16)(cid:34)(cid:33,,22785.0
,,18,,,Unknown,,cid:12)(cid:29)(cid:26)(cid:41)(cid:25)(cid:2)(cid:53)(cid:53)(cid:37)(cid:16)(cid:34)(cid:33,,22803.0
,,34,,,Unknown,,cid:12)(cid:29)(cid:26)(cid:41)(cid:25)(cid:2)(cid:53)(cid:53)(cid:37)(cid:16)(cid:34)(cid:33,,22837.0
,,62,,,Unknown,,cid:12)(cid:29)(cid:26)(cid:41)(cid:25)(cid:2)(cid:53)(cid:53)(cid:37)(cid:16)(cid:34)(cid:33,,22899.0
,,49,,,Unknown,,cid:12)(cid:29)(cid:26)(cid:41)(cid:25)(cid:2)(cid:53)(cid:53)(cid:37)(cid:16)(cid:34)(cid:33,,22948.0
,,3,,,Unknown,,cid:12)(cid:29)(cid:26)(cid:41)(cid:25)(cid:2)(cid:53)(cid:53)(cid:37)(cid:16)(cid:34)(cid:33,,22951.0
,,60,,,Unknown,,cid:12)(cid:29)(cid:26)(cid:41)(cid:25)(cid:2)(cid:53)(cid:53)(cid:37)(cid:16)(cid:34)(cid:33,,23011.0
,,5,,,Unknown,,cid:12)(cid:29)(cid:26)(cid:41)(cid:25)(cid:2)(cid:53)(cid:53)(cid:37)(cid:16)(cid:34)(cid:33,,23016.0
,,10,,,Unknown,,cid:12)(cid:29)(cid:26)(cid:41)(cid:25)(cid:2)(cid:53)(cid:53)(cid:37)(cid:16)(cid:34)(cid:33,,23026.0
,,2,,,Unknown,,cid:12)(cid:29)(cid:26)(cid:41)(cid:25)(cid:2)(cid:53)(cid:53)(cid:37)(cid:16)(cid:34)(cid:33,,23028.0
,,62,,,Unknown,,cid:12)(cid:29)(cid:26)(cid:41)(cid:25)(cid:2)(cid:53)(cid:53)(cid:37)(cid:16)(cid:34)(cid:33,,23090.0
,,11,,,Unknown,,cid:12)(cid:29)(cid:26)(cid:41)(cid:25)(cid:2)(cid:53)(cid:53)(cid:37)(cid:16)(cid:34)(cid:33,,23101.0
,,4,,,Unknown,,cid:12)(cid:29)(cid:26)(cid:41)(cid:25)(cid:2)(cid:53)(cid:53)(cid:37)(cid:16)(cid:34)(cid:33,,23105.0
,,3,,,Unknown,,cid:12)(cid:29)(cid:26)(cid:41)(cid:25)(cid:2)(cid:53)(cid:53)(cid:37)(cid:16)(cid:34)(cid:33,,23108.0
,,11,,,Unknown,,cid:12)(cid:29)(cid:26)(cid:41)(cid:25)(cid:2)(cid:53)(cid:53)(cid:37)(cid:16)(cid:34)(cid:33,,23119.0
,,4,,,Unknown,,cid:12)(cid:29)(cid:26)(cid:41)(cid:25)(cid:2)(cid:53)(cid:53)(cid:37)(cid:16)(cid:34)(cid:33,,23123.0
,,40,,,Unknown,,cid:12)(cid:29)(cid:26)(cid:41)(cid:25)(cid:2)(cid:53)(cid:53)(cid:37)(cid:16)(cid:34)(cid:33,,23163.0
,,2,,,Unknown,,cid:12)(cid:29)(cid:26)(cid:41)(cid:25)(cid:2)(cid:53)(cid:53)(cid:37)(cid:16)(cid:34)(cid:33,,23165.0
,,62,,,Unknown,,cid:12)(cid:29)(cid:26)(cid:41)(cid:25)(cid:2)(cid:53)(cid:53)(cid:37)(cid:16)(cid:34)(cid:33,,23227.0
,,11,,,Unknown,,cid:12)(cid:29)(cid:26)(cid:41)(cid:25)(cid:2)(cid:53)(cid:53)(cid:37)(cid:16)(cid:34)(cid:33,,23238.0
,,4,,,Unknown,,cid:12)(cid:29)(cid:26)(cid:41)(cid:25)(cid:2)(cid:53)(cid:53)(cid:37)(cid:16)(cid:34)(cid:33,,23242.0
,,3,,,Unknown,,cid:12)(cid:29)(cid:26)(cid:41)(cid:25)(cid:2)(cid:53)(cid:53)(cid:37)(cid:16)(cid:34)(cid:33,,23245.0
,,11,,,Unknown,,cid:12)(cid:29)(cid:26)(cid:41)(cid:25)(cid:2)(cid:53)(cid:53)(cid:37)(cid:16)(cid:34)(cid:33,,23256.0
,,4,,,Unknown,,cid:12)(cid:29)(cid:26)(cid:41)(cid:25)(cid:2)(cid:53)(cid:53)(cid:37)(cid:16)(cid:34)(cid:33,,23260.0
,,40,,,Unknown,,cid:12)(cid:29)(cid:26)(cid:41)(cid:25)(cid:2)(cid:53)(cid:53)(cid:37)(cid:16)(cid:34)(cid:33,,23300.0
,,2,,,Unknown,,cid:12)(cid:29)(cid:26)(cid:41)(cid:25)(cid:2)(cid:53)(cid:53)(cid:37)(cid:16)(cid:34)(cid:33,,23302.0
,,28,,,Unknown,,cid:12)(cid:29)(cid:26)(cid:41)(cid:25)(cid:2)(cid:53)(cid:53)(cid:37)(cid:16)(cid:34)(cid:33,,23330.0
,,3,,,Unknown,,cid:12)(cid:29)(cid:26)(cid:41)(cid:25)(cid:2)(cid:53)(cid:53)(cid:37)(cid:16)(cid:34)(cid:33,,23333.0
,,15,,,Unknown,,cid:12)(cid:29)(cid:26)(cid:41)(cid:25)(cid:2)(cid:53)(cid:53)(cid:37)(cid:16)(cid:34)(cid:33,,23348.0
,,2,,,Unknown,,cid:12)(cid:29)(cid:26)(cid:41)(cid:25)(cid:2)(cid:53)(cid:53)(cid:37)(cid:16)(cid:34)(cid:33,,23350.0
,,34,,,Unknown,,cid:12)(cid:29)(cid:26)(cid:41)(cid:25)(cid:2)(cid:53)(cid:53)(cid:37)(cid:16)(cid:34)(cid:33,,23384.0
,,18,,,Unknown,,cid:12)(cid:29)(cid:26)(cid:41)(cid:25)(cid:2)(cid:53)(cid:53)(cid:37)(cid:16)(cid:34)(cid:33,,23402.0
,,19,,,Unknown,,cid:12)(cid:29)(cid:26)(cid:41)(cid:25)(cid:2)(cid:53)(cid:53)(cid:37)(cid:16)(cid:34)(cid:33,,23421.0
,,36,,,Unknown,,cid:12)(cid:29)(cid:26)(cid:41)(cid:25)(cid:2)(cid:53)(cid:53)(cid:37)(cid:16)(cid:34)(cid:33,,23457.0
,,35,,,Unknown,,cid:12)(cid:29)(cid:26)(cid:41)(cid:25)(cid:2)(cid:53)(cid:53)(cid:37)(cid:16)(cid:34)(cid:33,,23492.0
,,2,,,Unknown,,cid:12)(cid:29)(cid:26)(cid:41)(cid:25)(cid:2)(cid:53)(cid:53)(cid:37)(cid:16)(cid:34)(cid:33,,23494.0
,,44,,,Unknown,,cid:12)(cid:29)(cid:26)(cid:41)(cid:25)(cid:2)(cid:53)(cid:53)(cid:37)(cid:16)(cid:34)(cid:33,,23538.0
,,12,,,Unknown,,cid:12)(cid:29)(cid:26)(cid:41)(cid:25)(cid:2)(cid:53)(cid:53)(cid:37)(cid:16)(cid:34)(cid:33,,23550.0
,,29,,,Unknown,,cid:12)(cid:29)(cid:26)(cid:41)(cid:25)(cid:2)(cid:53)(cid:53)(cid:37)(cid:16)(cid:34)(cid:33,,23579.0
,,26,,,Unknown,,cid:12)(cid:29)(cid:26)(cid:41)(cid:25)(cid:2)(cid:53)(cid:53)(cid:37)(cid:16)(cid:34)(cid:33,,23605.0
,,41,,,Unknown,,cid:12)(cid:29)(cid:26)(cid:41)(cid:25)(cid:2)(cid:53)(cid:53)(cid:37)(cid:16)(cid:34)(cid:33,,23646.0
,,25,,,Unknown,,cid:12)(cid:29)(cid:26)(cid:41)(cid:25)(cid:2)(cid:53)(cid:53)(cid:37)(cid:16)(cid:34)(cid:33,,23671.0
,,2,,,Unknown,,cid:12)(cid:29)(cid:26)(cid:41)(cid:25)(cid:2)(cid:53)(cid:53)(cid:37)(cid:16)(cid:34)(cid:33,,23673.0
,,53,,,Unknown,,cid:12)(cid:29)(cid:26)(cid:41)(cid:25)(cid:2)(cid:53)(cid:53)(cid:37)(cid:16)(cid:34)(cid:33,,23726.0
,,53,,,Unknown,,cid:12)(cid:29)(cid:26)(cid:41)(cid:25)(cid:2)(cid:53)(cid:53)(cid:37)(cid:16)(cid:34)(cid:33,,23779.0
,,37,,,Unknown,,cid:12)(cid:29)(cid:26)(cid:41)(cid:25)(cid:2)(cid:53)(cid:53)(cid:37)(cid:16)(cid:34)(cid:33,,23816.0
,,16,,,Unknown,,cid:12)(cid:29)(cid:26)(cid:41)(cid:25)(cid:2)(cid:53)(cid:53)(cid:37)(cid:16)(cid:34)(cid:33,,23832.0
,,34,,,Unknown,,cid:12)(cid:29)(cid:26)(cid:41)(cid:25)(cid:2)(cid:53)(cid:53)(cid:37)(cid:16)(cid:34)(cid:33,,23866.0
,,33,,,Unknown,,cid:12)(cid:29)(cid:26)(cid:41)(cid:25)(cid:2)(cid:53)(cid:53)(cid:37)(cid:16)(cid:34)(cid:33,,23899.0
,,1,,,Unknown,,cid:12)(cid:29)(cid:26)(cid:41)(cid:25)(cid:2)(cid:53)(cid:53)(cid:37)(cid:16)(cid:34)(cid:33,,23900.0
,,33,,,Unknown,,cid:12)(cid:29)(cid:26)(cid:41)(cid:25)(cid:2)(cid:53)(cid:53)(cid:37)(cid:16)(cid:34)(cid:33,,23933.0
,,45,,,Unknown,,cid:12)(cid:29)(cid:26)(cid:41)(cid:25)(cid:2)(cid:53)(cid:53)(cid:37)(cid:16)(cid:34)(cid:33,,23978.0
,,18,,,Unknown,,cid:12)(cid:29)(cid:26)(cid:41)(cid:25)(cid:2)(cid:53)(cid:53)(cid:37)(cid:16)(cid:34)(cid:33,,23996.0
,,34,,,Unknown,,cid:12)(cid:29)(cid:26)(cid:41)(cid:25)(cid:2)(cid:53)(cid:53)(cid:37)(cid:16)(cid:34)(cid:33,,24030.0
,,49,,,Unknown,,cid:12)(cid:29)(cid:26)(cid:41)(cid:25)(cid:2)(cid:53)(cid:53)(cid:37)(cid:16)(cid:34)(cid:33,,24079.0
,,31,,,Unknown,,cid:12)(cid:29)(cid:26)(cid:41)(cid:25)(cid:2)(cid:53)(cid:53)(cid:37)(cid:16)(cid:34)(cid:33,,24110.0
,,41,,,Unknown,,cid:12)(cid:29)(cid:26)(cid:41)(cid:25)(cid:2)(cid:53)(cid:53)(cid:37)(cid:16)(cid:34)(cid:33,,24151.0
,,24,,,Unknown,,cid:12)(cid:29)(cid:26)(cid:41)(cid:25)(cid:2)(cid:53)(cid:53)(cid:37)(cid:16)(cid:34)(cid:33,,24175.0
,,20,,,Unknown,,cid:12)(cid:29)(cid:26)(cid:41)(cid:25)(cid:2)(cid:53)(cid:53)(cid:37)(cid:16)(cid:34)(cid:33,,24195.0
,,30,,,Unknown,,cid:12)(cid:29)(cid:26)(cid:41)(cid:25)(cid:2)(cid:53)(cid:53)(cid:37)(cid:16)(cid:34)(cid:33,,24225.0
,,2,,,Unknown,,cid:12)(cid:29)(cid:26)(cid:41)(cid:25)(cid:2)(cid:53)(cid:53)(cid:37)(cid:16)(cid:34)(cid:33,,24227.0
,,36,,,Unknown,,cid:12)(cid:29)(cid:26)(cid:41)(cid:25)(cid:2)(cid:53)(cid:53)(cid:37)(cid:16)(cid:34)(cid:33,,24263.0
,,17,,,Unknown,,cid:12)(cid:29)(cid:26)(cid:41)(cid:25)(cid:2)(cid:53)(cid:53)(cid:37)(cid:16)(cid:34)(cid:33,,24280.0
,,17,,,Unknown,,cid:12)(cid:29)(cid:26)(cid:41)(cid:25)(cid:2)(cid:53)(cid:53)(cid:37)(cid:16)(cid:34)(cid:33,,24297.0
,,33,,,Unknown,,cid:12)(cid:29)(cid:26)(cid:41)(cid:25)(cid:2)(cid:53)(cid:53)(cid:37)(cid:16)(cid:34)(cid:33,,24330.0
,,2,,,Unknown,,cid:12)(cid:29)(cid:26)(cid:41)(cid:25)(cid:2)(cid:53)(cid:53)(cid:37)(cid:16)(cid:34)(cid:33,,24332.0
,,12,,,Unknown,,cid:12)(cid:29)(cid:26)(cid:41)(cid:25)(cid:2)(cid:53)(cid:53)(cid:37)(cid:16)(cid:34)(cid:33,,24344.0
,,20,,,Unknown,,cid:12)(cid:29)(cid:26)(cid:41)(cid:25)(cid:2)(cid:53)(cid:53)(cid:37)(cid:16)(cid:34)(cid:33,,24364.0
,,21,,,Unknown,,cid:12)(cid:29)(cid:26)(cid:41)(cid:25)(cid:2)(cid:53)(cid:53)(cid:37)(cid:16)(cid:34)(cid:33,,24385.0
,,22,,,Unknown,,cid:12)(cid:29)(cid:26)(cid:41)(cid:25)(cid:2)(cid:53)(cid:53)(cid:37)(cid:16)(cid:34)(cid:33,,24407.0
,,20,,,Unknown,,cid:12)(cid:29)(cid:26)(cid:41)(cid:25)(cid:2)(cid:53)(cid:53)(cid:37)(cid:16)(cid:34)(cid:33,,24427.0
,,23,,,Unknown,,cid:12)(cid:29)(cid:26)(cid:41)(cid:25)(cid:2)(cid:53)(cid:53)(cid:37)(cid:16)(cid:34)(cid:33,,24450.0
,,23,,,Unknown,,cid:12)(cid:29)(cid:26)(cid:41)(cid:25)(cid:2)(cid:53)(cid:53)(cid:37)(cid:16)(cid:34)(cid:33,,24473.0
,,24,,,Unknown,,cid:12)(cid:29)(cid:26)(cid:41)(cid:25)(cid:2)(cid:53)(cid:53)(cid:37)(cid:16)(cid:34)(cid:33,,24497.0
,,25,,,Unknown,,cid:12)(cid:29)(cid:26)(cid:41)(cid:25)(cid:2)(cid:53)(cid:53)(cid:37)(cid:16)(cid:34)(cid:33,,24522.0
,,26,,,Unknown,,cid:12)(cid:29)(cid:26)(cid:41)(cid:25)(cid:2)(cid:53)(cid:53)(cid:37)(cid:16)(cid:34)(cid:33,,24548.0
,,27,,,Unknown,,cid:12)(cid:29)(cid:26)(cid:41)(cid:25)(cid:2)(cid:53)(cid:53)(cid:37)(cid:16)(cid:34)(cid:33,,24575.0
,,2,,,Unknown,,cid:12)(cid:29)(cid:26)(cid:41)(cid:25)(cid:2)(cid:53)(cid:53)(cid:37)(cid:16)(cid:34)(cid:33,,24577.0
,,28,,,Unknown,,cid:12)(cid:29)(cid:26)(cid:41)(cid:25)(cid:2)(cid:53)(cid:53)(cid:37)(cid:16)(cid:34)(cid:33,,24605.0
,,3,,,Unknown,,cid:12)(cid:29)(cid:26)(cid:41)(cid:25)(cid:2)(cid:53)(cid:53)(cid:37)(cid:16)(cid:34)(cid:33,,24608.0
,,15,,,Unknown,,cid:12)(cid:29)(cid:26)(cid:41)(cid:25)(cid:2)(cid:53)(cid:53)(cid:37)(cid:16)(cid:34)(cid:33,,24623.0
,,2,,,Unknown,,cid:12)(cid:29)(cid:26)(cid:41)(cid:25)(cid:2)(cid:53)(cid:53)(cid:37)(cid:16)(cid:34)(cid:33,,24625.0
,,37,,,Unknown,,cid:12)(cid:29)(cid:26)(cid:41)(cid:25)(cid:2)(cid:53)(cid:53)(cid:37)(cid:16)(cid:34)(cid:33,,24662.0
,,1,,,Unknown,,cid:12)(cid:29)(cid:26)(cid:41)(cid:25)(cid:2)(cid:53)(cid:53)(cid:37)(cid:16)(cid:34)(cid:33,,24663.0
,,19,,,Unknown,,cid:12)(cid:29)(cid:26)(cid:41)(cid:25)(cid:2)(cid:53)(cid:53)(cid:37)(cid:16)(cid:34)(cid:33,,24682.0
,,1,,,Unknown,,cid:12)(cid:29)(cid:26)(cid:41)(cid:25)(cid:2)(cid:53)(cid:53)(cid:37)(cid:16)(cid:34)(cid:33,,24683.0
,,36,,,Unknown,,cid:12)(cid:29)(cid:26)(cid:41)(cid:25)(cid:2)(cid:53)(cid:53)(cid:37)(cid:16)(cid:34)(cid:33,,24719.0
,,2,,,Unknown,,cid:12)(cid:29)(cid:26)(cid:41)(cid:25)(cid:2)(cid:53)(cid:53)(cid:37)(cid:16)(cid:34)(cid:33,,24721.0
,,44,,,Unknown,,cid:12)(cid:29)(cid:26)(cid:41)(cid:25)(cid:2)(cid:53)(cid:53)(cid:37)(cid:16)(cid:34)(cid:33,,24765.0
,,12,,,Unknown,,cid:12)(cid:29)(cid:26)(cid:41)(cid:25)(cid:2)(cid:53)(cid:53)(cid:37)(cid:16)(cid:34)(cid:33,,24777.0
,,29,,,Unknown,,cid:12)(cid:29)(cid:26)(cid:41)(cid:25)(cid:2)(cid:53)(cid:53)(cid:37)(cid:16)(cid:34)(cid:33,,24806.0
,,26,,,Unknown,,cid:12)(cid:29)(cid:26)(cid:41)(cid:25)(cid:2)(cid:53)(cid:53)(cid:37)(cid:16)(cid:34)(cid:33,,24832.0
,,41,,,Unknown,,cid:12)(cid:29)(cid:26)(cid:41)(cid:25)(cid:2)(cid:53)(cid:53)(cid:37)(cid:16)(cid:34)(cid:33,,24873.0
,,25,,,Unknown,,cid:12)(cid:29)(cid:26)(cid:41)(cid:25)(cid:2)(cid:53)(cid:53)(cid:37)(cid:16)(cid:34)(cid:33,,24898.0
,,2,,,Unknown,,cid:12)(cid:29)(cid:26)(cid:41)(cid:25)(cid:2)(cid:53)(cid:53)(cid:37)(cid:16)(cid:34)(cid:33,,24900.0
,,53,,,Unknown,,cid:12)(cid:29)(cid:26)(cid:41)(cid:25)(cid:2)(cid:53)(cid:53)(cid:37)(cid:16)(cid:34)(cid:33,,24953.0
,,53,,,Unknown,,cid:12)(cid:29)(cid:26)(cid:41)(cid:25)(cid:2)(cid:53)(cid:53)(cid:37)(cid:16)(cid:34)(cid:33,,25006.0
,,37,,,Unknown,,cid:12)(cid:29)(cid:26)(cid:41)(cid:25)(cid:2)(cid:53)(cid:53)(cid:37)(cid:16)(cid:34)(cid:33,,25043.0
,,16,,,Unknown,,cid:12)(cid:29)(cid:26)(cid:41)(cid:25)(cid:2)(cid:53)(cid:53)(cid:37)(cid:16)(cid:34)(cid:33,,25059.0
,,34,,,Unknown,,cid:12)(cid:29)(cid:26)(cid:41)(cid:25)(cid:2)(cid:53)(cid:53)(cid:37)(cid:16)(cid:34)(cid:33,,25093.0
,,33,,,Unknown,,cid:12)(cid:29)(cid:26)(cid:41)(cid:25)(cid:2)(cid:53)(cid:53)(cid:37)(cid:16)(cid:34)(cid:33,,25126.0
,,37,,,Unknown,,cid:12)(cid:29)(cid:26)(cid:41)(cid:25)(cid:2)(cid:53)(cid:53)(cid:37)(cid:16)(cid:34)(cid:33,,25163.0
,,17,,,Unknown,,cid:12)(cid:29)(cid:26)(cid:41)(cid:25)(cid:2)(cid:53)(cid:53)(cid:37)(cid:16)(cid:34)(cid:33,,25180.0
,,45,,,Unknown,,cid:12)(cid:29)(cid:26)(cid:41)(cid:25)(cid:2)(cid:53)(cid:53)(cid:37)(cid:16)(cid:34)(cid:33,,25225.0
,,18,,,Unknown,,cid:12)(cid:29)(cid:26)(cid:41)(cid:25)(cid:2)(cid:53)(cid:53)(cid:37)(cid:16)(cid:34)(cid:33,,25243.0
,,34,,,Unknown,,cid:12)(cid:29)(cid:26)(cid:41)(cid:25)(cid:2)(cid:53)(cid:53)(cid:37)(cid:16)(cid:34)(cid:33,,25277.0
,,7,,,Unknown,,cid:12)(cid:29)(cid:26)(cid:41)(cid:25)(cid:2)(cid:53)(cid:53)(cid:37)(cid:16)(cid:34)(cid:33,,25284.0
,,8,,,Unknown,,cid:12)(cid:29)(cid:26)(cid:41)(cid:25)(cid:2)(cid:53)(cid:53)(cid:37)(cid:16)(cid:34)(cid:33,,25292.0
,,10,,,Unknown,,cid:12)(cid:29)(cid:26)(cid:41)(cid:25)(cid:2)(cid:53)(cid:53)(cid:37)(cid:16)(cid:34)(cid:33,,25302.0
,,5,,,Unknown,,cid:12)(cid:29)(cid:26)(cid:41)(cid:25)(cid:2)(cid:53)(cid:53)(cid:37)(cid:16)(cid:34)(cid:33,,25307.0
,,3,,,Unknown,,cid:12)(cid:29)(cid:26)(cid:41)(cid:25)(cid:2)(cid:53)(cid:53)(cid:37)(cid:16)(cid:34)(cid:33,,25310.0
,,9,,,Unknown,,cid:12)(cid:29)(cid:26)(cid:41)(cid:25)(cid:2)(cid:53)(cid:53)(cid:37)(cid:16)(cid:34)(cid:33,,25319.0
,,39,,,Unknown,,cid:12)(cid:29)(cid:26)(cid:41)(cid:25)(cid:2)(cid:53)(cid:53)(cid:37)(cid:16)(cid:34)(cid:33,,25358.0
,,11,,,Unknown,,cid:12)(cid:29)(cid:26)(cid:41)(cid:25)(cid:2)(cid:53)(cid:53)(cid:37)(cid:16)(cid:34)(cid:33,,25369.0
,,3,,,Unknown,,cid:12)(cid:29)(cid:26)(cid:41)(cid:25)(cid:2)(cid:53)(cid:53)(cid:37)(cid:16)(cid:34)(cid:33,,25372.0
,,10,,,Unknown,,cid:12)(cid:29)(cid:26)(cid:41)(cid:25)(cid:2)(cid:53)(cid:53)(cid:37)(cid:16)(cid:34)(cid:33,,25382.0
,,2,,,Unknown,,cid:12)(cid:29)(cid:26)(cid:41)(cid:25)(cid:2)(cid:53)(cid:53)(cid:37)(cid:16)(cid:34)(cid:33,,25384.0
,,12,,,Unknown,,cid:12)(cid:29)(cid:26)(cid:41)(cid:25)(cid:2)(cid:53)(cid:53)(cid:37)(cid:16)(cid:34)(cid:33,,25396.0
,,11,,,Unknown,,cid:12)(cid:29)(cid:26)(cid:41)(cid:25)(cid:2)(cid:53)(cid:53)(cid:37)(cid:16)(cid:34)(cid:33,,25407.0
,,4,,,Unknown,,cid:12)(cid:29)(cid:26)(cid:41)(cid:25)(cid:2)(cid:53)(cid:53)(cid:37)(cid:16)(cid:34)(cid:33,,25411.0
,,14,,,Unknown,,cid:12)(cid:29)(cid:26)(cid:41)(cid:25)(cid:2)(cid:53)(cid:53)(cid:37)(cid:16)(cid:34)(cid:33,,25425.0
,,11,,,Unknown,,cid:12)(cid:29)(cid:26)(cid:41)(cid:25)(cid:2)(cid:53)(cid:53)(cid:37)(cid:16)(cid:34)(cid:33,,25436.0
,,62,,,Unknown,,cid:12)(cid:29)(cid:26)(cid:41)(cid:25)(cid:2)(cid:53)(cid:53)(cid:37)(cid:16)(cid:34)(cid:33,,25498.0
,,62,,,Unknown,,cid:12)(cid:29)(cid:26)(cid:41)(cid:25)(cid:2)(cid:53)(cid:53)(cid:37)(cid:16)(cid:34)(cid:33,,25560.0
,,7,,,Unknown,,cid:12)(cid:29)(cid:26)(cid:41)(cid:25)(cid:2)(cid:53)(cid:53)(cid:37)(cid:16)(cid:34)(cid:33,,25567.0
,,5,,,Unknown,,cid:12)(cid:29)(cid:26)(cid:41)(cid:25)(cid:2)(cid:53)(cid:53)(cid:37)(cid:16)(cid:34)(cid:33,,25572.0
,,3,,,Unknown,,cid:12)(cid:29)(cid:26)(cid:41)(cid:25)(cid:2)(cid:53)(cid:53)(cid:37)(cid:16)(cid:34)(cid:33,,25575.0
,,9,,,Unknown,,cid:12)(cid:29)(cid:26)(cid:41)(cid:25)(cid:2)(cid:53)(cid:53)(cid:37)(cid:16)(cid:34)(cid:33,,25584.0
,,2,,,Unknown,,cid:12)(cid:29)(cid:26)(cid:41)(cid:25)(cid:2)(cid:53)(cid:53)(cid:37)(cid:16)(cid:34)(cid:33,,25586.0
,,28,,,Unknown,,cid:12)(cid:29)(cid:26)(cid:41)(cid:25)(cid:2)(cid:53)(cid:53)(cid:37)(cid:16)(cid:34)(cid:33,,25614.0
,,3,,,Unknown,,cid:12)(cid:29)(cid:26)(cid:41)(cid:25)(cid:2)(cid:53)(cid:53)(cid:37)(cid:16)(cid:34)(cid:33,,25617.0
,,15,,,Unknown,,cid:12)(cid:29)(cid:26)(cid:41)(cid:25)(cid:2)(cid:53)(cid:53)(cid:37)(cid:16)(cid:34)(cid:33,,25632.0
,,2,,,Unknown,,cid:12)(cid:29)(cid:26)(cid:41)(cid:25)(cid:2)(cid:53)(cid:53)(cid:37)(cid:16)(cid:34)(cid:33,,25634.0
,,17,,,Unknown,,cid:12)(cid:29)(cid:26)(cid:41)(cid:25)(cid:2)(cid:53)(cid:53)(cid:37)(cid:16)(cid:34)(cid:33,,25651.0
,,17,,,Unknown,,cid:12)(cid:29)(cid:26)(cid:41)(cid:25)(cid:2)(cid:53)(cid:53)(cid:37)(cid:16)(cid:34)(cid:33,,25668.0
,,33,,,Unknown,,cid:12)(cid:29)(cid:26)(cid:41)(cid:25)(cid:2)(cid:53)(cid:53)(cid:37)(cid:16)(cid:34)(cid:33,,25701.0
,,19,,,Unknown,,cid:12)(cid:29)(cid:26)(cid:41)(cid:25)(cid:2)(cid:53)(cid:53)(cid:37)(cid:16)(cid:34)(cid:33,,25720.0
,,33,,,Unknown,,cid:12)(cid:29)(cid:26)(cid:41)(cid:25)(cid:2)(cid:53)(cid:53)(cid:37)(cid:16)(cid:34)(cid:33,,25753.0
,,33,,,Unknown,,cid:12)(cid:29)(cid:26)(cid:41)(cid:25)(cid:2)(cid:53)(cid:53)(cid:37)(cid:16)(cid:34)(cid:33,,25786.0
,,2,,,Unknown,,cid:12)(cid:29)(cid:26)(cid:41)(cid:25)(cid:2)(cid:53)(cid:53)(cid:37)(cid:16)(cid:34)(cid:33,,25788.0
,,44,,,Unknown,,cid:12)(cid:29)(cid:26)(cid:41)(cid:25)(cid:2)(cid:53)(cid:53)(cid:37)(cid:16)(cid:34)(cid:33,,25832.0
,,12,,,Unknown,,cid:12)(cid:29)(cid:26)(cid:41)(cid:25)(cid:2)(cid:53)(cid:53)(cid:37)(cid:16)(cid:34)(cid:33,,25844.0
,,29,,,Unknown,,cid:12)(cid:29)(cid:26)(cid:41)(cid:25)(cid:2)(cid:53)(cid:53)(cid:37)(cid:16)(cid:34)(cid:33,,25873.0
,,26,,,Unknown,,cid:12)(cid:29)(cid:26)(cid:41)(cid:25)(cid:2)(cid:53)(cid:53)(cid:37)(cid:16)(cid:34)(cid:33,,25899.0
,,41,,,Unknown,,cid:12)(cid:29)(cid:26)(cid:41)(cid:25)(cid:2)(cid:53)(cid:53)(cid:37)(cid:16)(cid:34)(cid:33,,25940.0
,,25,,,Unknown,,cid:12)(cid:29)(cid:26)(cid:41)(cid:25)(cid:2)(cid:53)(cid:53)(cid:37)(cid:16)(cid:34)(cid:33,,25965.0
,,2,,,Unknown,,cid:12)(cid:29)(cid:26)(cid:41)(cid:25)(cid:2)(cid:53)(cid:53)(cid:37)(cid:16)(cid:34)(cid:33,,25967.0
,,53,,,Unknown,,cid:12)(cid:29)(cid:26)(cid:41)(cid:25)(cid:2)(cid:53)(cid:53)(cid:37)(cid:16)(cid:34)(cid:33,,26020.0
,,53,,,Unknown,,cid:12)(cid:29)(cid:26)(cid:41)(cid:25)(cid:2)(cid:53)(cid:53)(cid:37)(cid:16)(cid:34)(cid:33,,26073.0
,,18,,,Unknown,,cid:12)(cid:29)(cid:26)(cid:41)(cid:25)(cid:2)(cid:53)(cid:53)(cid:37)(cid:16)(cid:34)(cid:33,,26091.0
,,1,,,Unknown,,cid:12)(cid:29)(cid:26)(cid:41)(cid:25)(cid:2)(cid:53)(cid:53)(cid:37)(cid:16)(cid:34)(cid:33,,26092.0
,,1,,,Unknown,,cid:12)(cid:29)(cid:26)(cid:41)(cid:25)(cid:2)(cid:53)(cid:53)(cid:37)(cid:16)(cid:34)(cid:33,,26093.0
,,37,,,Unknown,,cid:12)(cid:29)(cid:26)(cid:41)(cid:25)(cid:2)(cid:53)(cid:53)(cid:37)(cid:16)(cid:34)(cid:33,,26130.0
,,18,,,Unknown,,cid:12)(cid:29)(cid:26)(cid:41)(cid:25)(cid:2)(cid:53)(cid:53)(cid:37)(cid:16)(cid:34)(cid:33,,26148.0
,,17,,,Unknown,,cid:12)(cid:29)(cid:26)(cid:41)(cid:25)(cid:2)(cid:53)(cid:53)(cid:37)(cid:16)(cid:34)(cid:33,,26165.0
,,45,,,Unknown,,cid:12)(cid:29)(cid:26)(cid:41)(cid:25)(cid:2)(cid:53)(cid:53)(cid:37)(cid:16)(cid:34)(cid:33,,26210.0
,,18,,,Unknown,,cid:12)(cid:29)(cid:26)(cid:41)(cid:25)(cid:2)(cid:53)(cid:53)(cid:37)(cid:16)(cid:34)(cid:33,,26228.0
,,32,,,Unknown,,cid:12)(cid:29)(cid:26)(cid:41)(cid:25)(cid:2)(cid:53)(cid:53)(cid:37)(cid:16)(cid:34)(cid:33,,26260.0
,,10,,,Unknown,,cid:12)(cid:29)(cid:26)(cid:41)(cid:25)(cid:2)(cid:53)(cid:53)(cid:37)(cid:16)(cid:34)(cid:33,,26270.0
,,11,,,Unknown,,cid:12)(cid:29)(cid:26)(cid:41)(cid:25)(cid:2)(cid:53)(cid:53)(cid:37)(cid:16)(cid:34)(cid:33,,26281.0
,,10,,,Unknown,,cid:12)(cid:29)(cid:26)(cid:41)(cid:25)(cid:2)(cid:53)(cid:53)(cid:37)(cid:16)(cid:34)(cid:33,,26291.0
,,49,,,Unknown,,cid:12)(cid:29)(cid:26)(cid:41)(cid:25)(cid:2)(cid:53)(cid:53)(cid:37)(cid:16)(cid:34)(cid:33,,26340.0
,,14,,,Unknown,,cid:12)(cid:29)(cid:26)(cid:41)(cid:25)(cid:2)(cid:53)(cid:53)(cid:37)(cid:16)(cid:34)(cid:33,,26354.0
,,2,,,Unknown,,cid:12)(cid:29)(cid:26)(cid:41)(cid:25)(cid:2)(cid:53)(cid:53)(cid:37)(cid:16)(cid:34)(cid:33,,26356.0
,,12,,,Unknown,,cid:12)(cid:29)(cid:26)(cid:41)(cid:25)(cid:2)(cid:53)(cid:53)(cid:37)(cid:16)(cid:34)(cid:33,,26368.0
,,11,,,Unknown,,cid:12)(cid:29)(cid:26)(cid:41)(cid:25)(cid:2)(cid:53)(cid:53)(cid:37)(cid:16)(cid:34)(cid:33,,26379.0
,,4,,,Unknown,,cid:12)(cid:29)(cid:26)(cid:41)(cid:25)(cid:2)(cid:53)(cid:53)(cid:37)(cid:16)(cid:34)(cid:33,,26383.0
,,14,,,Unknown,,cid:12)(cid:29)(cid:26)(cid:41)(cid:25)(cid:2)(cid:53)(cid:53)(cid:37)(cid:16)(cid:34)(cid:33,,26397.0
,,11,,,Unknown,,cid:12)(cid:29)(cid:26)(cid:41)(cid:25)(cid:2)(cid:53)(cid:53)(cid:37)(cid:16)(cid:34)(cid:33,,26408.0
,,62,,,Unknown,,cid:12)(cid:29)(cid:26)(cid:41)(cid:25)(cid:2)(cid:53)(cid:53)(cid:37)(cid:16)(cid:34)(cid:33,,26470.0
,,62,,,Unknown,,cid:12)(cid:29)(cid:26)(cid:41)(cid:25)(cid:2)(cid:53)(cid:53)(cid:37)(cid:16)(cid:34)(cid:33,,26532.0
,,7,,,Unknown,,cid:12)(cid:29)(cid:26)(cid:41)(cid:25)(cid:2)(cid:53)(cid:53)(cid:37)(cid:16)(cid:34)(cid:33,,26539.0
,,5,,,Unknown,,cid:12)(cid:29)(cid:26)(cid:41)(cid:25)(cid:2)(cid:53)(cid:53)(cid:37)(cid:16)(cid:34)(cid:33,,26544.0
,,3,,,Unknown,,cid:12)(cid:29)(cid:26)(cid:41)(cid:25)(cid:2)(cid:53)(cid:53)(cid:37)(cid:16)(cid:34)(cid:33,,26547.0
,,9,,,Unknown,,cid:12)(cid:29)(cid:26)(cid:41)(cid:25)(cid:2)(cid:53)(cid:53)(cid:37)(cid:16)(cid:34)(cid:33,,26556.0
,,2,,,Unknown,,cid:12)(cid:29)(cid:26)(cid:41)(cid:25)(cid:2)(cid:53)(cid:53)(cid:37)(cid:16)(cid:34)(cid:33,,26558.0
,,28,,,Unknown,,cid:12)(cid:29)(cid:26)(cid:41)(cid:25)(cid:2)(cid:53)(cid:53)(cid:37)(cid:16)(cid:34)(cid:33,,26586.0
,,3,,,Unknown,,cid:12)(cid:29)(cid:26)(cid:41)(cid:25)(cid:2)(cid:53)(cid:53)(cid:37)(cid:16)(cid:34)(cid:33,,26589.0
,,15,,,Unknown,,cid:12)(cid:29)(cid:26)(cid:41)(cid:25)(cid:2)(cid:53)(cid:53)(cid:37)(cid:16)(cid:34)(cid:33,,26604.0
,,2,,,Unknown,,cid:12)(cid:29)(cid:26)(cid:41)(cid:25)(cid:2)(cid:53)(cid:53)(cid:37)(cid:16)(cid:34)(cid:33,,26606.0
,,32,,,Unknown,,cid:12)(cid:29)(cid:26)(cid:41)(cid:25)(cid:2)(cid:53)(cid:53)(cid:37)(cid:16)(cid:34)(cid:33,,26638.0
,,18,,,Unknown,,cid:12)(cid:29)(cid:26)(cid:41)(cid:25)(cid:2)(cid:53)(cid:53)(cid:37)(cid:16)(cid:34)(cid:33,,26656.0
,,19,,,Unknown,,cid:12)(cid:29)(cid:26)(cid:41)(cid:25)(cid:2)(cid:53)(cid:53)(cid:37)(cid:16)(cid:34)(cid:33,,26675.0
,,17,,,Unknown,,cid:12)(cid:29)(cid:26)(cid:41)(cid:25)(cid:2)(cid:53)(cid:53)(cid:37)(cid:16)(cid:34)(cid:33,,26692.0
,,18,,,Unknown,,cid:12)(cid:29)(cid:26)(cid:41)(cid:25)(cid:2)(cid:53)(cid:53)(cid:37)(cid:16)(cid:34)(cid:33,,26710.0
,,2,,,Unknown,,cid:12)(cid:29)(cid:26)(cid:41)(cid:25)(cid:2)(cid:53)(cid:53)(cid:37)(cid:16)(cid:34)(cid:33,,26712.0
,,44,,,Unknown,,cid:12)(cid:29)(cid:26)(cid:41)(cid:25)(cid:2)(cid:53)(cid:53)(cid:37)(cid:16)(cid:34)(cid:33,,26756.0
,,12,,,Unknown,,cid:12)(cid:29)(cid:26)(cid:41)(cid:25)(cid:2)(cid:53)(cid:53)(cid:37)(cid:16)(cid:34)(cid:33,,26768.0
,,29,,,Unknown,,cid:12)(cid:29)(cid:26)(cid:41)(cid:25)(cid:2)(cid:53)(cid:53)(cid:37)(cid:16)(cid:34)(cid:33,,26797.0
,,26,,,Unknown,,cid:12)(cid:29)(cid:26)(cid:41)(cid:25)(cid:2)(cid:53)(cid:53)(cid:37)(cid:16)(cid:34)(cid:33,,26823.0
,,41,,,Unknown,,cid:12)(cid:29)(cid:26)(cid:41)(cid:25)(cid:2)(cid:53)(cid:53)(cid:37)(cid:16)(cid:34)(cid:33,,26864.0
,,25,,,Unknown,,cid:12)(cid:29)(cid:26)(cid:41)(cid:25)(cid:2)(cid:53)(cid:53)(cid:37)(cid:16)(cid:34)(cid:33,,26889.0
,,2,,,Unknown,,cid:12)(cid:29)(cid:26)(cid:41)(cid:25)(cid:2)(cid:53)(cid:53)(cid:37)(cid:16)(cid:34)(cid:33,,26891.0
,,53,,,Unknown,,cid:12)(cid:29)(cid:26)(cid:41)(cid:25)(cid:2)(cid:53)(cid:53)(cid:37)(cid:16)(cid:34)(cid:33,,26944.0
,,53,,,Unknown,,cid:12)(cid:29)(cid:26)(cid:41)(cid:25)(cid:2)(cid:53)(cid:53)(cid:37)(cid:16)(cid:34)(cid:33,,26997.0
,,18,,,Unknown,,cid:12)(cid:29)(cid:26)(cid:41)(cid:25)(cid:2)(cid:53)(cid:53)(cid:37)(cid:16)(cid:34)(cid:33,,27015.0
,,1,,,Unknown,,cid:12)(cid:29)(cid:26)(cid:41)(cid:25)(cid:2)(cid:53)(cid:53)(cid:37)(cid:16)(cid:34)(cid:33,,27016.0
,,1,,,Unknown,,cid:12)(cid:29)(cid:26)(cid:41)(cid:25)(cid:2)(cid:53)(cid:53)(cid:37)(cid:16)(cid:34)(cid:33,,27017.0
,,37,,,Unknown,,cid:12)(cid:29)(cid:26)(cid:41)(cid:25)(cid:2)(cid:53)(cid:53)(cid:37)(cid:16)(cid:34)(cid:33,,27054.0
,,10,,,Unknown,,Banque Inconnue,,10.0
,,20,,,Unknown,,Banque Inconnue,,30.0
,,21,,,Unknown,,Banque Inconnue,,51.0
,,41,,,Unknown,,Banque Inconnue,,92.0
,,25,,,Unknown,,Banque Inconnue,,117.0
,,27,,,Unknown,,Banque Inconnue,,144.0
,,2,,,Unknown,,Banque Inconnue,,146.0
,,22,,,Unknown,,Banque Inconnue,,168.0
,,25,,,Unknown,,Banque Inconnue,,193.0
,,27,,,Unknown,,Banque Inconnue,,220.0
,,2,,,Unknown,,Banque Inconnue,,222.0
,,31,,,Unknown,,Banque Inconnue,,253.0
,,29,,,Unknown,,Banque Inconnue,,282.0
,,26,,,Unknown,,Banque Inconnue,,308.0
,,41,,,Unknown,,Banque Inconnue,,349.0
,,25,,,Unknown,,Banque Inconnue,,374.0
,,27,,,Unknown,,Banque Inconnue,,401.0
,,2,,,Unknown,,Banque Inconnue,,403.0
,,51,,,Unknown,,Banque Inconnue,,454.0
,,25,,,Unknown,,Banque Inconnue,,479.0
,,2,,,Unknown,,Banque Inconnue,,481.0
,,48,,,Unknown,,Banque Inconnue,,529.0
,,20,,,Unknown,,Banque Inconnue,,549.0
,,41,,,Unknown,,Banque Inconnue,,590.0
,,26,,,Unknown,,Banque Inconnue,,616.0
,,25,,,Unknown,,Banque Inconnue,,641.0
,,2,,,Unknown,,Banque Inconnue,,643.0
,,31,,,Unknown,,Banque Inconnue,,674.0
,,20,,,Unknown,,Banque Inconnue,,694.0
,,23,,,Unknown,,Banque Inconnue,,717.0
,,55,,,Unknown,,Banque Inconnue,,772.0
,,41,,,Unknown,,Banque Inconnue,,813.0
,,25,,,Unknown,,Banque Inconnue,,838.0
,,2,,,Unknown,,Banque Inconnue,,840.0
,,38,,,Unknown,,Banque Inconnue,,878.0
,,20,,,Unknown,,Banque Inconnue,,898.0
,,30,,,Unknown,,Banque Inconnue,,928.0
,,41,,,Unknown,,Banque Inconnue,,969.0
,,20,,,Unknown,,Banque Inconnue,,989.0
,,2,,,Unknown,,Banque Inconnue,,991.0
,,27,,,Unknown,,Banque Inconnue,,1018.0
,,20,,,Unknown,,Banque Inconnue,,1038.0
,,30,,,Unknown,,Banque Inconnue,,1068.0
,,41,,,Unknown,,Banque Inconnue,,1109.0
,,2,,,Unknown,,Banque Inconnue,,1111.0
,,31,,,Unknown,,Banque Inconnue,,1142.0
,,20,,,Unknown,,Banque Inconnue,,1162.0
,,23,,,Unknown,,Banque Inconnue,,1185.0
,,55,,,Unknown,,Banque Inconnue,,1240.0
,,29,,,Unknown,,Banque Inconnue,,1269.0
,,41,,,Unknown,,Banque Inconnue,,1310.0
,,24,,,Unknown,,Banque Inconnue,,1334.0
,,50,,,Unknown,,Banque Inconnue,,1384.0
,,22,,,Unknown,,Banque Inconnue,,1406.0
,,25,,,Unknown,,Banque Inconnue,,1431.0
,,27,,,Unknown,,Banque Inconnue,,1458.0
,,2,,,Unknown,,Banque Inconnue,,1460.0
,,29,,,Unknown,,Banque Inconnue,,1489.0
,,48,,,Unknown,,Banque Inconnue,,1537.0
,,25,,,Unknown,,Banque Inconnue,,1562.0
,,31,,,Unknown,,Banque Inconnue,,1593.0
,,2,,,Unknown,,Banque Inconnue,,1595.0
,,49,,,Unknown,,Banque Inconnue,,1644.0
,,55,,,Unknown,,Banque Inconnue,,1699.0
,,55,,,Unknown,,Banque Inconnue,,1754.0
,,22,,,Unknown,,Banque Inconnue,,1776.0
,,25,,,Unknown,,Banque Inconnue,,1801.0
,,2,,,Unknown,,Banque Inconnue,,1803.0
,,39,,,Unknown,,Banque Inconnue,,1842.0
,,29,,,Unknown,,Banque Inconnue,,1871.0
,,72,,,Unknown,,Banque Inconnue,,1943.0
,,2,,,Unknown,,Banque Inconnue,,1945.0
,,25,,,Unknown,,Banque Inconnue,,1970.0
,,41,,,Unknown,,Banque Inconnue,,2011.0
,,2,,,Unknown,,Banque Inconnue,,2013.0
,,46,,,Unknown,,Banque Inconnue,,2059.0
,,20,,,Unknown,,Banque Inconnue,,2079.0
,,20,,,Unknown,,Banque Inconnue,,2099.0
,,69,,,Unknown,,Banque Inconnue,,2168.0
,,22,,,Unknown,,Banque Inconnue,,2190.0
,,25,,,Unknown,,Banque Inconnue,,2215.0
,,2,,,Unknown,,Banque Inconnue,,2217.0
,,39,,,Unknown,,Banque Inconnue,,2256.0
,,29,,,Unknown,,Banque Inconnue,,2285.0
,,72,,,Unknown,,Banque Inconnue,,2357.0
,,74,,,Unknown,,Banque Inconnue,,2431.0
,,38,,,Unknown,,Banque Inconnue,,2469.0
,,20,,,Unknown,,Banque Inconnue,,2489.0
,,30,,,Unknown,,Banque Inconnue,,2519.0
,,41,,,Unknown,,Banque Inconnue,,2560.0
,,20,,,Unknown,,Banque Inconnue,,2580.0
,,19,,,Unknown,,Banque Inconnue,,2599.0
,,2,,,Unknown,,Banque Inconnue,,2601.0
,,21,,,Unknown,,Banque Inconnue,,2622.0
,,30,,,Unknown,,Banque Inconnue,,2652.0
,,25,,,Unknown,,Banque Inconnue,,2677.0
,,2,,,Unknown,,Banque Inconnue,,2679.0
,,23,,,Unknown,,Banque Inconnue,,2702.0
,,29,,,Unknown,,Banque Inconnue,,2731.0
,,26,,,Unknown,,Banque Inconnue,,2757.0
,,59,,,Unknown,,Banque Inconnue,,2816.0
,,21,,,Unknown,,Banque Inconnue,,2837.0
,,25,,,Unknown,,Banque Inconnue,,2862.0
,,2,,,Unknown,,Banque Inconnue,,2864.0
,,51,,,Unknown,,Banque Inconnue,,2915.0
,,25,,,Unknown,,Banque Inconnue,,2940.0
,,2,,,Unknown,,Banque Inconnue,,2942.0
,,11,,,Unknown,,Banque Inconnue,,2953.0
,,14,,,Unknown,,Banque Inconnue,,2967.0
,,7,,,Unknown,,Banque Inconnue,,2974.0
,,8,,,Unknown,,Banque Inconnue,,2982.0
,,52,,,Unknown,,Banque Inconnue,,3034.0
,,49,,,Unknown,,Banque Inconnue,,3083.0
,,2,,,Unknown,,Banque Inconnue,,3085.0
,,9,,,Unknown,,Banque Inconnue,,3094.0
,,49,,,Unknown,,Banque Inconnue,,3143.0
,,9,,,Unknown,,Banque Inconnue,,3152.0
,,19,,,Unknown,,Banque Inconnue,,3171.0
,,2,,,Unknown,,Banque Inconnue,,3173.0
,,29,,,Unknown,,Banque Inconnue,,3202.0
,,21,,,Unknown,,Banque Inconnue,,3223.0
,,2,,,Unknown,,Banque Inconnue,,3225.0
,,31,,,Unknown,,Banque Inconnue,,3256.0
,,29,,,Unknown,,Banque Inconnue,,3285.0
,,55,,,Unknown,,Banque Inconnue,,3340.0
,,24,,,Unknown,,Banque Inconnue,,3364.0
,,41,,,Unknown,,Banque Inconnue,,3405.0
,,29,,,Unknown,,Banque Inconnue,,3434.0
,,22,,,Unknown,,Banque Inconnue,,3456.0
,,2,,,Unknown,,Banque Inconnue,,3458.0
,,51,,,Unknown,,Banque Inconnue,,3509.0
,,25,,,Unknown,,Banque Inconnue,,3534.0
,,2,,,Unknown,,Banque Inconnue,,3536.0
,,1,,,Unknown,,Banque Inconnue,,3537.0
,,34,,,Unknown,,Banque Inconnue,,3571.0
,,18,,,Unknown,,Banque Inconnue,,3589.0
,,2,,,Unknown,,Banque Inconnue,,3591.0
,,33,,,Unknown,,Banque Inconnue,,3624.0
,,33,,,Unknown,,Banque Inconnue,,3657.0
,,34,,,Unknown,,Banque Inconnue,,3691.0
,,2,,,Unknown,,Banque Inconnue,,3693.0
,,37,,,Unknown,,Banque Inconnue,,3730.0
,,34,,,Unknown,,Banque Inconnue,,3764.0
,,2,,,Unknown,,Banque Inconnue,,3766.0
,,44,,,Unknown,,Banque Inconnue,,3810.0
,,2,,,Unknown,,Banque Inconnue,,3812.0
,,15,,,Unknown,,Banque Inconnue,,3827.0
,,2,,,Unknown,,Banque Inconnue,,3829.0
,,27,,,Unknown,,Banque Inconnue,,3856.0
,,24,,,Unknown,,Banque Inconnue,,3880.0
,,58,,,Unknown,,Banque Inconnue,,3938.0
,,69,,,Unknown,,Banque Inconnue,,4007.0
,,25,,,Unknown,,Banque Inconnue,,4032.0
,,2,,,Unknown,,Banque Inconnue,,4034.0
,,27,,,Unknown,,Banque Inconnue,,4061.0
,,20,,,Unknown,,Banque Inconnue,,4081.0
,,31,,,Unknown,,Banque Inconnue,,4112.0
,,24,,,Unknown,,Banque Inconnue,,4136.0
,,29,,,Unknown,,Banque Inconnue,,4165.0
,,22,,,Unknown,,Banque Inconnue,,4187.0
,,2,,,Unknown,,Banque Inconnue,,4189.0
,,1,,,Unknown,,Banque Inconnue,,4190.0
,,18,,,Unknown,,Banque Inconnue,,4208.0
,,2,,,Unknown,,Banque Inconnue,,4210.0
,,50,,,Unknown,,Banque Inconnue,,4260.0
,,24,,,Unknown,,Banque Inconnue,,4284.0
,,27,,,Unknown,,Banque Inconnue,,4311.0
,,2,,,Unknown,,Banque Inconnue,,4313.0
,,26,,,Unknown,,Banque Inconnue,,4339.0
,,21,,,Unknown,,Banque Inconnue,,4360.0
,,25,,,Unknown,,Banque Inconnue,,4385.0
,,2,,,Unknown,,Banque Inconnue,,4387.0
,,14,,,Unknown,,Banque Inconnue,,4401.0
,,29,,,Unknown,,Banque Inconnue,,4430.0
,,2,,,Unknown,,Banque Inconnue,,4432.0
,,28,,,Unknown,,Banque Inconnue,,4460.0
,,29,,,Unknown,,Banque Inconnue,,4489.0
,,72,,,Unknown,,Banque Inconnue,,4561.0
,,25,,,Unknown,,Banque Inconnue,,4586.0
,,41,,,Unknown,,Banque Inconnue,,4627.0
,,41,,,Unknown,,Banque Inconnue,,4668.0
,,25,,,Unknown,,Banque Inconnue,,4693.0
,,19,,,Unknown,,Banque Inconnue,,4712.0
,,2,,,Unknown,,Banque Inconnue,,4714.0
,,16,,,Unknown,,Banque Inconnue,,4730.0
,,34,,,Unknown,,Banque Inconnue,,4764.0
,,18,,,Unknown,,Banque Inconnue,,4782.0
,,18,,,Unknown,,Banque Inconnue,,4800.0
,,33,,,Unknown,,Banque Inconnue,,4833.0
,,2,,,Unknown,,Banque Inconnue,,4835.0
,,39,,,Unknown,,Banque Inconnue,,4874.0
,,29,,,Unknown,,Banque Inconnue,,4903.0
,,26,,,Unknown,,Banque Inconnue,,4929.0
,,24,,,Unknown,,Banque Inconnue,,4953.0
,,27,,,Unknown,,Banque Inconnue,,4980.0
,,2,,,Unknown,,Banque Inconnue,,4982.0
,,15,,,Unknown,,Banque Inconnue,,4997.0
,,2,,,Unknown,,Banque Inconnue,,4999.0
,,3,,,Unknown,,Banque Inconnue,,5002.0
,,12,,,Unknown,,Banque Inconnue,,5014.0
,,9,,,Unknown,,Banque Inconnue,,5023.0
,,2,,,Unknown,,Banque Inconnue,,5025.0
,,39,,,Unknown,,Banque Inconnue,,5064.0
,,29,,,Unknown,,Banque Inconnue,,5093.0
,,26,,,Unknown,,Banque Inconnue,,5119.0
,,24,,,Unknown,,Banque Inconnue,,5143.0
,,27,,,Unknown,,Banque Inconnue,,5170.0
,,2,,,Unknown,,Banque Inconnue,,5172.0
,,30,,,Unknown,,Banque Inconnue,,5202.0
,,75,,,Unknown,,Banque Inconnue,,5277.0
,,35,,,Unknown,,Banque Inconnue,,5312.0
,,17,,,Unknown,,Banque Inconnue,,5329.0
,,33,,,Unknown,,Banque Inconnue,,5362.0
,,2,,,Unknown,,Banque Inconnue,,5364.0
,,36,,,Unknown,,Banque Inconnue,,5400.0
,,35,,,Unknown,,Banque Inconnue,,5435.0
,,33,,,Unknown,,Banque Inconnue,,5468.0
,,2,,,Unknown,,Banque Inconnue,,5470.0
,,32,,,Unknown,,Banque Inconnue,,5502.0
,,1,,,Unknown,,Banque Inconnue,,5503.0
,,32,,,Unknown,,Banque Inconnue,,5535.0
,,74,,,Unknown,,Banque Inconnue,,5609.0
,,11,,,Unknown,,Banque Inconnue,,5620.0
,,22,,,Unknown,,Banque Inconnue,,5642.0
,,24,,,Unknown,,Banque Inconnue,,5666.0
,,30,,,Unknown,,Banque Inconnue,,5696.0
,,51,,,Unknown,,Banque Inconnue,,5747.0
,,29,,,Unknown,,Banque Inconnue,,5776.0
,,2,,,Unknown,,Banque Inconnue,,5778.0
,,25,,,Unknown,,Banque Inconnue,,5803.0
,,27,,,Unknown,,Banque Inconnue,,5830.0
,,41,,,Unknown,,Banque Inconnue,,5871.0
,,2,,,Unknown,,Banque Inconnue,,5873.0
,,29,,,Unknown,,Banque Inconnue,,5902.0
,,69,,,Unknown,,Banque Inconnue,,5971.0
,,26,,,Unknown,,Banque Inconnue,,5997.0
,,42,,,Unknown,,Banque Inconnue,,6039.0
,,42,,,Unknown,,Banque Inconnue,,6081.0
,,2,,,Unknown,,Banque Inconnue,,6083.0
,,55,,,Unknown,,Banque Inconnue,,6138.0
,,29,,,Unknown,,Banque Inconnue,,6167.0
,,26,,,Unknown,,Banque Inconnue,,6193.0
,,2,,,Unknown,,Banque Inconnue,,6195.0
,,22,,,Unknown,,Banque Inconnue,,6217.0
,,68,,,Unknown,,Banque Inconnue,,6285.0
,,49,,,Unknown,,Banque Inconnue,,6334.0
,,21,,,Unknown,,Banque Inconnue,,6355.0
,,41,,,Unknown,,Banque Inconnue,,6396.0
,,20,,,Unknown,,Banque Inconnue,,6416.0
,,26,,,Unknown,,Banque Inconnue,,6442.0
,,24,,,Unknown,,Banque Inconnue,,6466.0
,,41,,,Unknown,,Banque Inconnue,,6507.0
,,42,,,Unknown,,Banque Inconnue,,6549.0
,,2,,,Unknown,,Banque Inconnue,,6551.0
,,51,,,Unknown,,Banque Inconnue,,6602.0
,,25,,,Unknown,,Banque Inconnue,,6627.0
,,2,,,Unknown,,Banque Inconnue,,6629.0
,,12,,,Unknown,,Banque Inconnue,,6641.0
,,20,,,Unknown,,Banque Inconnue,,6661.0
,,30,,,Unknown,,Banque Inconnue,,6691.0
,,41,,,Unknown,,Banque Inconnue,,6732.0
,,26,,,Unknown,,Banque Inconnue,,6758.0
,,56,,,Unknown,,Banque Inconnue,,6814.0
,,22,,,Unknown,,Banque Inconnue,,6836.0
,,25,,,Unknown,,Banque Inconnue,,6861.0
,,2,,,Unknown,,Banque Inconnue,,6863.0
,,39,,,Unknown,,Banque Inconnue,,6902.0
,,26,,,Unknown,,Banque Inconnue,,6928.0
,,21,,,Unknown,,Banque Inconnue,,6949.0
,,51,,,Unknown,,Banque Inconnue,,7000.0
,,25,,,Unknown,,Banque Inconnue,,7025.0
,,30,,,Unknown,,Banque Inconnue,,7055.0
,,41,,,Unknown,,Banque Inconnue,,7096.0
,,24,,,Unknown,,Banque Inconnue,,7120.0
,,25,,,Unknown,,Banque Inconnue,,7145.0
,,22,,,Unknown,,Banque Inconnue,,7167.0
,,2,,,Unknown,,Banque Inconnue,,7169.0
,,25,,,Unknown,,Banque Inconnue,,7194.0
,,41,,,Unknown,,Banque Inconnue,,7235.0
,,2,,,Unknown,,Banque Inconnue,,7237.0
,,51,,,Unknown,,Banque Inconnue,,7288.0
,,25,,,Unknown,,Banque Inconnue,,7313.0
,,2,,,Unknown,,Banque Inconnue,,7315.0
,,3,,,Unknown,,Banque Inconnue,,7318.0
,,42,,,Unknown,,Banque Inconnue,,7360.0
,,27,,,Unknown,,Banque Inconnue,,7387.0
,,20,,,Unknown,,Banque Inconnue,,7407.0
,,22,,,Unknown,,Banque Inconnue,,7429.0
,,21,,,Unknown,,Banque Inconnue,,7450.0
,,41,,,Unknown,,Banque Inconnue,,7491.0
,,24,,,Unknown,,Banque Inconnue,,7515.0
,,20,,,Unknown,,Banque Inconnue,,7535.0
,,30,,,Unknown,,Banque Inconnue,,7565.0
,,2,,,Unknown,,Banque Inconnue,,7567.0
,,66,,,Unknown,,Banque Inconnue,,7633.0
,,49,,,Unknown,,Banque Inconnue,,7682.0
,,12,,,Unknown,,Banque Inconnue,,7694.0
,,39,,,Unknown,,Banque Inconnue,,7733.0
,,3,,,Unknown,,Banque Inconnue,,7736.0
,,67,,,Unknown,,Banque Inconnue,,7803.0
,,2,,,Unknown,,Banque Inconnue,,7805.0
,,25,,,Unknown,,Banque Inconnue,,7830.0
,,30,,,Unknown,,Banque Inconnue,,7860.0
,,2,,,Unknown,,Banque Inconnue,,7862.0
,,41,,,Unknown,,Banque Inconnue,,7903.0
,,29,,,Unknown,,Banque Inconnue,,7932.0
,,30,,,Unknown,,Banque Inconnue,,7962.0
,,41,,,Unknown,,Banque Inconnue,,8003.0
,,2,,,Unknown,,Banque Inconnue,,8005.0
,,59,,,Unknown,,Banque Inconnue,,8064.0
,,21,,,Unknown,,Banque Inconnue,,8085.0
,,68,,,Unknown,,Banque Inconnue,,8153.0
,,42,,,Unknown,,Banque Inconnue,,8195.0
,,41,,,Unknown,,Banque Inconnue,,8236.0
,,29,,,Unknown,,Banque Inconnue,,8265.0
,,50,,,Unknown,,Banque Inconnue,,8315.0
,,22,,,Unknown,,Banque Inconnue,,8337.0
,,24,,,Unknown,,Banque Inconnue,,8361.0
,,27,,,Unknown,,Banque Inconnue,,8388.0
,,27,,,Unknown,,Banque Inconnue,,8415.0
,,25,,,Unknown,,Banque Inconnue,,8440.0
,,23,,,Unknown,,Banque Inconnue,,8463.0
,,25,,,Unknown,,Banque Inconnue,,8488.0
,,30,,,Unknown,,Banque Inconnue,,8518.0
,,41,,,Unknown,,Banque Inconnue,,8559.0
,,2,,,Unknown,,Banque Inconnue,,8561.0
,,51,,,Unknown,,Banque Inconnue,,8612.0
,,25,,,Unknown,,Banque Inconnue,,8637.0
,,2,,,Unknown,,Banque Inconnue,,8639.0
,,55,,,Unknown,,Banque Inconnue,,8694.0
,,29,,,Unknown,,Banque Inconnue,,8723.0
,,24,,,Unknown,,Banque Inconnue,,8747.0
,,25,,,Unknown,,Banque Inconnue,,8772.0
,,23,,,Unknown,,Banque Inconnue,,8795.0
,,25,,,Unknown,,Banque Inconnue,,8820.0
,,30,,,Unknown,,Banque Inconnue,,8850.0
,,41,,,Unknown,,Banque Inconnue,,8891.0
,,2,,,Unknown,,Banque Inconnue,,8893.0
,,27,,,Unknown,,Banque Inconnue,,8920.0
,,20,,,Unknown,,Banque Inconnue,,8940.0
,,21,,,Unknown,,Banque Inconnue,,8961.0
,,27,,,Unknown,,Banque Inconnue,,8988.0
,,2,,,Unknown,,Banque Inconnue,,8990.0
,,22,,,Unknown,,Banque Inconnue,,9012.0
,,25,,,Unknown,,Banque Inconnue,,9037.0
,,2,,,Unknown,,Banque Inconnue,,9039.0
,,30,,,Unknown,,Banque Inconnue,,9069.0
,,21,,,Unknown,,Banque Inconnue,,9090.0
,,23,,,Unknown,,Banque Inconnue,,9113.0
,,42,,,Unknown,,Banque Inconnue,,9155.0
,,26,,,Unknown,,Banque Inconnue,,9181.0
,,20,,,Unknown,,Banque Inconnue,,9201.0
,,2,,,Unknown,,Banque Inconnue,,9203.0
,,17,,,Unknown,,Banque Inconnue,,9220.0
,,32,,,Unknown,,Banque Inconnue,,9252.0
,,33,,,Unknown,,Banque Inconnue,,9285.0
,,34,,,Unknown,,Banque Inconnue,,9319.0
,,35,,,Unknown,,Banque Inconnue,,9354.0
,,74,,,Unknown,,Banque Inconnue,,9428.0
,,52,,,Unknown,,Banque Inconnue,,9480.0
,,21,,,Unknown,,Banque Inconnue,,9501.0
,,2,,,Unknown,,Banque Inconnue,,9503.0
,,18,,,Unknown,,Banque Inconnue,,9521.0
,,17,,,Unknown,,Banque Inconnue,,9538.0
,,45,,,Unknown,,Banque Inconnue,,9583.0
,,18,,,Unknown,,Banque Inconnue,,9601.0
,,34,,,Unknown,,Banque Inconnue,,9635.0
,,45,,,Unknown,,Banque Inconnue,,9680.0
,,1,,,Unknown,,Banque Inconnue,,9681.0
,,18,,,Unknown,,Banque Inconnue,,9699.0
,,1,,,Unknown,,Banque Inconnue,,9700.0
,,17,,,Unknown,,Banque Inconnue,,9717.0
,,2,,,Unknown,,Banque Inconnue,,9719.0
,,29,,,Unknown,,Banque Inconnue,,9748.0
,,21,,,Unknown,,Banque Inconnue,,9769.0
,,2,,,Unknown,,Banque Inconnue,,9771.0
,,37,,,Unknown,,Banque Inconnue,,9808.0
,,17,,,Unknown,,Banque Inconnue,,9825.0
,,45,,,Unknown,,Banque Inconnue,,9870.0
,,18,,,Unknown,,Banque Inconnue,,9888.0
,,34,,,Unknown,,Banque Inconnue,,9922.0
,,45,,,Unknown,,Banque Inconnue,,9967.0
,,1,,,Unknown,,Banque Inconnue,,9968.0
,,18,,,Unknown,,Banque Inconnue,,9986.0
,,1,,,Unknown,,Banque Inconnue,,9987.0
,,17,,,Unknown,,Banque Inconnue,,10004.0
,,5,,,Unknown,,Banque Inconnue,,10009.0
,,46,,,Unknown,,Banque Inconnue,,10055.0
,,47,,,Unknown,,Banque Inconnue,,10102.0
,,66,,,Unknown,,Banque Inconnue,,10168.0
,,28,,,Unknown,,Banque Inconnue,,10196.0
,,3,,,Unknown,,Banque Inconnue,,10199.0
,,16,,,Unknown,,Banque Inconnue,,10215.0
,,32,,,Unknown,,Banque Inconnue,,10247.0
,,2,,,Unknown,,Banque Inconnue,,10249.0
,,17,,,Unknown,,Banque Inconnue,,10266.0
,,32,,,Unknown,,Banque Inconnue,,10298.0
,,33,,,Unknown,,Banque Inconnue,,10331.0
,,34,,,Unknown,,Banque Inconnue,,10365.0
,,2,,,Unknown,,Banque Inconnue,,10367.0
,,35,,,Unknown,,Banque Inconnue,,10402.0
,,18,,,Unknown,,Banque Inconnue,,10420.0
,,18,,,Unknown,,Banque Inconnue,,10438.0
,,18,,,Unknown,,Banque Inconnue,,10456.0
,,2,,,Unknown,,Banque Inconnue,,10458.0
,,18,,,Unknown,,Banque Inconnue,,10476.0
,,17,,,Unknown,,Banque Inconnue,,10493.0
,,33,,,Unknown,,Banque Inconnue,,10526.0
,,35,,,Unknown,,Banque Inconnue,,10561.0
,,2,,,Unknown,,Banque Inconnue,,10563.0
,,17,,,Unknown,,Banque Inconnue,,10580.0
,,1,,,Unknown,,Banque Inconnue,,10581.0
,,36,,,Unknown,,Banque Inconnue,,10617.0
,,37,,,Unknown,,Banque Inconnue,,10654.0
,,2,,,Unknown,,Banque Inconnue,,10656.0
,,33,,,Unknown,,Banque Inconnue,,10689.0
,,35,,,Unknown,,Banque Inconnue,,10724.0
,,33,,,Unknown,,Banque Inconnue,,10757.0
,,1,,,Unknown,,Banque Inconnue,,10758.0
,,2,,,Unknown,,Banque Inconnue,,10760.0
,,1,,,Unknown,,Banque Inconnue,,10761.0
,,18,,,Unknown,,Banque Inconnue,,10779.0
,,34,,,Unknown,,Banque Inconnue,,10813.0
,,67,,,Unknown,,Banque Inconnue,,10880.0
,,37,,,Unknown,,Banque Inconnue,,10917.0
,,45,,,Unknown,,Banque Inconnue,,10962.0
,,37,,,Unknown,,Banque Inconnue,,10999.0
,,1,,,Card,,CARREFOUR MARKE,EGB,1.0
,,1,,,Card,,CARREFOUR MARKE,IBAN,2.0
,,31,,,Card,,CARREFOUR MARKE,Qonto,33.0
,,205 03,,,Card,,CARREFOUR MARKE,Qonto,20536.0
,,03,,,Card,,CARREFOUR MARKE,Qonto,20539.0
,,"18,00",,,Card,,CARREFOUR MARKE,Qonto,22339.0
,,03,,,Card,,CARREFOUR MARKE,Qonto,22342.0
,,03,,,Card,,CARREFOUR MARKE,Qonto,22345.0
,,"2,40",,,Card,,CARREFOUR MARKE,Qonto,22585.0
,,03,,,Card,,CARREFOUR MARKE,Qonto,22588.0
,,03,,,Card,,CARREFOUR MARKE,RESTAURANT VILLENEUVE,22591.0
,,"2,40",,,Card,,CARREFOUR MARKE,SU FRster,22831.0
,,03,,,Card,,CARREFOUR MARKE,Shein com,22834.0
,,03,,,Card,,CARREFOUR MARKE,London GB,22837.0
,,"2,40",,,Card,,CARREFOUR MARKE,KR PROV,23077.0
,,03,,,Card,,CARREFOUR MARKE,SARL PROVINS,23080.0
,,03,,,Card,,CARREFOUR MARKE,SumUp,23083.0
,,"2,40",,,Card,,CARREFOUR MARKE,PROVI,23323.0
,,03,,,Card,,CARREFOUR MARKE,AUBERGE DE LA VALLE,23326.0
,,03,,,Card,,CARREFOUR MARKE,GAUC FR Master Card .3759,23329.0
,,"2,40",,,Card,,CARREFOUR MARKE,Provins FR Master Card .3759,23569.0
,,03,,,Card,,CARREFOUR MARKE,LE NEMROD PROVINS FR Master Card .3759,23572.0
,,03,,,Card,,CARREFOUR MARKE,HEBDOS COMMUNIC,23575.0
,,"2,40",,,Card,,CARREFOUR MARKE,Qonto,23815.0
,,03,,,Card,,CARREFOUR MARKE,PAGE 2/4,23818.0
,,03,,,Card,,CARREFOUR MARKE,,23821.0
,,"2,40",,,Card,,CARREFOUR MARKE,,24061.0
,,04,,,Card,,CARREFOUR MARKE,,24065.0
,,03 27,,,Card,,CARREFOUR MARKE,,24392.0
,,00,,,Card,,CARREFOUR MARKE,,24392.0
,,04,,,Card,,CARREFOUR MARKE,,24396.0
,,03 65,,,Card,,CARREFOUR MARKE,,24761.0
,,95,,,Card,,CARREFOUR MARKE,,24856.0
,,04,,,Card,,CARREFOUR MARKE,,24860.0
,,03 47,,,Card,,CARREFOUR MARKE,,25207.0
,,77,,,Card,,CARREFOUR MARKE,,25284.0
,,74,,,Card,,CARREFOUR MARKE,,25358.0
,,04,,,Card,,CARREFOUR MARKE,,25362.0
,,03 64,,,Card,,CARREFOUR MARKE,,25726.0
,,99,,,Card,,CARREFOUR MARKE,,25825.0
,,05,,,Card,,CARREFOUR MARKE,,25830.0
,,03 14,,,Card,,CARREFOUR MARKE,,26144.0
,,00,,,Card,,CARREFOUR MARKE,,26144.0
,,05,,,Card,,CARREFOUR MARKE,,26149.0
,,03 58,,,Card,,CARREFOUR MARKE,,26507.0
,,19,,,Card,,CARREFOUR MARKE,,26526.0
,,05,,,Card,,CARREFOUR MARKE,,26531.0
,,03 46,,,Card,,CARREFOUR MARKE,,26877.0
,,00,,,Card,,CARREFOUR MARKE,,26877.0
,,06,,,Card,,CARREFOUR MARKE,,26883.0
,,"03 221,45",,,Card,,CARREFOUR MARKE,,349028.0
,,06,,,Card,,CARREFOUR MARKE,,349034.0
,,03,,,Card,,CARREFOUR MARKE,,349037.0
,,"9,99",,,Card,,CARREFOUR MARKE,,350036.0
,,06,,,Card,,CARREFOUR MARKE,,350042.0
,,03 25,,,Card,,CARREFOUR MARKE,,350367.0
,,50,,,Card,,CARREFOUR MARKE,,350417.0
,,09,,,Card,,CARREFOUR MARKE,,350426.0
,,"03 196,80",,,Card,,CARREFOUR MARKE,,670106.0
,,00,,,Card,,CARREFOUR MARKE,,670106.0
,,80,,,Card,,CARREFOUR MARKE,,670186.0
,,8 622,,,Card,,CARREFOUR MARKE,,678808.0
,,2,,,Card,,CARREFOUR MARKE,,678810.0
,,4,,,Card,,CARREFOUR MARKE,,678814.0
28/02/2022,,23,,,Cheque,,C8,VOTRE COMPTE COURANT N' 02421381795 DATE,23.0
,,02,,,Cheque,,C8,REMISE,25.0
,,50,,,Cheque,,C8,S7E MBoo12/180545,75.0
,,180,,,Cheque,,C8,CoM,255.0
,,0,,,Cheque,,C8,BRUT 64 69e,255.0
,,23,,,Cheque,,C8,MBo007/167241,278.0
,,02,,,Cheque,,C8,REMISE C8,280.0
,,59,,,Cheque,,C8,CoM,339.0
,,0,,,Cheque,,C8,BRUT 6 SE,339.0
,,24,,,Cheque,,C8,REMISE,363.0
,,02,,,Cheque,,C8,ReMISE,365.0
,,24,,,Cheque,,C8,CoM,389.0
,,02,,,Cheque,,C8,DEPOT AGEIICE,391.0
,,24,,,Cheque,,C8,REMISE,415.0
,,02,,,Cheque,,C8,MBC016/148159,417.0
,,50,,,Cheque,,C8,Sas Promogros,467.0
,,64,,,Cheque,,C8,Cou,531.0
,,0,,,Cheque,,C8,ReMISE,531.0
,,24,,,Cheque,,C8,BRUT 12,555.0
,,02,,,Cheque,,C8,CoM,557.0
,,228,,,Cheque,,C8,ReMISE,785.0
,,24,,,Cheque,,C8,BRUT 328 ME CoA,809.0
,,02,,,Cheque,,C8,BRUT 8,811.0
,,6,,,Cheque,,C8,COu 0,817.0
,,25,,,Cheque,,C8,N80002/195351,842.0
,,02,,,Cheque,,C8,REMISE,844.0
,,296,,,Cheque,,C8,Cou 0,1140.0
,,25,,,Cheque,,C8,BRUT 219 7oe,1165.0
,,02,,,Cheque,,C8,"Cou0,70E",1167.0
,,106 36,,,Cheque,,C8,ReMISE,11803.0
,,0,,,Cheque,,C8,BRUT 1 50E,11803.0
,,25,,,Cheque,,C8,M8o001/106883,11828.0
,,02,,,Cheque,,C8,SOUS ReSERVEDE CokptaGE RELEVE,11830.0
,,25,,,Cheque,,C8,DebIT CRedit,11855.0
,,02,,,Cheque,,C8,DATE DaTE OPERATION,11857.0
,,25,,,Cheque,,C8,Franche-Conté,11882.0
,,02,,,Cheque,,C8,QOMIE,11884.0
,,26,,,Cheque,,C8,Q5 0235,11910.0
,,02,,,Cheque,,C8,Bd0le Iremoulle,11912.0
,,50,,,Cheque,,C8,Coer F CCP Dion,11962.0
,,208,,,Cheque,,C8,Carba Assuaces,12170.0
,,0,,,Cheque,,C8,,12170.0
,,28,,,Cheque,,C8,,12198.0
,,02,,,Cheque,,C8,,12200.0
,,28,,,Cheque,,C8,,12228.0
,,02,,,Cheque,,C8,,12230.0
,,50,,,Cheque,,C8,,12280.0
,,647,,,Cheque,,C8,,12927.0
,,0,,,Cheque,,C8,,12927.0
,,110,,,Cheque,,C8,,13037.0
,,52 28,,,Cheque,,C8,,18265.0
,,02,,,Cheque,,C8,,18267.0
,,12,,,Cheque,,C8,,18279.0
,,28,,,Cheque,,C8,,18307.0
,,02,,,Cheque,,C8,,18309.0
,,328,,,Cheque,,C8,,18637.0
,,3,,,Cheque,,C8,,18640.0
,,28,,,Cheque,,C8,,18668.0
,,02,,,Cheque,,C8,,18670.0
,,372,,,Cheque,,C8,,19042.0
,,1,,,Cheque,,C8,,19043.0
,,28,,,Cheque,,C8,,19071.0
,,02,,,Cheque,,C8,,19073.0
,,8,,,Cheque,,C8,,19081.0
,,0 006,,,Cheque,,C8,,19087.0
,,3 28,,,Cheque,,C8,,19415.0
,,02,,,Cheque,,C8,,19417.0
,,43,,,Cheque,,C8,,19460.0
,,0,,,Cheque,,C8,,19460.0
,,28,,,Cheque,,C8,,19488.0
,,02,,,Cheque,,C8,,19490.0
,,595,,,Cheque,,C8,,20085.0
,,0,,,Cheque,,C8,,20085.0
,,28,,,Cheque,,C8,,20113.0
,,02,,,Cheque,,C8,,20115.0
,,219,,,Cheque,,C8,,20334.0
,,18,,,Cheque,,C8,,20352.0
,,517 28,,,Cheque,,C8,,72080.0
,,02,,,Cheque,,C8,,72082.0
,,1,,,Cheque,,C8,,72083.0
,,28,,,Cheque,,C8,,72111.0
,,02,,,Cheque,,C8,,72113.0
,,1,,,Cheque,,C8,,72114.0
,,28,,,Cheque,,C8,,72142.0
,,02,,,Cheque,,C8,,72144.0
,,180 24,,,Cheque,,C8,,90168.0
,,22,,,Cheque,,C8,,90190.0
,,02,,,Cheque,,C8,,90192.0
,,"58,91",,,Cheque,,C8,,96083.0
,,24,,,Cheque,,C8,,96107.0
,,02 23,,,Cheque,,C8,,96330.0
,,"02 747,86",,,Cheque,,C8,,371116.0
,,24,,,Cheque,,C8,,371140.0
,,02,,,Cheque,,C8,,371142.0
,,23,,,Cheque,,C8,,371165.0
,,02 24,,,Cheque,,C8,,371389.0
,,02 23,,,Cheque,,C8,,371612.0
,,"02 918,07",,,Cheque,,C8,,663419.0
,,"64,48",,,Cheque,,C8,,669867.0
,,24,,,Cheque,,C8,,669891.0
,,02 24,,,Cheque,,C8,,670115.0
,,"02 228,03",,,Cheque,,C8,,892918.0
,,24,,,Cheque,,C8,,892942.0
,,02 24,,,Cheque,,C8,,893166.0
,,02,,,Cheque,,C8,,893168.0
,,"6,52",,,Cheque,,C8,,893820.0
,,24,,,Cheque,,C8,,893844.0
,,02 24,,,Cheque,,C8,,894068.0
,,02 296 25,,,Cheque,,C8,,1123693.0
,,24,,,Cheque,,C8,,1123717.0
,,02 24,,,Cheque,,C8,,1123941.0
,,02 106.00,,,Cheque,,C8,,1126047.0
,,24,,,Cheque,,C8,,1126071.0
,,02 24,,,Cheque,,C8,,1126295.0
,,02,,,Cheque,,C8,,1126297.0
,,"7,14",,,Cheque,,C8,,1127011.0
,,25,,,Cheque,,C8,,1127036.0
,,02 25,,,Cheque,,C8,,1127261.0
,,"02 500,00",,,Cheque,,C8,,1377261.0
,,25,,,Cheque,,C8,,1377286.0
,,02 25,,,Cheque,,C8,,1377511.0
,,02,,,Cheque,,C8,,1377513.0
,,"4,65",,,Cheque,,C8,,1377978.0
,,25,,,Cheque,,C8,,1378003.0
,,02 25,,,Cheque,,C8,,1378228.0
,,02 237 24,,,Cheque,,C8,,1601952.0
,,28,,,Cheque,,C8,,1601980.0
,,02 28,,,Cheque,,C8,,1602208.0
,,"02 450,00",,,Cheque,,C8,,1847208.0
,,28,,,Cheque,,C8,,1847236.0
,,02,,,Cheque,,C8,,1847238.0
,,28,,,Cheque,,C8,,1847266.0
,,02 12,,,Cheque,,C8,,1847478.0
,,75,,,Cheque,,C8,,1847553.0
,,28,,,Cheque,,C8,,1847581.0
,,02 327 09,,,Cheque,,C8,,2080290.0
,,28,,,Cheque,,C8,,2080318.0
,,02 28,,,Cheque,,C8,,2080546.0
,,"02 372,83",,,Cheque,,C8,,2317829.0
,,28,,,Cheque,,C8,,2317857.0
,,02 18,,,Cheque,,C8,,2318075.0
,,89,,,Cheque,,C8,,2318164.0
,,28,,,Cheque,,C8,,2318192.0
,,02 28,,,Cheque,,C8,,2318420.0
,,02,,,Cheque,,C8,,2318422.0
,,28,,,Cheque,,C8,,2318450.0
,,02 28,,,Cheque,,C8,,2318678.0
,,"02 535,96",,,Cheque,,C8,,2572274.0
,,28,,,Cheque,,C8,,2572302.0
,,"02 219,00",,,Cheque,,C8,,2794202.0
,,28,,,Cheque,,C8,,2794230.0
,,02 748,,,Cheque,,C8,,2796978.0
,,28,,,Cheque,,C8,,2797006.0
,,02,,,Cheque,,C8,,2797008.0
,,00,,,Cheque,,C8,,2797008.0
,,6,,,Cheque,,C8,,2797014.0
,,0,,,Cheque,,C8,,2797014.0
,,2,,,Cheque,,C8,,2797016.0
,,14,,,Cheque,,C8,,2797030.0
,,07,,,Cheque,,C8,,2797037.0
28/02/2022,,28,,,Debit,,SVCS,BANQUE POPULAIRE +X BOURGOGNE FRANCHE,28.0
28/02/2022,,02,,,Debit,,SVCS,DATE,30.0
28/02/2022,,21,,,Debit,,SVCS,STICHIIG CUSTODIN,51.0
02/02/2022,,1,,,Debit,,SVCS,DebIT,52.0
02/02/2022,,28,,,Debit,,SVCS,TOTAL DES MOUVEMENTS,80.0
07/02/2022,,02,,,Debit,,SVCS,Oes oabonsen,82.0
07/02/2022,,"374,58",,,Debit,,SVCS,denreosremntetduno pronvon sucantectosonbelos oelarrete,37540.0
10/02/2022,,28,,,Debit,,SVCS,Debit DATE DETAIL DES PRELEVEMENTS,37568.0
11/02/2022,,02,,,Debit,,SVCS,FRatedfoo1oo7 ILRMA360000169109 051011c3/56d48c18081390080656c0d,37570.0
15/02/2022,,28,,,Debit,,SVCS,VERISURE,37598.0
21/02/2022,,02,,,Debit,,SVCS,Oph U1910026,37600.0
28/02/2022,,"32 554,09",,,Debit,,SVCS,SAS AEM SOFTS,3293009.0
03/02/2022,,"35 206,57",,,Debit,,SVCS,FR51222478175,6813666.0
28/02/2022,,"6 802,33",,,Debit,,SVCS,CUiEnT 005726 15/02/2022,7493899.0
03/02/2022,,1,,,Debit,,SVCS,VERISURE,7493900.0
07/02/2022,,28,,,Debit,,SVCS,FR93222324159,7493928.0
,,02,,,Debit,,SVCS,VOTRE,7493930.0
,,02,,,Debit,,SVCS,Debit DETAIL DES PRELEVEMENTS,7493932.0
,,02,,,Debit,,SVCS,BIMATOO,7493934.0
,,02,,,Debit,,SVCS,FORFAIT PROMOGROS,7493936.0
,,02,,,Debit,,SVCS,JANVIER 22 VOTRE COMPTE COURANT N' 02421381795 RELEVE N' 1 AU,7493938.0
,,01,,,Debit,,SVCS,CRedit EUROS DATE DETAIL DES VIREMENTS SEPA,7493939.0
,,01,,,Debit,,SVCS,MONEYGRAM,7493940.0
,,"652,35",,,Debit,,SVCS,Franche-Conté,7559175.0
,,160,,,Debit,,SVCS,FRCHE QOMIE,7559335.0
,,9,,,Debit,,SVCS,Q5 0235,7559344.0
,,8,,,Debit,,SVCS,14 Bd0le Tremoulle,7559352.0
,,07,,,Debit,,SVCS,F05,7559359.0
,,02,,,Debit,,SVCS,CCBPFFPPOHN 01s,7559361.0
,,"64,80",,,Debit,,SVCS,,7565841.0
,,07,,,Debit,,SVCS,,7565848.0
,,02,,,Debit,,SVCS,,7565850.0
,,"903,62",,,Debit,,SVCS,,7656212.0
,,1,,,Debit,,SVCS,,7656213.0
,,10,,,Debit,,SVCS,,7656223.0
,,02,,,Debit,,SVCS,,7656225.0
,,67 09,,,Debit,,SVCS,,7662934.0
,,11,,,Debit,,SVCS,,7662945.0
,,02,,,Debit,,SVCS,,7662947.0
,,"725,15",,,Debit,,SVCS,,7735462.0
,,15,,,Debit,,SVCS,,7735477.0
,,02,,,Debit,,SVCS,,7735479.0
,,47 99,,,Debit,,SVCS,,7740278.0
,,21,,,Debit,,SVCS,,7740299.0
,,02,,,Debit,,SVCS,,7740301.0
,,3,,,Debit,,SVCS,,7740304.0
,,"239,60",,,Debit,,SVCS,,7764264.0
,,8,,,Debit,,SVCS,,7764272.0
,,1,,,Debit,,SVCS,,7764273.0
,,28,,,Debit,,SVCS,,7764301.0
,,02,,,Debit,,SVCS,,7764303.0
,,8 03,,,Debit,,SVCS,,7765106.0
,,02,,,Debit,,SVCS,,7765108.0
,,"22 264,00",,,Debit,,SVCS,,9991508.0
,,22,,,Debit,,SVCS,,9991530.0
,,1,,,Debit,,SVCS,,9991531.0
,,28,,,Debit,,SVCS,,9991559.0
,,02,,,Debit,,SVCS,,9991561.0
,,03,,,Debit,,SVCS,,9991564.0
,,02,,,Debit,,SVCS,,9991566.0
,,"1,00",,,Debit,,SVCS,,9991666.0
,,07,,,Debit,,SVCS,,9991673.0
,,02,,,Debit,,SVCS,,9991675.0
,,008,,,Debit,,SVCS,,9991683.0
,,481 41,,,Debit,,SVCS,,10039824.0
,,7,,,Debit,,SVCS,,10039831.0
,,0,,,Debit,,SVCS,,10039831.0
,,2,,,Debit,,SVCS,,10039833.0
,,14,,,Debit,,SVCS,,10039847.0
,,160,,,Debit,,SVCS,,10040007.0
29/10/2021,,08,,,Debit,,SVCS,BANQUE POPULAIRE +X BOURGOGNE FRANCHE,8.0
,,10,,,Debit,,SVCS,Daie LibelleReFERENCE,18.0
,,26,,,Debit,,SVCS,C8 5072120015,44.0
,,08,,,Debit,,SVCS,ORUt,52.0
,,10,,,Debit,,SVCS,RyTHMEO,62.0
,,15,,,Debit,,SVCS,CONIRAT CXVSO,77.0
,,0,,,Debit,,SVCS,C8,77.0
,,06,,,Debit,,SVCS,ORUT J7,83.0
,,10,,,Debit,,SVCS,Rexise C8 5072120015 BRUr,93.0
,,07,,,Debit,,SVCS,COu,100.0
,,09,,,Debit,,SVCS,Revise C8,109.0
,,10,,,Debit,,SVCS,BRUt,119.0
,,11,,,Debit,,SVCS,Cou 0006,130.0
,,10,,,Debit,,SVCS,Rexise C8,140.0
,,19 906,,,Debit,,SVCS,BRUt S1v7e COv,20046.0
,,11,,,Debit,,SVCS,N8ooo714202,20057.0
,,10,,,Debit,,SVCS,Revise C8 6072120015 BRUt,20067.0
,,11,,,Debit,,SVCS,Cou 0 oe,20078.0
,,10,,,Debit,,SVCS,Revise C8,20088.0
,,0,,,Debit,,SVCS,Q6,20088.0
,,11,,,Debit,,SVCS,Coy 0 206 Necooe,20099.0
,,10,,,Debit,,SVCS,N80oo1/11056,20109.0
,,0,,,Debit,,SVCS,Remise C8,20109.0
,,11,,,Debit,,SVCS,PoP,20120.0
,,10,,,Debit,,SVCS,C8 470,20130.0
,,11,,,Debit,,SVCS,SM CASINO,20141.0
,,10,,,Debit,,SVCS,CSeo7oiconfrCON 11/10,20151.0
,,89,,,Debit,,SVCS,C8:*4704 Carrefour MarketicharnAY,20240.0
,,0 206,,,Debit,,SVCS,C8,20446.0
,,11,,,Debit,,SVCS,ELECTRODEPOI,20457.0
,,10,,,Debit,,SVCS,VeiRo,20467.0
,,0,,,Debit,,SVCS,RemiSE,20467.0
,,11,,,Debit,,SVCS,Remise,20478.0
,,10,,,Debit,,SVCS,COu,20488.0
,,215,,,Debit,,SVCS,SM CaSINO CSog7oiconfrancov,20703.0
,,11,,,Debit,,SVCS,Reservedecouptage 13/10,20714.0
,,10,,,Debit,,SVCS,Cou 0oe,20724.0
,,000,,,Debit,,SVCS,N80o16/105805 13/10 121021,20724.0
,,010 11,,,Debit,,SVCS,C8 4704 EuRoero,21735.0
,,10,,,Debit,,SVCS,N 9 AU 29/10/2021 Debit,21745.0
,,470,,,Debit,,SVCS,DATE Oaie,22215.0
,,11,,,Debit,,SVCS,D2CUU74,22226.0
,,10,,,Debit,,SVCS,D2CuU76,22236.0
,,11,,,Debit,,SVCS,D2CUU77,22247.0
,,10,,,Debit,,SVCS,DSNNBZK,22257.0
,,470,,,Debit,,SVCS,Bourgogne,22727.0
,,11,,,Debit,,SVCS,Franche-Comte,22738.0
,,10,,,Debit,,SVCS,PaGE,22748.0
,,470,,,Debit,,SVCS,Zex IVA,23218.0
,,12,,,Debit,,SVCS,Boungog,23230.0
,,10,,,Debit,,SVCS,CoVIf,23240.0
,,12,,,Debit,,SVCS,Dpon Cooo CCp Dpn0,23252.0
,,10,,,Debit,,SVCS,Ccbphppry0e,23262.0
,,12,,,Debit,,SVCS,,23274.0
,,10,,,Debit,,SVCS,,23284.0
,,470,,,Debit,,SVCS,,23754.0
,,12,,,Debit,,SVCS,,23766.0
,,10,,,Debit,,SVCS,,23776.0
,,13,,,Debit,,SVCS,,23789.0
,,10,,,Debit,,SVCS,,23799.0
,,0 246,,,Debit,,SVCS,,24045.0
,,13,,,Debit,,SVCS,,24058.0
,,10,,,Debit,,SVCS,,24068.0
,,0 006,,,Debit,,SVCS,,24074.0
,,0 026,,,Debit,,SVCS,,24100.0
,,13,,,Debit,,SVCS,,24113.0
,,10,,,Debit,,SVCS,,24123.0
,,13,,,Debit,,SVCS,,24136.0
,,10,,,Debit,,SVCS,,24146.0
,,9,,,Debit,,SVCS,,24155.0
,,29,,,Debit,,SVCS,,24184.0
,,10,,,Debit,,SVCS,,24194.0
,,26 15,,,Debit,,SVCS,,26809.0
,,07,,,Debit,,SVCS,,26816.0
,,10 07,,,Debit,,SVCS,,27823.0
,,10,,,Debit,,SVCS,,27833.0
,,07,,,Debit,,SVCS,,27840.0
,,10 07,,,Debit,,SVCS,,28847.0
,,"10 115,00",,,Debit,,SVCS,,1040347.0
,,07,,,Debit,,SVCS,,1040354.0
,,10 07,,,Debit,,SVCS,,1041361.0
,,10 21,,,Debit,,SVCS,,1042382.0
,,54,,,Debit,,SVCS,,1042436.0
,,08,,,Debit,,SVCS,,1042444.0
,,10 08,,,Debit,,SVCS,,1043452.0
,,10 37,,,Debit,,SVCS,,1044489.0
,,51,,,Debit,,SVCS,,1044540.0
,,11,,,Debit,,SVCS,,1044551.0
,,10 11,,,Debit,,SVCS,,1045562.0
,,10 19,,,Debit,,SVCS,,1046581.0
,,84,,,Debit,,SVCS,,1046665.0
,,0,,,Debit,,SVCS,,1046665.0
,,11,,,Debit,,SVCS,,1046676.0
,,10 11,,,Debit,,SVCS,,1047687.0
,,"10 224,49",,,Debit,,SVCS,,2070136.0
,,11,,,Debit,,SVCS,,2070147.0
,,10 11,,,Debit,,SVCS,,2071158.0
,,10 50,,,Debit,,SVCS,,2072208.0
,,99,,,Debit,,SVCS,,2072307.0
,,11,,,Debit,,SVCS,,2072318.0
,,10 11,,,Debit,,SVCS,,2073329.0
,,10 25,,,Debit,,SVCS,,2074354.0
,,96,,,Debit,,SVCS,,2074450.0
,,11,,,Debit,,SVCS,,2074461.0
,,10 11,,,Debit,,SVCS,,2075472.0
,,10 251 59,,,Debit,,SVCS,,3100631.0
,,11,,,Debit,,SVCS,,3100642.0
,,10 11,,,Debit,,SVCS,,3101653.0
,,10 89,,,Debit,,SVCS,,3102742.0
,,32,,,Debit,,SVCS,,3102774.0
,,11,,,Debit,,SVCS,,3102785.0
,,10 11,,,Debit,,SVCS,,3103796.0
,,10,,,Debit,,SVCS,,3103806.0
,,"5,87",,,Debit,,SVCS,,3104393.0
,,11,,,Debit,,SVCS,,3104404.0
,,10 11,,,Debit,,SVCS,,3105415.0
,,10 215 19,,,Debit,,SVCS,,4126934.0
,,11,,,Debit,,SVCS,,4126945.0
,,10 11,,,Debit,,SVCS,,4127956.0
,,"10 260,69",,,Debit,,SVCS,,5154025.0
,,11,,,Debit,,SVCS,,5154036.0
,,10 11,,,Debit,,SVCS,,5155047.0
,,10 11,,,Debit,,SVCS,,5156058.0
,,10 11,,,Debit,,SVCS,,5157069.0
,,10 11,,,Debit,,SVCS,,5158080.0
,,10 38,,,Debit,,SVCS,,5159118.0
,,05 11,,,Debit,,SVCS,,5159629.0
,,"10 114,18",,,Debit,,SVCS,,6171047.0
,,11,,,Debit,,SVCS,,6171058.0
,,"10 448,98",,,Debit,,SVCS,,7215956.0
,,"621,24",,,Debit,,SVCS,,7278080.0
,,11,,,Debit,,SVCS,,7278091.0
,,10 11,,,Debit,,SVCS,,7279102.0
,,10,,,Debit,,SVCS,,7279112.0
,,11,,,Debit,,SVCS,,7279123.0
,,10 103 16,,,Debit,,SVCS,,8289439.0
,,12,,,Debit,,SVCS,,8289451.0
,,10 12,,,Debit,,SVCS,,8290463.0
,,"10 160,67",,,Debit,,SVCS,,9306530.0
,,12,,,Debit,,SVCS,,9306542.0
,,10 12,,,Debit,,SVCS,,9307554.0
,,10 12,,,Debit,,SVCS,,9308566.0
,,10 12,,,Debit,,SVCS,,9309578.0
,,10 12,,,Debit,,SVCS,,9310590.0
,,10 12,,,Debit,,SVCS,,9311602.0
,,"10 213,73",,,Debit,,SVCS,,10332975.0
,,"460,00",,,Debit,,SVCS,,10378975.0
,,"76,83",,,Debit,,SVCS,,10386658.0
,,13,,,Debit,,SVCS,,10386671.0
,,10 13,,,Debit,,SVCS,,10387684.0
,,10,,,Debit,,SVCS,,10387694.0
,,5,,,Debit,,SVCS,,10387699.0
,,98,,,Debit,,SVCS,,10387797.0
,,13,,,Debit,,SVCS,,10387810.0
,,10 13,,,Debit,,SVCS,,10388823.0
,,"10 117,94",,,Debit,,SVCS,,11400617.0
,,13,,,Debit,,SVCS,,11400630.0
,,10 13,,,Debit,,SVCS,,11401643.0
,,10 296.00,,,Debit,,SVCS,,11411939.0
,,3,,,Debit,,SVCS,,11411942.0
,,09,,,Debit,,SVCS,,11411951.0
,,03,,,Debit,,SVCS,,11411954.0
,,0,,,Debit,,SVCS,,11411954.0
,,09,,,Debit,,SVCS,,11411963.0
,,0,,,Debit,,SVCS,,11411963.0
,,400 070 116,,,Debit,,SVCS,,411482079.0
,,1,,,Debit,,SVCS,,411482080.0
29/10/2021,,14,,,Cheque,,PRLV,VOTRE COMPTE COURANT N' 02421381795,14.0
,,10,,,Cheque,,PRLV,Oate CompiA Libelleireference,24.0
,,50,,,Cheque,,PRLV,82S56 CoY,74.0
,,0 166,,,Cheque,,PRLV,Cou,240.0
,,14,,,Cheque,,PRLV,Remise,254.0
,,10,,,Cheque,,PRLV,Cov,264.0
,,210,,,Cheque,,PRLV,Revise C8 5072120015,474.0
,,14,,,Cheque,,PRLV,Co,488.0
,,10,,,Cheque,,PRLV,Revise C8,498.0
,,15,,,Cheque,,PRLV,Ye CoM,513.0
,,10,,,Cheque,,PRLV,C8 470 Superu,523.0
,,0,,,Cheque,,PRLV,Vetrofrmce 6ovaULXenveli 16/10,523.0
,,15,,,Cheque,,PRLV,BRUI,538.0
,,10,,,Cheque,,PRLV,CoY,548.0
,,15,,,Cheque,,PRLV,Eviunited paRCEL SeRviC,563.0
,,10,,,Cheque,,PRLV,BRUt,573.0
,,8,,,Cheque,,PRLV,Cov,581.0
,,0 06,,,Cheque,,PRLV,RemiSE,587.0
,,15,,,Cheque,,PRLV,CoM,602.0
,,10,,,Cheque,,PRLV,Remise,612.0
,,15,,,Cheque,,PRLV,BRUr,627.0
,,10,,,Cheque,,PRLV,Remise C8 5072120015,637.0
,,470,,,Cheque,,PRLV,Revise C8 5072121012 BRUr,1107.0
,,15,,,Cheque,,PRLV,Cov,1122.0
,,10,,,Cheque,,PRLV,Verstou,1132.0
,,16,,,Cheque,,PRLV,AnNUVERST DU 121021,1148.0
,,10,,,Cheque,,PRLV,Erreuris,1158.0
,,56 236,,,Cheque,,PRLV,Vonnne,57394.0
,,0,,,Cheque,,PRLV,C8:4704 Relis MacoN,57394.0
,,16,,,Cheque,,PRLV,C8*4704 McTRo,57410.0
,,10,,,Cheque,,PRLV,Rexise,57420.0
,,18,,,Cheque,,PRLV,C8 5072121012,57438.0
,,10,,,Cheque,,PRLV,Date Daie,57448.0
,,09,,,Cheque,,PRLV,O9Taiam,57457.0
,,"30,72",,,Cheque,,PRLV,DBYQiEP,60529.0
,,28,,,Cheque,,PRLV,Franche-Comte,60557.0
,,228 18,,,Cheque,,PRLV,PAGE ^ Baroue PoPUARf,83375.0
,,10,,,Cheque,,PRLV,BoUaGocefaarof Couie,83385.0
,,18,,,Cheque,,PRLV,Voo 8Dacs 0io Cooon Qio2y IAilcor 6a,83403.0
,,10,,,Cheque,,PRLV,Irc 8,83413.0
,,18,,,Cheque,,PRLV,Cooor CcP Dnn,83431.0
,,10,,,Cheque,,PRLV,,83441.0
,,18,,,Cheque,,PRLV,,83459.0
,,10,,,Cheque,,PRLV,,83469.0
,,18,,,Cheque,,PRLV,,83487.0
,,10,,,Cheque,,PRLV,,83497.0
,,0 036,,,Cheque,,PRLV,,83533.0
,,12,,,Cheque,,PRLV,,83545.0
,,851 18,,,Cheque,,PRLV,,168663.0
,,10,,,Cheque,,PRLV,,168673.0
,,18,,,Cheque,,PRLV,,168691.0
,,10,,,Cheque,,PRLV,,168701.0
,,017 18,,,Cheque,,PRLV,,170419.0
,,10,,,Cheque,,PRLV,,170429.0
,,460,,,Cheque,,PRLV,,170889.0
,,459,,,Cheque,,PRLV,,171348.0
,,5,,,Cheque,,PRLV,,171353.0
,,18,,,Cheque,,PRLV,,171371.0
,,10,,,Cheque,,PRLV,,171381.0
,,60,,,Cheque,,PRLV,,171441.0
,,18,,,Cheque,,PRLV,,171459.0
,,10,,,Cheque,,PRLV,,171469.0
,,18,,,Cheque,,PRLV,,171487.0
,,10,,,Cheque,,PRLV,,171497.0
,,19,,,Cheque,,PRLV,,171516.0
,,10,,,Cheque,,PRLV,,171526.0
,,0 256,,,Cheque,,PRLV,,171782.0
,,19,,,Cheque,,PRLV,,171801.0
,,10,,,Cheque,,PRLV,,171811.0
,,72,,,Cheque,,PRLV,,171883.0
,,9,,,Cheque,,PRLV,,171892.0
,,29,,,Cheque,,PRLV,,171921.0
,,10,,,Cheque,,PRLV,,171931.0
,,"42,40",,,Cheque,,PRLV,,176171.0
,,13,,,Cheque,,PRLV,,176184.0
,,10 13,,,Cheque,,PRLV,,177197.0
,,10,,,Cheque,,PRLV,,177207.0
,,13,,,Cheque,,PRLV,,177220.0
,,10 13,,,Cheque,,PRLV,,178233.0
,,10 210 25,,,Cheque,,PRLV,,1199258.0
,,14,,,Cheque,,PRLV,,1199272.0
,,10,,,Cheque,,PRLV,,1199282.0
,,14,,,Cheque,,PRLV,,1199296.0
,,10 14,,,Cheque,,PRLV,,1200310.0
,,10 14,,,Cheque,,PRLV,,1201324.0
,,"10 500,00",,,Cheque,,PRLV,,2251324.0
,,62 03,,,Cheque,,PRLV,,2257527.0
,,15,,,Cheque,,PRLV,,2257542.0
,,10 15,,,Cheque,,PRLV,,2258557.0
,,"10 199,52",,,Cheque,,PRLV,,3278509.0
,,15,,,Cheque,,PRLV,,3278524.0
,,10 15,,,Cheque,,PRLV,,3279539.0
,,10,,,Cheque,,PRLV,,3279549.0
,,9 27,,,Cheque,,PRLV,,3280476.0
,,15,,,Cheque,,PRLV,,3280491.0
,,10 15,,,Cheque,,PRLV,,3281506.0
,,"10 205,34",,,Cheque,,PRLV,,4302040.0
,,15,,,Cheque,,PRLV,,4302055.0
,,10,,,Cheque,,PRLV,,4302065.0
,,15,,,Cheque,,PRLV,,4302080.0
,,10,,,Cheque,,PRLV,,4302090.0
,,15,,,Cheque,,PRLV,,4302105.0
,,10 15,,,Cheque,,PRLV,,4303120.0
,,10 15,,,Cheque,,PRLV,,4304135.0
,,"10 259,15",,,Cheque,,PRLV,,5330050.0
,,766 83,,,Cheque,,PRLV,,5406733.0
,,15,,,Cheque,,PRLV,,5406748.0
,,10 56,,,Cheque,,PRLV,,5407804.0
,,05,,,Cheque,,PRLV,,5407809.0
,,15,,,Cheque,,PRLV,,5407824.0
,,10 15,,,Cheque,,PRLV,,5408839.0
,,10,,,Cheque,,PRLV,,5408849.0
,,3 90,,,Cheque,,PRLV,,5409239.0
,,18,,,Cheque,,PRLV,,5409257.0
,,10 18,,,Cheque,,PRLV,,5410275.0
,,10 72,,,Cheque,,PRLV,,5411347.0
,,48,,,Cheque,,PRLV,,5411395.0
,,0,,,Cheque,,PRLV,,5411395.0
,,18,,,Cheque,,PRLV,,5411413.0
,,10 18,,,Cheque,,PRLV,,5412431.0
,,"10 247,42",,,Cheque,,PRLV,,6437173.0
,,18,,,Cheque,,PRLV,,6437191.0
,,10 18,,,Cheque,,PRLV,,6438209.0
,,10 24,,,Cheque,,PRLV,,6439233.0
,,31,,,Cheque,,PRLV,,6439264.0
,,18,,,Cheque,,PRLV,,6439282.0
,,10 18,,,Cheque,,PRLV,,6440300.0
,,"10 113,57",,,Cheque,,PRLV,,7451657.0
,,18,,,Cheque,,PRLV,,7451675.0
,,10,,,Cheque,,PRLV,,7451685.0
,,10 24,,,Cheque,,PRLV,,7452709.0
,,60,,,Cheque,,PRLV,,7452769.0
,,18,,,Cheque,,PRLV,,7452787.0
,,10 18,,,Cheque,,PRLV,,7453805.0
,,10,,,Cheque,,PRLV,,7453815.0
,,"8,67",,,Cheque,,PRLV,,7454682.0
,,18,,,Cheque,,PRLV,,7454700.0
,,10 18,,,Cheque,,PRLV,,7455718.0
,,10 181 44,,,Cheque,,PRLV,,8473862.0
,,18,,,Cheque,,PRLV,,8473880.0
,,10 18,,,Cheque,,PRLV,,8474898.0
,,10 146,,,Cheque,,PRLV,,8485044.0
,,08,,,Cheque,,PRLV,,8485052.0
,,18,,,Cheque,,PRLV,,8485070.0
,,10 12,,,Cheque,,PRLV,,8486082.0
,,"10 459,50",,,Cheque,,PRLV,,9532032.0
,,18,,,Cheque,,PRLV,,9532050.0
,,10 12,,,Cheque,,PRLV,,9533062.0
,,"10 460,00",,,Cheque,,PRLV,,10579062.0
,,18,,,Cheque,,PRLV,,10579080.0
,,10,,,Cheque,,PRLV,,10579090.0
,,18,,,Cheque,,PRLV,,10579108.0
,,10,,,Cheque,,PRLV,,10579118.0
,,18,,,Cheque,,PRLV,,10579136.0
,,10 18,,,Cheque,,PRLV,,10580154.0
,,10 18,,,Cheque,,PRLV,,10581172.0
,,10 76,,,Cheque,,PRLV,,10582248.0
,,00,,,Cheque,,PRLV,,10582248.0
,,"1 081,87",,,Cheque,,PRLV,,10690435.0
,,18,,,Cheque,,PRLV,,10690453.0
,,10 80,,,Cheque,,PRLV,,10691533.0
,,19,,,Cheque,,PRLV,,10691552.0
,,18,,,Cheque,,PRLV,,10691570.0
,,10 18,,,Cheque,,PRLV,,10692588.0
,,10 105,,,Cheque,,PRLV,,10702693.0
,,72,,,Cheque,,PRLV,,10702765.0
,,718,,,Cheque,,PRLV,,10703483.0
,,209,,,Cheque,,PRLV,,10703692.0
,,0,,,Cheque,,PRLV,,10703692.0
,,60,,,Cheque,,PRLV,,10703752.0
,,03,,,Cheque,,PRLV,,10703755.0
,,16,,,Cheque,,PRLV,,10703771.0
30/09/2021,,20,,,Debit,,RYTHMEO,VOTRE COMPTE COURANT N,20.0
30/09/2021,,09,,,Debit,,RYTHMEO,DATE,29.0
,,60,,,Debit,,RYTHMEO,C8 5033080011 BRUT 60 0e,89.0
,,0,,,Debit,,RYTHMEO,M80001/158866,89.0
,,20,,,Debit,,RYTHMEO,REMISE,109.0
,,09,,,Debit,,RYTHMEO,S7E,118.0
,,20,,,Debit,,RYTHMEO,COIRAT,138.0
,,09,,,Debit,,RYTHMEO,REMISE,147.0
,,85,,,Debit,,RYTHMEO,CB 5033081015 BRUT,232.0
,,0,,,Debit,,RYTHMEO,Ooe CoM,232.0
,,21,,,Debit,,RYTHMEO,REMISE,253.0
,,09,,,Debit,,RYTHMEO,J9e HBo002/182864,262.0
,,22,,,Debit,,RYTHMEO,C8 5033080011 BRUT,284.0
,,09,,,Debit,,RYTHMEO,REBRSE CB,293.0
,,0,,,Debit,,RYTHMEO,COH 0 50E,293.0
,,22,,,Debit,,RYTHMEO,CoM,315.0
,,09,,,Debit,,RYTHMEO,REMISE,324.0
,,23 806,,,Debit,,RYTHMEO,C8 5033080011 BRUT 200,24130.0
,,23,,,Debit,,RYTHMEO,Cou 0,24153.0
,,09,,,Debit,,RYTHMEO,ReMISE,24162.0
,,0,,,Debit,,RYTHMEO,DATE DaTE OPERATION,24162.0
,,55,,,Debit,,RYTHMEO,CKSOTNG,24217.0
,,0,,,Debit,,RYTHMEO,TOTAL DES MOUVEMENTS,24217.0
,,180,,,Debit,,RYTHMEO,uabonsen cus dencosremnteidune,24397.0
,,28,,,Debit,,RYTHMEO,TVAoudeb Qo,24425.0
,,09,,,Debit,,RYTHMEO,Resolubon,24434.0
,,175,,,Debit,,RYTHMEO,Reportez,24609.0
,,29,,,Debit,,RYTHMEO,FGDR,24638.0
,,09,,,Debit,,RYTHMEO,lormulaire dnlormation comnmunique,24647.0
,,200 06,,,Debit,,RYTHMEO,Lvret A,44653.0
,,29,,,Debit,,RYTHMEO,Lvret de Developpement Durable,44682.0
,,09,,,Debit,,RYTHMEO,Sohdare,44691.0
,,84,,,Debit,,RYTHMEO,Uvret dEpargne Populare,44775.0
,,0,,,Debit,,RYTHMEO,Banque Populaire Rives,44775.0
,,30,,,Debit,,RYTHMEO,Paris,44805.0
,,09,,,Debit,,RYTHMEO,Bnqe Poouare,44814.0
,,138,,,Debit,,RYTHMEO,Bnqe,44952.0
,,0,,,Debit,,RYTHMEO,Pais SooueimmtialecauRegsre,44952.0
,,30,,,Debit,,RYTHMEO,Aswnc sousk n07,44982.0
,,09,,,Debit,,RYTHMEO,Yous pouZ poulor,44991.0
,,5,,,Debit,,RYTHMEO,p0 non Vlue,44996.0
,,30,,,Debit,,RYTHMEO,Ms,45026.0
,,09,,,Debit,,RYTHMEO,Pourla,45035.0
,,"59,33",,,Debit,,RYTHMEO,Moou,50968.0
,,20,,,Debit,,RYTHMEO,,50988.0
,,09 20,,,Debit,,RYTHMEO,,51908.0
,,09,,,Debit,,RYTHMEO,,51917.0
,,20,,,Debit,,RYTHMEO,,51937.0
,,09 20,,,Debit,,RYTHMEO,,52857.0
,,09 84,,,Debit,,RYTHMEO,,53841.0
,,43,,,Debit,,RYTHMEO,,53884.0
,,20,,,Debit,,RYTHMEO,,53904.0
,,09 20,,,Debit,,RYTHMEO,,54824.0
,,09,,,Debit,,RYTHMEO,,54833.0
,,22,,,Debit,,RYTHMEO,,54855.0
,,09,,,Debit,,RYTHMEO,,54864.0
,,"43,51",,,Debit,,RYTHMEO,,59215.0
,,22,,,Debit,,RYTHMEO,,59237.0
,,09,,,Debit,,RYTHMEO,,59246.0
,,"122,41",,,Debit,,RYTHMEO,,71487.0
,,23,,,Debit,,RYTHMEO,,71510.0
,,09 23,,,Debit,,RYTHMEO,,72433.0
,,09 43,,,Debit,,RYTHMEO,,73376.0
,,82,,,Debit,,RYTHMEO,,73458.0
,,27,,,Debit,,RYTHMEO,,73485.0
,,09,,,Debit,,RYTHMEO,,73494.0
,,"54,50",,,Debit,,RYTHMEO,,78944.0
,,"178,52",,,Debit,,RYTHMEO,,96796.0
,,28,,,Debit,,RYTHMEO,,96824.0
,,"09 173,12",,,Debit,,RYTHMEO,,1014136.0
,,29,,,Debit,,RYTHMEO,,1014165.0
,,09 29,,,Debit,,RYTHMEO,,1015094.0
,,"09 198,50",,,Debit,,RYTHMEO,,1934944.0
,,29,,,Debit,,RYTHMEO,,1934973.0
,,09 29,,,Debit,,RYTHMEO,,1935902.0
,,09 83,,,Debit,,RYTHMEO,,1936885.0
,,55,,,Debit,,RYTHMEO,,1936940.0
,,30,,,Debit,,RYTHMEO,,1936970.0
,,09 30,,,Debit,,RYTHMEO,,1937900.0
,,"09 137,42",,,Debit,,RYTHMEO,,2851642.0
,,30,,,Debit,,RYTHMEO,,2851672.0
,,09 30,,,Debit,,RYTHMEO,,2852602.0
,,09 60,,,Debit,,RYTHMEO,,2853562.0
,,02,,,Debit,,RYTHMEO,,2853564.0
,,30,,,Debit,,RYTHMEO,,2853594.0
,,09,,,Debit,,RYTHMEO,,2853603.0
,,"1 511,15",,,Debit,,RYTHMEO,,3004718.0
,,"987,22",,,Debit,,RYTHMEO,,3103440.0
,,"672,71",,,Debit,,RYTHMEO,,3170711.0
,,2,,,Debit,,RYTHMEO,,3170713.0
,,0,,,Debit,,RYTHMEO,,3170713.0
,,11,,,Debit,,RYTHMEO,,3170724.0
,,75,,,Debit,,RYTHMEO,,3170799.0
18/09/2021,40,,40,,Cash,,EPI SERVICE PRIMEUR,Titulaire(s,-40.0
18/09/2021,10,,10,,Cash,,EPI SERVICE PRIMEUR,Date Date de Valeur,-50.0
18/09/2021,5,,5,,Cash,,EPI SERVICE PRIMEUR,COM,-55.0
20/09/2021,10,,10,,Cash,,EPI SERVICE PRIMEUR,CARTES,-65.0
20/09/2021,20,,20,,Cash,,EPI SERVICE PRIMEUR,COM,-85.0
20/09/2021,09 20,,09 20,,Cash,,EPI SERVICE PRIMEUR,COM,-1005.0
21/09/2021,09 20,,09 20,,Cash,,EPI SERVICE PRIMEUR,CARTES,-1925.0
20/09/2021,09 20,,09 20,,Cash,,EPI SERVICE PRIMEUR,METRO CASH,-2845.0
20/09/2021,09 18,,09 18,,Cash,,EPI SERVICE PRIMEUR,METRO CASH,-3763.0
21/09/2021,09,,09,,Cash,,EPI SERVICE PRIMEUR,REMISE,-3772.0
21/09/2021,64,,64,,Cash,,EPI SERVICE PRIMEUR,REMISE,-3836.0
21/09/2021,18,,18,,Cash,,EPI SERVICE PRIMEUR,TPV,-3854.0
21/09/2021,09,,09,,Cash,,EPI SERVICE PRIMEUR,REMISE,-3863.0
21/09/2021,64,,64,,Cash,,EPI SERVICE PRIMEUR,TPV,-3927.0
21/09/2021,18,,18,,Cash,,EPI SERVICE PRIMEUR,CARTE,-3945.0
21/09/2021,09,,09,,Cash,,EPI SERVICE PRIMEUR,CARREFOUR RENNES,-3954.0
21/09/2021,01,,01,,Cash,,EPI SERVICE PRIMEUR,COM,-3955.0
21/09/2021,20,,20,,Cash,,EPI SERVICE PRIMEUR,CARTES,-3975.0
21/09/2021,09,,09,,Cash,,EPI SERVICE PRIMEUR,COM,-3984.0
21/09/2021,20,,20,,Cash,,EPI SERVICE PRIMEUR,CARTES,-4004.0
22/09/2021,09,,09,,Cash,,EPI SERVICE PRIMEUR,COM,-4013.0
22/09/2021,20,,20,,Cash,,EPI SERVICE PRIMEUR,CARTES 0386405 64 2009,-4033.0
22/09/2021,09,,09,,Cash,,EPI SERVICE PRIMEUR,COM,-4042.0
22/09/2021,21,,21,,Cash,,EPI SERVICE PRIMEUR,CARTES,-4063.0
22/09/2021,09,,09,,Cash,,EPI SERVICE PRIMEUR,COM,-4072.0
22/09/2021,20,,20,,Cash,,EPI SERVICE PRIMEUR,CARTES,-4092.0
22/09/2021,09,,09,,Cash,,EPI SERVICE PRIMEUR,COM,-4101.0
22/09/2021,20,,20,,Cash,,EPI SERVICE PRIMEUR,CARTES,-4121.0
22/09/2021,09,,09,,Cash,,EPI SERVICE PRIMEUR,REMISE,-4130.0
22/09/2021,21,,21,,Cash,,EPI SERVICE PRIMEUR,TPV,-4151.0
23/09/2021,09,,09,,Cash,,EPI SERVICE PRIMEUR,REMISE,-4160.0
22/09/2021,20,,20,,Cash,,EPI SERVICE PRIMEUR,TPV,-4180.0
22/09/2021,09,,09,,Cash,,EPI SERVICE PRIMEUR,REMISE,-4189.0
23/09/2021,21,,21,,Cash,,EPI SERVICE PRIMEUR,TPV,-4210.0
23/09/2021,09,,09,,Cash,,EPI SERVICE PRIMEUR,REMISE,-4219.0
23/09/2021,64,,64,,Cash,,EPI SERVICE PRIMEUR,TPV,-4283.0
23/09/2021,21,,21,,Cash,,EPI SERVICE PRIMEUR,TPV,-4304.0
23/09/2021,09,,09,,Cash,,EPI SERVICE PRIMEUR,COM,-4313.0
23/09/2021,01,,01,,Cash,,EPI SERVICE PRIMEUR,CARTES,-4314.0
23/09/2021,21,,21,,Cash,,EPI SERVICE PRIMEUR,COM,-4335.0
23/09/2021,09,,09,,Cash,,EPI SERVICE PRIMEUR,CARTES,-4344.0
23/09/2021,64,,64,,Cash,,EPI SERVICE PRIMEUR,COM,-4408.0
,21,,21,,Cash,,EPI SERVICE PRIMEUR,CARTES 0386405,-4429.0
,09,,09,,Cash,,EPI SERVICE PRIMEUR,COM,-4438.0
,01,,01,,Cash,,EPI SERVICE PRIMEUR,CARTES,-4439.0
,21,,21,,Cash,,EPI SERVICE PRIMEUR,COM,-4460.0
,09,,09,,Cash,,EPI SERVICE PRIMEUR,CARTES,-4469.0
,64,,64,,Cash,,EPI SERVICE PRIMEUR,COM,-4533.0
,21,,21,,Cash,,EPI SERVICE PRIMEUR,COM,-4554.0
,09,,09,,Cash,,EPI SERVICE PRIMEUR,CARTES,-4563.0
,01,,01,,Cash,,EPI SERVICE PRIMEUR,TPV,-4564.0
,21,,21,,Cash,,EPI SERVICE PRIMEUR,TPV,-4585.0
,09,,09,,Cash,,EPI SERVICE PRIMEUR,REMISE,-4594.0
,21,,21,,Cash,,EPI SERVICE PRIMEUR,TPV,-4615.0
,09,,09,,Cash,,EPI SERVICE PRIMEUR,TPV,-4624.0
,21,,21,,Cash,,EPI SERVICE PRIMEUR,CARTE,-4645.0
,09,,09,,Cash,,EPI SERVICE PRIMEUR,ENTREP-,-4654.0
,21,,21,,Cash,,EPI SERVICE PRIMEUR,London,-4675.0
,09,,09,,Cash,,EPI SERVICE PRIMEUR,EUR 23/09/2021,-4684.0
,22,,22,,Cash,,EPI SERVICE PRIMEUR,CARTE,-4706.0
,09,,09,,Cash,,EPI SERVICE PRIMEUR,COM,-4715.0
,22,,22,,Cash,,EPI SERVICE PRIMEUR,CARTES,-4737.0
,09,,09,,Cash,,EPI SERVICE PRIMEUR,COM,-4746.0
,64,,64,,Cash,,EPI SERVICE PRIMEUR,CARTES 0386405,-4810.0
,22,,22,,Cash,,EPI SERVICE PRIMEUR,COM,-4832.0
,09,,09,,Cash,,EPI SERVICE PRIMEUR,CARTES,-4841.0
,01,,01,,Cash,,EPI SERVICE PRIMEUR,COM,-4842.0
,22,,22,,Cash,,EPI SERVICE PRIMEUR,CARTES,-4864.0
,09,,09,,Cash,,EPI SERVICE PRIMEUR,COM,-4873.0
,64,,64,,Cash,,EPI SERVICE PRIMEUR,CARTES,-4937.0
,22,,22,,Cash,,EPI SERVICE PRIMEUR,,-4959.0
,09,,09,,Cash,,EPI SERVICE PRIMEUR,,-4968.0
,01,,01,,Cash,,EPI SERVICE PRIMEUR,,-4969.0
,22,,22,,Cash,,EPI SERVICE PRIMEUR,,-4991.0
,09,,09,,Cash,,EPI SERVICE PRIMEUR,,-5000.0
,64,,64,,Cash,,EPI SERVICE PRIMEUR,,-5064.0
,22,,22,,Cash,,EPI SERVICE PRIMEUR,,-5086.0
,09,,09,,Cash,,EPI SERVICE PRIMEUR,,-5095.0
,64,,64,,Cash,,EPI SERVICE PRIMEUR,,-5159.0
,22,,22,,Cash,,EPI SERVICE PRIMEUR,,-5181.0
,09,,09,,Cash,,EPI SERVICE PRIMEUR,,-5190.0
,01,,01,,Cash,,EPI SERVICE PRIMEUR,,-5191.0
,22,,22,,Cash,,EPI SERVICE PRIMEUR,,-5213.0
,09,,09,,Cash,,EPI SERVICE PRIMEUR,,-5222.0
,22,,22,,Cash,,EPI SERVICE PRIMEUR,,-5244.0
,09,,09,,Cash,,EPI SERVICE PRIMEUR,,-5253.0
,23,,23,,Cash,,EPI SERVICE PRIMEUR,,-5276.0
,09,,09,,Cash,,EPI SERVICE PRIMEUR,,-5285.0
,22,,22,,Cash,,EPI SERVICE PRIMEUR,,-5307.0
,09,,09,,Cash,,EPI SERVICE PRIMEUR,,-5316.0
,22,,22,,Cash,,EPI SERVICE PRIMEUR,,-5338.0
,09,,09,,Cash,,EPI SERVICE PRIMEUR,,-5347.0
,23,,23,,Cash,,EPI SERVICE PRIMEUR,,-5370.0
,09,,09,,Cash,,EPI SERVICE PRIMEUR,,-5379.0
,23,,23,,Cash,,EPI SERVICE PRIMEUR,,-5402.0
,09,,09,,Cash,,EPI SERVICE PRIMEUR,,-5411.0
,23,,23,,Cash,,EPI SERVICE PRIMEUR,,-5434.0
,09,,09,,Cash,,EPI SERVICE PRIMEUR,,-5443.0
,22,,22,,Cash,,EPI SERVICE PRIMEUR,,-5465.0
,09,,09,,Cash,,EPI SERVICE PRIMEUR,,-5474.0
,"39,90",,"39,90",,Cash,,EPI SERVICE PRIMEUR,,-9464.0
,23,,23,,Cash,,EPI SERVICE PRIMEUR,,-9487.0
,09,,09,,Cash,,EPI SERVICE PRIMEUR,,-9496.0
,22,,22,,Cash,,EPI SERVICE PRIMEUR,,-9518.0
,09,,09,,Cash,,EPI SERVICE PRIMEUR,,-9527.0
,23,,23,,Cash,,EPI SERVICE PRIMEUR,,-9550.0
,09,,09,,Cash,,EPI SERVICE PRIMEUR,,-9559.0
,64,,64,,Cash,,EPI SERVICE PRIMEUR,,-9623.0
,23,,23,,Cash,,EPI SERVICE PRIMEUR,,-9646.0
,09,,09,,Cash,,EPI SERVICE PRIMEUR,,-9655.0
,64,,64,,Cash,,EPI SERVICE PRIMEUR,,-9719.0
,23,,23,,Cash,,EPI SERVICE PRIMEUR,,-9742.0
,09,,09,,Cash,,EPI SERVICE PRIMEUR,,-9751.0
,01,,01,,Cash,,EPI SERVICE PRIMEUR,,-9752.0
,23,,23,,Cash,,EPI SERVICE PRIMEUR,,-9775.0
,09,,09,,Cash,,EPI SERVICE PRIMEUR,,-9784.0
,64,,64,,Cash,,EPI SERVICE PRIMEUR,,-9848.0
,23,,23,,Cash,,EPI SERVICE PRIMEUR,,-9871.0
,09,,09,,Cash,,EPI SERVICE PRIMEUR,,-9880.0
,01,,01,,Cash,,EPI SERVICE PRIMEUR,,-9881.0
,"2,31",,"2,31",,Cash,,EPI SERVICE PRIMEUR,,-10112.0
,"0,18",,"0,18",,Cash,,EPI SERVICE PRIMEUR,,-10130.0
,"0,08",,"0,08",,Cash,,EPI SERVICE PRIMEUR,,-10138.0
,"260,00",,"260,00",,Cash,,EPI SERVICE PRIMEUR,,-36138.0
,20,,20,,Cash,,EPI SERVICE PRIMEUR,,-36158.0
,"09 449,55",,"09 449,55",,Cash,,EPI SERVICE PRIMEUR,,-981113.0
,20,,20,,Cash,,EPI SERVICE PRIMEUR,,-981133.0
,"09 112,24",,"09 112,24",,Cash,,EPI SERVICE PRIMEUR,,-1892357.0
,21,,21,,Cash,,EPI SERVICE PRIMEUR,,-1892378.0
,09 21,,09 21,,Cash,,EPI SERVICE PRIMEUR,,-1893299.0
,09 21,,09 21,,Cash,,EPI SERVICE PRIMEUR,,-1894220.0
,09 21,,09 21,,Cash,,EPI SERVICE PRIMEUR,,-1895141.0
,09 21,,09 21,,Cash,,EPI SERVICE PRIMEUR,,-1896062.0
,09 21,,09 21,,Cash,,EPI SERVICE PRIMEUR,,-1896983.0
,09 21,,09 21,,Cash,,EPI SERVICE PRIMEUR,,-1897904.0
,09 21,,09 21,,Cash,,EPI SERVICE PRIMEUR,,-1898825.0
,09 21,,09 21,,Cash,,EPI SERVICE PRIMEUR,,-1899746.0
,09 21,,09 21,,Cash,,EPI SERVICE PRIMEUR,,-1900667.0
,09 22,,09 22,,Cash,,EPI SERVICE PRIMEUR,,-1901589.0
,09 22,,09 22,,Cash,,EPI SERVICE PRIMEUR,,-1902511.0
,09 22,,09 22,,Cash,,EPI SERVICE PRIMEUR,,-1903433.0
,09 22,,09 22,,Cash,,EPI SERVICE PRIMEUR,,-1904355.0
,09 22,,09 22,,Cash,,EPI SERVICE PRIMEUR,,-1905277.0
,09 22,,09 22,,Cash,,EPI SERVICE PRIMEUR,,-1906199.0
,09 22,,09 22,,Cash,,EPI SERVICE PRIMEUR,,-1907121.0
,09 22,,09 22,,Cash,,EPI SERVICE PRIMEUR,,-1908043.0
,09 22,,09 22,,Cash,,EPI SERVICE PRIMEUR,,-1908965.0
,09 22,,09 22,,Cash,,EPI SERVICE PRIMEUR,,-1909887.0
,09 22,,09 22,,Cash,,EPI SERVICE PRIMEUR,,-1910809.0
,09 22,,09 22,,Cash,,EPI SERVICE PRIMEUR,,-1911731.0
,09 23,,09 23,,Cash,,EPI SERVICE PRIMEUR,,-1912654.0
,09 23,,09 23,,Cash,,EPI SERVICE PRIMEUR,,-1913577.0
,09 23,,09 23,,Cash,,EPI SERVICE PRIMEUR,,-1914500.0
,09 23,,09 23,,Cash,,EPI SERVICE PRIMEUR,,-1915423.0
,09 23,,09 23,,Cash,,EPI SERVICE PRIMEUR,,-1916346.0
,09 23,,09 23,,Cash,,EPI SERVICE PRIMEUR,,-1917269.0
,09 23,,09 23,,Cash,,EPI SERVICE PRIMEUR,,-1918192.0
,09 23,,09 23,,Cash,,EPI SERVICE PRIMEUR,,-1919115.0
,09 23,,09 23,,Cash,,EPI SERVICE PRIMEUR,,-1920038.0
,09 23,,09 23,,Cash,,EPI SERVICE PRIMEUR,,-1920961.0
,09 23,,09 23,,Cash,,EPI SERVICE PRIMEUR,,-1921884.0
,09 23,,09 23,,Cash,,EPI SERVICE PRIMEUR,,-1922807.0
,09 23,,09 23,,Cash,,EPI SERVICE PRIMEUR,,-1923730.0
,09 23,,09 23,,Cash,,EPI SERVICE PRIMEUR,,-1924653.0
,"09 298,90",,"09 298,90",,Cash,,EPI SERVICE PRIMEUR,,-2854543.0
,"79,00",,"79,00",,Cash,,EPI SERVICE PRIMEUR,,-2862443.0
,"236,00",,"236,00",,Cash,,EPI SERVICE PRIMEUR,,-2886043.0
,"142,55",,"142,55",,Cash,,EPI SERVICE PRIMEUR,,-2900298.0
,"1,63",,"1,63",,Cash,,EPI SERVICE PRIMEUR,,-2900461.0
,"2,01",,"2,01",,Cash,,EPI SERVICE PRIMEUR,,-2900662.0
,"1,25",,"1,25",,Cash,,EPI SERVICE PRIMEUR,,-2900787.0
,"0,31",,"0,31",,Cash,,EPI SERVICE PRIMEUR,,-2900818.0
,"0,76",,"0,76",,Cash,,EPI SERVICE PRIMEUR,,-2900894.0
,"0,38",,"0,38",,Cash,,EPI SERVICE PRIMEUR,,-2900932.0
,"39,50",,"39,50",,Cash,,EPI SERVICE PRIMEUR,,-2904882.0
,"322,00",,"322,00",,Cash,,EPI SERVICE PRIMEUR,,-2937082.0
,"61,50",,"61,50",,Cash,,EPI SERVICE PRIMEUR,,-2943232.0
,"56,70",,"56,70",,Cash,,EPI SERVICE PRIMEUR,,-2948902.0
,"176,20",,"176,20",,Cash,,EPI SERVICE PRIMEUR,,-2966522.0
,"0,62",,"0,62",,Cash,,EPI SERVICE PRIMEUR,,-2966584.0
,"3,73",,"3,73",,Cash,,EPI SERVICE PRIMEUR,,-2966957.0
,"1,27",,"1,27",,Cash,,EPI SERVICE PRIMEUR,,-2967084.0
,"0,22",,"0,22",,Cash,,EPI SERVICE PRIMEUR,,-2967106.0
,"0,79",,"0,79",,Cash,,EPI SERVICE PRIMEUR,,-2967185.0
,"0,13",,"0,13",,Cash,,EPI SERVICE PRIMEUR,,-2967198.0
,"0,03",,"0,03",,Cash,,EPI SERVICE PRIMEUR,,-2967201.0
,"37,00",,"37,00",,Cash,,EPI SERVICE PRIMEUR,,-2970901.0
,"49,50",,"49,50",,Cash,,EPI SERVICE PRIMEUR,,-2975851.0
,"256,30",,"256,30",,Cash,,EPI SERVICE PRIMEUR,,-3001481.0
,"44,00",,"44,00",,Cash,,EPI SERVICE PRIMEUR,,-3005881.0
,"66,30",,"66,30",,Cash,,EPI SERVICE PRIMEUR,,-3012511.0
,"181,95",,"181,95",,Cash,,EPI SERVICE PRIMEUR,,-3030706.0
,"50,43",,"50,43",,Cash,,EPI SERVICE PRIMEUR,,-3035749.0
,1,,1,,Cash,,EPI SERVICE PRIMEUR,,-3035750.0
,"39,90",,"39,90",,Cash,,EPI SERVICE PRIMEUR,,-3039740.0
,"144,41",,"144,41",,Cash,,EPI SERVICE PRIMEUR,,-3054181.0
,"0,73",,"0,73",,Cash,,EPI SERVICE PRIMEUR,,-3054254.0
,"1,05",,"1,05",,Cash,,EPI SERVICE PRIMEUR,,-3054359.0
,"0,18",,"0,18",,Cash,,EPI SERVICE PRIMEUR,,-3054377.0
,"0,87",,"0,87",,Cash,,EPI SERVICE PRIMEUR,,-3054464.0
,"0,12",,"0,12",,Cash,,EPI SERVICE PRIMEUR,,-3054476.0
23/09/2021,40,,40,,Cash,,EPI SERVICE PRIMEUR,Titulaire(s,-40.0
23/09/2021,10,,10,,Cash,,EPI SERVICE PRIMEUR,Date Date de Valeur,-50.0
23/09/2021,6,,6,,Cash,,EPI SERVICE PRIMEUR,METRO CASH,-56.0
23/09/2021,10,,10,,Cash,,EPI SERVICE PRIMEUR,REMISE,-66.0
23/09/2021,23,,23,,Cash,,EPI SERVICE PRIMEUR,REMISE,-89.0
24/09/2021,09 23,,09 23,,Cash,,EPI SERVICE PRIMEUR,TPV,-1012.0
24/09/2021,09,,09,,Cash,,EPI SERVICE PRIMEUR,REMISE,-1021.0
24/09/2021,23,,23,,Cash,,EPI SERVICE PRIMEUR,TPV,-1044.0
24/09/2021,09,,09,,Cash,,EPI SERVICE PRIMEUR,COM,-1053.0
24/09/2021,23,,23,,Cash,,EPI SERVICE PRIMEUR,CARTES,-1076.0
24/09/2021,09,,09,,Cash,,EPI SERVICE PRIMEUR,COM,-1085.0
24/09/2021,23,,23,,Cash,,EPI SERVICE PRIMEUR,CARTES,-1108.0
24/09/2021,09,,09,,Cash,,EPI SERVICE PRIMEUR,COM,-1117.0
24/09/2021,23,,23,,Cash,,EPI SERVICE PRIMEUR,CARTES 0386405,-1140.0
24/09/2021,09,,09,,Cash,,EPI SERVICE PRIMEUR,COM,-1149.0
24/09/2021,24,,24,,Cash,,EPI SERVICE PRIMEUR,CARTES,-1173.0
24/09/2021,09,,09,,Cash,,EPI SERVICE PRIMEUR,COM,-1182.0
27/09/2021,64,,64,,Cash,,EPI SERVICE PRIMEUR,CARTES,-1246.0
27/09/2021,24,,24,,Cash,,EPI SERVICE PRIMEUR,COM,-1270.0
25/09/2021,09,,09,,Cash,,EPI SERVICE PRIMEUR,CARTES,-1279.0
25/09/2021,01,,01,,Cash,,EPI SERVICE PRIMEUR,COM,-1280.0
25/09/2021,24,,24,,Cash,,EPI SERVICE PRIMEUR,CARTES 0386405,-1304.0
25/09/2021,09,,09,,Cash,,EPI SERVICE PRIMEUR,COM,-1313.0
25/09/2021,64,,64,,Cash,,EPI SERVICE PRIMEUR,CARTES,-1377.0
25/09/2021,24,,24,,Cash,,EPI SERVICE PRIMEUR,REMISE,-1401.0
25/09/2021,09,,09,,Cash,,EPI SERVICE PRIMEUR,REMISE,-1410.0
25/09/2021,01,,01,,Cash,,EPI SERVICE PRIMEUR,REMISE,-1411.0
25/09/2021,24,,24,,Cash,,EPI SERVICE PRIMEUR,TPV,-1435.0
25/09/2021,09,,09,,Cash,,EPI SERVICE PRIMEUR,REMISE,-1444.0
25/09/2021,64,,64,,Cash,,EPI SERVICE PRIMEUR,REMISE,-1508.0
25/09/2021,24,,24,,Cash,,EPI SERVICE PRIMEUR,REMISE,-1532.0
25/09/2021,09,,09,,Cash,,EPI SERVICE PRIMEUR,CARTE,-1541.0
27/09/2021,01,,01,,Cash,,EPI SERVICE PRIMEUR,AUTO,-1542.0
27/09/2021,24,,24,,Cash,,EPI SERVICE PRIMEUR,VERN SUR SEICH,-1566.0
27/09/2021,09,,09,,Cash,,EPI SERVICE PRIMEUR,COM,-1575.0
27/09/2021,64,,64,,Cash,,EPI SERVICE PRIMEUR,CARTES,-1639.0
27/09/2021,24,,24,,Cash,,EPI SERVICE PRIMEUR,COM,-1663.0
27/09/2021,09,,09,,Cash,,EPI SERVICE PRIMEUR,CARTES,-1672.0
27/09/2021,01,,01,,Cash,,EPI SERVICE PRIMEUR,COM,-1673.0
27/09/2021,24,,24,,Cash,,EPI SERVICE PRIMEUR,CARTES 0386405,-1697.0
27/09/2021,09,,09,,Cash,,EPI SERVICE PRIMEUR,COM,-1706.0
27/09/2021,24,,24,,Cash,,EPI SERVICE PRIMEUR,CARTES,-1730.0
27/09/2021,09,,09,,Cash,,EPI SERVICE PRIMEUR,COM,-1739.0
27/09/2021,24,,24,,Cash,,EPI SERVICE PRIMEUR,CARTES,-1763.0
27/09/2021,09,,09,,Cash,,EPI SERVICE PRIMEUR,COM,-1772.0
26/09/2021,24,,24,,Cash,,EPI SERVICE PRIMEUR,CARTES,-1796.0
27/09/2021,09,,09,,Cash,,EPI SERVICE PRIMEUR,COM,-1805.0
27/09/2021,27,,27,,Cash,,EPI SERVICE PRIMEUR,CARTES 0386405,-1832.0
26/09/2021,09,,09,,Cash,,EPI SERVICE PRIMEUR,COM,-1841.0
26/09/2021,27,,27,,Cash,,EPI SERVICE PRIMEUR,CARTES,-1868.0
,09,,09,,Cash,,EPI SERVICE PRIMEUR,COM,-1877.0
,25,,25,,Cash,,EPI SERVICE PRIMEUR,CARTES 0386405,-1902.0
,09,,09,,Cash,,EPI SERVICE PRIMEUR,COM,-1911.0
,24,,24,,Cash,,EPI SERVICE PRIMEUR,CARTES,-1935.0
,09,,09,,Cash,,EPI SERVICE PRIMEUR,COM,-1944.0
,25,,25,,Cash,,EPI SERVICE PRIMEUR,CARTES 0386405,-1969.0
,09,,09,,Cash,,EPI SERVICE PRIMEUR,COM,-1978.0
,64,,64,,Cash,,EPI SERVICE PRIMEUR,CARTES,-2042.0
,25,,25,,Cash,,EPI SERVICE PRIMEUR,REMISE,-2067.0
,09,,09,,Cash,,EPI SERVICE PRIMEUR,REMISE,-2076.0
,01,,01,,Cash,,EPI SERVICE PRIMEUR,REMISE,-2077.0
,25,,25,,Cash,,EPI SERVICE PRIMEUR,REMISE,-2102.0
,09,,09,,Cash,,EPI SERVICE PRIMEUR,STICHTING CUSTODIAN UBER PAY 27/09/2021,-2111.0
,64,,64,,Cash,,EPI SERVICE PRIMEUR,CARTE,-2175.0
,25,,25,,Cash,,EPI SERVICE PRIMEUR,METRO,-2200.0
,09,,09,,Cash,,EPI SERVICE PRIMEUR,COM,-2209.0
,01,,01,,Cash,,EPI SERVICE PRIMEUR,CARTES,-2210.0
,25,,25,,Cash,,EPI SERVICE PRIMEUR,COM,-2235.0
,09,,09,,Cash,,EPI SERVICE PRIMEUR,CARTES,-2244.0
,64,,64,,Cash,,EPI SERVICE PRIMEUR,COM,-2308.0
,25,,25,,Cash,,EPI SERVICE PRIMEUR,CARTES 0386405,-2333.0
,09,,09,,Cash,,EPI SERVICE PRIMEUR,COM,-2342.0
,01,,01,,Cash,,EPI SERVICE PRIMEUR,CARTES,-2343.0
,25,,25,,Cash,,EPI SERVICE PRIMEUR,COM,-2368.0
,09,,09,,Cash,,EPI SERVICE PRIMEUR,CARTES,-2377.0
,64,,64,,Cash,,EPI SERVICE PRIMEUR,COM,-2441.0
,25,,25,,Cash,,EPI SERVICE PRIMEUR,CARTES,-2466.0
,09,,09,,Cash,,EPI SERVICE PRIMEUR,COM,-2475.0
,01,,01,,Cash,,EPI SERVICE PRIMEUR,CARTES 0386405,-2476.0
,25,,25,,Cash,,EPI SERVICE PRIMEUR,COM,-2501.0
,09,,09,,Cash,,EPI SERVICE PRIMEUR,CARTES,-2510.0
,64,,64,,Cash,,EPI SERVICE PRIMEUR,COM,-2574.0
,25,,25,,Cash,,EPI SERVICE PRIMEUR,CARTES,-2599.0
,09,,09,,Cash,,EPI SERVICE PRIMEUR,COM,-2608.0
,01,,01,,Cash,,EPI SERVICE PRIMEUR,CARTES,-2609.0
,25,,25,,Cash,,EPI SERVICE PRIMEUR,,-2634.0
,09,,09,,Cash,,EPI SERVICE PRIMEUR,,-2643.0
,64,,64,,Cash,,EPI SERVICE PRIMEUR,,-2707.0
,25,,25,,Cash,,EPI SERVICE PRIMEUR,,-2732.0
,09,,09,,Cash,,EPI SERVICE PRIMEUR,,-2741.0
,01,,01,,Cash,,EPI SERVICE PRIMEUR,,-2742.0
,27,,27,,Cash,,EPI SERVICE PRIMEUR,,-2769.0
,09,,09,,Cash,,EPI SERVICE PRIMEUR,,-2778.0
,27,,27,,Cash,,EPI SERVICE PRIMEUR,,-2805.0
,09,,09,,Cash,,EPI SERVICE PRIMEUR,,-2814.0
,27,,27,,Cash,,EPI SERVICE PRIMEUR,,-2841.0
,09,,09,,Cash,,EPI SERVICE PRIMEUR,,-2850.0
,27,,27,,Cash,,EPI SERVICE PRIMEUR,,-2877.0
,09,,09,,Cash,,EPI SERVICE PRIMEUR,,-2886.0
,27,,27,,Cash,,EPI SERVICE PRIMEUR,,-2913.0
,09,,09,,Cash,,EPI SERVICE PRIMEUR,,-2922.0
,27,,27,,Cash,,EPI SERVICE PRIMEUR,,-2949.0
,09,,09,,Cash,,EPI SERVICE PRIMEUR,,-2958.0
,27,,27,,Cash,,EPI SERVICE PRIMEUR,,-2985.0
,09,,09,,Cash,,EPI SERVICE PRIMEUR,,-2994.0
,27,,27,,Cash,,EPI SERVICE PRIMEUR,,-3021.0
,09,,09,,Cash,,EPI SERVICE PRIMEUR,,-3030.0
,25,,25,,Cash,,EPI SERVICE PRIMEUR,,-3055.0
,09,,09,,Cash,,EPI SERVICE PRIMEUR,,-3064.0
,27,,27,,Cash,,EPI SERVICE PRIMEUR,,-3091.0
,09,,09,,Cash,,EPI SERVICE PRIMEUR,,-3100.0
,64,,64,,Cash,,EPI SERVICE PRIMEUR,,-3164.0
,27,,27,,Cash,,EPI SERVICE PRIMEUR,,-3191.0
,09,,09,,Cash,,EPI SERVICE PRIMEUR,,-3200.0
,01,,01,,Cash,,EPI SERVICE PRIMEUR,,-3201.0
,27,,27,,Cash,,EPI SERVICE PRIMEUR,,-3228.0
,09,,09,,Cash,,EPI SERVICE PRIMEUR,,-3237.0
,64,,64,,Cash,,EPI SERVICE PRIMEUR,,-3301.0
,27,,27,,Cash,,EPI SERVICE PRIMEUR,,-3328.0
,09,,09,,Cash,,EPI SERVICE PRIMEUR,,-3337.0
,01,,01,,Cash,,EPI SERVICE PRIMEUR,,-3338.0
,27,,27,,Cash,,EPI SERVICE PRIMEUR,,-3365.0
,09,,09,,Cash,,EPI SERVICE PRIMEUR,,-3374.0
,64,,64,,Cash,,EPI SERVICE PRIMEUR,,-3438.0
,26,,26,,Cash,,EPI SERVICE PRIMEUR,,-3464.0
,09,,09,,Cash,,EPI SERVICE PRIMEUR,,-3473.0
,01,,01,,Cash,,EPI SERVICE PRIMEUR,,-3474.0
,27,,27,,Cash,,EPI SERVICE PRIMEUR,,-3501.0
,09,,09,,Cash,,EPI SERVICE PRIMEUR,,-3510.0
,64,,64,,Cash,,EPI SERVICE PRIMEUR,,-3574.0
,27,,27,,Cash,,EPI SERVICE PRIMEUR,,-3601.0
,09,,09,,Cash,,EPI SERVICE PRIMEUR,,-3610.0
,01,,01,,Cash,,EPI SERVICE PRIMEUR,,-3611.0
,26,,26,,Cash,,EPI SERVICE PRIMEUR,,-3637.0
,09,,09,,Cash,,EPI SERVICE PRIMEUR,,-3646.0
,64,,64,,Cash,,EPI SERVICE PRIMEUR,,-3710.0
,26,,26,,Cash,,EPI SERVICE PRIMEUR,,-3736.0
,09,,09,,Cash,,EPI SERVICE PRIMEUR,,-3745.0
,01,,01,,Cash,,EPI SERVICE PRIMEUR,,-3746.0
,"1 305,03",,"1 305,03",,Cash,,EPI SERVICE PRIMEUR,,-134249.0
,24,,24,,Cash,,EPI SERVICE PRIMEUR,,-134273.0
,09 24,,09 24,,Cash,,EPI SERVICE PRIMEUR,,-135197.0
,09 24,,09 24,,Cash,,EPI SERVICE PRIMEUR,,-136121.0
,09 24,,09 24,,Cash,,EPI SERVICE PRIMEUR,,-137045.0
,09 24,,09 24,,Cash,,EPI SERVICE PRIMEUR,,-137969.0
,09 24,,09 24,,Cash,,EPI SERVICE PRIMEUR,,-138893.0
,09 24,,09 24,,Cash,,EPI SERVICE PRIMEUR,,-139817.0
,09 24,,09 24,,Cash,,EPI SERVICE PRIMEUR,,-140741.0
,09 24,,09 24,,Cash,,EPI SERVICE PRIMEUR,,-141665.0
,09 24,,09 24,,Cash,,EPI SERVICE PRIMEUR,,-142589.0
,09 24,,09 24,,Cash,,EPI SERVICE PRIMEUR,,-143513.0
,09 24,,09 24,,Cash,,EPI SERVICE PRIMEUR,,-144437.0
,09 25,,09 25,,Cash,,EPI SERVICE PRIMEUR,,-145362.0
,09 25,,09 25,,Cash,,EPI SERVICE PRIMEUR,,-146287.0
,09 25,,09 25,,Cash,,EPI SERVICE PRIMEUR,,-147212.0
,09 25,,09 25,,Cash,,EPI SERVICE PRIMEUR,,-148137.0
,09 25,,09 25,,Cash,,EPI SERVICE PRIMEUR,,-149062.0
,09 25,,09 25,,Cash,,EPI SERVICE PRIMEUR,,-149987.0
,09 25,,09 25,,Cash,,EPI SERVICE PRIMEUR,,-150912.0
,09 25,,09 25,,Cash,,EPI SERVICE PRIMEUR,,-151837.0
,09 25,,09 25,,Cash,,EPI SERVICE PRIMEUR,,-152762.0
,09 25,,09 25,,Cash,,EPI SERVICE PRIMEUR,,-153687.0
,09 25,,09 25,,Cash,,EPI SERVICE PRIMEUR,,-154612.0
,09 25,,09 25,,Cash,,EPI SERVICE PRIMEUR,,-155537.0
,09 25,,09 25,,Cash,,EPI SERVICE PRIMEUR,,-156462.0
,09 25,,09 25,,Cash,,EPI SERVICE PRIMEUR,,-157387.0
,09 25,,09 25,,Cash,,EPI SERVICE PRIMEUR,,-158312.0
,09 25,,09 25,,Cash,,EPI SERVICE PRIMEUR,,-159237.0
,09 25,,09 25,,Cash,,EPI SERVICE PRIMEUR,,-160162.0
,09 25,,09 25,,Cash,,EPI SERVICE PRIMEUR,,-161087.0
,09 25,,09 25,,Cash,,EPI SERVICE PRIMEUR,,-162012.0
,09 27,,09 27,,Cash,,EPI SERVICE PRIMEUR,,-162939.0
,09 27,,09 27,,Cash,,EPI SERVICE PRIMEUR,,-163866.0
,09 27,,09 27,,Cash,,EPI SERVICE PRIMEUR,,-164793.0
,09 27,,09 27,,Cash,,EPI SERVICE PRIMEUR,,-165720.0
,09 27,,09 27,,Cash,,EPI SERVICE PRIMEUR,,-166647.0
,09 27,,09 27,,Cash,,EPI SERVICE PRIMEUR,,-167574.0
,09,,09,,Cash,,EPI SERVICE PRIMEUR,,-167583.0
,27,,27,,Cash,,EPI SERVICE PRIMEUR,,-167610.0
,09 27,,09 27,,Cash,,EPI SERVICE PRIMEUR,,-168537.0
,09 27,,09 27,,Cash,,EPI SERVICE PRIMEUR,,-169464.0
,09 27,,09 27,,Cash,,EPI SERVICE PRIMEUR,,-170391.0
,09 27,,09 27,,Cash,,EPI SERVICE PRIMEUR,,-171318.0
,09 27,,09 27,,Cash,,EPI SERVICE PRIMEUR,,-172245.0
,09 27,,09 27,,Cash,,EPI SERVICE PRIMEUR,,-173172.0
,09 27,,09 27,,Cash,,EPI SERVICE PRIMEUR,,-174099.0
,09 27,,09 27,,Cash,,EPI SERVICE PRIMEUR,,-175026.0
,09,,09,,Cash,,EPI SERVICE PRIMEUR,,-175035.0
,27,,27,,Cash,,EPI SERVICE PRIMEUR,,-175062.0
,09 56,,09 56,,Cash,,EPI SERVICE PRIMEUR,,-176018.0
,"40 364,80",,"40 364,80",,Cash,,EPI SERVICE PRIMEUR,,-4212498.0
,"51,90",,"51,90",,Cash,,EPI SERVICE PRIMEUR,,-4217688.0
,"73,00",,"73,00",,Cash,,EPI SERVICE PRIMEUR,,-4224988.0
,"0,64",,"0,64",,Cash,,EPI SERVICE PRIMEUR,,-4225052.0
,"0,15",,"0,15",,Cash,,EPI SERVICE PRIMEUR,,-4225067.0
,"1,82",,"1,82",,Cash,,EPI SERVICE PRIMEUR,,-4225249.0
,"0,08",,"0,08",,Cash,,EPI SERVICE PRIMEUR,,-4225257.0
,"0,46",,"0,46",,Cash,,EPI SERVICE PRIMEUR,,-4225303.0
,"0,33",,"0,33",,Cash,,EPI SERVICE PRIMEUR,,-4225336.0
,"0,12",,"0,12",,Cash,,EPI SERVICE PRIMEUR,,-4225348.0
,"0,08",,"0,08",,Cash,,EPI SERVICE PRIMEUR,,-4225356.0
,"56,00",,"56,00",,Cash,,EPI SERVICE PRIMEUR,,-4230956.0
,"972,20",,"972,20",,Cash,,EPI SERVICE PRIMEUR,,-4328176.0
,"56,60",,"56,60",,Cash,,EPI SERVICE PRIMEUR,,-4333836.0
,"92,30",,"92,30",,Cash,,EPI SERVICE PRIMEUR,,-4343066.0
,"35,10",,"35,10",,Cash,,EPI SERVICE PRIMEUR,,-4346576.0
,"352,60",,"352,60",,Cash,,EPI SERVICE PRIMEUR,,-4381836.0
,"172,10",,"172,10",,Cash,,EPI SERVICE PRIMEUR,,-4399046.0
,"1,01",,"1,01",,Cash,,EPI SERVICE PRIMEUR,,-4399147.0
,"0,17",,"0,17",,Cash,,EPI SERVICE PRIMEUR,,-4399164.0
,"3,64",,"3,64",,Cash,,EPI SERVICE PRIMEUR,,-4399528.0
,"0,77",,"0,77",,Cash,,EPI SERVICE PRIMEUR,,-4399605.0
,"0,23",,"0,23",,Cash,,EPI SERVICE PRIMEUR,,-4399628.0
,"0,38",,"0,38",,Cash,,EPI SERVICE PRIMEUR,,-4399666.0
,"0,24",,"0,24",,Cash,,EPI SERVICE PRIMEUR,,-4399690.0
,"0,03",,"0,03",,Cash,,EPI SERVICE PRIMEUR,,-4399693.0
,"1,05",,"1,05",,Cash,,EPI SERVICE PRIMEUR,,-4399798.0
,"0,18",,"0,18",,Cash,,EPI SERVICE PRIMEUR,,-4399816.0
,"0,08",,"0,08",,Cash,,EPI SERVICE PRIMEUR,,-4399824.0
,"0,08",,"0,08",,Cash,,EPI SERVICE PRIMEUR,,-4399832.0
,"768,00",,"768,00",,Cash,,EPI SERVICE PRIMEUR,,-4476632.0
,"982,10",,"982,10",,Cash,,EPI SERVICE PRIMEUR,,-4574842.0
,"145,20",,"145,20",,Cash,,EPI SERVICE PRIMEUR,,-4589362.0
,"283,10",,"283,10",,Cash,,EPI SERVICE PRIMEUR,,-4617672.0
,"265,50",,"265,50",,Cash,,EPI SERVICE PRIMEUR,,-4644222.0
,"505,35",,"505,35",,Cash,,EPI SERVICE PRIMEUR,,-4694757.0
,"83,51",,"83,51",,Cash,,EPI SERVICE PRIMEUR,,-4703108.0
,"583,49",,"583,49",,Cash,,EPI SERVICE PRIMEUR,,-4761457.0
,"1,43",,"1,43",,Cash,,EPI SERVICE PRIMEUR,,-4761600.0
,"1,15",,"1,15",,Cash,,EPI SERVICE PRIMEUR,,-4761715.0
,"3,35",,"3,35",,Cash,,EPI SERVICE PRIMEUR,,-4762050.0
,"1,04",,"1,04",,Cash,,EPI SERVICE PRIMEUR,,-4762154.0
,"2,08",,"2,08",,Cash,,EPI SERVICE PRIMEUR,,-4762362.0
,"0,39",,"0,39",,Cash,,EPI SERVICE PRIMEUR,,-4762401.0
,"2,26",,"2,26",,Cash,,EPI SERVICE PRIMEUR,,-4762627.0
,"1,07",,"1,07",,Cash,,EPI SERVICE PRIMEUR,,-4762734.0
,"0,80",,"0,80",,Cash,,EPI SERVICE PRIMEUR,,-4762814.0
,"0,30",,"0,30",,Cash,,EPI SERVICE PRIMEUR,,-4762844.0
,8,,8,,Cash,,EPI SERVICE PRIMEUR,,-4762852.0
,4,,4,,Cash,,EPI SERVICE PRIMEUR,,-4762856.0
,1,,1,,Cash,,EPI SERVICE PRIMEUR,,-4762857.0
27/09/2021,40,,40,,Cash,,EPI SERVICE PRIMEUR,Titulaire(s,-40.0
27/09/2021,10,,10,,Cash,,EPI SERVICE PRIMEUR,Date Date de Valeur,-50.0
27/09/2021,7,,7,,Cash,,EPI SERVICE PRIMEUR,METRO CASH,-57.0
28/09/2021,10,,10,,Cash,,EPI SERVICE PRIMEUR,REMISE,-67.0
27/09/2021,27,,27,,Cash,,EPI SERVICE PRIMEUR,REMISE,-94.0
27/09/2021,09 27,,09 27,,Cash,,EPI SERVICE PRIMEUR,REMISE,-1021.0
28/09/2021,09,,09,,Cash,,EPI SERVICE PRIMEUR,REMISE,-1030.0
28/09/2021,27,,27,,Cash,,EPI SERVICE PRIMEUR,REMISE,-1057.0
28/09/2021,09,,09,,Cash,,EPI SERVICE PRIMEUR,TPV,-1066.0
28/09/2021,27,,27,,Cash,,EPI SERVICE PRIMEUR,COM,-1093.0
28/09/2021,09,,09,,Cash,,EPI SERVICE PRIMEUR,CARTES,-1102.0
28/09/2021,28,,28,,Cash,,EPI SERVICE PRIMEUR,COM,-1130.0
28/09/2021,09,,09,,Cash,,EPI SERVICE PRIMEUR,CARTES,-1139.0
28/09/2021,27,,27,,Cash,,EPI SERVICE PRIMEUR,COM,-1166.0
28/09/2021,09,,09,,Cash,,EPI SERVICE PRIMEUR,COM,-1175.0
29/09/2021,27,,27,,Cash,,EPI SERVICE PRIMEUR,CARTES,-1202.0
28/09/2021,09,,09,,Cash,,EPI SERVICE PRIMEUR,COM,-1211.0
28/09/2021,28,,28,,Cash,,EPI SERVICE PRIMEUR,CARTES,-1239.0
29/09/2021,09,,09,,Cash,,EPI SERVICE PRIMEUR,COM,-1248.0
29/09/2021,64,,64,,Cash,,EPI SERVICE PRIMEUR,CARTES,-1312.0
29/09/2021,28,,28,,Cash,,EPI SERVICE PRIMEUR,COM,-1340.0
29/09/2021,09,,09,,Cash,,EPI SERVICE PRIMEUR,CARTES,-1349.0
29/09/2021,01,,01,,Cash,,EPI SERVICE PRIMEUR,REMISE,-1350.0
29/09/2021,28,,28,,Cash,,EPI SERVICE PRIMEUR,REMISE,-1378.0
29/09/2021,09,,09,,Cash,,EPI SERVICE PRIMEUR,COM,-1387.0
29/09/2021,64,,64,,Cash,,EPI SERVICE PRIMEUR,CARTES,-1451.0
29/09/2021,28,,28,,Cash,,EPI SERVICE PRIMEUR,COM,-1479.0
29/09/2021,09,,09,,Cash,,EPI SERVICE PRIMEUR,CARTES,-1488.0
29/09/2021,01,,01,,Cash,,EPI SERVICE PRIMEUR,COM,-1489.0
30/09/2021,28,,28,,Cash,,EPI SERVICE PRIMEUR,CARTES 0386405,-1517.0
30/09/2021,09,,09,,Cash,,EPI SERVICE PRIMEUR,COM,-1526.0
30/09/2021,64,,64,,Cash,,EPI SERVICE PRIMEUR,CARTES,-1590.0
30/09/2021,28,,28,,Cash,,EPI SERVICE PRIMEUR,COM,-1618.0
30/09/2021,09,,09,,Cash,,EPI SERVICE PRIMEUR,CARTES,-1627.0
30/09/2021,01,,01,,Cash,,EPI SERVICE PRIMEUR,COM,-1628.0
30/09/2021,28,,28,,Cash,,EPI SERVICE PRIMEUR,CARTES,-1656.0
30/09/2021,09,,09,,Cash,,EPI SERVICE PRIMEUR,COM,-1665.0
30/09/2021,01,,01,,Cash,,EPI SERVICE PRIMEUR,REMISE,-1666.0
30/09/2021,28,,28,,Cash,,EPI SERVICE PRIMEUR,REMISE,-1694.0
30/09/2021,09,,09,,Cash,,EPI SERVICE PRIMEUR,REMISE,-1703.0
30/09/2021,28,,28,,Cash,,EPI SERVICE PRIMEUR,TPV,-1731.0
30/09/2021,09,,09,,Cash,,EPI SERVICE PRIMEUR,REMISE,-1740.0
30/09/2021,29,,29,,Cash,,EPI SERVICE PRIMEUR,TPV,-1769.0
30/09/2021,09,,09,,Cash,,EPI SERVICE PRIMEUR,COM,-1778.0
30/09/2021,28,,28,,Cash,,EPI SERVICE PRIMEUR,CARTES,-1806.0
01/10/2021,09,,09,,Cash,,EPI SERVICE PRIMEUR,COM,-1815.0
30/09/2021,28,,28,,Cash,,EPI SERVICE PRIMEUR,CARTES,-1843.0
30/09/2021,09,,09,,Cash,,EPI SERVICE PRIMEUR,COM,-1852.0
01/10/2021,29,,29,,Cash,,EPI SERVICE PRIMEUR,CARTES 0386405,-1881.0
01/10/2021,09,,09,,Cash,,EPI SERVICE PRIMEUR,COM,-1890.0
01/10/2021,64,,64,,Cash,,EPI SERVICE PRIMEUR,CARTES,-1954.0
01/10/2021,29,,29,,Cash,,EPI SERVICE PRIMEUR,COM,-1983.0
01/10/2021,09,,09,,Cash,,EPI SERVICE PRIMEUR,CARTES,-1992.0
,01,,01,,Cash,,EPI SERVICE PRIMEUR,COM,-1993.0
,29,,29,,Cash,,EPI SERVICE PRIMEUR,CARTES,-2022.0
,09,,09,,Cash,,EPI SERVICE PRIMEUR,COM,-2031.0
,64,,64,,Cash,,EPI SERVICE PRIMEUR,CARTES 0386405,-2095.0
,29,,29,,Cash,,EPI SERVICE PRIMEUR,COM,-2124.0
,09,,09,,Cash,,EPI SERVICE PRIMEUR,CARTES,-2133.0
,01,,01,,Cash,,EPI SERVICE PRIMEUR,COM,-2134.0
,29,,29,,Cash,,EPI SERVICE PRIMEUR,CARTES 0386405,-2163.0
,09,,09,,Cash,,EPI SERVICE PRIMEUR,COM,-2172.0
,64,,64,,Cash,,EPI SERVICE PRIMEUR,CARTES,-2236.0
,29,,29,,Cash,,EPI SERVICE PRIMEUR,COM,-2265.0
,09,,09,,Cash,,EPI SERVICE PRIMEUR,CARTES 0386405,-2274.0
,01,,01,,Cash,,EPI SERVICE PRIMEUR,COM,-2275.0
,29,,29,,Cash,,EPI SERVICE PRIMEUR,CARTES,-2304.0
,09,,09,,Cash,,EPI SERVICE PRIMEUR,TPV,-2313.0
,64,,64,,Cash,,EPI SERVICE PRIMEUR,TPV,-2377.0
,29,,29,,Cash,,EPI SERVICE PRIMEUR,CARTE,-2406.0
,09,,09,,Cash,,EPI SERVICE PRIMEUR,COM,-2415.0
,29,,29,,Cash,,EPI SERVICE PRIMEUR,CARTES,-2444.0
,09,,09,,Cash,,EPI SERVICE PRIMEUR,COM,-2453.0
,29,,29,,Cash,,EPI SERVICE PRIMEUR,CARTES 0386405,-2482.0
,09,,09,,Cash,,EPI SERVICE PRIMEUR,COM,-2491.0
,29,,29,,Cash,,EPI SERVICE PRIMEUR,CARTES,-2520.0
,09,,09,,Cash,,EPI SERVICE PRIMEUR,COM,-2529.0
,30,,30,,Cash,,EPI SERVICE PRIMEUR,CARTES,-2559.0
,09,,09,,Cash,,EPI SERVICE PRIMEUR,,-2568.0
,30,,30,,Cash,,EPI SERVICE PRIMEUR,,-2598.0
,09,,09,,Cash,,EPI SERVICE PRIMEUR,,-2607.0
,30,,30,,Cash,,EPI SERVICE PRIMEUR,,-2637.0
,09,,09,,Cash,,EPI SERVICE PRIMEUR,,-2646.0
,30,,30,,Cash,,EPI SERVICE PRIMEUR,,-2676.0
,09,,09,,Cash,,EPI SERVICE PRIMEUR,,-2685.0
,30,,30,,Cash,,EPI SERVICE PRIMEUR,,-2715.0
,09,,09,,Cash,,EPI SERVICE PRIMEUR,,-2724.0
,64,,64,,Cash,,EPI SERVICE PRIMEUR,,-2788.0
,30,,30,,Cash,,EPI SERVICE PRIMEUR,,-2818.0
,09,,09,,Cash,,EPI SERVICE PRIMEUR,,-2827.0
,01,,01,,Cash,,EPI SERVICE PRIMEUR,,-2828.0
,30,,30,,Cash,,EPI SERVICE PRIMEUR,,-2858.0
,09,,09,,Cash,,EPI SERVICE PRIMEUR,,-2867.0
,64,,64,,Cash,,EPI SERVICE PRIMEUR,,-2931.0
,30,,30,,Cash,,EPI SERVICE PRIMEUR,,-2961.0
,09,,09,,Cash,,EPI SERVICE PRIMEUR,,-2970.0
,01,,01,,Cash,,EPI SERVICE PRIMEUR,,-2971.0
,30,,30,,Cash,,EPI SERVICE PRIMEUR,,-3001.0
,09,,09,,Cash,,EPI SERVICE PRIMEUR,,-3010.0
,64,,64,,Cash,,EPI SERVICE PRIMEUR,,-3074.0
,30,,30,,Cash,,EPI SERVICE PRIMEUR,,-3104.0
,09,,09,,Cash,,EPI SERVICE PRIMEUR,,-3113.0
,01,,01,,Cash,,EPI SERVICE PRIMEUR,,-3114.0
,30,,30,,Cash,,EPI SERVICE PRIMEUR,,-3144.0
,09,,09,,Cash,,EPI SERVICE PRIMEUR,,-3153.0
,64,,64,,Cash,,EPI SERVICE PRIMEUR,,-3217.0
,30,,30,,Cash,,EPI SERVICE PRIMEUR,,-3247.0
,09,,09,,Cash,,EPI SERVICE PRIMEUR,,-3256.0
,01,,01,,Cash,,EPI SERVICE PRIMEUR,,-3257.0
,30,,30,,Cash,,EPI SERVICE PRIMEUR,,-3287.0
,09,,09,,Cash,,EPI SERVICE PRIMEUR,,-3296.0
,64,,64,,Cash,,EPI SERVICE PRIMEUR,,-3360.0
,30,,30,,Cash,,EPI SERVICE PRIMEUR,,-3390.0
,09,,09,,Cash,,EPI SERVICE PRIMEUR,,-3399.0
,01,,01,,Cash,,EPI SERVICE PRIMEUR,,-3400.0
,30,,30,,Cash,,EPI SERVICE PRIMEUR,,-3430.0
,09,,09,,Cash,,EPI SERVICE PRIMEUR,,-3439.0
,64,,64,,Cash,,EPI SERVICE PRIMEUR,,-3503.0
,30,,30,,Cash,,EPI SERVICE PRIMEUR,,-3533.0
,09,,09,,Cash,,EPI SERVICE PRIMEUR,,-3542.0
,01,,01,,Cash,,EPI SERVICE PRIMEUR,,-3543.0
,01,,01,,Cash,,EPI SERVICE PRIMEUR,,-3544.0
,10,,10,,Cash,,EPI SERVICE PRIMEUR,,-3554.0
,30,,30,,Cash,,EPI SERVICE PRIMEUR,,-3584.0
,09,,09,,Cash,,EPI SERVICE PRIMEUR,,-3593.0
,30,,30,,Cash,,EPI SERVICE PRIMEUR,,-3623.0
,09,,09,,Cash,,EPI SERVICE PRIMEUR,,-3632.0
,01,,01,,Cash,,EPI SERVICE PRIMEUR,,-3633.0
,10,,10,,Cash,,EPI SERVICE PRIMEUR,,-3643.0
,30,,30,,Cash,,EPI SERVICE PRIMEUR,,-3673.0
,09,,09,,Cash,,EPI SERVICE PRIMEUR,,-3682.0
,01,,01,,Cash,,EPI SERVICE PRIMEUR,,-3683.0
,10,,10,,Cash,,EPI SERVICE PRIMEUR,,-3693.0
,64,,64,,Cash,,EPI SERVICE PRIMEUR,,-3757.0
,01,,01,,Cash,,EPI SERVICE PRIMEUR,,-3758.0
,10,,10,,Cash,,EPI SERVICE PRIMEUR,,-3768.0
,64,,64,,Cash,,EPI SERVICE PRIMEUR,,-3832.0
,01,,01,,Cash,,EPI SERVICE PRIMEUR,,-3833.0
,10,,10,,Cash,,EPI SERVICE PRIMEUR,,-3843.0
,01,,01,,Cash,,EPI SERVICE PRIMEUR,,-3844.0
,01,,01,,Cash,,EPI SERVICE PRIMEUR,,-3845.0
,10,,10,,Cash,,EPI SERVICE PRIMEUR,,-3855.0
,64,,64,,Cash,,EPI SERVICE PRIMEUR,,-3919.0
,"297,00",,"297,00",,Cash,,EPI SERVICE PRIMEUR,,-33619.0
,28,,28,,Cash,,EPI SERVICE PRIMEUR,,-33647.0
,09 28,,09 28,,Cash,,EPI SERVICE PRIMEUR,,-34575.0
,09 28,,09 28,,Cash,,EPI SERVICE PRIMEUR,,-35503.0
,09 28,,09 28,,Cash,,EPI SERVICE PRIMEUR,,-36431.0
,09 28,,09 28,,Cash,,EPI SERVICE PRIMEUR,,-37359.0
,09 28,,09 28,,Cash,,EPI SERVICE PRIMEUR,,-38287.0
,09 28,,09 28,,Cash,,EPI SERVICE PRIMEUR,,-39215.0
,09 28,,09 28,,Cash,,EPI SERVICE PRIMEUR,,-40143.0
,09 28,,09 28,,Cash,,EPI SERVICE PRIMEUR,,-41071.0
,09 28,,09 28,,Cash,,EPI SERVICE PRIMEUR,,-41999.0
,09 28,,09 28,,Cash,,EPI SERVICE PRIMEUR,,-42927.0
,09 28,,09 28,,Cash,,EPI SERVICE PRIMEUR,,-43855.0
,09 29,,09 29,,Cash,,EPI SERVICE PRIMEUR,,-44784.0
,09 29,,09 29,,Cash,,EPI SERVICE PRIMEUR,,-45713.0
,09 29,,09 29,,Cash,,EPI SERVICE PRIMEUR,,-46642.0
,09 29,,09 29,,Cash,,EPI SERVICE PRIMEUR,,-47571.0
,09 29,,09 29,,Cash,,EPI SERVICE PRIMEUR,,-48500.0
,09 29,,09 29,,Cash,,EPI SERVICE PRIMEUR,,-49429.0
,09 29,,09 29,,Cash,,EPI SERVICE PRIMEUR,,-50358.0
,09 29,,09 29,,Cash,,EPI SERVICE PRIMEUR,,-51287.0
,09 29,,09 29,,Cash,,EPI SERVICE PRIMEUR,,-52216.0
,09 29,,09 29,,Cash,,EPI SERVICE PRIMEUR,,-53145.0
,09 29,,09 29,,Cash,,EPI SERVICE PRIMEUR,,-54074.0
,09 29,,09 29,,Cash,,EPI SERVICE PRIMEUR,,-55003.0
,09 30,,09 30,,Cash,,EPI SERVICE PRIMEUR,,-55933.0
,09 30,,09 30,,Cash,,EPI SERVICE PRIMEUR,,-56863.0
,09 30,,09 30,,Cash,,EPI SERVICE PRIMEUR,,-57793.0
,09 30,,09 30,,Cash,,EPI SERVICE PRIMEUR,,-58723.0
,09 30,,09 30,,Cash,,EPI SERVICE PRIMEUR,,-59653.0
,09 30,,09 30,,Cash,,EPI SERVICE PRIMEUR,,-60583.0
,09 30,,09 30,,Cash,,EPI SERVICE PRIMEUR,,-61513.0
,09 30,,09 30,,Cash,,EPI SERVICE PRIMEUR,,-62443.0
,09 30,,09 30,,Cash,,EPI SERVICE PRIMEUR,,-63373.0
,09 30,,09 30,,Cash,,EPI SERVICE PRIMEUR,,-64303.0
,09 30,,09 30,,Cash,,EPI SERVICE PRIMEUR,,-65233.0
,09 30,,09 30,,Cash,,EPI SERVICE PRIMEUR,,-66163.0
,09 30,,09 30,,Cash,,EPI SERVICE PRIMEUR,,-67093.0
,09 30,,09 30,,Cash,,EPI SERVICE PRIMEUR,,-68023.0
,09 30,,09 30,,Cash,,EPI SERVICE PRIMEUR,,-68953.0
,09 30,,09 30,,Cash,,EPI SERVICE PRIMEUR,,-69883.0
,09 30,,09 30,,Cash,,EPI SERVICE PRIMEUR,,-70813.0
,09 30,,09 30,,Cash,,EPI SERVICE PRIMEUR,,-71743.0
,09 30,,09 30,,Cash,,EPI SERVICE PRIMEUR,,-72673.0
,09 30,,09 30,,Cash,,EPI SERVICE PRIMEUR,,-73603.0
,09 01,,09 01,,Cash,,EPI SERVICE PRIMEUR,,-74504.0
,10 01,,10 01,,Cash,,EPI SERVICE PRIMEUR,,-75505.0
,10 01,,10 01,,Cash,,EPI SERVICE PRIMEUR,,-76506.0
,10 01,,10 01,,Cash,,EPI SERVICE PRIMEUR,,-77507.0
,10 01,,10 01,,Cash,,EPI SERVICE PRIMEUR,,-78508.0
,10 01,,10 01,,Cash,,EPI SERVICE PRIMEUR,,-79509.0
,10 01,,10 01,,Cash,,EPI SERVICE PRIMEUR,,-80510.0
,10 01,,10 01,,Cash,,EPI SERVICE PRIMEUR,,-81511.0
,10 10,,10 10,,Cash,,EPI SERVICE PRIMEUR,,-82521.0
,70 28,,70 28,,Cash,,EPI SERVICE PRIMEUR,,-89549.0
,"80 187,30",,"80 187,30",,Cash,,EPI SERVICE PRIMEUR,,-8108279.0
,"60,50",,"60,50",,Cash,,EPI SERVICE PRIMEUR,,-8114329.0
,"43,20",,"43,20",,Cash,,EPI SERVICE PRIMEUR,,-8118649.0
,"0,10",,"0,10",,Cash,,EPI SERVICE PRIMEUR,,-8118659.0
,"0,27",,"0,27",,Cash,,EPI SERVICE PRIMEUR,,-8118686.0
,"0,89",,"0,89",,Cash,,EPI SERVICE PRIMEUR,,-8118775.0
,"0,12",,"0,12",,Cash,,EPI SERVICE PRIMEUR,,-8118787.0
,"0,26",,"0,26",,Cash,,EPI SERVICE PRIMEUR,,-8118813.0
,"0,34",,"0,34",,Cash,,EPI SERVICE PRIMEUR,,-8118847.0
,"0,04",,"0,04",,Cash,,EPI SERVICE PRIMEUR,,-8118851.0
,"11,00",,"11,00",,Cash,,EPI SERVICE PRIMEUR,,-8119951.0
,"225,40",,"225,40",,Cash,,EPI SERVICE PRIMEUR,,-8142491.0
,"41,60",,"41,60",,Cash,,EPI SERVICE PRIMEUR,,-8146651.0
,"28,30",,"28,30",,Cash,,EPI SERVICE PRIMEUR,,-8149481.0
,"92,00",,"92,00",,Cash,,EPI SERVICE PRIMEUR,,-8158681.0
,"0,66",,"0,66",,Cash,,EPI SERVICE PRIMEUR,,-8158747.0
,"0,39",,"0,39",,Cash,,EPI SERVICE PRIMEUR,,-8158786.0
,"1,10",,"1,10",,Cash,,EPI SERVICE PRIMEUR,,-8158896.0
,"0,17",,"0,17",,Cash,,EPI SERVICE PRIMEUR,,-8158913.0
,"0,13",,"0,13",,Cash,,EPI SERVICE PRIMEUR,,-8158926.0
,"0,47",,"0,47",,Cash,,EPI SERVICE PRIMEUR,,-8158973.0
,"0,05",,"0,05",,Cash,,EPI SERVICE PRIMEUR,,-8158978.0
,"27,50",,"27,50",,Cash,,EPI SERVICE PRIMEUR,,-8161728.0
,"519,50",,"519,50",,Cash,,EPI SERVICE PRIMEUR,,-8213678.0
,"62,30",,"62,30",,Cash,,EPI SERVICE PRIMEUR,,-8219908.0
,"73,50",,"73,50",,Cash,,EPI SERVICE PRIMEUR,,-8227258.0
,"68,70",,"68,70",,Cash,,EPI SERVICE PRIMEUR,,-8234128.0
,"143,30",,"143,30",,Cash,,EPI SERVICE PRIMEUR,,-8248458.0
,"137,74",,"137,74",,Cash,,EPI SERVICE PRIMEUR,,-8262232.0
,"67,39",,"67,39",,Cash,,EPI SERVICE PRIMEUR,,-8268971.0
,"0,88",,"0,88",,Cash,,EPI SERVICE PRIMEUR,,-8269059.0
,"0,20",,"0,20",,Cash,,EPI SERVICE PRIMEUR,,-8269079.0
,"1,41",,"1,41",,Cash,,EPI SERVICE PRIMEUR,,-8269220.0
,"0,84",,"0,84",,Cash,,EPI SERVICE PRIMEUR,,-8269304.0
,"1,02",,"1,02",,Cash,,EPI SERVICE PRIMEUR,,-8269406.0
,"0,02",,"0,02",,Cash,,EPI SERVICE PRIMEUR,,-8269408.0
,"0,08",,"0,08",,Cash,,EPI SERVICE PRIMEUR,,-8269416.0
,"0,03",,"0,03",,Cash,,EPI SERVICE PRIMEUR,,-8269419.0
,"0,61",,"0,61",,Cash,,EPI SERVICE PRIMEUR,,-8269480.0
,"0,08",,"0,08",,Cash,,EPI SERVICE PRIMEUR,,-8269488.0
,"0,18",,"0,18",,Cash,,EPI SERVICE PRIMEUR,,-8269506.0
,"0,50",,"0,50",,Cash,,EPI SERVICE PRIMEUR,,-8269556.0
,1,,1,,Cash,,EPI SERVICE PRIMEUR,,-8269557.0
,1,,1,,Cash,,EPI SERVICE PRIMEUR,,-8269558.0
,"391,35",,"391,35",,Cash,,EPI SERVICE PRIMEUR,,-8308693.0
,"38,60",,"38,60",,Cash,,EPI SERVICE PRIMEUR,,-8312553.0
,"80,50",,"80,50",,Cash,,EPI SERVICE PRIMEUR,,-8320603.0
,"449,00",,"449,00",,Cash,,EPI SERVICE PRIMEUR,,-8365503.0
,"1,29",,"1,29",,Cash,,EPI SERVICE PRIMEUR,,-8365632.0
,"1,58",,"1,58",,Cash,,EPI SERVICE PRIMEUR,,-8365790.0
,"0,19",,"0,19",,Cash,,EPI SERVICE PRIMEUR,,-8365809.0
,"0,43",,"0,43",,Cash,,EPI SERVICE PRIMEUR,,-8365852.0
01/10/2021,01,,01,,Cheque,,Transactions,Relevés,-1.0
31/10/2021,10,,10,,Cheque,,Transactions,Du 01/10/2021 au 31/10/2021 qonto EGB 2 RUE WINSTON CHURCHILL 77120,-11.0
01/10/2021,31,,31,,Cheque,,Transactions,Coulommiers,-42.0
31/10/2021,10,,10,,Cheque,,Transactions,France Solde,-52.0
,2,,2,,Cheque,,Transactions,"Entrées + 3 796,40 € Sorties 2 504,46",-54.0
,01,,01,,Cheque,,Transactions,QNTOFRPIXXX Solde,-55.0
,10 27,,10 27,,Cheque,,Transactions,Date,-1082.0
,16,,16,,Cheque,,Transactions,Depot,-1098.0
,"3 796,40",,"3 796,40",,Cheque,,Transactions,DOS SANTOS Depot,-380738.0
,"2 504,46",,"2 504,46",,Cheque,,Transactions,Depot,-631184.0
,205,,205,,Cheque,,Transactions,Oonto,-631389.0
,31,,31,,Cheque,,Transactions,Abonnement,-631420.0
,10,,10,,Cheque,,Transactions,Frais,-631430.0
,"1 319,10",,"1 319,10",,Cheque,,Transactions,Oonto,-763340.0
,05,,05,,Cheque,,Transactions,Abonnement Frais,-763345.0
,10,,10,,Cheque,,Transactions,Oonto,-763355.0
,"450,00",,"450,00",,Cheque,,Transactions,Abonnement Frais,-808355.0
,05,,05,,Cheque,,Transactions,Oonto,-808360.0
,10,,10,,Cheque,,Transactions,Abonnement,-808370.0
,"530,00",,"530,00",,Cheque,,Transactions,Frais,-861370.0
,05,,05,,Cheque,,Transactions,Oonto,-861375.0
,10,,10,,Cheque,,Transactions,Oonto,-861385.0
,"288,00",,"288,00",,Cheque,,Transactions,Abonnement Frais,-890185.0
,05,,05,,Cheque,,Transactions,DELICES 77,-890190.0
,10,,10,,Cheque,,Transactions,EGB,-890200.0
,"240,00",,"240,00",,Cheque,,Transactions,,-914200.0
,05,,05,,Cheque,,Transactions,,-914205.0
,10,,10,,Cheque,,Transactions,,-914215.0
,"288,00",,"288,00",,Cheque,,Transactions,,-943015.0
,05,,05,,Cheque,,Transactions,,-943020.0
,10,,10,,Cheque,,Transactions,,-943030.0
,"42,00",,"42,00",,Cheque,,Transactions,,-947230.0
,05,,05,,Cheque,,Transactions,,-947235.0
,10,,10,,Cheque,,Transactions,,-947245.0
,"2,40",,"2,40",,Cheque,,Transactions,,-947485.0
,05,,05,,Cheque,,Transactions,,-947490.0
,10,,10,,Cheque,,Transactions,,-947500.0
,"2,40",,"2,40",,Cheque,,Transactions,,-947740.0
,05,,05,,Cheque,,Transactions,,-947745.0
,10,,10,,Cheque,,Transactions,,-947755.0
,"2,40",,"2,40",,Cheque,,Transactions,,-947995.0
,05,,05,,Cheque,,Transactions,,-948000.0
,10,,10,,Cheque,,Transactions,,-948010.0
,"2,40",,"2,40",,Cheque,,Transactions,,-948250.0
,05,,05,,Cheque,,Transactions,,-948255.0
,10,,10,,Cheque,,Transactions,,-948265.0
,"2,40",,"2,40",,Cheque,,Transactions,,-948505.0
,06,,06,,Cheque,,Transactions,,-948511.0
,10,,10,,Cheque,,Transactions,,-948521.0
,"237,78",,"237,78",,Cheque,,Transactions,,-972299.0
,07,,07,,Cheque,,Transactions,,-972306.0
,10,,10,,Cheque,,Transactions,,-972316.0
,"616,64",,"616,64",,Cheque,,Transactions,,-1033980.0
,08,,08,,Cheque,,Transactions,,-1033988.0
,10,,10,,Cheque,,Transactions,,-1033998.0
,"58,02",,"58,02",,Cheque,,Transactions,,-1039800.0
,08,,08,,Cheque,,Transactions,,-1039808.0
,10,,10,,Cheque,,Transactions,,-1039818.0
,77,,77,,Cheque,,Transactions,,-1039895.0
,"51,50",,"51,50",,Cheque,,Transactions,,-1045045.0
,08,,08,,Cheque,,Transactions,,-1045053.0
,10,,10,,Cheque,,Transactions,,-1045063.0
,"51,00",,"51,00",,Cheque,,Transactions,,-1050163.0
,09,,09,,Cheque,,Transactions,,-1050172.0
,10,,10,,Cheque,,Transactions,,-1050182.0
,"68,74",,"68,74",,Cheque,,Transactions,,-1057056.0
,01,,01,,Cheque,,Transactions,,-1057057.0
,10,,10,,Cheque,,Transactions,,-1057067.0
,31,,31,,Cheque,,Transactions,,-1057098.0
,10,,10,,Cheque,,Transactions,,-1057108.0
,205,,205,,Cheque,,Transactions,,-1057313.0
,1,,1,,Cheque,,Transactions,,-1057314.0
,2,,2,,Cheque,,Transactions,,-1057316.0
01/10/2021,,11,,,Cheque,,TOTAL,GROUPAMA 401374,11.0
31/10/2021,,10,,,Cheque,,TOTAL,Po73939785,21.0
,,"29,99",,,Cheque,,TOTAL,diallo mamadou,3020.0
,,11,,,Cheque,,TOTAL,WESTERN,3031.0
,,10,,,Cheque,,TOTAL,RELCOULOMMIERS,3041.0
,,"15,06",,,Cheque,,TOTAL,MAILLARD,4547.0
,,12,,,Cheque,,TOTAL,REBAIS FR,4559.0
,,10,,,Cheque,,TOTAL,LES TEMPLIERS,4569.0
,,"30,00",,,Cheque,,TOTAL,LECLERC,7569.0
,,12,,,Cheque,,TOTAL,RELCOULOMMIERS,7581.0
,,10,,,Cheque,,TOTAL,RECIPON Depot,7591.0
,,"58,50",,,Cheque,,TOTAL,RECIPON Depot,13441.0
,,12,,,Cheque,,TOTAL,Qonto,13453.0
,,10,,,Cheque,,TOTAL,Abonnement,13463.0
,,"16,02",,,Cheque,,TOTAL,Frais,15065.0
,,12,,,Cheque,,TOTAL,Oonto,15077.0
,,10,,,Cheque,,TOTAL,Abonnement,15087.0
,,"27,40",,,Cheque,,TOTAL,Frais,17827.0
,,13,,,Cheque,,TOTAL,Qonto,17840.0
,,10,,,Cheque,,TOTAL,Apple Pay,17850.0
,,"249,50",,,Cheque,,TOTAL,Qonto,42800.0
,,14,,,Cheque,,TOTAL,La Fayette,42814.0
,,10,,,Cheque,,TOTAL,"Paris RCS Paris n8819,489",42824.0
,,"25,00",,,Cheque,,TOTAL,Olinda,45324.0
,,14,,,Cheque,,TOTAL,| 'Autonte,45338.0
,,10,,,Cheque,,TOTAL,Resolution,45348.0
,,"51,20",,,Cheque,,TOTAL,ACPR)en,50468.0
,,15,,,Cheque,,TOTAL,numero,50483.0
,,10,,,Cheque,,TOTAL,EGB,50493.0
,,"17,33",,,Cheque,,TOTAL,,52226.0
,,15,,,Cheque,,TOTAL,,52241.0
,,10,,,Cheque,,TOTAL,,52251.0
,,"39,45",,,Cheque,,TOTAL,,56196.0
,,15,,,Cheque,,TOTAL,,56211.0
,,10,,,Cheque,,TOTAL,,56221.0
,,"10,00",,,Cheque,,TOTAL,,57221.0
,,16,,,Cheque,,TOTAL,,57237.0
,,10,,,Cheque,,TOTAL,,57247.0
,,"26,28",,,Cheque,,TOTAL,,59875.0
,,18,,,Cheque,,TOTAL,,59893.0
,,10,,,Cheque,,TOTAL,,59903.0
,,"16,43",,,Cheque,,TOTAL,,61546.0
,,18,,,Cheque,,TOTAL,,61564.0
,,10,,,Cheque,,TOTAL,,61574.0
,,"16,84",,,Cheque,,TOTAL,,63258.0
,,19,,,Cheque,,TOTAL,,63277.0
,,10,,,Cheque,,TOTAL,,63287.0
,,"56,34",,,Cheque,,TOTAL,,68921.0
,,28,,,Cheque,,TOTAL,,68949.0
,,10,,,Cheque,,TOTAL,,68959.0
,,"1 320,00",,,Cheque,,TOTAL,,200959.0
,,28,,,Cheque,,TOTAL,,200987.0
,,10,,,Cheque,,TOTAL,,200997.0
,,"680,40",,,Cheque,,TOTAL,,269037.0
,,28,,,Cheque,,TOTAL,,269065.0
,,10,,,Cheque,,TOTAL,,269075.0
,,"2,40",,,Cheque,,TOTAL,,269315.0
,,28,,,Cheque,,TOTAL,,269343.0
,,10,,,Cheque,,TOTAL,,269353.0
,,"2,40",,,Cheque,,TOTAL,,269593.0
,,29,,,Cheque,,TOTAL,,269622.0
,,10,,,Cheque,,TOTAL,,269632.0
,,"616,64",,,Cheque,,TOTAL,,331296.0
,,30,,,Cheque,,TOTAL,,331326.0
,,10,,,Cheque,,TOTAL,,331336.0
,,"60,00",,,Cheque,,TOTAL,,337336.0
,,250 995 35,,,Cheque,,TOTAL,,25436871.0
,,20,,,Cheque,,TOTAL,,25436891.0
,,489 626,,,Cheque,,TOTAL,,25926517.0
,,01,,,Cheque,,TOTAL,,25926518.0
,,10,,,Cheque,,TOTAL,,25926528.0
,,31,,,Cheque,,TOTAL,,25926559.0
,,10,,,Cheque,,TOTAL,,25926569.0
,,205,,,Cheque,,TOTAL,,25926774.0
,,2,,,Cheque,,TOTAL,,25926776.0
,,2,,,Cheque,,TOTAL,,25926778.0
,,5,,,Debit,,Credit Solde,poooic 2oiC01j1,5.0
,,01 79,,,Debit,,Credit Solde,Coût dun appel local WWW,184.0
,,48 40,,,Debit,,Credit Solde,COULOMMIERS 5 COURS GAMBETTA 77120,5024.0
,,00,,,Debit,,Credit Solde,Marai Mercredi,5024.0
,,01 64,,,Debit,,Credit Solde,ARGJENDI,5188.0
,,75 67,,,Debit,,Credit Solde,RUE,12755.0
,,08,,,Debit,,Credit Solde,FLEMING Votro Interlocuteur,12763.0
,,31,,,Debit,,Credit Solde,EURO ComptE,12794.0
,,01,,,Debit,,Credit Solde,Depot,12795.0
,,19,,,Debit,,Credit Solde,PARTS SOCIALES,12814.0
,,2,,,Debit,,Credit Solde,Solde,12816.0
,,1,,,Debit,,Credit Solde,31/01/19 Solde,12817.0
,,2,,,Debit,,Credit Solde,"31/01/19 41224,61 +000 +00 +200,00",12819.0
,,001 15,,,Debit,,Credit Solde,Remises Cheques,12934.0
,,00 080,,,Debit,,Credit Solde,N1751590000,13014.0
,,8,,,Debit,,Credit Solde,EURO Date Valeur Detail,13022.0
,,87,,,Debit,,Credit Solde,ReT,13109.0
,,63,,,Debit,,Credit Solde,ViRement,13172.0
,,10,,,Debit,,Credit Solde,RB ViR,13182.0
,,70,,,Debit,,Credit Solde,DOS,13252.0
,,31,,,Debit,,Credit Solde,ReT,13283.0
,,01,,,Debit,,Credit Solde,ViRement InteRne,13284.0
,,19,,,Debit,,Credit Solde,ReTRAIT,13303.0
,,31,,,Debit,,Credit Solde,GASHI,13334.0
,,01,,,Debit,,Credit Solde,N 0114688 M,13335.0
,,19,,,Debit,,Credit Solde,CB CONFORAMA FACT 230119,13354.0
,,31,,,Debit,,Credit Solde,N 0114688 M,13385.0
,,01,,,Debit,,Credit Solde,ReMZI,13386.0
,,19,,,Debit,,Credit Solde,N.0114688 M,13405.0
,,31,,,Debit,,Credit Solde,EPyinee{d6 Prevopnce Ie-Ce,13436.0
,,01,,,Debit,,Credit Solde,PaRS,13437.0
,,19,,,Debit,,Credit Solde,Banqu,13456.0
,,61,,,Debit,,Credit Solde,Cooperuve,13517.0
,,000,,,Debit,,Credit Solde,Utnu CU Coce Honeure,13517.0
,,00,,,Debit,,Credit Solde,Drectoire €,13517.0
,,"200,00",,,Debit,,Credit Solde,Onenuuon,33517.0
,,"725,00",,,Debit,,Credit Solde,@e Survcillance Caprul Ge 2 J15,106017.0
,,"50,00",,,Debit,,Credit Solde,Evros,111017.0
,,"445,39",,,Debit,,Credit Solde,Pons,155556.0
,,50,,,Debit,,Credit Solde,numero 07 0OS 200,155606.0
,,"1 500,39",,,Debit,,Credit Solde,,305645.0
,,2 725 00,,,Debit,,Credit Solde,,578145.0
,,87,,,Debit,,Credit Solde,,578232.0
,,9,,,Debit,,Credit Solde,,578241.0
,,"0,00",,,Debit,,Credit Solde,,578241.0
,,05,,,Debit,,Credit Solde,,578246.0
,,01 05,,,Debit,,Credit Solde,,578351.0
,,01,,,Debit,,Credit Solde,,578352.0
,,69 05,,,Debit,,Credit Solde,,585257.0
,,01 05,,,Debit,,Credit Solde,,585362.0
,,01,,,Debit,,Credit Solde,,585363.0
,,63,,,Debit,,Credit Solde,,585426.0
,,"2 000,00",,,Debit,,Credit Solde,,785426.0
,,"200,00",,,Debit,,Credit Solde,,805426.0
,,07,,,Debit,,Credit Solde,,805433.0
,,01 07,,,Debit,,Credit Solde,,805540.0
,,01,,,Debit,,Credit Solde,,805541.0
,,15,,,Debit,,Credit Solde,,805556.0
,,01 14,,,Debit,,Credit Solde,,805670.0
,,01,,,Debit,,Credit Solde,,805671.0
,,15,,,Debit,,Credit Solde,,805686.0
,,01 15,,,Debit,,Credit Solde,,805801.0
,,01,,,Debit,,Credit Solde,,805802.0
,,63 22,,,Debit,,Credit Solde,,812124.0
,,01 22,,,Debit,,Credit Solde,,812246.0
,,01,,,Debit,,Credit Solde,,812247.0
,,23,,,Debit,,Credit Solde,,812270.0
,,01 23,,,Debit,,Credit Solde,,812393.0
,,01,,,Debit,,Credit Solde,,812394.0
,,24,,,Debit,,Credit Solde,,812418.0
,,01 24,,,Debit,,Credit Solde,,812542.0
,,01,,,Debit,,Credit Solde,,812543.0
,,28,,,Debit,,Credit Solde,,812571.0
,,01 28,,,Debit,,Credit Solde,,812699.0
,,01,,,Debit,,Credit Solde,,812700.0
,,28,,,Debit,,Credit Solde,,812728.0
,,01 28,,,Debit,,Credit Solde,,812856.0
,,01,,,Debit,,Credit Solde,,812857.0
,,"5,00",,,Debit,,Credit Solde,,813357.0
,,"200,00",,,Debit,,Credit Solde,,833357.0
,,"600,00",,,Debit,,Credit Solde,,893357.0
,,"50,00",,,Debit,,Credit Solde,,898357.0
,,"52,00",,,Debit,,Credit Solde,,903557.0
,,"249,99",,,Debit,,Credit Solde,,928556.0
,,"60,00",,,Debit,,Credit Solde,,934556.0
,,1 71,,,Debit,,Credit Solde,,934727.0
,,00,,,Debit,,Credit Solde,,934727.0
,,1,,,Debit,,Credit Solde,,934728.0
,,3,,,Debit,,Credit Solde,,934731.0
,,16,,,Debit,,Credit Solde,,934747.0
,,512,,,Debit,,Credit Solde,,935259.0
,,85,,,Debit,,Credit Solde,,935344.0
,,2,,,Debit,,Credit Solde,,935346.0
,,000 000,,,Debit,,Credit Solde,,935346.0
,,182 900 942,,,Debit,,Credit Solde,,183836288.0
,,07,,,Debit,,Credit Solde,,183836295.0
,,200,,,Debit,,Credit Solde,,183836495.0
13/10/2020,,1,,,Debit,,PRLV,Gi PhoooiC,1.0
21/10/2020,,31,,,Debit,,PRLV,W20s2e8,32.0
,,10,,,Debit,,PRLV,COURANT N,42.0
,,20,,,Debit,,PRLV,Date Valeur Detail,62.0
,,23,,,Debit,,PRLV,ADBPNCOULOMMIER FACT 061020,85.0
,,2,,,Debit,,PRLV,ReMZI,87.0
,,3,,,Debit,,PRLV,ConVERGENCE DONT,90.0
,,87,,,Debit,,PRLV,EUR,177.0
,,07,,,Debit,,PRLV,Ret,184.0
,,10 07,,,Debit,,PRLV,RemZI,1191.0
,,10,,,Debit,,PRLV,RemZI,1201.0
,,07,,,Debit,,PRLV,CB TOTAL,1208.0
,,10 07,,,Debit,,PRLV,RemZI,2215.0
,,10,,,Debit,,PRLV,ReMISE,2225.0
,,08,,,Debit,,PRLV,Remis LE 13/10/2020,2233.0
,,10 08,,,Debit,,PRLV,PRLV ALLIANZ ARO ALLIANZ | A,3241.0
,,10,,,Debit,,PRLV,NMa,3251.0
,,"0,64",,,Debit,,PRLV,FR20ZZZ1075 14,3315.0
,,09,,,Debit,,PRLV,Tenue DossieR AdMinistratif,3324.0
,,10 09,,,Debit,,PRLV,CB SC,4333.0
,,10,,,Debit,,PRLV,ReMZI,4343.0
,,09,,,Debit,,PRLV,ReMISE,4352.0
,,10 09,,,Debit,,PRLV,ChEquES N,5361.0
,,10,,,Debit,,PRLV,ReMIS LE,5371.0
,,12,,,Debit,,PRLV,Cecocument,5383.0
,,10 12,,,Debit,,PRLV,chequler Ou,6395.0
,,10,,,Debit,,PRLV,Dancaire YoU,6405.0
,,12,,,Debit,,PRLV,Jerier You€,6417.0
,,10 12,,,Debit,,PRLV,Jknce PoU,7429.0
,,10,,,Debit,,PRLV,OfIC JU,7439.0
,,12,,,Debit,,PRLV,appei Cjne,7451.0
,,10 12,,,Debit,,PRLV,PJf,8463.0
,,10,,,Debit,,PRLV,Qu H YoUs Ctc},8473.0
,,13,,,Debit,,PRLV,YolYous,8486.0
,,10 13,,,Debit,,PRLV,rendarmene OU,9499.0
,,10,,,Debit,,PRLV,Ie Plus,9509.0
,,13,,,Debit,,PRLV,Cereleve ser,9522.0
,,10 14,,,Debit,,PRLV,ehnuvemen spprouve Yous,10536.0
,,10,,,Debit,,PRLV,Jucune,10546.0
,,13,,,Debit,,PRLV,Afuint Canf Voj€,10559.0
,,10,,,Debit,,PRLV,CtVo},10569.0
,,14,,,Debit,,PRLV,Onuju,10583.0
,,10 14,,,Debit,,PRLV,Ou rrchamjuon rcljuve,11597.0
,,10,,,Debit,,PRLV,JUX Pfocuu Ct IeMce} Dancaire,11607.0
,,15,,,Debit,,PRLV,Ouscnu Cft,11622.0
,,10 15,,,Debit,,PRLV,JUofes,12637.0
,,10,,,Debit,,PRLV,YoU€,12647.0
,,14,,,Debit,,PRLV,,12661.0
,,15,,,Debit,,PRLV,,12676.0
,,10 15,,,Debit,,PRLV,,13691.0
,,10,,,Debit,,PRLV,,13701.0
,,"400,00",,,Debit,,PRLV,,53701.0
,,"103,00",,,Debit,,PRLV,,64001.0
,,"29,64",,,Debit,,PRLV,,66965.0
,,"24,90",,,Debit,,PRLV,,69455.0
,,"46,00",,,Debit,,PRLV,,74055.0
,,"80,90",,,Debit,,PRLV,,82145.0
,,"34,41",,,Debit,,PRLV,,85586.0
,,"66,00",,,Debit,,PRLV,,92186.0
,,"14,60",,,Debit,,PRLV,,93646.0
,,"065,00",,,Debit,,PRLV,,100146.0
,,"54,00",,,Debit,,PRLV,,105546.0
,,"147,95",,,Debit,,PRLV,,120341.0
,,269 22,,,Debit,,PRLV,,147263.0
,,15,,,Debit,,PRLV,,147278.0
,,10 15,,,Debit,,PRLV,,148293.0
,,10,,,Debit,,PRLV,,148303.0
,,16,,,Debit,,PRLV,,148319.0
,,10 16,,,Debit,,PRLV,,149335.0
,,10,,,Debit,,PRLV,,149345.0
,,19,,,Debit,,PRLV,,149364.0
,,10 19,,,Debit,,PRLV,,150383.0
,,10,,,Debit,,PRLV,,150393.0
,,19,,,Debit,,PRLV,,150412.0
,,10 19,,,Debit,,PRLV,,151431.0
,,10,,,Debit,,PRLV,,151441.0
,,20,,,Debit,,PRLV,,151461.0
,,10 20,,,Debit,,PRLV,,152481.0
,,10,,,Debit,,PRLV,,152491.0
,,21,,,Debit,,PRLV,,152512.0
,,10 22,,,Debit,,PRLV,,153534.0
,,10,,,Debit,,PRLV,,153544.0
,,21,,,Debit,,PRLV,,153565.0
,,10,,,Debit,,PRLV,,153575.0
,,"80,00",,,Debit,,PRLV,,161575.0
,,"90,00",,,Debit,,PRLV,,170575.0
,,"37,50",,,Debit,,PRLV,,174325.0
,,"35,00",,,Debit,,PRLV,,177825.0
,,"8,00",,,Debit,,PRLV,,178625.0
,,"966,00",,,Debit,,PRLV,,275225.0
,,08,,,Debit,,PRLV,,275233.0
,,8,,,Debit,,PRLV,,275241.0
,,8,,,Debit,,PRLV,,275249.0
,,4,,,Debit,,PRLV,,275253.0
,,88,,,Debit,,PRLV,,275341.0
,,6,,,Debit,,PRLV,,275347.0
,,8,,,Debit,,PRLV,,275355.0
,,9,,,Debit,,PRLV,,275364.0
,,09 68,,,Debit,,PRLV,,276332.0
,,6 45,,,Debit,,PRLV,,276977.0
,,45,,,Debit,,PRLV,,277022.0
,,"0,15",,,Debit,,PRLV,,277037.0
,,3,,,Debit,,PRLV,,277040.0
,,1,,,Debit,,PRLV,,277041.0
,,1,,,Debit,,PRLV,,277042.0
31/10/2019,,31,,,Debit,,Credit,Gi PhoooiC,31.0
,,10,,,Debit,,Credit,W204)as 01j18604,41.0
,,19,,,Debit,,Credit,Mensuel N*1 Page 4 / ARgJEnDi,60.0
,,1,,,Debit,,Credit,Sunte,61.0
,,4,,,Debit,,Credit,CB RELAIS,65.0
,,87,,,Debit,,Credit,N 0114688 M,152.0
,,30,,,Debit,,Credit,SolDE AU,182.0
,,10 30,,,Debit,,Credit,N,1212.0
,,10,,,Debit,,Credit,Datalis,1222.0
,,"65,00",,,Debit,,Credit,dale dedition Qu,7722.0
,,31,,,Debit,,Credit,EUR,7753.0
,,"411 895,71",,,Debit,,Credit,tanfe,41197324.0
,,"813,49",,,Debit,,Credit,Ou defautselon celles higurant,41278673.0
,,87,,,Debit,,Credit,Conditions et Tants de la Caisse depargne,41278760.0
,,00,,,Debit,,Credit,Taux dinterets debiteurs,41278760.0
,,87,,,Debit,,Credit,TAUX DE BASE,41278847.0
,,31,,,Debit,,Credit,Ihypothese,41278878.0
,,10,,,Debit,,Credit,zero,41278888.0
,,6,,,Debit,,Credit,FRPp,41278894.0
,,4,,,Debit,,Credit,IBAN FR76,41278898.0
,,"0,150",,,Debit,,Credit,IBAN FR76,41279048.0
,,8,,,Debit,,Credit,Information,41279056.0
,,"1,000",,,Debit,,Credit,Vos depots,41280056.0
,,"0,150",,,Debit,,Credit,ala garantie,41280206.0
,,1,,,Debit,,Credit,Resolution,41280207.0
,,"2,000",,,Debit,,Credit,FGDR,41282207.0
,,2,,,Debit,,Credit,etablissementou,41282209.0
,,"2,000",,,Debit,,Credit,Concernant le Livret A Association,41284209.0
,,3,,,Debit,,Credit,Livret A HLM,41284212.0
,,"2,000",,,Debit,,Credit,TEtat,41286212.0
,,751,,,Debit,,Credit,,41286963.0
,,987,,,Debit,,Credit,,41287950.0
,,751,,,Debit,,Credit,,41288701.0
,,163,,,Debit,,Credit,,41288864.0
29/10/2020,,31,,,Debit,,Mensuel,Gi PuoooiC,31.0
,,10,,,Debit,,Mensuel,D'EPARGNE ILE DE FRANCE,41.0
,,20,,,Debit,,Mensuel,COURANT N,61.0
,,23,,,Debit,,Mensuel,Date Valeur Detail,84.0
,,3,,,Debit,,Mensuel,FACT 191020 N 0204603,87.0
,,3,,,Debit,,Mensuel,ReMZI,90.0
,,87,,,Debit,,Mensuel,TOTAL FACT 211020,177.0
,,21,,,Debit,,Mensuel,Sanel,198.0
,,10 21,,,Debit,,Mensuel,REMIS LE 29/10/2020,1219.0
,,10,,,Debit,,Mensuel,AU,1229.0
,,21,,,Debit,,Mensuel,"Irancs +14,302,29",1250.0
,,10 21,,,Debit,,Mensuel,FRPP,2271.0
,,10,,,Debit,,Mensuel,IBAN FR76,2281.0
,,22,,,Debit,,Mensuel,IBAN FR76,2303.0
,,10 22,,,Debit,,Mensuel,Information,3325.0
,,10,,,Debit,,Mensuel,Vos depots,3335.0
,,22,,,Debit,,Mensuel,Resolution,3357.0
,,10 22,,,Debit,,Mensuel,Roportez-vous &,4379.0
,,10,,,Debit,,Mensuel,FGDR,4389.0
,,26,,,Debit,,Mensuel,Livret A HLM,4415.0
,,10 26,,,Debit,,Mensuel,Cusse,5441.0
,,10,,,Debit,,Mensuel,Arcvoynce,5451.0
,,28,,,Debit,,Mensuel,Tolbiac CS,5479.0
,,10 28,,,Debit,,Mensuel,Banquc Cooperuve reoe,6507.0
,,10,,,Debit,,Mensuel,lcs arucles,6517.0
,,28,,,Debit,,Mensuel,t 'Uants,6545.0
,,10 28,,,Debit,,Mensuel,Code Honeuire,7573.0
,,10,,,Debit,,Mensuel,t hinngier Socete,7583.0
,,29,,,Debit,,Mensuel,Conscil d Onentuon,7612.0
,,10 30,,,Debit,,Mensuel,Surveillance Capial,8642.0
,,10,,,Debit,,Mensuel,RCS Pons,8652.0
,,29,,,Debit,,Mensuel,Pons,8681.0
,,10,,,Debit,,Mensuel,Casuaane,8691.0
,,"3,50",,,Debit,,Mensuel,numcro 07 0OS 200,9041.0
,,"152,65",,,Debit,,Mensuel,,24306.0
,,"60,00",,,Debit,,Mensuel,,30306.0
,,"4,80",,,Debit,,Mensuel,,30786.0
,,"90,33",,,Debit,,Mensuel,,39819.0
,,"3,50",,,Debit,,Mensuel,,40169.0
,,"50,00",,,Debit,,Mensuel,,45169.0
,,"005,00",,,Debit,,Mensuel,,45669.0
,,31,,,Debit,,Mensuel,,45700.0
,,"14,302,29",,,Debit,,Mensuel,,1475929.0
,,"2 180,37",,,Debit,,Mensuel,,1693966.0
,,751,,,Debit,,Mensuel,,1694717.0
,,987,,,Debit,,Mensuel,,1695704.0
,,751,,,Debit,,Mensuel,,1696455.0
,,163,,,Debit,,Mensuel,,1696618.0
,,1,,,Debit,,Mensuel,,1696619.0
,,5,,,Debit,,Mensuel,,1696624.0
,,26,,,Debit,,Mensuel,,1696650.0
,,28,,,Debit,,Mensuel,,1696678.0
,,512,,,Debit,,Mensuel,,1697190.0
,,85,,,Debit,,Mensuel,,1697275.0
,,3,,,Debit,,Mensuel,,1697278.0
,,2,,,Debit,,Mensuel,,1697280.0
,,75,,,Debit,,Mensuel,,1697355.0
,,900 942,,,Debit,,Mensuel,,2598297.0
,,07,,,Debit,,Mensuel,,2598304.0
,,200,,,Debit,,Mensuel,,2598504.0
,,1,,,Debit,,Mensuel,,2598505.0
01/08/2020,92,,92,,Unknown,,NAIS BEAUTE 15,SOCIETE GENERALE RELEVÉ DE COMPTE,-92.0
31/08/2020,01,,01,,Unknown,,NAIS BEAUTE 15,Page 1/5 VOS CONTACTS Votre Banque,-93.0
31/07/2020,08,,08,,Unknown,,NAIS BEAUTE 15,RUE DE VERDUN,-101.0
03/08/2020,31,,31,,Unknown,,NAIS BEAUTE 15,Email Isabelle,-132.0
03/08/2020,08,,08,,Unknown,,NAIS BEAUTE 15,NE VaUT PaS FaCTURE P61,-140.0
03/08/2020,8,,8,,Unknown,,NAIS BEAUTE 15,opération SOLDE,-148.0
03/08/2020,1,,1,,Unknown,,NAIS BEAUTE 15,OOE COM,-149.0
03/08/2020,5,,5,,Unknown,,NAIS BEAUTE 15,R06821 CT3883641801,-154.0
03/08/2020,0,,0,,Unknown,,NAIS BEAUTE 15,COM,-154.0
03/08/2020,15,,15,,Unknown,,NAIS BEAUTE 15,CT3883641001 BT,-169.0
03/08/2020,01 45,,01 45,,Unknown,,NAIS BEAUTE 15,COM,-314.0
03/08/2020,10 10,,10 10,,Unknown,,NAIS BEAUTE 15,COM,-1324.0
03/08/2020,10,,10,,Unknown,,NAIS BEAUTE 15,C13883641001 BT 127,-1334.0
03/08/2020,01 43,,01 43,,Unknown,,NAIS BEAUTE 15,OOE COM,-1477.0
03/08/2020,89 87,,89 87,,Unknown,,NAIS BEAUTE 15,EMIS NET,-10464.0
03/08/2020,62,,62,,Unknown,,NAIS BEAUTE 15,POURSamihana bhatta,-10526.0
03/08/2020,31,,31,,Unknown,,NAIS BEAUTE 15,Salary MOTIF,-10557.0
03/08/2020,07,,07,,Unknown,,NAIS BEAUTE 15,Salary CHEZ,-10564.0
03/08/2020,03,,03,,Unknown,,NAIS BEAUTE 15,REMISE,-10567.0
03/08/2020,08,,08,,Unknown,,NAIS BEAUTE 15,Salaire MOTIF: Salaire CHEZ SOGEFRPP,-10575.0
03/08/2020,03,,03,,Unknown,,NAIS BEAUTE 15,LIB,-10578.0
01/10/2015,08,,08,,Unknown,,NAIS BEAUTE 15,Insatisfaction,-10586.0
,01,,01,,Unknown,,NAIS BEAUTE 15,dosaccord,-10587.0
,08,,08,,Unknown,,NAIS BEAUTE 15,VOus pouvoz contactor Lagonco,-10595.0
,60,,60,,Unknown,,NAIS BEAUTE 15,Paris,-10655.0
,0,,0,,Unknown,,NAIS BEAUTE 15,Mediatour,-10655.0
,03,,03,,Unknown,,NAIS BEAUTE 15,Charte de la Mediation Societe Generale,-10658.0
,08,,08,,Unknown,,NAIS BEAUTE 15,Tadresse,-10666.0
,03,,03,,Unknown,,NAIS BEAUTE 15,Le Mediateur aupres,-10669.0
,08,,08,,Unknown,,NAIS BEAUTE 15,Valmy 92987,-10677.0
,02,,02,,Unknown,,NAIS BEAUTE 15,OU,-10679.0
,08,,08,,Unknown,,NAIS BEAUTE 15,recepton,-10687.0
,252,,252,,Unknown,,NAIS BEAUTE 15,Soacie Gcncae,-10939.0
,2,,2,,Unknown,,NAIS BEAUTE 15,Pans 1,-10941.0
,03,,03,,Unknown,,NAIS BEAUTE 15,,-10944.0
,08,,08,,Unknown,,NAIS BEAUTE 15,,-10952.0
,03,,03,,Unknown,,NAIS BEAUTE 15,,-10955.0
,08,,08,,Unknown,,NAIS BEAUTE 15,,-10963.0
,02,,02,,Unknown,,NAIS BEAUTE 15,,-10965.0
,08,,08,,Unknown,,NAIS BEAUTE 15,,-10973.0
,239,,239,,Unknown,,NAIS BEAUTE 15,,-11212.0
,2,,2,,Unknown,,NAIS BEAUTE 15,,-11214.0
,03,,03,,Unknown,,NAIS BEAUTE 15,,-11217.0
,08,,08,,Unknown,,NAIS BEAUTE 15,,-11225.0
,03,,03,,Unknown,,NAIS BEAUTE 15,,-11228.0
,08,,08,,Unknown,,NAIS BEAUTE 15,,-11236.0
,01,,01,,Unknown,,NAIS BEAUTE 15,,-11237.0
,08,,08,,Unknown,,NAIS BEAUTE 15,,-11245.0
,120,,120,,Unknown,,NAIS BEAUTE 15,,-11365.0
,1,,1,,Unknown,,NAIS BEAUTE 15,,-11366.0
,03,,03,,Unknown,,NAIS BEAUTE 15,,-11369.0
,08,,08,,Unknown,,NAIS BEAUTE 15,,-11377.0
,03,,03,,Unknown,,NAIS BEAUTE 15,,-11380.0
,08,,08,,Unknown,,NAIS BEAUTE 15,,-11388.0
,03,,03,,Unknown,,NAIS BEAUTE 15,,-11391.0
,08,,08,,Unknown,,NAIS BEAUTE 15,,-11399.0
,104,,104,,Unknown,,NAIS BEAUTE 15,,-11503.0
,1,,1,,Unknown,,NAIS BEAUTE 15,,-11504.0
,03,,03,,Unknown,,NAIS BEAUTE 15,,-11507.0
,08,,08,,Unknown,,NAIS BEAUTE 15,,-11515.0
,03,,03,,Unknown,,NAIS BEAUTE 15,,-11518.0
,08,,08,,Unknown,,NAIS BEAUTE 15,,-11526.0
,03,,03,,Unknown,,NAIS BEAUTE 15,,-11529.0
,08,,08,,Unknown,,NAIS BEAUTE 15,,-11537.0
,127,,127,,Unknown,,NAIS BEAUTE 15,,-11664.0
,1,,1,,Unknown,,NAIS BEAUTE 15,,-11665.0
,03,,03,,Unknown,,NAIS BEAUTE 15,,-11668.0
,08,,08,,Unknown,,NAIS BEAUTE 15,,-11676.0
,03,,03,,Unknown,,NAIS BEAUTE 15,,-11679.0
,08,,08,,Unknown,,NAIS BEAUTE 15,,-11687.0
,001,,001,,Unknown,,NAIS BEAUTE 15,,-11688.0
,03,,03,,Unknown,,NAIS BEAUTE 15,,-11691.0
,08,,08,,Unknown,,NAIS BEAUTE 15,,-11699.0
,03,,03,,Unknown,,NAIS BEAUTE 15,,-11702.0
,08,,08,,Unknown,,NAIS BEAUTE 15,,-11710.0
,001,,001,,Unknown,,NAIS BEAUTE 15,,-11711.0
,03,,03,,Unknown,,NAIS BEAUTE 15,,-11714.0
,08,,08,,Unknown,,NAIS BEAUTE 15,,-11722.0
,03,,03,,Unknown,,NAIS BEAUTE 15,,-11725.0
,08,,08,,Unknown,,NAIS BEAUTE 15,,-11733.0
,001,,001,,Unknown,,NAIS BEAUTE 15,,-11734.0
,"3.809,58",,"3.809,58",,Unknown,,NAIS BEAUTE 15,,-11737.80958
,"59,41",,"59,41",,Unknown,,NAIS BEAUTE 15,,-17678.80958
,"249,53",,"249,53",,Unknown,,NAIS BEAUTE 15,,-42631.80958
,"236,61",,"236,61",,Unknown,,NAIS BEAUTE 15,,-66292.80958
,"118,80",,"118,80",,Unknown,,NAIS BEAUTE 15,,-78172.80958
,"102,97",,"102,97",,Unknown,,NAIS BEAUTE 15,,-88469.80958
,"125,73",,"125,73",,Unknown,,NAIS BEAUTE 15,,-101042.80958
,"696,37",,"696,37",,Unknown,,NAIS BEAUTE 15,,-170679.80958
,"1 218,63",,"1 218,63",,Unknown,,NAIS BEAUTE 15,,-292542.80958
,1,,1,,Unknown,,NAIS BEAUTE 15,,-292543.80958
,"218,63",,"218,63",,Unknown,,NAIS BEAUTE 15,,-314406.80958
,33,,33,,Unknown,,NAIS BEAUTE 15,,-314439.80958
,76 77,,76 77,,Unknown,,NAIS BEAUTE 15,,-322116.80958
,01,,01,,Unknown,,NAIS BEAUTE 15,,-322117.80958
,10,,10,,Unknown,,NAIS BEAUTE 15,,-322127.80958
,18,,18,,Unknown,,NAIS BEAUTE 15,,-322145.80958
,17,,17,,Unknown,,NAIS BEAUTE 15,,-322162.80958
,7,,7,,Unknown,,NAIS BEAUTE 15,,-322169.80958
,90,,90,,Unknown,,NAIS BEAUTE 15,,-322259.80958
,552 120 222,,552 120 222,,Unknown,,NAIS BEAUTE 15,,-552442481.80958
,066 714 367,,066 714 367,,Unknown,,NAIS BEAUTE 15,,-619156848.80958
,58,,58,,Unknown,,NAIS BEAUTE 15,,-619156906.80958
,20,,20,,Unknown,,NAIS BEAUTE 15,,-619156926.80958
,1,,1,,Unknown,,NAIS BEAUTE 15,,-619156927.80958
,,5,,,Debit,,FLEMING,Mo1E0,5.0
,,01 79,,,Debit,,FLEMING,Coût dun appel local WWW caisse,184.0
,,48 40,,,Debit,,FLEMING,Votre Agence COULOMMIERS 5 COURS GAMBETTA 77120,5024.0
,,00,,,Debit,,FLEMING,Mensuel N'37,5024.0
,,01 64,,,Debit,,FLEMING,ARGJENDI,5188.0
,,75 67,,,Debit,,FLEMING,RUE,12755.0
,,08,,,Debit,,FLEMING,Votre Interlocuteur DE CLIENTELE AGENCE,12763.0
,,31,,,Debit,,FLEMING,COULOMMIERS Identifiant,12794.0
,,12,,,Debit,,FLEMING,EURO COMPTE,12806.0
,,21,,,Debit,,FLEMING,PARTS SOCIALES,12827.0
,,37,,,Debit,,FLEMING,Solde,12864.0
,,1,,,Debit,,FLEMING,u 31/12/21 Solde,12865.0
,,4,,,Debit,,FLEMING,Solde,12869.0
,,002,,,Debit,,FLEMING,DecaiSSES,12871.0
,,29,,,Debit,,FLEMING,EURO Date Valeur Detail,12900.0
,,00 880,,,Debit,,FLEMING,PRecedent AU,13780.0
,,8,,,Debit,,FLEMING,TOTAL FACT,13788.0
,,06 14,,,Debit,,FLEMING,CB SPORT,14402.0
,,84 16,,,Debit,,FLEMING,ReMZI,22818.0
,,12,,,Debit,,FLEMING,MC DONALDS FACT,22830.0
,,87,,,Debit,,FLEMING,ReTRAIT,22917.0
,,63,,,Debit,,FLEMING,Epxineet de Prevofonce,22980.0
,,10,,,Debit,,FLEMING,PARS,22990.0
,,70,,,Debit,,FLEMING,Banque Cooperauve,23060.0
,,31,,,Debit,,FLEMING,sUvanus,23091.0
,,12,,,Debit,,FLEMING,Code Honeuire,23103.0
,,21,,,Debit,,FLEMING,hinnaer Socete,23124.0
,,31,,,Debit,,FLEMING,Drcctoire,23155.0
,,12,,,Debit,,FLEMING,Conscil,23167.0
,,21,,,Debit,,FLEMING,Onenuuon ct de Surveillance 1 Cspiual de 2,23188.0
,,31,,,Debit,,FLEMING,RCS Pn:,23219.0
,,12,,,Debit,,FLEMING,,23231.0
,,21 69,,,Debit,,FLEMING,,25400.0
,,53,,,Debit,,FLEMING,,25453.0
,,00 200,,,Debit,,FLEMING,,25653.0
,,0,,,Debit,,FLEMING,,25653.0
,,"1 845,00",,,Debit,,FLEMING,,210153.0
,,30,,,Debit,,FLEMING,,210183.0
,,0 50,,,Debit,,FLEMING,,210233.0
,,"0 699,76",,,Debit,,FLEMING,,280209.0
,,"2 293,51",,,Debit,,FLEMING,,509560.0
,,"38,78",,,Debit,,FLEMING,,513438.0
,,05,,,Debit,,FLEMING,,513443.0
,,"1 845,00",,,Debit,,FLEMING,,697943.0
,,87,,,Debit,,FLEMING,,698030.0
,,"21 197,52",,,Debit,,FLEMING,,2817782.0
,,01,,,Debit,,FLEMING,,2817783.0
,,12 01,,,Debit,,FLEMING,,2818984.0
,,12,,,Debit,,FLEMING,,2818996.0
,,"96,90",,,Debit,,FLEMING,,2828686.0
,,02,,,Debit,,FLEMING,,2828688.0
,,12 02,,,Debit,,FLEMING,,2829890.0
,,12,,,Debit,,FLEMING,,2829902.0
,,172,,,Debit,,FLEMING,,2830074.0
,,97 03,,,Debit,,FLEMING,,2839777.0
,,12 03,,,Debit,,FLEMING,,2840980.0
,,12,,,Debit,,FLEMING,,2840992.0
,,"24,40",,,Debit,,FLEMING,,2843432.0
,,03,,,Debit,,FLEMING,,2843435.0
,,12 03,,,Debit,,FLEMING,,2844638.0
,,12,,,Debit,,FLEMING,,2844650.0
,,"10,00",,,Debit,,FLEMING,,2845650.0
,,03,,,Debit,,FLEMING,,2845653.0
,,12 03,,,Debit,,FLEMING,,2846856.0
,,12,,,Debit,,FLEMING,,2846868.0
,,"30,00",,,Debit,,FLEMING,,2849868.0
,,03,,,Debit,,FLEMING,,2849871.0
,,12 03,,,Debit,,FLEMING,,2851074.0
,,12,,,Debit,,FLEMING,,2851086.0
,,02,,,Debit,,FLEMING,,2851088.0
,,12,,,Debit,,FLEMING,,2851100.0
,,"30,00",,,Debit,,FLEMING,,2854100.0
,,03,,,Debit,,FLEMING,,2854103.0
,,12 03,,,Debit,,FLEMING,,2855306.0
,,12,,,Debit,,FLEMING,,2855318.0
,,"156,32",,,Debit,,FLEMING,,2870950.0
,,04,,,Debit,,FLEMING,,2870954.0
,,12 04,,,Debit,,FLEMING,,2872158.0
,,12,,,Debit,,FLEMING,,2872170.0
,,77,,,Debit,,FLEMING,,2872247.0
,,"12,00",,,Debit,,FLEMING,,2873447.0
,,1 06,,,Debit,,FLEMING,,2873553.0
,,12 06,,,Debit,,FLEMING,,2874759.0
,,12,,,Debit,,FLEMING,,2874771.0
,,"42,56",,,Debit,,FLEMING,,2879027.0
,,1,,,Debit,,FLEMING,,2879028.0
,,1,,,Debit,,FLEMING,,2879029.0
,,512,,,Debit,,FLEMING,,2879541.0
,,85,,,Debit,,FLEMING,,2879626.0
,,1,,,Debit,,FLEMING,,2879627.0
,,2,,,Debit,,FLEMING,,2879629.0
,,75,,,Debit,,FLEMING,,2879704.0
,,182 900 942,,,Debit,,FLEMING,,185780646.0
,,07,,,Debit,,FLEMING,,185780653.0
,,200,,,Debit,,FLEMING,,185780853.0
,,6,,,Debit,,FLEMING,,185780859.0
,,8,,,Debit,,FLEMING,,185780867.0
,,29,,,Debit,,Mensuel,Gi PhoooiC,29.0
,,02,,,Debit,,Mensuel,M2o4bee,31.0
,,20,,,Debit,,Mensuel,COURANT N,51.0
,,15,,,Debit,,Mensuel,Sune),66.0
,,2,,,Debit,,Mensuel,CB CARREFMARKETDAC FACT 070220,68.0
,,3,,,Debit,,Mensuel,PRLV,71.0
,,87,,,Debit,,Mensuel,N 0114688,158.0
,,10,,,Debit,,Mensuel,GASHI,168.0
,,02 10,,,Debit,,Mensuel,ReMZI,378.0
,,02,,,Debit,,Mensuel,ReMZI,380.0
,,10,,,Debit,,Mensuel,NMa,390.0
,,02 10,,,Debit,,Mensuel,GASHI,600.0
,,02,,,Debit,,Mensuel,ReMZI,602.0
,,11,,,Debit,,Mensuel,CB RELAIS,613.0
,,02 10,,,Debit,,Mensuel,N.0114688 M GASHI,823.0
,,02,,,Debit,,Mensuel,ReMZI,825.0
,,11,,,Debit,,Mensuel,Saner,836.0
,,02 11,,,Debit,,Mensuel,FACT 220220,1047.0
,,02,,,Debit,,Mensuel,ReMZI,1049.0
,,77,,,Debit,,Mensuel,N 0114688,1126.0
,,13,,,Debit,,Mensuel,SOLDE AU,1139.0
,,02 13,,,Debit,,Mensuel,Irancs,1352.0
,,02,,,Debit,,Mensuel,IBAN FR76,1354.0
,,17,,,Debit,,Mensuel,IBAN FR76,1371.0
,,02 17,,,Debit,,Mensuel,Paf,1588.0
,,02,,,Debit,,Mensuel,Penie,1590.0
,,17,,,Debit,,Mensuel,YoUf Cevez,1607.0
,,02 17,,,Debit,,Mensuel,Jeftef Yole,1824.0
,,02,,,Debit,,Mensuel,Concernant vou€ Cafte bancaire,1826.0
,,18,,,Debit,,Mensuel,Ccyci,1844.0
,,02 17,,,Debit,,Mensuel,ommungucr Je nmero,2061.0
,,02,,,Debit,,Mensuel,U,2063.0
,,14,,,Debit,,Mensuel,dppei Cune,2077.0
,,20,,,Debit,,Mensuel,ePyine,2097.0
,,02 20,,,Debit,,Mensuel,Qunneft Paf,2317.0
,,02,,,Debit,,Mensuel,QU B YoUs,2319.0
,,21,,,Debit,,Mensuel,TOhou,2340.0
,,02 21,,,Debit,,Mensuel,Encrge Yol Yous,2561.0
,,02,,,Debit,,Mensuel,Ctef JUC}PoybPefle,2563.0
,,22,,,Debit,,Mensuel,Ce Yos Moyen},2585.0
,,02 22,,,Debit,,Mensuel,Ce Puemeok,2807.0
,,02,,,Debit,,Mensuel,Uniiue,2809.0
,,24,,,Debit,,Mensuel,Umln,2833.0
,,02 24,,,Debit,,Mensuel,IBh Cereleve {er,3057.0
,,02,,,Debit,,Mensuel,conridert,3059.0
,,26,,,Debit,,Mensuel,Jppfolnve B,3085.0
,,02 26,,,Debit,,Mensuel,Jkufe,3311.0
,,02,,,Debit,,Mensuel,Beuant Canf vol€,3313.0
,,26,,,Debit,,Mensuel,Ct vof,3339.0
,,02 26,,,Debit,,Mensuel,OnUju,3565.0
,,02,,,Debit,,Mensuel,Ge Puemenr Jiooer,3567.0
,,27,,,Debit,,Mensuel,ainlormauon OU recamauon reljuye BPX,3594.0
,,02 27,,,Debit,,Mensuel,Produu,3821.0
,,02,,,Debit,,Mensuel,Jenyce} bancdire},3823.0
,,"66,00",,,Debit,,Mensuel,MLprc},10423.0
,,"85,00",,,Debit,,Mensuel,,18923.0
,,"24,90",,,Debit,,Mensuel,,21413.0
,,"5,50",,,Debit,,Mensuel,,21963.0
,,"55,07",,,Debit,,Mensuel,,27470.0
,,"88,80",,,Debit,,Mensuel,,36350.0
,,"2,80",,,Debit,,Mensuel,,36630.0
,,145 10,,,Debit,,Mensuel,,51140.0
,,"642,34",,,Debit,,Mensuel,,115374.0
,,"78,30",,,Debit,,Mensuel,,123204.0
,,"77,00",,,Debit,,Mensuel,,130904.0
,,"89,60",,,Debit,,Mensuel,,139864.0
,,"1,90",,,Debit,,Mensuel,,140054.0
,,"75,01",,,Debit,,Mensuel,,147555.0
,,"151,91",,,Debit,,Mensuel,,162746.0
,,"50,60",,,Debit,,Mensuel,,167806.0
,,29,,,Debit,,Mensuel,,167835.0
,,02,,,Debit,,Mensuel,,167837.0
,,20,,,Debit,,Mensuel,,167857.0
,,1 183 15,,,Debit,,Mensuel,,286172.0
,,"180,37",,,Debit,,Mensuel,,304209.0
,,751,,,Debit,,Mensuel,,304960.0
,,987,,,Debit,,Mensuel,,305947.0
,,751,,,Debit,,Mensuel,,306698.0
,,163,,,Debit,,Mensuel,,306861.0
,,4 08,,,Debit,,Mensuel,,307269.0
,,88,,,Debit,,Mensuel,,307357.0
,,6,,,Debit,,Mensuel,,307363.0
,,8,,,Debit,,Mensuel,,307371.0
,,8,,,Debit,,Mensuel,,307379.0
,,01,,,Debit,,Mensuel,,307380.0
,,4,,,Debit,,Mensuel,,307384.0
,,22,,,Debit,,Mensuel,,307406.0
,,88,,,Debit,,Mensuel,,307494.0
,,6,,,Debit,,Mensuel,,307500.0
,,8,,,Debit,,Mensuel,,307508.0
,,9,,,Debit,,Mensuel,,307517.0
,,08 88,,,Debit,,Mensuel,,308405.0
,,6 45,,,Debit,,Mensuel,,309050.0
,,48,,,Debit,,Mensuel,,309098.0
,,"0,15",,,Debit,,Mensuel,,309113.0
,,3,,,Debit,,Mensuel,,309116.0
,,1,,,Debit,,Mensuel,,309117.0
,,11,,,Credit,,Crédit du Nord,No 11,11.0
,,30 11,,,Credit,,Crédit du Nord,Paoe 1/,3022.0
,,1,,,Credit,,Crédit du Nord,MOISYLE,3023.0
,,42,,,Credit,,Crédit du Nord,GRAND Ter,3065.0
,,01 48,,,Credit,,Crédit du Nord,Vore ogence Quoumo,3213.0
,,15,,,Credit,,Crédit du Nord,Chns Laure BeRNET,3228.0
,,15 13,,,Credit,,Crédit du Nord,STALINGRAD Te,4741.0
,,65,,,Credit,,Crédit du Nord,Elode Drect,4806.0
,,01 55,,,Credit,,Crédit du Nord,Internet,4961.0
,,00,,,Credit,,Crédit du Nord,LE MARCHE DE TREMBLAY Date,4961.0
,,033,,,Credit,,Crédit du Nord,IBAN FR76,4994.0
,,"872,21",,,Credit,,Crédit du Nord,AT PREVOY,92215.0
,,"746,20",,,Credit,,Crédit du Nord,411 PAGPOIOOLECPL7 511,166835.0
,,"31,10",,,Credit,,Crédit du Nord,IvERSEMENT ESPECES,169945.0
,,411,,,Credit,,Crédit du Nord,VERDI 16687882,170356.0
,,"10,58",,,Credit,,Crédit du Nord,IvERSEMENT ESPECES,171414.0
,,26 11,,,Credit,,Crédit du Nord,N0,174025.0
,,411,,,Credit,,Crédit du Nord,N0,174436.0
,,"97,75",,,Credit,,Crédit du Nord,N0,184211.0
,,11 411,,,Credit,,Crédit du Nord,METROFRANCE,195622.0
,,0,,,Credit,,Crédit du Nord,PRelevement,195622.0
,,"168,84",,,Credit,,Crédit du Nord,N0,212506.0
,,11 41,,,Credit,,Crédit du Nord,C8 No,213647.0
,,"178,36",,,Credit,,Crédit du Nord,lutlisation,231483.0
,,411 411,,,Credit,,Crédit du Nord,VOls,642894.0
,,0,,,Credit,,Crédit du Nord,Linque,642894.0
,,411 411,,,Credit,,Crédit du Nord,boulevard Haussmann,1054305.0
,,"250,78",,,Credit,,Crédit du Nord,Pars ouparvoie clectroniaesulesteinternet,1079383.0
,,411,,,Credit,,Crédit du Nord,Qunadcon Le Mduteu rpadradans unalai,1079794.0
,,"312,67",,,Credit,,Crédit du Nord,Faccise feceptiond pise,1111061.0
,,411,,,Credit,,Crédit du Nord,Encasdeltoe,1111472.0
,,0,,,Credit,,Crédit du Nord,ddai,1111472.0
,,"393,77",,,Credit,,Crédit du Nord,ere prolonge,1150849.0
,,411 411,,,Credit,,Crédit du Nord,Medutur,1562260.0
,,0,,,Credit,,Crédit du Nord,Vous serezendroi dacccolrou reluserla pcoosmtion,1562260.0
,,"462,12",,,Credit,,Crédit du Nord,Mdiateur,1608472.0
,,411 411,,,Credit,,Crédit du Nord,J0jours 8,2019883.0
,,"9,99",,,Credit,,Crédit du Nord,quelekkdurunestpas,2020882.0
,,411,,,Credit,,Crédit du Nord,TvA,2021293.0
,,511,,,Credit,,Crédit du Nord,Jassanos Inftu @ORuS ousln,2021804.0
,,"900,00",,,Credit,,Crédit du Nord,,2111804.0
,,511 511,,,Credit,,Crédit du Nord,,2623315.0
,,"236,00",,,Credit,,Crédit du Nord,,2646915.0
,,511,,,Credit,,Crédit du Nord,,2647426.0
,,5 11,,,Credit,,Crédit du Nord,,2647937.0
,,"740,00",,,Credit,,Crédit du Nord,,2721937.0
,,531 511,,,Credit,,Crédit du Nord,,3253448.0
,,"760,00",,,Credit,,Crédit du Nord,,3329448.0
,,531,,,Credit,,Crédit du Nord,,3329979.0
,,5 11,,,Credit,,Crédit du Nord,,3330490.0
,,00 531,,,Credit,,Crédit du Nord,,3331021.0
,,5 11,,,Credit,,Crédit du Nord,,3331532.0
,,"127,33",,,Credit,,Crédit du Nord,,3344265.0
,,531 511,,,Credit,,Crédit du Nord,,3875776.0
,,"127,77",,,Credit,,Crédit du Nord,,3888553.0
,,51,,,Credit,,Crédit du Nord,,3888604.0
,,6 11,,,Credit,,Crédit du Nord,,3889215.0
,,"63,88",,,Credit,,Crédit du Nord,,3895603.0
,,6 11,,,Credit,,Crédit du Nord,,3896214.0
,,6 11,,,Credit,,Crédit du Nord,,3896825.0
,,"128,12",,,Credit,,Crédit du Nord,,3909637.0
,,6 11,,,Credit,,Crédit du Nord,,3910248.0
,,6 11,,,Credit,,Crédit du Nord,,3910859.0
,,919 28,,,Credit,,Crédit du Nord,,4002787.0
,,6 31,,,Credit,,Crédit du Nord,,4003418.0
,,711,,,Credit,,Crédit du Nord,,4004129.0
,,"145,53",,,Credit,,Crédit du Nord,,4018682.0
,,71 711,,,Credit,,Crédit du Nord,,4090393.0
,,711 711,,,Credit,,Crédit du Nord,,4802104.0
,,"651,18",,,Credit,,Crédit du Nord,,4867222.0
,,6 31,,,Credit,,Crédit du Nord,,4867853.0
,,8,,,Credit,,Crédit du Nord,,4867861.0
,,"159,90",,,Credit,,Crédit du Nord,,4883851.0
,,8 11,,,Credit,,Crédit du Nord,,4884662.0
,,59,,,Credit,,Crédit du Nord,,4884721.0
,,90,,,Credit,,Crédit du Nord,,4884811.0
,,0,,,Credit,,Crédit du Nord,,4884811.0
,,0,,,Credit,,Crédit du Nord,,4884811.0
,,8,,,Credit,,Crédit du Nord,,4884819.0
,,8,,,Credit,,Crédit du Nord,,4884827.0
,,890,,,Credit,,Crédit du Nord,,4885717.0
,,456 504 851,,,Credit,,Crédit du Nord,,461390568.0
,,456 504 851,,,Credit,,Crédit du Nord,,917895419.0
,,2,,,Credit,,Crédit du Nord,,917895421.0
,,12,,,Credit,,Crédit du Nord,Paoe 1/,12.0
,,31 12,,,Credit,,Crédit du Nord,MOISYLE,3124.0
,,1,,,Credit,,Crédit du Nord,GRAND Ter,3125.0
,,42,,,Credit,,Crédit du Nord,Vore ogence Quoumo vndcao,3167.0
,,01 48,,,Credit,,Crédit du Nord,Soha DAHLAB,3315.0
,,15,,,Credit,,Crédit du Nord,Elode Drect,3330.0
,,15 13,,,Credit,,Crédit du Nord,Internet,4843.0
,,65,,,Credit,,Crédit du Nord,LE MARCHE DE TREMBLAY Date,4908.0
,,15,,,Credit,,Crédit du Nord,IBAN FR76,4923.0
,,00,,,Credit,,Crédit du Nord,N0,4923.0
,,033,,,Credit,,Crédit du Nord,ReMISE,4956.0
,,"566,06",,,Credit,,Crédit du Nord,CB N0,61562.0
,,2 12,,,Credit,,Crédit du Nord,IPRLV,61774.0
,,"0,99",,,Credit,,Crédit du Nord,METROFRAICE,61873.0
,,212 212,,,Credit,,Crédit du Nord,METROFRAICE,274085.0
,,"174,10",,,Credit,,Crédit du Nord,PRelevement,291495.0
,,212,,,Credit,,Crédit du Nord,IpRElEVEMENT AT,291707.0
,,2 12,,,Credit,,Crédit du Nord,N0,291919.0
,,"260,39",,,Credit,,Crédit du Nord,PRElEVEMENT,317958.0
,,212 212,,,Credit,,Crédit du Nord,N0,530170.0
,,"318,67",,,Credit,,Crédit du Nord,Encas,562037.0
,,212,,,Credit,,Crédit du Nord,lutlisation,562249.0
,,2 12,,,Credit,,Crédit du Nord,VOls,562461.0
,,"368,73",,,Credit,,Crédit du Nord,Linque,599334.0
,,212 212,,,Credit,,Crédit du Nord,boulevard Haussmann,811546.0
,,0,,,Credit,,Crédit du Nord,Pars ouparvoie clectroniaesulesteinternet,811546.0
,,"392,93",,,Credit,,Crédit du Nord,Qunadcon Le Mduteu rpadradans unalai,850839.0
,,212 212,,,Credit,,Crédit du Nord,Faccise feceptiond pise,1063051.0
,,"411,58",,,Credit,,Crédit du Nord,Encasdeltoe,1104209.0
,,212,,,Credit,,Crédit du Nord,ddai,1104421.0
,,2 12,,,Credit,,Crédit du Nord,ere prolonge,1104633.0
,,"120,00",,,Credit,,Crédit du Nord,Medutur,1116633.0
,,212 212,,,Credit,,Crédit du Nord,Vous serezendroi dacccolrou reluserla pcoosmtion,1328845.0
,,"746,20",,,Credit,,Crédit du Nord,Mdiateur,1403465.0
,,3 12,,,Credit,,Crédit du Nord,J0jours 8,1403777.0
,,"101,93",,,Credit,,Crédit du Nord,quelekkdurunestpas,1413970.0
,,312,,,Credit,,Crédit du Nord,TvA,1414282.0
,,3 12,,,Credit,,Crédit du Nord,Jassanos Inftu @ORuS ousln,1414594.0
,,0,,,Credit,,Crédit du Nord,,1414594.0
,,"287,13",,,Credit,,Crédit du Nord,,1443307.0
,,312,,,Credit,,Crédit du Nord,,1443619.0
,,3 12,,,Credit,,Crédit du Nord,,1443931.0
,,312,,,Credit,,Crédit du Nord,,1444243.0
,,"4,12",,,Credit,,Crédit du Nord,,1444655.0
,,"10,58",,,Credit,,Crédit du Nord,,1445713.0
,,512,,,Credit,,Crédit du Nord,,1446225.0
,,4 12,,,Credit,,Crédit du Nord,,1446637.0
,,0,,,Credit,,Crédit du Nord,,1446637.0
,,"151,97",,,Credit,,Crédit du Nord,,1461834.0
,,412,,,Credit,,Crédit du Nord,,1462246.0
,,"4,12",,,Credit,,Crédit du Nord,,1462658.0
,,"168,84",,,Credit,,Crédit du Nord,,1479542.0
,,412 412,,,Credit,,Crédit du Nord,,1891954.0
,,"9,99",,,Credit,,Crédit du Nord,,1892953.0
,,412,,,Credit,,Crédit du Nord,,1893365.0
,,412,,,Credit,,Crédit du Nord,,1893777.0
,,"741,85",,,Credit,,Crédit du Nord,,1967962.0
,,412,,,Credit,,Crédit du Nord,,1968374.0
,,4 12,,,Credit,,Crédit du Nord,,1968786.0
,,29 312,,,Credit,,Crédit du Nord,,1998098.0
,,5 12,,,Credit,,Crédit du Nord,,1998610.0
,,"81,34",,,Credit,,Crédit du Nord,,2006744.0
,,512,,,Credit,,Crédit du Nord,,2007256.0
,,5 12,,,Credit,,Crédit du Nord,,2007768.0
,,"191,35",,,Credit,,Crédit du Nord,,2026903.0
,,512,,,Credit,,Crédit du Nord,,2027415.0
,,6 12,,,Credit,,Crédit du Nord,,2028027.0
,,0,,,Credit,,Crédit du Nord,,2028027.0
,,"111,55",,,Credit,,Crédit du Nord,,2039182.0
,,6 12,,,Credit,,Crédit du Nord,,2039794.0
,,6 12,,,Credit,,Crédit du Nord,,2040406.0
,,"171,06",,,Credit,,Crédit du Nord,,2057512.0
,,612,,,Credit,,Crédit du Nord,,2058124.0
,,9 12,,,Credit,,Crédit du Nord,,2059036.0
,,"256,03",,,Credit,,Crédit du Nord,,2084639.0
,,9 12,,,Credit,,Crédit du Nord,,2085551.0
,,59,,,Credit,,Crédit du Nord,,2085610.0
,,90,,,Credit,,Crédit du Nord,,2085700.0
,,0,,,Credit,,Crédit du Nord,,2085700.0
,,0,,,Credit,,Crédit du Nord,,2085700.0
,,8,,,Credit,,Crédit du Nord,,2085708.0
,,8,,,Credit,,Crédit du Nord,,2085716.0
,,890,,,Credit,,Crédit du Nord,,2086606.0
,,456 504 851,,,Credit,,Crédit du Nord,,458591457.0
,,456 504 851,,,Credit,,Crédit du Nord,,915096308.0
,,2,,,Credit,,Crédit du Nord,,915096310.0
28/02/2021,33,,33,,Unknown,,DENTREPRISE,SOCIETE GENERALE RELEVÉ DE COMPTE,-33.0
31/03/2021,28,,28,,Unknown,,DENTREPRISE,Page 1/8,-61.0
01/03/2020,02,,02,,Unknown,,DENTREPRISE,nternet,-63.0
,31,,31,,Unknown,,DENTREPRISE,prolessionnels socleteoencrale,-94.0
,03,,03,,Unknown,,DENTREPRISE,IAppli,-97.0
,3,,3,,Unknown,,DENTREPRISE,copel he &,-100.0
,1,,1,,Unknown,,DENTREPRISE,Votre agence,-101.0
,8,,8,,Unknown,,DENTREPRISE,ANNECY partelephone,-109.0
,0,,0,,Unknown,,DENTREPRISE,RUE ROYALE,-109.0
,04 50,,04 50,,Unknown,,DENTREPRISE,ANNECY,-559.0
,33 57,,33 57,,Unknown,,DENTREPRISE,Isabelle money@socoen com,-3916.0
,50,,50,,Unknown,,DENTREPRISE,opération SolDE,-3966.0
,04 50,,04 50,,Unknown,,DENTREPRISE,ReMISE,-4416.0
,10 90,,10 90,,Unknown,,DENTREPRISE,R35,-5506.0
,53,,53,,Unknown,,DENTREPRISE,COM,-5559.0
,98,,98,,Unknown,,DENTREPRISE,ReMISE,-5657.0
,04 50,,04 50,,Unknown,,DENTREPRISE,CoM 2 46e 01/032021,-6107.0
,33 57,,33 57,,Unknown,,DENTREPRISE,ReMISE,-9464.0
,2,,2,,Unknown,,DENTREPRISE,R63,-9466.0
,01,,01,,Unknown,,DENTREPRISE,CoM,-9467.0
,01,,01,,Unknown,,DENTREPRISE,ReMISE,-9468.0
,33,,33,,Unknown,,DENTREPRISE,CoM,-9501.0
,569,,569,,Unknown,,DENTREPRISE,ReMISE,-10070.0
,01,,01,,Unknown,,DENTREPRISE,"R65659 C13600,38501 BT 555",-10071.0
,01,,01,,Unknown,,DENTREPRISE,COM,-10072.0
,722,,722,,Unknown,,DENTREPRISE,ReMISE,-10794.0
,2,,2,,Unknown,,DENTREPRISE,"R65792 C13600,38501 BT",-10796.0
,01,,01,,Unknown,,DENTREPRISE,CoM 2,-10797.0
,01,,01,,Unknown,,DENTREPRISE,CARTE X2609,-10798.0
,78,,78,,Unknown,,DENTREPRISE,ThUSHYANTHAN DOUBLE,-10876.0
,736,,736,,Unknown,,DENTREPRISE,CoM 0 98E 02/032021 Q032021 ReMISE,-11612.0
,2,,2,,Unknown,,DENTREPRISE,CoM,-11614.0
,01,,01,,Unknown,,DENTREPRISE,ANUELLE CARTE,-11615.0
,01,,01,,Unknown,,DENTREPRISE,CIONS,-11616.0
,598,,598,,Unknown,,DENTREPRISE,TENUE DE CoMPTE AU,-12214.0
,01,,01,,Unknown,,DENTREPRISE,Cuito2 Depurs,-12215.0
,01,,01,,Unknown,,DENTREPRISE,tartt,-12216.0
,555,,555,,Unknown,,DENTREPRISE,Insatislaction OU,-12771.0
,01,,01,,Unknown,,DENTREPRISE,VOUs,-12772.0
,01,,01,,Unknown,,DENTREPRISE,Panis ceder18,-12773.0
,654,,654,,Unknown,,DENTREPRISE,Le Mediateurendemierrecours,-13427.0
,2,,2,,Unknown,,DENTREPRISE,Soaete Gencralendressantun,-13429.0
,01,,01,,Unknown,,DENTREPRISE,Le Aduleu,-13430.0
,01,,01,,Unknown,,DENTREPRISE,Sootte Gencrale,-13431.0
,26,,26,,Unknown,,DENTREPRISE,Valmny,-13457.0
,02,,02,,Unknown,,DENTREPRISE,Par L Deknse ceda 7 oupi,-13459.0
,02,,02,,Unknown,,DENTREPRISE,sie nlernet Qu,-13461.0
,01,,01,,Unknown,,DENTREPRISE,Ir LeMduleu,-13462.0
,2,,2,,Unknown,,DENTREPRISE,dosskf,-13464.0
,548,,548,,Unknown,,DENTREPRISE,So0,-14012.0
,35 567,,35 567,,Unknown,,DENTREPRISE,,-49579.0
,"13 719,61",,"13 719,61",,Unknown,,DENTREPRISE,,-1421540.0
,734,,734,,Unknown,,DENTREPRISE,,-1422274.0
,3 596,,3 596,,Unknown,,DENTREPRISE,,-1425870.0
,"73 554,01",,"73 554,01",,Unknown,,DENTREPRISE,,-8781271.0
,652 48,,652 48,,Unknown,,DENTREPRISE,,-8846519.0
,"73,10",,"73,10",,Unknown,,DENTREPRISE,,-8853829.0
,36,,36,,Unknown,,DENTREPRISE,,-8853865.0
,49 02,,49 02,,Unknown,,DENTREPRISE,,-8858767.0
,289,,289,,Unknown,,DENTREPRISE,,-8859056.0
,0,,0,,Unknown,,DENTREPRISE,,-8859056.0
,02,,02,,Unknown,,DENTREPRISE,,-8859058.0
,425,,425,,Unknown,,DENTREPRISE,,-8859483.0
,02,,02,,Unknown,,DENTREPRISE,,-8859485.0
,01,,01,,Unknown,,DENTREPRISE,,-8859486.0
,02,,02,,Unknown,,DENTREPRISE,,-8859488.0
,"38,73",,"38,73",,Unknown,,DENTREPRISE,,-8863361.0
,02,,02,,Unknown,,DENTREPRISE,,-8863363.0
,288,,288,,Unknown,,DENTREPRISE,,-8863651.0
,423,,423,,Unknown,,DENTREPRISE,,-8864074.0
,6 12,,6 12,,Unknown,,DENTREPRISE,,-8864686.0
,00,,00,,Unknown,,DENTREPRISE,,-8864686.0
,"38,73",,"38,73",,Unknown,,DENTREPRISE,,-8868559.0
,10,,10,,Unknown,,DENTREPRISE,,-8868569.0
,25,,25,,Unknown,,DENTREPRISE,,-8868594.0
,33,,33,,Unknown,,DENTREPRISE,,-8868627.0
,1 76,,1 76,,Unknown,,DENTREPRISE,,-8868803.0
,01,,01,,Unknown,,DENTREPRISE,,-8868804.0
,03,,03,,Unknown,,DENTREPRISE,,-8868807.0
,17,,17,,Unknown,,DENTREPRISE,,-8868824.0
,7,,7,,Unknown,,DENTREPRISE,,-8868831.0
,552,,552,,Unknown,,DENTREPRISE,,-8869383.0
,367,,367,,Unknown,,DENTREPRISE,,-8869750.0
,25,,25,,Unknown,,DENTREPRISE,,-8869775.0
,1,,1,,Unknown,,DENTREPRISE,,-8869776.0
01/08/2021,33,,33,,Unknown,,DENTREPRISE,SOCIETE GENERALE RELEVÉ DE COMPTE,-33.0
31/08/2021,01,,01,,Unknown,,DENTREPRISE,n'8,-34.0
28/08/2021,08,,08,,Unknown,,DENTREPRISE,Page 1/8 VOS CONTACTS Votre Banque,-42.0
31/07/2021,31,,31,,Unknown,,DENTREPRISE,nternet,-73.0
01/03/2020,08,,08,,Unknown,,DENTREPRISE,prolessionnels socleteoencrale,-81.0
,8,,8,,Unknown,,DENTREPRISE,IAppli,-89.0
,1,,1,,Unknown,,DENTREPRISE,execubon,-90.0
,8,,8,,Unknown,,DENTREPRISE,appelnon surtare,-98.0
,0,,0,,Unknown,,DENTREPRISE,ANNECY partelephone,-98.0
,04 50,,04 50,,Unknown,,DENTREPRISE,ax,-548.0
,33 57,,33 57,,Unknown,,DENTREPRISE,RUE ROYALE,-3905.0
,50,,50,,Unknown,,DENTREPRISE,Isabelle money@socoen com,-3955.0
,04 50,,04 50,,Unknown,,DENTREPRISE,P06 INFO CHEQUIER,-4405.0
,10 90,,10 90,,Unknown,,DENTREPRISE,ANNECY,-5495.0
,53,,53,,Unknown,,DENTREPRISE,RELEVÉ DES OPÉRATIONS,-5548.0
,98,,98,,Unknown,,DENTREPRISE,opération SolDE,-5646.0
,04 50,,04 50,,Unknown,,DENTREPRISE,"R3032 C13600,38501",-6096.0
,33 57,,33 57,,Unknown,,DENTREPRISE,CoM,-9453.0
,2,,2,,Unknown,,DENTREPRISE,S8e CoM,-9455.0
,28,,28,,Unknown,,DENTREPRISE,CoM,-9483.0
,08,,08,,Unknown,,DENTREPRISE,007 R3o9,-9491.0
,31,,31,,Unknown,,DENTREPRISE,"R47216 C13600,38501 BT 912 9E",-9522.0
,07,,07,,Unknown,,DENTREPRISE,CoM 3,-9529.0
,02,,02,,Unknown,,DENTREPRISE,"R48228 C13600,38501",-9531.0
,01,,01,,Unknown,,DENTREPRISE,"CoM 2,75E",-9532.0
,08,,08,,Unknown,,DENTREPRISE,CoM 0,-9540.0
,365,,365,,Unknown,,DENTREPRISE,BQ CEPACPT,-9905.0
,02,,02,,Unknown,,DENTREPRISE,ReMise,-9907.0
,01,,01,,Unknown,,DENTREPRISE,CEPAFRPPASO,-9908.0
,08,,08,,Unknown,,DENTREPRISE,PReLEVEMENT EUROPEEN 3012809104 DE,-9916.0
,813,,813,,Unknown,,DENTREPRISE,MADAT,-10729.0
,2,,2,,Unknown,,DENTREPRISE,Cuito2 Depurs,-10731.0
,02,,02,,Unknown,,DENTREPRISE,tartt,-10733.0
,007,,007,,Unknown,,DENTREPRISE,Insatislaction OU,-10740.0
,627,,627,,Unknown,,DENTREPRISE,VOUs,-11367.0
,2,,2,,Unknown,,DENTREPRISE,Pans ceder18 Tel,-11369.0
,02,,02,,Unknown,,DENTREPRISE,Le Mediateurendemierrecours,-11371.0
,007,,007,,Unknown,,DENTREPRISE,Soaete Gencralendressantun,-11378.0
,341,,341,,Unknown,,DENTREPRISE,Le Aeduleu aupesde,-11719.0
,02,,02,,Unknown,,DENTREPRISE,Deknse Ceda,-11721.0
,912,,912,,Unknown,,DENTREPRISE,sie nlernet Qu,-12633.0
,3,,3,,Unknown,,DENTREPRISE,WMW mneduleu,-12636.0
,02,,02,,Unknown,,DENTREPRISE,Ir LeMeduleu,-12638.0
,808,,808,,Unknown,,DENTREPRISE,dosskf,-13446.0
,2,,2,,Unknown,,DENTREPRISE,So0,-13448.0
,02,,02,,Unknown,,DENTREPRISE,,-13450.0
,45,,45,,Unknown,,DENTREPRISE,,-13495.0
,0,,0,,Unknown,,DENTREPRISE,,-13495.0
,02,,02,,Unknown,,DENTREPRISE,,-13497.0
,05 23,,05 23,,Unknown,,DENTREPRISE,,-14020.0
,02,,02,,Unknown,,DENTREPRISE,,-14022.0
,"2.681,27",,"2.681,27",,Unknown,,DENTREPRISE,,-14024.68127
,"364,01",,"364,01",,Unknown,,DENTREPRISE,,-50425.68127
,810 77,,810 77,,Unknown,,DENTREPRISE,,-131502.68127
,625,,625,,Unknown,,DENTREPRISE,,-132127.68127
,"6 310,28",,"6 310,28",,Unknown,,DENTREPRISE,,-763155.6812700001
,"909,45",,"909,45",,Unknown,,DENTREPRISE,,-854100.6812700001
,805 70,,805 70,,Unknown,,DENTREPRISE,,-934670.6812700001
,45 74,,45 74,,Unknown,,DENTREPRISE,,-939244.6812700001
,"6 480,00",,"6 480,00",,Unknown,,DENTREPRISE,,-1587244.68127
,68 40,,68 40,,Unknown,,DENTREPRISE,,-1594084.68127
,33,,33,,Unknown,,DENTREPRISE,,-1594117.68127
,1 76,,1 76,,Unknown,,DENTREPRISE,,-1594293.68127
,01,,01,,Unknown,,DENTREPRISE,,-1594294.68127
,03,,03,,Unknown,,DENTREPRISE,,-1594297.68127
,17,,17,,Unknown,,DENTREPRISE,,-1594314.68127
,7,,7,,Unknown,,DENTREPRISE,,-1594321.68127
,552,,552,,Unknown,,DENTREPRISE,,-1594873.68127
,367,,367,,Unknown,,DENTREPRISE,,-1595240.68127
,25,,25,,Unknown,,DENTREPRISE,,-1595265.68127
,1,,1,,Unknown,,DENTREPRISE,,-1595266.68127
01/09/2021,33,,33,,Cheque,,DENTREPRISE,SOCIETE GENERALE RELEVÉ DE COMPTE,-33.0
30/09/2021,01,,01,,Cheque,,DENTREPRISE,Page 1/8 VOS CONTACTS Votre Banque,-34.0
01/03/2020,09,,09,,Cheque,,DENTREPRISE,nternet,-43.0
,30,,30,,Cheque,,DENTREPRISE,prolessionnels socleteoencrale,-73.0
,09,,09,,Cheque,,DENTREPRISE,IAppli,-82.0
,9,,9,,Cheque,,DENTREPRISE,execubon,-91.0
,1,,1,,Cheque,,DENTREPRISE,appelnon surtare,-92.0
,8,,8,,Cheque,,DENTREPRISE,ANNECY partelephone,-100.0
,0,,0,,Cheque,,DENTREPRISE,ax,-100.0
,04 50,,04 50,,Cheque,,DENTREPRISE,RUE ROYALE,-550.0
,33 57,,33 57,,Cheque,,DENTREPRISE,Isabelle money@socoen com,-3907.0
,50,,50,,Cheque,,DENTREPRISE,opération SolDE,-3957.0
,04 50,,04 50,,Cheque,,DENTREPRISE,Alne CY Av De Geneve,-4407.0
,10 90,,10 90,,Cheque,,DENTREPRISE,ReMISE,-5497.0
,53,,53,,Cheque,,DENTREPRISE,ReMISE,-5550.0
,98,,98,,Cheque,,DENTREPRISE,"R85777 C13600,38501 BT 685 SE CoM",-5648.0
,04 50,,04 50,,Cheque,,DENTREPRISE,BQ CRLY CPT,-6098.0
,33 57,,33 57,,Cheque,,DENTREPRISE,DATE,-9455.0
,2,,2,,Cheque,,DENTREPRISE,CRLYFRPPXXX,-9457.0
,31,,31,,Cheque,,DENTREPRISE,CARTE,-9488.0
,01,,01,,Cheque,,DENTREPRISE,AREA,-9489.0
,01,,01,,Cheque,,DENTREPRISE,PRLVEUROPEEN,-9490.0
,01,,01,,Cheque,,DENTREPRISE,B28 6205321557 DE BimaTooCoNSEIL ID FR59Z,-9491.0
,01,,01,,Cheque,,DENTREPRISE,MotifNnecyseptembre,-9492.0
,01,,01,,Cheque,,DENTREPRISE,MARCHE MADAT AMARCHE21,-9493.0
,31,,31,,Cheque,,DENTREPRISE,Q092021 ReMISE,-9524.0
,08,,08,,Cheque,,DENTREPRISE,R00593 C13600438501,-9532.0
,965,,965,,Cheque,,DENTREPRISE,CoM,-10497.0
,6,,6,,Cheque,,DENTREPRISE,ChEQUE 202 Pnementchon 202 Débit Crédit,-10503.0
,01,,01,,Cheque,,DENTREPRISE,uito2 Depurs,-10504.0
,01,,01,,Cheque,,DENTREPRISE,tartt,-10505.0
,31,,31,,Cheque,,DENTREPRISE,Insatislaction OU,-10536.0
,08,,08,,Cheque,,DENTREPRISE,VOUs,-10544.0
,685,,685,,Cheque,,DENTREPRISE,Pans ceder18 Tel,-11229.0
,2,,2,,Cheque,,DENTREPRISE,Le Mediateurendemierrecours,-11231.0
,01,,01,,Cheque,,DENTREPRISE,Soaete Gencralendressantun,-11232.0
,01,,01,,Cheque,,DENTREPRISE,Le Aeduleu aupesde,-11233.0
,11 46,,11 46,,Cheque,,DENTREPRISE,Deknse Ceda,-12379.0
,01,,01,,Cheque,,DENTREPRISE,sie nlernet Qu,-12380.0
,205 01,,205 01,,Cheque,,DENTREPRISE,WMW mneduleu,-32881.0
,30,,30,,Cheque,,DENTREPRISE,Ir LeMeduleu,-32911.0
,08,,08,,Cheque,,DENTREPRISE,dosskf,-32919.0
,01,,01,,Cheque,,DENTREPRISE,So0,-32920.0
,01,,01,,Cheque,,DENTREPRISE,,-32921.0
,02,,02,,Cheque,,DENTREPRISE,,-32923.0
,01,,01,,Cheque,,DENTREPRISE,,-32924.0
,09,,09,,Cheque,,DENTREPRISE,,-32933.0
,496,,496,,Cheque,,DENTREPRISE,,-33429.0
,02,,02,,Cheque,,DENTREPRISE,,-33431.0
,3,,3,,Cheque,,DENTREPRISE,,-33434.0
,02,,02,,Cheque,,DENTREPRISE,,-33436.0
,01,,01,,Cheque,,DENTREPRISE,,-33437.0
,202,,202,,Cheque,,DENTREPRISE,,-33639.0
,202,,202,,Cheque,,DENTREPRISE,,-33841.0
,135,,135,,Cheque,,DENTREPRISE,,-33976.0
,92 850,,92 850,,Cheque,,DENTREPRISE,,-126826.0
,0 959,,0 959,,Cheque,,DENTREPRISE,,-127785.0
,0 683 10,,0 683 10,,Cheque,,DENTREPRISE,,-196095.0
,"915,96",,"915,96",,Cheque,,DENTREPRISE,,-287691.0
,"761,61",,"761,61",,Cheque,,DENTREPRISE,,-363852.0
,"4,40",,"4,40",,Cheque,,DENTREPRISE,,-364292.0
,"200,00",,"200,00",,Cheque,,DENTREPRISE,,-384292.0
,494,,494,,Cheque,,DENTREPRISE,,-384786.0
,76,,76,,Cheque,,DENTREPRISE,,-384862.0
,1,,1,,Cheque,,DENTREPRISE,,-384863.0
,14,,14,,Cheque,,DENTREPRISE,,-384877.0
,33,,33,,Cheque,,DENTREPRISE,,-384910.0
,1 76,,1 76,,Cheque,,DENTREPRISE,,-385086.0
,01,,01,,Cheque,,DENTREPRISE,,-385087.0
,03,,03,,Cheque,,DENTREPRISE,,-385090.0
,17,,17,,Cheque,,DENTREPRISE,,-385107.0
,7,,7,,Cheque,,DENTREPRISE,,-385114.0
,552,,552,,Cheque,,DENTREPRISE,,-385666.0
,367,,367,,Cheque,,DENTREPRISE,,-386033.0
,25,,25,,Cheque,,DENTREPRISE,,-386058.0
,1,,1,,Cheque,,DENTREPRISE,,-386059.0
01/12/2021,33,,33,,Cheque,,DENTREPRISE,SOCIETE GENERALE RELEVÉ DE COMPTE,-33.0
31/12/2021,01,,01,,Cheque,,DENTREPRISE,n'12 Page,-34.0
30/11/2021,12,,12,,Cheque,,DENTREPRISE,nternet,-46.0
01/12/2021,31,,31,,Cheque,,DENTREPRISE,prolessionnels socleteoencrale,-77.0
01/12/2021,12,,12,,Cheque,,DENTREPRISE,IAppli,-89.0
01/12/2021,12,,12,,Cheque,,DENTREPRISE,execubon,-101.0
01/12/2021,1,,1,,Cheque,,DENTREPRISE,appelnon surtare,-102.0
29/11/2021,9,,9,,Cheque,,DENTREPRISE,ANNECY partelephone,-111.0
01/03/2020,0,,0,,Cheque,,DENTREPRISE,ax,-111.0
,04 50,,04 50,,Cheque,,DENTREPRISE,RUE ROYALE,-561.0
,33 57,,33 57,,Cheque,,DENTREPRISE,Isabelle money@socoen com,-3918.0
,50,,50,,Cheque,,DENTREPRISE,opération SolDE,-3968.0
,04 50,,04 50,,Cheque,,DENTREPRISE,GAB,-4418.0
,10 90,,10 90,,Cheque,,DENTREPRISE,Alne CY Av De Geneve,-5508.0
,53,,53,,Cheque,,DENTREPRISE,"R99692 C13600,38501 BT 327",-5561.0
,98,,98,,Cheque,,DENTREPRISE,COM Me,-5659.0
,04 50,,04 50,,Cheque,,DENTREPRISE,"R99718 C13600,38501 BT 583 19E",-6109.0
,33 57,,33 57,,Cheque,,DENTREPRISE,CoM,-9466.0
,2,,2,,Cheque,,DENTREPRISE,POUR Eurodel,-9468.0
,30,,30,,Cheque,,DENTREPRISE,BQ,-9498.0
,11,,11,,Cheque,,DENTREPRISE,CMCI CPT 00020123901 DATE,-9509.0
,01,,01,,Cheque,,DENTREPRISE,INSTATANEEMiSNet,-9510.0
,01,,01,,Cheque,,DENTREPRISE,BQ CMCI CPT 00020123901 DATE,-9511.0
,01,,01,,Cheque,,DENTREPRISE,REMISE,-9512.0
,01,,01,,Cheque,,DENTREPRISE,Ref,-9513.0
,01,,01,,Cheque,,DENTREPRISE,MOTIF Facture,-9514.0
,0,,0,,Cheque,,DENTREPRISE,CMCIFRPPXXX,-9514.0
,11,,11,,Cheque,,DENTREPRISE,ChEQUE 194 01/122021/ 30/112021 ChEQUE 195,-9525.0
,327,,327,,Cheque,,DENTREPRISE,Remise C8,-9852.0
,01,,01,,Cheque,,DENTREPRISE,COM,-9853.0
,01,,01,,Cheque,,DENTREPRISE,"C13600,38501 BT 397",-9854.0
,0,,0,,Cheque,,DENTREPRISE,tartt,-9854.0
,11,,11,,Cheque,,DENTREPRISE,Insatislaction OU,-9865.0
,583,,583,,Cheque,,DENTREPRISE,VOUs,-10448.0
,01,,01,,Cheque,,DENTREPRISE,Panis ceder18,-10449.0
,01,,01,,Cheque,,DENTREPRISE,Le Mediateurendemierrecours,-10450.0
,01,,01,,Cheque,,DENTREPRISE,Soaete Gencralendressantun,-10451.0
,12,,12,,Cheque,,DENTREPRISE,Le Aeduleu aupesde,-10463.0
,12 19,,12 19,,Cheque,,DENTREPRISE,Deknse Ceda,-11682.0
,01,,01,,Cheque,,DENTREPRISE,sie nlernet Qu,-11683.0
,12,,12,,Cheque,,DENTREPRISE,WMW mneduleu,-11695.0
,01,,01,,Cheque,,DENTREPRISE,Ir LeMeduleu,-11696.0
,12,,12,,Cheque,,DENTREPRISE,dosskf,-11708.0
,01,,01,,Cheque,,DENTREPRISE,So0,-11709.0
,12,,12,,Cheque,,DENTREPRISE,,-11721.0
,12 20,,12 20,,Cheque,,DENTREPRISE,,-12941.0
,01,,01,,Cheque,,DENTREPRISE,,-12942.0
,29,,29,,Cheque,,DENTREPRISE,,-12971.0
,11,,11,,Cheque,,DENTREPRISE,,-12982.0
,194 01,,194 01,,Cheque,,DENTREPRISE,,-32383.0
,30,,30,,Cheque,,DENTREPRISE,,-32413.0
,195 02,,195 02,,Cheque,,DENTREPRISE,,-51915.0
,01,,01,,Cheque,,DENTREPRISE,,-51916.0
,12,,12,,Cheque,,DENTREPRISE,,-51928.0
,30,,30,,Cheque,,DENTREPRISE,,-51958.0
,02,,02,,Cheque,,DENTREPRISE,,-51960.0
,01,,01,,Cheque,,DENTREPRISE,,-51961.0
,12,,12,,Cheque,,DENTREPRISE,,-51973.0
,397,,397,,Cheque,,DENTREPRISE,,-52370.0
,"781,26",,"781,26",,Cheque,,DENTREPRISE,,-130496.0
,5 590,,5 590,,Cheque,,DENTREPRISE,,-136086.0
,0 326,,0 326,,Cheque,,DENTREPRISE,,-136412.0
,"5 581,21",,"5 581,21",,Cheque,,DENTREPRISE,,-694533.0
,"2 849,09",,"2 849,09",,Cheque,,DENTREPRISE,,-979442.0
,"2 221,07",,"2 221,07",,Cheque,,DENTREPRISE,,-1201549.0
,"1 122,60",,"1 122,60",,Cheque,,DENTREPRISE,,-1313809.0
,"536,08",,"536,08",,Cheque,,DENTREPRISE,,-1367417.0
,338,,338,,Cheque,,DENTREPRISE,,-1367755.0
,9 395 73,,9 395 73,,Cheque,,DENTREPRISE,,-2307328.0
,33,,33,,Cheque,,DENTREPRISE,,-2307361.0
,1 76,,1 76,,Cheque,,DENTREPRISE,,-2307537.0
,01,,01,,Cheque,,DENTREPRISE,,-2307538.0
,03,,03,,Cheque,,DENTREPRISE,,-2307541.0
,17,,17,,Cheque,,DENTREPRISE,,-2307558.0
,7,,7,,Cheque,,DENTREPRISE,,-2307565.0
,552,,552,,Cheque,,DENTREPRISE,,-2308117.0
,367,,367,,Cheque,,DENTREPRISE,,-2308484.0
,25,,25,,Cheque,,DENTREPRISE,,-2308509.0
,1,,1,,Cheque,,DENTREPRISE,,-2308510.0
01/01/2022,33,,33,,Cash,,DENTREPRISE,SOCIETE GENERALE RELEVÉ DE COMPTE,-33.0
31/01/2022,01,,01,,Cash,,DENTREPRISE,Page 1/9 VOS CONTACTS,-34.0
31/12/2021,01,,01,,Cash,,DENTREPRISE,nternet,-35.0
03/01/2022,31,,31,,Cash,,DENTREPRISE,prolessionnels socleteoencrale,-66.0
04/01/2022,01,,01,,Cash,,DENTREPRISE,IAppli,-67.0
01/03/2020,1,,1,,Cash,,DENTREPRISE,execubon,-68.0
,1,,1,,Cash,,DENTREPRISE,appelnon surtare,-69.0
,9,,9,,Cash,,DENTREPRISE,ANNECY partelephone,-78.0
,0,,0,,Cash,,DENTREPRISE,ax,-78.0
,04 50,,04 50,,Cash,,DENTREPRISE,RUE ROYALE,-528.0
,33 57,,33 57,,Cash,,DENTREPRISE,ANNECY,-3885.0
,50,,50,,Cash,,DENTREPRISE,Isabelle money@socoen com,-3935.0
,04 50,,04 50,,Cash,,DENTREPRISE,opération SolDE PREcEDEnT AU,-4385.0
,10 90,,10 90,,Cash,,DENTREPRISE,ReMISE,-5475.0
,53,,53,,Cash,,DENTREPRISE,CoM,-5528.0
,98,,98,,Cash,,DENTREPRISE,REMISE,-5626.0
,04 50,,04 50,,Cash,,DENTREPRISE,R13329,-6076.0
,33 57,,33 57,,Cash,,DENTREPRISE,CoM,-9433.0
,2,,2,,Cash,,DENTREPRISE,CoM 3,-9435.0
,31,,31,,Cash,,DENTREPRISE,ReMISE,-9466.0
,12,,12,,Cash,,DENTREPRISE,"R398o C13600,38501 BT",-9478.0
,03,,03,,Cash,,DENTREPRISE,M1ECoM 5,-9481.0
,777,,777,,Cash,,DENTREPRISE,ReMISE,-10258.0
,2,,2,,Cash,,DENTREPRISE,"0201 R62915 C13600,38501 BT 467 68E",-10260.0
,03,,03,,Cash,,DENTREPRISE,CoM,-10263.0
,745,,745,,Cash,,DENTREPRISE,ReMISE,-11008.0
,2,,2,,Cash,,DENTREPRISE,"R62920 C13600,38501 BT 689 05E",-11010.0
,03,,03,,Cash,,DENTREPRISE,CoM 2,-11013.0
,31,,31,,Cash,,DENTREPRISE,ReMISE,-11044.0
,12,,12,,Cash,,DENTREPRISE,"R96275 C13600,38501",-11056.0
,896,,896,,Cash,,DENTREPRISE,COM,-11952.0
,3,,3,,Cash,,DENTREPRISE,CARTE,-11955.0
,03,,03,,Cash,,DENTREPRISE,CHAM,-11958.0
,31,,31,,Cash,,DENTREPRISE,PRLVEUROPEEN,-11989.0
,12,,12,,Cash,,DENTREPRISE,B28 9204181210,-12001.0
,5,,5,,Cash,,DENTREPRISE,MoTIF SERVICE JANVIER REF,-12006.0
,03,,03,,Cash,,DENTREPRISE,MADAT AMARCHE21,-12009.0
,467,,467,,Cash,,DENTREPRISE,PRELEVEMENT EUROPEEN 9218847221 DE METRO CASH,-12476.0
,03,,03,,Cash,,DENTREPRISE,ID FR17ZZ7452888 MoTIF PRelevement REF 0101198076,-12479.0
,689,,689,,Cash,,DENTREPRISE,REMISE,-13168.0
,2 80,,2 80,,Cash,,DENTREPRISE,S0e COM,-13448.0
,03,,03,,Cash,,DENTREPRISE,C8 0301,-13451.0
,01,,01,,Cash,,DENTREPRISE,COM,-13452.0
,01,,01,,Cash,,DENTREPRISE,tartt,-13453.0
,03,,03,,Cash,,DENTREPRISE,Insatislaction OU,-13456.0
,01,,01,,Cash,,DENTREPRISE,VOUs,-13457.0
,03,,03,,Cash,,DENTREPRISE,Pans ceder18 Tel,-13460.0
,654 56,,654 56,,Cash,,DENTREPRISE,Le Mediateurendemierrecours graturement eten apolication deb Chale,-78916.0
,"775,31",,"775,31",,Cash,,DENTREPRISE,Tadresse,-156447.0
,742 74,,742 74,,Cash,,DENTREPRISE,Le Aduleu,-230721.0
,893,,893,,Cash,,DENTREPRISE,Sootte Gencrale,-231614.0
,8,,8,,Cash,,DENTREPRISE,Valmny,-231622.0
,"1 277,37",,"1 277,37",,Cash,,DENTREPRISE,Par L Deknse ceda 7 oupi,-359359.0
,466,,466,,Cash,,DENTREPRISE,sie nlernet Qu,-359825.0
,0 686,,0 686,,Cash,,DENTREPRISE,WMW mneduleu,-360511.0
,2 458 92,,2 458 92,,Cash,,DENTREPRISE,Ir LeMeduleu,-606403.0
,"30 200,00",,"30 200,00",,Cash,,DENTREPRISE,dosskf,-3626403.0
,"1 500,00",,"1 500,00",,Cash,,DENTREPRISE,So0,-3776403.0
,04,,04,,Cash,,DENTREPRISE,,-3776407.0
,01,,01,,Cash,,DENTREPRISE,,-3776408.0
,8,,8,,Cash,,DENTREPRISE,,-3776416.0
,0,,0,,Cash,,DENTREPRISE,,-3776416.0
,04,,04,,Cash,,DENTREPRISE,,-3776420.0
,476,,476,,Cash,,DENTREPRISE,,-3776896.0
,"8,47",,"8,47",,Cash,,DENTREPRISE,,-3777743.0
,474 56,,474 56,,Cash,,DENTREPRISE,,-3825199.0
,33,,33,,Cash,,DENTREPRISE,,-3825232.0
,1 76,,1 76,,Cash,,DENTREPRISE,,-3825408.0
,01,,01,,Cash,,DENTREPRISE,,-3825409.0
,03,,03,,Cash,,DENTREPRISE,,-3825412.0
,17,,17,,Cash,,DENTREPRISE,,-3825429.0
,7,,7,,Cash,,DENTREPRISE,,-3825436.0
,552,,552,,Cash,,DENTREPRISE,,-3825988.0
,367,,367,,Cash,,DENTREPRISE,,-3826355.0
,25,,25,,Cash,,DENTREPRISE,,-3826380.0
,1,,1,,Cash,,DENTREPRISE,,-3826381.0
29/11/2019,11,,11,,Credit,,Crédit,BANQUE POSTALE,-11.0
31/10/2019,1,,1,,Credit,,Crédit,Relevé,-12.0
,29,,29,,Credit,,Crédit,Vos Comptes 24h/24,-41.0
,2,,2,,Credit,,Crédit,BAnQUE PoSTalE,-43.0
,24,,24,,Credit,,Crédit,GRANDE,-67.0
,00,,00,,Credit,,Crédit,Y 033 IBAN,-67.0
,01 53,,01 53,,Credit,,Crédit,FR37,-220.0
,68 37,,68 37,,Credit,,Crédit,CREDIT CARTE BANCAIRE ReMISE,-7057.0
,37,,37,,Credit,,Crédit,CRedit CaRTE BanCAiRE,-7094.0
,9,,9,,Credit,,Crédit,CARTE BANCAIRE,-7103.0
,170,,170,,Credit,,Crédit,CRedit,-7273.0
,52 177 18,,52 177 18,,Credit,,Crédit,CARTE BANCAIRE ReMISE,-5224991.0
,033,,033,,Credit,,Crédit,CARTE BANCAIRE,-5225024.0
,342,,342,,Credit,,Crédit,COCCI,-5225366.0
,29,,29,,Credit,,Crédit,MARKEI,-5225395.0
,11,,11,,Credit,,Crédit,CREDIT CARTE BANCAIRE,-5225406.0
,"609,59",,"609,59",,Credit,,Crédit,OPe,-5286365.0
,0,,0,,Credit,,Crédit,CARTE BANCAIRE ReMISE,-5286365.0
,"69,33",,"69,33",,Credit,,Crédit,S,-5293298.0
,31,,31,,Credit,,Crédit,CARTE BANCAIRE,-5293329.0
,10,,10,,Credit,,Crédit,OPE,-5293339.0
,04,,04,,Credit,,Crédit,CARTE BANCAIRE,-5293343.0
,11,,11,,Credit,,Crédit,CARTE BANCAIRE,-5293354.0
,04,,04,,Credit,,Crédit,CARTE BANCAIRE,-5293358.0
,11,,11,,Credit,,Crédit,CARTE BANCAIRE,-5293369.0
,04,,04,,Credit,,Crédit,CARTE BANCAIRE,-5293373.0
,11,,11,,Credit,,Crédit,CARTE BANCAIRE,-5293384.0
,04,,04,,Credit,,Crédit,CARTE BANCAIRE,-5293388.0
,11,,11,,Credit,,Crédit,Page 1/4,-5293399.0
,2,,2,,Credit,,Crédit,,-5293401.0
,04,,04,,Credit,,Crédit,,-5293405.0
,11,,11,,Credit,,Crédit,,-5293416.0
,04,,04,,Credit,,Crédit,,-5293420.0
,11,,11,,Credit,,Crédit,,-5293431.0
,3,,3,,Credit,,Crédit,,-5293434.0
,04,,04,,Credit,,Crédit,,-5293438.0
,11,,11,,Credit,,Crédit,,-5293449.0
,04,,04,,Credit,,Crédit,,-5293453.0
,11,,11,,Credit,,Crédit,,-5293464.0
,04,,04,,Credit,,Crédit,,-5293468.0
,11,,11,,Credit,,Crédit,,-5293479.0
,04,,04,,Credit,,Crédit,,-5293483.0
,11,,11,,Credit,,Crédit,,-5293494.0
,04,,04,,Credit,,Crédit,,-5293498.0
,11,,11,,Credit,,Crédit,,-5293509.0
,04,,04,,Credit,,Crédit,,-5293513.0
,11,,11,,Credit,,Crédit,,-5293524.0
,04,,04,,Credit,,Crédit,,-5293528.0
,11,,11,,Credit,,Crédit,,-5293539.0
,2,,2,,Credit,,Crédit,,-5293541.0
,04,,04,,Credit,,Crédit,,-5293545.0
,11,,11,,Credit,,Crédit,,-5293556.0
,3,,3,,Credit,,Crédit,,-5293559.0
,04,,04,,Credit,,Crédit,,-5293563.0
,11,,11,,Credit,,Crédit,,-5293574.0
,04,,04,,Credit,,Crédit,,-5293578.0
,11,,11,,Credit,,Crédit,,-5293589.0
,04,,04,,Credit,,Crédit,,-5293593.0
,11,,11,,Credit,,Crédit,,-5293604.0
,"2,99",,"2,99",,Credit,,Crédit,,-5293903.0
,"3,21",,"3,21",,Credit,,Crédit,,-5294224.0
,"3,81",,"3,81",,Credit,,Crédit,,-5294605.0
,"8,06",,"8,06",,Credit,,Crédit,,-5295411.0
,"12,76",,"12,76",,Credit,,Crédit,,-5296687.0
,"19,87",,"19,87",,Credit,,Crédit,,-5298674.0
,"32,27",,"32,27",,Credit,,Crédit,,-5301901.0
,"32,45",,"32,45",,Credit,,Crédit,,-5305146.0
,"40,26",,"40,26",,Credit,,Crédit,,-5309172.0
,"0,05",,"0,05",,Credit,,Crédit,,-5309177.0
,"0,05",,"0,05",,Credit,,Crédit,,-5309182.0
,"0,05",,"0,05",,Credit,,Crédit,,-5309187.0
,"0,10",,"0,10",,Credit,,Crédit,,-5309197.0
,"0,15",,"0,15",,Credit,,Crédit,,-5309212.0
,"0,15",,"0,15",,Credit,,Crédit,,-5309227.0
,"0,25",,"0,25",,Credit,,Crédit,,-5309252.0
,"0,25",,"0,25",,Credit,,Crédit,,-5309277.0
,1,,1,,Credit,,Crédit,,-5309278.0
,4,,4,,Credit,,Crédit,,-5309282.0
31/12/2019,12,,12,,Virement,,Crédit,BANQUE POSTALE,-12.0
29/11/2019,30,,30,,Virement,,Crédit,Arrêté,-42.0
,31,,31,,Virement,,Crédit,Relevé,-73.0
,2,,2,,Virement,,Crédit,Vos Comptes 24h/24,-75.0
,24,,24,,Virement,,Crédit,BAnQUE PoSTalE,-99.0
,01 53,,01 53,,Virement,,Crédit,GRANDE,-252.0
,68 37,,68 37,,Virement,,Crédit,Y 033 IBAN,-7089.0
,37,,37,,Virement,,Crédit,FR37,-7126.0
,9,,9,,Virement,,Crédit,VIREMENT DE MONDIAL,-7135.0
,170,,170,,Virement,,Crédit,VSEA004071/98300000,-7305.0
,52 177 18,,52 177 18,,Virement,,Crédit,CRedit CaRTE BanCAiRE,-5225023.0
,033,,033,,Virement,,Crédit,CARTE BANCAIRE ReMISE,-5225056.0
,342,,342,,Virement,,Crédit,CRedit,-5225398.0
,31,,31,,Virement,,Crédit,CARTE BANCAIRE,-5225429.0
,12,,12,,Virement,,Crédit,DE7,-5225441.0
,"278,42",,"278,42",,Virement,,Crédit,CARTE BANCAIRE,-5253283.0
,0,,0,,Virement,,Crédit,CARTE BANCAIRE,-5253283.0
,"609,59",,"609,59",,Virement,,Crédit,CARTE BANCAIRE,-5314242.0
,29,,29,,Virement,,Crédit,Remise 030073,-5314271.0
,11,,11,,Virement,,Crédit,CARTE BANCAIRE,-5314282.0
,02,,02,,Virement,,Crédit,DEZ FA,-5314284.0
,12,,12,,Virement,,Crédit,CREDIT CARTE BANCAIRE,-5314296.0
,02,,02,,Virement,,Crédit,CARTE BANCAIRE,-5314298.0
,12,,12,,Virement,,Crédit,CARTE,-5314310.0
,02,,02,,Virement,,Crédit,CARTE BANCAIRE,-5314312.0
,12,,12,,Virement,,Crédit,S OPE,-5314324.0
,02,,02,,Virement,,Crédit,CARTE BANCAIRE,-5314326.0
,12,,12,,Virement,,Crédit,Ope CoccimaRket,-5314338.0
,4,,4,,Virement,,Crédit,CARTE BANCAIRE,-5314342.0
,02,,02,,Virement,,Crédit,FA CoCCI MARKET SevReS,-5314344.0
,12,,12,,Virement,,Crédit,,-5314356.0
,02,,02,,Virement,,Crédit,,-5314358.0
,12,,12,,Virement,,Crédit,,-5314370.0
,02,,02,,Virement,,Crédit,,-5314372.0
,12,,12,,Virement,,Crédit,,-5314384.0
,02,,02,,Virement,,Crédit,,-5314386.0
,12,,12,,Virement,,Crédit,,-5314398.0
,4,,4,,Virement,,Crédit,,-5314402.0
,02,,02,,Virement,,Crédit,,-5314404.0
,12,,12,,Virement,,Crédit,,-5314416.0
,02,,02,,Virement,,Crédit,,-5314418.0
,12,,12,,Virement,,Crédit,,-5314430.0
,04,,04,,Virement,,Crédit,,-5314434.0
,12,,12,,Virement,,Crédit,,-5314446.0
,2,,2,,Virement,,Crédit,,-5314448.0
,04,,04,,Virement,,Crédit,,-5314452.0
,12,,12,,Virement,,Crédit,,-5314464.0
,2,,2,,Virement,,Crédit,,-5314466.0
,04,,04,,Virement,,Crédit,,-5314470.0
,12,,12,,Virement,,Crédit,,-5314482.0
,2,,2,,Virement,,Crédit,,-5314484.0
,04,,04,,Virement,,Crédit,,-5314488.0
,12,,12,,Virement,,Crédit,,-5314500.0
,2,,2,,Virement,,Crédit,,-5314502.0
,05,,05,,Virement,,Crédit,,-5314507.0
,12,,12,,Virement,,Crédit,,-5314519.0
,05,,05,,Virement,,Crédit,,-5314524.0
,12,,12,,Virement,,Crédit,,-5314536.0
,2,,2,,Virement,,Crédit,,-5314538.0
,05,,05,,Virement,,Crédit,,-5314543.0
,12,,12,,Virement,,Crédit,,-5314555.0
,2,,2,,Virement,,Crédit,,-5314557.0
,"272,64",,"272,64",,Virement,,Crédit,,-5341821.0
,"2,30",,"2,30",,Virement,,Crédit,,-5342051.0
,"3,68",,"3,68",,Virement,,Crédit,,-5342419.0
,"12,14",,"12,14",,Virement,,Crédit,,-5343633.0
,"35,88",,"35,88",,Virement,,Crédit,,-5347221.0
,"0,05",,"0,05",,Virement,,Crédit,,-5347226.0
,"0,05",,"0,05",,Virement,,Crédit,,-5347231.0
,"0,35",,"0,35",,Virement,,Crédit,,-5347266.0
,609,,609,,Virement,,Crédit,,-5347875.0
,59,,59,,Virement,,Crédit,,-5347934.0
,"8,00",,"8,00",,Virement,,Crédit,,-5348734.0
,"0,10",,"0,10",,Virement,,Crédit,,-5348744.0
,"0,10",,"0,10",,Virement,,Crédit,,-5348754.0
,"23,48",,"23,48",,Virement,,Crédit,,-5351102.0
,"28,10",,"28,10",,Virement,,Crédit,,-5353912.0
,"0,14",,"0,14",,Virement,,Crédit,,-5353926.0
,1,,1,,Virement,,Crédit,,-5353927.0
,2,,2,,Virement,,Crédit,,-5353929.0
,20,,20,,Virement,,Crédit,,-5353949.0
07.10.2019,,010,,,Cheque,,S.A,Paris,10.0
,,05,,,Cheque,,S.A,Bun Oua,15.0
,,91,,,Cheque,,S.A,Votre conseiller Sebastien Hippias,106.0
,,01 42,,,Cheque,,S.A,THIBIYA,248.0
,,85,,,Cheque,,S.A,SUPERMARKET,333.0
,,01 42,,,Cheque,,S.A,BOULEVARD SAINT,475.0
,,85 71,,,Cheque,,S.A,Internet,9046.0
,,34,,,Cheque,,S.A,S.as,9080.0
,,01 42,,,Cheque,,S.A,Thibiya Supermarket,9222.0
,,85 71,,,Cheque,,S.A,S.a.s,17793.0
,,41,,,Cheque,,S.A,Thibiya Supermarket,17834.0
,,29,,,Cheque,,S.A,FR76,17863.0
,,1,,,Cheque,,S.A,BIc,17864.0
,,09 69,,,Cheque,,S.A,Libelle,18833.0
,,39 92,,,Cheque,,S.A,Remise,22825.0
,,91,,,Cheque,,S.A,Remise,22916.0
,,2,,,Cheque,,S.A,Cheque,22918.0
,,"421,40",,,Cheque,,S.A,Com Carte 223639401,65058.0
,,002,,,Cheque,,S.A,Com,65060.0
,,632,,,Cheque,,S.A,Remise,65692.0
,,07.10,,,Cheque,,S.A,Remise,65699.1
,,07.10,,,Cheque,,S.A,Virement Blocage,65706.20000000001
,,07.10,,,Cheque,,S.A,Com Carte 223639401 3721864,65713.30000000002
,,08.10,,,Cheque,,S.A,Com,65721.40000000002
,,08.10,,,Cheque,,S.A,Frais,65729.50000000003
,,07,,,Cheque,,S.A,10.10 10.10 Prlv AXA,65736.50000000003
,,10 08,,,Cheque,,S.A,CONTRATOOOOO1043754320400Ax000000000013163092 FRI4ZZZ391832,66744.50000000003
,,10 08,,,Cheque,,S.A,Com Carte 223639401,67752.50000000003
,,10,,,Cheque,,S.A,Com Carte 223639301,67762.50000000003
,,07,,,Cheque,,S.A,CA Ile-De-France26,67769.50000000003
,,10 08,,,Cheque,,S.A,Qual De La Rapee,68777.50000000003
,,10 08,,,Cheque,,S.A,RCS PARIS,69785.50000000003
,,10,,,Cheque,,S.A,,69795.50000000003
,,08.10,,,Cheque,,S.A,,69803.60000000003
,,08.10,,,Cheque,,S.A,,69811.70000000004
,,07,,,Cheque,,S.A,,69818.70000000004
,,10 08,,,Cheque,,S.A,,70826.70000000004
,,10 08,,,Cheque,,S.A,,71834.70000000004
,,10,,,Cheque,,S.A,,71844.70000000004
,,07,,,Cheque,,S.A,,71851.70000000004
,,10 09,,,Cheque,,S.A,,72860.70000000004
,,10 09,,,Cheque,,S.A,,73869.70000000004
,,10,,,Cheque,,S.A,,73879.70000000004
,,08,,,Cheque,,S.A,,73887.70000000004
,,10 09,,,Cheque,,S.A,,74896.70000000004
,,10 09,,,Cheque,,S.A,,75905.70000000004
,,10,,,Cheque,,S.A,,75915.70000000004
,,08,,,Cheque,,S.A,,75923.70000000004
,,10 09,,,Cheque,,S.A,,76932.70000000004
,,10 09,,,Cheque,,S.A,,77941.70000000004
,,10,,,Cheque,,S.A,,77951.70000000004
,,09.10,,,Cheque,,S.A,,77960.80000000005
,,09.10,,,Cheque,,S.A,,77969.90000000005
,,08,,,Cheque,,S.A,,77977.90000000005
,,10 09,,,Cheque,,S.A,,78986.90000000005
,,10 09,,,Cheque,,S.A,,79995.90000000005
,,10,,,Cheque,,S.A,,80005.90000000005
,,08,,,Cheque,,S.A,,80013.90000000005
,,10 09,,,Cheque,,S.A,,81022.90000000005
,,10 09,,,Cheque,,S.A,,82031.90000000005
,,10,,,Cheque,,S.A,,82041.90000000005
,,10.10,,,Cheque,,S.A,,82052.00000000006
,,10.10,,,Cheque,,S.A,,82062.10000000006
,,09,,,Cheque,,S.A,,82071.10000000006
,,10 10,,,Cheque,,S.A,,83081.10000000006
,,10 10,,,Cheque,,S.A,,84091.10000000006
,,10,,,Cheque,,S.A,,84101.10000000006
,,09,,,Cheque,,S.A,,84110.10000000006
,,10 10,,,Cheque,,S.A,,85120.10000000006
,,10 10,,,Cheque,,S.A,,86130.10000000006
,,10,,,Cheque,,S.A,,86140.10000000006
,,10.10,,,Cheque,,S.A,,86150.20000000007
,,10.10,,,Cheque,,S.A,,86160.30000000008
,,09,,,Cheque,,S.A,,86169.30000000008
,,10 10,,,Cheque,,S.A,,87179.30000000008
,,10 10,,,Cheque,,S.A,,88189.30000000008
,,10,,,Cheque,,S.A,,88199.30000000008
,,09,,,Cheque,,S.A,,88208.30000000008
,,10 11,,,Cheque,,S.A,,89219.30000000008
,,10 11,,,Cheque,,S.A,,90230.30000000008
,,10,,,Cheque,,S.A,,90240.30000000008
,,10,,,Cheque,,S.A,,90250.30000000008
,,10 11,,,Cheque,,S.A,,91261.30000000008
,,10 11,,,Cheque,,S.A,,92272.30000000008
,,10,,,Cheque,,S.A,,92282.30000000008
,,10,,,Cheque,,S.A,,92292.30000000008
,,10 11,,,Cheque,,S.A,,93303.30000000008
,,10 11,,,Cheque,,S.A,,94314.30000000008
,,10,,,Cheque,,S.A,,94324.30000000008
,,10,,,Cheque,,S.A,,94334.30000000008
,,10 11,,,Cheque,,S.A,,95345.30000000008
,,10 11,,,Cheque,,S.A,,96356.30000000008
,,10,,,Cheque,,S.A,,96366.30000000008
,,10,,,Cheque,,S.A,,96376.30000000008
,,10,,,Cheque,,S.A,,96386.30000000008
,,"3 234,26",,,Cheque,,S.A,,419812.30000000005
,,"12,00",,,Cheque,,S.A,,421012.30000000005
,,"73,20",,,Cheque,,S.A,,428332.30000000005
,,100 20,,,Cheque,,S.A,,438352.30000000005
,,"465,60",,,Cheque,,S.A,,484912.30000000005
,,"0,85",,,Cheque,,S.A,,484997.30000000005
,,"0,37",,,Cheque,,S.A,,485034.30000000005
,,"126,40",,,Cheque,,S.A,,497674.30000000005
,,158 40,,,Cheque,,S.A,,513514.30000000005
,,802 12,,,Cheque,,S.A,,593726.3
,,"0,96",,,Cheque,,S.A,,593822.3
,,"3,08",,,Cheque,,S.A,,594130.3
,,81.00,,,Cheque,,S.A,,594211.3
,,"130,90",,,Cheque,,S.A,,607301.3
,,58 70,,,Cheque,,S.A,,613171.3
,,48 04,,,Cheque,,S.A,,617975.3
,,0 21,,,Cheque,,S.A,,617996.3
,,0 47,,,Cheque,,S.A,,618043.3
,,141 00,,,Cheque,,S.A,,632143.3
,,"114,60",,,Cheque,,S.A,,643603.3
,,"0,63",,,Cheque,,S.A,,643666.3
,,0 50,,,Cheque,,S.A,,643716.3
,,1,,,Cheque,,S.A,,643717.3
,,4,,,Cheque,,S.A,,643721.3
,,775 665 615,,,Cheque,,S.A,,776309336.3
05.11.2019,,011,,,Debit,,S.A,Paris,11.0
,,05,,,Debit,,S.A,We,16.0
,,91,,,Debit,,S.A,Votre conseiller Sebastien Hippias,107.0
,,01 42,,,Debit,,S.A,THIBIYA,249.0
,,85,,,Debit,,S.A,SUPERMARKET,334.0
,,01 42,,,Debit,,S.A,BOULEVARD SAINT,476.0
,,85 71,,,Debit,,S.A,Internet,9047.0
,,34,,,Debit,,S.A,S.as,9081.0
,,01 42,,,Debit,,S.A,Thibiya Supermarket,9223.0
,,85 71,,,Debit,,S.A,S.a.s,17794.0
,,41,,,Debit,,S.A,FR76,17835.0
,,29,,,Debit,,S.A,BIc,17864.0
,,1,,,Debit,,S.A,Libelle,17865.0
,,09 69,,,Debit,,S.A,Remise,18834.0
,,39 92,,,Debit,,S.A,Remise,22826.0
,,91,,,Debit,,S.A,Com Carte 223639401,22917.0
,,2,,,Debit,,S.A,Com,22919.0
,,1 092.81,,,Debit,,S.A,Prlv Comm Interventio,24011.81
,,002,,,Debit,,S.A,Carte Metro,24013.81
,,632,,,Debit,,S.A,Remise,24645.81
,,05.11,,,Debit,,S.A,Remise Carte 223639301,24650.920000000002
,,06.11,,,Debit,,S.A,Com,24657.030000000002
,,06.11,,,Debit,,S.A,Com Carte 223639401,24663.140000000003
,,05,,,Debit,,S.A,Frais,24668.140000000003
,,11 06,,,Debit,,S.A,Remise,25774.140000000003
,,41 06,,,Debit,,S.A,Remise,29880.140000000003
,,41,,,Debit,,S.A,Com Carte 223639401,29921.140000000003
,,05,,,Debit,,S.A,Com Carte 223639401,29926.140000000003
,,11 06,,,Debit,,S.A,Page 1,31032.140000000003
,,11 06,,,Debit,,S.A,CA Ile-De-France26,32138.140000000003
,,11,,,Debit,,S.A,Qual De La Rapee,32149.140000000003
,,05,,,Debit,,S.A,RCS PARIS,32154.140000000003
,,11 06,,,Debit,,S.A,,33260.14
,,41 06,,,Debit,,S.A,,37366.14
,,41,,,Debit,,S.A,,37407.14
,,05,,,Debit,,S.A,,37412.14
,,11,,,Debit,,S.A,,37423.14
,,12.11,,,Debit,,S.A,,37435.25
,,09,,,Debit,,S.A,,37444.25
,,11 12,,,Debit,,S.A,,38556.25
,,11,,,Debit,,S.A,,38567.25
,,07,,,Debit,,S.A,,38574.25
,,11 14,,,Debit,,S.A,,39688.25
,,11 14,,,Debit,,S.A,,40802.25
,,11,,,Debit,,S.A,,40813.25
,,13,,,Debit,,S.A,,40826.25
,,11,,,Debit,,S.A,,40837.25
,,13,,,Debit,,S.A,,40850.25
,,11 14,,,Debit,,S.A,,41964.25
,,11 14,,,Debit,,S.A,,43078.25
,,11,,,Debit,,S.A,,43089.25
,,07,,,Debit,,S.A,,43096.25
,,11 14,,,Debit,,S.A,,44210.25
,,11,,,Debit,,S.A,,44221.25
,,14,,,Debit,,S.A,,44235.25
,,11,,,Debit,,S.A,,44246.25
,,14,,,Debit,,S.A,,44260.25
,,11 15,,,Debit,,S.A,,45375.25
,,11 15,,,Debit,,S.A,,46490.25
,,11,,,Debit,,S.A,,46501.25
,,14,,,Debit,,S.A,,46515.25
,,11,,,Debit,,S.A,,46526.25
,,14,,,Debit,,S.A,,46540.25
,,11 16,,,Debit,,S.A,,47656.25
,,11 18,,,Debit,,S.A,,48774.25
,,11,,,Debit,,S.A,,48785.25
,,15,,,Debit,,S.A,,48800.25
,,11 16,,,Debit,,S.A,,49916.25
,,11 18,,,Debit,,S.A,,51034.25
,,11,,,Debit,,S.A,,51045.25
,,15,,,Debit,,S.A,,51060.25
,,11 16,,,Debit,,S.A,,52176.25
,,11 18,,,Debit,,S.A,,53294.25
,,11,,,Debit,,S.A,,53305.25
,,15,,,Debit,,S.A,,53320.25
,,"11 421,40",,,Debit,,S.A,,1195460.25
,,"12,00",,,Debit,,S.A,,1196660.25
,,"90,96",,,Debit,,S.A,,1205756.25
,,68 40,,,Debit,,S.A,,1212596.25
,,0 26,,,Debit,,S.A,,1212622.25
,,"0,38",,,Debit,,S.A,,1212660.25
,,"400 179,04",,,Debit,,S.A,,41230564.25
,,48,,,Debit,,S.A,,41230612.25
,,04 48,,,Debit,,S.A,,41231060.25
,,"04 654,62",,,Debit,,S.A,,41696522.25
,,"698,16",,,Debit,,S.A,,41766338.25
,,"3,38",,,Debit,,S.A,,41766676.25
,,"2,36",,,Debit,,S.A,,41766912.25
,,"16,00",,,Debit,,S.A,,41768512.25
,,"36,80",,,Debit,,S.A,,41772192.25
,,"175,00",,,Debit,,S.A,,41789692.25
,,"0,16",,,Debit,,S.A,,41789708.25
,,"1,46",,,Debit,,S.A,,41789854.25
,,"155,60",,,Debit,,S.A,,41805414.25
,,"10,60",,,Debit,,S.A,,41806474.25
,,"0,64",,,Debit,,S.A,,41806538.25
,,1,,,Debit,,S.A,,41806539.25
,,4,,,Debit,,S.A,,41806543.25
,,775 665 615,,,Debit,,S.A,,817472158.25
06/09/2021,40,,40,,Unknown,,EPI SERVICE PRIMEUR,Titulaire(s,-40.0
06/09/2021,9,,9,,Unknown,,EPI SERVICE PRIMEUR,Date Date de Valeur,-49.0
06/09/2021,9,,9,,Unknown,,EPI SERVICE PRIMEUR,TPV,-58.0
06/09/2021,10,,10,,Unknown,,EPI SERVICE PRIMEUR,STICHTING CUSTODIAN UBER PAY 06/09/2021,-68.0
06/09/2021,06,,06,,Unknown,,EPI SERVICE PRIMEUR,UBER PAY 06/09/2021,-74.0
06/09/2021,09 06,,09 06,,Unknown,,EPI SERVICE PRIMEUR,COM,-980.0
06/09/2021,09 06,,09 06,,Unknown,,EPI SERVICE PRIMEUR,CARTES,-1886.0
06/09/2021,09 06,,09 06,,Unknown,,EPI SERVICE PRIMEUR,COM,-2792.0
06/09/2021,09 06,,09 06,,Unknown,,EPI SERVICE PRIMEUR,CARTES,-3698.0
05/09/2021,09 06,,09 06,,Unknown,,EPI SERVICE PRIMEUR,COM,-4604.0
05/09/2021,09 06,,09 06,,Unknown,,EPI SERVICE PRIMEUR,CARTES 0386405,-5510.0
05/09/2021,09 06,,09 06,,Unknown,,EPI SERVICE PRIMEUR,COM,-6416.0
05/09/2021,09 06,,09 06,,Unknown,,EPI SERVICE PRIMEUR,CARTES,-7322.0
05/09/2021,09 06,,09 06,,Unknown,,EPI SERVICE PRIMEUR,COM,-8228.0
05/09/2021,09 06,,09 06,,Unknown,,EPI SERVICE PRIMEUR,CARTES,-9134.0
06/09/2021,09 06,,09 06,,Unknown,,EPI SERVICE PRIMEUR,COM,-10040.0
06/09/2021,09 06,,09 06,,Unknown,,EPI SERVICE PRIMEUR,CARTES,-10946.0
06/09/2021,09 06,,09 06,,Unknown,,EPI SERVICE PRIMEUR,COM,-11852.0
06/09/2021,09 06,,09 06,,Unknown,,EPI SERVICE PRIMEUR,CARTES 0386405 64,-12758.0
06/09/2021,09 06,,09 06,,Unknown,,EPI SERVICE PRIMEUR,COM,-13664.0
06/09/2021,09 06,,09 06,,Unknown,,EPI SERVICE PRIMEUR,CARTES,-14570.0
07/09/2021,09 06,,09 06,,Unknown,,EPI SERVICE PRIMEUR,COM,-15476.0
06/09/2021,09,,09,,Unknown,,EPI SERVICE PRIMEUR,CARTES,-15485.0
06/09/2021,06,,06,,Unknown,,EPI SERVICE PRIMEUR,COM,-15491.0
07/09/2021,09,,09,,Unknown,,EPI SERVICE PRIMEUR,CARTES,-15500.0
07/09/2021,06,,06,,Unknown,,EPI SERVICE PRIMEUR,COM,-15506.0
07/09/2021,09,,09,,Unknown,,EPI SERVICE PRIMEUR,CARTES 0386405 64 0309,-15515.0
07/09/2021,06,,06,,Unknown,,EPI SERVICE PRIMEUR,COM,-15521.0
07/09/2021,09,,09,,Unknown,,EPI SERVICE PRIMEUR,CARTES,-15530.0
07/09/2021,64,,64,,Unknown,,EPI SERVICE PRIMEUR,EDF EPI SERVICE,-15594.0
07/09/2021,06,,06,,Unknown,,EPI SERVICE PRIMEUR,TPV,-15600.0
07/09/2021,09,,09,,Unknown,,EPI SERVICE PRIMEUR,TPV,-15609.0
07/09/2021,01,,01,,Unknown,,EPI SERVICE PRIMEUR,TPV,-15610.0
07/09/2021,06,,06,,Unknown,,EPI SERVICE PRIMEUR,CARTE,-15616.0
07/09/2021,09,,09,,Unknown,,EPI SERVICE PRIMEUR,PEAGE AUTOROUTE,-15625.0
,64,,64,,Unknown,,EPI SERVICE PRIMEUR,CARTE,-15689.0
,06,,06,,Unknown,,EPI SERVICE PRIMEUR,CARTE,-15695.0
,09,,09,,Unknown,,EPI SERVICE PRIMEUR,COM,-15704.0
,01,,01,,Unknown,,EPI SERVICE PRIMEUR,CARTES,-15705.0
,06,,06,,Unknown,,EPI SERVICE PRIMEUR,COM,-15711.0
,09,,09,,Unknown,,EPI SERVICE PRIMEUR,CARTES,-15720.0
,64,,64,,Unknown,,EPI SERVICE PRIMEUR,COM,-15784.0
,06,,06,,Unknown,,EPI SERVICE PRIMEUR,COM,-15790.0
,09,,09,,Unknown,,EPI SERVICE PRIMEUR,CARTES,-15799.0
,01,,01,,Unknown,,EPI SERVICE PRIMEUR,COM,-15800.0
,05,,05,,Unknown,,EPI SERVICE PRIMEUR,CARTES,-15805.0
,09,,09,,Unknown,,EPI SERVICE PRIMEUR,COM,-15814.0
,64,,64,,Unknown,,EPI SERVICE PRIMEUR,CARTES,-15878.0
,05,,05,,Unknown,,EPI SERVICE PRIMEUR,COM,-15883.0
,09,,09,,Unknown,,EPI SERVICE PRIMEUR,CARTES,-15892.0
,01,,01,,Unknown,,EPI SERVICE PRIMEUR,,-15893.0
,05,,05,,Unknown,,EPI SERVICE PRIMEUR,,-15898.0
,09,,09,,Unknown,,EPI SERVICE PRIMEUR,,-15907.0
,64,,64,,Unknown,,EPI SERVICE PRIMEUR,,-15971.0
,05,,05,,Unknown,,EPI SERVICE PRIMEUR,,-15976.0
,09,,09,,Unknown,,EPI SERVICE PRIMEUR,,-15985.0
,01,,01,,Unknown,,EPI SERVICE PRIMEUR,,-15986.0
,05,,05,,Unknown,,EPI SERVICE PRIMEUR,,-15991.0
,09,,09,,Unknown,,EPI SERVICE PRIMEUR,,-16000.0
,64,,64,,Unknown,,EPI SERVICE PRIMEUR,,-16064.0
,05,,05,,Unknown,,EPI SERVICE PRIMEUR,,-16069.0
,09,,09,,Unknown,,EPI SERVICE PRIMEUR,,-16078.0
,01,,01,,Unknown,,EPI SERVICE PRIMEUR,,-16079.0
,06,,06,,Unknown,,EPI SERVICE PRIMEUR,,-16085.0
,09,,09,,Unknown,,EPI SERVICE PRIMEUR,,-16094.0
,06,,06,,Unknown,,EPI SERVICE PRIMEUR,,-16100.0
,09,,09,,Unknown,,EPI SERVICE PRIMEUR,,-16109.0
,09,,09,,Unknown,,EPI SERVICE PRIMEUR,,-16118.0
,06,,06,,Unknown,,EPI SERVICE PRIMEUR,,-16124.0
,2,,2,,Unknown,,EPI SERVICE PRIMEUR,,-16126.0
,992 06,,992 06,,Unknown,,EPI SERVICE PRIMEUR,,-115332.0
,09,,09,,Unknown,,EPI SERVICE PRIMEUR,,-115341.0
,06,,06,,Unknown,,EPI SERVICE PRIMEUR,,-115347.0
,09,,09,,Unknown,,EPI SERVICE PRIMEUR,,-115356.0
,06,,06,,Unknown,,EPI SERVICE PRIMEUR,,-115362.0
,09,,09,,Unknown,,EPI SERVICE PRIMEUR,,-115371.0
,06,,06,,Unknown,,EPI SERVICE PRIMEUR,,-115377.0
,09,,09,,Unknown,,EPI SERVICE PRIMEUR,,-115386.0
,07,,07,,Unknown,,EPI SERVICE PRIMEUR,,-115393.0
,09,,09,,Unknown,,EPI SERVICE PRIMEUR,,-115402.0
,06,,06,,Unknown,,EPI SERVICE PRIMEUR,,-115408.0
,09,,09,,Unknown,,EPI SERVICE PRIMEUR,,-115417.0
,06,,06,,Unknown,,EPI SERVICE PRIMEUR,,-115423.0
,09,,09,,Unknown,,EPI SERVICE PRIMEUR,,-115432.0
,07,,07,,Unknown,,EPI SERVICE PRIMEUR,,-115439.0
,09,,09,,Unknown,,EPI SERVICE PRIMEUR,,-115448.0
,04,,04,,Unknown,,EPI SERVICE PRIMEUR,,-115452.0
,09,,09,,Unknown,,EPI SERVICE PRIMEUR,,-115461.0
,07,,07,,Unknown,,EPI SERVICE PRIMEUR,,-115468.0
,09,,09,,Unknown,,EPI SERVICE PRIMEUR,,-115477.0
,04,,04,,Unknown,,EPI SERVICE PRIMEUR,,-115481.0
,09,,09,,Unknown,,EPI SERVICE PRIMEUR,,-115490.0
,07,,07,,Unknown,,EPI SERVICE PRIMEUR,,-115497.0
,09,,09,,Unknown,,EPI SERVICE PRIMEUR,,-115506.0
,06,,06,,Unknown,,EPI SERVICE PRIMEUR,,-115512.0
,09,,09,,Unknown,,EPI SERVICE PRIMEUR,,-115521.0
,07,,07,,Unknown,,EPI SERVICE PRIMEUR,,-115528.0
,09,,09,,Unknown,,EPI SERVICE PRIMEUR,,-115537.0
,07,,07,,Unknown,,EPI SERVICE PRIMEUR,,-115544.0
,09,,09,,Unknown,,EPI SERVICE PRIMEUR,,-115553.0
,64,,64,,Unknown,,EPI SERVICE PRIMEUR,,-115617.0
,07,,07,,Unknown,,EPI SERVICE PRIMEUR,,-115624.0
,09,,09,,Unknown,,EPI SERVICE PRIMEUR,,-115633.0
,01,,01,,Unknown,,EPI SERVICE PRIMEUR,,-115634.0
,07,,07,,Unknown,,EPI SERVICE PRIMEUR,,-115641.0
,09,,09,,Unknown,,EPI SERVICE PRIMEUR,,-115650.0
,64,,64,,Unknown,,EPI SERVICE PRIMEUR,,-115714.0
,07,,07,,Unknown,,EPI SERVICE PRIMEUR,,-115721.0
,09,,09,,Unknown,,EPI SERVICE PRIMEUR,,-115730.0
,01,,01,,Unknown,,EPI SERVICE PRIMEUR,,-115731.0
,07,,07,,Unknown,,EPI SERVICE PRIMEUR,,-115738.0
,09,,09,,Unknown,,EPI SERVICE PRIMEUR,,-115747.0
,64,,64,,Unknown,,EPI SERVICE PRIMEUR,,-115811.0
,07,,07,,Unknown,,EPI SERVICE PRIMEUR,,-115818.0
,09,,09,,Unknown,,EPI SERVICE PRIMEUR,,-115827.0
,01,,01,,Unknown,,EPI SERVICE PRIMEUR,,-115828.0
,07,,07,,Unknown,,EPI SERVICE PRIMEUR,,-115835.0
,09,,09,,Unknown,,EPI SERVICE PRIMEUR,,-115844.0
,01,,01,,Unknown,,EPI SERVICE PRIMEUR,,-115845.0
,"249,30",,"249,30",,Unknown,,EPI SERVICE PRIMEUR,,-140775.0
,"41,42",,"41,42",,Unknown,,EPI SERVICE PRIMEUR,,-144917.0
,"608,69",,"608,69",,Unknown,,EPI SERVICE PRIMEUR,,-205786.0
,"1,16",,"1,16",,Unknown,,EPI SERVICE PRIMEUR,,-205902.0
,"0,47",,"0,47",,Unknown,,EPI SERVICE PRIMEUR,,-205949.0
,"4,65",,"4,65",,Unknown,,EPI SERVICE PRIMEUR,,-206414.0
,"1,46",,"1,46",,Unknown,,EPI SERVICE PRIMEUR,,-206560.0
,"4,11",,"4,11",,Unknown,,EPI SERVICE PRIMEUR,,-206971.0
,"0,37",,"0,37",,Unknown,,EPI SERVICE PRIMEUR,,-207008.0
,"4,68",,"4,68",,Unknown,,EPI SERVICE PRIMEUR,,-207476.0
,"1,15",,"1,15",,Unknown,,EPI SERVICE PRIMEUR,,-207591.0
,"0,39",,"0,39",,Unknown,,EPI SERVICE PRIMEUR,,-207630.0
,"0,51",,"0,51",,Unknown,,EPI SERVICE PRIMEUR,,-207681.0
,"0,19",,"0,19",,Unknown,,EPI SERVICE PRIMEUR,,-207700.0
,"0,27",,"0,27",,Unknown,,EPI SERVICE PRIMEUR,,-207727.0
,"89,33",,"89,33",,Unknown,,EPI SERVICE PRIMEUR,,-216660.0
,"121,58",,"121,58",,Unknown,,EPI SERVICE PRIMEUR,,-228818.0
,06,,06,,Unknown,,EPI SERVICE PRIMEUR,,-228824.0
,"09 600,00",,"09 600,00",,Unknown,,EPI SERVICE PRIMEUR,,-1188824.0
,06,,06,,Unknown,,EPI SERVICE PRIMEUR,,-1188830.0
,"09 125,41",,"09 125,41",,Unknown,,EPI SERVICE PRIMEUR,,-2101371.0
,07,,07,,Unknown,,EPI SERVICE PRIMEUR,,-2101378.0
,09 07,,09 07,,Unknown,,EPI SERVICE PRIMEUR,,-2102285.0
,09 07,,09 07,,Unknown,,EPI SERVICE PRIMEUR,,-2103192.0
,09 07,,09 07,,Unknown,,EPI SERVICE PRIMEUR,,-2104099.0
,09 07,,09 07,,Unknown,,EPI SERVICE PRIMEUR,,-2105006.0
,09 07,,09 07,,Unknown,,EPI SERVICE PRIMEUR,,-2105913.0
,09 07,,09 07,,Unknown,,EPI SERVICE PRIMEUR,,-2106820.0
,09 07,,09 07,,Unknown,,EPI SERVICE PRIMEUR,,-2107727.0
,09 07,,09 07,,Unknown,,EPI SERVICE PRIMEUR,,-2108634.0
,09 07,,09 07,,Unknown,,EPI SERVICE PRIMEUR,,-2109541.0
,09 07,,09 07,,Unknown,,EPI SERVICE PRIMEUR,,-2110448.0
,09 07,,09 07,,Unknown,,EPI SERVICE PRIMEUR,,-2111355.0
,09 07,,09 07,,Unknown,,EPI SERVICE PRIMEUR,,-2112262.0
,09 07,,09 07,,Unknown,,EPI SERVICE PRIMEUR,,-2113169.0
,09 07,,09 07,,Unknown,,EPI SERVICE PRIMEUR,,-2114076.0
,09 07,,09 07,,Unknown,,EPI SERVICE PRIMEUR,,-2114983.0
,"09 106,72",,"09 106,72",,Unknown,,EPI SERVICE PRIMEUR,,-3025655.0
,"83,30",,"83,30",,Unknown,,EPI SERVICE PRIMEUR,,-3033985.0
,"387,90",,"387,90",,Unknown,,EPI SERVICE PRIMEUR,,-3072775.0
,"184,90",,"184,90",,Unknown,,EPI SERVICE PRIMEUR,,-3091265.0
,"151,10",,"151,10",,Unknown,,EPI SERVICE PRIMEUR,,-3106375.0
,"8,20",,"8,20",,Unknown,,EPI SERVICE PRIMEUR,,-3107195.0
,"29,50",,"29,50",,Unknown,,EPI SERVICE PRIMEUR,,-3110145.0
,"246,89",,"246,89",,Unknown,,EPI SERVICE PRIMEUR,,-3134834.0
,"1,25",,"1,25",,Unknown,,EPI SERVICE PRIMEUR,,-3134959.0
,"1,30",,"1,30",,Unknown,,EPI SERVICE PRIMEUR,,-3135089.0
,"0,19",,"0,19",,Unknown,,EPI SERVICE PRIMEUR,,-3135108.0
,"1,70",,"1,70",,Unknown,,EPI SERVICE PRIMEUR,,-3135278.0
,"0,31",,"0,31",,Unknown,,EPI SERVICE PRIMEUR,,-3135309.0
,"1,01",,"1,01",,Unknown,,EPI SERVICE PRIMEUR,,-3135410.0
,"2,02",,"2,02",,Unknown,,EPI SERVICE PRIMEUR,,-3135612.0
,"0,47",,"0,47",,Unknown,,EPI SERVICE PRIMEUR,,-3135659.0
,1,,1,,Unknown,,EPI SERVICE PRIMEUR,,-3135660.0
,1,,1,,Unknown,,EPI SERVICE PRIMEUR,,-3135661.0
,4,,4,,Unknown,,EPI SERVICE PRIMEUR,,-3135665.0
07.11.2018,,06.10,,,Debit,,DAANCY,LCL RELEVE DE COMPTE,6.1
,,07.11,,,Debit,,DAANCY,AvENUE HENRI,13.21
,,3,,,Debit,,DAANCY,BARBUSSE,16.21
,,107,,,Debit,,DAANCY,DES POSTES,123.21000000000001
,,23,,,Debit,,DAANCY,PSK ALIMENTATION Domiciliaton,146.21
,,25,,,Debit,,DAANCY,Relercnces bancaires nationalcs RB Banque Indicatit N,171.21
,,4,,,Debit,,DAANCY,Qe 30002,175.21
,,45,,,Debit,,DAANCY,PA5,220.21
,,01 48,,,Debit,,DAANCY,BARIS KELES,368.21000000000004
,,14 98,,,Debit,,DAANCY,Identiliant,1866.21
,,66,,,Debit,,DAANCY,Internet,1932.21
,,19,,,Debit,,DAANCY,LCLIr,1951.21
,,05.10,,,Debit,,DAANCY,PRELEVEMENT A LA SOURCE,1956.31
,,"524,73",,,Debit,,DAANCY,B2B,54429.31
,,03.10,,,Debit,,DAANCY,B2B,54432.409999999996
,,02,,,Debit,,DAANCY,ECriTuURES DE,54434.409999999996
,,10,,,Debit,,DAANCY,PerioDE DATE,54444.409999999996
,,18 03,,,Debit,,DAANCY,Libelle VALEUR,56247.409999999996
,,10,,,Debit,,DAANCY,CrEDIT,56257.409999999996
,,0,,,Debit,,DAANCY,NO,56257.409999999996
,,18 08,,,Debit,,DAANCY,CB NO619077 DU,58065.409999999996
,,10,,,Debit,,DAANCY,NO619433 DU,58075.409999999996
,,08.10,,,Debit,,DAANCY,CB NO 714335 DU,58083.509999999995
,,08.10,,,Debit,,DAANCY,COMMISSIONS SuR,58091.60999999999
,,08.10,,,Debit,,DAANCY,CB NO,58099.70999999999
,,08.10,,,Debit,,DAANCY,COMMISSIONS SuA REMISE,58107.80999999999
,,08.10,,,Debit,,DAANCY,CB NO,58115.90999999999
,,08.10,,,Debit,,DAANCY,COMMISSIONS SuR ReMISE,58124.00999999999
,,08.10,,,Debit,,DAANCY,COMMISSIONS,58132.109999999986
,,08.10,,,Debit,,DAANCY,REMISE,58140.209999999985
,,08.10,,,Debit,,DAANCY,CB NO,58148.30999999998
,,08.10,,,Debit,,DAANCY,COMMISSIONS,58156.40999999998
,,"619,33",,,Debit,,DAANCY,COMMISSIONS,120089.40999999997
,,08.10,,,Debit,,DAANCY,CB NO 619077 DU,120097.50999999998
,,09.10,,,Debit,,DAANCY,COMMISSIONS SuA,120106.60999999999
,,09.10,,,Debit,,DAANCY,CB NO8*7106 DU 091018 09.10,120115.70999999999
,,03.10,,,Debit,,DAANCY,REMISE,120118.81
,,18 03,,,Debit,,DAANCY,NO847106 DU,121921.81
,,10.18,,,Debit,,DAANCY,Page 76 Credi Lyonnais,121931.98999999999
,,08.10,,,Debit,,DAANCY,Lyon,121940.09
,,18 08,,,Debit,,DAANCY,Aepublique,123748.09
,,10.18,,,Debit,,DAANCY,Lyon,123758.26999999999
,,08.10,,,Debit,,DAANCY,,123766.37
,,18 08,,,Debit,,DAANCY,,125574.37
,,10.18,,,Debit,,DAANCY,,125584.54999999999
,,08.10,,,Debit,,DAANCY,,125592.65
,,18 08,,,Debit,,DAANCY,,127400.65
,,10.18,,,Debit,,DAANCY,,127410.82999999999
,,08.10,,,Debit,,DAANCY,,127418.93
,,"18 374,45",,,Debit,,DAANCY,,1964863.93
,,"374,45",,,Debit,,DAANCY,,2002308.93
,,"70,301 28",,,Debit,,DAANCY,,9032436.93
,,"70,201 82",,,Debit,,DAANCY,,16052618.93
,,20,,,Debit,,DAANCY,,16052638.93
,,49,,,Debit,,DAANCY,,16052687.93
,,"48,201",,,Debit,,DAANCY,,16100888.93
,,"0,29",,,Debit,,DAANCY,,16100917.93
,,08.10,,,Debit,,DAANCY,,16100926.03
,,18,,,Debit,,DAANCY,,16100944.03
,,"0,42",,,Debit,,DAANCY,,16100986.03
,,08.10,,,Debit,,DAANCY,,16100994.129999999
,,18,,,Debit,,DAANCY,,16101012.129999999
,,"0,29",,,Debit,,DAANCY,,16101041.129999999
,,08,,,Debit,,DAANCY,,16101049.129999999
,,10.18,,,Debit,,DAANCY,,16101059.309999999
,,"0,17",,,Debit,,DAANCY,,16101076.309999999
,,08.10,,,Debit,,DAANCY,,16101084.409999998
,,18,,,Debit,,DAANCY,,16101102.409999998
,,"0,60",,,Debit,,DAANCY,,16101162.409999998
,,08.10,,,Debit,,DAANCY,,16101170.509999998
,,18,,,Debit,,DAANCY,,16101188.509999998
,,"0,42",,,Debit,,DAANCY,,16101230.509999998
,,09.10,,,Debit,,DAANCY,,16101239.609999998
,,18,,,Debit,,DAANCY,,16101257.609999998
,,"0,12",,,Debit,,DAANCY,,16101269.609999998
,,9 20,,,Debit,,DAANCY,,16102189.609999998
,,09.10,,,Debit,,DAANCY,,16102198.709999997
,,18,,,Debit,,DAANCY,,16102216.709999997
,,76,,,Debit,,DAANCY,,16102292.709999997
,,2 037 713 591,,,Debit,,DAANCY,,2053815883.71
,,509 741,,,Debit,,DAANCY,,2054325624.71
,,18,,,Debit,,DAANCY,,2054325642.71
,,07 00,,,Debit,,DAANCY,,2054326342.71
07.12.2018,,08.11,,,Debit,,DAANCY,LCL RELEVE DE COMPTE,8.11
,,07.12,,,Debit,,DAANCY,No 4,15.23
,,4,,,Debit,,DAANCY,AvENUE HENRI,19.23
,,107,,,Debit,,DAANCY,BARBUSSE,126.23
,,23,,,Debit,,DAANCY,DES POSTES,149.23000000000002
,,25,,,Debit,,DAANCY,PSK ALIMENTATION Domiciliaton,174.23000000000002
,,4,,,Debit,,DAANCY,Relercnces bancaires nationalcs RB Banque Indicatit N,178.23000000000002
,,45,,,Debit,,DAANCY,Qe 30002,223.23000000000002
,,01 48,,,Debit,,DAANCY,PA5,371.23
,,14 98,,,Debit,,DAANCY,BARIS KELES,1869.23
,,66,,,Debit,,DAANCY,votre Identifiant,1935.23
,,19,,,Debit,,DAANCY,Ier decembre 2018,1954.23
,,07.11,,,Debit,,DAANCY,Gerer vos cartes Pros,1961.34
,,"382,72",,,Debit,,DAANCY,Ier,40233.34
,,08.11,,,Debit,,DAANCY,PAS,40241.45
,,08.11,,,Debit,,DAANCY,B28,40249.56
,,08.11,,,Debit,,DAANCY,Tresor Public,40257.67
,,08.11,,,Debit,,DAANCY,PAS declare,40265.78
,,08.11,,,Debit,,DAANCY,gouvfr,40273.89
,,09.11,,,Debit,,DAANCY,B2B,40283.0
,,09.11,,,Debit,,DAANCY,detaut,40292.11
,,08.11,,,Debit,,DAANCY,B2B,40300.22
,,18 08,,,Debit,,DAANCY,ECRITURES DE LA PErioDE DATE,42108.22
,,11.18,,,Debit,,DAANCY,SOLDE,42119.4
,,08.11,,,Debit,,DAANCY,CB,42127.51
,,18 24,,,Debit,,DAANCY,Palv SEPA Free Telecom UBELLeFree,43951.51
,,70,,,Debit,,DAANCY,aefClient,44021.51
,,"92,00",,,Debit,,DAANCY,COMMISSIONS,53221.51
,,"29,99",,,Debit,,DAANCY,REMISE,56220.51
,,08.11,,,Debit,,DAANCY,COMMISSIONS,56228.62
,,18,,,Debit,,DAANCY,CHO,56246.62
,,"0,15",,,Debit,,DAANCY,COMMISSIONS,56261.62
,,08.11,,,Debit,,DAANCY,CB NO,56269.73
,,18,,,Debit,,DAANCY,Page 76 Credi Lyonnais,56287.73
,,"0,66",,,Debit,,DAANCY,ACS,56353.73
,,09.11,,,Debit,,DAANCY,Lyon,56362.840000000004
,,18 09,,,Debit,,DAANCY,Aepublique,58171.840000000004
,,11.18,,,Debit,,DAANCY,Lyon,58183.020000000004
,,"890,00",,,Debit,,DAANCY,,147183.02000000002
,,"0,12",,,Debit,,DAANCY,,147195.02000000002
,,7,,,Debit,,DAANCY,,147202.02000000002
,,76,,,Debit,,DAANCY,,147278.02000000002
,,2 037 713 591,,,Debit,,DAANCY,,2037860869.02
,,954 509 741,,,Debit,,DAANCY,,2992370610.02
,,18,,,Debit,,DAANCY,,2992370628.02
,,07 00,,,Debit,,DAANCY,,2992371328.02
06.12.2019,,08.11,,,Debit,,DAANCY,LCL RELEVE DE COMPTE,8.11
,,06.12,,,Debit,,DAANCY,AvENUE HENRI,14.23
,,16,,,Debit,,DAANCY,BARBUSSE,30.23
,,107,,,Debit,,DAANCY,DES POSTES,137.23
,,23,,,Debit,,DAANCY,PSK ALIMENTATION Domiciliaton,160.23
,,25,,,Debit,,DAANCY,Relercnces bancaires nationalcs RB Banque Indicatit N,185.23
,,4,,,Debit,,DAANCY,Qe 30002,189.23
,,45,,,Debit,,DAANCY,PA5,234.23
,,01 48,,,Debit,,DAANCY,BARIS KELES,382.23
,,14 98,,,Debit,,DAANCY,votre Identifiant,1880.23
,,66,,,Debit,,DAANCY,Ier,1946.23
,,19,,,Debit,,DAANCY,Ier decembre 2019,1965.23
,,07.11,,,Debit,,DAANCY,LCLIr,1972.34
,,"400,05",,,Debit,,DAANCY,Icl.tr,41977.34
,,08.11,,,Debit,,DAANCY,Solution,41985.45
,,08.11,,,Debit,,DAANCY,Gerer vos cartes Pros,41993.56
,,08.11,,,Debit,,DAANCY,vouS pouveZ resilier,42001.67
,,08.11,,,Debit,,DAANCY,ECriTuURES DE LA,42009.78
,,"388,06",,,Debit,,DAANCY,PerioDE DATE,80815.78
,,08.11,,,Debit,,DAANCY,Libelle VALEUR,80823.89
,,12.11,,,Debit,,DAANCY,CreDIT,80836.0
,,12.11,,,Debit,,DAANCY,SOLDE,80848.11
,,08,,,Debit,,DAANCY,CB NO 388776,80856.11
,,11.19,,,Debit,,DAANCY,COMMISSIONS SuR REMISE,80867.3
,,08.11,,,Debit,,DAANCY,CB NO,80875.41
,,19 08,,,Debit,,DAANCY,COMMISSIONS SuA REMISE,82783.41
,,11.19,,,Debit,,DAANCY,CB NO 388776,82794.6
,,08.11,,,Debit,,DAANCY,COMMISSIONS,82802.71
,,"19 030,94",,,Debit,,DAANCY,NO 498368 DU,1985896.71
,,"70,101 50",,,Debit,,DAANCY,COMMISSIONS,8996046.71
,,201,,,Debit,,DAANCY,NO 675738 DU,8996247.71
,,"0,42",,,Debit,,DAANCY,NO 591524 DU,8996289.71
,,08.11,,,Debit,,DAANCY,COMMISSIONS,8996297.82
,,19,,,Debit,,DAANCY,CB NO 631595 DU,8996316.82
,,"0,30",,,Debit,,DAANCY,COMMISSIONS,8996346.82
,,19,,,Debit,,DAANCY,COMMISSIONS,8996365.82
,,"0,89",,,Debit,,DAANCY,NO 675914 DU,8996454.82
,,19,,,Debit,,DAANCY,COMMISSIONS,8996473.82
,,"0,70",,,Debit,,DAANCY,NO 631390,8996543.82
,,19,,,Debit,,DAANCY,Page 76,8996562.82
,,"1,62",,,Debit,,DAANCY,Lyon,8996724.82
,,19,,,Debit,,DAANCY,Aepublique,8996743.82
,,"1,25",,,Debit,,DAANCY,Lyon,8996868.82
,,19,,,Debit,,DAANCY,,8996887.82
,,0,,,Debit,,DAANCY,,8996887.82
,,64,,,Debit,,DAANCY,,8996951.82
,,19,,,Debit,,DAANCY,,8996970.82
,,"0,39",,,Debit,,DAANCY,,8997009.82
,,19,,,Debit,,DAANCY,,8997028.82
,,"1,88",,,Debit,,DAANCY,,8997216.82
,,8,,,Debit,,DAANCY,,8997224.82
,,76,,,Debit,,DAANCY,,8997300.82
,,2 037 713 591,,,Debit,,DAANCY,,2046710891.82
,,509 741,,,Debit,,DAANCY,,2047220632.82
,,18,,,Debit,,DAANCY,,2047220650.82
,,07 00,,,Debit,,DAANCY,,2047221350.82
07.01.2020,,07.12,,,Debit,,DAANCY,LCL RELEVE DE COMPTE,7.12
,,07.01,,,Debit,,DAANCY,07.12.2019au 07.01.2020 - N,14.129999999999999
,,17,,,Debit,,DAANCY,AvENUE HENRI,31.13
,,107,,,Debit,,DAANCY,BARBUSSE,138.13
,,23,,,Debit,,DAANCY,DES POSTES,161.13
,,25,,,Debit,,DAANCY,PSK ALIMENTATION Domiciliaton,186.13
,,4,,,Debit,,DAANCY,Relercnces bancaires nationalcs RB Banque Indicatit N,190.13
,,45,,,Debit,,DAANCY,Qe 30002,235.13
,,01 48,,,Debit,,DAANCY,PA5,383.13
,,14 98,,,Debit,,DAANCY,ROMAIN LAIDET,1881.13
,,88,,,Debit,,DAANCY,votre Identifiant,1969.13
,,19,,,Debit,,DAANCY,Mes Comptes ECrITURES DE LA PErioDE DATE,1988.13
,,06.12,,,Debit,,DAANCY,CreDIT,1994.25
,,"574,26",,,Debit,,DAANCY,SOLDE,59420.25
,,09.12,,,Debit,,DAANCY,CHO,59429.37
,,09.12,,,Debit,,DAANCY,COMMISSIONS,59438.490000000005
,,09.12,,,Debit,,DAANCY,CB NO 150511,59447.61000000001
,,09.12,,,Debit,,DAANCY,COMMISSIONS SuA REMISE,59456.73000000001
,,09.12,,,Debit,,DAANCY,CB NO,59465.85000000001
,,09.12,,,Debit,,DAANCY,COMMISSIONS SuA REMISE,59474.970000000016
,,09.12,,,Debit,,DAANCY,CB NO,59484.09000000002
,,09.12,,,Debit,,DAANCY,COMMISSIONS,59493.21000000002
,,09.12,,,Debit,,DAANCY,NO,59502.33000000002
,,09.12,,,Debit,,DAANCY,COMMISSIONS,59511.450000000026
,,09.12,,,Debit,,DAANCY,COMMISSIONS,59520.57000000003
,,09.12,,,Debit,,DAANCY,CB NO,59529.69000000003
,,09.12,,,Debit,,DAANCY,REMISE,59538.810000000034
,,09.12,,,Debit,,DAANCY,CB NO 150511,59547.93000000004
,,07,,,Debit,,DAANCY,CB NO,59554.93000000004
,,12,,,Debit,,DAANCY,REMISE,59566.93000000004
,,19 10,,,Debit,,DAANCY,CB NO055905 DU,61476.93000000004
,,12,,,Debit,,DAANCY,REMISE,61488.93000000004
,,10.12,,,Debit,,DAANCY,CB NO056353,61499.05000000004
,,10.12,,,Debit,,DAANCY,CB2BOIMA DiSTAIB,61509.17000000004
,,10.12,,,Debit,,DAANCY,CB NO 292633 DU 101219,61519.290000000045
,,09.12,,,Debit,,DAANCY,CB NO,61528.41000000005
,,19 09,,,Debit,,DAANCY,COMMISSIONS SuR REMISE,63437.41000000005
,,12.19,,,Debit,,DAANCY,CB NO 292633 DU 101219,63449.60000000005
,,"297,04",,,Debit,,DAANCY,COMMISSIONS SuA,93153.60000000005
,,"0,47",,,Debit,,DAANCY,CB NO,93200.60000000005
,,09.12,,,Debit,,DAANCY,Page 76,93209.72000000004
,,19,,,Debit,,DAANCY,Lyon,93228.72000000004
,,"0,88",,,Debit,,DAANCY,Aepublique,93316.72000000004
,,09.12,,,Debit,,DAANCY,Lyon,93325.84000000004
,,19,,,Debit,,DAANCY,,93344.84000000004
,,"1,17",,,Debit,,DAANCY,,93461.84000000004
,,09.12,,,Debit,,DAANCY,,93470.96000000004
,,19,,,Debit,,DAANCY,,93489.96000000004
,,"0,83",,,Debit,,DAANCY,,93572.96000000004
,,09.12,,,Debit,,DAANCY,,93582.08000000003
,,19,,,Debit,,DAANCY,,93601.08000000003
,,"1,25",,,Debit,,DAANCY,,93726.08000000003
,,09.12,,,Debit,,DAANCY,,93735.20000000003
,,19,,,Debit,,DAANCY,,93754.20000000003
,,"0,45",,,Debit,,DAANCY,,93799.20000000003
,,09.12,,,Debit,,DAANCY,,93808.32000000002
,,19 09,,,Debit,,DAANCY,,95717.32000000002
,,12.19,,,Debit,,DAANCY,,95729.51000000002
,,09.12,,,Debit,,DAANCY,,95738.63000000002
,,19 09,,,Debit,,DAANCY,,97647.63000000002
,,12.19,,,Debit,,DAANCY,,97659.82000000002
,,09.12,,,Debit,,DAANCY,,97668.94000000002
,,19 09,,,Debit,,DAANCY,,99577.94000000002
,,12.19,,,Debit,,DAANCY,,99590.13000000002
,,09.12,,,Debit,,DAANCY,,99599.25000000001
,,19 10,,,Debit,,DAANCY,,101509.25000000001
,,12 19,,,Debit,,DAANCY,,102728.25000000001
,,10.12,,,Debit,,DAANCY,,102738.37000000001
,,19 10,,,Debit,,DAANCY,,104648.37000000001
,,12.19,,,Debit,,DAANCY,,104660.56000000001
,,208,,,Debit,,DAANCY,,104868.56000000001
,,"194,70",,,Debit,,DAANCY,,124338.56000000001
,,"78,10",,,Debit,,DAANCY,,132148.56
,,"74,301 146,90",,,Debit,,DAANCY,,7430246838.56
,,"120,58",,,Debit,,DAANCY,,7430258896.56
,,"160,72",,,Debit,,DAANCY,,7430274968.56
,,"123,80",,,Debit,,DAANCY,,7430287348.56
,,"66,20",,,Debit,,DAANCY,,7430293968.56
,,"0,94",,,Debit,,DAANCY,,7430294062.56
,,10.12,,,Debit,,DAANCY,,7430294072.68
,,19,,,Debit,,DAANCY,,7430294091.68
,,"0,40",,,Debit,,DAANCY,,7430294131.68
,,8,,,Debit,,DAANCY,,7430294139.68
,,76,,,Debit,,DAANCY,,7430294215.68
,,2 037 713 591,,,Debit,,DAANCY,,9468007806.68
,,509 741,,,Debit,,DAANCY,,9468517547.68
,,18,,,Debit,,DAANCY,,9468517565.68
,,07 00,,,Debit,,DAANCY,,9468518265.68
