date,Debit,credit,amount,balance,mode of transaction,customer name,bank name,transaction details,balance amount
11.08.2020,Unknown,11.08,Unknown,Unknown,Credit,Unknown,LCL,Aoat A0 RELEVE DE COMPTE,11.08
20.08.2020,Unknown,20.08,Unknown,Unknown,Credit,Unknown,LCL,DUPLICATA,31.16
Unknown,Unknown,294,Unknown,Unknown,Credit,Unknown,LCL,N,325.16
Unknown,Unknown,58,Unknown,Unknown,Credit,Unknown,LCL,D'IDENTITE,383.16
Unknown,Unknown,12,Unknown,Unknown,Credit,Unknown,LCL,BICETRE,395.16
Unknown,Unknown,50,Unknown,Unknown,Credit,Unknown,LCL,MONS,445.16
Unknown,Unknown,10.08,Unknown,Unknown,Credit,Unknown,LCL,MONSIEUR AMOKRANE,455.24
Unknown,Unknown,"19 185,57",Unknown,Unknown,Credit,Unknown,LCL,BICETRE,1919012.24
Unknown,Unknown,04.08,Unknown,Unknown,Credit,Unknown,LCL,Cle 30002,1919016.32
Unknown,Unknown,05 08,Unknown,Unknown,Credit,Unknown,LCL,T 50 References bancaires internationales,1919524.32
Unknown,Unknown,"20 351,50",Unknown,Unknown,Credit,Unknown,LCL,OOOO,3954674.32
Unknown,Unknown,"19 537,07",Unknown,Unknown,Credit,Unknown,LCL,7121 T5O,5908381.32
Unknown,Unknown,20.08,Unknown,Unknown,Credit,Unknown,LCL,SOLDE,5908401.4
Unknown,Unknown,"19 537,07",Unknown,Unknown,Credit,Unknown,LCL,OOOO1CH,7862108.4
Unknown,Unknown,1,Unknown,Unknown,Credit,Unknown,LCL,OOOOOOO,7862109.4
Unknown,Unknown,Unknown,Unknown,Unknown,Credit,Unknown,LCL,TOTAUX,7862109.4
Unknown,Unknown,Unknown,Unknown,Unknown,Credit,Unknown,LCL,SOLDE,7862109.4
Unknown,Unknown,Unknown,Unknown,Unknown,Credit,Unknown,LCL,Resolution,7862109.4
Unknown,Unknown,Unknown,Unknown,Unknown,Credit,Unknown,LCL,Dispositions genérales de banque disponibles,7862109.4
Unknown,Unknown,Unknown,Unknown,Unknown,Credit,Unknown,LCL,LCLfr,7862109.4
01.01.2020,Unknown,01.01,Unknown,Unknown,Credit,Unknown,COVMISSION,LCL RELEVE DE COMPTE,1.01
10.01.2020,Unknown,10.01,Unknown,Unknown,Credit,Unknown,COVMISSION,Jaavf,11.02
Unknown,Unknown,277,Unknown,Unknown,Credit,Unknown,COVMISSION,G40100p00141,288.02
Unknown,Unknown,158,Unknown,Unknown,Credit,Unknown,COVMISSION,MONSIEUR AMOKRANE,446.02
Unknown,Unknown,12,Unknown,Unknown,Credit,Unknown,COVMISSION,MONSIEUR AMOKRANE,458.02
Unknown,Unknown,50,Unknown,Unknown,Credit,Unknown,COVMISSION,BICETRE,508.02
Unknown,Unknown,31.12,Unknown,Unknown,Credit,Unknown,COVMISSION,References,539.14
Unknown,Unknown,"19 365,76",Unknown,Unknown,Credit,Unknown,COVMISSION,Cle,1937115.14
Unknown,Unknown,31.12,Unknown,Unknown,Credit,Unknown,COVMISSION,T 50 References bancaires internationales,1937146.26
Unknown,Unknown,03.01,Unknown,Unknown,Credit,Unknown,COVMISSION,FR85,1937149.27
Unknown,Unknown,20,Unknown,Unknown,Credit,Unknown,COVMISSION,T5o BIC,1937169.27
Unknown,Unknown,"6,00",Unknown,Unknown,Credit,Unknown,COVMISSION,CREDIT 31.12,1937769.27
Unknown,Unknown,"19 359,76",Unknown,Unknown,Credit,Unknown,COVMISSION,ExtrAIT,3873745.27
Unknown,Unknown,02.01,Unknown,Unknown,Credit,Unknown,COVMISSION,DECADAIRE,3873747.28
Unknown,Unknown,02.01,Unknown,Unknown,Credit,Unknown,COVMISSION,SOLDE INTERMEDIAIRE A FIN,3873749.29
Unknown,Unknown,02.01,Unknown,Unknown,Credit,Unknown,COVMISSION,ABONNEMENT,3873751.2999999993
Unknown,Unknown,08.01,Unknown,Unknown,Credit,Unknown,COVMISSION,MULTIPREVOYANCE PRo230000105568,3873759.309999999
Unknown,Unknown,08.01,Unknown,Unknown,Credit,Unknown,COVMISSION,OOOOOADE2001010000105568 ID CrEANCIER FR39ZZZ000957,3873767.319999999
Unknown,Unknown,02.01,Unknown,Unknown,Credit,Unknown,COVMISSION,ADESOOOO10556800933750,3873769.329999999
Unknown,Unknown,20 02,Unknown,Unknown,Credit,Unknown,COVMISSION,IDF,3875771.329999999
Unknown,Unknown,01.20,Unknown,Unknown,Credit,Unknown,COVMISSION,ID CREANCIER,3875772.529999999
Unknown,Unknown,"39,50",Unknown,Unknown,Credit,Unknown,COVMISSION,Tip1030o6710700813142000037477679,3879722.529999999
Unknown,Unknown,"6,24",Unknown,Unknown,Credit,Unknown,COVMISSION,CHQ,3880346.529999999
Unknown,Unknown,"20 184,50",Unknown,Unknown,Credit,Unknown,COVMISSION,VERSEMENT,5898796.529999999
Unknown,Unknown,08.01,Unknown,Unknown,Credit,Unknown,COVMISSION,TOTAUX,5898804.539999999
Unknown,Unknown,20 08,Unknown,Unknown,Credit,Unknown,COVMISSION,SOLDE,5900812.539999999
Unknown,Unknown,01 20,Unknown,Unknown,Credit,Unknown,COVMISSION,Resolution,5900932.539999999
Unknown,Unknown,"698,70",Unknown,Unknown,Credit,Unknown,COVMISSION,dillusee,5970802.539999999
Unknown,Unknown,"760,00",Unknown,Unknown,Credit,Unknown,COVMISSION,LCLIr,6046802.539999999
Unknown,Unknown,"934,94",Unknown,Unknown,Credit,Unknown,COVMISSION,Page 71 Crédit Lyonnais SA,6140296.539999999
Unknown,Unknown,"20 125,76",Unknown,Unknown,Credit,Unknown,COVMISSION,RCS Lyon 18,8152872.539999999
Unknown,Unknown,8,Unknown,Unknown,Credit,Unknown,COVMISSION,rue de la République,8152880.539999999
Unknown,Unknown,8 10,Unknown,Unknown,Credit,Unknown,COVMISSION,Unknown,8153690.539999999
Unknown,Unknown,01,Unknown,Unknown,Credit,Unknown,COVMISSION,Unknown,8153691.539999999
Unknown,Unknown,"19 190,82",Unknown,Unknown,Credit,Unknown,COVMISSION,Unknown,10072773.54
Unknown,Unknown,1,Unknown,Unknown,Credit,Unknown,COVMISSION,Unknown,10072774.54
Unknown,Unknown,71,Unknown,Unknown,Credit,Unknown,COVMISSION,Unknown,10072845.54
Unknown,Unknown,2 037 713 591,Unknown,Unknown,Credit,Unknown,COVMISSION,Unknown,2047786436.54
Unknown,Unknown,954 509 741,Unknown,Unknown,Credit,Unknown,COVMISSION,Unknown,3002296177.54
Unknown,Unknown,18,Unknown,Unknown,Credit,Unknown,COVMISSION,Unknown,3002296195.54
Unknown,Unknown,07 00,Unknown,Unknown,Credit,Unknown,COVMISSION,Unknown,3002296895.54
31/03/2019,Unknown,91,Unknown,Unknown,Credit,Unknown,DEPARGNE,Semce gatut puapod,91.0
Unknown,Unknown,71,Unknown,Unknown,Credit,Unknown,DEPARGNE,eparane fr Votre Agence MAISONS ALFORT 147 AvenueDugenERALLECLERC,162.0
Unknown,Unknown,7,Unknown,Unknown,Credit,Unknown,DEPARGNE,Kuardi,169.0
Unknown,Unknown,147,Unknown,Unknown,Credit,Unknown,DEPARGNE,Keraed,316.0
Unknown,Unknown,01,Unknown,Unknown,Credit,Unknown,DEPARGNE,Jeudi,317.0
Unknown,Unknown,12,Unknown,Unknown,Credit,Unknown,DEPARGNE,Vendred,329.0
Unknown,Unknown,31,Unknown,Unknown,Credit,Unknown,DEPARGNE,Samed,360.0
Unknown,Unknown,03,Unknown,Unknown,Credit,Unknown,DEPARGNE,N 10,363.0
Unknown,Unknown,10,Unknown,Unknown,Credit,Unknown,DEPARGNE,Votre Conseiller AMANDINE AvRIL,373.0
Unknown,Unknown,1,Unknown,Unknown,Credit,Unknown,DEPARGNE,Kettanenacira,374.0
Unknown,Unknown,15 36,Unknown,Unknown,Credit,Unknown,DEPARGNE,WoumeKettane,1910.0
Unknown,Unknown,2,Unknown,Unknown,Credit,Unknown,DEPARGNE,DEPOT JOINT,1912.0
Unknown,Unknown,28,Unknown,Unknown,Credit,Unknown,DEPARGNE,IZICARTE,1940.0
Unknown,Unknown,02,Unknown,Unknown,Credit,Unknown,DEPARGNE,Soleau310419,1942.0
Unknown,Unknown,19,Unknown,Unknown,Credit,Unknown,DEPARGNE,Montant,1961.0
Unknown,Unknown,54,Unknown,Unknown,Credit,Unknown,DEPARGNE,KETTANE,2015.0
Unknown,Unknown,00,Unknown,Unknown,Credit,Unknown,DEPARGNE,DEPOT JOINT N 17515,2015.0
Unknown,Unknown,28,Unknown,Unknown,Credit,Unknown,DEPARGNE,Dale Detandes,2043.0
Unknown,Unknown,02,Unknown,Unknown,Credit,Unknown,DEPARGNE,Solde Precedent AU 28/02/19,2045.0
Unknown,Unknown,19,Unknown,Unknown,Credit,Unknown,DEPARGNE,VnEUR AU,2064.0
Unknown,Unknown,01,Unknown,Unknown,Credit,Unknown,DEPARGNE,MotoPaix,2065.0
Unknown,Unknown,03,Unknown,Unknown,Credit,Unknown,DEPARGNE,SePAINteRepaRGIE,2068.0
Unknown,Unknown,28,Unknown,Unknown,Credit,Unknown,DEPARGNE,SALARIAL,2096.0
Unknown,Unknown,314,Unknown,Unknown,Credit,Unknown,DEPARGNE,GRoUPEM OnopR,2410.0
Unknown,Unknown,006,Unknown,Unknown,Credit,Unknown,DEPARGNE,Ret,2416.0
Unknown,Unknown,09,Unknown,Unknown,Credit,Unknown,DEPARGNE,Me,2425.0
Unknown,Unknown,"2 787,73",Unknown,Unknown,Credit,Unknown,DEPARGNE,Ret,281198.0
Unknown,Unknown,"550,00",Unknown,Unknown,Credit,Unknown,DEPARGNE,ViR SepaDofip VaL De arne ReMBoURSEMENT(ORC,336198.0
Unknown,Unknown,"548,98",Unknown,Unknown,Credit,Unknown,DEPARGNE,KETT,391096.0
Unknown,Unknown,"803,70",Unknown,Unknown,Credit,Unknown,DEPARGNE,~Rel doneur dordre,471466.0
Unknown,Unknown,"82,75",Unknown,Unknown,Credit,Unknown,DEPARGNE,GFC19 0940006W-006-0086,479741.0
Unknown,Unknown,"703,50",Unknown,Unknown,Credit,Unknown,DEPARGNE,Cux,550091.0
Unknown,Unknown,"43,45",Unknown,Unknown,Credit,Unknown,DEPARGNE,Nuv€ Iqtc CS,554436.0
Unknown,Unknown,"20,98",Unknown,Unknown,Credit,Unknown,DEPARGNE,CeDe,556534.0
Unknown,Unknown,1,Unknown,Unknown,Credit,Unknown,DEPARGNE,8S ctumnucuCode,556535.0
Unknown,Unknown,900 942,Unknown,Unknown,Credit,Unknown,DEPARGNE,Honcureet,1457477.0
Unknown,Unknown,0,Unknown,Unknown,Credit,Unknown,DEPARGNE,Soocte,1457477.0
Unknown,Unknown,200,Unknown,Unknown,Credit,Unknown,DEPARGNE,Drectoreet,1457677.0
Unknown,Unknown,3,Unknown,Unknown,Credit,Unknown,DEPARGNE,Conei cOicnuuoncice Sunvralnce Cpiu,1457680.0
Unknown,Unknown,8,Unknown,Unknown,Credit,Unknown,DEPARGNE,ACSPn Sicx',1457688.0
Unknown,Unknown,Unknown,Unknown,Unknown,Credit,Unknown,DEPARGNE,Pneculoue Is001 A Incrmcaur,1457688.0
30/11/2019,Unknown,71,Unknown,Unknown,Credit,Unknown,IleDE FRANCE Direct,Feer CAISSE,71.0
Unknown,Unknown,7,Unknown,Unknown,Credit,Unknown,IleDE FRANCE Direct,Semce gatut puapod,78.0
Unknown,Unknown,147,Unknown,Unknown,Credit,Unknown,IleDE FRANCE Direct,eparane fr Votre Agence MAISONS ALFORT 147 AvenueDugenERALLECLERC,225.0
Unknown,Unknown,01,Unknown,Unknown,Credit,Unknown,IleDE FRANCE Direct,Kuardi,226.0
Unknown,Unknown,12,Unknown,Unknown,Credit,Unknown,IleDE FRANCE Direct,Keraed,238.0
Unknown,Unknown,30,Unknown,Unknown,Credit,Unknown,IleDE FRANCE Direct,Jeudi,268.0
Unknown,Unknown,11,Unknown,Unknown,Credit,Unknown,IleDE FRANCE Direct,Vendred,279.0
Unknown,Unknown,18,Unknown,Unknown,Credit,Unknown,IleDE FRANCE Direct,Samed,297.0
Unknown,Unknown,1,Unknown,Unknown,Credit,Unknown,IleDE FRANCE Direct,N 18 Page 1/ 100 2010110,298.0
Unknown,Unknown,100,Unknown,Unknown,Credit,Unknown,IleDE FRANCE Direct,Votre Conseiller AMANDINE AvRIL,398.0
Unknown,Unknown,15 36,Unknown,Unknown,Credit,Unknown,IleDE FRANCE Direct,Eml amandineavnlocedfcisseeoagnetr 10 BIS DE LA REVOL DES OEILLETS 94380 BONNEUIL SUR MARNE Identifiants,1934.0
Unknown,Unknown,10,Unknown,Unknown,Credit,Unknown,IleDE FRANCE Direct,Kettanenacira,1944.0
Unknown,Unknown,30,Unknown,Unknown,Credit,Unknown,IleDE FRANCE Direct,WoumeKettane,1974.0
Unknown,Unknown,11,Unknown,Unknown,Credit,Unknown,IleDE FRANCE Direct,DEPOT JOINT,1985.0
Unknown,Unknown,19,Unknown,Unknown,Credit,Unknown,IleDE FRANCE Direct,IZICARTE,2004.0
Unknown,Unknown,11,Unknown,Unknown,Credit,Unknown,IleDE FRANCE Direct,Sokeau 30/11/19,2015.0
Unknown,Unknown,19,Unknown,Unknown,Credit,Unknown,IleDE FRANCE Direct,KETTANE,2034.0
Unknown,Unknown,"42 000,00",Unknown,Unknown,Credit,Unknown,IleDE FRANCE Direct,DEPOT JOINT N 17515,4202034.0
Unknown,Unknown,31,Unknown,Unknown,Credit,Unknown,IleDE FRANCE Direct,Dale Detandes,4202065.0
Unknown,Unknown,10,Unknown,Unknown,Credit,Unknown,IleDE FRANCE Direct,Solde Precedent AU 31/10/19 Operations,4202075.0
Unknown,Unknown,19,Unknown,Unknown,Credit,Unknown,IleDE FRANCE Direct,depa,4202094.0
Unknown,Unknown,08,Unknown,Unknown,Credit,Unknown,IleDE FRANCE Direct,GAB,4202102.0
Unknown,Unknown,11,Unknown,Unknown,Credit,Unknown,IleDE FRANCE Direct,DEPOT ESPECE,4202113.0
Unknown,Unknown,26,Unknown,Unknown,Credit,Unknown,IleDE FRANCE Direct,AWoneu,4202139.0
Unknown,Unknown,11,Unknown,Unknown,Credit,Unknown,IleDE FRANCE Direct,"1930,00146491930,0014649 ~Rel doneur",4202150.0
Unknown,Unknown,27,Unknown,Unknown,Credit,Unknown,IleDE FRANCE Direct,MotOPRIX,4202177.0
Unknown,Unknown,11,Unknown,Unknown,Credit,Unknown,IleDE FRANCE Direct,Rel,4202188.0
Unknown,Unknown,02,Unknown,Unknown,Credit,Unknown,IleDE FRANCE Direct,Tauty,4202190.0
Unknown,Unknown,11,Unknown,Unknown,Credit,Unknown,IleDE FRANCE Direct,Bolt Blance,4202201.0
Unknown,Unknown,0,Unknown,Unknown,Credit,Unknown,IleDE FRANCE Direct,Ret,4202201.0
Unknown,Unknown,11,Unknown,Unknown,Credit,Unknown,IleDE FRANCE Direct,GRAS SAVOYE,4202212.0
Unknown,Unknown,09,Unknown,Unknown,Credit,Unknown,IleDE FRANCE Direct,Ret,4202221.0
Unknown,Unknown,11,Unknown,Unknown,Credit,Unknown,IleDE FRANCE Direct,Ret,4202232.0
Unknown,Unknown,09,Unknown,Unknown,Credit,Unknown,IleDE FRANCE Direct,Ret,4202241.0
Unknown,Unknown,11,Unknown,Unknown,Credit,Unknown,IleDE FRANCE Direct,Dol Gedn,4202252.0
Unknown,Unknown,3,Unknown,Unknown,Credit,Unknown,IleDE FRANCE Direct,Cux,4202255.0
Unknown,Unknown,05,Unknown,Unknown,Credit,Unknown,IleDE FRANCE Direct,Inne J6n8r,4202260.0
Unknown,Unknown,11,Unknown,Unknown,Credit,Unknown,IleDE FRANCE Direct,Nkur,4202271.0
Unknown,Unknown,05,Unknown,Unknown,Credit,Unknown,IleDE FRANCE Direct,Enque Cocoeru,4202276.0
Unknown,Unknown,11,Unknown,Unknown,Credit,Unknown,IleDE FRANCE Direct,8S ctumnucuCode,4202287.0
Unknown,Unknown,06,Unknown,Unknown,Credit,Unknown,IleDE FRANCE Direct,Honcureet,4202293.0
Unknown,Unknown,11,Unknown,Unknown,Credit,Unknown,IleDE FRANCE Direct,Soocte,4202304.0
Unknown,Unknown,07,Unknown,Unknown,Credit,Unknown,IleDE FRANCE Direct,Drectoreet,4202311.0
Unknown,Unknown,11,Unknown,Unknown,Credit,Unknown,IleDE FRANCE Direct,Conei cOicnuuoncice Sunvralnce Cpiu,4202322.0
Unknown,Unknown,111,Unknown,Unknown,Credit,Unknown,IleDE FRANCE Direct,ACSPn Sicx',4202433.0
Unknown,Unknown,0,Unknown,Unknown,Credit,Unknown,IleDE FRANCE Direct,Pneculoue Is001 A Incrmcaur,4202433.0
Unknown,Unknown,11,Unknown,Unknown,Credit,Unknown,IleDE FRANCE Direct,Unknown,4202444.0
Unknown,Unknown,11,Unknown,Unknown,Credit,Unknown,IleDE FRANCE Direct,Unknown,4202455.0
Unknown,Unknown,6,Unknown,Unknown,Credit,Unknown,IleDE FRANCE Direct,Unknown,4202461.0
Unknown,Unknown,18,Unknown,Unknown,Credit,Unknown,IleDE FRANCE Direct,Unknown,4202479.0
Unknown,Unknown,11,Unknown,Unknown,Credit,Unknown,IleDE FRANCE Direct,Unknown,4202490.0
Unknown,Unknown,74,Unknown,Unknown,Credit,Unknown,IleDE FRANCE Direct,Unknown,4202564.0
Unknown,Unknown,"450,00",Unknown,Unknown,Credit,Unknown,IleDE FRANCE Direct,Unknown,4247564.0
Unknown,Unknown,"450,00",Unknown,Unknown,Credit,Unknown,IleDE FRANCE Direct,Unknown,4292564.0
Unknown,Unknown,499,Unknown,Unknown,Credit,Unknown,IleDE FRANCE Direct,Unknown,4293063.0
Unknown,Unknown,8,Unknown,Unknown,Credit,Unknown,IleDE FRANCE Direct,Unknown,4293071.0
Unknown,Unknown,0,Unknown,Unknown,Credit,Unknown,IleDE FRANCE Direct,Unknown,4293071.0
Unknown,Unknown,798 54,Unknown,Unknown,Credit,Unknown,IleDE FRANCE Direct,Unknown,4372925.0
Unknown,Unknown,"39,89",Unknown,Unknown,Credit,Unknown,IleDE FRANCE Direct,Unknown,4376914.0
Unknown,Unknown,"7,50",Unknown,Unknown,Credit,Unknown,IleDE FRANCE Direct,Unknown,4377664.0
Unknown,Unknown,"19,24",Unknown,Unknown,Credit,Unknown,IleDE FRANCE Direct,Unknown,4379588.0
Unknown,Unknown,"210,00",Unknown,Unknown,Credit,Unknown,IleDE FRANCE Direct,Unknown,4400588.0
Unknown,Unknown,128 75,Unknown,Unknown,Credit,Unknown,IleDE FRANCE Direct,Unknown,4413463.0
Unknown,Unknown,"86,80",Unknown,Unknown,Credit,Unknown,IleDE FRANCE Direct,Unknown,4422143.0
Unknown,Unknown,756,Unknown,Unknown,Credit,Unknown,IleDE FRANCE Direct,Unknown,4422899.0
Unknown,Unknown,1,Unknown,Unknown,Credit,Unknown,IleDE FRANCE Direct,Unknown,4422900.0
Unknown,Unknown,900 942,Unknown,Unknown,Credit,Unknown,IleDE FRANCE Direct,Unknown,5323842.0
Unknown,Unknown,0,Unknown,Unknown,Credit,Unknown,IleDE FRANCE Direct,Unknown,5323842.0
Unknown,Unknown,200,Unknown,Unknown,Credit,Unknown,IleDE FRANCE Direct,Unknown,5324042.0
Unknown,Unknown,6,Unknown,Unknown,Credit,Unknown,IleDE FRANCE Direct,Unknown,5324048.0
31/12/2019,Unknown,71,Unknown,Unknown,Credit,Unknown,IleDE FRANCE Direct,Semce gatut puapod,71.0
Unknown,Unknown,7,Unknown,Unknown,Credit,Unknown,IleDE FRANCE Direct,eparane fr Votre Agence MAISONS ALFORT 147 AvenueDugenERALLECLERC,78.0
Unknown,Unknown,147,Unknown,Unknown,Credit,Unknown,IleDE FRANCE Direct,Kuardi,225.0
Unknown,Unknown,01,Unknown,Unknown,Credit,Unknown,IleDE FRANCE Direct,Keraed,226.0
Unknown,Unknown,12,Unknown,Unknown,Credit,Unknown,IleDE FRANCE Direct,Jeudi,238.0
Unknown,Unknown,31,Unknown,Unknown,Credit,Unknown,IleDE FRANCE Direct,Vendred,269.0
Unknown,Unknown,12,Unknown,Unknown,Credit,Unknown,IleDE FRANCE Direct,Samed,281.0
Unknown,Unknown,19,Unknown,Unknown,Credit,Unknown,IleDE FRANCE Direct,Votre Conseiller AMANDINE AvRIL,300.0
Unknown,Unknown,1,Unknown,Unknown,Credit,Unknown,IleDE FRANCE Direct,Eml amandineavnlocedfcisseeoagnetr 10 BIS DE LA REVOL DES OEILLETS 94380 BONNEUIL SUR MARNE Identifiants,301.0
Unknown,Unknown,15 36,Unknown,Unknown,Credit,Unknown,IleDE FRANCE Direct,Kettanenacira,1837.0
Unknown,Unknown,10,Unknown,Unknown,Credit,Unknown,IleDE FRANCE Direct,WoumeKettane,1847.0
Unknown,Unknown,31,Unknown,Unknown,Credit,Unknown,IleDE FRANCE Direct,DEPOT JOINT,1878.0
Unknown,Unknown,12,Unknown,Unknown,Credit,Unknown,IleDE FRANCE Direct,IZICARTE,1890.0
Unknown,Unknown,19,Unknown,Unknown,Credit,Unknown,IleDE FRANCE Direct,Sokeau 31/12/19,1909.0
Unknown,Unknown,30,Unknown,Unknown,Credit,Unknown,IleDE FRANCE Direct,M,1939.0
Unknown,Unknown,11,Unknown,Unknown,Credit,Unknown,IleDE FRANCE Direct,KETTANE,1950.0
Unknown,Unknown,19,Unknown,Unknown,Credit,Unknown,IleDE FRANCE Direct,DEPOT JOINT N 17515,1969.0
Unknown,Unknown,"504,80",Unknown,Unknown,Credit,Unknown,IleDE FRANCE Direct,Dale Detandes,52449.0
Unknown,Unknown,"000,00",Unknown,Unknown,Credit,Unknown,IleDE FRANCE Direct,Solde Precedent AU 30/11/19,52449.0
Unknown,Unknown,30,Unknown,Unknown,Credit,Unknown,IleDE FRANCE Direct,ChEqUES,52479.0
Unknown,Unknown,11,Unknown,Unknown,Credit,Unknown,IleDE FRANCE Direct,DEPOT ESPECE,52490.0
Unknown,Unknown,19,Unknown,Unknown,Credit,Unknown,IleDE FRANCE Direct,DEPOT ESPECE,52509.0
Unknown,Unknown,09,Unknown,Unknown,Credit,Unknown,IleDE FRANCE Direct,MotoPaix,52518.0
Unknown,Unknown,12,Unknown,Unknown,Credit,Unknown,IleDE FRANCE Direct,Payout H 35099825 ~Rel,52530.0
Unknown,Unknown,12 05,Unknown,Unknown,Credit,Unknown,IleDE FRANCE Direct,GO,53735.0
Unknown,Unknown,12,Unknown,Unknown,Credit,Unknown,IleDE FRANCE Direct,MotoPaix,53747.0
Unknown,Unknown,06,Unknown,Unknown,Credit,Unknown,IleDE FRANCE Direct,MonopRIX SA,53753.0
Unknown,Unknown,12 05,Unknown,Unknown,Credit,Unknown,IleDE FRANCE Direct,CbelecleRc,54958.0
Unknown,Unknown,12,Unknown,Unknown,Credit,Unknown,IleDE FRANCE Direct,CpaM,54970.0
Unknown,Unknown,14,Unknown,Unknown,Credit,Unknown,IleDE FRANCE Direct,Rel,54984.0
Unknown,Unknown,12,Unknown,Unknown,Credit,Unknown,IleDE FRANCE Direct,~Ret,54996.0
Unknown,Unknown,02,Unknown,Unknown,Credit,Unknown,IleDE FRANCE Direct,Bolt Blince Payout,54998.0
Unknown,Unknown,12,Unknown,Unknown,Credit,Unknown,IleDE FRANCE Direct,Rel,55010.0
Unknown,Unknown,02,Unknown,Unknown,Credit,Unknown,IleDE FRANCE Direct,CHEQUE Iroooooso,55012.0
Unknown,Unknown,12,Unknown,Unknown,Credit,Unknown,IleDE FRANCE Direct,Cux,55024.0
Unknown,Unknown,02,Unknown,Unknown,Credit,Unknown,IleDE FRANCE Direct,Nuv€ Iqtc CS,55026.0
Unknown,Unknown,12,Unknown,Unknown,Credit,Unknown,IleDE FRANCE Direct,CeDe,55038.0
Unknown,Unknown,03,Unknown,Unknown,Credit,Unknown,IleDE FRANCE Direct,8S ctumnucuCode,55041.0
Unknown,Unknown,12,Unknown,Unknown,Credit,Unknown,IleDE FRANCE Direct,Honcureet,55053.0
Unknown,Unknown,03,Unknown,Unknown,Credit,Unknown,IleDE FRANCE Direct,Soocte onmme'Drectoreet,55056.0
Unknown,Unknown,12,Unknown,Unknown,Credit,Unknown,IleDE FRANCE Direct,ACSPn Sicx',55068.0
Unknown,Unknown,06,Unknown,Unknown,Credit,Unknown,IleDE FRANCE Direct,Pneculoue Is001 A Incrmcaur,55074.0
Unknown,Unknown,12,Unknown,Unknown,Credit,Unknown,IleDE FRANCE Direct,Unknown,55086.0
Unknown,Unknown,11,Unknown,Unknown,Credit,Unknown,IleDE FRANCE Direct,Unknown,55097.0
Unknown,Unknown,12,Unknown,Unknown,Credit,Unknown,IleDE FRANCE Direct,Unknown,55109.0
Unknown,Unknown,16,Unknown,Unknown,Credit,Unknown,IleDE FRANCE Direct,Unknown,55125.0
Unknown,Unknown,12,Unknown,Unknown,Credit,Unknown,IleDE FRANCE Direct,Unknown,55137.0
Unknown,Unknown,6,Unknown,Unknown,Credit,Unknown,IleDE FRANCE Direct,Unknown,55143.0
Unknown,Unknown,23,Unknown,Unknown,Credit,Unknown,IleDE FRANCE Direct,Unknown,55166.0
Unknown,Unknown,12,Unknown,Unknown,Credit,Unknown,IleDE FRANCE Direct,Unknown,55178.0
Unknown,Unknown,30,Unknown,Unknown,Credit,Unknown,IleDE FRANCE Direct,Unknown,55208.0
Unknown,Unknown,12,Unknown,Unknown,Credit,Unknown,IleDE FRANCE Direct,Unknown,55220.0
Unknown,Unknown,05,Unknown,Unknown,Credit,Unknown,IleDE FRANCE Direct,Unknown,55225.0
Unknown,Unknown,12,Unknown,Unknown,Credit,Unknown,IleDE FRANCE Direct,Unknown,55237.0
Unknown,Unknown,12,Unknown,Unknown,Credit,Unknown,IleDE FRANCE Direct,Unknown,55249.0
Unknown,Unknown,12,Unknown,Unknown,Credit,Unknown,IleDE FRANCE Direct,Unknown,55261.0
Unknown,Unknown,"955,42",Unknown,Unknown,Credit,Unknown,IleDE FRANCE Direct,Unknown,150803.0
Unknown,Unknown,"150,00",Unknown,Unknown,Credit,Unknown,IleDE FRANCE Direct,Unknown,165803.0
Unknown,Unknown,"450,00",Unknown,Unknown,Credit,Unknown,IleDE FRANCE Direct,Unknown,210803.0
Unknown,Unknown,"693,58",Unknown,Unknown,Credit,Unknown,IleDE FRANCE Direct,Unknown,280161.0
Unknown,Unknown,"25,97",Unknown,Unknown,Credit,Unknown,IleDE FRANCE Direct,Unknown,282758.0
Unknown,Unknown,"30,05",Unknown,Unknown,Credit,Unknown,IleDE FRANCE Direct,Unknown,285763.0
Unknown,Unknown,"29,89",Unknown,Unknown,Credit,Unknown,IleDE FRANCE Direct,Unknown,288752.0
Unknown,Unknown,"518,00",Unknown,Unknown,Credit,Unknown,IleDE FRANCE Direct,Unknown,340552.0
Unknown,Unknown,"5,60",Unknown,Unknown,Credit,Unknown,IleDE FRANCE Direct,Unknown,341112.0
Unknown,Unknown,116,Unknown,Unknown,Credit,Unknown,IleDE FRANCE Direct,Unknown,341228.0
Unknown,Unknown,3,Unknown,Unknown,Credit,Unknown,IleDE FRANCE Direct,Unknown,341231.0
Unknown,Unknown,"29,28",Unknown,Unknown,Credit,Unknown,IleDE FRANCE Direct,Unknown,344159.0
Unknown,Unknown,"228,80",Unknown,Unknown,Credit,Unknown,IleDE FRANCE Direct,Unknown,367039.0
Unknown,Unknown,"397,00",Unknown,Unknown,Credit,Unknown,IleDE FRANCE Direct,Unknown,406739.0
Unknown,Unknown,1,Unknown,Unknown,Credit,Unknown,IleDE FRANCE Direct,Unknown,406740.0
Unknown,Unknown,900 942,Unknown,Unknown,Credit,Unknown,IleDE FRANCE Direct,Unknown,1307682.0
Unknown,Unknown,0,Unknown,Unknown,Credit,Unknown,IleDE FRANCE Direct,Unknown,1307682.0
Unknown,Unknown,200,Unknown,Unknown,Credit,Unknown,IleDE FRANCE Direct,Unknown,1307882.0
Unknown,Unknown,8,Unknown,Unknown,Credit,Unknown,IleDE FRANCE Direct,Unknown,1307890.0
11.12.2021,Unknown,11.12,Unknown,Unknown,Credit,Unknown,LCL,So RELEVE DE COMPTE,11.12
20.12.2021,Unknown,20.12,Unknown,Unknown,Credit,Unknown,LCL,D'IDENTITE,31.24
Unknown,Unknown,335,Unknown,Unknown,Credit,Unknown,LCL,BiCETRE 58 AVENUE DE FONTAINEBLEAU 94270,366.24
Unknown,Unknown,58,Unknown,Unknown,Credit,Unknown,LCL,BICETRE,424.24
Unknown,Unknown,12,Unknown,Unknown,Credit,Unknown,LCL,MONS,436.24
Unknown,Unknown,9,Unknown,Unknown,Credit,Unknown,LCL,SEINE 9 Titulaire,445.24
Unknown,Unknown,50,Unknown,Unknown,Credit,Unknown,LCL,MONSIEUR AMOKRANE,495.24
Unknown,Unknown,10 12,Unknown,Unknown,Credit,Unknown,LCL,BICETRE,1507.24
Unknown,Unknown,"72 305,67",Unknown,Unknown,Credit,Unknown,LCL,Cle,7232074.24
Unknown,Unknown,16 12,Unknown,Unknown,Credit,Unknown,LCL,References,7233686.24
Unknown,Unknown,16.12,Unknown,Unknown,Credit,Unknown,LCL,FR85,7233702.36
Unknown,Unknown,"21 880,00",Unknown,Unknown,Credit,Unknown,LCL,CREDIT 10 12,9421702.36
Unknown,Unknown,"880,00",Unknown,Unknown,Credit,Unknown,LCL,PRLV,9509702.36
Unknown,Unknown,"72 305,67",Unknown,Unknown,Credit,Unknown,LCL,DIRECTION GENERALE DES FINANCES PUBLIQUE S CREANCIER,16740269.36
Unknown,Unknown,20 12,Unknown,Unknown,Credit,Unknown,LCL,NNFR46ZZZ0050022194030858865R923374,16742281.36
Unknown,Unknown,"71 425,67",Unknown,Unknown,Credit,Unknown,LCL,TOTAUX,23884848.36
Unknown,Unknown,1,Unknown,Unknown,Credit,Unknown,LCL,SOLDE,23884849.36
Unknown,Unknown,Unknown,Unknown,Unknown,Credit,Unknown,LCL,Resolution,23884849.36
Unknown,Unknown,Unknown,Unknown,Unknown,Credit,Unknown,LCL,Dispositions generales de banque disponibles,23884849.36
21.01.2021,Unknown,21.01,Unknown,Unknown,Credit,Unknown,Banque Indicatit,LCL RELEVE DE COMPTE COURANT,21.01
10.02.2021,Unknown,10.02,Unknown,Unknown,Credit,Unknown,Banque Indicatit,N,31.03
Unknown,Unknown,306,Unknown,Unknown,Credit,Unknown,Banque Indicatit,KREMLIn,337.03
Unknown,Unknown,58,Unknown,Unknown,Credit,Unknown,Banque Indicatit,58 AVENUE DE FONTAINEBLEAU 194270,395.03
Unknown,Unknown,12,Unknown,Unknown,Credit,Unknown,Banque Indicatit,MONSIEUR AMOKRANE,407.03
Unknown,Unknown,50,Unknown,Unknown,Credit,Unknown,Banque Indicatit,MONSIEUR AMOKRANE,457.03
Unknown,Unknown,20.01,Unknown,Unknown,Credit,Unknown,Banque Indicatit,BICETRE,477.04
Unknown,Unknown,"35 806,16",Unknown,Unknown,Credit,Unknown,Banque Indicatit,Clé 30002,3581093.04
Unknown,Unknown,31.01,Unknown,Unknown,Credit,Unknown,Banque Indicatit,T 50 References,3581124.05
Unknown,Unknown,02.02,Unknown,Unknown,Credit,Unknown,Banque Indicatit,FR85,3581126.07
Unknown,Unknown,21,Unknown,Unknown,Credit,Unknown,Banque Indicatit,T5o BIC,3581147.07
Unknown,Unknown,"5,50",Unknown,Unknown,Credit,Unknown,Banque Indicatit,EXTRAIT,3581697.07
Unknown,Unknown,"35 800,66",Unknown,Unknown,Credit,Unknown,Banque Indicatit,DECADAIRE,7161763.07
Unknown,Unknown,01.02,Unknown,Unknown,Credit,Unknown,Banque Indicatit,SOLDE INTERMEDIAIRE A FIN JANVIER 35,7161764.09
Unknown,Unknown,01.02,Unknown,Unknown,Credit,Unknown,Banque Indicatit,LIBELLE MULTIPREVOYANCE PRO2300O0105568 REF,7161765.109999999
Unknown,Unknown,01.02,Unknown,Unknown,Credit,Unknown,Banque Indicatit,ADESOOOO10556800933750,7161766.129999999
Unknown,Unknown,21,Unknown,Unknown,Credit,Unknown,Banque Indicatit,ABONNEMENT,7161787.129999999
Unknown,Unknown,"6,24",Unknown,Unknown,Credit,Unknown,Banque Indicatit,ZEN PRO,7162411.129999999
Unknown,Unknown,01.02,Unknown,Unknown,Credit,Unknown,Banque Indicatit,B,7162412.149999999
Unknown,Unknown,21 40,Unknown,Unknown,Credit,Unknown,Banque Indicatit,SOLDE,7164552.149999999
Unknown,Unknown,30,Unknown,Unknown,Credit,Unknown,Banque Indicatit,FGDR,7164582.149999999
Unknown,Unknown,"52,04",Unknown,Unknown,Credit,Unknown,Banque Indicatit,LCLIr,7169786.149999999
Unknown,Unknown,"35 806,16",Unknown,Unknown,Credit,Unknown,Banque Indicatit,Page 11 Credit Lyonnais,10750402.15
Unknown,Unknown,10.02,Unknown,Unknown,Credit,Unknown,Banque Indicatit,SiREn 954 509 741 RCS Lyon 18,10750412.169999998
Unknown,Unknown,"35 754,12",Unknown,Unknown,Credit,Unknown,Banque Indicatit,rue de la République,14325824.169999998
Unknown,Unknown,8,Unknown,Unknown,Credit,Unknown,Banque Indicatit,Unknown,14325832.169999998
Unknown,Unknown,1,Unknown,Unknown,Credit,Unknown,Banque Indicatit,Unknown,14325833.169999998
Unknown,Unknown,8,Unknown,Unknown,Credit,Unknown,Banque Indicatit,Unknown,14325841.169999998
Unknown,Unknown,1,Unknown,Unknown,Credit,Unknown,Banque Indicatit,Unknown,14325842.169999998
Unknown,Unknown,1,Unknown,Unknown,Credit,Unknown,Banque Indicatit,Unknown,14325843.169999998
Unknown,Unknown,0,Unknown,Unknown,Credit,Unknown,Banque Indicatit,Unknown,14325843.169999998
Unknown,Unknown,11,Unknown,Unknown,Credit,Unknown,Banque Indicatit,Unknown,14325854.169999998
Unknown,Unknown,2 037 713 591,Unknown,Unknown,Credit,Unknown,Banque Indicatit,Unknown,2052039445.17
Unknown,Unknown,954 509 741,Unknown,Unknown,Credit,Unknown,Banque Indicatit,Unknown,3006549186.17
Unknown,Unknown,18,Unknown,Unknown,Credit,Unknown,Banque Indicatit,Unknown,3006549204.17
Unknown,Unknown,07 00,Unknown,Unknown,Credit,Unknown,Banque Indicatit,Unknown,3006549904.17
01.01.2022,Unknown,01.01,Unknown,Unknown,Credit,Unknown,PRLV,LCL RELEVE DE COMPTE COURANT,1.01
10.01.2022,Unknown,10.01,Unknown,Unknown,Credit,Unknown,PRLV,N,11.02
Unknown,Unknown,337,Unknown,Unknown,Credit,Unknown,PRLV,D'IDENTITE,348.02
Unknown,Unknown,58,Unknown,Unknown,Credit,Unknown,PRLV,58 AVENUE DE FONTAINEBLEAU 94270,406.02
Unknown,Unknown,0,Unknown,Unknown,Credit,Unknown,PRLV,ATY,406.02
Unknown,Unknown,1,Unknown,Unknown,Credit,Unknown,PRLV,MONSIEUR,407.02
Unknown,Unknown,1 50,Unknown,Unknown,Credit,Unknown,PRLV,MONSIEUR AMOKRANE,557.02
Unknown,Unknown,10,Unknown,Unknown,Credit,Unknown,PRLV,BICETRE,567.02
Unknown,Unknown,28,Unknown,Unknown,Credit,Unknown,PRLV,Clé,595.02
Unknown,Unknown,12,Unknown,Unknown,Credit,Unknown,PRLV,T 50 References bancaires internationales,607.02
Unknown,Unknown,50,Unknown,Unknown,Credit,Unknown,PRLV,T50 BIC,657.02
Unknown,Unknown,31.12,Unknown,Unknown,Credit,Unknown,PRLV,CREDIT 31.12,688.14
Unknown,Unknown,"72 447,86",Unknown,Unknown,Credit,Unknown,PRLV,SOLDE,7245474.14
Unknown,Unknown,31.12,Unknown,Unknown,Credit,Unknown,PRLV,EXTRAIT,7245505.26
Unknown,Unknown,04.01,Unknown,Unknown,Credit,Unknown,PRLV,DECADAIRE,7245509.27
Unknown,Unknown,22,Unknown,Unknown,Credit,Unknown,PRLV,SOLDE INTERMEDIAIRE A FIN,7245531.27
Unknown,Unknown,"9,00",Unknown,Unknown,Credit,Unknown,PRLV,ABONNEMENT,7246431.27
Unknown,Unknown,"72 438,86",Unknown,Unknown,Credit,Unknown,PRLV,LIBELLE MULTIPREVOYANCE PRO2300O0105568 REF,14490317.27
Unknown,Unknown,03.01,Unknown,Unknown,Credit,Unknown,PRLV,CLIENT OOOOOADE2201010000105568,14490320.28
Unknown,Unknown,03.01,Unknown,Unknown,Credit,Unknown,PRLV,ADESOOOO10556800933750,14490323.29
Unknown,Unknown,03.01,Unknown,Unknown,Credit,Unknown,PRLV,TOTAUX,14490326.3
Unknown,Unknown,22 03,Unknown,Unknown,Credit,Unknown,PRLV,SOLDE,14492529.3
Unknown,Unknown,01 22,Unknown,Unknown,Credit,Unknown,PRLV,Résolution,14492651.3
Unknown,Unknown,"40,30",Unknown,Unknown,Credit,Unknown,PRLV,dillusee,14496681.3
Unknown,Unknown,"6,24",Unknown,Unknown,Credit,Unknown,PRLV,lormulaire dinlormation,14497305.3
Unknown,Unknown,"55,54",Unknown,Unknown,Credit,Unknown,PRLV,Dispositions genérales de banque disponibles,14502859.3
Unknown,Unknown,"72 447,86",Unknown,Unknown,Credit,Unknown,PRLV,LCLIr,21747645.3
Unknown,Unknown,10.01,Unknown,Unknown,Credit,Unknown,PRLV,volre conseiller,21747655.31
Unknown,Unknown,"72 392,32",Unknown,Unknown,Credit,Unknown,PRLV,RCS Lyon 18,28986887.31
Unknown,Unknown,8,Unknown,Unknown,Credit,Unknown,PRLV,rue de la République,28986895.31
Unknown,Unknown,1,Unknown,Unknown,Credit,Unknown,PRLV,Unknown,28986896.31
Unknown,Unknown,8,Unknown,Unknown,Credit,Unknown,PRLV,Unknown,28986904.31
Unknown,Unknown,1,Unknown,Unknown,Credit,Unknown,PRLV,Unknown,28986905.31
Unknown,Unknown,0,Unknown,Unknown,Credit,Unknown,PRLV,Unknown,28986905.31
Unknown,Unknown,1,Unknown,Unknown,Credit,Unknown,PRLV,Unknown,28986906.31
Unknown,Unknown,1,Unknown,Unknown,Credit,Unknown,PRLV,Unknown,28986907.31
Unknown,Unknown,2 037 713 591,Unknown,Unknown,Credit,Unknown,PRLV,Unknown,2066700498.31
Unknown,Unknown,954 509 741,Unknown,Unknown,Credit,Unknown,PRLV,Unknown,3021210239.31
Unknown,Unknown,18,Unknown,Unknown,Credit,Unknown,PRLV,Unknown,3021210257.31
Unknown,Unknown,07 00,Unknown,Unknown,Credit,Unknown,PRLV,Unknown,3021210957.31
08/07/2021,40,Unknown,40,Unknown,Unknown,Unknown,Deliveroo,CCM RENNES,-40.0
07/07/2021,8,Unknown,8,Unknown,Unknown,Unknown,Deliveroo,CHALOTAIS 35000 RENNES,-48.0
07/07/2021,1,Unknown,1,Unknown,Unknown,Unknown,Deliveroo,CARTESICHEQUIERS,-49.0
08/07/2021,11,Unknown,11,Unknown,Unknown,Unknown,Deliveroo,Titulaire(s,-60.0
08/07/2021,07,Unknown,07,Unknown,Unknown,Unknown,Deliveroo,EPI SERVICE PrIMEUR,-67.0
08/07/2021,11,Unknown,11,Unknown,Unknown,Unknown,Deliveroo,NUMÉRO DE,-78.0
08/07/2021,02 99,Unknown,02 99,Unknown,Unknown,Unknown,Deliveroo,Crédit ANCIEN SOLDE CRÉDITEUR,-377.0
08/07/2021,14 94,Unknown,14 94,Unknown,Unknown,Unknown,Deliveroo,TPV,-1871.0
08/07/2021,34,Unknown,34,Unknown,Unknown,Unknown,Deliveroo,TPV,-1905.0
08/07/2021,31,Unknown,31,Unknown,Unknown,Unknown,Deliveroo,TPV,-1936.0
08/07/2021,75 10,Unknown,75 10,Unknown,Unknown,Unknown,Deliveroo,CARTE,-9446.0
08/07/2021,11,Unknown,11,Unknown,Unknown,Unknown,Deliveroo,COM,-9457.0
08/07/2021,02 98,Unknown,02 98,Unknown,Unknown,Unknown,Deliveroo,CARTES,-9755.0
08/07/2021,28 42,Unknown,28 42,Unknown,Unknown,Unknown,Deliveroo,COM,-12597.0
08/07/2021,28,Unknown,28,Unknown,Unknown,Unknown,Deliveroo,CARTES 0386405 64 0707,-12625.0
08/07/2021,95,Unknown,95,Unknown,Unknown,Unknown,Deliveroo,COM,-12720.0
08/07/2021,095,Unknown,095,Unknown,Unknown,Unknown,Deliveroo,CARTES,-12815.0
09/07/2021,07,Unknown,07,Unknown,Unknown,Unknown,Deliveroo,COM,-12822.0
09/07/2021,"17 178,52",Unknown,"17 178,52",Unknown,Unknown,Unknown,Deliveroo,CARTES,-1730674.0
01/07/2021,08,Unknown,08,Unknown,Unknown,Unknown,Deliveroo,COM,-1730682.0
09/07/2021,07 08,Unknown,07 08,Unknown,Unknown,Unknown,Deliveroo,CARTES,-1731390.0
09/07/2021,07 08,Unknown,07 08,Unknown,Unknown,Unknown,Deliveroo,TPV,-1732098.0
09/07/2021,07 08,Unknown,07 08,Unknown,Unknown,Unknown,Deliveroo,TPV,-1732806.0
09/07/2021,07 08,Unknown,07 08,Unknown,Unknown,Unknown,Deliveroo,CARTE,-1733514.0
09/07/2021,07 08,Unknown,07 08,Unknown,Unknown,Unknown,Deliveroo,CARTE,-1734222.0
09/07/2021,07 08,Unknown,07 08,Unknown,Unknown,Unknown,Deliveroo,COMM,-1734930.0
09/07/2021,07 08,Unknown,07 08,Unknown,Unknown,Unknown,Deliveroo,COM,-1735638.0
09/07/2021,07 08,Unknown,07 08,Unknown,Unknown,Unknown,Deliveroo,CARTES,-1736346.0
09/07/2021,07 08,Unknown,07 08,Unknown,Unknown,Unknown,Deliveroo,COM,-1737054.0
09/07/2021,07 08,Unknown,07 08,Unknown,Unknown,Unknown,Deliveroo,CARTES,-1737762.0
09/07/2021,07 08,Unknown,07 08,Unknown,Unknown,Unknown,Deliveroo,COM,-1738470.0
09/07/2021,07 08,Unknown,07 08,Unknown,Unknown,Unknown,Deliveroo,CARTES 0386405,-1739178.0
Unknown,07 09,Unknown,07 09,Unknown,Unknown,Unknown,Deliveroo,COM,-1739887.0
Unknown,07 09,Unknown,07 09,Unknown,Unknown,Unknown,Deliveroo,CARTES,-1740596.0
Unknown,07 09,Unknown,07 09,Unknown,Unknown,Unknown,Deliveroo,COM,-1741305.0
Unknown,07 09,Unknown,07 09,Unknown,Unknown,Unknown,Deliveroo,CARTES,-1742014.0
Unknown,07 09,Unknown,07 09,Unknown,Unknown,Unknown,Deliveroo,COM,-1742723.0
Unknown,07 09,Unknown,07 09,Unknown,Unknown,Unknown,Deliveroo,CARTES,-1743432.0
Unknown,07 09,Unknown,07 09,Unknown,Unknown,Unknown,Deliveroo,COM,-1744141.0
Unknown,07 09,Unknown,07 09,Unknown,Unknown,Unknown,Deliveroo,CARTES 0386405 64 0707,-1744850.0
Unknown,07 09,Unknown,07 09,Unknown,Unknown,Unknown,Deliveroo,COM,-1745559.0
Unknown,07 09,Unknown,07 09,Unknown,Unknown,Unknown,Deliveroo,CARTES,-1746268.0
Unknown,07 09,Unknown,07 09,Unknown,Unknown,Unknown,Deliveroo,TPV,-1746977.0
Unknown,07 09,Unknown,07 09,Unknown,Unknown,Unknown,Deliveroo,TPV,-1747686.0
Unknown,07 09,Unknown,07 09,Unknown,Unknown,Unknown,Deliveroo,REMISE,-1748395.0
Unknown,07 09,Unknown,07 09,Unknown,Unknown,Unknown,Deliveroo,TPV,-1749104.0
Unknown,07 09,Unknown,07 09,Unknown,Unknown,Unknown,Deliveroo,TPV,-1749813.0
Unknown,07 10,Unknown,07 10,Unknown,Unknown,Unknown,Deliveroo,Unknown,-1750523.0
Unknown,07 10,Unknown,07 10,Unknown,Unknown,Unknown,Deliveroo,Unknown,-1751233.0
Unknown,07 10,Unknown,07 10,Unknown,Unknown,Unknown,Deliveroo,Unknown,-1751943.0
Unknown,07 10,Unknown,07 10,Unknown,Unknown,Unknown,Deliveroo,Unknown,-1752653.0
Unknown,07 08,Unknown,07 08,Unknown,Unknown,Unknown,Deliveroo,Unknown,-1753361.0
Unknown,07,Unknown,07,Unknown,Unknown,Unknown,Deliveroo,Unknown,-1753368.0
Unknown,07,Unknown,07,Unknown,Unknown,Unknown,Deliveroo,Unknown,-1753375.0
Unknown,07,Unknown,07,Unknown,Unknown,Unknown,Deliveroo,Unknown,-1753382.0
Unknown,07,Unknown,07,Unknown,Unknown,Unknown,Deliveroo,Unknown,-1753389.0
Unknown,07,Unknown,07,Unknown,Unknown,Unknown,Deliveroo,Unknown,-1753396.0
Unknown,08,Unknown,08,Unknown,Unknown,Unknown,Deliveroo,Unknown,-1753404.0
Unknown,07,Unknown,07,Unknown,Unknown,Unknown,Deliveroo,Unknown,-1753411.0
Unknown,08,Unknown,08,Unknown,Unknown,Unknown,Deliveroo,Unknown,-1753419.0
Unknown,07,Unknown,07,Unknown,Unknown,Unknown,Deliveroo,Unknown,-1753426.0
Unknown,08,Unknown,08,Unknown,Unknown,Unknown,Deliveroo,Unknown,-1753434.0
Unknown,07,Unknown,07,Unknown,Unknown,Unknown,Deliveroo,Unknown,-1753441.0
Unknown,07,Unknown,07,Unknown,Unknown,Unknown,Deliveroo,Unknown,-1753448.0
Unknown,07,Unknown,07,Unknown,Unknown,Unknown,Deliveroo,Unknown,-1753455.0
Unknown,35,Unknown,35,Unknown,Unknown,Unknown,Deliveroo,Unknown,-1753490.0
Unknown,08,Unknown,08,Unknown,Unknown,Unknown,Deliveroo,Unknown,-1753498.0
Unknown,07,Unknown,07,Unknown,Unknown,Unknown,Deliveroo,Unknown,-1753505.0
Unknown,07,Unknown,07,Unknown,Unknown,Unknown,Deliveroo,Unknown,-1753512.0
Unknown,07,Unknown,07,Unknown,Unknown,Unknown,Deliveroo,Unknown,-1753519.0
Unknown,08,Unknown,08,Unknown,Unknown,Unknown,Deliveroo,Unknown,-1753527.0
Unknown,07,Unknown,07,Unknown,Unknown,Unknown,Deliveroo,Unknown,-1753534.0
Unknown,07,Unknown,07,Unknown,Unknown,Unknown,Deliveroo,Unknown,-1753541.0
Unknown,07,Unknown,07,Unknown,Unknown,Unknown,Deliveroo,Unknown,-1753548.0
Unknown,08,Unknown,08,Unknown,Unknown,Unknown,Deliveroo,Unknown,-1753556.0
Unknown,07,Unknown,07,Unknown,Unknown,Unknown,Deliveroo,Unknown,-1753563.0
Unknown,64,Unknown,64,Unknown,Unknown,Unknown,Deliveroo,Unknown,-1753627.0
Unknown,08,Unknown,08,Unknown,Unknown,Unknown,Deliveroo,Unknown,-1753635.0
Unknown,07,Unknown,07,Unknown,Unknown,Unknown,Deliveroo,Unknown,-1753642.0
Unknown,64,Unknown,64,Unknown,Unknown,Unknown,Deliveroo,Unknown,-1753706.0
Unknown,08,Unknown,08,Unknown,Unknown,Unknown,Deliveroo,Unknown,-1753714.0
Unknown,07,Unknown,07,Unknown,Unknown,Unknown,Deliveroo,Unknown,-1753721.0
Unknown,01,Unknown,01,Unknown,Unknown,Unknown,Deliveroo,Unknown,-1753722.0
Unknown,08,Unknown,08,Unknown,Unknown,Unknown,Deliveroo,Unknown,-1753730.0
Unknown,07,Unknown,07,Unknown,Unknown,Unknown,Deliveroo,Unknown,-1753737.0
Unknown,64,Unknown,64,Unknown,Unknown,Unknown,Deliveroo,Unknown,-1753801.0
Unknown,08,Unknown,08,Unknown,Unknown,Unknown,Deliveroo,Unknown,-1753809.0
Unknown,07,Unknown,07,Unknown,Unknown,Unknown,Deliveroo,Unknown,-1753816.0
Unknown,01,Unknown,01,Unknown,Unknown,Unknown,Deliveroo,Unknown,-1753817.0
Unknown,08,Unknown,08,Unknown,Unknown,Unknown,Deliveroo,Unknown,-1753825.0
Unknown,07,Unknown,07,Unknown,Unknown,Unknown,Deliveroo,Unknown,-1753832.0
Unknown,08,Unknown,08,Unknown,Unknown,Unknown,Deliveroo,Unknown,-1753840.0
Unknown,07,Unknown,07,Unknown,Unknown,Unknown,Deliveroo,Unknown,-1753847.0
Unknown,08,Unknown,08,Unknown,Unknown,Unknown,Deliveroo,Unknown,-1753855.0
Unknown,07,Unknown,07,Unknown,Unknown,Unknown,Deliveroo,Unknown,-1753862.0
Unknown,08,Unknown,08,Unknown,Unknown,Unknown,Deliveroo,Unknown,-1753870.0
Unknown,07,Unknown,07,Unknown,Unknown,Unknown,Deliveroo,Unknown,-1753877.0
Unknown,09,Unknown,09,Unknown,Unknown,Unknown,Deliveroo,Unknown,-1753886.0
Unknown,07,Unknown,07,Unknown,Unknown,Unknown,Deliveroo,Unknown,-1753893.0
Unknown,08,Unknown,08,Unknown,Unknown,Unknown,Deliveroo,Unknown,-1753901.0
Unknown,07,Unknown,07,Unknown,Unknown,Unknown,Deliveroo,Unknown,-1753908.0
Unknown,09,Unknown,09,Unknown,Unknown,Unknown,Deliveroo,Unknown,-1753917.0
Unknown,07,Unknown,07,Unknown,Unknown,Unknown,Deliveroo,Unknown,-1753924.0
Unknown,08,Unknown,08,Unknown,Unknown,Unknown,Deliveroo,Unknown,-1753932.0
Unknown,07,Unknown,07,Unknown,Unknown,Unknown,Deliveroo,Unknown,-1753939.0
Unknown,01,Unknown,01,Unknown,Unknown,Unknown,Deliveroo,Unknown,-1753940.0
Unknown,07,Unknown,07,Unknown,Unknown,Unknown,Deliveroo,Unknown,-1753947.0
Unknown,02 09,Unknown,02 09,Unknown,Unknown,Unknown,Deliveroo,Unknown,-1754156.0
Unknown,07,Unknown,07,Unknown,Unknown,Unknown,Deliveroo,Unknown,-1754163.0
Unknown,64,Unknown,64,Unknown,Unknown,Unknown,Deliveroo,Unknown,-1754227.0
Unknown,09,Unknown,09,Unknown,Unknown,Unknown,Deliveroo,Unknown,-1754236.0
Unknown,07,Unknown,07,Unknown,Unknown,Unknown,Deliveroo,Unknown,-1754243.0
Unknown,01,Unknown,01,Unknown,Unknown,Unknown,Deliveroo,Unknown,-1754244.0
Unknown,09,Unknown,09,Unknown,Unknown,Unknown,Deliveroo,Unknown,-1754253.0
Unknown,07,Unknown,07,Unknown,Unknown,Unknown,Deliveroo,Unknown,-1754260.0
Unknown,64,Unknown,64,Unknown,Unknown,Unknown,Deliveroo,Unknown,-1754324.0
Unknown,09,Unknown,09,Unknown,Unknown,Unknown,Deliveroo,Unknown,-1754333.0
Unknown,07,Unknown,07,Unknown,Unknown,Unknown,Deliveroo,Unknown,-1754340.0
Unknown,01,Unknown,01,Unknown,Unknown,Unknown,Deliveroo,Unknown,-1754341.0
Unknown,09,Unknown,09,Unknown,Unknown,Unknown,Deliveroo,Unknown,-1754350.0
Unknown,07,Unknown,07,Unknown,Unknown,Unknown,Deliveroo,Unknown,-1754357.0
Unknown,64,Unknown,64,Unknown,Unknown,Unknown,Deliveroo,Unknown,-1754421.0
Unknown,09,Unknown,09,Unknown,Unknown,Unknown,Deliveroo,Unknown,-1754430.0
Unknown,07,Unknown,07,Unknown,Unknown,Unknown,Deliveroo,Unknown,-1754437.0
Unknown,01,Unknown,01,Unknown,Unknown,Unknown,Deliveroo,Unknown,-1754438.0
Unknown,09,Unknown,09,Unknown,Unknown,Unknown,Deliveroo,Unknown,-1754447.0
Unknown,07,Unknown,07,Unknown,Unknown,Unknown,Deliveroo,Unknown,-1754454.0
Unknown,64,Unknown,64,Unknown,Unknown,Unknown,Deliveroo,Unknown,-1754518.0
Unknown,09,Unknown,09,Unknown,Unknown,Unknown,Deliveroo,Unknown,-1754527.0
Unknown,07,Unknown,07,Unknown,Unknown,Unknown,Deliveroo,Unknown,-1754534.0
Unknown,01,Unknown,01,Unknown,Unknown,Unknown,Deliveroo,Unknown,-1754535.0
Unknown,09,Unknown,09,Unknown,Unknown,Unknown,Deliveroo,Unknown,-1754544.0
Unknown,07,Unknown,07,Unknown,Unknown,Unknown,Deliveroo,Unknown,-1754551.0
Unknown,09,Unknown,09,Unknown,Unknown,Unknown,Deliveroo,Unknown,-1754560.0
Unknown,07,Unknown,07,Unknown,Unknown,Unknown,Deliveroo,Unknown,-1754567.0
Unknown,09,Unknown,09,Unknown,Unknown,Unknown,Deliveroo,Unknown,-1754576.0
Unknown,07,Unknown,07,Unknown,Unknown,Unknown,Deliveroo,Unknown,-1754583.0
Unknown,09,Unknown,09,Unknown,Unknown,Unknown,Deliveroo,Unknown,-1754592.0
Unknown,07,Unknown,07,Unknown,Unknown,Unknown,Deliveroo,Unknown,-1754599.0
Unknown,"252,40",Unknown,"252,40",Unknown,Unknown,Unknown,Deliveroo,Unknown,-1779839.0
Unknown,"88,00",Unknown,"88,00",Unknown,Unknown,Unknown,Deliveroo,Unknown,-1788639.0
Unknown,"75,80",Unknown,"75,80",Unknown,Unknown,Unknown,Deliveroo,Unknown,-1796219.0
Unknown,"63,04",Unknown,"63,04",Unknown,Unknown,Unknown,Deliveroo,Unknown,-1802523.0
Unknown,"233,59",Unknown,"233,59",Unknown,Unknown,Unknown,Deliveroo,Unknown,-1825882.0
Unknown,"186,02",Unknown,"186,02",Unknown,Unknown,Unknown,Deliveroo,Unknown,-1844484.0
Unknown,"223,76",Unknown,"223,76",Unknown,Unknown,Unknown,Deliveroo,Unknown,-1866860.0
Unknown,"50,00",Unknown,"50,00",Unknown,Unknown,Unknown,Deliveroo,Unknown,-1871860.0
Unknown,"0,94",Unknown,"0,94",Unknown,Unknown,Unknown,Deliveroo,Unknown,-1871954.0
Unknown,"0,77",Unknown,"0,77",Unknown,Unknown,Unknown,Deliveroo,Unknown,-1872031.0
Unknown,"0,31",Unknown,"0,31",Unknown,Unknown,Unknown,Deliveroo,Unknown,-1872062.0
Unknown,"0,08",Unknown,"0,08",Unknown,Unknown,Unknown,Deliveroo,Unknown,-1872070.0
Unknown,"0,46",Unknown,"0,46",Unknown,Unknown,Unknown,Deliveroo,Unknown,-1872116.0
Unknown,"110,20",Unknown,"110,20",Unknown,Unknown,Unknown,Deliveroo,Unknown,-1883136.0
Unknown,"473,70",Unknown,"473,70",Unknown,Unknown,Unknown,Deliveroo,Unknown,-1930506.0
Unknown,"52,10",Unknown,"52,10",Unknown,Unknown,Unknown,Deliveroo,Unknown,-1935716.0
Unknown,"78,30",Unknown,"78,30",Unknown,Unknown,Unknown,Deliveroo,Unknown,-1943546.0
Unknown,"100,00",Unknown,"100,00",Unknown,Unknown,Unknown,Deliveroo,Unknown,-1953546.0
Unknown,"150,00",Unknown,"150,00",Unknown,Unknown,Unknown,Deliveroo,Unknown,-1968546.0
Unknown,"34,09",Unknown,"34,09",Unknown,Unknown,Unknown,Deliveroo,Unknown,-1971955.0
Unknown,"0,52",Unknown,"0,52",Unknown,Unknown,Unknown,Deliveroo,Unknown,-1972007.0
Unknown,"0,03",Unknown,"0,03",Unknown,Unknown,Unknown,Deliveroo,Unknown,-1972010.0
Unknown,"1,63",Unknown,"1,63",Unknown,Unknown,Unknown,Deliveroo,Unknown,-1972173.0
Unknown,"0,56",Unknown,"0,56",Unknown,Unknown,Unknown,Deliveroo,Unknown,-1972229.0
Unknown,"0,95",Unknown,"0,95",Unknown,Unknown,Unknown,Deliveroo,Unknown,-1972324.0
Unknown,"0,02",Unknown,"0,02",Unknown,Unknown,Unknown,Deliveroo,Unknown,-1972326.0
Unknown,"0,23",Unknown,"0,23",Unknown,Unknown,Unknown,Deliveroo,Unknown,-1972349.0
Unknown,"0,15",Unknown,"0,15",Unknown,Unknown,Unknown,Deliveroo,Unknown,-1972364.0
Unknown,1,Unknown,1,Unknown,Unknown,Unknown,Deliveroo,Unknown,-1972365.0
Unknown,8,Unknown,8,Unknown,Unknown,Unknown,Deliveroo,Unknown,-1972373.0
Unknown,"97,20",Unknown,"97,20",Unknown,Unknown,Unknown,Deliveroo,Unknown,-1982093.0
Unknown,"653,26",Unknown,"653,26",Unknown,Unknown,Unknown,Deliveroo,Unknown,-2047419.0
Unknown,"19,50",Unknown,"19,50",Unknown,Unknown,Unknown,Deliveroo,Unknown,-2049369.0
Unknown,"83,15",Unknown,"83,15",Unknown,Unknown,Unknown,Deliveroo,Unknown,-2057684.0
19/07/2021,40,Unknown,40,Unknown,Unknown,Unknown,EPI SERVICE PRIMEUR,Titulaire(s,-40.0
19/07/2021,8,Unknown,8,Unknown,Unknown,Unknown,EPI SERVICE PRIMEUR,Page 5/11 Crédit Mutuel,-48.0
19/07/2021,5,Unknown,5,Unknown,Unknown,Unknown,EPI SERVICE PRIMEUR,Date Date de Valeur,-53.0
19/07/2021,11,Unknown,11,Unknown,Unknown,Unknown,EPI SERVICE PRIMEUR,Bretagne UR 537000000543170617,-64.0
19/07/2021,19,Unknown,19,Unknown,Unknown,Unknown,EPI SERVICE PRIMEUR,Bretagne UR,-83.0
19/07/2021,07 19,Unknown,07 19,Unknown,Unknown,Unknown,EPI SERVICE PRIMEUR,AVR 21753759570000160721,-802.0
20/07/2021,07,Unknown,07,Unknown,Unknown,Unknown,EPI SERVICE PRIMEUR,Bretagne UR,-809.0
19/07/2021,19,Unknown,19,Unknown,Unknown,Unknown,EPI SERVICE PRIMEUR,MAI 21753759570000160721,-828.0
19/07/2021,07,Unknown,07,Unknown,Unknown,Unknown,EPI SERVICE PRIMEUR,REMISE,-835.0
20/07/2021,19,Unknown,19,Unknown,Unknown,Unknown,EPI SERVICE PRIMEUR,TPV,-854.0
20/07/2021,07,Unknown,07,Unknown,Unknown,Unknown,EPI SERVICE PRIMEUR,REMISE,-861.0
20/07/2021,19,Unknown,19,Unknown,Unknown,Unknown,EPI SERVICE PRIMEUR,TPV,-880.0
20/07/2021,07,Unknown,07,Unknown,Unknown,Unknown,EPI SERVICE PRIMEUR,REMISE,-887.0
20/07/2021,19,Unknown,19,Unknown,Unknown,Unknown,EPI SERVICE PRIMEUR,TPV,-906.0
20/07/2021,07,Unknown,07,Unknown,Unknown,Unknown,EPI SERVICE PRIMEUR,REMISE,-913.0
20/07/2021,19,Unknown,19,Unknown,Unknown,Unknown,EPI SERVICE PRIMEUR,TPV,-932.0
20/07/2021,07,Unknown,07,Unknown,Unknown,Unknown,EPI SERVICE PRIMEUR,REMISE,-939.0
20/07/2021,20,Unknown,20,Unknown,Unknown,Unknown,EPI SERVICE PRIMEUR,TPV,-959.0
20/07/2021,07,Unknown,07,Unknown,Unknown,Unknown,EPI SERVICE PRIMEUR,CARTE,-966.0
20/07/2021,19,Unknown,19,Unknown,Unknown,Unknown,EPI SERVICE PRIMEUR,PEAGE AUTOROUTE,-985.0
20/07/2021,07,Unknown,07,Unknown,Unknown,Unknown,EPI SERVICE PRIMEUR,CARTE,-992.0
20/07/2021,19,Unknown,19,Unknown,Unknown,Unknown,EPI SERVICE PRIMEUR,Sapn,-1011.0
20/07/2021,07,Unknown,07,Unknown,Unknown,Unknown,EPI SERVICE PRIMEUR,GRAND CO,-1018.0
20/07/2021,20,Unknown,20,Unknown,Unknown,Unknown,EPI SERVICE PRIMEUR,CARTE,-1038.0
20/07/2021,07,Unknown,07,Unknown,Unknown,Unknown,EPI SERVICE PRIMEUR,CARTE,-1045.0
20/07/2021,20,Unknown,20,Unknown,Unknown,Unknown,EPI SERVICE PRIMEUR,CARTE,-1065.0
20/07/2021,07,Unknown,07,Unknown,Unknown,Unknown,EPI SERVICE PRIMEUR,PARIS 20/07/2021 COM,-1072.0
20/07/2021,20,Unknown,20,Unknown,Unknown,Unknown,EPI SERVICE PRIMEUR,CARTES,-1092.0
21/07/2021,07,Unknown,07,Unknown,Unknown,Unknown,EPI SERVICE PRIMEUR,COM,-1099.0
21/07/2021,18,Unknown,18,Unknown,Unknown,Unknown,EPI SERVICE PRIMEUR,CARTES,-1117.0
21/07/2021,07,Unknown,07,Unknown,Unknown,Unknown,EPI SERVICE PRIMEUR,COM,-1124.0
Unknown,20,Unknown,20,Unknown,Unknown,Unknown,EPI SERVICE PRIMEUR,CARTES 0386405,-1144.0
Unknown,07,Unknown,07,Unknown,Unknown,Unknown,EPI SERVICE PRIMEUR,COM,-1151.0
Unknown,18,Unknown,18,Unknown,Unknown,Unknown,EPI SERVICE PRIMEUR,CARTES,-1169.0
Unknown,07,Unknown,07,Unknown,Unknown,Unknown,EPI SERVICE PRIMEUR,COM,-1176.0
Unknown,20,Unknown,20,Unknown,Unknown,Unknown,EPI SERVICE PRIMEUR,CARTES,-1196.0
Unknown,07,Unknown,07,Unknown,Unknown,Unknown,EPI SERVICE PRIMEUR,COM,-1203.0
Unknown,18,Unknown,18,Unknown,Unknown,Unknown,EPI SERVICE PRIMEUR,CARTES 0386405,-1221.0
Unknown,07,Unknown,07,Unknown,Unknown,Unknown,EPI SERVICE PRIMEUR,GERE ET025137103,-1228.0
Unknown,20,Unknown,20,Unknown,Unknown,Unknown,EPI SERVICE PRIMEUR,FR67010451697 973C7349C0574126A157041022321014,-1248.0
Unknown,07,Unknown,07,Unknown,Unknown,Unknown,EPI SERVICE PRIMEUR,REMISE,-1255.0
Unknown,19,Unknown,19,Unknown,Unknown,Unknown,EPI SERVICE PRIMEUR,REMISE,-1274.0
Unknown,07,Unknown,07,Unknown,Unknown,Unknown,EPI SERVICE PRIMEUR,TPV,-1281.0
Unknown,20,Unknown,20,Unknown,Unknown,Unknown,EPI SERVICE PRIMEUR,REMISE,-1301.0
Unknown,07,Unknown,07,Unknown,Unknown,Unknown,EPI SERVICE PRIMEUR,TPV,-1308.0
Unknown,19,Unknown,19,Unknown,Unknown,Unknown,EPI SERVICE PRIMEUR,REMISE,-1327.0
Unknown,07,Unknown,07,Unknown,Unknown,Unknown,EPI SERVICE PRIMEUR,TPV,-1334.0
Unknown,20,Unknown,20,Unknown,Unknown,Unknown,EPI SERVICE PRIMEUR,CARTE,-1354.0
Unknown,07,Unknown,07,Unknown,Unknown,Unknown,EPI SERVICE PRIMEUR,COM,-1361.0
Unknown,64,Unknown,64,Unknown,Unknown,Unknown,EPI SERVICE PRIMEUR,CARTES,-1425.0
Unknown,20,Unknown,20,Unknown,Unknown,Unknown,EPI SERVICE PRIMEUR,COM,-1445.0
Unknown,07,Unknown,07,Unknown,Unknown,Unknown,EPI SERVICE PRIMEUR,CARTES,-1452.0
Unknown,01,Unknown,01,Unknown,Unknown,Unknown,EPI SERVICE PRIMEUR,Unknown,-1453.0
Unknown,20,Unknown,20,Unknown,Unknown,Unknown,EPI SERVICE PRIMEUR,Unknown,-1473.0
Unknown,07,Unknown,07,Unknown,Unknown,Unknown,EPI SERVICE PRIMEUR,Unknown,-1480.0
Unknown,64,Unknown,64,Unknown,Unknown,Unknown,EPI SERVICE PRIMEUR,Unknown,-1544.0
Unknown,20,Unknown,20,Unknown,Unknown,Unknown,EPI SERVICE PRIMEUR,Unknown,-1564.0
Unknown,07,Unknown,07,Unknown,Unknown,Unknown,EPI SERVICE PRIMEUR,Unknown,-1571.0
Unknown,01,Unknown,01,Unknown,Unknown,Unknown,EPI SERVICE PRIMEUR,Unknown,-1572.0
Unknown,20,Unknown,20,Unknown,Unknown,Unknown,EPI SERVICE PRIMEUR,Unknown,-1592.0
Unknown,07,Unknown,07,Unknown,Unknown,Unknown,EPI SERVICE PRIMEUR,Unknown,-1599.0
Unknown,64,Unknown,64,Unknown,Unknown,Unknown,EPI SERVICE PRIMEUR,Unknown,-1663.0
Unknown,20,Unknown,20,Unknown,Unknown,Unknown,EPI SERVICE PRIMEUR,Unknown,-1683.0
Unknown,07,Unknown,07,Unknown,Unknown,Unknown,EPI SERVICE PRIMEUR,Unknown,-1690.0
Unknown,64,Unknown,64,Unknown,Unknown,Unknown,EPI SERVICE PRIMEUR,Unknown,-1754.0
Unknown,20,Unknown,20,Unknown,Unknown,Unknown,EPI SERVICE PRIMEUR,Unknown,-1774.0
Unknown,07,Unknown,07,Unknown,Unknown,Unknown,EPI SERVICE PRIMEUR,Unknown,-1781.0
Unknown,20,Unknown,20,Unknown,Unknown,Unknown,EPI SERVICE PRIMEUR,Unknown,-1801.0
Unknown,07,Unknown,07,Unknown,Unknown,Unknown,EPI SERVICE PRIMEUR,Unknown,-1808.0
Unknown,20,Unknown,20,Unknown,Unknown,Unknown,EPI SERVICE PRIMEUR,Unknown,-1828.0
Unknown,07,Unknown,07,Unknown,Unknown,Unknown,EPI SERVICE PRIMEUR,Unknown,-1835.0
Unknown,20,Unknown,20,Unknown,Unknown,Unknown,EPI SERVICE PRIMEUR,Unknown,-1855.0
Unknown,07,Unknown,07,Unknown,Unknown,Unknown,EPI SERVICE PRIMEUR,Unknown,-1862.0
Unknown,20,Unknown,20,Unknown,Unknown,Unknown,EPI SERVICE PRIMEUR,Unknown,-1882.0
Unknown,07,Unknown,07,Unknown,Unknown,Unknown,EPI SERVICE PRIMEUR,Unknown,-1889.0
Unknown,20,Unknown,20,Unknown,Unknown,Unknown,EPI SERVICE PRIMEUR,Unknown,-1909.0
Unknown,07,Unknown,07,Unknown,Unknown,Unknown,EPI SERVICE PRIMEUR,Unknown,-1916.0
Unknown,21,Unknown,21,Unknown,Unknown,Unknown,EPI SERVICE PRIMEUR,Unknown,-1937.0
Unknown,07,Unknown,07,Unknown,Unknown,Unknown,EPI SERVICE PRIMEUR,Unknown,-1944.0
Unknown,20,Unknown,20,Unknown,Unknown,Unknown,EPI SERVICE PRIMEUR,Unknown,-1964.0
Unknown,07,Unknown,07,Unknown,Unknown,Unknown,EPI SERVICE PRIMEUR,Unknown,-1971.0
Unknown,8 21,Unknown,8 21,Unknown,Unknown,Unknown,EPI SERVICE PRIMEUR,Unknown,-2792.0
Unknown,07,Unknown,07,Unknown,Unknown,Unknown,EPI SERVICE PRIMEUR,Unknown,-2799.0
Unknown,64,Unknown,64,Unknown,Unknown,Unknown,EPI SERVICE PRIMEUR,Unknown,-2863.0
Unknown,21,Unknown,21,Unknown,Unknown,Unknown,EPI SERVICE PRIMEUR,Unknown,-2884.0
Unknown,07,Unknown,07,Unknown,Unknown,Unknown,EPI SERVICE PRIMEUR,Unknown,-2891.0
Unknown,01,Unknown,01,Unknown,Unknown,Unknown,EPI SERVICE PRIMEUR,Unknown,-2892.0
Unknown,"467,99",Unknown,"467,99",Unknown,Unknown,Unknown,EPI SERVICE PRIMEUR,Unknown,-49691.0
Unknown,19,Unknown,19,Unknown,Unknown,Unknown,EPI SERVICE PRIMEUR,Unknown,-49710.0
Unknown,"07 491,00",Unknown,"07 491,00",Unknown,Unknown,Unknown,EPI SERVICE PRIMEUR,Unknown,-798810.0
Unknown,19,Unknown,19,Unknown,Unknown,Unknown,EPI SERVICE PRIMEUR,Unknown,-798829.0
Unknown,"07 491,00",Unknown,"07 491,00",Unknown,Unknown,Unknown,EPI SERVICE PRIMEUR,Unknown,-1547929.0
Unknown,19,Unknown,19,Unknown,Unknown,Unknown,EPI SERVICE PRIMEUR,Unknown,-1547948.0
Unknown,"07 491,00",Unknown,"07 491,00",Unknown,Unknown,Unknown,EPI SERVICE PRIMEUR,Unknown,-2297048.0
Unknown,20,Unknown,20,Unknown,Unknown,Unknown,EPI SERVICE PRIMEUR,Unknown,-2297068.0
Unknown,07 20,Unknown,07 20,Unknown,Unknown,Unknown,EPI SERVICE PRIMEUR,Unknown,-2297788.0
Unknown,07 20,Unknown,07 20,Unknown,Unknown,Unknown,EPI SERVICE PRIMEUR,Unknown,-2298508.0
Unknown,07 20,Unknown,07 20,Unknown,Unknown,Unknown,EPI SERVICE PRIMEUR,Unknown,-2299228.0
Unknown,07 20,Unknown,07 20,Unknown,Unknown,Unknown,EPI SERVICE PRIMEUR,Unknown,-2299948.0
Unknown,07 20,Unknown,07 20,Unknown,Unknown,Unknown,EPI SERVICE PRIMEUR,Unknown,-2300668.0
Unknown,07 20,Unknown,07 20,Unknown,Unknown,Unknown,EPI SERVICE PRIMEUR,Unknown,-2301388.0
Unknown,07 20,Unknown,07 20,Unknown,Unknown,Unknown,EPI SERVICE PRIMEUR,Unknown,-2302108.0
Unknown,07 20,Unknown,07 20,Unknown,Unknown,Unknown,EPI SERVICE PRIMEUR,Unknown,-2302828.0
Unknown,07 20,Unknown,07 20,Unknown,Unknown,Unknown,EPI SERVICE PRIMEUR,Unknown,-2303548.0
Unknown,07 20,Unknown,07 20,Unknown,Unknown,Unknown,EPI SERVICE PRIMEUR,Unknown,-2304268.0
Unknown,07 20,Unknown,07 20,Unknown,Unknown,Unknown,EPI SERVICE PRIMEUR,Unknown,-2304988.0
Unknown,07 20,Unknown,07 20,Unknown,Unknown,Unknown,EPI SERVICE PRIMEUR,Unknown,-2305708.0
Unknown,07 20,Unknown,07 20,Unknown,Unknown,Unknown,EPI SERVICE PRIMEUR,Unknown,-2306428.0
Unknown,07 20,Unknown,07 20,Unknown,Unknown,Unknown,EPI SERVICE PRIMEUR,Unknown,-2307148.0
Unknown,07 20,Unknown,07 20,Unknown,Unknown,Unknown,EPI SERVICE PRIMEUR,Unknown,-2307868.0
Unknown,07 20,Unknown,07 20,Unknown,Unknown,Unknown,EPI SERVICE PRIMEUR,Unknown,-2308588.0
Unknown,07 20,Unknown,07 20,Unknown,Unknown,Unknown,EPI SERVICE PRIMEUR,Unknown,-2309308.0
Unknown,07 20,Unknown,07 20,Unknown,Unknown,Unknown,EPI SERVICE PRIMEUR,Unknown,-2310028.0
Unknown,07 18,Unknown,07 18,Unknown,Unknown,Unknown,EPI SERVICE PRIMEUR,Unknown,-2310746.0
Unknown,"60 274,70",Unknown,"60 274,70",Unknown,Unknown,Unknown,EPI SERVICE PRIMEUR,Unknown,-8338216.0
Unknown,"71,50",Unknown,"71,50",Unknown,Unknown,Unknown,EPI SERVICE PRIMEUR,Unknown,-8345366.0
Unknown,"84,50",Unknown,"84,50",Unknown,Unknown,Unknown,EPI SERVICE PRIMEUR,Unknown,-8353816.0
Unknown,"147,30",Unknown,"147,30",Unknown,Unknown,Unknown,EPI SERVICE PRIMEUR,Unknown,-8368546.0
Unknown,"83,50",Unknown,"83,50",Unknown,Unknown,Unknown,EPI SERVICE PRIMEUR,Unknown,-8376896.0
Unknown,"40,32",Unknown,"40,32",Unknown,Unknown,Unknown,EPI SERVICE PRIMEUR,Unknown,-8380928.0
Unknown,"7,70",Unknown,"7,70",Unknown,Unknown,Unknown,EPI SERVICE PRIMEUR,Unknown,-8381698.0
Unknown,"11,50",Unknown,"11,50",Unknown,Unknown,Unknown,EPI SERVICE PRIMEUR,Unknown,-8382848.0
Unknown,"29,50",Unknown,"29,50",Unknown,Unknown,Unknown,EPI SERVICE PRIMEUR,Unknown,-8385798.0
Unknown,"000,00",Unknown,"000,00",Unknown,Unknown,Unknown,EPI SERVICE PRIMEUR,Unknown,-8385798.0
Unknown,"100,00",Unknown,"100,00",Unknown,Unknown,Unknown,EPI SERVICE PRIMEUR,Unknown,-8395798.0
Unknown,"1,74",Unknown,"1,74",Unknown,Unknown,Unknown,EPI SERVICE PRIMEUR,Unknown,-8395972.0
Unknown,"2,10",Unknown,"2,10",Unknown,Unknown,Unknown,EPI SERVICE PRIMEUR,Unknown,-8396182.0
Unknown,"1,08",Unknown,"1,08",Unknown,Unknown,Unknown,EPI SERVICE PRIMEUR,Unknown,-8396290.0
Unknown,"0,24",Unknown,"0,24",Unknown,Unknown,Unknown,EPI SERVICE PRIMEUR,Unknown,-8396314.0
Unknown,"0,80",Unknown,"0,80",Unknown,Unknown,Unknown,EPI SERVICE PRIMEUR,Unknown,-8396394.0
Unknown,"0,06",Unknown,"0,06",Unknown,Unknown,Unknown,EPI SERVICE PRIMEUR,Unknown,-8396400.0
Unknown,"112,26",Unknown,"112,26",Unknown,Unknown,Unknown,EPI SERVICE PRIMEUR,Unknown,-8407626.0
Unknown,20,Unknown,20,Unknown,Unknown,Unknown,EPI SERVICE PRIMEUR,Unknown,-8407646.0
Unknown,"07 613,58",Unknown,"07 613,58",Unknown,Unknown,Unknown,EPI SERVICE PRIMEUR,Unknown,-9169004.0
Unknown,1 21,Unknown,1 21,Unknown,Unknown,Unknown,EPI SERVICE PRIMEUR,Unknown,-9169125.0
Unknown,07,Unknown,07,Unknown,Unknown,Unknown,EPI SERVICE PRIMEUR,Unknown,-9169132.0
Unknown,21,Unknown,21,Unknown,Unknown,Unknown,EPI SERVICE PRIMEUR,Unknown,-9169153.0
Unknown,07 21,Unknown,07 21,Unknown,Unknown,Unknown,EPI SERVICE PRIMEUR,Unknown,-9169874.0
Unknown,07,Unknown,07,Unknown,Unknown,Unknown,EPI SERVICE PRIMEUR,Unknown,-9169881.0
Unknown,21,Unknown,21,Unknown,Unknown,Unknown,EPI SERVICE PRIMEUR,Unknown,-9169902.0
Unknown,07,Unknown,07,Unknown,Unknown,Unknown,EPI SERVICE PRIMEUR,Unknown,-9169909.0
Unknown,8 21,Unknown,8 21,Unknown,Unknown,Unknown,EPI SERVICE PRIMEUR,Unknown,-9170730.0
Unknown,07,Unknown,07,Unknown,Unknown,Unknown,EPI SERVICE PRIMEUR,Unknown,-9170737.0
Unknown,8 21,Unknown,8 21,Unknown,Unknown,Unknown,EPI SERVICE PRIMEUR,Unknown,-9171558.0
Unknown,07,Unknown,07,Unknown,Unknown,Unknown,EPI SERVICE PRIMEUR,Unknown,-9171565.0
Unknown,21,Unknown,21,Unknown,Unknown,Unknown,EPI SERVICE PRIMEUR,Unknown,-9171586.0
Unknown,07 70,Unknown,07 70,Unknown,Unknown,Unknown,EPI SERVICE PRIMEUR,Unknown,-9172356.0
Unknown,"90 244,20",Unknown,"90 244,20",Unknown,Unknown,Unknown,EPI SERVICE PRIMEUR,Unknown,-18196776.0
Unknown,"60,90",Unknown,"60,90",Unknown,Unknown,Unknown,EPI SERVICE PRIMEUR,Unknown,-18202866.0
Unknown,"329,20",Unknown,"329,20",Unknown,Unknown,Unknown,EPI SERVICE PRIMEUR,Unknown,-18235786.0
Unknown,"19,99",Unknown,"19,99",Unknown,Unknown,Unknown,EPI SERVICE PRIMEUR,Unknown,-18237785.0
Unknown,"1,96",Unknown,"1,96",Unknown,Unknown,Unknown,EPI SERVICE PRIMEUR,Unknown,-18237981.0
Unknown,"1,23",Unknown,"1,23",Unknown,Unknown,Unknown,EPI SERVICE PRIMEUR,Unknown,-18238104.0
01/08/2021,01,Unknown,01,Unknown,Cheque,Unknown,Transactions,Relevés bancaires,-1.0
31/08/2021,08,Unknown,08,Unknown,Cheque,Unknown,Transactions,Du,-9.0
01/08/2021,31,Unknown,31,Unknown,Cheque,Unknown,Transactions,EGB 2,-40.0
31/08/2021,08,Unknown,08,Unknown,Cheque,Unknown,Transactions,Coulommiers,-48.0
Unknown,2,Unknown,2,Unknown,Cheque,Unknown,Transactions,France Solde,-50.0
Unknown,01,Unknown,01,Unknown,Cheque,Unknown,Transactions,Entrées,-51.0
Unknown,08,Unknown,08,Unknown,Cheque,Unknown,Transactions,Sorties IBAN,-59.0
Unknown,"1 055,55",Unknown,"1 055,55",Unknown,Cheque,Unknown,Transactions,QNTOFRPIXXX Solde,-105614.0
Unknown,"1 626,00",Unknown,"1 626,00",Unknown,Cheque,Unknown,Transactions,Date,-268214.0
Unknown,"2 555,93",Unknown,"2 555,93",Unknown,Cheque,Unknown,Transactions,SOURDUNE FR,-523807.0
Unknown,205,Unknown,205,Unknown,Cheque,Unknown,Transactions,ANAIS,-524012.0
Unknown,31,Unknown,31,Unknown,Cheque,Unknown,Transactions,FERTE G FR,-524043.0
Unknown,"08 125,62",Unknown,"08 125,62",Unknown,Cheque,Unknown,Transactions,LECLERC,-1336605.0
Unknown,01,Unknown,01,Unknown,Cheque,Unknown,Transactions,DELICES 77,-1336606.0
Unknown,08,Unknown,08,Unknown,Cheque,Unknown,Transactions,LA POSTE 779240,-1336614.0
Unknown,"42,00",Unknown,"42,00",Unknown,Cheque,Unknown,Transactions,TEMPLIERS,-1340814.0
Unknown,03,Unknown,03,Unknown,Cheque,Unknown,Transactions,LECLERC,-1340817.0
Unknown,08,Unknown,08,Unknown,Cheque,Unknown,Transactions,MC DONALD'S COULOMMIER,-1340825.0
Unknown,"88,09",Unknown,"88,09",Unknown,Cheque,Unknown,Transactions,HERVE Depot,-1349634.0
Unknown,03,Unknown,03,Unknown,Cheque,Unknown,Transactions,MAGNANI Depot,-1349637.0
Unknown,08,Unknown,08,Unknown,Cheque,Unknown,Transactions,Qonto,-1349645.0
Unknown,"110,00",Unknown,"110,00",Unknown,Cheque,Unknown,Transactions,Frais,-1360645.0
Unknown,03,Unknown,03,Unknown,Cheque,Unknown,Transactions,EGB,-1360648.0
Unknown,08,Unknown,08,Unknown,Cheque,Unknown,Transactions,Unknown,-1360656.0
Unknown,"15,00",Unknown,"15,00",Unknown,Cheque,Unknown,Transactions,Unknown,-1362156.0
Unknown,03,Unknown,03,Unknown,Cheque,Unknown,Transactions,Unknown,-1362159.0
Unknown,08,Unknown,08,Unknown,Cheque,Unknown,Transactions,Unknown,-1362167.0
Unknown,0,Unknown,0,Unknown,Cheque,Unknown,Transactions,Unknown,-1362167.0
Unknown,"17,00",Unknown,"17,00",Unknown,Cheque,Unknown,Transactions,Unknown,-1363867.0
Unknown,04,Unknown,04,Unknown,Cheque,Unknown,Transactions,Unknown,-1363871.0
Unknown,08,Unknown,08,Unknown,Cheque,Unknown,Transactions,Unknown,-1363879.0
Unknown,"100,00",Unknown,"100,00",Unknown,Cheque,Unknown,Transactions,Unknown,-1373879.0
Unknown,04,Unknown,04,Unknown,Cheque,Unknown,Transactions,Unknown,-1373883.0
Unknown,08,Unknown,08,Unknown,Cheque,Unknown,Transactions,Unknown,-1373891.0
Unknown,77,Unknown,77,Unknown,Cheque,Unknown,Transactions,Unknown,-1373968.0
Unknown,"28,00",Unknown,"28,00",Unknown,Cheque,Unknown,Transactions,Unknown,-1376768.0
Unknown,05,Unknown,05,Unknown,Cheque,Unknown,Transactions,Unknown,-1376773.0
Unknown,08,Unknown,08,Unknown,Cheque,Unknown,Transactions,Unknown,-1376781.0
Unknown,"1,76",Unknown,"1,76",Unknown,Cheque,Unknown,Transactions,Unknown,-1376957.0
Unknown,05,Unknown,05,Unknown,Cheque,Unknown,Transactions,Unknown,-1376962.0
Unknown,08,Unknown,08,Unknown,Cheque,Unknown,Transactions,Unknown,-1376970.0
Unknown,"79,78",Unknown,"79,78",Unknown,Cheque,Unknown,Transactions,Unknown,-1384948.0
Unknown,05,Unknown,05,Unknown,Cheque,Unknown,Transactions,Unknown,-1384953.0
Unknown,08,Unknown,08,Unknown,Cheque,Unknown,Transactions,Unknown,-1384961.0
Unknown,"103,72",Unknown,"103,72",Unknown,Cheque,Unknown,Transactions,Unknown,-1395333.0
Unknown,06,Unknown,06,Unknown,Cheque,Unknown,Transactions,Unknown,-1395339.0
Unknown,08,Unknown,08,Unknown,Cheque,Unknown,Transactions,Unknown,-1395347.0
Unknown,"294,87",Unknown,"294,87",Unknown,Cheque,Unknown,Transactions,Unknown,-1424834.0
Unknown,06,Unknown,06,Unknown,Cheque,Unknown,Transactions,Unknown,-1424840.0
Unknown,08,Unknown,08,Unknown,Cheque,Unknown,Transactions,Unknown,-1424848.0
Unknown,"35,00",Unknown,"35,00",Unknown,Cheque,Unknown,Transactions,Unknown,-1428348.0
Unknown,06,Unknown,06,Unknown,Cheque,Unknown,Transactions,Unknown,-1428354.0
Unknown,08,Unknown,08,Unknown,Cheque,Unknown,Transactions,Unknown,-1428362.0
Unknown,"22,50",Unknown,"22,50",Unknown,Cheque,Unknown,Transactions,Unknown,-1430612.0
Unknown,09,Unknown,09,Unknown,Cheque,Unknown,Transactions,Unknown,-1430621.0
Unknown,08,Unknown,08,Unknown,Cheque,Unknown,Transactions,Unknown,-1430629.0
Unknown,"336,00",Unknown,"336,00",Unknown,Cheque,Unknown,Transactions,Unknown,-1464229.0
Unknown,09,Unknown,09,Unknown,Cheque,Unknown,Transactions,Unknown,-1464238.0
Unknown,08,Unknown,08,Unknown,Cheque,Unknown,Transactions,Unknown,-1464246.0
Unknown,"240,00",Unknown,"240,00",Unknown,Cheque,Unknown,Transactions,Unknown,-1488246.0
Unknown,09,Unknown,09,Unknown,Cheque,Unknown,Transactions,Unknown,-1488255.0
Unknown,08,Unknown,08,Unknown,Cheque,Unknown,Transactions,Unknown,-1488263.0
Unknown,"144,00",Unknown,"144,00",Unknown,Cheque,Unknown,Transactions,Unknown,-1502663.0
Unknown,09,Unknown,09,Unknown,Cheque,Unknown,Transactions,Unknown,-1502672.0
Unknown,08,Unknown,08,Unknown,Cheque,Unknown,Transactions,Unknown,-1502680.0
Unknown,"2,40",Unknown,"2,40",Unknown,Cheque,Unknown,Transactions,Unknown,-1502920.0
Unknown,01,Unknown,01,Unknown,Cheque,Unknown,Transactions,Unknown,-1502921.0
Unknown,08,Unknown,08,Unknown,Cheque,Unknown,Transactions,Unknown,-1502929.0
Unknown,31,Unknown,31,Unknown,Cheque,Unknown,Transactions,Unknown,-1502960.0
Unknown,08,Unknown,08,Unknown,Cheque,Unknown,Transactions,Unknown,-1502968.0
Unknown,205,Unknown,205,Unknown,Cheque,Unknown,Transactions,Unknown,-1503173.0
Unknown,1,Unknown,1,Unknown,Cheque,Unknown,Transactions,Unknown,-1503174.0
Unknown,3,Unknown,3,Unknown,Cheque,Unknown,Transactions,Unknown,-1503177.0
01/08/2021,Unknown,09,Unknown,Unknown,Cheque,Unknown,VIVA,Oonto,9.0
31/08/2021,Unknown,08,Unknown,Unknown,Cheque,Unknown,VIVA,Abonnement Frais,17.0
Unknown,Unknown,"2,40",Unknown,Unknown,Cheque,Unknown,VIVA,Oonto,257.0
Unknown,Unknown,09,Unknown,Unknown,Cheque,Unknown,VIVA,Abonnement,266.0
Unknown,Unknown,08,Unknown,Unknown,Cheque,Unknown,VIVA,Frais,274.0
Unknown,Unknown,"2,40",Unknown,Unknown,Cheque,Unknown,VIVA,P073087196,514.0
Unknown,Unknown,10,Unknown,Unknown,Cheque,Unknown,VIVA,ALVES,524.0
Unknown,Unknown,08,Unknown,Unknown,Cheque,Unknown,VIVA,Depôt,532.0
Unknown,Unknown,"29,99",Unknown,Unknown,Cheque,Unknown,VIVA,MIETTE,3531.0
Unknown,Unknown,10,Unknown,Unknown,Cheque,Unknown,VIVA,Depôt,3541.0
Unknown,Unknown,08,Unknown,Unknown,Cheque,Unknown,VIVA,FOUCHER Dépôt,3549.0
Unknown,Unknown,"255,00",Unknown,Unknown,Cheque,Unknown,VIVA,Oonto,29049.0
Unknown,Unknown,10,Unknown,Unknown,Cheque,Unknown,VIVA,Abonnement Frais,29059.0
Unknown,Unknown,08,Unknown,Unknown,Cheque,Unknown,VIVA,Oonto,29067.0
Unknown,Unknown,"376,00",Unknown,Unknown,Cheque,Unknown,VIVA,Abonnement Frais,66667.0
Unknown,Unknown,10,Unknown,Unknown,Cheque,Unknown,VIVA,Oonto,66677.0
Unknown,Unknown,08,Unknown,Unknown,Cheque,Unknown,VIVA,Abonnement,66685.0
Unknown,Unknown,"275,00",Unknown,Unknown,Cheque,Unknown,VIVA,Frais,94185.0
Unknown,Unknown,10,Unknown,Unknown,Cheque,Unknown,VIVA,SANEF SENLIS,94195.0
Unknown,Unknown,08,Unknown,Unknown,Cheque,Unknown,VIVA,NEWCO,94203.0
Unknown,Unknown,"2,40",Unknown,Unknown,Cheque,Unknown,VIVA,GERMIA LL PRISHTINA,94443.0
Unknown,Unknown,10,Unknown,Unknown,Cheque,Unknown,VIVA,ARSENAL 2,94453.0
Unknown,Unknown,08,Unknown,Unknown,Cheque,Unknown,VIVA,BEKA,94461.0
Unknown,Unknown,"2,40",Unknown,Unknown,Cheque,Unknown,VIVA,VIVA FRESH,94701.0
Unknown,Unknown,10,Unknown,Unknown,Cheque,Unknown,VIVA,BOUYGTEL VAD,94711.0
Unknown,Unknown,08,Unknown,Unknown,Cheque,Unknown,VIVA,BEKA,94719.0
Unknown,Unknown,"2,40",Unknown,Unknown,Cheque,Unknown,VIVA,EGB,94959.0
Unknown,Unknown,11,Unknown,Unknown,Cheque,Unknown,VIVA,Unknown,94970.0
Unknown,Unknown,08,Unknown,Unknown,Cheque,Unknown,VIVA,Unknown,94978.0
Unknown,Unknown,"22,50",Unknown,Unknown,Cheque,Unknown,VIVA,Unknown,97228.0
Unknown,Unknown,11,Unknown,Unknown,Cheque,Unknown,VIVA,Unknown,97239.0
Unknown,Unknown,08,Unknown,Unknown,Cheque,Unknown,VIVA,Unknown,97247.0
Unknown,Unknown,"7,60",Unknown,Unknown,Cheque,Unknown,VIVA,Unknown,98007.0
Unknown,Unknown,17,Unknown,Unknown,Cheque,Unknown,VIVA,Unknown,98024.0
Unknown,Unknown,08,Unknown,Unknown,Cheque,Unknown,VIVA,Unknown,98032.0
Unknown,Unknown,"86,00",Unknown,Unknown,Cheque,Unknown,VIVA,Unknown,106632.0
Unknown,Unknown,20,Unknown,Unknown,Cheque,Unknown,VIVA,Unknown,106652.0
Unknown,Unknown,08,Unknown,Unknown,Cheque,Unknown,VIVA,Unknown,106660.0
Unknown,Unknown,2,Unknown,Unknown,Cheque,Unknown,VIVA,Unknown,106662.0
Unknown,Unknown,"124,00",Unknown,Unknown,Cheque,Unknown,VIVA,Unknown,119062.0
Unknown,Unknown,23,Unknown,Unknown,Cheque,Unknown,VIVA,Unknown,119085.0
Unknown,Unknown,08,Unknown,Unknown,Cheque,Unknown,VIVA,Unknown,119093.0
Unknown,Unknown,"30,61",Unknown,Unknown,Cheque,Unknown,VIVA,Unknown,122154.0
Unknown,Unknown,23,Unknown,Unknown,Cheque,Unknown,VIVA,Unknown,122177.0
Unknown,Unknown,08,Unknown,Unknown,Cheque,Unknown,VIVA,Unknown,122185.0
Unknown,Unknown,"49,50",Unknown,Unknown,Cheque,Unknown,VIVA,Unknown,127135.0
Unknown,Unknown,23,Unknown,Unknown,Cheque,Unknown,VIVA,Unknown,127158.0
Unknown,Unknown,08,Unknown,Unknown,Cheque,Unknown,VIVA,Unknown,127166.0
Unknown,Unknown,"10,39",Unknown,Unknown,Cheque,Unknown,VIVA,Unknown,128205.0
Unknown,Unknown,24,Unknown,Unknown,Cheque,Unknown,VIVA,Unknown,128229.0
Unknown,Unknown,08,Unknown,Unknown,Cheque,Unknown,VIVA,Unknown,128237.0
Unknown,Unknown,"122,00",Unknown,Unknown,Cheque,Unknown,VIVA,Unknown,140437.0
Unknown,Unknown,24,Unknown,Unknown,Cheque,Unknown,VIVA,Unknown,140461.0
Unknown,Unknown,08,Unknown,Unknown,Cheque,Unknown,VIVA,Unknown,140469.0
Unknown,Unknown,"237,78",Unknown,Unknown,Cheque,Unknown,VIVA,Unknown,164247.0
Unknown,Unknown,24,Unknown,Unknown,Cheque,Unknown,VIVA,Unknown,164271.0
Unknown,Unknown,08,Unknown,Unknown,Cheque,Unknown,VIVA,Unknown,164279.0
Unknown,Unknown,"11,90",Unknown,Unknown,Cheque,Unknown,VIVA,Unknown,165469.0
Unknown,Unknown,24,Unknown,Unknown,Cheque,Unknown,VIVA,Unknown,165493.0
Unknown,Unknown,08,Unknown,Unknown,Cheque,Unknown,VIVA,Unknown,165501.0
Unknown,Unknown,"149,56",Unknown,Unknown,Cheque,Unknown,VIVA,Unknown,180457.0
Unknown,Unknown,26,Unknown,Unknown,Cheque,Unknown,VIVA,Unknown,180483.0
Unknown,Unknown,08,Unknown,Unknown,Cheque,Unknown,VIVA,Unknown,180491.0
Unknown,Unknown,"73,99",Unknown,Unknown,Cheque,Unknown,VIVA,Unknown,187890.0
Unknown,Unknown,26,Unknown,Unknown,Cheque,Unknown,VIVA,Unknown,187916.0
Unknown,Unknown,08,Unknown,Unknown,Cheque,Unknown,VIVA,Unknown,187924.0
Unknown,Unknown,"82,97",Unknown,Unknown,Cheque,Unknown,VIVA,Unknown,196221.0
Unknown,Unknown,26,Unknown,Unknown,Cheque,Unknown,VIVA,Unknown,196247.0
Unknown,Unknown,08,Unknown,Unknown,Cheque,Unknown,VIVA,Unknown,196255.0
Unknown,Unknown,"92,40",Unknown,Unknown,Cheque,Unknown,VIVA,Unknown,205495.0
Unknown,Unknown,26,Unknown,Unknown,Cheque,Unknown,VIVA,Unknown,205521.0
Unknown,Unknown,08,Unknown,Unknown,Cheque,Unknown,VIVA,Unknown,205529.0
Unknown,Unknown,"30,17",Unknown,Unknown,Cheque,Unknown,VIVA,Unknown,208546.0
Unknown,Unknown,01,Unknown,Unknown,Cheque,Unknown,VIVA,Unknown,208547.0
Unknown,Unknown,08,Unknown,Unknown,Cheque,Unknown,VIVA,Unknown,208555.0
Unknown,Unknown,31,Unknown,Unknown,Cheque,Unknown,VIVA,Unknown,208586.0
Unknown,Unknown,08,Unknown,Unknown,Cheque,Unknown,VIVA,Unknown,208594.0
Unknown,Unknown,205,Unknown,Unknown,Cheque,Unknown,VIVA,Unknown,208799.0
Unknown,Unknown,2,Unknown,Unknown,Cheque,Unknown,VIVA,Unknown,208801.0
Unknown,Unknown,3,Unknown,Unknown,Cheque,Unknown,VIVA,Unknown,208804.0
01/08/2021,Unknown,27,Unknown,Unknown,Unknown,Unknown,JP PUTEVI,Carte,27.0
31/08/2021,Unknown,08,Unknown,Unknown,Unknown,Unknown,JP PUTEVI,A3,35.0
Unknown,Unknown,13,Unknown,Unknown,Unknown,Unknown,JP PUTEVI,A3,48.0
Unknown,Unknown,117,Unknown,Unknown,Unknown,Unknown,JP PUTEVI,TOTALDALTYSA4,165.0
Unknown,Unknown,"1,00",Unknown,Unknown,Unknown,Unknown,JP PUTEVI,JP PUTEVI,265.0
Unknown,Unknown,"8,70",Unknown,Unknown,Unknown,Unknown,JP PUTEVI,SID,1135.0
Unknown,Unknown,"020,00",Unknown,Unknown,Unknown,Unknown,JP PUTEVI,SID,3135.0
Unknown,Unknown,28,Unknown,Unknown,Unknown,Unknown,JP PUTEVI,SANEF SENLIS,3163.0
Unknown,Unknown,08,Unknown,Unknown,Unknown,Unknown,JP PUTEVI,MC DONALD'S COULOMMIER,3171.0
Unknown,Unknown,1,Unknown,Unknown,Unknown,Unknown,JP PUTEVI,SANEF AUTOROUTE,3172.0
Unknown,Unknown,"17,15",Unknown,Unknown,Unknown,Unknown,JP PUTEVI,Qonto,4887.0
Unknown,Unknown,"128,00",Unknown,Unknown,Unknown,Unknown,JP PUTEVI,Apple Pay,17687.0
Unknown,Unknown,28,Unknown,Unknown,Unknown,Unknown,JP PUTEVI,Oonto,17715.0
Unknown,Unknown,08,Unknown,Unknown,Unknown,Unknown,JP PUTEVI,La Fayette,17723.0
Unknown,Unknown,7,Unknown,Unknown,Unknown,Unknown,JP PUTEVI,Paris RCS Paris,17730.0
Unknown,Unknown,1 00,Unknown,Unknown,Unknown,Unknown,JP PUTEVI,Olinda,17830.0
Unknown,Unknown,"0,94",Unknown,Unknown,Unknown,Unknown,JP PUTEVI,|'Autonte,17924.0
Unknown,Unknown,"7,00",Unknown,Unknown,Unknown,Unknown,JP PUTEVI,Contrôle Prudentiel,18624.0
Unknown,Unknown,29,Unknown,Unknown,Unknown,Unknown,JP PUTEVI,Resolution,18653.0
Unknown,Unknown,08,Unknown,Unknown,Unknown,Unknown,JP PUTEVI,ACPR)en,18661.0
Unknown,Unknown,0,Unknown,Unknown,Unknown,Unknown,JP PUTEVI,EGB,18661.0
Unknown,Unknown,"163,19",Unknown,Unknown,Unknown,Unknown,JP PUTEVI,Unknown,34980.0
Unknown,Unknown,30,Unknown,Unknown,Unknown,Unknown,JP PUTEVI,Unknown,35010.0
Unknown,Unknown,08,Unknown,Unknown,Unknown,Unknown,JP PUTEVI,Unknown,35018.0
Unknown,Unknown,"7,60",Unknown,Unknown,Unknown,Unknown,JP PUTEVI,Unknown,35778.0
Unknown,Unknown,30,Unknown,Unknown,Unknown,Unknown,JP PUTEVI,Unknown,35808.0
Unknown,Unknown,08,Unknown,Unknown,Unknown,Unknown,JP PUTEVI,Unknown,35816.0
Unknown,Unknown,"2,00",Unknown,Unknown,Unknown,Unknown,JP PUTEVI,Unknown,36016.0
Unknown,Unknown,30,Unknown,Unknown,Unknown,Unknown,JP PUTEVI,Unknown,36046.0
Unknown,Unknown,08,Unknown,Unknown,Unknown,Unknown,JP PUTEVI,Unknown,36054.0
Unknown,Unknown,"12,50",Unknown,Unknown,Unknown,Unknown,JP PUTEVI,Unknown,37304.0
Unknown,Unknown,31,Unknown,Unknown,Unknown,Unknown,JP PUTEVI,Unknown,37335.0
Unknown,Unknown,08,Unknown,Unknown,Unknown,Unknown,JP PUTEVI,Unknown,37343.0
Unknown,Unknown,3,Unknown,Unknown,Unknown,Unknown,JP PUTEVI,Unknown,37346.0
Unknown,Unknown,117,Unknown,Unknown,Unknown,Unknown,JP PUTEVI,Unknown,37463.0
Unknown,Unknown,1 00,Unknown,Unknown,Unknown,Unknown,JP PUTEVI,Unknown,37563.0
Unknown,Unknown,"3,58",Unknown,Unknown,Unknown,Unknown,JP PUTEVI,Unknown,37921.0
Unknown,Unknown,"420,00",Unknown,Unknown,Unknown,Unknown,JP PUTEVI,Unknown,79921.0
Unknown,Unknown,31,Unknown,Unknown,Unknown,Unknown,JP PUTEVI,Unknown,79952.0
Unknown,Unknown,08,Unknown,Unknown,Unknown,Unknown,JP PUTEVI,Unknown,79960.0
Unknown,Unknown,74,Unknown,Unknown,Unknown,Unknown,JP PUTEVI,Unknown,80034.0
Unknown,Unknown,"64,99",Unknown,Unknown,Unknown,Unknown,JP PUTEVI,Unknown,86533.0
Unknown,Unknown,31,Unknown,Unknown,Unknown,Unknown,JP PUTEVI,Unknown,86564.0
Unknown,Unknown,08,Unknown,Unknown,Unknown,Unknown,JP PUTEVI,Unknown,86572.0
Unknown,Unknown,"16,00",Unknown,Unknown,Unknown,Unknown,JP PUTEVI,Unknown,88172.0
Unknown,Unknown,31,Unknown,Unknown,Unknown,Unknown,JP PUTEVI,Unknown,88203.0
Unknown,Unknown,08,Unknown,Unknown,Unknown,Unknown,JP PUTEVI,Unknown,88211.0
Unknown,Unknown,"22,50",Unknown,Unknown,Unknown,Unknown,JP PUTEVI,Unknown,90461.0
Unknown,Unknown,31,Unknown,Unknown,Unknown,Unknown,JP PUTEVI,Unknown,90492.0
Unknown,Unknown,08,Unknown,Unknown,Unknown,Unknown,JP PUTEVI,Unknown,90500.0
Unknown,Unknown,"9,10",Unknown,Unknown,Unknown,Unknown,JP PUTEVI,Unknown,91410.0
Unknown,Unknown,31,Unknown,Unknown,Unknown,Unknown,JP PUTEVI,Unknown,91441.0
Unknown,Unknown,08,Unknown,Unknown,Unknown,Unknown,JP PUTEVI,Unknown,91449.0
Unknown,Unknown,"70,05",Unknown,Unknown,Unknown,Unknown,JP PUTEVI,Unknown,98454.0
Unknown,Unknown,31,Unknown,Unknown,Unknown,Unknown,JP PUTEVI,Unknown,98485.0
Unknown,Unknown,08,Unknown,Unknown,Unknown,Unknown,JP PUTEVI,Unknown,98493.0
Unknown,Unknown,"39,55",Unknown,Unknown,Unknown,Unknown,JP PUTEVI,Unknown,102448.0
Unknown,Unknown,31,Unknown,Unknown,Unknown,Unknown,JP PUTEVI,Unknown,102479.0
Unknown,Unknown,08,Unknown,Unknown,Unknown,Unknown,JP PUTEVI,Unknown,102487.0
Unknown,Unknown,"4,60",Unknown,Unknown,Unknown,Unknown,JP PUTEVI,Unknown,102947.0
Unknown,Unknown,250 995 35,Unknown,Unknown,Unknown,Unknown,JP PUTEVI,Unknown,25202482.0
Unknown,Unknown,20,Unknown,Unknown,Unknown,Unknown,JP PUTEVI,Unknown,25202502.0
Unknown,Unknown,819 489 626,Unknown,Unknown,Unknown,Unknown,JP PUTEVI,Unknown,844692128.0
Unknown,Unknown,01,Unknown,Unknown,Unknown,Unknown,JP PUTEVI,Unknown,844692129.0
Unknown,Unknown,08,Unknown,Unknown,Unknown,Unknown,JP PUTEVI,Unknown,844692137.0
Unknown,Unknown,31,Unknown,Unknown,Unknown,Unknown,JP PUTEVI,Unknown,844692168.0
Unknown,Unknown,08,Unknown,Unknown,Unknown,Unknown,JP PUTEVI,Unknown,844692176.0
Unknown,Unknown,205,Unknown,Unknown,Unknown,Unknown,JP PUTEVI,Unknown,844692381.0
Unknown,Unknown,3,Unknown,Unknown,Unknown,Unknown,JP PUTEVI,Unknown,844692384.0
Unknown,Unknown,3,Unknown,Unknown,Unknown,Unknown,JP PUTEVI,Unknown,844692387.0
Unknown,Unknown,1,Unknown,Unknown,Unknown,Unknown,Banque Inconnue,cid:22)(cid:23)(cid:24,1.0
Unknown,Unknown,2,Unknown,Unknown,Unknown,Unknown,Banque Inconnue,cid:15)(cid:2)(cid:1)(cid:2)(cid:34)(cid:34)(cid:34)(cid:19)(cid:33)(cid:37)(cid:2)(cid:44,3.0
Unknown,Unknown,3,Unknown,Unknown,Unknown,Unknown,Banque Inconnue,cid:25)(cid:24)(cid:26)(cid:27)(cid:28)(cid:2)(cid:28)(cid:3)(cid:16)(cid:32)(cid:2)(cid:17)(cid:32)(cid:33)(cid:34)(cid:2)(cid:35)(cid:18)(cid:18)(cid:18)(cid:2)(cid:18)(cid:17)(cid:33)(cid:35)(cid:2)(cid:17)(cid:1)(cid:36)(cid:37)(cid:2)(cid:33)(cid:35)(cid:33)(cid:1)(cid:2)(cid:1)(cid:18)(cid:34,6.0
Unknown,Unknown,2,Unknown,Unknown,Unknown,Unknown,Banque Inconnue,cid:24)(cid:25)(cid:29)(cid:28)(cid:2)(cid:38)(cid:8)(cid:10)(cid:11)(cid:28)(cid:3)(cid:39)(cid:17)(cid:40)(cid:40)(cid:40,8.0
Unknown,Unknown,4,Unknown,Unknown,Unknown,Unknown,Banque Inconnue,Unknown,12.0
Unknown,Unknown,5,Unknown,Unknown,Unknown,Unknown,Banque Inconnue,Unknown,17.0
Unknown,Unknown,6,Unknown,Unknown,Unknown,Unknown,Banque Inconnue,Unknown,23.0
Unknown,Unknown,7,Unknown,Unknown,Unknown,Unknown,Banque Inconnue,Unknown,30.0
Unknown,Unknown,8,Unknown,Unknown,Unknown,Unknown,Banque Inconnue,Unknown,38.0
Unknown,Unknown,9,Unknown,Unknown,Unknown,Unknown,Banque Inconnue,Unknown,47.0
Unknown,Unknown,10,Unknown,Unknown,Unknown,Unknown,Banque Inconnue,Unknown,57.0
Unknown,Unknown,11,Unknown,Unknown,Unknown,Unknown,Banque Inconnue,Unknown,68.0
Unknown,Unknown,9,Unknown,Unknown,Unknown,Unknown,Banque Inconnue,Unknown,77.0
Unknown,Unknown,12,Unknown,Unknown,Unknown,Unknown,Banque Inconnue,Unknown,89.0
Unknown,Unknown,13,Unknown,Unknown,Unknown,Unknown,Banque Inconnue,Unknown,102.0
Unknown,Unknown,2,Unknown,Unknown,Unknown,Unknown,Banque Inconnue,Unknown,104.0
Unknown,Unknown,6,Unknown,Unknown,Unknown,Unknown,Banque Inconnue,Unknown,110.0
Unknown,Unknown,14,Unknown,Unknown,Unknown,Unknown,Banque Inconnue,Unknown,124.0
Unknown,Unknown,15,Unknown,Unknown,Unknown,Unknown,Banque Inconnue,Unknown,139.0
Unknown,Unknown,7,Unknown,Unknown,Unknown,Unknown,Banque Inconnue,Unknown,146.0
Unknown,Unknown,16,Unknown,Unknown,Unknown,Unknown,Banque Inconnue,Unknown,162.0
Unknown,Unknown,17,Unknown,Unknown,Unknown,Unknown,Banque Inconnue,Unknown,179.0
Unknown,Unknown,18,Unknown,Unknown,Unknown,Unknown,Banque Inconnue,Unknown,197.0
Unknown,Unknown,16,Unknown,Unknown,Unknown,Unknown,Banque Inconnue,Unknown,213.0
Unknown,Unknown,19,Unknown,Unknown,Unknown,Unknown,Banque Inconnue,Unknown,232.0
Unknown,Unknown,18,Unknown,Unknown,Unknown,Unknown,Banque Inconnue,Unknown,250.0
Unknown,Unknown,20,Unknown,Unknown,Unknown,Unknown,Banque Inconnue,Unknown,270.0
Unknown,Unknown,16,Unknown,Unknown,Unknown,Unknown,Banque Inconnue,Unknown,286.0
Unknown,Unknown,20,Unknown,Unknown,Unknown,Unknown,Banque Inconnue,Unknown,306.0
Unknown,Unknown,17,Unknown,Unknown,Unknown,Unknown,Banque Inconnue,Unknown,323.0
Unknown,Unknown,7,Unknown,Unknown,Unknown,Unknown,Banque Inconnue,Unknown,330.0
Unknown,Unknown,9,Unknown,Unknown,Unknown,Unknown,Banque Inconnue,Unknown,339.0
Unknown,Unknown,15,Unknown,Unknown,Unknown,Unknown,Banque Inconnue,Unknown,354.0
Unknown,Unknown,7,Unknown,Unknown,Unknown,Unknown,Banque Inconnue,Unknown,361.0
Unknown,Unknown,21,Unknown,Unknown,Unknown,Unknown,Banque Inconnue,Unknown,382.0
Unknown,Unknown,17,Unknown,Unknown,Unknown,Unknown,Banque Inconnue,Unknown,399.0
Unknown,Unknown,18,Unknown,Unknown,Unknown,Unknown,Banque Inconnue,Unknown,417.0
Unknown,Unknown,16,Unknown,Unknown,Unknown,Unknown,Banque Inconnue,Unknown,433.0
Unknown,Unknown,19,Unknown,Unknown,Unknown,Unknown,Banque Inconnue,Unknown,452.0
Unknown,Unknown,18,Unknown,Unknown,Unknown,Unknown,Banque Inconnue,Unknown,470.0
Unknown,Unknown,20,Unknown,Unknown,Unknown,Unknown,Banque Inconnue,Unknown,490.0
Unknown,Unknown,16,Unknown,Unknown,Unknown,Unknown,Banque Inconnue,Unknown,506.0
Unknown,Unknown,20,Unknown,Unknown,Unknown,Unknown,Banque Inconnue,Unknown,526.0
Unknown,Unknown,17,Unknown,Unknown,Unknown,Unknown,Banque Inconnue,Unknown,543.0
Unknown,Unknown,22,Unknown,Unknown,Unknown,Unknown,Banque Inconnue,Unknown,565.0
Unknown,Unknown,23,Unknown,Unknown,Unknown,Unknown,Banque Inconnue,Unknown,588.0
Unknown,Unknown,24,Unknown,Unknown,Unknown,Unknown,Banque Inconnue,Unknown,612.0
Unknown,Unknown,30,Unknown,Unknown,Unknown,Unknown,Banque Inconnue,Unknown,642.0
Unknown,Unknown,31,Unknown,Unknown,Unknown,Unknown,Banque Inconnue,Unknown,673.0
Unknown,Unknown,3,Unknown,Unknown,Unknown,Unknown,Banque Inconnue,Unknown,676.0
Unknown,Unknown,32,Unknown,Unknown,Unknown,Unknown,Banque Inconnue,Unknown,708.0
Unknown,Unknown,2,Unknown,Unknown,Unknown,Unknown,Banque Inconnue,Unknown,710.0
Unknown,Unknown,7,Unknown,Unknown,Unknown,Unknown,Banque Inconnue,Unknown,717.0
Unknown,Unknown,9,Unknown,Unknown,Unknown,Unknown,Banque Inconnue,Unknown,726.0
Unknown,Unknown,15,Unknown,Unknown,Unknown,Unknown,Banque Inconnue,Unknown,741.0
Unknown,Unknown,7,Unknown,Unknown,Unknown,Unknown,Banque Inconnue,Unknown,748.0
Unknown,Unknown,16,Unknown,Unknown,Unknown,Unknown,Banque Inconnue,Unknown,764.0
Unknown,Unknown,17,Unknown,Unknown,Unknown,Unknown,Banque Inconnue,Unknown,781.0
Unknown,Unknown,18,Unknown,Unknown,Unknown,Unknown,Banque Inconnue,Unknown,799.0
Unknown,Unknown,16,Unknown,Unknown,Unknown,Unknown,Banque Inconnue,Unknown,815.0
Unknown,Unknown,19,Unknown,Unknown,Unknown,Unknown,Banque Inconnue,Unknown,834.0
Unknown,Unknown,33,Unknown,Unknown,Unknown,Unknown,Banque Inconnue,Unknown,867.0
Unknown,Unknown,7,Unknown,Unknown,Unknown,Unknown,Banque Inconnue,Unknown,874.0
Unknown,Unknown,17,Unknown,Unknown,Unknown,Unknown,Banque Inconnue,Unknown,891.0
Unknown,Unknown,7,Unknown,Unknown,Unknown,Unknown,Banque Inconnue,Unknown,898.0
Unknown,Unknown,16,Unknown,Unknown,Unknown,Unknown,Banque Inconnue,Unknown,914.0
Unknown,Unknown,34,Unknown,Unknown,Unknown,Unknown,Banque Inconnue,Unknown,948.0
Unknown,Unknown,34,Unknown,Unknown,Unknown,Unknown,Banque Inconnue,Unknown,982.0
Unknown,Unknown,35,Unknown,Unknown,Unknown,Unknown,Banque Inconnue,Unknown,1017.0
Unknown,Unknown,34,Unknown,Unknown,Unknown,Unknown,Banque Inconnue,Unknown,1051.0
Unknown,Unknown,34,Unknown,Unknown,Unknown,Unknown,Banque Inconnue,Unknown,1085.0
Unknown,Unknown,7,Unknown,Unknown,Unknown,Unknown,Banque Inconnue,Unknown,1092.0
Unknown,Unknown,36,Unknown,Unknown,Unknown,Unknown,Banque Inconnue,Unknown,1128.0
Unknown,Unknown,1,Unknown,Unknown,Unknown,Unknown,Banque Inconnue,Unknown,1129.0
Unknown,Unknown,2,Unknown,Unknown,Unknown,Unknown,Banque Inconnue,Unknown,1131.0
Unknown,Unknown,3,Unknown,Unknown,Unknown,Unknown,Banque Inconnue,Unknown,1134.0
Unknown,Unknown,4,Unknown,Unknown,Unknown,Unknown,Banque Inconnue,Unknown,1138.0
Unknown,Unknown,5,Unknown,Unknown,Unknown,Unknown,Banque Inconnue,Unknown,1143.0
Unknown,Unknown,2,Unknown,Unknown,Unknown,Unknown,Banque Inconnue,Unknown,1145.0
Unknown,Unknown,6,Unknown,Unknown,Unknown,Unknown,Banque Inconnue,Unknown,1151.0
Unknown,Unknown,7,Unknown,Unknown,Unknown,Unknown,Banque Inconnue,Unknown,1158.0
Unknown,Unknown,8,Unknown,Unknown,Unknown,Unknown,Banque Inconnue,Unknown,1166.0
Unknown,Unknown,9,Unknown,Unknown,Unknown,Unknown,Banque Inconnue,Unknown,1175.0
Unknown,Unknown,10,Unknown,Unknown,Unknown,Unknown,Banque Inconnue,Unknown,1185.0
Unknown,Unknown,11,Unknown,Unknown,Unknown,Unknown,Banque Inconnue,Unknown,1196.0
Unknown,Unknown,8,Unknown,Unknown,Unknown,Unknown,Banque Inconnue,Unknown,1204.0
Unknown,Unknown,2,Unknown,Unknown,Unknown,Unknown,Banque Inconnue,Unknown,1206.0
Unknown,Unknown,12,Unknown,Unknown,Unknown,Unknown,Banque Inconnue,Unknown,1218.0
Unknown,Unknown,13,Unknown,Unknown,Unknown,Unknown,Banque Inconnue,Unknown,1231.0
Unknown,Unknown,4,Unknown,Unknown,Unknown,Unknown,Banque Inconnue,Unknown,1235.0
Unknown,Unknown,3,Unknown,Unknown,Unknown,Unknown,Banque Inconnue,Unknown,1238.0
Unknown,Unknown,12,Unknown,Unknown,Unknown,Unknown,Banque Inconnue,Unknown,1250.0
Unknown,Unknown,13,Unknown,Unknown,Unknown,Unknown,Banque Inconnue,Unknown,1263.0
Unknown,Unknown,7,Unknown,Unknown,Unknown,Unknown,Banque Inconnue,Unknown,1270.0
Unknown,Unknown,14,Unknown,Unknown,Unknown,Unknown,Banque Inconnue,Unknown,1284.0
Unknown,Unknown,14,Unknown,Unknown,Unknown,Unknown,Banque Inconnue,Unknown,1298.0
Unknown,Unknown,2,Unknown,Unknown,Unknown,Unknown,Banque Inconnue,Unknown,1300.0
Unknown,Unknown,15,Unknown,Unknown,Unknown,Unknown,Banque Inconnue,Unknown,1315.0
Unknown,Unknown,2,Unknown,Unknown,Unknown,Unknown,Banque Inconnue,Unknown,1317.0
Unknown,Unknown,5,Unknown,Unknown,Unknown,Unknown,Banque Inconnue,Unknown,1322.0
Unknown,Unknown,30,Unknown,Unknown,Unknown,Unknown,Banque Inconnue,Unknown,1352.0
Unknown,Unknown,41,Unknown,Unknown,Unknown,Unknown,Banque Inconnue,Unknown,1393.0
Unknown,Unknown,26,Unknown,Unknown,Unknown,Unknown,Banque Inconnue,Unknown,1419.0
Unknown,Unknown,42,Unknown,Unknown,Unknown,Unknown,Banque Inconnue,Unknown,1461.0
Unknown,Unknown,25,Unknown,Unknown,Unknown,Unknown,Banque Inconnue,Unknown,1486.0
Unknown,Unknown,27,Unknown,Unknown,Unknown,Unknown,Banque Inconnue,Unknown,1513.0
Unknown,Unknown,43,Unknown,Unknown,Unknown,Unknown,Banque Inconnue,Unknown,1556.0
Unknown,Unknown,2,Unknown,Unknown,Unknown,Unknown,Banque Inconnue,Unknown,1558.0
Unknown,Unknown,17,Unknown,Unknown,Unknown,Unknown,Banque Inconnue,Unknown,1575.0
Unknown,Unknown,2,Unknown,Unknown,Unknown,Unknown,Banque Inconnue,Unknown,1577.0
Unknown,Unknown,32,Unknown,Unknown,Unknown,Unknown,Banque Inconnue,Unknown,1609.0
Unknown,Unknown,1,Unknown,Unknown,Unknown,Unknown,Banque Inconnue,Unknown,1610.0
Unknown,Unknown,32,Unknown,Unknown,Unknown,Unknown,Banque Inconnue,Unknown,1642.0
Unknown,Unknown,19,Unknown,Unknown,Unknown,Unknown,Banque Inconnue,Unknown,1661.0
Unknown,Unknown,18,Unknown,Unknown,Unknown,Unknown,Banque Inconnue,Unknown,1679.0
Unknown,Unknown,18,Unknown,Unknown,Unknown,Unknown,Banque Inconnue,Unknown,1697.0
Unknown,Unknown,2,Unknown,Unknown,Unknown,Unknown,Banque Inconnue,Unknown,1699.0
Unknown,Unknown,44,Unknown,Unknown,Unknown,Unknown,Banque Inconnue,Unknown,1743.0
Unknown,Unknown,16,Unknown,Unknown,Unknown,Unknown,Banque Inconnue,Unknown,1759.0
Unknown,Unknown,16,Unknown,Unknown,Unknown,Unknown,Banque Inconnue,Unknown,1775.0
Unknown,Unknown,17,Unknown,Unknown,Unknown,Unknown,Banque Inconnue,Unknown,1792.0
Unknown,Unknown,1,Unknown,Unknown,Unknown,Unknown,Banque Inconnue,Unknown,1793.0
Unknown,Unknown,18,Unknown,Unknown,Unknown,Unknown,Banque Inconnue,Unknown,1811.0
Unknown,Unknown,19,Unknown,Unknown,Unknown,Unknown,Banque Inconnue,Unknown,1830.0
Unknown,Unknown,2,Unknown,Unknown,Unknown,Unknown,Banque Inconnue,Unknown,1832.0
Unknown,Unknown,12,Unknown,Unknown,Unknown,Unknown,Banque Inconnue,Unknown,1844.0
Unknown,Unknown,20,Unknown,Unknown,Unknown,Unknown,Banque Inconnue,Unknown,1864.0
Unknown,Unknown,21,Unknown,Unknown,Unknown,Unknown,Banque Inconnue,Unknown,1885.0
Unknown,Unknown,22,Unknown,Unknown,Unknown,Unknown,Banque Inconnue,Unknown,1907.0
Unknown,Unknown,20,Unknown,Unknown,Unknown,Unknown,Banque Inconnue,Unknown,1927.0
Unknown,Unknown,23,Unknown,Unknown,Unknown,Unknown,Banque Inconnue,Unknown,1950.0
Unknown,Unknown,23,Unknown,Unknown,Unknown,Unknown,Banque Inconnue,Unknown,1973.0
Unknown,Unknown,24,Unknown,Unknown,Unknown,Unknown,Banque Inconnue,Unknown,1997.0
Unknown,Unknown,25,Unknown,Unknown,Unknown,Unknown,Banque Inconnue,Unknown,2022.0
Unknown,Unknown,26,Unknown,Unknown,Unknown,Unknown,Banque Inconnue,Unknown,2048.0
Unknown,Unknown,27,Unknown,Unknown,Unknown,Unknown,Banque Inconnue,Unknown,2075.0
Unknown,Unknown,19,Unknown,Unknown,Unknown,Unknown,Banque Inconnue,Unknown,2094.0
Unknown,Unknown,2,Unknown,Unknown,Unknown,Unknown,Banque Inconnue,Unknown,2096.0
Unknown,Unknown,28,Unknown,Unknown,Unknown,Unknown,Banque Inconnue,Unknown,2124.0
Unknown,Unknown,26,Unknown,Unknown,Unknown,Unknown,Banque Inconnue,Unknown,2150.0
Unknown,Unknown,29,Unknown,Unknown,Unknown,Unknown,Banque Inconnue,Unknown,2179.0
Unknown,Unknown,30,Unknown,Unknown,Unknown,Unknown,Banque Inconnue,Unknown,2209.0
Unknown,Unknown,31,Unknown,Unknown,Unknown,Unknown,Banque Inconnue,Unknown,2240.0
Unknown,Unknown,25,Unknown,Unknown,Unknown,Unknown,Banque Inconnue,Unknown,2265.0
Unknown,Unknown,9,Unknown,Unknown,Unknown,Unknown,Banque Inconnue,Unknown,2274.0
Unknown,Unknown,20,Unknown,Unknown,Unknown,Unknown,Banque Inconnue,Unknown,2294.0
Unknown,Unknown,26,Unknown,Unknown,Unknown,Unknown,Banque Inconnue,Unknown,2320.0
Unknown,Unknown,41,Unknown,Unknown,Unknown,Unknown,Banque Inconnue,Unknown,2361.0
Unknown,Unknown,24,Unknown,Unknown,Unknown,Unknown,Banque Inconnue,Unknown,2385.0
Unknown,Unknown,25,Unknown,Unknown,Unknown,Unknown,Banque Inconnue,Unknown,2410.0
Unknown,Unknown,27,Unknown,Unknown,Unknown,Unknown,Banque Inconnue,Unknown,2437.0
Unknown,Unknown,15,Unknown,Unknown,Unknown,Unknown,Banque Inconnue,Unknown,2452.0
Unknown,Unknown,2,Unknown,Unknown,Unknown,Unknown,Banque Inconnue,Unknown,2454.0
Unknown,Unknown,1,Unknown,Unknown,Unknown,Unknown,Banque Inconnue,Unknown,2455.0
Unknown,Unknown,2,Unknown,Unknown,Unknown,Unknown,Banque Inconnue,Unknown,2457.0
Unknown,Unknown,34,Unknown,Unknown,Unknown,Unknown,Banque Inconnue,Unknown,2491.0
Unknown,Unknown,34,Unknown,Unknown,Unknown,Unknown,Banque Inconnue,Unknown,2525.0
Unknown,Unknown,34,Unknown,Unknown,Unknown,Unknown,Banque Inconnue,Unknown,2559.0
Unknown,Unknown,19,Unknown,Unknown,Unknown,Unknown,Banque Inconnue,Unknown,2578.0
Unknown,Unknown,33,Unknown,Unknown,Unknown,Unknown,Banque Inconnue,Unknown,2611.0
Unknown,Unknown,37,Unknown,Unknown,Unknown,Unknown,Banque Inconnue,Unknown,2648.0
Unknown,Unknown,2,Unknown,Unknown,Unknown,Unknown,Banque Inconnue,Unknown,2650.0
Unknown,Unknown,44,Unknown,Unknown,Unknown,Unknown,Banque Inconnue,Unknown,2694.0
Unknown,Unknown,25,Unknown,Unknown,Unknown,Unknown,Banque Inconnue,Unknown,2719.0
Unknown,Unknown,24,Unknown,Unknown,Unknown,Unknown,Banque Inconnue,Unknown,2743.0
Unknown,Unknown,26,Unknown,Unknown,Unknown,Unknown,Banque Inconnue,Unknown,2769.0
Unknown,Unknown,27,Unknown,Unknown,Unknown,Unknown,Banque Inconnue,Unknown,2796.0
Unknown,Unknown,28,Unknown,Unknown,Unknown,Unknown,Banque Inconnue,Unknown,2824.0
Unknown,Unknown,2,Unknown,Unknown,Unknown,Unknown,Banque Inconnue,Unknown,2826.0
Unknown,Unknown,28,Unknown,Unknown,Unknown,Unknown,Banque Inconnue,Unknown,2854.0
Unknown,Unknown,3,Unknown,Unknown,Unknown,Unknown,Banque Inconnue,Unknown,2857.0
Unknown,Unknown,16,Unknown,Unknown,Unknown,Unknown,Banque Inconnue,Unknown,2873.0
Unknown,Unknown,32,Unknown,Unknown,Unknown,Unknown,Banque Inconnue,Unknown,2905.0
Unknown,Unknown,2,Unknown,Unknown,Unknown,Unknown,Banque Inconnue,Unknown,2907.0
Unknown,Unknown,17,Unknown,Unknown,Unknown,Unknown,Banque Inconnue,Unknown,2924.0
Unknown,Unknown,32,Unknown,Unknown,Unknown,Unknown,Banque Inconnue,Unknown,2956.0
Unknown,Unknown,33,Unknown,Unknown,Unknown,Unknown,Banque Inconnue,Unknown,2989.0
Unknown,Unknown,34,Unknown,Unknown,Unknown,Unknown,Banque Inconnue,Unknown,3023.0
Unknown,Unknown,2,Unknown,Unknown,Unknown,Unknown,Banque Inconnue,Unknown,3025.0
Unknown,Unknown,35,Unknown,Unknown,Unknown,Unknown,Banque Inconnue,Unknown,3060.0
Unknown,Unknown,18,Unknown,Unknown,Unknown,Unknown,Banque Inconnue,Unknown,3078.0
Unknown,Unknown,18,Unknown,Unknown,Unknown,Unknown,Banque Inconnue,Unknown,3096.0
Unknown,Unknown,18,Unknown,Unknown,Unknown,Unknown,Banque Inconnue,Unknown,3114.0
Unknown,Unknown,2,Unknown,Unknown,Unknown,Unknown,Banque Inconnue,Unknown,3116.0
Unknown,Unknown,18,Unknown,Unknown,Unknown,Unknown,Banque Inconnue,Unknown,3134.0
Unknown,Unknown,17,Unknown,Unknown,Unknown,Unknown,Banque Inconnue,Unknown,3151.0
Unknown,Unknown,33,Unknown,Unknown,Unknown,Unknown,Banque Inconnue,Unknown,3184.0
Unknown,Unknown,35,Unknown,Unknown,Unknown,Unknown,Banque Inconnue,Unknown,3219.0
Unknown,Unknown,2,Unknown,Unknown,Unknown,Unknown,Banque Inconnue,Unknown,3221.0
Unknown,Unknown,17,Unknown,Unknown,Unknown,Unknown,Banque Inconnue,Unknown,3238.0
Unknown,Unknown,1,Unknown,Unknown,Unknown,Unknown,Banque Inconnue,Unknown,3239.0
Unknown,Unknown,36,Unknown,Unknown,Unknown,Unknown,Banque Inconnue,Unknown,3275.0
Unknown,Unknown,37,Unknown,Unknown,Unknown,Unknown,Banque Inconnue,Unknown,3312.0
Unknown,Unknown,2,Unknown,Unknown,Unknown,Unknown,Banque Inconnue,Unknown,3314.0
Unknown,Unknown,33,Unknown,Unknown,Unknown,Unknown,Banque Inconnue,Unknown,3347.0
Unknown,Unknown,35,Unknown,Unknown,Unknown,Unknown,Banque Inconnue,Unknown,3382.0
Unknown,Unknown,33,Unknown,Unknown,Unknown,Unknown,Banque Inconnue,Unknown,3415.0
Unknown,Unknown,1,Unknown,Unknown,Unknown,Unknown,Banque Inconnue,Unknown,3416.0
Unknown,Unknown,2,Unknown,Unknown,Unknown,Unknown,Banque Inconnue,Unknown,3418.0
Unknown,Unknown,1,Unknown,Unknown,Unknown,Unknown,Banque Inconnue,Unknown,3419.0
Unknown,Unknown,18,Unknown,Unknown,Unknown,Unknown,Banque Inconnue,Unknown,3437.0
Unknown,Unknown,34,Unknown,Unknown,Unknown,Unknown,Banque Inconnue,Unknown,3471.0
Unknown,Unknown,24,Unknown,Unknown,Unknown,Unknown,Banque Inconnue,Unknown,3495.0
Unknown,Unknown,25,Unknown,Unknown,Unknown,Unknown,Banque Inconnue,Unknown,3520.0
Unknown,Unknown,29,Unknown,Unknown,Unknown,Unknown,Banque Inconnue,Unknown,3549.0
Unknown,Unknown,28,Unknown,Unknown,Unknown,Unknown,Banque Inconnue,Unknown,3577.0
Unknown,Unknown,2,Unknown,Unknown,Unknown,Unknown,Banque Inconnue,Unknown,3579.0
Unknown,Unknown,38,Unknown,Unknown,Unknown,Unknown,Banque Inconnue,Unknown,3617.0
Unknown,Unknown,8,Unknown,Unknown,Unknown,Unknown,Banque Inconnue,Unknown,3625.0
Unknown,Unknown,10,Unknown,Unknown,Unknown,Unknown,Banque Inconnue,Unknown,3635.0
Unknown,Unknown,11,Unknown,Unknown,Unknown,Unknown,Banque Inconnue,Unknown,3646.0
Unknown,Unknown,28,Unknown,Unknown,Unknown,Unknown,Banque Inconnue,Unknown,3674.0
Unknown,Unknown,3,Unknown,Unknown,Unknown,Unknown,Banque Inconnue,Unknown,3677.0
Unknown,Unknown,39,Unknown,Unknown,Unknown,Unknown,Banque Inconnue,Unknown,3716.0
Unknown,Unknown,17,Unknown,Unknown,Unknown,Unknown,Banque Inconnue,Unknown,3733.0
Unknown,Unknown,40,Unknown,Unknown,Unknown,Unknown,Banque Inconnue,Unknown,3773.0
Unknown,Unknown,40,Unknown,Unknown,Unknown,Unknown,Banque Inconnue,Unknown,3813.0
Unknown,Unknown,40,Unknown,Unknown,Unknown,Unknown,Banque Inconnue,Unknown,3853.0
Unknown,Unknown,30,Unknown,Unknown,Unknown,Unknown,Banque Inconnue,Unknown,3883.0
Unknown,Unknown,31,Unknown,Unknown,Unknown,Unknown,Banque Inconnue,Unknown,3914.0
Unknown,Unknown,3,Unknown,Unknown,Unknown,Unknown,Banque Inconnue,Unknown,3917.0
Unknown,Unknown,32,Unknown,Unknown,Unknown,Unknown,Banque Inconnue,Unknown,3949.0
Unknown,Unknown,2,Unknown,Unknown,Unknown,Unknown,Banque Inconnue,Unknown,3951.0
Unknown,Unknown,7,Unknown,Unknown,Unknown,Unknown,Banque Inconnue,Unknown,3958.0
Unknown,Unknown,9,Unknown,Unknown,Unknown,Unknown,Banque Inconnue,Unknown,3967.0
Unknown,Unknown,15,Unknown,Unknown,Unknown,Unknown,Banque Inconnue,Unknown,3982.0
Unknown,Unknown,7,Unknown,Unknown,Unknown,Unknown,Banque Inconnue,Unknown,3989.0
Unknown,Unknown,21,Unknown,Unknown,Unknown,Unknown,Banque Inconnue,Unknown,4010.0
Unknown,Unknown,17,Unknown,Unknown,Unknown,Unknown,Banque Inconnue,Unknown,4027.0
Unknown,Unknown,18,Unknown,Unknown,Unknown,Unknown,Banque Inconnue,Unknown,4045.0
Unknown,Unknown,16,Unknown,Unknown,Unknown,Unknown,Banque Inconnue,Unknown,4061.0
Unknown,Unknown,19,Unknown,Unknown,Unknown,Unknown,Banque Inconnue,Unknown,4080.0
Unknown,Unknown,33,Unknown,Unknown,Unknown,Unknown,Banque Inconnue,Unknown,4113.0
Unknown,Unknown,7,Unknown,Unknown,Unknown,Unknown,Banque Inconnue,Unknown,4120.0
Unknown,Unknown,17,Unknown,Unknown,Unknown,Unknown,Banque Inconnue,Unknown,4137.0
Unknown,Unknown,20,Unknown,Unknown,Unknown,Unknown,Banque Inconnue,Unknown,4157.0
Unknown,Unknown,34,Unknown,Unknown,Unknown,Unknown,Banque Inconnue,Unknown,4191.0
Unknown,Unknown,35,Unknown,Unknown,Unknown,Unknown,Banque Inconnue,Unknown,4226.0
Unknown,Unknown,37,Unknown,Unknown,Unknown,Unknown,Banque Inconnue,Unknown,4263.0
Unknown,Unknown,20,Unknown,Unknown,Unknown,Unknown,Banque Inconnue,Unknown,4283.0
Unknown,Unknown,7,Unknown,Unknown,Unknown,Unknown,Banque Inconnue,Unknown,4290.0
Unknown,Unknown,36,Unknown,Unknown,Unknown,Unknown,Banque Inconnue,Unknown,4326.0
Unknown,Unknown,14,Unknown,Unknown,Unknown,Unknown,cid:10)(cid:11)(cid:10)(cid:46)(cid:14)(cid:2)(cid:9)(cid:11)(cid:4)(cid:3)(cid:49)(cid:4)(cid:8)(cid:5)(cid:2)(cid:28)(cid:3,cid:6)(cid:5)(cid:9)(cid:10)(cid:5)(cid:3)(cid:8)(cid:2)(cid:4)(cid:8)(cid:7)(cid:11)(cid:8)(cid:2)(cid:12)(cid:11)(cid:4)(cid:3)(cid:51)(cid:5)(cid:52)(cid:11)(cid:7)(cid:5)(cid:2)(cid:28)(cid:3,14.0
Unknown,Unknown,9,Unknown,Unknown,Unknown,Unknown,cid:10)(cid:11)(cid:10)(cid:46)(cid:14)(cid:2)(cid:9)(cid:11)(cid:4)(cid:3)(cid:49)(cid:4)(cid:8)(cid:5)(cid:2)(cid:28)(cid:3,cid:18)(cid:36)(cid:45)(cid:18)(cid:35,23.0
Unknown,Unknown,38,Unknown,Unknown,Unknown,Unknown,cid:10)(cid:11)(cid:10)(cid:46)(cid:14)(cid:2)(cid:9)(cid:11)(cid:4)(cid:3)(cid:49)(cid:4)(cid:8)(cid:5)(cid:2)(cid:28)(cid:3,cid:18)(cid:36)(cid:45)(cid:18)(cid:35,61.0
Unknown,Unknown,2,Unknown,Unknown,Unknown,Unknown,cid:10)(cid:11)(cid:10)(cid:46)(cid:14)(cid:2)(cid:9)(cid:11)(cid:4)(cid:3)(cid:49)(cid:4)(cid:8)(cid:5)(cid:2)(cid:28)(cid:3,cid:14)(cid:5)(cid:9)(cid:2)(cid:10)(cid:5)(cid:54)(cid:39)(cid:14)(cid:7)(cid:5)(cid:3)(cid:9)(cid:2)(cid:12)(cid:11)(cid:4)(cid:14)(cid:11)(cid:54)(cid:54)(cid:7)(cid:5)(cid:3)(cid:2)(cid:28)(cid:3,63.0
Unknown,Unknown,7,Unknown,Unknown,Unknown,Unknown,cid:10)(cid:11)(cid:10)(cid:46)(cid:14)(cid:2)(cid:9)(cid:11)(cid:4)(cid:3)(cid:49)(cid:4)(cid:8)(cid:5)(cid:2)(cid:28)(cid:3,cid:12)(cid:46)(cid:38)(cid:4)(cid:46)(cid:8)(cid:10)(cid:2)(cid:13)(cid:5)(cid:3)(cid:52)(cid:5,70.0
Unknown,Unknown,32,Unknown,Unknown,Unknown,Unknown,cid:10)(cid:11)(cid:10)(cid:46)(cid:14)(cid:2)(cid:9)(cid:11)(cid:4)(cid:3)(cid:49)(cid:4)(cid:8)(cid:5)(cid:2)(cid:28)(cid:3,Unknown,102.0
Unknown,Unknown,2,Unknown,Unknown,Unknown,Unknown,cid:10)(cid:11)(cid:10)(cid:46)(cid:14)(cid:2)(cid:9)(cid:11)(cid:4)(cid:3)(cid:49)(cid:4)(cid:8)(cid:5)(cid:2)(cid:28)(cid:3,Unknown,104.0
Unknown,Unknown,7,Unknown,Unknown,Unknown,Unknown,cid:10)(cid:11)(cid:10)(cid:46)(cid:14)(cid:2)(cid:9)(cid:11)(cid:4)(cid:3)(cid:49)(cid:4)(cid:8)(cid:5)(cid:2)(cid:28)(cid:3,Unknown,111.0
Unknown,Unknown,4,Unknown,Unknown,Unknown,Unknown,cid:10)(cid:11)(cid:10)(cid:46)(cid:14)(cid:2)(cid:9)(cid:11)(cid:4)(cid:3)(cid:49)(cid:4)(cid:8)(cid:5)(cid:2)(cid:28)(cid:3,Unknown,115.0
Unknown,Unknown,9,Unknown,Unknown,Unknown,Unknown,cid:10)(cid:11)(cid:10)(cid:46)(cid:14)(cid:2)(cid:9)(cid:11)(cid:4)(cid:3)(cid:49)(cid:4)(cid:8)(cid:5)(cid:2)(cid:28)(cid:3,Unknown,124.0
Unknown,Unknown,3,Unknown,Unknown,Unknown,Unknown,cid:10)(cid:11)(cid:10)(cid:46)(cid:14)(cid:2)(cid:9)(cid:11)(cid:4)(cid:3)(cid:49)(cid:4)(cid:8)(cid:5)(cid:2)(cid:28)(cid:3,Unknown,127.0
Unknown,Unknown,2,Unknown,Unknown,Unknown,Unknown,cid:10)(cid:11)(cid:10)(cid:46)(cid:14)(cid:2)(cid:9)(cid:11)(cid:4)(cid:3)(cid:49)(cid:4)(cid:8)(cid:5)(cid:2)(cid:28)(cid:3,Unknown,129.0
Unknown,Unknown,15,Unknown,Unknown,Unknown,Unknown,cid:10)(cid:11)(cid:10)(cid:46)(cid:14)(cid:2)(cid:9)(cid:11)(cid:4)(cid:3)(cid:49)(cid:4)(cid:8)(cid:5)(cid:2)(cid:28)(cid:3,Unknown,144.0
Unknown,Unknown,13,Unknown,Unknown,Unknown,Unknown,cid:10)(cid:11)(cid:10)(cid:46)(cid:14)(cid:2)(cid:9)(cid:11)(cid:4)(cid:3)(cid:49)(cid:4)(cid:8)(cid:5)(cid:2)(cid:28)(cid:3,Unknown,157.0
Unknown,Unknown,39,Unknown,Unknown,Unknown,Unknown,cid:10)(cid:11)(cid:10)(cid:46)(cid:14)(cid:2)(cid:9)(cid:11)(cid:4)(cid:3)(cid:49)(cid:4)(cid:8)(cid:5)(cid:2)(cid:28)(cid:3,Unknown,196.0
Unknown,Unknown,13,Unknown,Unknown,Unknown,Unknown,cid:10)(cid:11)(cid:10)(cid:46)(cid:14)(cid:2)(cid:9)(cid:11)(cid:4)(cid:3)(cid:49)(cid:4)(cid:8)(cid:5)(cid:2)(cid:28)(cid:3,Unknown,209.0
Unknown,Unknown,9,Unknown,Unknown,Unknown,Unknown,cid:10)(cid:11)(cid:10)(cid:46)(cid:14)(cid:2)(cid:9)(cid:11)(cid:4)(cid:3)(cid:49)(cid:4)(cid:8)(cid:5)(cid:2)(cid:28)(cid:3,Unknown,218.0
Unknown,Unknown,10,Unknown,Unknown,Unknown,Unknown,cid:10)(cid:11)(cid:10)(cid:46)(cid:14)(cid:2)(cid:9)(cid:11)(cid:4)(cid:3)(cid:49)(cid:4)(cid:8)(cid:5)(cid:2)(cid:28)(cid:3,Unknown,228.0
Unknown,Unknown,6,Unknown,Unknown,Unknown,Unknown,cid:10)(cid:11)(cid:10)(cid:46)(cid:14)(cid:2)(cid:9)(cid:11)(cid:4)(cid:3)(cid:49)(cid:4)(cid:8)(cid:5)(cid:2)(cid:28)(cid:3,Unknown,234.0
Unknown,Unknown,9,Unknown,Unknown,Unknown,Unknown,cid:10)(cid:11)(cid:10)(cid:46)(cid:14)(cid:2)(cid:9)(cid:11)(cid:4)(cid:3)(cid:49)(cid:4)(cid:8)(cid:5)(cid:2)(cid:28)(cid:3,Unknown,243.0
Unknown,Unknown,11,Unknown,Unknown,Unknown,Unknown,cid:10)(cid:11)(cid:10)(cid:46)(cid:14)(cid:2)(cid:9)(cid:11)(cid:4)(cid:3)(cid:49)(cid:4)(cid:8)(cid:5)(cid:2)(cid:28)(cid:3,Unknown,254.0
Unknown,Unknown,38,Unknown,Unknown,Unknown,Unknown,cid:10)(cid:11)(cid:10)(cid:46)(cid:14)(cid:2)(cid:9)(cid:11)(cid:4)(cid:3)(cid:49)(cid:4)(cid:8)(cid:5)(cid:2)(cid:28)(cid:3,Unknown,292.0
Unknown,Unknown,12,Unknown,Unknown,Unknown,Unknown,cid:10)(cid:11)(cid:10)(cid:46)(cid:14)(cid:2)(cid:9)(cid:11)(cid:4)(cid:3)(cid:49)(cid:4)(cid:8)(cid:5)(cid:2)(cid:28)(cid:3,Unknown,304.0
Unknown,Unknown,31,Unknown,Unknown,Unknown,Unknown,cid:10)(cid:11)(cid:10)(cid:46)(cid:14)(cid:2)(cid:9)(cid:11)(cid:4)(cid:3)(cid:49)(cid:4)(cid:8)(cid:5)(cid:2)(cid:28)(cid:3,Unknown,335.0
Unknown,Unknown,10,Unknown,Unknown,Unknown,Unknown,cid:10)(cid:11)(cid:10)(cid:46)(cid:14)(cid:2)(cid:9)(cid:11)(cid:4)(cid:3)(cid:49)(cid:4)(cid:8)(cid:5)(cid:2)(cid:28)(cid:3,Unknown,345.0
Unknown,Unknown,6,Unknown,Unknown,Unknown,Unknown,cid:10)(cid:11)(cid:10)(cid:46)(cid:14)(cid:2)(cid:9)(cid:11)(cid:4)(cid:3)(cid:49)(cid:4)(cid:8)(cid:5)(cid:2)(cid:28)(cid:3,Unknown,351.0
Unknown,Unknown,14,Unknown,Unknown,Unknown,Unknown,cid:10)(cid:11)(cid:10)(cid:46)(cid:14)(cid:2)(cid:9)(cid:11)(cid:4)(cid:3)(cid:49)(cid:4)(cid:8)(cid:5)(cid:2)(cid:28)(cid:3,Unknown,365.0
Unknown,Unknown,5,Unknown,Unknown,Unknown,Unknown,cid:10)(cid:11)(cid:10)(cid:46)(cid:14)(cid:2)(cid:9)(cid:11)(cid:4)(cid:3)(cid:49)(cid:4)(cid:8)(cid:5)(cid:2)(cid:28)(cid:3,Unknown,370.0
Unknown,Unknown,8,Unknown,Unknown,Unknown,Unknown,cid:10)(cid:11)(cid:10)(cid:46)(cid:14)(cid:2)(cid:9)(cid:11)(cid:4)(cid:3)(cid:49)(cid:4)(cid:8)(cid:5)(cid:2)(cid:28)(cid:3,Unknown,378.0
Unknown,Unknown,12,Unknown,Unknown,Unknown,Unknown,cid:10)(cid:11)(cid:10)(cid:46)(cid:14)(cid:2)(cid:9)(cid:11)(cid:4)(cid:3)(cid:49)(cid:4)(cid:8)(cid:5)(cid:2)(cid:28)(cid:3,Unknown,390.0
Unknown,Unknown,38,Unknown,Unknown,Unknown,Unknown,cid:10)(cid:11)(cid:10)(cid:46)(cid:14)(cid:2)(cid:9)(cid:11)(cid:4)(cid:3)(cid:49)(cid:4)(cid:8)(cid:5)(cid:2)(cid:28)(cid:3,Unknown,428.0
Unknown,Unknown,29,Unknown,Unknown,Unknown,Unknown,cid:10)(cid:11)(cid:10)(cid:46)(cid:14)(cid:2)(cid:9)(cid:11)(cid:4)(cid:3)(cid:49)(cid:4)(cid:8)(cid:5)(cid:2)(cid:28)(cid:3,Unknown,457.0
Unknown,Unknown,13,Unknown,Unknown,Unknown,Unknown,cid:10)(cid:11)(cid:10)(cid:46)(cid:14)(cid:2)(cid:9)(cid:11)(cid:4)(cid:3)(cid:49)(cid:4)(cid:8)(cid:5)(cid:2)(cid:28)(cid:3,Unknown,470.0
Unknown,Unknown,5,Unknown,Unknown,Unknown,Unknown,cid:10)(cid:11)(cid:10)(cid:46)(cid:14)(cid:2)(cid:9)(cid:11)(cid:4)(cid:3)(cid:49)(cid:4)(cid:8)(cid:5)(cid:2)(cid:28)(cid:3,Unknown,475.0
Unknown,Unknown,32,Unknown,Unknown,Unknown,Unknown,cid:10)(cid:11)(cid:10)(cid:46)(cid:14)(cid:2)(cid:9)(cid:11)(cid:4)(cid:3)(cid:49)(cid:4)(cid:8)(cid:5)(cid:2)(cid:28)(cid:3,Unknown,507.0
Unknown,Unknown,12,Unknown,Unknown,Unknown,Unknown,cid:10)(cid:11)(cid:10)(cid:46)(cid:14)(cid:2)(cid:9)(cid:11)(cid:4)(cid:3)(cid:49)(cid:4)(cid:8)(cid:5)(cid:2)(cid:28)(cid:3,Unknown,519.0
Unknown,Unknown,38,Unknown,Unknown,Unknown,Unknown,cid:10)(cid:11)(cid:10)(cid:46)(cid:14)(cid:2)(cid:9)(cid:11)(cid:4)(cid:3)(cid:49)(cid:4)(cid:8)(cid:5)(cid:2)(cid:28)(cid:3,Unknown,557.0
Unknown,Unknown,18,Unknown,Unknown,Unknown,Unknown,cid:10)(cid:11)(cid:10)(cid:46)(cid:14)(cid:2)(cid:9)(cid:11)(cid:4)(cid:3)(cid:49)(cid:4)(cid:8)(cid:5)(cid:2)(cid:28)(cid:3,Unknown,575.0
Unknown,Unknown,17,Unknown,Unknown,Unknown,Unknown,cid:10)(cid:11)(cid:10)(cid:46)(cid:14)(cid:2)(cid:9)(cid:11)(cid:4)(cid:3)(cid:49)(cid:4)(cid:8)(cid:5)(cid:2)(cid:28)(cid:3,Unknown,592.0
Unknown,Unknown,45,Unknown,Unknown,Unknown,Unknown,cid:10)(cid:11)(cid:10)(cid:46)(cid:14)(cid:2)(cid:9)(cid:11)(cid:4)(cid:3)(cid:49)(cid:4)(cid:8)(cid:5)(cid:2)(cid:28)(cid:3,Unknown,637.0
Unknown,Unknown,18,Unknown,Unknown,Unknown,Unknown,cid:10)(cid:11)(cid:10)(cid:46)(cid:14)(cid:2)(cid:9)(cid:11)(cid:4)(cid:3)(cid:49)(cid:4)(cid:8)(cid:5)(cid:2)(cid:28)(cid:3,Unknown,655.0
Unknown,Unknown,35,Unknown,Unknown,Unknown,Unknown,cid:10)(cid:11)(cid:10)(cid:46)(cid:14)(cid:2)(cid:9)(cid:11)(cid:4)(cid:3)(cid:49)(cid:4)(cid:8)(cid:5)(cid:2)(cid:28)(cid:3,Unknown,690.0
Unknown,Unknown,38,Unknown,Unknown,Unknown,Unknown,cid:10)(cid:11)(cid:10)(cid:46)(cid:14)(cid:2)(cid:9)(cid:11)(cid:4)(cid:3)(cid:49)(cid:4)(cid:8)(cid:5)(cid:2)(cid:28)(cid:3,Unknown,728.0
Unknown,Unknown,20,Unknown,Unknown,Unknown,Unknown,cid:10)(cid:11)(cid:10)(cid:46)(cid:14)(cid:2)(cid:9)(cid:11)(cid:4)(cid:3)(cid:49)(cid:4)(cid:8)(cid:5)(cid:2)(cid:28)(cid:3,Unknown,748.0
Unknown,Unknown,30,Unknown,Unknown,Unknown,Unknown,cid:10)(cid:11)(cid:10)(cid:46)(cid:14)(cid:2)(cid:9)(cid:11)(cid:4)(cid:3)(cid:49)(cid:4)(cid:8)(cid:5)(cid:2)(cid:28)(cid:3,Unknown,778.0
Unknown,Unknown,41,Unknown,Unknown,Unknown,Unknown,cid:10)(cid:11)(cid:10)(cid:46)(cid:14)(cid:2)(cid:9)(cid:11)(cid:4)(cid:3)(cid:49)(cid:4)(cid:8)(cid:5)(cid:2)(cid:28)(cid:3,Unknown,819.0
Unknown,Unknown,20,Unknown,Unknown,Unknown,Unknown,cid:10)(cid:11)(cid:10)(cid:46)(cid:14)(cid:2)(cid:9)(cid:11)(cid:4)(cid:3)(cid:49)(cid:4)(cid:8)(cid:5)(cid:2)(cid:28)(cid:3,Unknown,839.0
Unknown,Unknown,15,Unknown,Unknown,Unknown,Unknown,cid:10)(cid:11)(cid:10)(cid:46)(cid:14)(cid:2)(cid:9)(cid:11)(cid:4)(cid:3)(cid:49)(cid:4)(cid:8)(cid:5)(cid:2)(cid:28)(cid:3,Unknown,854.0
Unknown,Unknown,2,Unknown,Unknown,Unknown,Unknown,cid:10)(cid:11)(cid:10)(cid:46)(cid:14)(cid:2)(cid:9)(cid:11)(cid:4)(cid:3)(cid:49)(cid:4)(cid:8)(cid:5)(cid:2)(cid:28)(cid:3,Unknown,856.0
Unknown,Unknown,36,Unknown,Unknown,Unknown,Unknown,cid:10)(cid:11)(cid:10)(cid:46)(cid:14)(cid:2)(cid:9)(cid:11)(cid:4)(cid:3)(cid:49)(cid:4)(cid:8)(cid:5)(cid:2)(cid:28)(cid:3,Unknown,892.0
Unknown,Unknown,1,Unknown,Unknown,Unknown,Unknown,cid:10)(cid:11)(cid:10)(cid:46)(cid:14)(cid:2)(cid:9)(cid:11)(cid:4)(cid:3)(cid:49)(cid:4)(cid:8)(cid:5)(cid:2)(cid:28)(cid:3,Unknown,893.0
Unknown,Unknown,19,Unknown,Unknown,Unknown,Unknown,cid:10)(cid:11)(cid:10)(cid:46)(cid:14)(cid:2)(cid:9)(cid:11)(cid:4)(cid:3)(cid:49)(cid:4)(cid:8)(cid:5)(cid:2)(cid:28)(cid:3,Unknown,912.0
Unknown,Unknown,18,Unknown,Unknown,Unknown,Unknown,cid:10)(cid:11)(cid:10)(cid:46)(cid:14)(cid:2)(cid:9)(cid:11)(cid:4)(cid:3)(cid:49)(cid:4)(cid:8)(cid:5)(cid:2)(cid:28)(cid:3,Unknown,930.0
Unknown,Unknown,18,Unknown,Unknown,Unknown,Unknown,cid:10)(cid:11)(cid:10)(cid:46)(cid:14)(cid:2)(cid:9)(cid:11)(cid:4)(cid:3)(cid:49)(cid:4)(cid:8)(cid:5)(cid:2)(cid:28)(cid:3,Unknown,948.0
Unknown,Unknown,2,Unknown,Unknown,Unknown,Unknown,cid:10)(cid:11)(cid:10)(cid:46)(cid:14)(cid:2)(cid:9)(cid:11)(cid:4)(cid:3)(cid:49)(cid:4)(cid:8)(cid:5)(cid:2)(cid:28)(cid:3,Unknown,950.0
Unknown,Unknown,44,Unknown,Unknown,Unknown,Unknown,cid:10)(cid:11)(cid:10)(cid:46)(cid:14)(cid:2)(cid:9)(cid:11)(cid:4)(cid:3)(cid:49)(cid:4)(cid:8)(cid:5)(cid:2)(cid:28)(cid:3,Unknown,994.0
Unknown,Unknown,46,Unknown,Unknown,Unknown,Unknown,cid:10)(cid:11)(cid:10)(cid:46)(cid:14)(cid:2)(cid:9)(cid:11)(cid:4)(cid:3)(cid:49)(cid:4)(cid:8)(cid:5)(cid:2)(cid:28)(cid:3,Unknown,1040.0
Unknown,Unknown,47,Unknown,Unknown,Unknown,Unknown,cid:10)(cid:11)(cid:10)(cid:46)(cid:14)(cid:2)(cid:9)(cid:11)(cid:4)(cid:3)(cid:49)(cid:4)(cid:8)(cid:5)(cid:2)(cid:28)(cid:3,Unknown,1087.0
Unknown,Unknown,20,Unknown,Unknown,Unknown,Unknown,cid:10)(cid:11)(cid:10)(cid:46)(cid:14)(cid:2)(cid:9)(cid:11)(cid:4)(cid:3)(cid:49)(cid:4)(cid:8)(cid:5)(cid:2)(cid:28)(cid:3,Unknown,1107.0
Unknown,Unknown,30,Unknown,Unknown,Unknown,Unknown,cid:10)(cid:11)(cid:10)(cid:46)(cid:14)(cid:2)(cid:9)(cid:11)(cid:4)(cid:3)(cid:49)(cid:4)(cid:8)(cid:5)(cid:2)(cid:28)(cid:3,Unknown,1137.0
Unknown,Unknown,30,Unknown,Unknown,Unknown,Unknown,cid:10)(cid:11)(cid:10)(cid:46)(cid:14)(cid:2)(cid:9)(cid:11)(cid:4)(cid:3)(cid:49)(cid:4)(cid:8)(cid:5)(cid:2)(cid:28)(cid:3,Unknown,1167.0
Unknown,Unknown,25,Unknown,Unknown,Unknown,Unknown,cid:10)(cid:11)(cid:10)(cid:46)(cid:14)(cid:2)(cid:9)(cid:11)(cid:4)(cid:3)(cid:49)(cid:4)(cid:8)(cid:5)(cid:2)(cid:28)(cid:3,Unknown,1192.0
Unknown,Unknown,23,Unknown,Unknown,Unknown,Unknown,cid:10)(cid:11)(cid:10)(cid:46)(cid:14)(cid:2)(cid:9)(cid:11)(cid:4)(cid:3)(cid:49)(cid:4)(cid:8)(cid:5)(cid:2)(cid:28)(cid:3,Unknown,1215.0
Unknown,Unknown,25,Unknown,Unknown,Unknown,Unknown,cid:10)(cid:11)(cid:10)(cid:46)(cid:14)(cid:2)(cid:9)(cid:11)(cid:4)(cid:3)(cid:49)(cid:4)(cid:8)(cid:5)(cid:2)(cid:28)(cid:3,Unknown,1240.0
Unknown,Unknown,30,Unknown,Unknown,Unknown,Unknown,cid:10)(cid:11)(cid:10)(cid:46)(cid:14)(cid:2)(cid:9)(cid:11)(cid:4)(cid:3)(cid:49)(cid:4)(cid:8)(cid:5)(cid:2)(cid:28)(cid:3,Unknown,1270.0
Unknown,Unknown,41,Unknown,Unknown,Unknown,Unknown,cid:10)(cid:11)(cid:10)(cid:46)(cid:14)(cid:2)(cid:9)(cid:11)(cid:4)(cid:3)(cid:49)(cid:4)(cid:8)(cid:5)(cid:2)(cid:28)(cid:3,Unknown,1311.0
Unknown,Unknown,2,Unknown,Unknown,Unknown,Unknown,cid:10)(cid:11)(cid:10)(cid:46)(cid:14)(cid:2)(cid:9)(cid:11)(cid:4)(cid:3)(cid:49)(cid:4)(cid:8)(cid:5)(cid:2)(cid:28)(cid:3,Unknown,1313.0
Unknown,Unknown,45,Unknown,Unknown,Unknown,Unknown,cid:10)(cid:11)(cid:10)(cid:46)(cid:14)(cid:2)(cid:9)(cid:11)(cid:4)(cid:3)(cid:49)(cid:4)(cid:8)(cid:5)(cid:2)(cid:28)(cid:3,Unknown,1358.0
Unknown,Unknown,2,Unknown,Unknown,Unknown,Unknown,cid:10)(cid:11)(cid:10)(cid:46)(cid:14)(cid:2)(cid:9)(cid:11)(cid:4)(cid:3)(cid:49)(cid:4)(cid:8)(cid:5)(cid:2)(cid:28)(cid:3,Unknown,1360.0
Unknown,Unknown,28,Unknown,Unknown,Unknown,Unknown,cid:10)(cid:11)(cid:10)(cid:46)(cid:14)(cid:2)(cid:9)(cid:11)(cid:4)(cid:3)(cid:49)(cid:4)(cid:8)(cid:5)(cid:2)(cid:28)(cid:3,Unknown,1388.0
Unknown,Unknown,26,Unknown,Unknown,Unknown,Unknown,cid:10)(cid:11)(cid:10)(cid:46)(cid:14)(cid:2)(cid:9)(cid:11)(cid:4)(cid:3)(cid:49)(cid:4)(cid:8)(cid:5)(cid:2)(cid:28)(cid:3,Unknown,1414.0
Unknown,Unknown,29,Unknown,Unknown,Unknown,Unknown,cid:10)(cid:11)(cid:10)(cid:46)(cid:14)(cid:2)(cid:9)(cid:11)(cid:4)(cid:3)(cid:49)(cid:4)(cid:8)(cid:5)(cid:2)(cid:28)(cid:3,Unknown,1443.0
Unknown,Unknown,24,Unknown,Unknown,Unknown,Unknown,cid:10)(cid:11)(cid:10)(cid:46)(cid:14)(cid:2)(cid:9)(cid:11)(cid:4)(cid:3)(cid:49)(cid:4)(cid:8)(cid:5)(cid:2)(cid:28)(cid:3,Unknown,1467.0
Unknown,Unknown,27,Unknown,Unknown,Unknown,Unknown,cid:10)(cid:11)(cid:10)(cid:46)(cid:14)(cid:2)(cid:9)(cid:11)(cid:4)(cid:3)(cid:49)(cid:4)(cid:8)(cid:5)(cid:2)(cid:28)(cid:3,Unknown,1494.0
Unknown,Unknown,2,Unknown,Unknown,Unknown,Unknown,cid:10)(cid:11)(cid:10)(cid:46)(cid:14)(cid:2)(cid:9)(cid:11)(cid:4)(cid:3)(cid:49)(cid:4)(cid:8)(cid:5)(cid:2)(cid:28)(cid:3,Unknown,1496.0
Unknown,Unknown,29,Unknown,Unknown,Unknown,Unknown,cid:10)(cid:11)(cid:10)(cid:46)(cid:14)(cid:2)(cid:9)(cid:11)(cid:4)(cid:3)(cid:49)(cid:4)(cid:8)(cid:5)(cid:2)(cid:28)(cid:3,Unknown,1525.0
Unknown,Unknown,48,Unknown,Unknown,Unknown,Unknown,cid:10)(cid:11)(cid:10)(cid:46)(cid:14)(cid:2)(cid:9)(cid:11)(cid:4)(cid:3)(cid:49)(cid:4)(cid:8)(cid:5)(cid:2)(cid:28)(cid:3,Unknown,1573.0
Unknown,Unknown,48,Unknown,Unknown,Unknown,Unknown,cid:10)(cid:11)(cid:10)(cid:46)(cid:14)(cid:2)(cid:9)(cid:11)(cid:4)(cid:3)(cid:49)(cid:4)(cid:8)(cid:5)(cid:2)(cid:28)(cid:3,Unknown,1621.0
Unknown,Unknown,24,Unknown,Unknown,Unknown,Unknown,cid:10)(cid:11)(cid:10)(cid:46)(cid:14)(cid:2)(cid:9)(cid:11)(cid:4)(cid:3)(cid:49)(cid:4)(cid:8)(cid:5)(cid:2)(cid:28)(cid:3,Unknown,1645.0
Unknown,Unknown,41,Unknown,Unknown,Unknown,Unknown,cid:10)(cid:11)(cid:10)(cid:46)(cid:14)(cid:2)(cid:9)(cid:11)(cid:4)(cid:3)(cid:49)(cid:4)(cid:8)(cid:5)(cid:2)(cid:28)(cid:3,Unknown,1686.0
Unknown,Unknown,24,Unknown,Unknown,Unknown,Unknown,cid:10)(cid:11)(cid:10)(cid:46)(cid:14)(cid:2)(cid:9)(cid:11)(cid:4)(cid:3)(cid:49)(cid:4)(cid:8)(cid:5)(cid:2)(cid:28)(cid:3,Unknown,1710.0
Unknown,Unknown,20,Unknown,Unknown,Unknown,Unknown,cid:10)(cid:11)(cid:10)(cid:46)(cid:14)(cid:2)(cid:9)(cid:11)(cid:4)(cid:3)(cid:49)(cid:4)(cid:8)(cid:5)(cid:2)(cid:28)(cid:3,Unknown,1730.0
Unknown,Unknown,30,Unknown,Unknown,Unknown,Unknown,cid:10)(cid:11)(cid:10)(cid:46)(cid:14)(cid:2)(cid:9)(cid:11)(cid:4)(cid:3)(cid:49)(cid:4)(cid:8)(cid:5)(cid:2)(cid:28)(cid:3,Unknown,1760.0
Unknown,Unknown,30,Unknown,Unknown,Unknown,Unknown,cid:10)(cid:11)(cid:10)(cid:46)(cid:14)(cid:2)(cid:9)(cid:11)(cid:4)(cid:3)(cid:49)(cid:4)(cid:8)(cid:5)(cid:2)(cid:28)(cid:3,Unknown,1790.0
Unknown,Unknown,25,Unknown,Unknown,Unknown,Unknown,cid:10)(cid:11)(cid:10)(cid:46)(cid:14)(cid:2)(cid:9)(cid:11)(cid:4)(cid:3)(cid:49)(cid:4)(cid:8)(cid:5)(cid:2)(cid:28)(cid:3,Unknown,1815.0
Unknown,Unknown,22,Unknown,Unknown,Unknown,Unknown,cid:10)(cid:11)(cid:10)(cid:46)(cid:14)(cid:2)(cid:9)(cid:11)(cid:4)(cid:3)(cid:49)(cid:4)(cid:8)(cid:5)(cid:2)(cid:28)(cid:3,Unknown,1837.0
Unknown,Unknown,27,Unknown,Unknown,Unknown,Unknown,cid:10)(cid:11)(cid:10)(cid:46)(cid:14)(cid:2)(cid:9)(cid:11)(cid:4)(cid:3)(cid:49)(cid:4)(cid:8)(cid:5)(cid:2)(cid:28)(cid:3,Unknown,1864.0
Unknown,Unknown,18,Unknown,Unknown,Unknown,Unknown,cid:10)(cid:11)(cid:10)(cid:46)(cid:14)(cid:2)(cid:9)(cid:11)(cid:4)(cid:3)(cid:49)(cid:4)(cid:8)(cid:5)(cid:2)(cid:28)(cid:3,Unknown,1882.0
Unknown,Unknown,37,Unknown,Unknown,Unknown,Unknown,cid:10)(cid:11)(cid:10)(cid:46)(cid:14)(cid:2)(cid:9)(cid:11)(cid:4)(cid:3)(cid:49)(cid:4)(cid:8)(cid:5)(cid:2)(cid:28)(cid:3,Unknown,1919.0
Unknown,Unknown,45,Unknown,Unknown,Unknown,Unknown,cid:10)(cid:11)(cid:10)(cid:46)(cid:14)(cid:2)(cid:9)(cid:11)(cid:4)(cid:3)(cid:49)(cid:4)(cid:8)(cid:5)(cid:2)(cid:28)(cid:3,Unknown,1964.0
Unknown,Unknown,18,Unknown,Unknown,Unknown,Unknown,cid:10)(cid:11)(cid:10)(cid:46)(cid:14)(cid:2)(cid:9)(cid:11)(cid:4)(cid:3)(cid:49)(cid:4)(cid:8)(cid:5)(cid:2)(cid:28)(cid:3,Unknown,1982.0
Unknown,Unknown,35,Unknown,Unknown,Unknown,Unknown,cid:10)(cid:11)(cid:10)(cid:46)(cid:14)(cid:2)(cid:9)(cid:11)(cid:4)(cid:3)(cid:49)(cid:4)(cid:8)(cid:5)(cid:2)(cid:28)(cid:3,Unknown,2017.0
Unknown,Unknown,10,Unknown,Unknown,Unknown,Unknown,cid:10)(cid:11)(cid:10)(cid:46)(cid:14)(cid:2)(cid:9)(cid:11)(cid:4)(cid:3)(cid:49)(cid:4)(cid:8)(cid:5)(cid:2)(cid:28)(cid:3,Unknown,2027.0
Unknown,Unknown,11,Unknown,Unknown,Unknown,Unknown,cid:10)(cid:11)(cid:10)(cid:46)(cid:14)(cid:2)(cid:9)(cid:11)(cid:4)(cid:3)(cid:49)(cid:4)(cid:8)(cid:5)(cid:2)(cid:28)(cid:3,Unknown,2038.0
Unknown,Unknown,10,Unknown,Unknown,Unknown,Unknown,cid:10)(cid:11)(cid:10)(cid:46)(cid:14)(cid:2)(cid:9)(cid:11)(cid:4)(cid:3)(cid:49)(cid:4)(cid:8)(cid:5)(cid:2)(cid:28)(cid:3,Unknown,2048.0
Unknown,Unknown,46,Unknown,Unknown,Unknown,Unknown,cid:10)(cid:11)(cid:10)(cid:46)(cid:14)(cid:2)(cid:9)(cid:11)(cid:4)(cid:3)(cid:49)(cid:4)(cid:8)(cid:5)(cid:2)(cid:28)(cid:3,Unknown,2094.0
Unknown,Unknown,14,Unknown,Unknown,Unknown,Unknown,cid:10)(cid:11)(cid:10)(cid:46)(cid:14)(cid:2)(cid:9)(cid:11)(cid:4)(cid:3)(cid:49)(cid:4)(cid:8)(cid:5)(cid:2)(cid:28)(cid:3,Unknown,2108.0
Unknown,Unknown,2,Unknown,Unknown,Unknown,Unknown,cid:10)(cid:11)(cid:10)(cid:46)(cid:14)(cid:2)(cid:9)(cid:11)(cid:4)(cid:3)(cid:49)(cid:4)(cid:8)(cid:5)(cid:2)(cid:28)(cid:3,Unknown,2110.0
Unknown,Unknown,9,Unknown,Unknown,Unknown,Unknown,cid:10)(cid:11)(cid:10)(cid:46)(cid:14)(cid:2)(cid:9)(cid:11)(cid:4)(cid:3)(cid:49)(cid:4)(cid:8)(cid:5)(cid:2)(cid:28)(cid:3,Unknown,2119.0
Unknown,Unknown,11,Unknown,Unknown,Unknown,Unknown,cid:10)(cid:11)(cid:10)(cid:46)(cid:14)(cid:2)(cid:9)(cid:11)(cid:4)(cid:3)(cid:49)(cid:4)(cid:8)(cid:5)(cid:2)(cid:28)(cid:3,Unknown,2130.0
Unknown,Unknown,4,Unknown,Unknown,Unknown,Unknown,cid:10)(cid:11)(cid:10)(cid:46)(cid:14)(cid:2)(cid:9)(cid:11)(cid:4)(cid:3)(cid:49)(cid:4)(cid:8)(cid:5)(cid:2)(cid:28)(cid:3,Unknown,2134.0
Unknown,Unknown,3,Unknown,Unknown,Unknown,Unknown,cid:10)(cid:11)(cid:10)(cid:46)(cid:14)(cid:2)(cid:9)(cid:11)(cid:4)(cid:3)(cid:49)(cid:4)(cid:8)(cid:5)(cid:2)(cid:28)(cid:3,Unknown,2137.0
Unknown,Unknown,49,Unknown,Unknown,Unknown,Unknown,cid:10)(cid:11)(cid:10)(cid:46)(cid:14)(cid:2)(cid:9)(cid:11)(cid:4)(cid:3)(cid:49)(cid:4)(cid:8)(cid:5)(cid:2)(cid:28)(cid:3,Unknown,2186.0
Unknown,Unknown,4,Unknown,Unknown,Unknown,Unknown,cid:10)(cid:11)(cid:10)(cid:46)(cid:14)(cid:2)(cid:9)(cid:11)(cid:4)(cid:3)(cid:49)(cid:4)(cid:8)(cid:5)(cid:2)(cid:28)(cid:3,Unknown,2190.0
Unknown,Unknown,8,Unknown,Unknown,Unknown,Unknown,cid:10)(cid:11)(cid:10)(cid:46)(cid:14)(cid:2)(cid:9)(cid:11)(cid:4)(cid:3)(cid:49)(cid:4)(cid:8)(cid:5)(cid:2)(cid:28)(cid:3,Unknown,2198.0
Unknown,Unknown,5,Unknown,Unknown,Unknown,Unknown,cid:10)(cid:11)(cid:10)(cid:46)(cid:14)(cid:2)(cid:9)(cid:11)(cid:4)(cid:3)(cid:49)(cid:4)(cid:8)(cid:5)(cid:2)(cid:28)(cid:3,Unknown,2203.0
Unknown,Unknown,2,Unknown,Unknown,Unknown,Unknown,cid:10)(cid:11)(cid:10)(cid:46)(cid:14)(cid:2)(cid:9)(cid:11)(cid:4)(cid:3)(cid:49)(cid:4)(cid:8)(cid:5)(cid:2)(cid:28)(cid:3,Unknown,2205.0
Unknown,Unknown,28,Unknown,Unknown,Unknown,Unknown,cid:10)(cid:11)(cid:10)(cid:46)(cid:14)(cid:2)(cid:9)(cid:11)(cid:4)(cid:3)(cid:49)(cid:4)(cid:8)(cid:5)(cid:2)(cid:28)(cid:3,Unknown,2233.0
Unknown,Unknown,3,Unknown,Unknown,Unknown,Unknown,cid:10)(cid:11)(cid:10)(cid:46)(cid:14)(cid:2)(cid:9)(cid:11)(cid:4)(cid:3)(cid:49)(cid:4)(cid:8)(cid:5)(cid:2)(cid:28)(cid:3,Unknown,2236.0
Unknown,Unknown,15,Unknown,Unknown,Unknown,Unknown,cid:10)(cid:11)(cid:10)(cid:46)(cid:14)(cid:2)(cid:9)(cid:11)(cid:4)(cid:3)(cid:49)(cid:4)(cid:8)(cid:5)(cid:2)(cid:28)(cid:3,Unknown,2251.0
Unknown,Unknown,2,Unknown,Unknown,Unknown,Unknown,cid:10)(cid:11)(cid:10)(cid:46)(cid:14)(cid:2)(cid:9)(cid:11)(cid:4)(cid:3)(cid:49)(cid:4)(cid:8)(cid:5)(cid:2)(cid:28)(cid:3,Unknown,2253.0
Unknown,Unknown,35,Unknown,Unknown,Unknown,Unknown,cid:10)(cid:11)(cid:10)(cid:46)(cid:14)(cid:2)(cid:9)(cid:11)(cid:4)(cid:3)(cid:49)(cid:4)(cid:8)(cid:5)(cid:2)(cid:28)(cid:3,Unknown,2288.0
Unknown,Unknown,35,Unknown,Unknown,Unknown,Unknown,cid:10)(cid:11)(cid:10)(cid:46)(cid:14)(cid:2)(cid:9)(cid:11)(cid:4)(cid:3)(cid:49)(cid:4)(cid:8)(cid:5)(cid:2)(cid:28)(cid:3,Unknown,2323.0
Unknown,Unknown,19,Unknown,Unknown,Unknown,Unknown,cid:10)(cid:11)(cid:10)(cid:46)(cid:14)(cid:2)(cid:9)(cid:11)(cid:4)(cid:3)(cid:49)(cid:4)(cid:8)(cid:5)(cid:2)(cid:28)(cid:3,Unknown,2342.0
Unknown,Unknown,18,Unknown,Unknown,Unknown,Unknown,cid:10)(cid:11)(cid:10)(cid:46)(cid:14)(cid:2)(cid:9)(cid:11)(cid:4)(cid:3)(cid:49)(cid:4)(cid:8)(cid:5)(cid:2)(cid:28)(cid:3,Unknown,2360.0
Unknown,Unknown,33,Unknown,Unknown,Unknown,Unknown,cid:10)(cid:11)(cid:10)(cid:46)(cid:14)(cid:2)(cid:9)(cid:11)(cid:4)(cid:3)(cid:49)(cid:4)(cid:8)(cid:5)(cid:2)(cid:28)(cid:3,Unknown,2393.0
Unknown,Unknown,2,Unknown,Unknown,Unknown,Unknown,cid:10)(cid:11)(cid:10)(cid:46)(cid:14)(cid:2)(cid:9)(cid:11)(cid:4)(cid:3)(cid:49)(cid:4)(cid:8)(cid:5)(cid:2)(cid:28)(cid:3,Unknown,2395.0
Unknown,Unknown,44,Unknown,Unknown,Unknown,Unknown,cid:10)(cid:11)(cid:10)(cid:46)(cid:14)(cid:2)(cid:9)(cid:11)(cid:4)(cid:3)(cid:49)(cid:4)(cid:8)(cid:5)(cid:2)(cid:28)(cid:3,Unknown,2439.0
Unknown,Unknown,12,Unknown,Unknown,Unknown,Unknown,cid:10)(cid:11)(cid:10)(cid:46)(cid:14)(cid:2)(cid:9)(cid:11)(cid:4)(cid:3)(cid:49)(cid:4)(cid:8)(cid:5)(cid:2)(cid:28)(cid:3,Unknown,2451.0
Unknown,Unknown,29,Unknown,Unknown,Unknown,Unknown,cid:10)(cid:11)(cid:10)(cid:46)(cid:14)(cid:2)(cid:9)(cid:11)(cid:4)(cid:3)(cid:49)(cid:4)(cid:8)(cid:5)(cid:2)(cid:28)(cid:3,Unknown,2480.0
Unknown,Unknown,26,Unknown,Unknown,Unknown,Unknown,cid:10)(cid:11)(cid:10)(cid:46)(cid:14)(cid:2)(cid:9)(cid:11)(cid:4)(cid:3)(cid:49)(cid:4)(cid:8)(cid:5)(cid:2)(cid:28)(cid:3,Unknown,2506.0
Unknown,Unknown,41,Unknown,Unknown,Unknown,Unknown,cid:10)(cid:11)(cid:10)(cid:46)(cid:14)(cid:2)(cid:9)(cid:11)(cid:4)(cid:3)(cid:49)(cid:4)(cid:8)(cid:5)(cid:2)(cid:28)(cid:3,Unknown,2547.0
Unknown,Unknown,25,Unknown,Unknown,Unknown,Unknown,cid:10)(cid:11)(cid:10)(cid:46)(cid:14)(cid:2)(cid:9)(cid:11)(cid:4)(cid:3)(cid:49)(cid:4)(cid:8)(cid:5)(cid:2)(cid:28)(cid:3,Unknown,2572.0
Unknown,Unknown,2,Unknown,Unknown,Unknown,Unknown,cid:10)(cid:11)(cid:10)(cid:46)(cid:14)(cid:2)(cid:9)(cid:11)(cid:4)(cid:3)(cid:49)(cid:4)(cid:8)(cid:5)(cid:2)(cid:28)(cid:3,Unknown,2574.0
Unknown,Unknown,50,Unknown,Unknown,Unknown,Unknown,cid:10)(cid:11)(cid:10)(cid:46)(cid:14)(cid:2)(cid:9)(cid:11)(cid:4)(cid:3)(cid:49)(cid:4)(cid:8)(cid:5)(cid:2)(cid:28)(cid:3,Unknown,2624.0
Unknown,Unknown,50,Unknown,Unknown,Unknown,Unknown,cid:10)(cid:11)(cid:10)(cid:46)(cid:14)(cid:2)(cid:9)(cid:11)(cid:4)(cid:3)(cid:49)(cid:4)(cid:8)(cid:5)(cid:2)(cid:28)(cid:3,Unknown,2674.0
Unknown,Unknown,18,Unknown,Unknown,Unknown,Unknown,cid:10)(cid:11)(cid:10)(cid:46)(cid:14)(cid:2)(cid:9)(cid:11)(cid:4)(cid:3)(cid:49)(cid:4)(cid:8)(cid:5)(cid:2)(cid:28)(cid:3,Unknown,2692.0
Unknown,Unknown,1,Unknown,Unknown,Unknown,Unknown,cid:10)(cid:11)(cid:10)(cid:46)(cid:14)(cid:2)(cid:9)(cid:11)(cid:4)(cid:3)(cid:49)(cid:4)(cid:8)(cid:5)(cid:2)(cid:28)(cid:3,Unknown,2693.0
Unknown,Unknown,1,Unknown,Unknown,Unknown,Unknown,cid:10)(cid:11)(cid:10)(cid:46)(cid:14)(cid:2)(cid:9)(cid:11)(cid:4)(cid:3)(cid:49)(cid:4)(cid:8)(cid:5)(cid:2)(cid:28)(cid:3,Unknown,2694.0
Unknown,Unknown,37,Unknown,Unknown,Unknown,Unknown,cid:10)(cid:11)(cid:10)(cid:46)(cid:14)(cid:2)(cid:9)(cid:11)(cid:4)(cid:3)(cid:49)(cid:4)(cid:8)(cid:5)(cid:2)(cid:28)(cid:3,Unknown,2731.0
Unknown,Unknown,18,Unknown,Unknown,Unknown,Unknown,cid:10)(cid:11)(cid:10)(cid:46)(cid:14)(cid:2)(cid:9)(cid:11)(cid:4)(cid:3)(cid:49)(cid:4)(cid:8)(cid:5)(cid:2)(cid:28)(cid:3,Unknown,2749.0
Unknown,Unknown,37,Unknown,Unknown,Unknown,Unknown,cid:10)(cid:11)(cid:10)(cid:46)(cid:14)(cid:2)(cid:9)(cid:11)(cid:4)(cid:3)(cid:49)(cid:4)(cid:8)(cid:5)(cid:2)(cid:28)(cid:3,Unknown,2786.0
Unknown,Unknown,45,Unknown,Unknown,Unknown,Unknown,cid:10)(cid:11)(cid:10)(cid:46)(cid:14)(cid:2)(cid:9)(cid:11)(cid:4)(cid:3)(cid:49)(cid:4)(cid:8)(cid:5)(cid:2)(cid:28)(cid:3,Unknown,2831.0
Unknown,Unknown,18,Unknown,Unknown,Unknown,Unknown,cid:10)(cid:11)(cid:10)(cid:46)(cid:14)(cid:2)(cid:9)(cid:11)(cid:4)(cid:3)(cid:49)(cid:4)(cid:8)(cid:5)(cid:2)(cid:28)(cid:3,Unknown,2849.0
Unknown,Unknown,35,Unknown,Unknown,Unknown,Unknown,cid:10)(cid:11)(cid:10)(cid:46)(cid:14)(cid:2)(cid:9)(cid:11)(cid:4)(cid:3)(cid:49)(cid:4)(cid:8)(cid:5)(cid:2)(cid:28)(cid:3,Unknown,2884.0
Unknown,Unknown,6,Unknown,Unknown,Unknown,Unknown,cid:10)(cid:11)(cid:10)(cid:46)(cid:14)(cid:2)(cid:9)(cid:11)(cid:4)(cid:3)(cid:49)(cid:4)(cid:8)(cid:5)(cid:2)(cid:28)(cid:3,Unknown,2890.0
Unknown,Unknown,5,Unknown,Unknown,Unknown,Unknown,cid:10)(cid:11)(cid:10)(cid:46)(cid:14)(cid:2)(cid:9)(cid:11)(cid:4)(cid:3)(cid:49)(cid:4)(cid:8)(cid:5)(cid:2)(cid:28)(cid:3,Unknown,2895.0
Unknown,Unknown,9,Unknown,Unknown,Unknown,Unknown,cid:10)(cid:11)(cid:10)(cid:46)(cid:14)(cid:2)(cid:9)(cid:11)(cid:4)(cid:3)(cid:49)(cid:4)(cid:8)(cid:5)(cid:2)(cid:28)(cid:3,Unknown,2904.0
Unknown,Unknown,10,Unknown,Unknown,Unknown,Unknown,cid:10)(cid:11)(cid:10)(cid:46)(cid:14)(cid:2)(cid:9)(cid:11)(cid:4)(cid:3)(cid:49)(cid:4)(cid:8)(cid:5)(cid:2)(cid:28)(cid:3,Unknown,2914.0
Unknown,Unknown,5,Unknown,Unknown,Unknown,Unknown,cid:10)(cid:11)(cid:10)(cid:46)(cid:14)(cid:2)(cid:9)(cid:11)(cid:4)(cid:3)(cid:49)(cid:4)(cid:8)(cid:5)(cid:2)(cid:28)(cid:3,Unknown,2919.0
Unknown,Unknown,3,Unknown,Unknown,Unknown,Unknown,cid:10)(cid:11)(cid:10)(cid:46)(cid:14)(cid:2)(cid:9)(cid:11)(cid:4)(cid:3)(cid:49)(cid:4)(cid:8)(cid:5)(cid:2)(cid:28)(cid:3,Unknown,2922.0
Unknown,Unknown,8,Unknown,Unknown,Unknown,Unknown,cid:10)(cid:11)(cid:10)(cid:46)(cid:14)(cid:2)(cid:9)(cid:11)(cid:4)(cid:3)(cid:49)(cid:4)(cid:8)(cid:5)(cid:2)(cid:28)(cid:3,Unknown,2930.0
Unknown,Unknown,2,Unknown,Unknown,Unknown,Unknown,cid:10)(cid:11)(cid:10)(cid:46)(cid:14)(cid:2)(cid:9)(cid:11)(cid:4)(cid:3)(cid:49)(cid:4)(cid:8)(cid:5)(cid:2)(cid:28)(cid:3,Unknown,2932.0
Unknown,Unknown,4,Unknown,Unknown,Unknown,Unknown,cid:10)(cid:11)(cid:10)(cid:46)(cid:14)(cid:2)(cid:9)(cid:11)(cid:4)(cid:3)(cid:49)(cid:4)(cid:8)(cid:5)(cid:2)(cid:28)(cid:3,Unknown,2936.0
Unknown,Unknown,8,Unknown,Unknown,Unknown,Unknown,cid:10)(cid:11)(cid:10)(cid:46)(cid:14)(cid:2)(cid:9)(cid:11)(cid:4)(cid:3)(cid:49)(cid:4)(cid:8)(cid:5)(cid:2)(cid:28)(cid:3,Unknown,2944.0
Unknown,Unknown,7,Unknown,Unknown,Unknown,Unknown,cid:10)(cid:11)(cid:10)(cid:46)(cid:14)(cid:2)(cid:9)(cid:11)(cid:4)(cid:3)(cid:49)(cid:4)(cid:8)(cid:5)(cid:2)(cid:28)(cid:3,Unknown,2951.0
Unknown,Unknown,11,Unknown,Unknown,Unknown,Unknown,cid:10)(cid:11)(cid:10)(cid:46)(cid:14)(cid:2)(cid:9)(cid:11)(cid:4)(cid:3)(cid:49)(cid:4)(cid:8)(cid:5)(cid:2)(cid:28)(cid:3,Unknown,2962.0
Unknown,Unknown,8,Unknown,Unknown,Unknown,Unknown,cid:10)(cid:11)(cid:10)(cid:46)(cid:14)(cid:2)(cid:9)(cid:11)(cid:4)(cid:3)(cid:49)(cid:4)(cid:8)(cid:5)(cid:2)(cid:28)(cid:3,Unknown,2970.0
Unknown,Unknown,2,Unknown,Unknown,Unknown,Unknown,cid:10)(cid:11)(cid:10)(cid:46)(cid:14)(cid:2)(cid:9)(cid:11)(cid:4)(cid:3)(cid:49)(cid:4)(cid:8)(cid:5)(cid:2)(cid:28)(cid:3,Unknown,2972.0
Unknown,Unknown,12,Unknown,Unknown,Unknown,Unknown,cid:10)(cid:11)(cid:10)(cid:46)(cid:14)(cid:2)(cid:9)(cid:11)(cid:4)(cid:3)(cid:49)(cid:4)(cid:8)(cid:5)(cid:2)(cid:28)(cid:3,Unknown,2984.0
Unknown,Unknown,11,Unknown,Unknown,Unknown,Unknown,cid:10)(cid:11)(cid:10)(cid:46)(cid:14)(cid:2)(cid:9)(cid:11)(cid:4)(cid:3)(cid:49)(cid:4)(cid:8)(cid:5)(cid:2)(cid:28)(cid:3,Unknown,2995.0
Unknown,Unknown,4,Unknown,Unknown,Unknown,Unknown,cid:10)(cid:11)(cid:10)(cid:46)(cid:14)(cid:2)(cid:9)(cid:11)(cid:4)(cid:3)(cid:49)(cid:4)(cid:8)(cid:5)(cid:2)(cid:28)(cid:3,Unknown,2999.0
Unknown,Unknown,3,Unknown,Unknown,Unknown,Unknown,cid:10)(cid:11)(cid:10)(cid:46)(cid:14)(cid:2)(cid:9)(cid:11)(cid:4)(cid:3)(cid:49)(cid:4)(cid:8)(cid:5)(cid:2)(cid:28)(cid:3,Unknown,3002.0
Unknown,Unknown,51,Unknown,Unknown,Unknown,Unknown,cid:10)(cid:11)(cid:10)(cid:46)(cid:14)(cid:2)(cid:9)(cid:11)(cid:4)(cid:3)(cid:49)(cid:4)(cid:8)(cid:5)(cid:2)(cid:28)(cid:3,Unknown,3053.0
Unknown,Unknown,5,Unknown,Unknown,Unknown,Unknown,cid:10)(cid:11)(cid:10)(cid:46)(cid:14)(cid:2)(cid:9)(cid:11)(cid:4)(cid:3)(cid:49)(cid:4)(cid:8)(cid:5)(cid:2)(cid:28)(cid:3,Unknown,3058.0
Unknown,Unknown,52,Unknown,Unknown,Unknown,Unknown,cid:10)(cid:11)(cid:10)(cid:46)(cid:14)(cid:2)(cid:9)(cid:11)(cid:4)(cid:3)(cid:49)(cid:4)(cid:8)(cid:5)(cid:2)(cid:28)(cid:3,Unknown,3110.0
Unknown,Unknown,11,Unknown,Unknown,Unknown,Unknown,cid:10)(cid:11)(cid:10)(cid:46)(cid:14)(cid:2)(cid:9)(cid:11)(cid:4)(cid:3)(cid:49)(cid:4)(cid:8)(cid:5)(cid:2)(cid:28)(cid:3,Unknown,3121.0
Unknown,Unknown,7,Unknown,Unknown,Unknown,Unknown,cid:10)(cid:11)(cid:10)(cid:46)(cid:14)(cid:2)(cid:9)(cid:11)(cid:4)(cid:3)(cid:49)(cid:4)(cid:8)(cid:5)(cid:2)(cid:28)(cid:3,Unknown,3128.0
Unknown,Unknown,5,Unknown,Unknown,Unknown,Unknown,cid:10)(cid:11)(cid:10)(cid:46)(cid:14)(cid:2)(cid:9)(cid:11)(cid:4)(cid:3)(cid:49)(cid:4)(cid:8)(cid:5)(cid:2)(cid:28)(cid:3,Unknown,3133.0
Unknown,Unknown,2,Unknown,Unknown,Unknown,Unknown,cid:10)(cid:11)(cid:10)(cid:46)(cid:14)(cid:2)(cid:9)(cid:11)(cid:4)(cid:3)(cid:49)(cid:4)(cid:8)(cid:5)(cid:2)(cid:28)(cid:3,Unknown,3135.0
Unknown,Unknown,28,Unknown,Unknown,Unknown,Unknown,cid:10)(cid:11)(cid:10)(cid:46)(cid:14)(cid:2)(cid:9)(cid:11)(cid:4)(cid:3)(cid:49)(cid:4)(cid:8)(cid:5)(cid:2)(cid:28)(cid:3,Unknown,3163.0
Unknown,Unknown,3,Unknown,Unknown,Unknown,Unknown,cid:10)(cid:11)(cid:10)(cid:46)(cid:14)(cid:2)(cid:9)(cid:11)(cid:4)(cid:3)(cid:49)(cid:4)(cid:8)(cid:5)(cid:2)(cid:28)(cid:3,Unknown,3166.0
Unknown,Unknown,15,Unknown,Unknown,Unknown,Unknown,cid:10)(cid:11)(cid:10)(cid:46)(cid:14)(cid:2)(cid:9)(cid:11)(cid:4)(cid:3)(cid:49)(cid:4)(cid:8)(cid:5)(cid:2)(cid:28)(cid:3,Unknown,3181.0
Unknown,Unknown,2,Unknown,Unknown,Unknown,Unknown,cid:10)(cid:11)(cid:10)(cid:46)(cid:14)(cid:2)(cid:9)(cid:11)(cid:4)(cid:3)(cid:49)(cid:4)(cid:8)(cid:5)(cid:2)(cid:28)(cid:3,Unknown,3183.0
Unknown,Unknown,17,Unknown,Unknown,Unknown,Unknown,cid:10)(cid:11)(cid:10)(cid:46)(cid:14)(cid:2)(cid:9)(cid:11)(cid:4)(cid:3)(cid:49)(cid:4)(cid:8)(cid:5)(cid:2)(cid:28)(cid:3,Unknown,3200.0
Unknown,Unknown,17,Unknown,Unknown,Unknown,Unknown,cid:10)(cid:11)(cid:10)(cid:46)(cid:14)(cid:2)(cid:9)(cid:11)(cid:4)(cid:3)(cid:49)(cid:4)(cid:8)(cid:5)(cid:2)(cid:28)(cid:3,Unknown,3217.0
Unknown,Unknown,18,Unknown,Unknown,Unknown,Unknown,cid:10)(cid:11)(cid:10)(cid:46)(cid:14)(cid:2)(cid:9)(cid:11)(cid:4)(cid:3)(cid:49)(cid:4)(cid:8)(cid:5)(cid:2)(cid:28)(cid:3,Unknown,3235.0
Unknown,Unknown,19,Unknown,Unknown,Unknown,Unknown,cid:10)(cid:11)(cid:10)(cid:46)(cid:14)(cid:2)(cid:9)(cid:11)(cid:4)(cid:3)(cid:49)(cid:4)(cid:8)(cid:5)(cid:2)(cid:28)(cid:3,Unknown,3254.0
Unknown,Unknown,18,Unknown,Unknown,Unknown,Unknown,cid:10)(cid:11)(cid:10)(cid:46)(cid:14)(cid:2)(cid:9)(cid:11)(cid:4)(cid:3)(cid:49)(cid:4)(cid:8)(cid:5)(cid:2)(cid:28)(cid:3,Unknown,3272.0
Unknown,Unknown,18,Unknown,Unknown,Unknown,Unknown,cid:10)(cid:11)(cid:10)(cid:46)(cid:14)(cid:2)(cid:9)(cid:11)(cid:4)(cid:3)(cid:49)(cid:4)(cid:8)(cid:5)(cid:2)(cid:28)(cid:3,Unknown,3290.0
Unknown,Unknown,2,Unknown,Unknown,Unknown,Unknown,cid:10)(cid:11)(cid:10)(cid:46)(cid:14)(cid:2)(cid:9)(cid:11)(cid:4)(cid:3)(cid:49)(cid:4)(cid:8)(cid:5)(cid:2)(cid:28)(cid:3,Unknown,3292.0
Unknown,Unknown,44,Unknown,Unknown,Unknown,Unknown,cid:10)(cid:11)(cid:10)(cid:46)(cid:14)(cid:2)(cid:9)(cid:11)(cid:4)(cid:3)(cid:49)(cid:4)(cid:8)(cid:5)(cid:2)(cid:28)(cid:3,Unknown,3336.0
Unknown,Unknown,12,Unknown,Unknown,Unknown,Unknown,cid:10)(cid:11)(cid:10)(cid:46)(cid:14)(cid:2)(cid:9)(cid:11)(cid:4)(cid:3)(cid:49)(cid:4)(cid:8)(cid:5)(cid:2)(cid:28)(cid:3,Unknown,3348.0
Unknown,Unknown,29,Unknown,Unknown,Unknown,Unknown,cid:10)(cid:11)(cid:10)(cid:46)(cid:14)(cid:2)(cid:9)(cid:11)(cid:4)(cid:3)(cid:49)(cid:4)(cid:8)(cid:5)(cid:2)(cid:28)(cid:3,Unknown,3377.0
Unknown,Unknown,26,Unknown,Unknown,Unknown,Unknown,cid:10)(cid:11)(cid:10)(cid:46)(cid:14)(cid:2)(cid:9)(cid:11)(cid:4)(cid:3)(cid:49)(cid:4)(cid:8)(cid:5)(cid:2)(cid:28)(cid:3,Unknown,3403.0
Unknown,Unknown,41,Unknown,Unknown,Unknown,Unknown,cid:10)(cid:11)(cid:10)(cid:46)(cid:14)(cid:2)(cid:9)(cid:11)(cid:4)(cid:3)(cid:49)(cid:4)(cid:8)(cid:5)(cid:2)(cid:28)(cid:3,Unknown,3444.0
Unknown,Unknown,25,Unknown,Unknown,Unknown,Unknown,cid:10)(cid:11)(cid:10)(cid:46)(cid:14)(cid:2)(cid:9)(cid:11)(cid:4)(cid:3)(cid:49)(cid:4)(cid:8)(cid:5)(cid:2)(cid:28)(cid:3,Unknown,3469.0
Unknown,Unknown,2,Unknown,Unknown,Unknown,Unknown,cid:10)(cid:11)(cid:10)(cid:46)(cid:14)(cid:2)(cid:9)(cid:11)(cid:4)(cid:3)(cid:49)(cid:4)(cid:8)(cid:5)(cid:2)(cid:28)(cid:3,Unknown,3471.0
Unknown,Unknown,50,Unknown,Unknown,Unknown,Unknown,cid:10)(cid:11)(cid:10)(cid:46)(cid:14)(cid:2)(cid:9)(cid:11)(cid:4)(cid:3)(cid:49)(cid:4)(cid:8)(cid:5)(cid:2)(cid:28)(cid:3,Unknown,3521.0
Unknown,Unknown,50,Unknown,Unknown,Unknown,Unknown,cid:10)(cid:11)(cid:10)(cid:46)(cid:14)(cid:2)(cid:9)(cid:11)(cid:4)(cid:3)(cid:49)(cid:4)(cid:8)(cid:5)(cid:2)(cid:28)(cid:3,Unknown,3571.0
Unknown,Unknown,37,Unknown,Unknown,Unknown,Unknown,cid:10)(cid:11)(cid:10)(cid:46)(cid:14)(cid:2)(cid:9)(cid:11)(cid:4)(cid:3)(cid:49)(cid:4)(cid:8)(cid:5)(cid:2)(cid:28)(cid:3,Unknown,3608.0
Unknown,Unknown,16,Unknown,Unknown,Unknown,Unknown,cid:10)(cid:11)(cid:10)(cid:46)(cid:14)(cid:2)(cid:9)(cid:11)(cid:4)(cid:3)(cid:49)(cid:4)(cid:8)(cid:5)(cid:2)(cid:28)(cid:3,Unknown,3624.0
Unknown,Unknown,34,Unknown,Unknown,Unknown,Unknown,cid:10)(cid:11)(cid:10)(cid:46)(cid:14)(cid:2)(cid:9)(cid:11)(cid:4)(cid:3)(cid:49)(cid:4)(cid:8)(cid:5)(cid:2)(cid:28)(cid:3,Unknown,3658.0
Unknown,Unknown,33,Unknown,Unknown,Unknown,Unknown,cid:10)(cid:11)(cid:10)(cid:46)(cid:14)(cid:2)(cid:9)(cid:11)(cid:4)(cid:3)(cid:49)(cid:4)(cid:8)(cid:5)(cid:2)(cid:28)(cid:3,Unknown,3691.0
Unknown,Unknown,18,Unknown,Unknown,Unknown,Unknown,cid:10)(cid:11)(cid:10)(cid:46)(cid:14)(cid:2)(cid:9)(cid:11)(cid:4)(cid:3)(cid:49)(cid:4)(cid:8)(cid:5)(cid:2)(cid:28)(cid:3,Unknown,3709.0
Unknown,Unknown,37,Unknown,Unknown,Unknown,Unknown,cid:10)(cid:11)(cid:10)(cid:46)(cid:14)(cid:2)(cid:9)(cid:11)(cid:4)(cid:3)(cid:49)(cid:4)(cid:8)(cid:5)(cid:2)(cid:28)(cid:3,Unknown,3746.0
Unknown,Unknown,45,Unknown,Unknown,Unknown,Unknown,cid:10)(cid:11)(cid:10)(cid:46)(cid:14)(cid:2)(cid:9)(cid:11)(cid:4)(cid:3)(cid:49)(cid:4)(cid:8)(cid:5)(cid:2)(cid:28)(cid:3,Unknown,3791.0
Unknown,Unknown,18,Unknown,Unknown,Unknown,Unknown,cid:10)(cid:11)(cid:10)(cid:46)(cid:14)(cid:2)(cid:9)(cid:11)(cid:4)(cid:3)(cid:49)(cid:4)(cid:8)(cid:5)(cid:2)(cid:28)(cid:3,Unknown,3809.0
Unknown,Unknown,35,Unknown,Unknown,Unknown,Unknown,cid:10)(cid:11)(cid:10)(cid:46)(cid:14)(cid:2)(cid:9)(cid:11)(cid:4)(cid:3)(cid:49)(cid:4)(cid:8)(cid:5)(cid:2)(cid:28)(cid:3,Unknown,3844.0
Unknown,Unknown,46,Unknown,Unknown,Unknown,Unknown,cid:10)(cid:11)(cid:10)(cid:46)(cid:14)(cid:2)(cid:9)(cid:11)(cid:4)(cid:3)(cid:49)(cid:4)(cid:8)(cid:5)(cid:2)(cid:28)(cid:3,Unknown,3890.0
Unknown,Unknown,8,Unknown,Unknown,Unknown,Unknown,cid:10)(cid:11)(cid:10)(cid:46)(cid:14)(cid:2)(cid:9)(cid:11)(cid:4)(cid:3)(cid:49)(cid:4)(cid:8)(cid:5)(cid:2)(cid:28)(cid:3,Unknown,3898.0
Unknown,Unknown,46,Unknown,Unknown,Unknown,Unknown,cid:10)(cid:11)(cid:10)(cid:46)(cid:14)(cid:2)(cid:9)(cid:11)(cid:4)(cid:3)(cid:49)(cid:4)(cid:8)(cid:5)(cid:2)(cid:28)(cid:3,Unknown,3944.0
Unknown,Unknown,7,Unknown,Unknown,Unknown,Unknown,cid:10)(cid:11)(cid:10)(cid:46)(cid:14)(cid:2)(cid:9)(cid:11)(cid:4)(cid:3)(cid:49)(cid:4)(cid:8)(cid:5)(cid:2)(cid:28)(cid:3,Unknown,3951.0
Unknown,Unknown,9,Unknown,Unknown,Unknown,Unknown,cid:10)(cid:11)(cid:10)(cid:46)(cid:14)(cid:2)(cid:9)(cid:11)(cid:4)(cid:3)(cid:49)(cid:4)(cid:8)(cid:5)(cid:2)(cid:28)(cid:3,Unknown,3960.0
Unknown,Unknown,2,Unknown,Unknown,Unknown,Unknown,cid:10)(cid:11)(cid:10)(cid:46)(cid:14)(cid:2)(cid:9)(cid:11)(cid:4)(cid:3)(cid:49)(cid:4)(cid:8)(cid:5)(cid:2)(cid:28)(cid:3,Unknown,3962.0
Unknown,Unknown,14,Unknown,Unknown,Unknown,Unknown,cid:10)(cid:11)(cid:10)(cid:46)(cid:14)(cid:2)(cid:9)(cid:11)(cid:4)(cid:3)(cid:49)(cid:4)(cid:8)(cid:5)(cid:2)(cid:28)(cid:3,Unknown,3976.0
Unknown,Unknown,46,Unknown,Unknown,Unknown,Unknown,cid:10)(cid:11)(cid:10)(cid:46)(cid:14)(cid:2)(cid:9)(cid:11)(cid:4)(cid:3)(cid:49)(cid:4)(cid:8)(cid:5)(cid:2)(cid:28)(cid:3,Unknown,4022.0
Unknown,Unknown,2,Unknown,Unknown,Unknown,Unknown,cid:10)(cid:11)(cid:10)(cid:46)(cid:14)(cid:2)(cid:9)(cid:11)(cid:4)(cid:3)(cid:49)(cid:4)(cid:8)(cid:5)(cid:2)(cid:28)(cid:3,Unknown,4024.0
Unknown,Unknown,28,Unknown,Unknown,Unknown,Unknown,cid:10)(cid:11)(cid:10)(cid:46)(cid:14)(cid:2)(cid:9)(cid:11)(cid:4)(cid:3)(cid:49)(cid:4)(cid:8)(cid:5)(cid:2)(cid:28)(cid:3,Unknown,4052.0
Unknown,Unknown,5,Unknown,Unknown,Unknown,Unknown,cid:10)(cid:11)(cid:10)(cid:46)(cid:14)(cid:2)(cid:9)(cid:11)(cid:4)(cid:3)(cid:49)(cid:4)(cid:8)(cid:5)(cid:2)(cid:28)(cid:3,Unknown,4057.0
Unknown,Unknown,3,Unknown,Unknown,Unknown,Unknown,cid:10)(cid:11)(cid:10)(cid:46)(cid:14)(cid:2)(cid:9)(cid:11)(cid:4)(cid:3)(cid:49)(cid:4)(cid:8)(cid:5)(cid:2)(cid:28)(cid:3,Unknown,4060.0
Unknown,Unknown,10,Unknown,Unknown,Unknown,Unknown,cid:10)(cid:11)(cid:10)(cid:46)(cid:14)(cid:2)(cid:9)(cid:11)(cid:4)(cid:3)(cid:49)(cid:4)(cid:8)(cid:5)(cid:2)(cid:28)(cid:3,Unknown,4070.0
Unknown,Unknown,5,Unknown,Unknown,Unknown,Unknown,cid:10)(cid:11)(cid:10)(cid:46)(cid:14)(cid:2)(cid:9)(cid:11)(cid:4)(cid:3)(cid:49)(cid:4)(cid:8)(cid:5)(cid:2)(cid:28)(cid:3,Unknown,4075.0
Unknown,Unknown,2,Unknown,Unknown,Unknown,Unknown,cid:10)(cid:11)(cid:10)(cid:46)(cid:14)(cid:2)(cid:9)(cid:11)(cid:4)(cid:3)(cid:49)(cid:4)(cid:8)(cid:5)(cid:2)(cid:28)(cid:3,Unknown,4077.0
Unknown,Unknown,53,Unknown,Unknown,Unknown,Unknown,cid:10)(cid:11)(cid:10)(cid:46)(cid:14)(cid:2)(cid:9)(cid:11)(cid:4)(cid:3)(cid:49)(cid:4)(cid:8)(cid:5)(cid:2)(cid:28)(cid:3,Unknown,4130.0
Unknown,Unknown,2,Unknown,Unknown,Unknown,Unknown,cid:10)(cid:11)(cid:10)(cid:46)(cid:14)(cid:2)(cid:9)(cid:11)(cid:4)(cid:3)(cid:49)(cid:4)(cid:8)(cid:5)(cid:2)(cid:28)(cid:3,Unknown,4132.0
Unknown,Unknown,28,Unknown,Unknown,Unknown,Unknown,cid:10)(cid:11)(cid:10)(cid:46)(cid:14)(cid:2)(cid:9)(cid:11)(cid:4)(cid:3)(cid:49)(cid:4)(cid:8)(cid:5)(cid:2)(cid:28)(cid:3,Unknown,4160.0
Unknown,Unknown,3,Unknown,Unknown,Unknown,Unknown,cid:10)(cid:11)(cid:10)(cid:46)(cid:14)(cid:2)(cid:9)(cid:11)(cid:4)(cid:3)(cid:49)(cid:4)(cid:8)(cid:5)(cid:2)(cid:28)(cid:3,Unknown,4163.0
Unknown,Unknown,15,Unknown,Unknown,Unknown,Unknown,cid:10)(cid:11)(cid:10)(cid:46)(cid:14)(cid:2)(cid:9)(cid:11)(cid:4)(cid:3)(cid:49)(cid:4)(cid:8)(cid:5)(cid:2)(cid:28)(cid:3,Unknown,4178.0
Unknown,Unknown,2,Unknown,Unknown,Unknown,Unknown,cid:10)(cid:11)(cid:10)(cid:46)(cid:14)(cid:2)(cid:9)(cid:11)(cid:4)(cid:3)(cid:49)(cid:4)(cid:8)(cid:5)(cid:2)(cid:28)(cid:3,Unknown,4180.0
Unknown,Unknown,17,Unknown,Unknown,Unknown,Unknown,cid:10)(cid:11)(cid:10)(cid:46)(cid:14)(cid:2)(cid:9)(cid:11)(cid:4)(cid:3)(cid:49)(cid:4)(cid:8)(cid:5)(cid:2)(cid:28)(cid:3,Unknown,4197.0
Unknown,Unknown,34,Unknown,Unknown,Unknown,Unknown,cid:10)(cid:11)(cid:10)(cid:46)(cid:14)(cid:2)(cid:9)(cid:11)(cid:4)(cid:3)(cid:49)(cid:4)(cid:8)(cid:5)(cid:2)(cid:28)(cid:3,Unknown,4231.0
Unknown,Unknown,19,Unknown,Unknown,Unknown,Unknown,cid:10)(cid:11)(cid:10)(cid:46)(cid:14)(cid:2)(cid:9)(cid:11)(cid:4)(cid:3)(cid:49)(cid:4)(cid:8)(cid:5)(cid:2)(cid:28)(cid:3,Unknown,4250.0
Unknown,Unknown,18,Unknown,Unknown,Unknown,Unknown,cid:10)(cid:11)(cid:10)(cid:46)(cid:14)(cid:2)(cid:9)(cid:11)(cid:4)(cid:3)(cid:49)(cid:4)(cid:8)(cid:5)(cid:2)(cid:28)(cid:3,Unknown,4268.0
Unknown,Unknown,18,Unknown,Unknown,Unknown,Unknown,cid:10)(cid:11)(cid:10)(cid:46)(cid:14)(cid:2)(cid:9)(cid:11)(cid:4)(cid:3)(cid:49)(cid:4)(cid:8)(cid:5)(cid:2)(cid:28)(cid:3,Unknown,4286.0
Unknown,Unknown,2,Unknown,Unknown,Unknown,Unknown,cid:10)(cid:11)(cid:10)(cid:46)(cid:14)(cid:2)(cid:9)(cid:11)(cid:4)(cid:3)(cid:49)(cid:4)(cid:8)(cid:5)(cid:2)(cid:28)(cid:3,Unknown,4288.0
Unknown,Unknown,44,Unknown,Unknown,Unknown,Unknown,cid:10)(cid:11)(cid:10)(cid:46)(cid:14)(cid:2)(cid:9)(cid:11)(cid:4)(cid:3)(cid:49)(cid:4)(cid:8)(cid:5)(cid:2)(cid:28)(cid:3,Unknown,4332.0
Unknown,Unknown,12,Unknown,Unknown,Unknown,Unknown,cid:10)(cid:11)(cid:10)(cid:46)(cid:14)(cid:2)(cid:9)(cid:11)(cid:4)(cid:3)(cid:49)(cid:4)(cid:8)(cid:5)(cid:2)(cid:28)(cid:3,Unknown,4344.0
Unknown,Unknown,29,Unknown,Unknown,Unknown,Unknown,cid:10)(cid:11)(cid:10)(cid:46)(cid:14)(cid:2)(cid:9)(cid:11)(cid:4)(cid:3)(cid:49)(cid:4)(cid:8)(cid:5)(cid:2)(cid:28)(cid:3,Unknown,4373.0
Unknown,Unknown,26,Unknown,Unknown,Unknown,Unknown,cid:10)(cid:11)(cid:10)(cid:46)(cid:14)(cid:2)(cid:9)(cid:11)(cid:4)(cid:3)(cid:49)(cid:4)(cid:8)(cid:5)(cid:2)(cid:28)(cid:3,Unknown,4399.0
Unknown,Unknown,41,Unknown,Unknown,Unknown,Unknown,cid:10)(cid:11)(cid:10)(cid:46)(cid:14)(cid:2)(cid:9)(cid:11)(cid:4)(cid:3)(cid:49)(cid:4)(cid:8)(cid:5)(cid:2)(cid:28)(cid:3,Unknown,4440.0
Unknown,Unknown,25,Unknown,Unknown,Unknown,Unknown,cid:10)(cid:11)(cid:10)(cid:46)(cid:14)(cid:2)(cid:9)(cid:11)(cid:4)(cid:3)(cid:49)(cid:4)(cid:8)(cid:5)(cid:2)(cid:28)(cid:3,Unknown,4465.0
Unknown,Unknown,2,Unknown,Unknown,Unknown,Unknown,cid:10)(cid:11)(cid:10)(cid:46)(cid:14)(cid:2)(cid:9)(cid:11)(cid:4)(cid:3)(cid:49)(cid:4)(cid:8)(cid:5)(cid:2)(cid:28)(cid:3,Unknown,4467.0
Unknown,Unknown,50,Unknown,Unknown,Unknown,Unknown,cid:10)(cid:11)(cid:10)(cid:46)(cid:14)(cid:2)(cid:9)(cid:11)(cid:4)(cid:3)(cid:49)(cid:4)(cid:8)(cid:5)(cid:2)(cid:28)(cid:3,Unknown,4517.0
Unknown,Unknown,50,Unknown,Unknown,Unknown,Unknown,cid:10)(cid:11)(cid:10)(cid:46)(cid:14)(cid:2)(cid:9)(cid:11)(cid:4)(cid:3)(cid:49)(cid:4)(cid:8)(cid:5)(cid:2)(cid:28)(cid:3,Unknown,4567.0
Unknown,Unknown,18,Unknown,Unknown,Unknown,Unknown,cid:10)(cid:11)(cid:10)(cid:46)(cid:14)(cid:2)(cid:9)(cid:11)(cid:4)(cid:3)(cid:49)(cid:4)(cid:8)(cid:5)(cid:2)(cid:28)(cid:3,Unknown,4585.0
Unknown,Unknown,1,Unknown,Unknown,Unknown,Unknown,cid:10)(cid:11)(cid:10)(cid:46)(cid:14)(cid:2)(cid:9)(cid:11)(cid:4)(cid:3)(cid:49)(cid:4)(cid:8)(cid:5)(cid:2)(cid:28)(cid:3,Unknown,4586.0
Unknown,Unknown,1,Unknown,Unknown,Unknown,Unknown,cid:10)(cid:11)(cid:10)(cid:46)(cid:14)(cid:2)(cid:9)(cid:11)(cid:4)(cid:3)(cid:49)(cid:4)(cid:8)(cid:5)(cid:2)(cid:28)(cid:3,Unknown,4587.0
Unknown,Unknown,37,Unknown,Unknown,Unknown,Unknown,cid:10)(cid:11)(cid:10)(cid:46)(cid:14)(cid:2)(cid:9)(cid:11)(cid:4)(cid:3)(cid:49)(cid:4)(cid:8)(cid:5)(cid:2)(cid:28)(cid:3,Unknown,4624.0
Unknown,Unknown,18,Unknown,Unknown,Unknown,Unknown,cid:10)(cid:11)(cid:10)(cid:46)(cid:14)(cid:2)(cid:9)(cid:11)(cid:4)(cid:3)(cid:49)(cid:4)(cid:8)(cid:5)(cid:2)(cid:28)(cid:3,Unknown,4642.0
Unknown,Unknown,37,Unknown,Unknown,Unknown,Unknown,cid:10)(cid:11)(cid:10)(cid:46)(cid:14)(cid:2)(cid:9)(cid:11)(cid:4)(cid:3)(cid:49)(cid:4)(cid:8)(cid:5)(cid:2)(cid:28)(cid:3,Unknown,4679.0
Unknown,Unknown,45,Unknown,Unknown,Unknown,Unknown,cid:10)(cid:11)(cid:10)(cid:46)(cid:14)(cid:2)(cid:9)(cid:11)(cid:4)(cid:3)(cid:49)(cid:4)(cid:8)(cid:5)(cid:2)(cid:28)(cid:3,Unknown,4724.0
Unknown,Unknown,18,Unknown,Unknown,Unknown,Unknown,cid:10)(cid:11)(cid:10)(cid:46)(cid:14)(cid:2)(cid:9)(cid:11)(cid:4)(cid:3)(cid:49)(cid:4)(cid:8)(cid:5)(cid:2)(cid:28)(cid:3,Unknown,4742.0
Unknown,Unknown,35,Unknown,Unknown,Unknown,Unknown,cid:10)(cid:11)(cid:10)(cid:46)(cid:14)(cid:2)(cid:9)(cid:11)(cid:4)(cid:3)(cid:49)(cid:4)(cid:8)(cid:5)(cid:2)(cid:28)(cid:3,Unknown,4777.0
Unknown,Unknown,11,Unknown,Unknown,Unknown,Unknown,cid:10)(cid:11)(cid:10)(cid:46)(cid:14)(cid:2)(cid:9)(cid:11)(cid:4)(cid:3)(cid:49)(cid:4)(cid:8)(cid:5)(cid:2)(cid:28)(cid:3,Unknown,4788.0
Unknown,Unknown,2,Unknown,Unknown,Unknown,Unknown,cid:10)(cid:11)(cid:10)(cid:46)(cid:14)(cid:2)(cid:9)(cid:11)(cid:4)(cid:3)(cid:49)(cid:4)(cid:8)(cid:5)(cid:2)(cid:28)(cid:3,Unknown,4790.0
Unknown,Unknown,10,Unknown,Unknown,Unknown,Unknown,cid:10)(cid:11)(cid:10)(cid:46)(cid:14)(cid:2)(cid:9)(cid:11)(cid:4)(cid:3)(cid:49)(cid:4)(cid:8)(cid:5)(cid:2)(cid:28)(cid:3,Unknown,4800.0
Unknown,Unknown,46,Unknown,Unknown,Unknown,Unknown,cid:10)(cid:11)(cid:10)(cid:46)(cid:14)(cid:2)(cid:9)(cid:11)(cid:4)(cid:3)(cid:49)(cid:4)(cid:8)(cid:5)(cid:2)(cid:28)(cid:3,Unknown,4846.0
Unknown,Unknown,12,Unknown,Unknown,Unknown,Unknown,cid:10)(cid:11)(cid:10)(cid:46)(cid:14)(cid:2)(cid:9)(cid:11)(cid:4)(cid:3)(cid:49)(cid:4)(cid:8)(cid:5)(cid:2)(cid:28)(cid:3,Unknown,4858.0
Unknown,Unknown,11,Unknown,Unknown,Unknown,Unknown,cid:10)(cid:11)(cid:10)(cid:46)(cid:14)(cid:2)(cid:9)(cid:11)(cid:4)(cid:3)(cid:49)(cid:4)(cid:8)(cid:5)(cid:2)(cid:28)(cid:3,Unknown,4869.0
Unknown,Unknown,9,Unknown,Unknown,Unknown,Unknown,cid:10)(cid:11)(cid:10)(cid:46)(cid:14)(cid:2)(cid:9)(cid:11)(cid:4)(cid:3)(cid:49)(cid:4)(cid:8)(cid:5)(cid:2)(cid:28)(cid:3,Unknown,4878.0
Unknown,Unknown,2,Unknown,Unknown,Unknown,Unknown,cid:10)(cid:11)(cid:10)(cid:46)(cid:14)(cid:2)(cid:9)(cid:11)(cid:4)(cid:3)(cid:49)(cid:4)(cid:8)(cid:5)(cid:2)(cid:28)(cid:3,Unknown,4880.0
Unknown,Unknown,39,Unknown,Unknown,Unknown,Unknown,cid:10)(cid:11)(cid:10)(cid:46)(cid:14)(cid:2)(cid:9)(cid:11)(cid:4)(cid:3)(cid:49)(cid:4)(cid:8)(cid:5)(cid:2)(cid:28)(cid:3,Unknown,4919.0
Unknown,Unknown,3,Unknown,Unknown,Unknown,Unknown,cid:10)(cid:11)(cid:10)(cid:46)(cid:14)(cid:2)(cid:9)(cid:11)(cid:4)(cid:3)(cid:49)(cid:4)(cid:8)(cid:5)(cid:2)(cid:28)(cid:3,Unknown,4922.0
Unknown,Unknown,11,Unknown,Unknown,Unknown,Unknown,cid:10)(cid:11)(cid:10)(cid:46)(cid:14)(cid:2)(cid:9)(cid:11)(cid:4)(cid:3)(cid:49)(cid:4)(cid:8)(cid:5)(cid:2)(cid:28)(cid:3,Unknown,4933.0
Unknown,Unknown,52,Unknown,Unknown,Unknown,Unknown,cid:10)(cid:11)(cid:10)(cid:46)(cid:14)(cid:2)(cid:9)(cid:11)(cid:4)(cid:3)(cid:49)(cid:4)(cid:8)(cid:5)(cid:2)(cid:28)(cid:3,Unknown,4985.0
Unknown,Unknown,7,Unknown,Unknown,Unknown,Unknown,cid:10)(cid:11)(cid:10)(cid:46)(cid:14)(cid:2)(cid:9)(cid:11)(cid:4)(cid:3)(cid:49)(cid:4)(cid:8)(cid:5)(cid:2)(cid:28)(cid:3,Unknown,4992.0
Unknown,Unknown,8,Unknown,Unknown,Unknown,Unknown,cid:10)(cid:11)(cid:10)(cid:46)(cid:14)(cid:2)(cid:9)(cid:11)(cid:4)(cid:3)(cid:49)(cid:4)(cid:8)(cid:5)(cid:2)(cid:28)(cid:3,Unknown,5000.0
Unknown,Unknown,9,Unknown,Unknown,Unknown,Unknown,cid:10)(cid:11)(cid:10)(cid:46)(cid:14)(cid:2)(cid:9)(cid:11)(cid:4)(cid:3)(cid:49)(cid:4)(cid:8)(cid:5)(cid:2)(cid:28)(cid:3,Unknown,5009.0
Unknown,Unknown,2,Unknown,Unknown,Unknown,Unknown,cid:10)(cid:11)(cid:10)(cid:46)(cid:14)(cid:2)(cid:9)(cid:11)(cid:4)(cid:3)(cid:49)(cid:4)(cid:8)(cid:5)(cid:2)(cid:28)(cid:3,Unknown,5011.0
Unknown,Unknown,28,Unknown,Unknown,Unknown,Unknown,cid:10)(cid:11)(cid:10)(cid:46)(cid:14)(cid:2)(cid:9)(cid:11)(cid:4)(cid:3)(cid:49)(cid:4)(cid:8)(cid:5)(cid:2)(cid:28)(cid:3,Unknown,5039.0
Unknown,Unknown,3,Unknown,Unknown,Unknown,Unknown,cid:10)(cid:11)(cid:10)(cid:46)(cid:14)(cid:2)(cid:9)(cid:11)(cid:4)(cid:3)(cid:49)(cid:4)(cid:8)(cid:5)(cid:2)(cid:28)(cid:3,Unknown,5042.0
Unknown,Unknown,15,Unknown,Unknown,Unknown,Unknown,cid:10)(cid:11)(cid:10)(cid:46)(cid:14)(cid:2)(cid:9)(cid:11)(cid:4)(cid:3)(cid:49)(cid:4)(cid:8)(cid:5)(cid:2)(cid:28)(cid:3,Unknown,5057.0
Unknown,Unknown,2,Unknown,Unknown,Unknown,Unknown,cid:10)(cid:11)(cid:10)(cid:46)(cid:14)(cid:2)(cid:9)(cid:11)(cid:4)(cid:3)(cid:49)(cid:4)(cid:8)(cid:5)(cid:2)(cid:28)(cid:3,Unknown,5059.0
Unknown,Unknown,17,Unknown,Unknown,Unknown,Unknown,cid:10)(cid:11)(cid:10)(cid:46)(cid:14)(cid:2)(cid:9)(cid:11)(cid:4)(cid:3)(cid:49)(cid:4)(cid:8)(cid:5)(cid:2)(cid:28)(cid:3,Unknown,5076.0
Unknown,Unknown,16,Unknown,Unknown,Unknown,Unknown,cid:10)(cid:11)(cid:10)(cid:46)(cid:14)(cid:2)(cid:9)(cid:11)(cid:4)(cid:3)(cid:49)(cid:4)(cid:8)(cid:5)(cid:2)(cid:28)(cid:3,Unknown,5092.0
Unknown,Unknown,19,Unknown,Unknown,Unknown,Unknown,cid:10)(cid:11)(cid:10)(cid:46)(cid:14)(cid:2)(cid:9)(cid:11)(cid:4)(cid:3)(cid:49)(cid:4)(cid:8)(cid:5)(cid:2)(cid:28)(cid:3,Unknown,5111.0
Unknown,Unknown,18,Unknown,Unknown,Unknown,Unknown,cid:10)(cid:11)(cid:10)(cid:46)(cid:14)(cid:2)(cid:9)(cid:11)(cid:4)(cid:3)(cid:49)(cid:4)(cid:8)(cid:5)(cid:2)(cid:28)(cid:3,Unknown,5129.0
Unknown,Unknown,18,Unknown,Unknown,Unknown,Unknown,cid:10)(cid:11)(cid:10)(cid:46)(cid:14)(cid:2)(cid:9)(cid:11)(cid:4)(cid:3)(cid:49)(cid:4)(cid:8)(cid:5)(cid:2)(cid:28)(cid:3,Unknown,5147.0
Unknown,Unknown,2,Unknown,Unknown,Unknown,Unknown,cid:10)(cid:11)(cid:10)(cid:46)(cid:14)(cid:2)(cid:9)(cid:11)(cid:4)(cid:3)(cid:49)(cid:4)(cid:8)(cid:5)(cid:2)(cid:28)(cid:3,Unknown,5149.0
Unknown,Unknown,44,Unknown,Unknown,Unknown,Unknown,cid:10)(cid:11)(cid:10)(cid:46)(cid:14)(cid:2)(cid:9)(cid:11)(cid:4)(cid:3)(cid:49)(cid:4)(cid:8)(cid:5)(cid:2)(cid:28)(cid:3,Unknown,5193.0
Unknown,Unknown,12,Unknown,Unknown,Unknown,Unknown,cid:10)(cid:11)(cid:10)(cid:46)(cid:14)(cid:2)(cid:9)(cid:11)(cid:4)(cid:3)(cid:49)(cid:4)(cid:8)(cid:5)(cid:2)(cid:28)(cid:3,Unknown,5205.0
Unknown,Unknown,29,Unknown,Unknown,Unknown,Unknown,cid:10)(cid:11)(cid:10)(cid:46)(cid:14)(cid:2)(cid:9)(cid:11)(cid:4)(cid:3)(cid:49)(cid:4)(cid:8)(cid:5)(cid:2)(cid:28)(cid:3,Unknown,5234.0
Unknown,Unknown,26,Unknown,Unknown,Unknown,Unknown,cid:10)(cid:11)(cid:10)(cid:46)(cid:14)(cid:2)(cid:9)(cid:11)(cid:4)(cid:3)(cid:49)(cid:4)(cid:8)(cid:5)(cid:2)(cid:28)(cid:3,Unknown,5260.0
Unknown,Unknown,41,Unknown,Unknown,Unknown,Unknown,cid:10)(cid:11)(cid:10)(cid:46)(cid:14)(cid:2)(cid:9)(cid:11)(cid:4)(cid:3)(cid:49)(cid:4)(cid:8)(cid:5)(cid:2)(cid:28)(cid:3,Unknown,5301.0
Unknown,Unknown,25,Unknown,Unknown,Unknown,Unknown,cid:10)(cid:11)(cid:10)(cid:46)(cid:14)(cid:2)(cid:9)(cid:11)(cid:4)(cid:3)(cid:49)(cid:4)(cid:8)(cid:5)(cid:2)(cid:28)(cid:3,Unknown,5326.0
Unknown,Unknown,2,Unknown,Unknown,Unknown,Unknown,cid:10)(cid:11)(cid:10)(cid:46)(cid:14)(cid:2)(cid:9)(cid:11)(cid:4)(cid:3)(cid:49)(cid:4)(cid:8)(cid:5)(cid:2)(cid:28)(cid:3,Unknown,5328.0
Unknown,Unknown,50,Unknown,Unknown,Unknown,Unknown,cid:10)(cid:11)(cid:10)(cid:46)(cid:14)(cid:2)(cid:9)(cid:11)(cid:4)(cid:3)(cid:49)(cid:4)(cid:8)(cid:5)(cid:2)(cid:28)(cid:3,Unknown,5378.0
Unknown,Unknown,50,Unknown,Unknown,Unknown,Unknown,cid:10)(cid:11)(cid:10)(cid:46)(cid:14)(cid:2)(cid:9)(cid:11)(cid:4)(cid:3)(cid:49)(cid:4)(cid:8)(cid:5)(cid:2)(cid:28)(cid:3,Unknown,5428.0
Unknown,Unknown,18,Unknown,Unknown,Unknown,Unknown,cid:10)(cid:11)(cid:10)(cid:46)(cid:14)(cid:2)(cid:9)(cid:11)(cid:4)(cid:3)(cid:49)(cid:4)(cid:8)(cid:5)(cid:2)(cid:28)(cid:3,Unknown,5446.0
Unknown,Unknown,1,Unknown,Unknown,Unknown,Unknown,cid:10)(cid:11)(cid:10)(cid:46)(cid:14)(cid:2)(cid:9)(cid:11)(cid:4)(cid:3)(cid:49)(cid:4)(cid:8)(cid:5)(cid:2)(cid:28)(cid:3,Unknown,5447.0
Unknown,Unknown,1,Unknown,Unknown,Unknown,Unknown,cid:10)(cid:11)(cid:10)(cid:46)(cid:14)(cid:2)(cid:9)(cid:11)(cid:4)(cid:3)(cid:49)(cid:4)(cid:8)(cid:5)(cid:2)(cid:28)(cid:3,Unknown,5448.0
Unknown,Unknown,37,Unknown,Unknown,Unknown,Unknown,cid:10)(cid:11)(cid:10)(cid:46)(cid:14)(cid:2)(cid:9)(cid:11)(cid:4)(cid:3)(cid:49)(cid:4)(cid:8)(cid:5)(cid:2)(cid:28)(cid:3,Unknown,5485.0
Unknown,Unknown,18,Unknown,Unknown,Unknown,Unknown,cid:10)(cid:11)(cid:10)(cid:46)(cid:14)(cid:2)(cid:9)(cid:11)(cid:4)(cid:3)(cid:49)(cid:4)(cid:8)(cid:5)(cid:2)(cid:28)(cid:3,Unknown,5503.0
Unknown,Unknown,36,Unknown,Unknown,Unknown,Unknown,cid:10)(cid:11)(cid:10)(cid:46)(cid:14)(cid:2)(cid:9)(cid:11)(cid:4)(cid:3)(cid:49)(cid:4)(cid:8)(cid:5)(cid:2)(cid:28)(cid:3,Unknown,5539.0
Unknown,Unknown,45,Unknown,Unknown,Unknown,Unknown,cid:10)(cid:11)(cid:10)(cid:46)(cid:14)(cid:2)(cid:9)(cid:11)(cid:4)(cid:3)(cid:49)(cid:4)(cid:8)(cid:5)(cid:2)(cid:28)(cid:3,Unknown,5584.0
Unknown,Unknown,18,Unknown,Unknown,Unknown,Unknown,cid:10)(cid:11)(cid:10)(cid:46)(cid:14)(cid:2)(cid:9)(cid:11)(cid:4)(cid:3)(cid:49)(cid:4)(cid:8)(cid:5)(cid:2)(cid:28)(cid:3,Unknown,5602.0
Unknown,Unknown,35,Unknown,Unknown,Unknown,Unknown,cid:10)(cid:11)(cid:10)(cid:46)(cid:14)(cid:2)(cid:9)(cid:11)(cid:4)(cid:3)(cid:49)(cid:4)(cid:8)(cid:5)(cid:2)(cid:28)(cid:3,Unknown,5637.0
Unknown,Unknown,14,Unknown,Unknown,Unknown,Unknown,cid:10)(cid:11)(cid:10)(cid:46)(cid:14)(cid:2)(cid:9)(cid:11)(cid:4)(cid:3)(cid:49)(cid:4)(cid:8)(cid:5)(cid:2)(cid:28)(cid:3,Unknown,5651.0
Unknown,Unknown,5,Unknown,Unknown,Unknown,Unknown,cid:10)(cid:11)(cid:10)(cid:46)(cid:14)(cid:2)(cid:9)(cid:11)(cid:4)(cid:3)(cid:49)(cid:4)(cid:8)(cid:5)(cid:2)(cid:28)(cid:3,Unknown,5656.0
Unknown,Unknown,12,Unknown,Unknown,Unknown,Unknown,cid:10)(cid:11)(cid:10)(cid:46)(cid:14)(cid:2)(cid:9)(cid:11)(cid:4)(cid:3)(cid:49)(cid:4)(cid:8)(cid:5)(cid:2)(cid:28)(cid:3,Unknown,5668.0
Unknown,Unknown,14,Unknown,Unknown,Unknown,Unknown,cid:10)(cid:11)(cid:10)(cid:46)(cid:14)(cid:2)(cid:9)(cid:11)(cid:4)(cid:3)(cid:49)(cid:4)(cid:8)(cid:5)(cid:2)(cid:28)(cid:3,Unknown,5682.0
Unknown,Unknown,5,Unknown,Unknown,Unknown,Unknown,cid:10)(cid:11)(cid:10)(cid:46)(cid:14)(cid:2)(cid:9)(cid:11)(cid:4)(cid:3)(cid:49)(cid:4)(cid:8)(cid:5)(cid:2)(cid:28)(cid:3,Unknown,5687.0
Unknown,Unknown,3,Unknown,Unknown,Unknown,Unknown,cid:10)(cid:11)(cid:10)(cid:46)(cid:14)(cid:2)(cid:9)(cid:11)(cid:4)(cid:3)(cid:49)(cid:4)(cid:8)(cid:5)(cid:2)(cid:28)(cid:3,Unknown,5690.0
Unknown,Unknown,12,Unknown,Unknown,Unknown,Unknown,cid:10)(cid:11)(cid:10)(cid:46)(cid:14)(cid:2)(cid:9)(cid:11)(cid:4)(cid:3)(cid:49)(cid:4)(cid:8)(cid:5)(cid:2)(cid:28)(cid:3,Unknown,5702.0
Unknown,Unknown,2,Unknown,Unknown,Unknown,Unknown,cid:10)(cid:11)(cid:10)(cid:46)(cid:14)(cid:2)(cid:9)(cid:11)(cid:4)(cid:3)(cid:49)(cid:4)(cid:8)(cid:5)(cid:2)(cid:28)(cid:3,Unknown,5704.0
Unknown,Unknown,49,Unknown,Unknown,Unknown,Unknown,cid:10)(cid:11)(cid:10)(cid:46)(cid:14)(cid:2)(cid:9)(cid:11)(cid:4)(cid:3)(cid:49)(cid:4)(cid:8)(cid:5)(cid:2)(cid:28)(cid:3,Unknown,5753.0
Unknown,Unknown,7,Unknown,Unknown,Unknown,Unknown,cid:10)(cid:11)(cid:10)(cid:46)(cid:14)(cid:2)(cid:9)(cid:11)(cid:4)(cid:3)(cid:49)(cid:4)(cid:8)(cid:5)(cid:2)(cid:28)(cid:3,Unknown,5760.0
Unknown,Unknown,9,Unknown,Unknown,Unknown,Unknown,cid:10)(cid:11)(cid:10)(cid:46)(cid:14)(cid:2)(cid:9)(cid:11)(cid:4)(cid:3)(cid:49)(cid:4)(cid:8)(cid:5)(cid:2)(cid:28)(cid:3,Unknown,5769.0
Unknown,Unknown,10,Unknown,Unknown,Unknown,Unknown,cid:10)(cid:11)(cid:10)(cid:46)(cid:14)(cid:2)(cid:9)(cid:11)(cid:4)(cid:3)(cid:49)(cid:4)(cid:8)(cid:5)(cid:2)(cid:28)(cid:3,Unknown,5779.0
Unknown,Unknown,3,Unknown,Unknown,Unknown,Unknown,cid:10)(cid:11)(cid:10)(cid:46)(cid:14)(cid:2)(cid:9)(cid:11)(cid:4)(cid:3)(cid:49)(cid:4)(cid:8)(cid:5)(cid:2)(cid:28)(cid:3,Unknown,5782.0
Unknown,Unknown,2,Unknown,Unknown,Unknown,Unknown,cid:10)(cid:11)(cid:10)(cid:46)(cid:14)(cid:2)(cid:9)(cid:11)(cid:4)(cid:3)(cid:49)(cid:4)(cid:8)(cid:5)(cid:2)(cid:28)(cid:3,Unknown,5784.0
Unknown,Unknown,12,Unknown,Unknown,Unknown,Unknown,cid:10)(cid:11)(cid:10)(cid:46)(cid:14)(cid:2)(cid:9)(cid:11)(cid:4)(cid:3)(cid:49)(cid:4)(cid:8)(cid:5)(cid:2)(cid:28)(cid:3,Unknown,5796.0
Unknown,Unknown,11,Unknown,Unknown,Unknown,Unknown,cid:10)(cid:11)(cid:10)(cid:46)(cid:14)(cid:2)(cid:9)(cid:11)(cid:4)(cid:3)(cid:49)(cid:4)(cid:8)(cid:5)(cid:2)(cid:28)(cid:3,Unknown,5807.0
Unknown,Unknown,4,Unknown,Unknown,Unknown,Unknown,cid:10)(cid:11)(cid:10)(cid:46)(cid:14)(cid:2)(cid:9)(cid:11)(cid:4)(cid:3)(cid:49)(cid:4)(cid:8)(cid:5)(cid:2)(cid:28)(cid:3,Unknown,5811.0
Unknown,Unknown,14,Unknown,Unknown,Unknown,Unknown,cid:10)(cid:11)(cid:10)(cid:46)(cid:14)(cid:2)(cid:9)(cid:11)(cid:4)(cid:3)(cid:49)(cid:4)(cid:8)(cid:5)(cid:2)(cid:28)(cid:3,Unknown,5825.0
Unknown,Unknown,11,Unknown,Unknown,Unknown,Unknown,cid:10)(cid:11)(cid:10)(cid:46)(cid:14)(cid:2)(cid:9)(cid:11)(cid:4)(cid:3)(cid:49)(cid:4)(cid:8)(cid:5)(cid:2)(cid:28)(cid:3,Unknown,5836.0
Unknown,Unknown,54,Unknown,Unknown,Unknown,Unknown,cid:10)(cid:11)(cid:10)(cid:46)(cid:14)(cid:2)(cid:9)(cid:11)(cid:4)(cid:3)(cid:49)(cid:4)(cid:8)(cid:5)(cid:2)(cid:28)(cid:3,Unknown,5890.0
Unknown,Unknown,54,Unknown,Unknown,Unknown,Unknown,cid:10)(cid:11)(cid:10)(cid:46)(cid:14)(cid:2)(cid:9)(cid:11)(cid:4)(cid:3)(cid:49)(cid:4)(cid:8)(cid:5)(cid:2)(cid:28)(cid:3,Unknown,5944.0
Unknown,Unknown,7,Unknown,Unknown,Unknown,Unknown,cid:10)(cid:11)(cid:10)(cid:46)(cid:14)(cid:2)(cid:9)(cid:11)(cid:4)(cid:3)(cid:49)(cid:4)(cid:8)(cid:5)(cid:2)(cid:28)(cid:3,Unknown,5951.0
Unknown,Unknown,5,Unknown,Unknown,Unknown,Unknown,cid:10)(cid:11)(cid:10)(cid:46)(cid:14)(cid:2)(cid:9)(cid:11)(cid:4)(cid:3)(cid:49)(cid:4)(cid:8)(cid:5)(cid:2)(cid:28)(cid:3,Unknown,5956.0
Unknown,Unknown,3,Unknown,Unknown,Unknown,Unknown,cid:10)(cid:11)(cid:10)(cid:46)(cid:14)(cid:2)(cid:9)(cid:11)(cid:4)(cid:3)(cid:49)(cid:4)(cid:8)(cid:5)(cid:2)(cid:28)(cid:3,Unknown,5959.0
Unknown,Unknown,2,Unknown,Unknown,Unknown,Unknown,cid:10)(cid:11)(cid:10)(cid:46)(cid:14)(cid:2)(cid:9)(cid:11)(cid:4)(cid:3)(cid:49)(cid:4)(cid:8)(cid:5)(cid:2)(cid:28)(cid:3,Unknown,5961.0
Unknown,Unknown,28,Unknown,Unknown,Unknown,Unknown,cid:10)(cid:11)(cid:10)(cid:46)(cid:14)(cid:2)(cid:9)(cid:11)(cid:4)(cid:3)(cid:49)(cid:4)(cid:8)(cid:5)(cid:2)(cid:28)(cid:3,Unknown,5989.0
Unknown,Unknown,3,Unknown,Unknown,Unknown,Unknown,cid:10)(cid:11)(cid:10)(cid:46)(cid:14)(cid:2)(cid:9)(cid:11)(cid:4)(cid:3)(cid:49)(cid:4)(cid:8)(cid:5)(cid:2)(cid:28)(cid:3,Unknown,5992.0
Unknown,Unknown,15,Unknown,Unknown,Unknown,Unknown,cid:10)(cid:11)(cid:10)(cid:46)(cid:14)(cid:2)(cid:9)(cid:11)(cid:4)(cid:3)(cid:49)(cid:4)(cid:8)(cid:5)(cid:2)(cid:28)(cid:3,Unknown,6007.0
Unknown,Unknown,2,Unknown,Unknown,Unknown,Unknown,cid:10)(cid:11)(cid:10)(cid:46)(cid:14)(cid:2)(cid:9)(cid:11)(cid:4)(cid:3)(cid:49)(cid:4)(cid:8)(cid:5)(cid:2)(cid:28)(cid:3,Unknown,6009.0
Unknown,Unknown,17,Unknown,Unknown,Unknown,Unknown,cid:10)(cid:11)(cid:10)(cid:46)(cid:14)(cid:2)(cid:9)(cid:11)(cid:4)(cid:3)(cid:49)(cid:4)(cid:8)(cid:5)(cid:2)(cid:28)(cid:3,Unknown,6026.0
Unknown,Unknown,18,Unknown,Unknown,Unknown,Unknown,cid:10)(cid:11)(cid:10)(cid:46)(cid:14)(cid:2)(cid:9)(cid:11)(cid:4)(cid:3)(cid:49)(cid:4)(cid:8)(cid:5)(cid:2)(cid:28)(cid:3,Unknown,6044.0
Unknown,Unknown,18,Unknown,Unknown,Unknown,Unknown,cid:10)(cid:11)(cid:10)(cid:46)(cid:14)(cid:2)(cid:9)(cid:11)(cid:4)(cid:3)(cid:49)(cid:4)(cid:8)(cid:5)(cid:2)(cid:28)(cid:3,Unknown,6062.0
Unknown,Unknown,19,Unknown,Unknown,Unknown,Unknown,cid:10)(cid:11)(cid:10)(cid:46)(cid:14)(cid:2)(cid:9)(cid:11)(cid:4)(cid:3)(cid:49)(cid:4)(cid:8)(cid:5)(cid:2)(cid:28)(cid:3,Unknown,6081.0
Unknown,Unknown,18,Unknown,Unknown,Unknown,Unknown,cid:10)(cid:11)(cid:10)(cid:46)(cid:14)(cid:2)(cid:9)(cid:11)(cid:4)(cid:3)(cid:49)(cid:4)(cid:8)(cid:5)(cid:2)(cid:28)(cid:3,Unknown,6099.0
Unknown,Unknown,18,Unknown,Unknown,Unknown,Unknown,cid:10)(cid:11)(cid:10)(cid:46)(cid:14)(cid:2)(cid:9)(cid:11)(cid:4)(cid:3)(cid:49)(cid:4)(cid:8)(cid:5)(cid:2)(cid:28)(cid:3,Unknown,6117.0
Unknown,Unknown,2,Unknown,Unknown,Unknown,Unknown,cid:10)(cid:11)(cid:10)(cid:46)(cid:14)(cid:2)(cid:9)(cid:11)(cid:4)(cid:3)(cid:49)(cid:4)(cid:8)(cid:5)(cid:2)(cid:28)(cid:3,Unknown,6119.0
Unknown,Unknown,44,Unknown,Unknown,Unknown,Unknown,cid:10)(cid:11)(cid:10)(cid:46)(cid:14)(cid:2)(cid:9)(cid:11)(cid:4)(cid:3)(cid:49)(cid:4)(cid:8)(cid:5)(cid:2)(cid:28)(cid:3,Unknown,6163.0
Unknown,Unknown,12,Unknown,Unknown,Unknown,Unknown,cid:10)(cid:11)(cid:10)(cid:46)(cid:14)(cid:2)(cid:9)(cid:11)(cid:4)(cid:3)(cid:49)(cid:4)(cid:8)(cid:5)(cid:2)(cid:28)(cid:3,Unknown,6175.0
Unknown,Unknown,29,Unknown,Unknown,Unknown,Unknown,cid:10)(cid:11)(cid:10)(cid:46)(cid:14)(cid:2)(cid:9)(cid:11)(cid:4)(cid:3)(cid:49)(cid:4)(cid:8)(cid:5)(cid:2)(cid:28)(cid:3,Unknown,6204.0
Unknown,Unknown,26,Unknown,Unknown,Unknown,Unknown,cid:10)(cid:11)(cid:10)(cid:46)(cid:14)(cid:2)(cid:9)(cid:11)(cid:4)(cid:3)(cid:49)(cid:4)(cid:8)(cid:5)(cid:2)(cid:28)(cid:3,Unknown,6230.0
Unknown,Unknown,41,Unknown,Unknown,Unknown,Unknown,cid:10)(cid:11)(cid:10)(cid:46)(cid:14)(cid:2)(cid:9)(cid:11)(cid:4)(cid:3)(cid:49)(cid:4)(cid:8)(cid:5)(cid:2)(cid:28)(cid:3,Unknown,6271.0
Unknown,Unknown,25,Unknown,Unknown,Unknown,Unknown,cid:10)(cid:11)(cid:10)(cid:46)(cid:14)(cid:2)(cid:9)(cid:11)(cid:4)(cid:3)(cid:49)(cid:4)(cid:8)(cid:5)(cid:2)(cid:28)(cid:3,Unknown,6296.0
Unknown,Unknown,2,Unknown,Unknown,Unknown,Unknown,cid:10)(cid:11)(cid:10)(cid:46)(cid:14)(cid:2)(cid:9)(cid:11)(cid:4)(cid:3)(cid:49)(cid:4)(cid:8)(cid:5)(cid:2)(cid:28)(cid:3,Unknown,6298.0
Unknown,Unknown,50,Unknown,Unknown,Unknown,Unknown,cid:10)(cid:11)(cid:10)(cid:46)(cid:14)(cid:2)(cid:9)(cid:11)(cid:4)(cid:3)(cid:49)(cid:4)(cid:8)(cid:5)(cid:2)(cid:28)(cid:3,Unknown,6348.0
Unknown,Unknown,50,Unknown,Unknown,Unknown,Unknown,cid:10)(cid:11)(cid:10)(cid:46)(cid:14)(cid:2)(cid:9)(cid:11)(cid:4)(cid:3)(cid:49)(cid:4)(cid:8)(cid:5)(cid:2)(cid:28)(cid:3,Unknown,6398.0
Unknown,Unknown,37,Unknown,Unknown,Unknown,Unknown,cid:10)(cid:11)(cid:10)(cid:46)(cid:14)(cid:2)(cid:9)(cid:11)(cid:4)(cid:3)(cid:49)(cid:4)(cid:8)(cid:5)(cid:2)(cid:28)(cid:3,Unknown,6435.0
Unknown,Unknown,16,Unknown,Unknown,Unknown,Unknown,cid:10)(cid:11)(cid:10)(cid:46)(cid:14)(cid:2)(cid:9)(cid:11)(cid:4)(cid:3)(cid:49)(cid:4)(cid:8)(cid:5)(cid:2)(cid:28)(cid:3,Unknown,6451.0
Unknown,Unknown,34,Unknown,Unknown,Unknown,Unknown,cid:10)(cid:11)(cid:10)(cid:46)(cid:14)(cid:2)(cid:9)(cid:11)(cid:4)(cid:3)(cid:49)(cid:4)(cid:8)(cid:5)(cid:2)(cid:28)(cid:3,Unknown,6485.0
Unknown,Unknown,33,Unknown,Unknown,Unknown,Unknown,cid:10)(cid:11)(cid:10)(cid:46)(cid:14)(cid:2)(cid:9)(cid:11)(cid:4)(cid:3)(cid:49)(cid:4)(cid:8)(cid:5)(cid:2)(cid:28)(cid:3,Unknown,6518.0
Unknown,Unknown,18,Unknown,Unknown,Unknown,Unknown,cid:10)(cid:11)(cid:10)(cid:46)(cid:14)(cid:2)(cid:9)(cid:11)(cid:4)(cid:3)(cid:49)(cid:4)(cid:8)(cid:5)(cid:2)(cid:28)(cid:3,Unknown,6536.0
Unknown,Unknown,36,Unknown,Unknown,Unknown,Unknown,cid:10)(cid:11)(cid:10)(cid:46)(cid:14)(cid:2)(cid:9)(cid:11)(cid:4)(cid:3)(cid:49)(cid:4)(cid:8)(cid:5)(cid:2)(cid:28)(cid:3,Unknown,6572.0
Unknown,Unknown,45,Unknown,Unknown,Unknown,Unknown,cid:10)(cid:11)(cid:10)(cid:46)(cid:14)(cid:2)(cid:9)(cid:11)(cid:4)(cid:3)(cid:49)(cid:4)(cid:8)(cid:5)(cid:2)(cid:28)(cid:3,Unknown,6617.0
Unknown,Unknown,18,Unknown,Unknown,Unknown,Unknown,cid:10)(cid:11)(cid:10)(cid:46)(cid:14)(cid:2)(cid:9)(cid:11)(cid:4)(cid:3)(cid:49)(cid:4)(cid:8)(cid:5)(cid:2)(cid:28)(cid:3,Unknown,6635.0
Unknown,Unknown,35,Unknown,Unknown,Unknown,Unknown,cid:10)(cid:11)(cid:10)(cid:46)(cid:14)(cid:2)(cid:9)(cid:11)(cid:4)(cid:3)(cid:49)(cid:4)(cid:8)(cid:5)(cid:2)(cid:28)(cid:3,Unknown,6670.0
Unknown,Unknown,49,Unknown,Unknown,Unknown,Unknown,cid:10)(cid:11)(cid:10)(cid:46)(cid:14)(cid:2)(cid:9)(cid:11)(cid:4)(cid:3)(cid:49)(cid:4)(cid:8)(cid:5)(cid:2)(cid:28)(cid:3,Unknown,6719.0
Unknown,Unknown,5,Unknown,Unknown,Unknown,Unknown,cid:10)(cid:11)(cid:10)(cid:46)(cid:14)(cid:2)(cid:9)(cid:11)(cid:4)(cid:3)(cid:49)(cid:4)(cid:8)(cid:5)(cid:2)(cid:28)(cid:3,Unknown,6724.0
Unknown,Unknown,14,Unknown,Unknown,Unknown,Unknown,cid:10)(cid:11)(cid:10)(cid:46)(cid:14)(cid:2)(cid:9)(cid:11)(cid:4)(cid:3)(cid:49)(cid:4)(cid:8)(cid:5)(cid:2)(cid:28)(cid:3,Unknown,6738.0
Unknown,Unknown,7,Unknown,Unknown,Unknown,Unknown,cid:10)(cid:11)(cid:10)(cid:46)(cid:14)(cid:2)(cid:9)(cid:11)(cid:4)(cid:3)(cid:49)(cid:4)(cid:8)(cid:5)(cid:2)(cid:28)(cid:3,Unknown,6745.0
Unknown,Unknown,12,Unknown,Unknown,Unknown,Unknown,cid:10)(cid:11)(cid:10)(cid:46)(cid:14)(cid:2)(cid:9)(cid:11)(cid:4)(cid:3)(cid:49)(cid:4)(cid:8)(cid:5)(cid:2)(cid:28)(cid:3,Unknown,6757.0
Unknown,Unknown,5,Unknown,Unknown,Unknown,Unknown,cid:10)(cid:11)(cid:10)(cid:46)(cid:14)(cid:2)(cid:9)(cid:11)(cid:4)(cid:3)(cid:49)(cid:4)(cid:8)(cid:5)(cid:2)(cid:28)(cid:3,Unknown,6762.0
Unknown,Unknown,9,Unknown,Unknown,Unknown,Unknown,cid:10)(cid:11)(cid:10)(cid:46)(cid:14)(cid:2)(cid:9)(cid:11)(cid:4)(cid:3)(cid:49)(cid:4)(cid:8)(cid:5)(cid:2)(cid:28)(cid:3,Unknown,6771.0
Unknown,Unknown,2,Unknown,Unknown,Unknown,Unknown,cid:10)(cid:11)(cid:10)(cid:46)(cid:14)(cid:2)(cid:9)(cid:11)(cid:4)(cid:3)(cid:49)(cid:4)(cid:8)(cid:5)(cid:2)(cid:28)(cid:3,Unknown,6773.0
Unknown,Unknown,16,Unknown,Unknown,Unknown,Unknown,cid:10)(cid:11)(cid:10)(cid:46)(cid:14)(cid:2)(cid:9)(cid:11)(cid:4)(cid:3)(cid:49)(cid:4)(cid:8)(cid:5)(cid:2)(cid:28)(cid:3,Unknown,6789.0
Unknown,Unknown,16,Unknown,Unknown,Unknown,Unknown,cid:10)(cid:11)(cid:10)(cid:46)(cid:14)(cid:2)(cid:9)(cid:11)(cid:4)(cid:3)(cid:49)(cid:4)(cid:8)(cid:5)(cid:2)(cid:28)(cid:3,Unknown,6805.0
Unknown,Unknown,2,Unknown,Unknown,Unknown,Unknown,cid:10)(cid:11)(cid:10)(cid:46)(cid:14)(cid:2)(cid:9)(cid:11)(cid:4)(cid:3)(cid:49)(cid:4)(cid:8)(cid:5)(cid:2)(cid:28)(cid:3,Unknown,6807.0
Unknown,Unknown,12,Unknown,Unknown,Unknown,Unknown,cid:10)(cid:11)(cid:10)(cid:46)(cid:14)(cid:2)(cid:9)(cid:11)(cid:4)(cid:3)(cid:49)(cid:4)(cid:8)(cid:5)(cid:2)(cid:28)(cid:3,Unknown,6819.0
Unknown,Unknown,11,Unknown,Unknown,Unknown,Unknown,cid:10)(cid:11)(cid:10)(cid:46)(cid:14)(cid:2)(cid:9)(cid:11)(cid:4)(cid:3)(cid:49)(cid:4)(cid:8)(cid:5)(cid:2)(cid:28)(cid:3,Unknown,6830.0
Unknown,Unknown,4,Unknown,Unknown,Unknown,Unknown,cid:10)(cid:11)(cid:10)(cid:46)(cid:14)(cid:2)(cid:9)(cid:11)(cid:4)(cid:3)(cid:49)(cid:4)(cid:8)(cid:5)(cid:2)(cid:28)(cid:3,Unknown,6834.0
Unknown,Unknown,14,Unknown,Unknown,Unknown,Unknown,cid:10)(cid:11)(cid:10)(cid:46)(cid:14)(cid:2)(cid:9)(cid:11)(cid:4)(cid:3)(cid:49)(cid:4)(cid:8)(cid:5)(cid:2)(cid:28)(cid:3,Unknown,6848.0
Unknown,Unknown,11,Unknown,Unknown,Unknown,Unknown,cid:10)(cid:11)(cid:10)(cid:46)(cid:14)(cid:2)(cid:9)(cid:11)(cid:4)(cid:3)(cid:49)(cid:4)(cid:8)(cid:5)(cid:2)(cid:28)(cid:3,Unknown,6859.0
Unknown,Unknown,54,Unknown,Unknown,Unknown,Unknown,cid:10)(cid:11)(cid:10)(cid:46)(cid:14)(cid:2)(cid:9)(cid:11)(cid:4)(cid:3)(cid:49)(cid:4)(cid:8)(cid:5)(cid:2)(cid:28)(cid:3,Unknown,6913.0
Unknown,Unknown,54,Unknown,Unknown,Unknown,Unknown,cid:10)(cid:11)(cid:10)(cid:46)(cid:14)(cid:2)(cid:9)(cid:11)(cid:4)(cid:3)(cid:49)(cid:4)(cid:8)(cid:5)(cid:2)(cid:28)(cid:3,Unknown,6967.0
Unknown,Unknown,7,Unknown,Unknown,Unknown,Unknown,cid:10)(cid:11)(cid:10)(cid:46)(cid:14)(cid:2)(cid:9)(cid:11)(cid:4)(cid:3)(cid:49)(cid:4)(cid:8)(cid:5)(cid:2)(cid:28)(cid:3,Unknown,6974.0
Unknown,Unknown,5,Unknown,Unknown,Unknown,Unknown,cid:10)(cid:11)(cid:10)(cid:46)(cid:14)(cid:2)(cid:9)(cid:11)(cid:4)(cid:3)(cid:49)(cid:4)(cid:8)(cid:5)(cid:2)(cid:28)(cid:3,Unknown,6979.0
Unknown,Unknown,3,Unknown,Unknown,Unknown,Unknown,cid:10)(cid:11)(cid:10)(cid:46)(cid:14)(cid:2)(cid:9)(cid:11)(cid:4)(cid:3)(cid:49)(cid:4)(cid:8)(cid:5)(cid:2)(cid:28)(cid:3,Unknown,6982.0
Unknown,Unknown,9,Unknown,Unknown,Unknown,Unknown,cid:10)(cid:11)(cid:10)(cid:46)(cid:14)(cid:2)(cid:9)(cid:11)(cid:4)(cid:3)(cid:49)(cid:4)(cid:8)(cid:5)(cid:2)(cid:28)(cid:3,Unknown,6991.0
Unknown,Unknown,2,Unknown,Unknown,Unknown,Unknown,cid:10)(cid:11)(cid:10)(cid:46)(cid:14)(cid:2)(cid:9)(cid:11)(cid:4)(cid:3)(cid:49)(cid:4)(cid:8)(cid:5)(cid:2)(cid:28)(cid:3,Unknown,6993.0
Unknown,Unknown,28,Unknown,Unknown,Unknown,Unknown,cid:10)(cid:11)(cid:10)(cid:46)(cid:14)(cid:2)(cid:9)(cid:11)(cid:4)(cid:3)(cid:49)(cid:4)(cid:8)(cid:5)(cid:2)(cid:28)(cid:3,Unknown,7021.0
Unknown,Unknown,3,Unknown,Unknown,Unknown,Unknown,cid:10)(cid:11)(cid:10)(cid:46)(cid:14)(cid:2)(cid:9)(cid:11)(cid:4)(cid:3)(cid:49)(cid:4)(cid:8)(cid:5)(cid:2)(cid:28)(cid:3,Unknown,7024.0
Unknown,Unknown,15,Unknown,Unknown,Unknown,Unknown,cid:10)(cid:11)(cid:10)(cid:46)(cid:14)(cid:2)(cid:9)(cid:11)(cid:4)(cid:3)(cid:49)(cid:4)(cid:8)(cid:5)(cid:2)(cid:28)(cid:3,Unknown,7039.0
Unknown,Unknown,2,Unknown,Unknown,Unknown,Unknown,cid:10)(cid:11)(cid:10)(cid:46)(cid:14)(cid:2)(cid:9)(cid:11)(cid:4)(cid:3)(cid:49)(cid:4)(cid:8)(cid:5)(cid:2)(cid:28)(cid:3,Unknown,7041.0
Unknown,Unknown,1,Unknown,Unknown,Unknown,Unknown,cid:10)(cid:11)(cid:10)(cid:46)(cid:14)(cid:2)(cid:9)(cid:11)(cid:4)(cid:3)(cid:49)(cid:4)(cid:8)(cid:5)(cid:2)(cid:28)(cid:3,Unknown,7042.0
Unknown,Unknown,35,Unknown,Unknown,Unknown,Unknown,cid:10)(cid:11)(cid:10)(cid:46)(cid:14)(cid:2)(cid:9)(cid:11)(cid:4)(cid:3)(cid:49)(cid:4)(cid:8)(cid:5)(cid:2)(cid:28)(cid:3,Unknown,7077.0
Unknown,Unknown,19,Unknown,Unknown,Unknown,Unknown,cid:10)(cid:11)(cid:10)(cid:46)(cid:14)(cid:2)(cid:9)(cid:11)(cid:4)(cid:3)(cid:49)(cid:4)(cid:8)(cid:5)(cid:2)(cid:28)(cid:3,Unknown,7096.0
Unknown,Unknown,18,Unknown,Unknown,Unknown,Unknown,cid:10)(cid:11)(cid:10)(cid:46)(cid:14)(cid:2)(cid:9)(cid:11)(cid:4)(cid:3)(cid:49)(cid:4)(cid:8)(cid:5)(cid:2)(cid:28)(cid:3,Unknown,7114.0
Unknown,Unknown,18,Unknown,Unknown,Unknown,Unknown,cid:10)(cid:11)(cid:10)(cid:46)(cid:14)(cid:2)(cid:9)(cid:11)(cid:4)(cid:3)(cid:49)(cid:4)(cid:8)(cid:5)(cid:2)(cid:28)(cid:3,Unknown,7132.0
Unknown,Unknown,2,Unknown,Unknown,Unknown,Unknown,cid:10)(cid:11)(cid:10)(cid:46)(cid:14)(cid:2)(cid:9)(cid:11)(cid:4)(cid:3)(cid:49)(cid:4)(cid:8)(cid:5)(cid:2)(cid:28)(cid:3,Unknown,7134.0
Unknown,Unknown,44,Unknown,Unknown,Unknown,Unknown,cid:10)(cid:11)(cid:10)(cid:46)(cid:14)(cid:2)(cid:9)(cid:11)(cid:4)(cid:3)(cid:49)(cid:4)(cid:8)(cid:5)(cid:2)(cid:28)(cid:3,Unknown,7178.0
Unknown,Unknown,12,Unknown,Unknown,Unknown,Unknown,cid:10)(cid:11)(cid:10)(cid:46)(cid:14)(cid:2)(cid:9)(cid:11)(cid:4)(cid:3)(cid:49)(cid:4)(cid:8)(cid:5)(cid:2)(cid:28)(cid:3,Unknown,7190.0
Unknown,Unknown,29,Unknown,Unknown,Unknown,Unknown,cid:10)(cid:11)(cid:10)(cid:46)(cid:14)(cid:2)(cid:9)(cid:11)(cid:4)(cid:3)(cid:49)(cid:4)(cid:8)(cid:5)(cid:2)(cid:28)(cid:3,Unknown,7219.0
Unknown,Unknown,26,Unknown,Unknown,Unknown,Unknown,cid:10)(cid:11)(cid:10)(cid:46)(cid:14)(cid:2)(cid:9)(cid:11)(cid:4)(cid:3)(cid:49)(cid:4)(cid:8)(cid:5)(cid:2)(cid:28)(cid:3,Unknown,7245.0
Unknown,Unknown,41,Unknown,Unknown,Unknown,Unknown,cid:10)(cid:11)(cid:10)(cid:46)(cid:14)(cid:2)(cid:9)(cid:11)(cid:4)(cid:3)(cid:49)(cid:4)(cid:8)(cid:5)(cid:2)(cid:28)(cid:3,Unknown,7286.0
Unknown,Unknown,25,Unknown,Unknown,Unknown,Unknown,cid:10)(cid:11)(cid:10)(cid:46)(cid:14)(cid:2)(cid:9)(cid:11)(cid:4)(cid:3)(cid:49)(cid:4)(cid:8)(cid:5)(cid:2)(cid:28)(cid:3,Unknown,7311.0
Unknown,Unknown,2,Unknown,Unknown,Unknown,Unknown,cid:10)(cid:11)(cid:10)(cid:46)(cid:14)(cid:2)(cid:9)(cid:11)(cid:4)(cid:3)(cid:49)(cid:4)(cid:8)(cid:5)(cid:2)(cid:28)(cid:3,Unknown,7313.0
Unknown,Unknown,50,Unknown,Unknown,Unknown,Unknown,cid:10)(cid:11)(cid:10)(cid:46)(cid:14)(cid:2)(cid:9)(cid:11)(cid:4)(cid:3)(cid:49)(cid:4)(cid:8)(cid:5)(cid:2)(cid:28)(cid:3,Unknown,7363.0
Unknown,Unknown,50,Unknown,Unknown,Unknown,Unknown,cid:10)(cid:11)(cid:10)(cid:46)(cid:14)(cid:2)(cid:9)(cid:11)(cid:4)(cid:3)(cid:49)(cid:4)(cid:8)(cid:5)(cid:2)(cid:28)(cid:3,Unknown,7413.0
Unknown,Unknown,37,Unknown,Unknown,Unknown,Unknown,cid:10)(cid:11)(cid:10)(cid:46)(cid:14)(cid:2)(cid:9)(cid:11)(cid:4)(cid:3)(cid:49)(cid:4)(cid:8)(cid:5)(cid:2)(cid:28)(cid:3,Unknown,7450.0
Unknown,Unknown,16,Unknown,Unknown,Unknown,Unknown,cid:10)(cid:11)(cid:10)(cid:46)(cid:14)(cid:2)(cid:9)(cid:11)(cid:4)(cid:3)(cid:49)(cid:4)(cid:8)(cid:5)(cid:2)(cid:28)(cid:3,Unknown,7466.0
Unknown,Unknown,34,Unknown,Unknown,Unknown,Unknown,cid:10)(cid:11)(cid:10)(cid:46)(cid:14)(cid:2)(cid:9)(cid:11)(cid:4)(cid:3)(cid:49)(cid:4)(cid:8)(cid:5)(cid:2)(cid:28)(cid:3,Unknown,7500.0
Unknown,Unknown,33,Unknown,Unknown,Unknown,Unknown,cid:10)(cid:11)(cid:10)(cid:46)(cid:14)(cid:2)(cid:9)(cid:11)(cid:4)(cid:3)(cid:49)(cid:4)(cid:8)(cid:5)(cid:2)(cid:28)(cid:3,Unknown,7533.0
Unknown,Unknown,18,Unknown,Unknown,Unknown,Unknown,cid:10)(cid:11)(cid:10)(cid:46)(cid:14)(cid:2)(cid:9)(cid:11)(cid:4)(cid:3)(cid:49)(cid:4)(cid:8)(cid:5)(cid:2)(cid:28)(cid:3,Unknown,7551.0
Unknown,Unknown,34,Unknown,Unknown,Unknown,Unknown,cid:10)(cid:11)(cid:10)(cid:46)(cid:14)(cid:2)(cid:9)(cid:11)(cid:4)(cid:3)(cid:49)(cid:4)(cid:8)(cid:5)(cid:2)(cid:28)(cid:3,Unknown,7585.0
Unknown,Unknown,45,Unknown,Unknown,Unknown,Unknown,cid:10)(cid:11)(cid:10)(cid:46)(cid:14)(cid:2)(cid:9)(cid:11)(cid:4)(cid:3)(cid:49)(cid:4)(cid:8)(cid:5)(cid:2)(cid:28)(cid:3,Unknown,7630.0
Unknown,Unknown,18,Unknown,Unknown,Unknown,Unknown,cid:10)(cid:11)(cid:10)(cid:46)(cid:14)(cid:2)(cid:9)(cid:11)(cid:4)(cid:3)(cid:49)(cid:4)(cid:8)(cid:5)(cid:2)(cid:28)(cid:3,Unknown,7648.0
Unknown,Unknown,35,Unknown,Unknown,Unknown,Unknown,cid:10)(cid:11)(cid:10)(cid:46)(cid:14)(cid:2)(cid:9)(cid:11)(cid:4)(cid:3)(cid:49)(cid:4)(cid:8)(cid:5)(cid:2)(cid:28)(cid:3,Unknown,7683.0
Unknown,Unknown,14,Unknown,Unknown,Unknown,Unknown,cid:10)(cid:11)(cid:10)(cid:46)(cid:14)(cid:2)(cid:9)(cid:11)(cid:4)(cid:3)(cid:49)(cid:4)(cid:8)(cid:5)(cid:2)(cid:28)(cid:3,Unknown,7697.0
Unknown,Unknown,46,Unknown,Unknown,Unknown,Unknown,cid:10)(cid:11)(cid:10)(cid:46)(cid:14)(cid:2)(cid:9)(cid:11)(cid:4)(cid:3)(cid:49)(cid:4)(cid:8)(cid:5)(cid:2)(cid:28)(cid:3,Unknown,7743.0
Unknown,Unknown,2,Unknown,Unknown,Unknown,Unknown,cid:10)(cid:11)(cid:10)(cid:46)(cid:14)(cid:2)(cid:9)(cid:11)(cid:4)(cid:3)(cid:49)(cid:4)(cid:8)(cid:5)(cid:2)(cid:28)(cid:3,Unknown,7745.0
Unknown,Unknown,39,Unknown,Unknown,Unknown,Unknown,cid:10)(cid:11)(cid:10)(cid:46)(cid:14)(cid:2)(cid:9)(cid:11)(cid:4)(cid:3)(cid:49)(cid:4)(cid:8)(cid:5)(cid:2)(cid:28)(cid:3,Unknown,7784.0
Unknown,Unknown,11,Unknown,Unknown,Unknown,Unknown,cid:10)(cid:11)(cid:10)(cid:46)(cid:14)(cid:2)(cid:9)(cid:11)(cid:4)(cid:3)(cid:49)(cid:4)(cid:8)(cid:5)(cid:2)(cid:28)(cid:3,Unknown,7795.0
Unknown,Unknown,9,Unknown,Unknown,Unknown,Unknown,cid:10)(cid:11)(cid:10)(cid:46)(cid:14)(cid:2)(cid:9)(cid:11)(cid:4)(cid:3)(cid:49)(cid:4)(cid:8)(cid:5)(cid:2)(cid:28)(cid:3,Unknown,7804.0
Unknown,Unknown,10,Unknown,Unknown,Unknown,Unknown,cid:10)(cid:11)(cid:10)(cid:46)(cid:14)(cid:2)(cid:9)(cid:11)(cid:4)(cid:3)(cid:49)(cid:4)(cid:8)(cid:5)(cid:2)(cid:28)(cid:3,Unknown,7814.0
Unknown,Unknown,5,Unknown,Unknown,Unknown,Unknown,cid:10)(cid:11)(cid:10)(cid:46)(cid:14)(cid:2)(cid:9)(cid:11)(cid:4)(cid:3)(cid:49)(cid:4)(cid:8)(cid:5)(cid:2)(cid:28)(cid:3,Unknown,7819.0
Unknown,Unknown,2,Unknown,Unknown,Unknown,Unknown,cid:10)(cid:11)(cid:10)(cid:46)(cid:14)(cid:2)(cid:9)(cid:11)(cid:4)(cid:3)(cid:49)(cid:4)(cid:8)(cid:5)(cid:2)(cid:28)(cid:3,Unknown,7821.0
Unknown,Unknown,16,Unknown,Unknown,Unknown,Unknown,cid:10)(cid:11)(cid:10)(cid:46)(cid:14)(cid:2)(cid:9)(cid:11)(cid:4)(cid:3)(cid:49)(cid:4)(cid:8)(cid:5)(cid:2)(cid:28)(cid:3,Unknown,7837.0
Unknown,Unknown,16,Unknown,Unknown,Unknown,Unknown,cid:10)(cid:11)(cid:10)(cid:46)(cid:14)(cid:2)(cid:9)(cid:11)(cid:4)(cid:3)(cid:49)(cid:4)(cid:8)(cid:5)(cid:2)(cid:28)(cid:3,Unknown,7853.0
Unknown,Unknown,33,Unknown,Unknown,Unknown,Unknown,cid:10)(cid:11)(cid:10)(cid:46)(cid:14)(cid:2)(cid:9)(cid:11)(cid:4)(cid:3)(cid:49)(cid:4)(cid:8)(cid:5)(cid:2)(cid:28)(cid:3,Unknown,7886.0
Unknown,Unknown,1,Unknown,Unknown,Unknown,Unknown,cid:10)(cid:11)(cid:10)(cid:46)(cid:14)(cid:2)(cid:9)(cid:11)(cid:4)(cid:3)(cid:49)(cid:4)(cid:8)(cid:5)(cid:2)(cid:28)(cid:3,Unknown,7887.0
Unknown,Unknown,36,Unknown,Unknown,Unknown,Unknown,cid:10)(cid:11)(cid:10)(cid:46)(cid:14)(cid:2)(cid:9)(cid:11)(cid:4)(cid:3)(cid:49)(cid:4)(cid:8)(cid:5)(cid:2)(cid:28)(cid:3,Unknown,7923.0
Unknown,Unknown,18,Unknown,Unknown,Unknown,Unknown,cid:10)(cid:11)(cid:10)(cid:46)(cid:14)(cid:2)(cid:9)(cid:11)(cid:4)(cid:3)(cid:49)(cid:4)(cid:8)(cid:5)(cid:2)(cid:28)(cid:3,Unknown,7941.0
Unknown,Unknown,2,Unknown,Unknown,Unknown,Unknown,cid:10)(cid:11)(cid:10)(cid:46)(cid:14)(cid:2)(cid:9)(cid:11)(cid:4)(cid:3)(cid:49)(cid:4)(cid:8)(cid:5)(cid:2)(cid:28)(cid:3,Unknown,7943.0
Unknown,Unknown,12,Unknown,Unknown,Unknown,Unknown,cid:10)(cid:11)(cid:10)(cid:46)(cid:14)(cid:2)(cid:9)(cid:11)(cid:4)(cid:3)(cid:49)(cid:4)(cid:8)(cid:5)(cid:2)(cid:28)(cid:3,Unknown,7955.0
Unknown,Unknown,11,Unknown,Unknown,Unknown,Unknown,cid:10)(cid:11)(cid:10)(cid:46)(cid:14)(cid:2)(cid:9)(cid:11)(cid:4)(cid:3)(cid:49)(cid:4)(cid:8)(cid:5)(cid:2)(cid:28)(cid:3,Unknown,7966.0
Unknown,Unknown,4,Unknown,Unknown,Unknown,Unknown,cid:10)(cid:11)(cid:10)(cid:46)(cid:14)(cid:2)(cid:9)(cid:11)(cid:4)(cid:3)(cid:49)(cid:4)(cid:8)(cid:5)(cid:2)(cid:28)(cid:3,Unknown,7970.0
Unknown,Unknown,14,Unknown,Unknown,Unknown,Unknown,cid:10)(cid:11)(cid:10)(cid:46)(cid:14)(cid:2)(cid:9)(cid:11)(cid:4)(cid:3)(cid:49)(cid:4)(cid:8)(cid:5)(cid:2)(cid:28)(cid:3,Unknown,7984.0
Unknown,Unknown,11,Unknown,Unknown,Unknown,Unknown,cid:10)(cid:11)(cid:10)(cid:46)(cid:14)(cid:2)(cid:9)(cid:11)(cid:4)(cid:3)(cid:49)(cid:4)(cid:8)(cid:5)(cid:2)(cid:28)(cid:3,Unknown,7995.0
Unknown,Unknown,54,Unknown,Unknown,Unknown,Unknown,cid:10)(cid:11)(cid:10)(cid:46)(cid:14)(cid:2)(cid:9)(cid:11)(cid:4)(cid:3)(cid:49)(cid:4)(cid:8)(cid:5)(cid:2)(cid:28)(cid:3,Unknown,8049.0
Unknown,Unknown,54,Unknown,Unknown,Unknown,Unknown,cid:10)(cid:11)(cid:10)(cid:46)(cid:14)(cid:2)(cid:9)(cid:11)(cid:4)(cid:3)(cid:49)(cid:4)(cid:8)(cid:5)(cid:2)(cid:28)(cid:3,Unknown,8103.0
Unknown,Unknown,7,Unknown,Unknown,Unknown,Unknown,cid:10)(cid:11)(cid:10)(cid:46)(cid:14)(cid:2)(cid:9)(cid:11)(cid:4)(cid:3)(cid:49)(cid:4)(cid:8)(cid:5)(cid:2)(cid:28)(cid:3,Unknown,8110.0
Unknown,Unknown,5,Unknown,Unknown,Unknown,Unknown,cid:10)(cid:11)(cid:10)(cid:46)(cid:14)(cid:2)(cid:9)(cid:11)(cid:4)(cid:3)(cid:49)(cid:4)(cid:8)(cid:5)(cid:2)(cid:28)(cid:3,Unknown,8115.0
Unknown,Unknown,3,Unknown,Unknown,Unknown,Unknown,cid:10)(cid:11)(cid:10)(cid:46)(cid:14)(cid:2)(cid:9)(cid:11)(cid:4)(cid:3)(cid:49)(cid:4)(cid:8)(cid:5)(cid:2)(cid:28)(cid:3,Unknown,8118.0
Unknown,Unknown,9,Unknown,Unknown,Unknown,Unknown,cid:10)(cid:11)(cid:10)(cid:46)(cid:14)(cid:2)(cid:9)(cid:11)(cid:4)(cid:3)(cid:49)(cid:4)(cid:8)(cid:5)(cid:2)(cid:28)(cid:3,Unknown,8127.0
Unknown,Unknown,2,Unknown,Unknown,Unknown,Unknown,cid:10)(cid:11)(cid:10)(cid:46)(cid:14)(cid:2)(cid:9)(cid:11)(cid:4)(cid:3)(cid:49)(cid:4)(cid:8)(cid:5)(cid:2)(cid:28)(cid:3,Unknown,8129.0
Unknown,Unknown,28,Unknown,Unknown,Unknown,Unknown,cid:10)(cid:11)(cid:10)(cid:46)(cid:14)(cid:2)(cid:9)(cid:11)(cid:4)(cid:3)(cid:49)(cid:4)(cid:8)(cid:5)(cid:2)(cid:28)(cid:3,Unknown,8157.0
Unknown,Unknown,3,Unknown,Unknown,Unknown,Unknown,cid:10)(cid:11)(cid:10)(cid:46)(cid:14)(cid:2)(cid:9)(cid:11)(cid:4)(cid:3)(cid:49)(cid:4)(cid:8)(cid:5)(cid:2)(cid:28)(cid:3,Unknown,8160.0
Unknown,Unknown,15,Unknown,Unknown,Unknown,Unknown,cid:10)(cid:11)(cid:10)(cid:46)(cid:14)(cid:2)(cid:9)(cid:11)(cid:4)(cid:3)(cid:49)(cid:4)(cid:8)(cid:5)(cid:2)(cid:28)(cid:3,Unknown,8175.0
Unknown,Unknown,2,Unknown,Unknown,Unknown,Unknown,cid:10)(cid:11)(cid:10)(cid:46)(cid:14)(cid:2)(cid:9)(cid:11)(cid:4)(cid:3)(cid:49)(cid:4)(cid:8)(cid:5)(cid:2)(cid:28)(cid:3,Unknown,8177.0
Unknown,Unknown,17,Unknown,Unknown,Unknown,Unknown,cid:10)(cid:11)(cid:10)(cid:46)(cid:14)(cid:2)(cid:9)(cid:11)(cid:4)(cid:3)(cid:49)(cid:4)(cid:8)(cid:5)(cid:2)(cid:28)(cid:3,Unknown,8194.0
Unknown,Unknown,19,Unknown,Unknown,Unknown,Unknown,cid:10)(cid:11)(cid:10)(cid:46)(cid:14)(cid:2)(cid:9)(cid:11)(cid:4)(cid:3)(cid:49)(cid:4)(cid:8)(cid:5)(cid:2)(cid:28)(cid:3,Unknown,8213.0
Unknown,Unknown,16,Unknown,Unknown,Unknown,Unknown,cid:10)(cid:11)(cid:10)(cid:46)(cid:14)(cid:2)(cid:9)(cid:11)(cid:4)(cid:3)(cid:49)(cid:4)(cid:8)(cid:5)(cid:2)(cid:28)(cid:3,Unknown,8229.0
Unknown,Unknown,32,Unknown,Unknown,Unknown,Unknown,cid:10)(cid:11)(cid:10)(cid:46)(cid:14)(cid:2)(cid:9)(cid:11)(cid:4)(cid:3)(cid:49)(cid:4)(cid:8)(cid:5)(cid:2)(cid:28)(cid:3,Unknown,8261.0
Unknown,Unknown,2,Unknown,Unknown,Unknown,Unknown,cid:10)(cid:11)(cid:10)(cid:46)(cid:14)(cid:2)(cid:9)(cid:11)(cid:4)(cid:3)(cid:49)(cid:4)(cid:8)(cid:5)(cid:2)(cid:28)(cid:3,Unknown,8263.0
Unknown,Unknown,44,Unknown,Unknown,Unknown,Unknown,cid:10)(cid:11)(cid:10)(cid:46)(cid:14)(cid:2)(cid:9)(cid:11)(cid:4)(cid:3)(cid:49)(cid:4)(cid:8)(cid:5)(cid:2)(cid:28)(cid:3,Unknown,8307.0
Unknown,Unknown,12,Unknown,Unknown,Unknown,Unknown,cid:10)(cid:11)(cid:10)(cid:46)(cid:14)(cid:2)(cid:9)(cid:11)(cid:4)(cid:3)(cid:49)(cid:4)(cid:8)(cid:5)(cid:2)(cid:28)(cid:3,Unknown,8319.0
Unknown,Unknown,29,Unknown,Unknown,Unknown,Unknown,cid:10)(cid:11)(cid:10)(cid:46)(cid:14)(cid:2)(cid:9)(cid:11)(cid:4)(cid:3)(cid:49)(cid:4)(cid:8)(cid:5)(cid:2)(cid:28)(cid:3,Unknown,8348.0
Unknown,Unknown,26,Unknown,Unknown,Unknown,Unknown,cid:10)(cid:11)(cid:10)(cid:46)(cid:14)(cid:2)(cid:9)(cid:11)(cid:4)(cid:3)(cid:49)(cid:4)(cid:8)(cid:5)(cid:2)(cid:28)(cid:3,Unknown,8374.0
Unknown,Unknown,41,Unknown,Unknown,Unknown,Unknown,cid:10)(cid:11)(cid:10)(cid:46)(cid:14)(cid:2)(cid:9)(cid:11)(cid:4)(cid:3)(cid:49)(cid:4)(cid:8)(cid:5)(cid:2)(cid:28)(cid:3,Unknown,8415.0
Unknown,Unknown,25,Unknown,Unknown,Unknown,Unknown,cid:10)(cid:11)(cid:10)(cid:46)(cid:14)(cid:2)(cid:9)(cid:11)(cid:4)(cid:3)(cid:49)(cid:4)(cid:8)(cid:5)(cid:2)(cid:28)(cid:3,Unknown,8440.0
Unknown,Unknown,2,Unknown,Unknown,Unknown,Unknown,cid:10)(cid:11)(cid:10)(cid:46)(cid:14)(cid:2)(cid:9)(cid:11)(cid:4)(cid:3)(cid:49)(cid:4)(cid:8)(cid:5)(cid:2)(cid:28)(cid:3,Unknown,8442.0
Unknown,Unknown,50,Unknown,Unknown,Unknown,Unknown,cid:10)(cid:11)(cid:10)(cid:46)(cid:14)(cid:2)(cid:9)(cid:11)(cid:4)(cid:3)(cid:49)(cid:4)(cid:8)(cid:5)(cid:2)(cid:28)(cid:3,Unknown,8492.0
Unknown,Unknown,50,Unknown,Unknown,Unknown,Unknown,cid:10)(cid:11)(cid:10)(cid:46)(cid:14)(cid:2)(cid:9)(cid:11)(cid:4)(cid:3)(cid:49)(cid:4)(cid:8)(cid:5)(cid:2)(cid:28)(cid:3,Unknown,8542.0
Unknown,Unknown,37,Unknown,Unknown,Unknown,Unknown,cid:10)(cid:11)(cid:10)(cid:46)(cid:14)(cid:2)(cid:9)(cid:11)(cid:4)(cid:3)(cid:49)(cid:4)(cid:8)(cid:5)(cid:2)(cid:28)(cid:3,Unknown,8579.0
Unknown,Unknown,16,Unknown,Unknown,Unknown,Unknown,cid:10)(cid:11)(cid:10)(cid:46)(cid:14)(cid:2)(cid:9)(cid:11)(cid:4)(cid:3)(cid:49)(cid:4)(cid:8)(cid:5)(cid:2)(cid:28)(cid:3,Unknown,8595.0
Unknown,Unknown,34,Unknown,Unknown,Unknown,Unknown,cid:10)(cid:11)(cid:10)(cid:46)(cid:14)(cid:2)(cid:9)(cid:11)(cid:4)(cid:3)(cid:49)(cid:4)(cid:8)(cid:5)(cid:2)(cid:28)(cid:3,Unknown,8629.0
Unknown,Unknown,33,Unknown,Unknown,Unknown,Unknown,cid:10)(cid:11)(cid:10)(cid:46)(cid:14)(cid:2)(cid:9)(cid:11)(cid:4)(cid:3)(cid:49)(cid:4)(cid:8)(cid:5)(cid:2)(cid:28)(cid:3,Unknown,8662.0
Unknown,Unknown,18,Unknown,Unknown,Unknown,Unknown,cid:10)(cid:11)(cid:10)(cid:46)(cid:14)(cid:2)(cid:9)(cid:11)(cid:4)(cid:3)(cid:49)(cid:4)(cid:8)(cid:5)(cid:2)(cid:28)(cid:3,Unknown,8680.0
Unknown,Unknown,34,Unknown,Unknown,Unknown,Unknown,cid:10)(cid:11)(cid:10)(cid:46)(cid:14)(cid:2)(cid:9)(cid:11)(cid:4)(cid:3)(cid:49)(cid:4)(cid:8)(cid:5)(cid:2)(cid:28)(cid:3,Unknown,8714.0
Unknown,Unknown,45,Unknown,Unknown,Unknown,Unknown,cid:10)(cid:11)(cid:10)(cid:46)(cid:14)(cid:2)(cid:9)(cid:11)(cid:4)(cid:3)(cid:49)(cid:4)(cid:8)(cid:5)(cid:2)(cid:28)(cid:3,Unknown,8759.0
Unknown,Unknown,18,Unknown,Unknown,Unknown,Unknown,cid:10)(cid:11)(cid:10)(cid:46)(cid:14)(cid:2)(cid:9)(cid:11)(cid:4)(cid:3)(cid:49)(cid:4)(cid:8)(cid:5)(cid:2)(cid:28)(cid:3,Unknown,8777.0
Unknown,Unknown,35,Unknown,Unknown,Unknown,Unknown,cid:10)(cid:11)(cid:10)(cid:46)(cid:14)(cid:2)(cid:9)(cid:11)(cid:4)(cid:3)(cid:49)(cid:4)(cid:8)(cid:5)(cid:2)(cid:28)(cid:3,Unknown,8812.0
Unknown,Unknown,46,Unknown,Unknown,Unknown,Unknown,cid:10)(cid:11)(cid:10)(cid:46)(cid:14)(cid:2)(cid:9)(cid:11)(cid:4)(cid:3)(cid:49)(cid:4)(cid:8)(cid:5)(cid:2)(cid:28)(cid:3,Unknown,8858.0
Unknown,Unknown,31,Unknown,Unknown,Unknown,Unknown,cid:10)(cid:11)(cid:10)(cid:46)(cid:14)(cid:2)(cid:9)(cid:11)(cid:4)(cid:3)(cid:49)(cid:4)(cid:8)(cid:5)(cid:2)(cid:28)(cid:3,Unknown,8889.0
Unknown,Unknown,41,Unknown,Unknown,Unknown,Unknown,cid:10)(cid:11)(cid:10)(cid:46)(cid:14)(cid:2)(cid:9)(cid:11)(cid:4)(cid:3)(cid:49)(cid:4)(cid:8)(cid:5)(cid:2)(cid:28)(cid:3,Unknown,8930.0
Unknown,Unknown,24,Unknown,Unknown,Unknown,Unknown,cid:10)(cid:11)(cid:10)(cid:46)(cid:14)(cid:2)(cid:9)(cid:11)(cid:4)(cid:3)(cid:49)(cid:4)(cid:8)(cid:5)(cid:2)(cid:28)(cid:3,Unknown,8954.0
Unknown,Unknown,20,Unknown,Unknown,Unknown,Unknown,cid:10)(cid:11)(cid:10)(cid:46)(cid:14)(cid:2)(cid:9)(cid:11)(cid:4)(cid:3)(cid:49)(cid:4)(cid:8)(cid:5)(cid:2)(cid:28)(cid:3,Unknown,8974.0
Unknown,Unknown,30,Unknown,Unknown,Unknown,Unknown,cid:10)(cid:11)(cid:10)(cid:46)(cid:14)(cid:2)(cid:9)(cid:11)(cid:4)(cid:3)(cid:49)(cid:4)(cid:8)(cid:5)(cid:2)(cid:28)(cid:3,Unknown,9004.0
Unknown,Unknown,2,Unknown,Unknown,Unknown,Unknown,cid:10)(cid:11)(cid:10)(cid:46)(cid:14)(cid:2)(cid:9)(cid:11)(cid:4)(cid:3)(cid:49)(cid:4)(cid:8)(cid:5)(cid:2)(cid:28)(cid:3,Unknown,9006.0
Unknown,Unknown,36,Unknown,Unknown,Unknown,Unknown,cid:10)(cid:11)(cid:10)(cid:46)(cid:14)(cid:2)(cid:9)(cid:11)(cid:4)(cid:3)(cid:49)(cid:4)(cid:8)(cid:5)(cid:2)(cid:28)(cid:3,Unknown,9042.0
Unknown,Unknown,17,Unknown,Unknown,Unknown,Unknown,cid:10)(cid:11)(cid:10)(cid:46)(cid:14)(cid:2)(cid:9)(cid:11)(cid:4)(cid:3)(cid:49)(cid:4)(cid:8)(cid:5)(cid:2)(cid:28)(cid:3,Unknown,9059.0
Unknown,Unknown,17,Unknown,Unknown,Unknown,Unknown,cid:10)(cid:11)(cid:10)(cid:46)(cid:14)(cid:2)(cid:9)(cid:11)(cid:4)(cid:3)(cid:49)(cid:4)(cid:8)(cid:5)(cid:2)(cid:28)(cid:3,Unknown,9076.0
Unknown,Unknown,33,Unknown,Unknown,Unknown,Unknown,cid:10)(cid:11)(cid:10)(cid:46)(cid:14)(cid:2)(cid:9)(cid:11)(cid:4)(cid:3)(cid:49)(cid:4)(cid:8)(cid:5)(cid:2)(cid:28)(cid:3,Unknown,9109.0
Unknown,Unknown,2,Unknown,Unknown,Unknown,Unknown,cid:10)(cid:11)(cid:10)(cid:46)(cid:14)(cid:2)(cid:9)(cid:11)(cid:4)(cid:3)(cid:49)(cid:4)(cid:8)(cid:5)(cid:2)(cid:28)(cid:3,Unknown,9111.0
Unknown,Unknown,12,Unknown,Unknown,Unknown,Unknown,cid:10)(cid:11)(cid:10)(cid:46)(cid:14)(cid:2)(cid:9)(cid:11)(cid:4)(cid:3)(cid:49)(cid:4)(cid:8)(cid:5)(cid:2)(cid:28)(cid:3,Unknown,9123.0
Unknown,Unknown,20,Unknown,Unknown,Unknown,Unknown,cid:10)(cid:11)(cid:10)(cid:46)(cid:14)(cid:2)(cid:9)(cid:11)(cid:4)(cid:3)(cid:49)(cid:4)(cid:8)(cid:5)(cid:2)(cid:28)(cid:3,Unknown,9143.0
Unknown,Unknown,21,Unknown,Unknown,Unknown,Unknown,cid:10)(cid:11)(cid:10)(cid:46)(cid:14)(cid:2)(cid:9)(cid:11)(cid:4)(cid:3)(cid:49)(cid:4)(cid:8)(cid:5)(cid:2)(cid:28)(cid:3,Unknown,9164.0
Unknown,Unknown,22,Unknown,Unknown,Unknown,Unknown,cid:10)(cid:11)(cid:10)(cid:46)(cid:14)(cid:2)(cid:9)(cid:11)(cid:4)(cid:3)(cid:49)(cid:4)(cid:8)(cid:5)(cid:2)(cid:28)(cid:3,Unknown,9186.0
Unknown,Unknown,20,Unknown,Unknown,Unknown,Unknown,cid:10)(cid:11)(cid:10)(cid:46)(cid:14)(cid:2)(cid:9)(cid:11)(cid:4)(cid:3)(cid:49)(cid:4)(cid:8)(cid:5)(cid:2)(cid:28)(cid:3,Unknown,9206.0
Unknown,Unknown,23,Unknown,Unknown,Unknown,Unknown,cid:10)(cid:11)(cid:10)(cid:46)(cid:14)(cid:2)(cid:9)(cid:11)(cid:4)(cid:3)(cid:49)(cid:4)(cid:8)(cid:5)(cid:2)(cid:28)(cid:3,Unknown,9229.0
Unknown,Unknown,23,Unknown,Unknown,Unknown,Unknown,cid:10)(cid:11)(cid:10)(cid:46)(cid:14)(cid:2)(cid:9)(cid:11)(cid:4)(cid:3)(cid:49)(cid:4)(cid:8)(cid:5)(cid:2)(cid:28)(cid:3,Unknown,9252.0
Unknown,Unknown,24,Unknown,Unknown,Unknown,Unknown,cid:10)(cid:11)(cid:10)(cid:46)(cid:14)(cid:2)(cid:9)(cid:11)(cid:4)(cid:3)(cid:49)(cid:4)(cid:8)(cid:5)(cid:2)(cid:28)(cid:3,Unknown,9276.0
Unknown,Unknown,25,Unknown,Unknown,Unknown,Unknown,cid:10)(cid:11)(cid:10)(cid:46)(cid:14)(cid:2)(cid:9)(cid:11)(cid:4)(cid:3)(cid:49)(cid:4)(cid:8)(cid:5)(cid:2)(cid:28)(cid:3,Unknown,9301.0
Unknown,Unknown,26,Unknown,Unknown,Unknown,Unknown,cid:10)(cid:11)(cid:10)(cid:46)(cid:14)(cid:2)(cid:9)(cid:11)(cid:4)(cid:3)(cid:49)(cid:4)(cid:8)(cid:5)(cid:2)(cid:28)(cid:3,Unknown,9327.0
Unknown,Unknown,27,Unknown,Unknown,Unknown,Unknown,cid:10)(cid:11)(cid:10)(cid:46)(cid:14)(cid:2)(cid:9)(cid:11)(cid:4)(cid:3)(cid:49)(cid:4)(cid:8)(cid:5)(cid:2)(cid:28)(cid:3,Unknown,9354.0
Unknown,Unknown,2,Unknown,Unknown,Unknown,Unknown,cid:10)(cid:11)(cid:10)(cid:46)(cid:14)(cid:2)(cid:9)(cid:11)(cid:4)(cid:3)(cid:49)(cid:4)(cid:8)(cid:5)(cid:2)(cid:28)(cid:3,Unknown,9356.0
Unknown,Unknown,28,Unknown,Unknown,Unknown,Unknown,cid:10)(cid:11)(cid:10)(cid:46)(cid:14)(cid:2)(cid:9)(cid:11)(cid:4)(cid:3)(cid:49)(cid:4)(cid:8)(cid:5)(cid:2)(cid:28)(cid:3,Unknown,9384.0
Unknown,Unknown,3,Unknown,Unknown,Unknown,Unknown,cid:10)(cid:11)(cid:10)(cid:46)(cid:14)(cid:2)(cid:9)(cid:11)(cid:4)(cid:3)(cid:49)(cid:4)(cid:8)(cid:5)(cid:2)(cid:28)(cid:3,Unknown,9387.0
Unknown,Unknown,15,Unknown,Unknown,Unknown,Unknown,cid:10)(cid:11)(cid:10)(cid:46)(cid:14)(cid:2)(cid:9)(cid:11)(cid:4)(cid:3)(cid:49)(cid:4)(cid:8)(cid:5)(cid:2)(cid:28)(cid:3,Unknown,9402.0
Unknown,Unknown,2,Unknown,Unknown,Unknown,Unknown,cid:10)(cid:11)(cid:10)(cid:46)(cid:14)(cid:2)(cid:9)(cid:11)(cid:4)(cid:3)(cid:49)(cid:4)(cid:8)(cid:5)(cid:2)(cid:28)(cid:3,Unknown,9404.0
Unknown,Unknown,16,Unknown,Unknown,Unknown,Unknown,cid:10)(cid:11)(cid:10)(cid:46)(cid:14)(cid:2)(cid:9)(cid:11)(cid:4)(cid:3)(cid:49)(cid:4)(cid:8)(cid:5)(cid:2)(cid:28)(cid:3,Unknown,9420.0
Unknown,Unknown,33,Unknown,Unknown,Unknown,Unknown,cid:10)(cid:11)(cid:10)(cid:46)(cid:14)(cid:2)(cid:9)(cid:11)(cid:4)(cid:3)(cid:49)(cid:4)(cid:8)(cid:5)(cid:2)(cid:28)(cid:3,Unknown,9453.0
Unknown,Unknown,19,Unknown,Unknown,Unknown,Unknown,cid:10)(cid:11)(cid:10)(cid:46)(cid:14)(cid:2)(cid:9)(cid:11)(cid:4)(cid:3)(cid:49)(cid:4)(cid:8)(cid:5)(cid:2)(cid:28)(cid:3,Unknown,9472.0
Unknown,Unknown,16,Unknown,Unknown,Unknown,Unknown,cid:10)(cid:11)(cid:10)(cid:46)(cid:14)(cid:2)(cid:9)(cid:11)(cid:4)(cid:3)(cid:49)(cid:4)(cid:8)(cid:5)(cid:2)(cid:28)(cid:3,Unknown,9488.0
Unknown,Unknown,35,Unknown,Unknown,Unknown,Unknown,cid:10)(cid:11)(cid:10)(cid:46)(cid:14)(cid:2)(cid:9)(cid:11)(cid:4)(cid:3)(cid:49)(cid:4)(cid:8)(cid:5)(cid:2)(cid:28)(cid:3,Unknown,9523.0
Unknown,Unknown,2,Unknown,Unknown,Unknown,Unknown,cid:10)(cid:11)(cid:10)(cid:46)(cid:14)(cid:2)(cid:9)(cid:11)(cid:4)(cid:3)(cid:49)(cid:4)(cid:8)(cid:5)(cid:2)(cid:28)(cid:3,Unknown,9525.0
Unknown,Unknown,44,Unknown,Unknown,Unknown,Unknown,cid:10)(cid:11)(cid:10)(cid:46)(cid:14)(cid:2)(cid:9)(cid:11)(cid:4)(cid:3)(cid:49)(cid:4)(cid:8)(cid:5)(cid:2)(cid:28)(cid:3,Unknown,9569.0
Unknown,Unknown,12,Unknown,Unknown,Unknown,Unknown,cid:10)(cid:11)(cid:10)(cid:46)(cid:14)(cid:2)(cid:9)(cid:11)(cid:4)(cid:3)(cid:49)(cid:4)(cid:8)(cid:5)(cid:2)(cid:28)(cid:3,Unknown,9581.0
Unknown,Unknown,29,Unknown,Unknown,Unknown,Unknown,cid:10)(cid:11)(cid:10)(cid:46)(cid:14)(cid:2)(cid:9)(cid:11)(cid:4)(cid:3)(cid:49)(cid:4)(cid:8)(cid:5)(cid:2)(cid:28)(cid:3,Unknown,9610.0
Unknown,Unknown,26,Unknown,Unknown,Unknown,Unknown,cid:10)(cid:11)(cid:10)(cid:46)(cid:14)(cid:2)(cid:9)(cid:11)(cid:4)(cid:3)(cid:49)(cid:4)(cid:8)(cid:5)(cid:2)(cid:28)(cid:3,Unknown,9636.0
Unknown,Unknown,41,Unknown,Unknown,Unknown,Unknown,cid:10)(cid:11)(cid:10)(cid:46)(cid:14)(cid:2)(cid:9)(cid:11)(cid:4)(cid:3)(cid:49)(cid:4)(cid:8)(cid:5)(cid:2)(cid:28)(cid:3,Unknown,9677.0
Unknown,Unknown,25,Unknown,Unknown,Unknown,Unknown,cid:10)(cid:11)(cid:10)(cid:46)(cid:14)(cid:2)(cid:9)(cid:11)(cid:4)(cid:3)(cid:49)(cid:4)(cid:8)(cid:5)(cid:2)(cid:28)(cid:3,Unknown,9702.0
Unknown,Unknown,2,Unknown,Unknown,Unknown,Unknown,cid:10)(cid:11)(cid:10)(cid:46)(cid:14)(cid:2)(cid:9)(cid:11)(cid:4)(cid:3)(cid:49)(cid:4)(cid:8)(cid:5)(cid:2)(cid:28)(cid:3,Unknown,9704.0
Unknown,Unknown,50,Unknown,Unknown,Unknown,Unknown,cid:10)(cid:11)(cid:10)(cid:46)(cid:14)(cid:2)(cid:9)(cid:11)(cid:4)(cid:3)(cid:49)(cid:4)(cid:8)(cid:5)(cid:2)(cid:28)(cid:3,Unknown,9754.0
Unknown,Unknown,50,Unknown,Unknown,Unknown,Unknown,cid:10)(cid:11)(cid:10)(cid:46)(cid:14)(cid:2)(cid:9)(cid:11)(cid:4)(cid:3)(cid:49)(cid:4)(cid:8)(cid:5)(cid:2)(cid:28)(cid:3,Unknown,9804.0
Unknown,Unknown,37,Unknown,Unknown,Unknown,Unknown,cid:10)(cid:11)(cid:10)(cid:46)(cid:14)(cid:2)(cid:9)(cid:11)(cid:4)(cid:3)(cid:49)(cid:4)(cid:8)(cid:5)(cid:2)(cid:28)(cid:3,Unknown,9841.0
Unknown,Unknown,16,Unknown,Unknown,Unknown,Unknown,cid:10)(cid:11)(cid:10)(cid:46)(cid:14)(cid:2)(cid:9)(cid:11)(cid:4)(cid:3)(cid:49)(cid:4)(cid:8)(cid:5)(cid:2)(cid:28)(cid:3,Unknown,9857.0
Unknown,Unknown,34,Unknown,Unknown,Unknown,Unknown,cid:10)(cid:11)(cid:10)(cid:46)(cid:14)(cid:2)(cid:9)(cid:11)(cid:4)(cid:3)(cid:49)(cid:4)(cid:8)(cid:5)(cid:2)(cid:28)(cid:3,Unknown,9891.0
Unknown,Unknown,33,Unknown,Unknown,Unknown,Unknown,cid:10)(cid:11)(cid:10)(cid:46)(cid:14)(cid:2)(cid:9)(cid:11)(cid:4)(cid:3)(cid:49)(cid:4)(cid:8)(cid:5)(cid:2)(cid:28)(cid:3,Unknown,9924.0
Unknown,Unknown,18,Unknown,Unknown,Unknown,Unknown,cid:10)(cid:11)(cid:10)(cid:46)(cid:14)(cid:2)(cid:9)(cid:11)(cid:4)(cid:3)(cid:49)(cid:4)(cid:8)(cid:5)(cid:2)(cid:28)(cid:3,Unknown,9942.0
Unknown,Unknown,34,Unknown,Unknown,Unknown,Unknown,cid:10)(cid:11)(cid:10)(cid:46)(cid:14)(cid:2)(cid:9)(cid:11)(cid:4)(cid:3)(cid:49)(cid:4)(cid:8)(cid:5)(cid:2)(cid:28)(cid:3,Unknown,9976.0
Unknown,Unknown,45,Unknown,Unknown,Unknown,Unknown,cid:10)(cid:11)(cid:10)(cid:46)(cid:14)(cid:2)(cid:9)(cid:11)(cid:4)(cid:3)(cid:49)(cid:4)(cid:8)(cid:5)(cid:2)(cid:28)(cid:3,Unknown,10021.0
Unknown,Unknown,18,Unknown,Unknown,Unknown,Unknown,cid:10)(cid:11)(cid:10)(cid:46)(cid:14)(cid:2)(cid:9)(cid:11)(cid:4)(cid:3)(cid:49)(cid:4)(cid:8)(cid:5)(cid:2)(cid:28)(cid:3,Unknown,10039.0
Unknown,Unknown,35,Unknown,Unknown,Unknown,Unknown,cid:10)(cid:11)(cid:10)(cid:46)(cid:14)(cid:2)(cid:9)(cid:11)(cid:4)(cid:3)(cid:49)(cid:4)(cid:8)(cid:5)(cid:2)(cid:28)(cid:3,Unknown,10074.0
Unknown,Unknown,14,Unknown,Unknown,Unknown,Unknown,cid:10)(cid:11)(cid:10)(cid:46)(cid:14)(cid:2)(cid:9)(cid:11)(cid:4)(cid:3)(cid:49)(cid:4)(cid:8)(cid:5)(cid:2)(cid:28)(cid:3,Unknown,10088.0
Unknown,Unknown,5,Unknown,Unknown,Unknown,Unknown,cid:10)(cid:11)(cid:10)(cid:46)(cid:14)(cid:2)(cid:9)(cid:11)(cid:4)(cid:3)(cid:49)(cid:4)(cid:8)(cid:5)(cid:2)(cid:28)(cid:3,Unknown,10093.0
Unknown,Unknown,9,Unknown,Unknown,Unknown,Unknown,cid:10)(cid:11)(cid:10)(cid:46)(cid:14)(cid:2)(cid:9)(cid:11)(cid:4)(cid:3)(cid:49)(cid:4)(cid:8)(cid:5)(cid:2)(cid:28)(cid:3,Unknown,10102.0
Unknown,Unknown,2,Unknown,Unknown,Unknown,Unknown,cid:10)(cid:11)(cid:10)(cid:46)(cid:14)(cid:2)(cid:9)(cid:11)(cid:4)(cid:3)(cid:49)(cid:4)(cid:8)(cid:5)(cid:2)(cid:28)(cid:3,Unknown,10104.0
Unknown,Unknown,10,Unknown,Unknown,Unknown,Unknown,cid:10)(cid:11)(cid:10)(cid:46)(cid:14)(cid:2)(cid:9)(cid:11)(cid:4)(cid:3)(cid:49)(cid:4)(cid:8)(cid:5)(cid:2)(cid:28)(cid:3,Unknown,10114.0
Unknown,Unknown,5,Unknown,Unknown,Unknown,Unknown,cid:10)(cid:11)(cid:10)(cid:46)(cid:14)(cid:2)(cid:9)(cid:11)(cid:4)(cid:3)(cid:49)(cid:4)(cid:8)(cid:5)(cid:2)(cid:28)(cid:3,Unknown,10119.0
Unknown,Unknown,54,Unknown,Unknown,Unknown,Unknown,cid:10)(cid:11)(cid:10)(cid:46)(cid:14)(cid:2)(cid:9)(cid:11)(cid:4)(cid:3)(cid:49)(cid:4)(cid:8)(cid:5)(cid:2)(cid:28)(cid:3,Unknown,10173.0
Unknown,Unknown,39,Unknown,Unknown,Unknown,Unknown,cid:10)(cid:11)(cid:10)(cid:46)(cid:14)(cid:2)(cid:9)(cid:11)(cid:4)(cid:3)(cid:49)(cid:4)(cid:8)(cid:5)(cid:2)(cid:28)(cid:3,Unknown,10212.0
Unknown,Unknown,14,Unknown,Unknown,Unknown,Unknown,cid:10)(cid:11)(cid:10)(cid:46)(cid:14)(cid:2)(cid:9)(cid:11)(cid:4)(cid:3)(cid:49)(cid:4)(cid:8)(cid:5)(cid:2)(cid:28)(cid:3,Unknown,10226.0
Unknown,Unknown,7,Unknown,Unknown,Unknown,Unknown,cid:10)(cid:11)(cid:10)(cid:46)(cid:14)(cid:2)(cid:9)(cid:11)(cid:4)(cid:3)(cid:49)(cid:4)(cid:8)(cid:5)(cid:2)(cid:28)(cid:3,Unknown,10233.0
Unknown,Unknown,5,Unknown,Unknown,Unknown,Unknown,cid:10)(cid:11)(cid:10)(cid:46)(cid:14)(cid:2)(cid:9)(cid:11)(cid:4)(cid:3)(cid:49)(cid:4)(cid:8)(cid:5)(cid:2)(cid:28)(cid:3,Unknown,10238.0
Unknown,Unknown,3,Unknown,Unknown,Unknown,Unknown,cid:10)(cid:11)(cid:10)(cid:46)(cid:14)(cid:2)(cid:9)(cid:11)(cid:4)(cid:3)(cid:49)(cid:4)(cid:8)(cid:5)(cid:2)(cid:28)(cid:3,Unknown,10241.0
Unknown,Unknown,9,Unknown,Unknown,Unknown,Unknown,cid:10)(cid:11)(cid:10)(cid:46)(cid:14)(cid:2)(cid:9)(cid:11)(cid:4)(cid:3)(cid:49)(cid:4)(cid:8)(cid:5)(cid:2)(cid:28)(cid:3,Unknown,10250.0
Unknown,Unknown,2,Unknown,Unknown,Unknown,Unknown,cid:10)(cid:11)(cid:10)(cid:46)(cid:14)(cid:2)(cid:9)(cid:11)(cid:4)(cid:3)(cid:49)(cid:4)(cid:8)(cid:5)(cid:2)(cid:28)(cid:3,Unknown,10252.0
Unknown,Unknown,12,Unknown,Unknown,Unknown,Unknown,cid:10)(cid:11)(cid:10)(cid:46)(cid:14)(cid:2)(cid:9)(cid:11)(cid:4)(cid:3)(cid:49)(cid:4)(cid:8)(cid:5)(cid:2)(cid:28)(cid:3,Unknown,10264.0
Unknown,Unknown,11,Unknown,Unknown,Unknown,Unknown,cid:10)(cid:11)(cid:10)(cid:46)(cid:14)(cid:2)(cid:9)(cid:11)(cid:4)(cid:3)(cid:49)(cid:4)(cid:8)(cid:5)(cid:2)(cid:28)(cid:3,Unknown,10275.0
Unknown,Unknown,4,Unknown,Unknown,Unknown,Unknown,cid:10)(cid:11)(cid:10)(cid:46)(cid:14)(cid:2)(cid:9)(cid:11)(cid:4)(cid:3)(cid:49)(cid:4)(cid:8)(cid:5)(cid:2)(cid:28)(cid:3,Unknown,10279.0
Unknown,Unknown,14,Unknown,Unknown,Unknown,Unknown,cid:10)(cid:11)(cid:10)(cid:46)(cid:14)(cid:2)(cid:9)(cid:11)(cid:4)(cid:3)(cid:49)(cid:4)(cid:8)(cid:5)(cid:2)(cid:28)(cid:3,Unknown,10293.0
Unknown,Unknown,11,Unknown,Unknown,Unknown,Unknown,cid:10)(cid:11)(cid:10)(cid:46)(cid:14)(cid:2)(cid:9)(cid:11)(cid:4)(cid:3)(cid:49)(cid:4)(cid:8)(cid:5)(cid:2)(cid:28)(cid:3,Unknown,10304.0
Unknown,Unknown,54,Unknown,Unknown,Unknown,Unknown,cid:10)(cid:11)(cid:10)(cid:46)(cid:14)(cid:2)(cid:9)(cid:11)(cid:4)(cid:3)(cid:49)(cid:4)(cid:8)(cid:5)(cid:2)(cid:28)(cid:3,Unknown,10358.0
Unknown,Unknown,54,Unknown,Unknown,Unknown,Unknown,cid:10)(cid:11)(cid:10)(cid:46)(cid:14)(cid:2)(cid:9)(cid:11)(cid:4)(cid:3)(cid:49)(cid:4)(cid:8)(cid:5)(cid:2)(cid:28)(cid:3,Unknown,10412.0
Unknown,Unknown,7,Unknown,Unknown,Unknown,Unknown,cid:10)(cid:11)(cid:10)(cid:46)(cid:14)(cid:2)(cid:9)(cid:11)(cid:4)(cid:3)(cid:49)(cid:4)(cid:8)(cid:5)(cid:2)(cid:28)(cid:3,Unknown,10419.0
Unknown,Unknown,5,Unknown,Unknown,Unknown,Unknown,cid:10)(cid:11)(cid:10)(cid:46)(cid:14)(cid:2)(cid:9)(cid:11)(cid:4)(cid:3)(cid:49)(cid:4)(cid:8)(cid:5)(cid:2)(cid:28)(cid:3,Unknown,10424.0
Unknown,Unknown,3,Unknown,Unknown,Unknown,Unknown,cid:10)(cid:11)(cid:10)(cid:46)(cid:14)(cid:2)(cid:9)(cid:11)(cid:4)(cid:3)(cid:49)(cid:4)(cid:8)(cid:5)(cid:2)(cid:28)(cid:3,Unknown,10427.0
Unknown,Unknown,2,Unknown,Unknown,Unknown,Unknown,cid:10)(cid:11)(cid:10)(cid:46)(cid:14)(cid:2)(cid:9)(cid:11)(cid:4)(cid:3)(cid:49)(cid:4)(cid:8)(cid:5)(cid:2)(cid:28)(cid:3,Unknown,10429.0
Unknown,Unknown,28,Unknown,Unknown,Unknown,Unknown,cid:10)(cid:11)(cid:10)(cid:46)(cid:14)(cid:2)(cid:9)(cid:11)(cid:4)(cid:3)(cid:49)(cid:4)(cid:8)(cid:5)(cid:2)(cid:28)(cid:3,Unknown,10457.0
Unknown,Unknown,3,Unknown,Unknown,Unknown,Unknown,cid:10)(cid:11)(cid:10)(cid:46)(cid:14)(cid:2)(cid:9)(cid:11)(cid:4)(cid:3)(cid:49)(cid:4)(cid:8)(cid:5)(cid:2)(cid:28)(cid:3,Unknown,10460.0
Unknown,Unknown,15,Unknown,Unknown,Unknown,Unknown,cid:10)(cid:11)(cid:10)(cid:46)(cid:14)(cid:2)(cid:9)(cid:11)(cid:4)(cid:3)(cid:49)(cid:4)(cid:8)(cid:5)(cid:2)(cid:28)(cid:3,Unknown,10475.0
Unknown,Unknown,2,Unknown,Unknown,Unknown,Unknown,cid:10)(cid:11)(cid:10)(cid:46)(cid:14)(cid:2)(cid:9)(cid:11)(cid:4)(cid:3)(cid:49)(cid:4)(cid:8)(cid:5)(cid:2)(cid:28)(cid:3,Unknown,10477.0
Unknown,Unknown,17,Unknown,Unknown,Unknown,Unknown,cid:10)(cid:11)(cid:10)(cid:46)(cid:14)(cid:2)(cid:9)(cid:11)(cid:4)(cid:3)(cid:49)(cid:4)(cid:8)(cid:5)(cid:2)(cid:28)(cid:3,Unknown,10494.0
Unknown,Unknown,18,Unknown,Unknown,Unknown,Unknown,cid:10)(cid:11)(cid:10)(cid:46)(cid:14)(cid:2)(cid:9)(cid:11)(cid:4)(cid:3)(cid:49)(cid:4)(cid:8)(cid:5)(cid:2)(cid:28)(cid:3,Unknown,10512.0
Unknown,Unknown,37,Unknown,Unknown,Unknown,Unknown,cid:10)(cid:11)(cid:10)(cid:46)(cid:14)(cid:2)(cid:9)(cid:11)(cid:4)(cid:3)(cid:49)(cid:4)(cid:8)(cid:5)(cid:2)(cid:28)(cid:3,Unknown,10549.0
Unknown,Unknown,19,Unknown,Unknown,Unknown,Unknown,cid:10)(cid:11)(cid:10)(cid:46)(cid:14)(cid:2)(cid:9)(cid:11)(cid:4)(cid:3)(cid:49)(cid:4)(cid:8)(cid:5)(cid:2)(cid:28)(cid:3,Unknown,10568.0
Unknown,Unknown,16,Unknown,Unknown,Unknown,Unknown,cid:10)(cid:11)(cid:10)(cid:46)(cid:14)(cid:2)(cid:9)(cid:11)(cid:4)(cid:3)(cid:49)(cid:4)(cid:8)(cid:5)(cid:2)(cid:28)(cid:3,Unknown,10584.0
Unknown,Unknown,1,Unknown,Unknown,Unknown,Unknown,cid:10)(cid:11)(cid:10)(cid:46)(cid:14)(cid:2)(cid:9)(cid:11)(cid:4)(cid:3)(cid:49)(cid:4)(cid:8)(cid:5)(cid:2)(cid:28)(cid:3,Unknown,10585.0
Unknown,Unknown,2,Unknown,Unknown,Unknown,Unknown,cid:10)(cid:11)(cid:10)(cid:46)(cid:14)(cid:2)(cid:9)(cid:11)(cid:4)(cid:3)(cid:49)(cid:4)(cid:8)(cid:5)(cid:2)(cid:28)(cid:3,Unknown,10587.0
Unknown,Unknown,44,Unknown,Unknown,Unknown,Unknown,cid:10)(cid:11)(cid:10)(cid:46)(cid:14)(cid:2)(cid:9)(cid:11)(cid:4)(cid:3)(cid:49)(cid:4)(cid:8)(cid:5)(cid:2)(cid:28)(cid:3,Unknown,10631.0
Unknown,Unknown,12,Unknown,Unknown,Unknown,Unknown,cid:10)(cid:11)(cid:10)(cid:46)(cid:14)(cid:2)(cid:9)(cid:11)(cid:4)(cid:3)(cid:49)(cid:4)(cid:8)(cid:5)(cid:2)(cid:28)(cid:3,Unknown,10643.0
Unknown,Unknown,29,Unknown,Unknown,Unknown,Unknown,cid:10)(cid:11)(cid:10)(cid:46)(cid:14)(cid:2)(cid:9)(cid:11)(cid:4)(cid:3)(cid:49)(cid:4)(cid:8)(cid:5)(cid:2)(cid:28)(cid:3,Unknown,10672.0
Unknown,Unknown,26,Unknown,Unknown,Unknown,Unknown,cid:10)(cid:11)(cid:10)(cid:46)(cid:14)(cid:2)(cid:9)(cid:11)(cid:4)(cid:3)(cid:49)(cid:4)(cid:8)(cid:5)(cid:2)(cid:28)(cid:3,Unknown,10698.0
Unknown,Unknown,41,Unknown,Unknown,Unknown,Unknown,cid:10)(cid:11)(cid:10)(cid:46)(cid:14)(cid:2)(cid:9)(cid:11)(cid:4)(cid:3)(cid:49)(cid:4)(cid:8)(cid:5)(cid:2)(cid:28)(cid:3,Unknown,10739.0
Unknown,Unknown,25,Unknown,Unknown,Unknown,Unknown,cid:10)(cid:11)(cid:10)(cid:46)(cid:14)(cid:2)(cid:9)(cid:11)(cid:4)(cid:3)(cid:49)(cid:4)(cid:8)(cid:5)(cid:2)(cid:28)(cid:3,Unknown,10764.0
Unknown,Unknown,2,Unknown,Unknown,Unknown,Unknown,cid:10)(cid:11)(cid:10)(cid:46)(cid:14)(cid:2)(cid:9)(cid:11)(cid:4)(cid:3)(cid:49)(cid:4)(cid:8)(cid:5)(cid:2)(cid:28)(cid:3,Unknown,10766.0
Unknown,Unknown,50,Unknown,Unknown,Unknown,Unknown,cid:10)(cid:11)(cid:10)(cid:46)(cid:14)(cid:2)(cid:9)(cid:11)(cid:4)(cid:3)(cid:49)(cid:4)(cid:8)(cid:5)(cid:2)(cid:28)(cid:3,Unknown,10816.0
Unknown,Unknown,50,Unknown,Unknown,Unknown,Unknown,cid:10)(cid:11)(cid:10)(cid:46)(cid:14)(cid:2)(cid:9)(cid:11)(cid:4)(cid:3)(cid:49)(cid:4)(cid:8)(cid:5)(cid:2)(cid:28)(cid:3,Unknown,10866.0
Unknown,Unknown,37,Unknown,Unknown,Unknown,Unknown,cid:10)(cid:11)(cid:10)(cid:46)(cid:14)(cid:2)(cid:9)(cid:11)(cid:4)(cid:3)(cid:49)(cid:4)(cid:8)(cid:5)(cid:2)(cid:28)(cid:3,Unknown,10903.0
Unknown,Unknown,16,Unknown,Unknown,Unknown,Unknown,cid:10)(cid:11)(cid:10)(cid:46)(cid:14)(cid:2)(cid:9)(cid:11)(cid:4)(cid:3)(cid:49)(cid:4)(cid:8)(cid:5)(cid:2)(cid:28)(cid:3,Unknown,10919.0
Unknown,Unknown,34,Unknown,Unknown,Unknown,Unknown,cid:10)(cid:11)(cid:10)(cid:46)(cid:14)(cid:2)(cid:9)(cid:11)(cid:4)(cid:3)(cid:49)(cid:4)(cid:8)(cid:5)(cid:2)(cid:28)(cid:3,Unknown,10953.0
Unknown,Unknown,33,Unknown,Unknown,Unknown,Unknown,cid:10)(cid:11)(cid:10)(cid:46)(cid:14)(cid:2)(cid:9)(cid:11)(cid:4)(cid:3)(cid:49)(cid:4)(cid:8)(cid:5)(cid:2)(cid:28)(cid:3,Unknown,10986.0
Unknown,Unknown,18,Unknown,Unknown,Unknown,Unknown,cid:10)(cid:11)(cid:10)(cid:46)(cid:14)(cid:2)(cid:9)(cid:11)(cid:4)(cid:3)(cid:49)(cid:4)(cid:8)(cid:5)(cid:2)(cid:28)(cid:3,Unknown,11004.0
Unknown,Unknown,32,Unknown,Unknown,Unknown,Unknown,cid:10)(cid:11)(cid:10)(cid:46)(cid:14)(cid:2)(cid:9)(cid:11)(cid:4)(cid:3)(cid:49)(cid:4)(cid:8)(cid:5)(cid:2)(cid:28)(cid:3,Unknown,11036.0
Unknown,Unknown,45,Unknown,Unknown,Unknown,Unknown,cid:10)(cid:11)(cid:10)(cid:46)(cid:14)(cid:2)(cid:9)(cid:11)(cid:4)(cid:3)(cid:49)(cid:4)(cid:8)(cid:5)(cid:2)(cid:28)(cid:3,Unknown,11081.0
Unknown,Unknown,18,Unknown,Unknown,Unknown,Unknown,cid:10)(cid:11)(cid:10)(cid:46)(cid:14)(cid:2)(cid:9)(cid:11)(cid:4)(cid:3)(cid:49)(cid:4)(cid:8)(cid:5)(cid:2)(cid:28)(cid:3,Unknown,11099.0
Unknown,Unknown,35,Unknown,Unknown,Unknown,Unknown,cid:10)(cid:11)(cid:10)(cid:46)(cid:14)(cid:2)(cid:9)(cid:11)(cid:4)(cid:3)(cid:49)(cid:4)(cid:8)(cid:5)(cid:2)(cid:28)(cid:3,Unknown,11134.0
Unknown,Unknown,14,Unknown,Unknown,Unknown,Unknown,cid:10)(cid:11)(cid:10)(cid:46)(cid:14)(cid:2)(cid:9)(cid:11)(cid:4)(cid:3)(cid:49)(cid:4)(cid:8)(cid:5)(cid:2)(cid:28)(cid:3,Unknown,11148.0
Unknown,Unknown,5,Unknown,Unknown,Unknown,Unknown,cid:10)(cid:11)(cid:10)(cid:46)(cid:14)(cid:2)(cid:9)(cid:11)(cid:4)(cid:3)(cid:49)(cid:4)(cid:8)(cid:5)(cid:2)(cid:28)(cid:3,Unknown,11153.0
Unknown,Unknown,12,Unknown,Unknown,Unknown,Unknown,cid:10)(cid:11)(cid:10)(cid:46)(cid:14)(cid:2)(cid:9)(cid:11)(cid:4)(cid:3)(cid:49)(cid:4)(cid:8)(cid:5)(cid:2)(cid:28)(cid:3,Unknown,11165.0
Unknown,Unknown,14,Unknown,Unknown,Unknown,Unknown,cid:10)(cid:11)(cid:10)(cid:46)(cid:14)(cid:2)(cid:9)(cid:11)(cid:4)(cid:3)(cid:49)(cid:4)(cid:8)(cid:5)(cid:2)(cid:28)(cid:3,Unknown,11179.0
Unknown,Unknown,5,Unknown,Unknown,Unknown,Unknown,cid:10)(cid:11)(cid:10)(cid:46)(cid:14)(cid:2)(cid:9)(cid:11)(cid:4)(cid:3)(cid:49)(cid:4)(cid:8)(cid:5)(cid:2)(cid:28)(cid:3,Unknown,11184.0
Unknown,Unknown,3,Unknown,Unknown,Unknown,Unknown,cid:10)(cid:11)(cid:10)(cid:46)(cid:14)(cid:2)(cid:9)(cid:11)(cid:4)(cid:3)(cid:49)(cid:4)(cid:8)(cid:5)(cid:2)(cid:28)(cid:3,Unknown,11187.0
Unknown,Unknown,12,Unknown,Unknown,Unknown,Unknown,cid:10)(cid:11)(cid:10)(cid:46)(cid:14)(cid:2)(cid:9)(cid:11)(cid:4)(cid:3)(cid:49)(cid:4)(cid:8)(cid:5)(cid:2)(cid:28)(cid:3,Unknown,11199.0
Unknown,Unknown,2,Unknown,Unknown,Unknown,Unknown,cid:10)(cid:11)(cid:10)(cid:46)(cid:14)(cid:2)(cid:9)(cid:11)(cid:4)(cid:3)(cid:49)(cid:4)(cid:8)(cid:5)(cid:2)(cid:28)(cid:3,Unknown,11201.0
Unknown,Unknown,49,Unknown,Unknown,Unknown,Unknown,cid:10)(cid:11)(cid:10)(cid:46)(cid:14)(cid:2)(cid:9)(cid:11)(cid:4)(cid:3)(cid:49)(cid:4)(cid:8)(cid:5)(cid:2)(cid:28)(cid:3,Unknown,11250.0
Unknown,Unknown,7,Unknown,Unknown,Unknown,Unknown,cid:10)(cid:11)(cid:10)(cid:46)(cid:14)(cid:2)(cid:9)(cid:11)(cid:4)(cid:3)(cid:49)(cid:4)(cid:8)(cid:5)(cid:2)(cid:28)(cid:3,Unknown,11257.0
Unknown,Unknown,9,Unknown,Unknown,Unknown,Unknown,cid:10)(cid:11)(cid:10)(cid:46)(cid:14)(cid:2)(cid:9)(cid:11)(cid:4)(cid:3)(cid:49)(cid:4)(cid:8)(cid:5)(cid:2)(cid:28)(cid:3,Unknown,11266.0
Unknown,Unknown,10,Unknown,Unknown,Unknown,Unknown,cid:10)(cid:11)(cid:10)(cid:46)(cid:14)(cid:2)(cid:9)(cid:11)(cid:4)(cid:3)(cid:49)(cid:4)(cid:8)(cid:5)(cid:2)(cid:28)(cid:3,Unknown,11276.0
Unknown,Unknown,3,Unknown,Unknown,Unknown,Unknown,cid:10)(cid:11)(cid:10)(cid:46)(cid:14)(cid:2)(cid:9)(cid:11)(cid:4)(cid:3)(cid:49)(cid:4)(cid:8)(cid:5)(cid:2)(cid:28)(cid:3,Unknown,11279.0
Unknown,Unknown,2,Unknown,Unknown,Unknown,Unknown,cid:10)(cid:11)(cid:10)(cid:46)(cid:14)(cid:2)(cid:9)(cid:11)(cid:4)(cid:3)(cid:49)(cid:4)(cid:8)(cid:5)(cid:2)(cid:28)(cid:3,Unknown,11281.0
Unknown,Unknown,12,Unknown,Unknown,Unknown,Unknown,cid:10)(cid:11)(cid:10)(cid:46)(cid:14)(cid:2)(cid:9)(cid:11)(cid:4)(cid:3)(cid:49)(cid:4)(cid:8)(cid:5)(cid:2)(cid:28)(cid:3,Unknown,11293.0
Unknown,Unknown,11,Unknown,Unknown,Unknown,Unknown,cid:10)(cid:11)(cid:10)(cid:46)(cid:14)(cid:2)(cid:9)(cid:11)(cid:4)(cid:3)(cid:49)(cid:4)(cid:8)(cid:5)(cid:2)(cid:28)(cid:3,Unknown,11304.0
Unknown,Unknown,4,Unknown,Unknown,Unknown,Unknown,cid:10)(cid:11)(cid:10)(cid:46)(cid:14)(cid:2)(cid:9)(cid:11)(cid:4)(cid:3)(cid:49)(cid:4)(cid:8)(cid:5)(cid:2)(cid:28)(cid:3,Unknown,11308.0
Unknown,Unknown,14,Unknown,Unknown,Unknown,Unknown,cid:10)(cid:11)(cid:10)(cid:46)(cid:14)(cid:2)(cid:9)(cid:11)(cid:4)(cid:3)(cid:49)(cid:4)(cid:8)(cid:5)(cid:2)(cid:28)(cid:3,Unknown,11322.0
Unknown,Unknown,11,Unknown,Unknown,Unknown,Unknown,cid:10)(cid:11)(cid:10)(cid:46)(cid:14)(cid:2)(cid:9)(cid:11)(cid:4)(cid:3)(cid:49)(cid:4)(cid:8)(cid:5)(cid:2)(cid:28)(cid:3,Unknown,11333.0
Unknown,Unknown,54,Unknown,Unknown,Unknown,Unknown,cid:10)(cid:11)(cid:10)(cid:46)(cid:14)(cid:2)(cid:9)(cid:11)(cid:4)(cid:3)(cid:49)(cid:4)(cid:8)(cid:5)(cid:2)(cid:28)(cid:3,Unknown,11387.0
Unknown,Unknown,54,Unknown,Unknown,Unknown,Unknown,cid:10)(cid:11)(cid:10)(cid:46)(cid:14)(cid:2)(cid:9)(cid:11)(cid:4)(cid:3)(cid:49)(cid:4)(cid:8)(cid:5)(cid:2)(cid:28)(cid:3,Unknown,11441.0
Unknown,Unknown,7,Unknown,Unknown,Unknown,Unknown,cid:10)(cid:11)(cid:10)(cid:46)(cid:14)(cid:2)(cid:9)(cid:11)(cid:4)(cid:3)(cid:49)(cid:4)(cid:8)(cid:5)(cid:2)(cid:28)(cid:3,Unknown,11448.0
Unknown,Unknown,5,Unknown,Unknown,Unknown,Unknown,cid:10)(cid:11)(cid:10)(cid:46)(cid:14)(cid:2)(cid:9)(cid:11)(cid:4)(cid:3)(cid:49)(cid:4)(cid:8)(cid:5)(cid:2)(cid:28)(cid:3,Unknown,11453.0
Unknown,Unknown,3,Unknown,Unknown,Unknown,Unknown,cid:10)(cid:11)(cid:10)(cid:46)(cid:14)(cid:2)(cid:9)(cid:11)(cid:4)(cid:3)(cid:49)(cid:4)(cid:8)(cid:5)(cid:2)(cid:28)(cid:3,Unknown,11456.0
Unknown,Unknown,2,Unknown,Unknown,Unknown,Unknown,cid:10)(cid:11)(cid:10)(cid:46)(cid:14)(cid:2)(cid:9)(cid:11)(cid:4)(cid:3)(cid:49)(cid:4)(cid:8)(cid:5)(cid:2)(cid:28)(cid:3,Unknown,11458.0
Unknown,Unknown,28,Unknown,Unknown,Unknown,Unknown,cid:10)(cid:11)(cid:10)(cid:46)(cid:14)(cid:2)(cid:9)(cid:11)(cid:4)(cid:3)(cid:49)(cid:4)(cid:8)(cid:5)(cid:2)(cid:28)(cid:3,Unknown,11486.0
Unknown,Unknown,3,Unknown,Unknown,Unknown,Unknown,cid:10)(cid:11)(cid:10)(cid:46)(cid:14)(cid:2)(cid:9)(cid:11)(cid:4)(cid:3)(cid:49)(cid:4)(cid:8)(cid:5)(cid:2)(cid:28)(cid:3,Unknown,11489.0
Unknown,Unknown,15,Unknown,Unknown,Unknown,Unknown,cid:10)(cid:11)(cid:10)(cid:46)(cid:14)(cid:2)(cid:9)(cid:11)(cid:4)(cid:3)(cid:49)(cid:4)(cid:8)(cid:5)(cid:2)(cid:28)(cid:3,Unknown,11504.0
Unknown,Unknown,2,Unknown,Unknown,Unknown,Unknown,cid:10)(cid:11)(cid:10)(cid:46)(cid:14)(cid:2)(cid:9)(cid:11)(cid:4)(cid:3)(cid:49)(cid:4)(cid:8)(cid:5)(cid:2)(cid:28)(cid:3,Unknown,11506.0
Unknown,Unknown,1,Unknown,Unknown,Unknown,Unknown,cid:10)(cid:11)(cid:10)(cid:46)(cid:14)(cid:2)(cid:9)(cid:11)(cid:4)(cid:3)(cid:49)(cid:4)(cid:8)(cid:5)(cid:2)(cid:28)(cid:3,Unknown,11507.0
Unknown,Unknown,33,Unknown,Unknown,Unknown,Unknown,cid:10)(cid:11)(cid:10)(cid:46)(cid:14)(cid:2)(cid:9)(cid:11)(cid:4)(cid:3)(cid:49)(cid:4)(cid:8)(cid:5)(cid:2)(cid:28)(cid:3,Unknown,11540.0
Unknown,Unknown,36,Unknown,Unknown,Unknown,Unknown,cid:10)(cid:11)(cid:10)(cid:46)(cid:14)(cid:2)(cid:9)(cid:11)(cid:4)(cid:3)(cid:49)(cid:4)(cid:8)(cid:5)(cid:2)(cid:28)(cid:3,Unknown,11576.0
Unknown,Unknown,19,Unknown,Unknown,Unknown,Unknown,cid:10)(cid:11)(cid:10)(cid:46)(cid:14)(cid:2)(cid:9)(cid:11)(cid:4)(cid:3)(cid:49)(cid:4)(cid:8)(cid:5)(cid:2)(cid:28)(cid:3,Unknown,11595.0
Unknown,Unknown,35,Unknown,Unknown,Unknown,Unknown,cid:10)(cid:11)(cid:10)(cid:46)(cid:14)(cid:2)(cid:9)(cid:11)(cid:4)(cid:3)(cid:49)(cid:4)(cid:8)(cid:5)(cid:2)(cid:28)(cid:3,Unknown,11630.0
Unknown,Unknown,16,Unknown,Unknown,Unknown,Unknown,cid:10)(cid:11)(cid:10)(cid:46)(cid:14)(cid:2)(cid:9)(cid:11)(cid:4)(cid:3)(cid:49)(cid:4)(cid:8)(cid:5)(cid:2)(cid:28)(cid:3,Unknown,11646.0
Unknown,Unknown,2,Unknown,Unknown,Unknown,Unknown,cid:10)(cid:11)(cid:10)(cid:46)(cid:14)(cid:2)(cid:9)(cid:11)(cid:4)(cid:3)(cid:49)(cid:4)(cid:8)(cid:5)(cid:2)(cid:28)(cid:3,Unknown,11648.0
Unknown,Unknown,44,Unknown,Unknown,Unknown,Unknown,cid:10)(cid:11)(cid:10)(cid:46)(cid:14)(cid:2)(cid:9)(cid:11)(cid:4)(cid:3)(cid:49)(cid:4)(cid:8)(cid:5)(cid:2)(cid:28)(cid:3,Unknown,11692.0
Unknown,Unknown,12,Unknown,Unknown,Unknown,Unknown,cid:10)(cid:11)(cid:10)(cid:46)(cid:14)(cid:2)(cid:9)(cid:11)(cid:4)(cid:3)(cid:49)(cid:4)(cid:8)(cid:5)(cid:2)(cid:28)(cid:3,Unknown,11704.0
Unknown,Unknown,29,Unknown,Unknown,Unknown,Unknown,cid:10)(cid:11)(cid:10)(cid:46)(cid:14)(cid:2)(cid:9)(cid:11)(cid:4)(cid:3)(cid:49)(cid:4)(cid:8)(cid:5)(cid:2)(cid:28)(cid:3,Unknown,11733.0
Unknown,Unknown,26,Unknown,Unknown,Unknown,Unknown,cid:10)(cid:11)(cid:10)(cid:46)(cid:14)(cid:2)(cid:9)(cid:11)(cid:4)(cid:3)(cid:49)(cid:4)(cid:8)(cid:5)(cid:2)(cid:28)(cid:3,Unknown,11759.0
Unknown,Unknown,41,Unknown,Unknown,Unknown,Unknown,cid:10)(cid:11)(cid:10)(cid:46)(cid:14)(cid:2)(cid:9)(cid:11)(cid:4)(cid:3)(cid:49)(cid:4)(cid:8)(cid:5)(cid:2)(cid:28)(cid:3,Unknown,11800.0
Unknown,Unknown,25,Unknown,Unknown,Unknown,Unknown,cid:10)(cid:11)(cid:10)(cid:46)(cid:14)(cid:2)(cid:9)(cid:11)(cid:4)(cid:3)(cid:49)(cid:4)(cid:8)(cid:5)(cid:2)(cid:28)(cid:3,Unknown,11825.0
Unknown,Unknown,2,Unknown,Unknown,Unknown,Unknown,cid:10)(cid:11)(cid:10)(cid:46)(cid:14)(cid:2)(cid:9)(cid:11)(cid:4)(cid:3)(cid:49)(cid:4)(cid:8)(cid:5)(cid:2)(cid:28)(cid:3,Unknown,11827.0
Unknown,Unknown,50,Unknown,Unknown,Unknown,Unknown,cid:10)(cid:11)(cid:10)(cid:46)(cid:14)(cid:2)(cid:9)(cid:11)(cid:4)(cid:3)(cid:49)(cid:4)(cid:8)(cid:5)(cid:2)(cid:28)(cid:3,Unknown,11877.0
Unknown,Unknown,50,Unknown,Unknown,Unknown,Unknown,cid:10)(cid:11)(cid:10)(cid:46)(cid:14)(cid:2)(cid:9)(cid:11)(cid:4)(cid:3)(cid:49)(cid:4)(cid:8)(cid:5)(cid:2)(cid:28)(cid:3,Unknown,11927.0
Unknown,Unknown,37,Unknown,Unknown,Unknown,Unknown,cid:10)(cid:11)(cid:10)(cid:46)(cid:14)(cid:2)(cid:9)(cid:11)(cid:4)(cid:3)(cid:49)(cid:4)(cid:8)(cid:5)(cid:2)(cid:28)(cid:3,Unknown,11964.0
Unknown,Unknown,16,Unknown,Unknown,Unknown,Unknown,cid:10)(cid:11)(cid:10)(cid:46)(cid:14)(cid:2)(cid:9)(cid:11)(cid:4)(cid:3)(cid:49)(cid:4)(cid:8)(cid:5)(cid:2)(cid:28)(cid:3,Unknown,11980.0
Unknown,Unknown,34,Unknown,Unknown,Unknown,Unknown,cid:10)(cid:11)(cid:10)(cid:46)(cid:14)(cid:2)(cid:9)(cid:11)(cid:4)(cid:3)(cid:49)(cid:4)(cid:8)(cid:5)(cid:2)(cid:28)(cid:3,Unknown,12014.0
Unknown,Unknown,33,Unknown,Unknown,Unknown,Unknown,cid:10)(cid:11)(cid:10)(cid:46)(cid:14)(cid:2)(cid:9)(cid:11)(cid:4)(cid:3)(cid:49)(cid:4)(cid:8)(cid:5)(cid:2)(cid:28)(cid:3,Unknown,12047.0
Unknown,Unknown,18,Unknown,Unknown,Unknown,Unknown,cid:10)(cid:11)(cid:10)(cid:46)(cid:14)(cid:2)(cid:9)(cid:11)(cid:4)(cid:3)(cid:49)(cid:4)(cid:8)(cid:5)(cid:2)(cid:28)(cid:3,Unknown,12065.0
Unknown,Unknown,32,Unknown,Unknown,Unknown,Unknown,cid:10)(cid:11)(cid:10)(cid:46)(cid:14)(cid:2)(cid:9)(cid:11)(cid:4)(cid:3)(cid:49)(cid:4)(cid:8)(cid:5)(cid:2)(cid:28)(cid:3,Unknown,12097.0
Unknown,Unknown,45,Unknown,Unknown,Unknown,Unknown,cid:10)(cid:11)(cid:10)(cid:46)(cid:14)(cid:2)(cid:9)(cid:11)(cid:4)(cid:3)(cid:49)(cid:4)(cid:8)(cid:5)(cid:2)(cid:28)(cid:3,Unknown,12142.0
Unknown,Unknown,18,Unknown,Unknown,Unknown,Unknown,cid:10)(cid:11)(cid:10)(cid:46)(cid:14)(cid:2)(cid:9)(cid:11)(cid:4)(cid:3)(cid:49)(cid:4)(cid:8)(cid:5)(cid:2)(cid:28)(cid:3,Unknown,12160.0
Unknown,Unknown,35,Unknown,Unknown,Unknown,Unknown,cid:10)(cid:11)(cid:10)(cid:46)(cid:14)(cid:2)(cid:9)(cid:11)(cid:4)(cid:3)(cid:49)(cid:4)(cid:8)(cid:5)(cid:2)(cid:28)(cid:3,Unknown,12195.0
Unknown,Unknown,54,Unknown,Unknown,Unknown,Unknown,cid:10)(cid:11)(cid:10)(cid:46)(cid:14)(cid:2)(cid:9)(cid:11)(cid:4)(cid:3)(cid:49)(cid:4)(cid:8)(cid:5)(cid:2)(cid:28)(cid:3,Unknown,12249.0
Unknown,Unknown,12,Unknown,Unknown,Unknown,Unknown,cid:10)(cid:11)(cid:10)(cid:46)(cid:14)(cid:2)(cid:9)(cid:11)(cid:4)(cid:3)(cid:49)(cid:4)(cid:8)(cid:5)(cid:2)(cid:28)(cid:3,Unknown,12261.0
Unknown,Unknown,2,Unknown,Unknown,Unknown,Unknown,cid:10)(cid:11)(cid:10)(cid:46)(cid:14)(cid:2)(cid:9)(cid:11)(cid:4)(cid:3)(cid:49)(cid:4)(cid:8)(cid:5)(cid:2)(cid:28)(cid:3,Unknown,12263.0
Unknown,Unknown,49,Unknown,Unknown,Unknown,Unknown,cid:10)(cid:11)(cid:10)(cid:46)(cid:14)(cid:2)(cid:9)(cid:11)(cid:4)(cid:3)(cid:49)(cid:4)(cid:8)(cid:5)(cid:2)(cid:28)(cid:3,Unknown,12312.0
Unknown,Unknown,11,Unknown,Unknown,Unknown,Unknown,cid:10)(cid:11)(cid:10)(cid:46)(cid:14)(cid:2)(cid:9)(cid:11)(cid:4)(cid:3)(cid:49)(cid:4)(cid:8)(cid:5)(cid:2)(cid:28)(cid:3,Unknown,12323.0
Unknown,Unknown,8,Unknown,Unknown,Unknown,Unknown,cid:10)(cid:11)(cid:10)(cid:46)(cid:14)(cid:2)(cid:9)(cid:11)(cid:4)(cid:3)(cid:49)(cid:4)(cid:8)(cid:5)(cid:2)(cid:28)(cid:3,Unknown,12331.0
Unknown,Unknown,46,Unknown,Unknown,Unknown,Unknown,cid:10)(cid:11)(cid:10)(cid:46)(cid:14)(cid:2)(cid:9)(cid:11)(cid:4)(cid:3)(cid:49)(cid:4)(cid:8)(cid:5)(cid:2)(cid:28)(cid:3,Unknown,12377.0
Unknown,Unknown,14,Unknown,Unknown,Unknown,Unknown,cid:10)(cid:11)(cid:10)(cid:46)(cid:14)(cid:2)(cid:9)(cid:11)(cid:4)(cid:3)(cid:49)(cid:4)(cid:8)(cid:5)(cid:2)(cid:28)(cid:3,Unknown,12391.0
Unknown,Unknown,49,Unknown,Unknown,Unknown,Unknown,cid:10)(cid:11)(cid:10)(cid:46)(cid:14)(cid:2)(cid:9)(cid:11)(cid:4)(cid:3)(cid:49)(cid:4)(cid:8)(cid:5)(cid:2)(cid:28)(cid:3,Unknown,12440.0
Unknown,Unknown,55,Unknown,Unknown,Unknown,Unknown,cid:10)(cid:11)(cid:10)(cid:46)(cid:14)(cid:2)(cid:9)(cid:11)(cid:4)(cid:3)(cid:49)(cid:4)(cid:8)(cid:5)(cid:2)(cid:28)(cid:3,Unknown,12495.0
Unknown,Unknown,9,Unknown,Unknown,Unknown,Unknown,cid:10)(cid:11)(cid:10)(cid:46)(cid:14)(cid:2)(cid:9)(cid:11)(cid:4)(cid:3)(cid:49)(cid:4)(cid:8)(cid:5)(cid:2)(cid:28)(cid:3,Unknown,12504.0
Unknown,Unknown,2,Unknown,Unknown,Unknown,Unknown,cid:10)(cid:11)(cid:10)(cid:46)(cid:14)(cid:2)(cid:9)(cid:11)(cid:4)(cid:3)(cid:49)(cid:4)(cid:8)(cid:5)(cid:2)(cid:28)(cid:3,Unknown,12506.0
Unknown,Unknown,12,Unknown,Unknown,Unknown,Unknown,cid:10)(cid:11)(cid:10)(cid:46)(cid:14)(cid:2)(cid:9)(cid:11)(cid:4)(cid:3)(cid:49)(cid:4)(cid:8)(cid:5)(cid:2)(cid:28)(cid:3,Unknown,12518.0
Unknown,Unknown,11,Unknown,Unknown,Unknown,Unknown,cid:10)(cid:11)(cid:10)(cid:46)(cid:14)(cid:2)(cid:9)(cid:11)(cid:4)(cid:3)(cid:49)(cid:4)(cid:8)(cid:5)(cid:2)(cid:28)(cid:3,Unknown,12529.0
Unknown,Unknown,4,Unknown,Unknown,Unknown,Unknown,cid:10)(cid:11)(cid:10)(cid:46)(cid:14)(cid:2)(cid:9)(cid:11)(cid:4)(cid:3)(cid:49)(cid:4)(cid:8)(cid:5)(cid:2)(cid:28)(cid:3,Unknown,12533.0
Unknown,Unknown,14,Unknown,Unknown,Unknown,Unknown,cid:10)(cid:11)(cid:10)(cid:46)(cid:14)(cid:2)(cid:9)(cid:11)(cid:4)(cid:3)(cid:49)(cid:4)(cid:8)(cid:5)(cid:2)(cid:28)(cid:3,Unknown,12547.0
Unknown,Unknown,11,Unknown,Unknown,Unknown,Unknown,cid:10)(cid:11)(cid:10)(cid:46)(cid:14)(cid:2)(cid:9)(cid:11)(cid:4)(cid:3)(cid:49)(cid:4)(cid:8)(cid:5)(cid:2)(cid:28)(cid:3,Unknown,12558.0
Unknown,Unknown,54,Unknown,Unknown,Unknown,Unknown,cid:10)(cid:11)(cid:10)(cid:46)(cid:14)(cid:2)(cid:9)(cid:11)(cid:4)(cid:3)(cid:49)(cid:4)(cid:8)(cid:5)(cid:2)(cid:28)(cid:3,Unknown,12612.0
Unknown,Unknown,54,Unknown,Unknown,Unknown,Unknown,cid:10)(cid:11)(cid:10)(cid:46)(cid:14)(cid:2)(cid:9)(cid:11)(cid:4)(cid:3)(cid:49)(cid:4)(cid:8)(cid:5)(cid:2)(cid:28)(cid:3,Unknown,12666.0
Unknown,Unknown,7,Unknown,Unknown,Unknown,Unknown,cid:10)(cid:11)(cid:10)(cid:46)(cid:14)(cid:2)(cid:9)(cid:11)(cid:4)(cid:3)(cid:49)(cid:4)(cid:8)(cid:5)(cid:2)(cid:28)(cid:3,Unknown,12673.0
Unknown,Unknown,5,Unknown,Unknown,Unknown,Unknown,cid:10)(cid:11)(cid:10)(cid:46)(cid:14)(cid:2)(cid:9)(cid:11)(cid:4)(cid:3)(cid:49)(cid:4)(cid:8)(cid:5)(cid:2)(cid:28)(cid:3,Unknown,12678.0
Unknown,Unknown,3,Unknown,Unknown,Unknown,Unknown,cid:10)(cid:11)(cid:10)(cid:46)(cid:14)(cid:2)(cid:9)(cid:11)(cid:4)(cid:3)(cid:49)(cid:4)(cid:8)(cid:5)(cid:2)(cid:28)(cid:3,Unknown,12681.0
Unknown,Unknown,2,Unknown,Unknown,Unknown,Unknown,cid:10)(cid:11)(cid:10)(cid:46)(cid:14)(cid:2)(cid:9)(cid:11)(cid:4)(cid:3)(cid:49)(cid:4)(cid:8)(cid:5)(cid:2)(cid:28)(cid:3,Unknown,12683.0
Unknown,Unknown,28,Unknown,Unknown,Unknown,Unknown,cid:10)(cid:11)(cid:10)(cid:46)(cid:14)(cid:2)(cid:9)(cid:11)(cid:4)(cid:3)(cid:49)(cid:4)(cid:8)(cid:5)(cid:2)(cid:28)(cid:3,Unknown,12711.0
Unknown,Unknown,3,Unknown,Unknown,Unknown,Unknown,cid:10)(cid:11)(cid:10)(cid:46)(cid:14)(cid:2)(cid:9)(cid:11)(cid:4)(cid:3)(cid:49)(cid:4)(cid:8)(cid:5)(cid:2)(cid:28)(cid:3,Unknown,12714.0
Unknown,Unknown,15,Unknown,Unknown,Unknown,Unknown,cid:10)(cid:11)(cid:10)(cid:46)(cid:14)(cid:2)(cid:9)(cid:11)(cid:4)(cid:3)(cid:49)(cid:4)(cid:8)(cid:5)(cid:2)(cid:28)(cid:3,Unknown,12729.0
Unknown,Unknown,2,Unknown,Unknown,Unknown,Unknown,cid:10)(cid:11)(cid:10)(cid:46)(cid:14)(cid:2)(cid:9)(cid:11)(cid:4)(cid:3)(cid:49)(cid:4)(cid:8)(cid:5)(cid:2)(cid:28)(cid:3,Unknown,12731.0
Unknown,Unknown,37,Unknown,Unknown,Unknown,Unknown,cid:10)(cid:11)(cid:10)(cid:46)(cid:14)(cid:2)(cid:9)(cid:11)(cid:4)(cid:3)(cid:49)(cid:4)(cid:8)(cid:5)(cid:2)(cid:28)(cid:3,Unknown,12768.0
Unknown,Unknown,34,Unknown,Unknown,Unknown,Unknown,cid:10)(cid:11)(cid:10)(cid:46)(cid:14)(cid:2)(cid:9)(cid:11)(cid:4)(cid:3)(cid:49)(cid:4)(cid:8)(cid:5)(cid:2)(cid:28)(cid:3,Unknown,12802.0
Unknown,Unknown,19,Unknown,Unknown,Unknown,Unknown,cid:10)(cid:11)(cid:10)(cid:46)(cid:14)(cid:2)(cid:9)(cid:11)(cid:4)(cid:3)(cid:49)(cid:4)(cid:8)(cid:5)(cid:2)(cid:28)(cid:3,Unknown,12821.0
Unknown,Unknown,18,Unknown,Unknown,Unknown,Unknown,cid:10)(cid:11)(cid:10)(cid:46)(cid:14)(cid:2)(cid:9)(cid:11)(cid:4)(cid:3)(cid:49)(cid:4)(cid:8)(cid:5)(cid:2)(cid:28)(cid:3,Unknown,12839.0
Unknown,Unknown,18,Unknown,Unknown,Unknown,Unknown,cid:10)(cid:11)(cid:10)(cid:46)(cid:14)(cid:2)(cid:9)(cid:11)(cid:4)(cid:3)(cid:49)(cid:4)(cid:8)(cid:5)(cid:2)(cid:28)(cid:3,Unknown,12857.0
Unknown,Unknown,2,Unknown,Unknown,Unknown,Unknown,cid:10)(cid:11)(cid:10)(cid:46)(cid:14)(cid:2)(cid:9)(cid:11)(cid:4)(cid:3)(cid:49)(cid:4)(cid:8)(cid:5)(cid:2)(cid:28)(cid:3,Unknown,12859.0
Unknown,Unknown,44,Unknown,Unknown,Unknown,Unknown,cid:10)(cid:11)(cid:10)(cid:46)(cid:14)(cid:2)(cid:9)(cid:11)(cid:4)(cid:3)(cid:49)(cid:4)(cid:8)(cid:5)(cid:2)(cid:28)(cid:3,Unknown,12903.0
Unknown,Unknown,12,Unknown,Unknown,Unknown,Unknown,cid:10)(cid:11)(cid:10)(cid:46)(cid:14)(cid:2)(cid:9)(cid:11)(cid:4)(cid:3)(cid:49)(cid:4)(cid:8)(cid:5)(cid:2)(cid:28)(cid:3,Unknown,12915.0
Unknown,Unknown,29,Unknown,Unknown,Unknown,Unknown,cid:10)(cid:11)(cid:10)(cid:46)(cid:14)(cid:2)(cid:9)(cid:11)(cid:4)(cid:3)(cid:49)(cid:4)(cid:8)(cid:5)(cid:2)(cid:28)(cid:3,Unknown,12944.0
Unknown,Unknown,26,Unknown,Unknown,Unknown,Unknown,cid:10)(cid:11)(cid:10)(cid:46)(cid:14)(cid:2)(cid:9)(cid:11)(cid:4)(cid:3)(cid:49)(cid:4)(cid:8)(cid:5)(cid:2)(cid:28)(cid:3,Unknown,12970.0
Unknown,Unknown,41,Unknown,Unknown,Unknown,Unknown,cid:10)(cid:11)(cid:10)(cid:46)(cid:14)(cid:2)(cid:9)(cid:11)(cid:4)(cid:3)(cid:49)(cid:4)(cid:8)(cid:5)(cid:2)(cid:28)(cid:3,Unknown,13011.0
Unknown,Unknown,25,Unknown,Unknown,Unknown,Unknown,cid:10)(cid:11)(cid:10)(cid:46)(cid:14)(cid:2)(cid:9)(cid:11)(cid:4)(cid:3)(cid:49)(cid:4)(cid:8)(cid:5)(cid:2)(cid:28)(cid:3,Unknown,13036.0
Unknown,Unknown,2,Unknown,Unknown,Unknown,Unknown,cid:10)(cid:11)(cid:10)(cid:46)(cid:14)(cid:2)(cid:9)(cid:11)(cid:4)(cid:3)(cid:49)(cid:4)(cid:8)(cid:5)(cid:2)(cid:28)(cid:3,Unknown,13038.0
Unknown,Unknown,50,Unknown,Unknown,Unknown,Unknown,cid:10)(cid:11)(cid:10)(cid:46)(cid:14)(cid:2)(cid:9)(cid:11)(cid:4)(cid:3)(cid:49)(cid:4)(cid:8)(cid:5)(cid:2)(cid:28)(cid:3,Unknown,13088.0
Unknown,Unknown,50,Unknown,Unknown,Unknown,Unknown,cid:10)(cid:11)(cid:10)(cid:46)(cid:14)(cid:2)(cid:9)(cid:11)(cid:4)(cid:3)(cid:49)(cid:4)(cid:8)(cid:5)(cid:2)(cid:28)(cid:3,Unknown,13138.0
Unknown,Unknown,37,Unknown,Unknown,Unknown,Unknown,cid:10)(cid:11)(cid:10)(cid:46)(cid:14)(cid:2)(cid:9)(cid:11)(cid:4)(cid:3)(cid:49)(cid:4)(cid:8)(cid:5)(cid:2)(cid:28)(cid:3,Unknown,13175.0
Unknown,Unknown,16,Unknown,Unknown,Unknown,Unknown,cid:10)(cid:11)(cid:10)(cid:46)(cid:14)(cid:2)(cid:9)(cid:11)(cid:4)(cid:3)(cid:49)(cid:4)(cid:8)(cid:5)(cid:2)(cid:28)(cid:3,Unknown,13191.0
Unknown,Unknown,34,Unknown,Unknown,Unknown,Unknown,cid:10)(cid:11)(cid:10)(cid:46)(cid:14)(cid:2)(cid:9)(cid:11)(cid:4)(cid:3)(cid:49)(cid:4)(cid:8)(cid:5)(cid:2)(cid:28)(cid:3,Unknown,13225.0
Unknown,Unknown,33,Unknown,Unknown,Unknown,Unknown,cid:10)(cid:11)(cid:10)(cid:46)(cid:14)(cid:2)(cid:9)(cid:11)(cid:4)(cid:3)(cid:49)(cid:4)(cid:8)(cid:5)(cid:2)(cid:28)(cid:3,Unknown,13258.0
Unknown,Unknown,18,Unknown,Unknown,Unknown,Unknown,cid:10)(cid:11)(cid:10)(cid:46)(cid:14)(cid:2)(cid:9)(cid:11)(cid:4)(cid:3)(cid:49)(cid:4)(cid:8)(cid:5)(cid:2)(cid:28)(cid:3,Unknown,13276.0
Unknown,Unknown,32,Unknown,Unknown,Unknown,Unknown,cid:10)(cid:11)(cid:10)(cid:46)(cid:14)(cid:2)(cid:9)(cid:11)(cid:4)(cid:3)(cid:49)(cid:4)(cid:8)(cid:5)(cid:2)(cid:28)(cid:3,Unknown,13308.0
Unknown,Unknown,45,Unknown,Unknown,Unknown,Unknown,cid:10)(cid:11)(cid:10)(cid:46)(cid:14)(cid:2)(cid:9)(cid:11)(cid:4)(cid:3)(cid:49)(cid:4)(cid:8)(cid:5)(cid:2)(cid:28)(cid:3,Unknown,13353.0
Unknown,Unknown,18,Unknown,Unknown,Unknown,Unknown,cid:10)(cid:11)(cid:10)(cid:46)(cid:14)(cid:2)(cid:9)(cid:11)(cid:4)(cid:3)(cid:49)(cid:4)(cid:8)(cid:5)(cid:2)(cid:28)(cid:3,Unknown,13371.0
Unknown,Unknown,35,Unknown,Unknown,Unknown,Unknown,cid:10)(cid:11)(cid:10)(cid:46)(cid:14)(cid:2)(cid:9)(cid:11)(cid:4)(cid:3)(cid:49)(cid:4)(cid:8)(cid:5)(cid:2)(cid:28)(cid:3,Unknown,13406.0
Unknown,Unknown,14,Unknown,Unknown,Unknown,Unknown,cid:10)(cid:11)(cid:10)(cid:46)(cid:14)(cid:2)(cid:9)(cid:11)(cid:4)(cid:3)(cid:49)(cid:4)(cid:8)(cid:5)(cid:2)(cid:28)(cid:3,Unknown,13420.0
Unknown,Unknown,46,Unknown,Unknown,Unknown,Unknown,cid:10)(cid:11)(cid:10)(cid:46)(cid:14)(cid:2)(cid:9)(cid:11)(cid:4)(cid:3)(cid:49)(cid:4)(cid:8)(cid:5)(cid:2)(cid:28)(cid:3,Unknown,13466.0
Unknown,Unknown,2,Unknown,Unknown,Unknown,Unknown,cid:10)(cid:11)(cid:10)(cid:46)(cid:14)(cid:2)(cid:9)(cid:11)(cid:4)(cid:3)(cid:49)(cid:4)(cid:8)(cid:5)(cid:2)(cid:28)(cid:3,Unknown,13468.0
Unknown,Unknown,9,Unknown,Unknown,Unknown,Unknown,cid:10)(cid:11)(cid:10)(cid:46)(cid:14)(cid:2)(cid:9)(cid:11)(cid:4)(cid:3)(cid:49)(cid:4)(cid:8)(cid:5)(cid:2)(cid:28)(cid:3,Unknown,13477.0
Unknown,Unknown,4,Unknown,Unknown,Unknown,Unknown,cid:10)(cid:11)(cid:10)(cid:46)(cid:14)(cid:2)(cid:9)(cid:11)(cid:4)(cid:3)(cid:49)(cid:4)(cid:8)(cid:5)(cid:2)(cid:28)(cid:3,Unknown,13481.0
Unknown,Unknown,12,Unknown,Unknown,Unknown,Unknown,cid:10)(cid:11)(cid:10)(cid:46)(cid:14)(cid:2)(cid:9)(cid:11)(cid:4)(cid:3)(cid:49)(cid:4)(cid:8)(cid:5)(cid:2)(cid:28)(cid:3,Unknown,13493.0
Unknown,Unknown,3,Unknown,Unknown,Unknown,Unknown,cid:10)(cid:11)(cid:10)(cid:46)(cid:14)(cid:2)(cid:9)(cid:11)(cid:4)(cid:3)(cid:49)(cid:4)(cid:8)(cid:5)(cid:2)(cid:28)(cid:3,Unknown,13496.0
Unknown,Unknown,5,Unknown,Unknown,Unknown,Unknown,cid:10)(cid:11)(cid:10)(cid:46)(cid:14)(cid:2)(cid:9)(cid:11)(cid:4)(cid:3)(cid:49)(cid:4)(cid:8)(cid:5)(cid:2)(cid:28)(cid:3,Unknown,13501.0
Unknown,Unknown,3,Unknown,Unknown,Unknown,Unknown,cid:10)(cid:11)(cid:10)(cid:46)(cid:14)(cid:2)(cid:9)(cid:11)(cid:4)(cid:3)(cid:49)(cid:4)(cid:8)(cid:5)(cid:2)(cid:28)(cid:3,Unknown,13504.0
Unknown,Unknown,7,Unknown,Unknown,Unknown,Unknown,cid:10)(cid:11)(cid:10)(cid:46)(cid:14)(cid:2)(cid:9)(cid:11)(cid:4)(cid:3)(cid:49)(cid:4)(cid:8)(cid:5)(cid:2)(cid:28)(cid:3,Unknown,13511.0
Unknown,Unknown,5,Unknown,Unknown,Unknown,Unknown,cid:10)(cid:11)(cid:10)(cid:46)(cid:14)(cid:2)(cid:9)(cid:11)(cid:4)(cid:3)(cid:49)(cid:4)(cid:8)(cid:5)(cid:2)(cid:28)(cid:3,Unknown,13516.0
Unknown,Unknown,2,Unknown,Unknown,Unknown,Unknown,cid:10)(cid:11)(cid:10)(cid:46)(cid:14)(cid:2)(cid:9)(cid:11)(cid:4)(cid:3)(cid:49)(cid:4)(cid:8)(cid:5)(cid:2)(cid:28)(cid:3,Unknown,13518.0
Unknown,Unknown,12,Unknown,Unknown,Unknown,Unknown,cid:10)(cid:11)(cid:10)(cid:46)(cid:14)(cid:2)(cid:9)(cid:11)(cid:4)(cid:3)(cid:49)(cid:4)(cid:8)(cid:5)(cid:2)(cid:28)(cid:3,Unknown,13530.0
Unknown,Unknown,11,Unknown,Unknown,Unknown,Unknown,cid:10)(cid:11)(cid:10)(cid:46)(cid:14)(cid:2)(cid:9)(cid:11)(cid:4)(cid:3)(cid:49)(cid:4)(cid:8)(cid:5)(cid:2)(cid:28)(cid:3,Unknown,13541.0
Unknown,Unknown,4,Unknown,Unknown,Unknown,Unknown,cid:10)(cid:11)(cid:10)(cid:46)(cid:14)(cid:2)(cid:9)(cid:11)(cid:4)(cid:3)(cid:49)(cid:4)(cid:8)(cid:5)(cid:2)(cid:28)(cid:3,Unknown,13545.0
Unknown,Unknown,14,Unknown,Unknown,Unknown,Unknown,cid:10)(cid:11)(cid:10)(cid:46)(cid:14)(cid:2)(cid:9)(cid:11)(cid:4)(cid:3)(cid:49)(cid:4)(cid:8)(cid:5)(cid:2)(cid:28)(cid:3,Unknown,13559.0
Unknown,Unknown,11,Unknown,Unknown,Unknown,Unknown,cid:10)(cid:11)(cid:10)(cid:46)(cid:14)(cid:2)(cid:9)(cid:11)(cid:4)(cid:3)(cid:49)(cid:4)(cid:8)(cid:5)(cid:2)(cid:28)(cid:3,Unknown,13570.0
Unknown,Unknown,54,Unknown,Unknown,Unknown,Unknown,cid:10)(cid:11)(cid:10)(cid:46)(cid:14)(cid:2)(cid:9)(cid:11)(cid:4)(cid:3)(cid:49)(cid:4)(cid:8)(cid:5)(cid:2)(cid:28)(cid:3,Unknown,13624.0
Unknown,Unknown,54,Unknown,Unknown,Unknown,Unknown,cid:10)(cid:11)(cid:10)(cid:46)(cid:14)(cid:2)(cid:9)(cid:11)(cid:4)(cid:3)(cid:49)(cid:4)(cid:8)(cid:5)(cid:2)(cid:28)(cid:3,Unknown,13678.0
Unknown,Unknown,7,Unknown,Unknown,Unknown,Unknown,cid:10)(cid:11)(cid:10)(cid:46)(cid:14)(cid:2)(cid:9)(cid:11)(cid:4)(cid:3)(cid:49)(cid:4)(cid:8)(cid:5)(cid:2)(cid:28)(cid:3,Unknown,13685.0
Unknown,Unknown,5,Unknown,Unknown,Unknown,Unknown,cid:10)(cid:11)(cid:10)(cid:46)(cid:14)(cid:2)(cid:9)(cid:11)(cid:4)(cid:3)(cid:49)(cid:4)(cid:8)(cid:5)(cid:2)(cid:28)(cid:3,Unknown,13690.0
Unknown,Unknown,3,Unknown,Unknown,Unknown,Unknown,cid:10)(cid:11)(cid:10)(cid:46)(cid:14)(cid:2)(cid:9)(cid:11)(cid:4)(cid:3)(cid:49)(cid:4)(cid:8)(cid:5)(cid:2)(cid:28)(cid:3,Unknown,13693.0
Unknown,Unknown,9,Unknown,Unknown,Unknown,Unknown,cid:10)(cid:11)(cid:10)(cid:46)(cid:14)(cid:2)(cid:9)(cid:11)(cid:4)(cid:3)(cid:49)(cid:4)(cid:8)(cid:5)(cid:2)(cid:28)(cid:3,Unknown,13702.0
Unknown,Unknown,2,Unknown,Unknown,Unknown,Unknown,cid:10)(cid:11)(cid:10)(cid:46)(cid:14)(cid:2)(cid:9)(cid:11)(cid:4)(cid:3)(cid:49)(cid:4)(cid:8)(cid:5)(cid:2)(cid:28)(cid:3,Unknown,13704.0
Unknown,Unknown,28,Unknown,Unknown,Unknown,Unknown,cid:10)(cid:11)(cid:10)(cid:46)(cid:14)(cid:2)(cid:9)(cid:11)(cid:4)(cid:3)(cid:49)(cid:4)(cid:8)(cid:5)(cid:2)(cid:28)(cid:3,Unknown,13732.0
Unknown,Unknown,3,Unknown,Unknown,Unknown,Unknown,cid:10)(cid:11)(cid:10)(cid:46)(cid:14)(cid:2)(cid:9)(cid:11)(cid:4)(cid:3)(cid:49)(cid:4)(cid:8)(cid:5)(cid:2)(cid:28)(cid:3,Unknown,13735.0
Unknown,Unknown,15,Unknown,Unknown,Unknown,Unknown,cid:10)(cid:11)(cid:10)(cid:46)(cid:14)(cid:2)(cid:9)(cid:11)(cid:4)(cid:3)(cid:49)(cid:4)(cid:8)(cid:5)(cid:2)(cid:28)(cid:3,Unknown,13750.0
Unknown,Unknown,2,Unknown,Unknown,Unknown,Unknown,cid:10)(cid:11)(cid:10)(cid:46)(cid:14)(cid:2)(cid:9)(cid:11)(cid:4)(cid:3)(cid:49)(cid:4)(cid:8)(cid:5)(cid:2)(cid:28)(cid:3,Unknown,13752.0
Unknown,Unknown,1,Unknown,Unknown,Unknown,Unknown,cid:10)(cid:11)(cid:10)(cid:46)(cid:14)(cid:2)(cid:9)(cid:11)(cid:4)(cid:3)(cid:49)(cid:4)(cid:8)(cid:5)(cid:2)(cid:28)(cid:3,Unknown,13753.0
Unknown,Unknown,1,Unknown,Unknown,Unknown,Unknown,cid:10)(cid:11)(cid:10)(cid:46)(cid:14)(cid:2)(cid:9)(cid:11)(cid:4)(cid:3)(cid:49)(cid:4)(cid:8)(cid:5)(cid:2)(cid:28)(cid:3,Unknown,13754.0
Unknown,Unknown,19,Unknown,Unknown,Unknown,Unknown,cid:10)(cid:11)(cid:10)(cid:46)(cid:14)(cid:2)(cid:9)(cid:11)(cid:4)(cid:3)(cid:49)(cid:4)(cid:8)(cid:5)(cid:2)(cid:28)(cid:3,Unknown,13773.0
Unknown,Unknown,34,Unknown,Unknown,Unknown,Unknown,cid:10)(cid:11)(cid:10)(cid:46)(cid:14)(cid:2)(cid:9)(cid:11)(cid:4)(cid:3)(cid:49)(cid:4)(cid:8)(cid:5)(cid:2)(cid:28)(cid:3,Unknown,13807.0
Unknown,Unknown,18,Unknown,Unknown,Unknown,Unknown,cid:10)(cid:11)(cid:10)(cid:46)(cid:14)(cid:2)(cid:9)(cid:11)(cid:4)(cid:3)(cid:49)(cid:4)(cid:8)(cid:5)(cid:2)(cid:28)(cid:3,Unknown,13825.0
Unknown,Unknown,2,Unknown,Unknown,Unknown,Unknown,cid:10)(cid:11)(cid:10)(cid:46)(cid:14)(cid:2)(cid:9)(cid:11)(cid:4)(cid:3)(cid:49)(cid:4)(cid:8)(cid:5)(cid:2)(cid:28)(cid:3,Unknown,13827.0
Unknown,Unknown,44,Unknown,Unknown,Unknown,Unknown,cid:10)(cid:11)(cid:10)(cid:46)(cid:14)(cid:2)(cid:9)(cid:11)(cid:4)(cid:3)(cid:49)(cid:4)(cid:8)(cid:5)(cid:2)(cid:28)(cid:3,Unknown,13871.0
Unknown,Unknown,12,Unknown,Unknown,Unknown,Unknown,cid:10)(cid:11)(cid:10)(cid:46)(cid:14)(cid:2)(cid:9)(cid:11)(cid:4)(cid:3)(cid:49)(cid:4)(cid:8)(cid:5)(cid:2)(cid:28)(cid:3,Unknown,13883.0
Unknown,Unknown,29,Unknown,Unknown,Unknown,Unknown,cid:10)(cid:11)(cid:10)(cid:46)(cid:14)(cid:2)(cid:9)(cid:11)(cid:4)(cid:3)(cid:49)(cid:4)(cid:8)(cid:5)(cid:2)(cid:28)(cid:3,Unknown,13912.0
Unknown,Unknown,26,Unknown,Unknown,Unknown,Unknown,cid:10)(cid:11)(cid:10)(cid:46)(cid:14)(cid:2)(cid:9)(cid:11)(cid:4)(cid:3)(cid:49)(cid:4)(cid:8)(cid:5)(cid:2)(cid:28)(cid:3,Unknown,13938.0
Unknown,Unknown,41,Unknown,Unknown,Unknown,Unknown,cid:10)(cid:11)(cid:10)(cid:46)(cid:14)(cid:2)(cid:9)(cid:11)(cid:4)(cid:3)(cid:49)(cid:4)(cid:8)(cid:5)(cid:2)(cid:28)(cid:3,Unknown,13979.0
Unknown,Unknown,25,Unknown,Unknown,Unknown,Unknown,cid:10)(cid:11)(cid:10)(cid:46)(cid:14)(cid:2)(cid:9)(cid:11)(cid:4)(cid:3)(cid:49)(cid:4)(cid:8)(cid:5)(cid:2)(cid:28)(cid:3,Unknown,14004.0
Unknown,Unknown,2,Unknown,Unknown,Unknown,Unknown,cid:10)(cid:11)(cid:10)(cid:46)(cid:14)(cid:2)(cid:9)(cid:11)(cid:4)(cid:3)(cid:49)(cid:4)(cid:8)(cid:5)(cid:2)(cid:28)(cid:3,Unknown,14006.0
Unknown,Unknown,50,Unknown,Unknown,Unknown,Unknown,cid:10)(cid:11)(cid:10)(cid:46)(cid:14)(cid:2)(cid:9)(cid:11)(cid:4)(cid:3)(cid:49)(cid:4)(cid:8)(cid:5)(cid:2)(cid:28)(cid:3,Unknown,14056.0
Unknown,Unknown,50,Unknown,Unknown,Unknown,Unknown,cid:10)(cid:11)(cid:10)(cid:46)(cid:14)(cid:2)(cid:9)(cid:11)(cid:4)(cid:3)(cid:49)(cid:4)(cid:8)(cid:5)(cid:2)(cid:28)(cid:3,Unknown,14106.0
Unknown,Unknown,18,Unknown,Unknown,Unknown,Unknown,cid:10)(cid:11)(cid:10)(cid:46)(cid:14)(cid:2)(cid:9)(cid:11)(cid:4)(cid:3)(cid:49)(cid:4)(cid:8)(cid:5)(cid:2)(cid:28)(cid:3,Unknown,14124.0
Unknown,Unknown,1,Unknown,Unknown,Unknown,Unknown,cid:10)(cid:11)(cid:10)(cid:46)(cid:14)(cid:2)(cid:9)(cid:11)(cid:4)(cid:3)(cid:49)(cid:4)(cid:8)(cid:5)(cid:2)(cid:28)(cid:3,Unknown,14125.0
Unknown,Unknown,1,Unknown,Unknown,Unknown,Unknown,cid:10)(cid:11)(cid:10)(cid:46)(cid:14)(cid:2)(cid:9)(cid:11)(cid:4)(cid:3)(cid:49)(cid:4)(cid:8)(cid:5)(cid:2)(cid:28)(cid:3,Unknown,14126.0
Unknown,Unknown,37,Unknown,Unknown,Unknown,Unknown,cid:10)(cid:11)(cid:10)(cid:46)(cid:14)(cid:2)(cid:9)(cid:11)(cid:4)(cid:3)(cid:49)(cid:4)(cid:8)(cid:5)(cid:2)(cid:28)(cid:3,Unknown,14163.0
Unknown,Unknown,18,Unknown,Unknown,Unknown,Unknown,cid:10)(cid:11)(cid:10)(cid:46)(cid:14)(cid:2)(cid:9)(cid:11)(cid:4)(cid:3)(cid:49)(cid:4)(cid:8)(cid:5)(cid:2)(cid:28)(cid:3,Unknown,14181.0
Unknown,Unknown,33,Unknown,Unknown,Unknown,Unknown,cid:10)(cid:11)(cid:10)(cid:46)(cid:14)(cid:2)(cid:9)(cid:11)(cid:4)(cid:3)(cid:49)(cid:4)(cid:8)(cid:5)(cid:2)(cid:28)(cid:3,Unknown,14214.0
Unknown,Unknown,45,Unknown,Unknown,Unknown,Unknown,cid:10)(cid:11)(cid:10)(cid:46)(cid:14)(cid:2)(cid:9)(cid:11)(cid:4)(cid:3)(cid:49)(cid:4)(cid:8)(cid:5)(cid:2)(cid:28)(cid:3,Unknown,14259.0
Unknown,Unknown,18,Unknown,Unknown,Unknown,Unknown,cid:10)(cid:11)(cid:10)(cid:46)(cid:14)(cid:2)(cid:9)(cid:11)(cid:4)(cid:3)(cid:49)(cid:4)(cid:8)(cid:5)(cid:2)(cid:28)(cid:3,Unknown,14277.0
Unknown,Unknown,35,Unknown,Unknown,Unknown,Unknown,cid:10)(cid:11)(cid:10)(cid:46)(cid:14)(cid:2)(cid:9)(cid:11)(cid:4)(cid:3)(cid:49)(cid:4)(cid:8)(cid:5)(cid:2)(cid:28)(cid:3,Unknown,14312.0
Unknown,Unknown,12,Unknown,Unknown,Unknown,Unknown,cid:10)(cid:11)(cid:10)(cid:46)(cid:14)(cid:2)(cid:9)(cid:11)(cid:4)(cid:3)(cid:49)(cid:4)(cid:8)(cid:5)(cid:2)(cid:28)(cid:3,Unknown,14324.0
Unknown,Unknown,46,Unknown,Unknown,Unknown,Unknown,cid:10)(cid:11)(cid:10)(cid:46)(cid:14)(cid:2)(cid:9)(cid:11)(cid:4)(cid:3)(cid:49)(cid:4)(cid:8)(cid:5)(cid:2)(cid:28)(cid:3,Unknown,14370.0
Unknown,Unknown,38,Unknown,Unknown,Unknown,Unknown,cid:10)(cid:11)(cid:10)(cid:46)(cid:14)(cid:2)(cid:9)(cid:11)(cid:4)(cid:3)(cid:49)(cid:4)(cid:8)(cid:5)(cid:2)(cid:28)(cid:3,Unknown,14408.0
Unknown,Unknown,4,Unknown,Unknown,Unknown,Unknown,cid:10)(cid:11)(cid:10)(cid:46)(cid:14)(cid:2)(cid:9)(cid:11)(cid:4)(cid:3)(cid:49)(cid:4)(cid:8)(cid:5)(cid:2)(cid:28)(cid:3,Unknown,14412.0
Unknown,Unknown,46,Unknown,Unknown,Unknown,Unknown,cid:10)(cid:11)(cid:10)(cid:46)(cid:14)(cid:2)(cid:9)(cid:11)(cid:4)(cid:3)(cid:49)(cid:4)(cid:8)(cid:5)(cid:2)(cid:28)(cid:3,Unknown,14458.0
Unknown,Unknown,8,Unknown,Unknown,Unknown,Unknown,cid:10)(cid:11)(cid:10)(cid:46)(cid:14)(cid:2)(cid:9)(cid:11)(cid:4)(cid:3)(cid:49)(cid:4)(cid:8)(cid:5)(cid:2)(cid:28)(cid:3,Unknown,14466.0
Unknown,Unknown,10,Unknown,Unknown,Unknown,Unknown,cid:10)(cid:11)(cid:10)(cid:46)(cid:14)(cid:2)(cid:9)(cid:11)(cid:4)(cid:3)(cid:49)(cid:4)(cid:8)(cid:5)(cid:2)(cid:28)(cid:3,Unknown,14476.0
Unknown,Unknown,2,Unknown,Unknown,Unknown,Unknown,cid:10)(cid:11)(cid:10)(cid:46)(cid:14)(cid:2)(cid:9)(cid:11)(cid:4)(cid:3)(cid:49)(cid:4)(cid:8)(cid:5)(cid:2)(cid:28)(cid:3,Unknown,14478.0
Unknown,Unknown,13,Unknown,Unknown,Unknown,Unknown,cid:10)(cid:11)(cid:10)(cid:46)(cid:14)(cid:2)(cid:9)(cid:11)(cid:4)(cid:3)(cid:49)(cid:4)(cid:8)(cid:5)(cid:2)(cid:28)(cid:3,Unknown,14491.0
Unknown,Unknown,5,Unknown,Unknown,Unknown,Unknown,cid:10)(cid:11)(cid:10)(cid:46)(cid:14)(cid:2)(cid:9)(cid:11)(cid:4)(cid:3)(cid:49)(cid:4)(cid:8)(cid:5)(cid:2)(cid:28)(cid:3,Unknown,14496.0
Unknown,Unknown,3,Unknown,Unknown,Unknown,Unknown,cid:10)(cid:11)(cid:10)(cid:46)(cid:14)(cid:2)(cid:9)(cid:11)(cid:4)(cid:3)(cid:49)(cid:4)(cid:8)(cid:5)(cid:2)(cid:28)(cid:3,Unknown,14499.0
Unknown,Unknown,52,Unknown,Unknown,Unknown,Unknown,cid:10)(cid:11)(cid:10)(cid:46)(cid:14)(cid:2)(cid:9)(cid:11)(cid:4)(cid:3)(cid:49)(cid:4)(cid:8)(cid:5)(cid:2)(cid:28)(cid:3,Unknown,14551.0
Unknown,Unknown,5,Unknown,Unknown,Unknown,Unknown,cid:10)(cid:11)(cid:10)(cid:46)(cid:14)(cid:2)(cid:9)(cid:11)(cid:4)(cid:3)(cid:49)(cid:4)(cid:8)(cid:5)(cid:2)(cid:28)(cid:3,Unknown,14556.0
Unknown,Unknown,43,Unknown,Unknown,Unknown,Unknown,cid:10)(cid:11)(cid:10)(cid:46)(cid:14)(cid:2)(cid:9)(cid:11)(cid:4)(cid:3)(cid:49)(cid:4)(cid:8)(cid:5)(cid:2)(cid:28)(cid:3,Unknown,14599.0
Unknown,Unknown,2,Unknown,Unknown,Unknown,Unknown,cid:10)(cid:11)(cid:10)(cid:46)(cid:14)(cid:2)(cid:9)(cid:11)(cid:4)(cid:3)(cid:49)(cid:4)(cid:8)(cid:5)(cid:2)(cid:28)(cid:3,Unknown,14601.0
Unknown,Unknown,37,Unknown,Unknown,Unknown,Unknown,cid:10)(cid:11)(cid:10)(cid:46)(cid:14)(cid:2)(cid:9)(cid:11)(cid:4)(cid:3)(cid:49)(cid:4)(cid:8)(cid:5)(cid:2)(cid:28)(cid:3,Unknown,14638.0
Unknown,Unknown,37,Unknown,Unknown,Unknown,Unknown,cid:10)(cid:11)(cid:10)(cid:46)(cid:14)(cid:2)(cid:9)(cid:11)(cid:4)(cid:3)(cid:49)(cid:4)(cid:8)(cid:5)(cid:2)(cid:28)(cid:3,Unknown,14675.0
Unknown,Unknown,32,Unknown,Unknown,Unknown,Unknown,cid:10)(cid:11)(cid:10)(cid:46)(cid:14)(cid:2)(cid:9)(cid:11)(cid:4)(cid:3)(cid:49)(cid:4)(cid:8)(cid:5)(cid:2)(cid:28)(cid:3,Unknown,14707.0
Unknown,Unknown,19,Unknown,Unknown,Unknown,Unknown,cid:10)(cid:11)(cid:10)(cid:46)(cid:14)(cid:2)(cid:9)(cid:11)(cid:4)(cid:3)(cid:49)(cid:4)(cid:8)(cid:5)(cid:2)(cid:28)(cid:3,Unknown,14726.0
Unknown,Unknown,18,Unknown,Unknown,Unknown,Unknown,cid:10)(cid:11)(cid:10)(cid:46)(cid:14)(cid:2)(cid:9)(cid:11)(cid:4)(cid:3)(cid:49)(cid:4)(cid:8)(cid:5)(cid:2)(cid:28)(cid:3,Unknown,14744.0
Unknown,Unknown,18,Unknown,Unknown,Unknown,Unknown,cid:10)(cid:11)(cid:10)(cid:46)(cid:14)(cid:2)(cid:9)(cid:11)(cid:4)(cid:3)(cid:49)(cid:4)(cid:8)(cid:5)(cid:2)(cid:28)(cid:3,Unknown,14762.0
Unknown,Unknown,2,Unknown,Unknown,Unknown,Unknown,cid:10)(cid:11)(cid:10)(cid:46)(cid:14)(cid:2)(cid:9)(cid:11)(cid:4)(cid:3)(cid:49)(cid:4)(cid:8)(cid:5)(cid:2)(cid:28)(cid:3,Unknown,14764.0
Unknown,Unknown,44,Unknown,Unknown,Unknown,Unknown,cid:10)(cid:11)(cid:10)(cid:46)(cid:14)(cid:2)(cid:9)(cid:11)(cid:4)(cid:3)(cid:49)(cid:4)(cid:8)(cid:5)(cid:2)(cid:28)(cid:3,Unknown,14808.0
Unknown,Unknown,49,Unknown,Unknown,Unknown,Unknown,cid:10)(cid:11)(cid:10)(cid:46)(cid:14)(cid:2)(cid:9)(cid:11)(cid:4)(cid:3)(cid:49)(cid:4)(cid:8)(cid:5)(cid:2)(cid:28)(cid:3,Unknown,14857.0
Unknown,Unknown,42,Unknown,Unknown,Unknown,Unknown,cid:10)(cid:11)(cid:10)(cid:46)(cid:14)(cid:2)(cid:9)(cid:11)(cid:4)(cid:3)(cid:49)(cid:4)(cid:8)(cid:5)(cid:2)(cid:28)(cid:3,Unknown,14899.0
Unknown,Unknown,56,Unknown,Unknown,Unknown,Unknown,cid:10)(cid:11)(cid:10)(cid:46)(cid:14)(cid:2)(cid:9)(cid:11)(cid:4)(cid:3)(cid:49)(cid:4)(cid:8)(cid:5)(cid:2)(cid:28)(cid:3,Unknown,14955.0
Unknown,Unknown,57,Unknown,Unknown,Unknown,Unknown,cid:10)(cid:11)(cid:10)(cid:46)(cid:14)(cid:2)(cid:9)(cid:11)(cid:4)(cid:3)(cid:49)(cid:4)(cid:8)(cid:5)(cid:2)(cid:28)(cid:3,Unknown,15012.0
Unknown,Unknown,41,Unknown,Unknown,Unknown,Unknown,cid:10)(cid:11)(cid:10)(cid:46)(cid:14)(cid:2)(cid:9)(cid:11)(cid:4)(cid:3)(cid:49)(cid:4)(cid:8)(cid:5)(cid:2)(cid:28)(cid:3,Unknown,15053.0
Unknown,Unknown,2,Unknown,Unknown,Unknown,Unknown,cid:10)(cid:11)(cid:10)(cid:46)(cid:14)(cid:2)(cid:9)(cid:11)(cid:4)(cid:3)(cid:49)(cid:4)(cid:8)(cid:5)(cid:2)(cid:28)(cid:3,Unknown,15055.0
Unknown,Unknown,48,Unknown,Unknown,Unknown,Unknown,cid:10)(cid:11)(cid:10)(cid:46)(cid:14)(cid:2)(cid:9)(cid:11)(cid:4)(cid:3)(cid:49)(cid:4)(cid:8)(cid:5)(cid:2)(cid:28)(cid:3,Unknown,15103.0
Unknown,Unknown,25,Unknown,Unknown,Unknown,Unknown,cid:10)(cid:11)(cid:10)(cid:46)(cid:14)(cid:2)(cid:9)(cid:11)(cid:4)(cid:3)(cid:49)(cid:4)(cid:8)(cid:5)(cid:2)(cid:28)(cid:3,Unknown,15128.0
Unknown,Unknown,2,Unknown,Unknown,Unknown,Unknown,cid:10)(cid:11)(cid:10)(cid:46)(cid:14)(cid:2)(cid:9)(cid:11)(cid:4)(cid:3)(cid:49)(cid:4)(cid:8)(cid:5)(cid:2)(cid:28)(cid:3,Unknown,15130.0
Unknown,Unknown,31,Unknown,Unknown,Unknown,Unknown,cid:10)(cid:11)(cid:10)(cid:46)(cid:14)(cid:2)(cid:9)(cid:11)(cid:4)(cid:3)(cid:49)(cid:4)(cid:8)(cid:5)(cid:2)(cid:28)(cid:3,Unknown,15161.0
Unknown,Unknown,58,Unknown,Unknown,Unknown,Unknown,cid:10)(cid:11)(cid:10)(cid:46)(cid:14)(cid:2)(cid:9)(cid:11)(cid:4)(cid:3)(cid:49)(cid:4)(cid:8)(cid:5)(cid:2)(cid:28)(cid:3,Unknown,15219.0
Unknown,Unknown,59,Unknown,Unknown,Unknown,Unknown,cid:10)(cid:11)(cid:10)(cid:46)(cid:14)(cid:2)(cid:9)(cid:11)(cid:4)(cid:3)(cid:49)(cid:4)(cid:8)(cid:5)(cid:2)(cid:28)(cid:3,Unknown,15278.0
Unknown,Unknown,60,Unknown,Unknown,Unknown,Unknown,cid:10)(cid:11)(cid:10)(cid:46)(cid:14)(cid:2)(cid:9)(cid:11)(cid:4)(cid:3)(cid:49)(cid:4)(cid:8)(cid:5)(cid:2)(cid:28)(cid:3,Unknown,15338.0
Unknown,Unknown,21,Unknown,Unknown,Unknown,Unknown,cid:10)(cid:11)(cid:10)(cid:46)(cid:14)(cid:2)(cid:9)(cid:11)(cid:4)(cid:3)(cid:49)(cid:4)(cid:8)(cid:5)(cid:2)(cid:28)(cid:3,Unknown,15359.0
Unknown,Unknown,25,Unknown,Unknown,Unknown,Unknown,cid:10)(cid:11)(cid:10)(cid:46)(cid:14)(cid:2)(cid:9)(cid:11)(cid:4)(cid:3)(cid:49)(cid:4)(cid:8)(cid:5)(cid:2)(cid:28)(cid:3,Unknown,15384.0
Unknown,Unknown,18,Unknown,Unknown,Unknown,Unknown,cid:10)(cid:11)(cid:10)(cid:46)(cid:14)(cid:2)(cid:9)(cid:11)(cid:4)(cid:3)(cid:49)(cid:4)(cid:8)(cid:5)(cid:2)(cid:28)(cid:3,Unknown,15402.0
Unknown,Unknown,33,Unknown,Unknown,Unknown,Unknown,cid:10)(cid:11)(cid:10)(cid:46)(cid:14)(cid:2)(cid:9)(cid:11)(cid:4)(cid:3)(cid:49)(cid:4)(cid:8)(cid:5)(cid:2)(cid:28)(cid:3,Unknown,15435.0
Unknown,Unknown,45,Unknown,Unknown,Unknown,Unknown,cid:10)(cid:11)(cid:10)(cid:46)(cid:14)(cid:2)(cid:9)(cid:11)(cid:4)(cid:3)(cid:49)(cid:4)(cid:8)(cid:5)(cid:2)(cid:28)(cid:3,Unknown,15480.0
Unknown,Unknown,18,Unknown,Unknown,Unknown,Unknown,cid:10)(cid:11)(cid:10)(cid:46)(cid:14)(cid:2)(cid:9)(cid:11)(cid:4)(cid:3)(cid:49)(cid:4)(cid:8)(cid:5)(cid:2)(cid:28)(cid:3,Unknown,15498.0
Unknown,Unknown,35,Unknown,Unknown,Unknown,Unknown,cid:10)(cid:11)(cid:10)(cid:46)(cid:14)(cid:2)(cid:9)(cid:11)(cid:4)(cid:3)(cid:49)(cid:4)(cid:8)(cid:5)(cid:2)(cid:28)(cid:3,Unknown,15533.0
Unknown,Unknown,54,Unknown,Unknown,Unknown,Unknown,cid:10)(cid:11)(cid:10)(cid:46)(cid:14)(cid:2)(cid:9)(cid:11)(cid:4)(cid:3)(cid:49)(cid:4)(cid:8)(cid:5)(cid:2)(cid:28)(cid:3,Unknown,15587.0
Unknown,Unknown,7,Unknown,Unknown,Unknown,Unknown,cid:10)(cid:11)(cid:10)(cid:46)(cid:14)(cid:2)(cid:9)(cid:11)(cid:4)(cid:3)(cid:49)(cid:4)(cid:8)(cid:5)(cid:2)(cid:28)(cid:3,Unknown,15594.0
Unknown,Unknown,12,Unknown,Unknown,Unknown,Unknown,cid:10)(cid:11)(cid:10)(cid:46)(cid:14)(cid:2)(cid:9)(cid:11)(cid:4)(cid:3)(cid:49)(cid:4)(cid:8)(cid:5)(cid:2)(cid:28)(cid:3,Unknown,15606.0
Unknown,Unknown,13,Unknown,Unknown,Unknown,Unknown,cid:10)(cid:11)(cid:10)(cid:46)(cid:14)(cid:2)(cid:9)(cid:11)(cid:4)(cid:3)(cid:49)(cid:4)(cid:8)(cid:5)(cid:2)(cid:28)(cid:3,Unknown,15619.0
Unknown,Unknown,5,Unknown,Unknown,Unknown,Unknown,cid:10)(cid:11)(cid:10)(cid:46)(cid:14)(cid:2)(cid:9)(cid:11)(cid:4)(cid:3)(cid:49)(cid:4)(cid:8)(cid:5)(cid:2)(cid:28)(cid:3,Unknown,15624.0
Unknown,Unknown,14,Unknown,Unknown,Unknown,Unknown,cid:10)(cid:11)(cid:10)(cid:46)(cid:14)(cid:2)(cid:9)(cid:11)(cid:4)(cid:3)(cid:49)(cid:4)(cid:8)(cid:5)(cid:2)(cid:28)(cid:3,Unknown,15638.0
Unknown,Unknown,2,Unknown,Unknown,Unknown,Unknown,cid:10)(cid:11)(cid:10)(cid:46)(cid:14)(cid:2)(cid:9)(cid:11)(cid:4)(cid:3)(cid:49)(cid:4)(cid:8)(cid:5)(cid:2)(cid:28)(cid:3,Unknown,15640.0
Unknown,Unknown,53,Unknown,Unknown,Unknown,Unknown,cid:10)(cid:11)(cid:10)(cid:46)(cid:14)(cid:2)(cid:9)(cid:11)(cid:4)(cid:3)(cid:49)(cid:4)(cid:8)(cid:5)(cid:2)(cid:28)(cid:3,Unknown,15693.0
Unknown,Unknown,5,Unknown,Unknown,Unknown,Unknown,cid:10)(cid:11)(cid:10)(cid:46)(cid:14)(cid:2)(cid:9)(cid:11)(cid:4)(cid:3)(cid:49)(cid:4)(cid:8)(cid:5)(cid:2)(cid:28)(cid:3,Unknown,15698.0
Unknown,Unknown,11,Unknown,Unknown,Unknown,Unknown,cid:10)(cid:11)(cid:10)(cid:46)(cid:14)(cid:2)(cid:9)(cid:11)(cid:4)(cid:3)(cid:49)(cid:4)(cid:8)(cid:5)(cid:2)(cid:28)(cid:3,Unknown,15709.0
Unknown,Unknown,3,Unknown,Unknown,Unknown,Unknown,cid:10)(cid:11)(cid:10)(cid:46)(cid:14)(cid:2)(cid:9)(cid:11)(cid:4)(cid:3)(cid:49)(cid:4)(cid:8)(cid:5)(cid:2)(cid:28)(cid:3,Unknown,15712.0
Unknown,Unknown,53,Unknown,Unknown,Unknown,Unknown,cid:10)(cid:11)(cid:10)(cid:46)(cid:14)(cid:2)(cid:9)(cid:11)(cid:4)(cid:3)(cid:49)(cid:4)(cid:8)(cid:5)(cid:2)(cid:28)(cid:3,Unknown,15765.0
Unknown,Unknown,5,Unknown,Unknown,Unknown,Unknown,cid:10)(cid:11)(cid:10)(cid:46)(cid:14)(cid:2)(cid:9)(cid:11)(cid:4)(cid:3)(cid:49)(cid:4)(cid:8)(cid:5)(cid:2)(cid:28)(cid:3,Unknown,15770.0
Unknown,Unknown,9,Unknown,Unknown,Unknown,Unknown,cid:10)(cid:11)(cid:10)(cid:46)(cid:14)(cid:2)(cid:9)(cid:11)(cid:4)(cid:3)(cid:49)(cid:4)(cid:8)(cid:5)(cid:2)(cid:28)(cid:3,Unknown,15779.0
Unknown,Unknown,43,Unknown,Unknown,Unknown,Unknown,cid:10)(cid:11)(cid:10)(cid:46)(cid:14)(cid:2)(cid:9)(cid:11)(cid:4)(cid:3)(cid:49)(cid:4)(cid:8)(cid:5)(cid:2)(cid:28)(cid:3,Unknown,15822.0
Unknown,Unknown,2,Unknown,Unknown,Unknown,Unknown,cid:10)(cid:11)(cid:10)(cid:46)(cid:14)(cid:2)(cid:9)(cid:11)(cid:4)(cid:3)(cid:49)(cid:4)(cid:8)(cid:5)(cid:2)(cid:28)(cid:3,Unknown,15824.0
Unknown,Unknown,1,Unknown,Unknown,Unknown,Unknown,cid:10)(cid:11)(cid:10)(cid:46)(cid:14)(cid:2)(cid:9)(cid:11)(cid:4)(cid:3)(cid:49)(cid:4)(cid:8)(cid:5)(cid:2)(cid:28)(cid:3,Unknown,15825.0
Unknown,Unknown,36,Unknown,Unknown,Unknown,Unknown,cid:10)(cid:11)(cid:10)(cid:46)(cid:14)(cid:2)(cid:9)(cid:11)(cid:4)(cid:3)(cid:49)(cid:4)(cid:8)(cid:5)(cid:2)(cid:28)(cid:3,Unknown,15861.0
Unknown,Unknown,18,Unknown,Unknown,Unknown,Unknown,cid:10)(cid:11)(cid:10)(cid:46)(cid:14)(cid:2)(cid:9)(cid:11)(cid:4)(cid:3)(cid:49)(cid:4)(cid:8)(cid:5)(cid:2)(cid:28)(cid:3,Unknown,15879.0
Unknown,Unknown,19,Unknown,Unknown,Unknown,Unknown,cid:10)(cid:11)(cid:10)(cid:46)(cid:14)(cid:2)(cid:9)(cid:11)(cid:4)(cid:3)(cid:49)(cid:4)(cid:8)(cid:5)(cid:2)(cid:28)(cid:3,Unknown,15898.0
Unknown,Unknown,18,Unknown,Unknown,Unknown,Unknown,cid:10)(cid:11)(cid:10)(cid:46)(cid:14)(cid:2)(cid:9)(cid:11)(cid:4)(cid:3)(cid:49)(cid:4)(cid:8)(cid:5)(cid:2)(cid:28)(cid:3,Unknown,15916.0
Unknown,Unknown,18,Unknown,Unknown,Unknown,Unknown,cid:10)(cid:11)(cid:10)(cid:46)(cid:14)(cid:2)(cid:9)(cid:11)(cid:4)(cid:3)(cid:49)(cid:4)(cid:8)(cid:5)(cid:2)(cid:28)(cid:3,Unknown,15934.0
Unknown,Unknown,2,Unknown,Unknown,Unknown,Unknown,cid:10)(cid:11)(cid:10)(cid:46)(cid:14)(cid:2)(cid:9)(cid:11)(cid:4)(cid:3)(cid:49)(cid:4)(cid:8)(cid:5)(cid:2)(cid:28)(cid:3,Unknown,15936.0
Unknown,Unknown,44,Unknown,Unknown,Unknown,Unknown,cid:10)(cid:11)(cid:10)(cid:46)(cid:14)(cid:2)(cid:9)(cid:11)(cid:4)(cid:3)(cid:49)(cid:4)(cid:8)(cid:5)(cid:2)(cid:28)(cid:3,Unknown,15980.0
Unknown,Unknown,49,Unknown,Unknown,Unknown,Unknown,cid:10)(cid:11)(cid:10)(cid:46)(cid:14)(cid:2)(cid:9)(cid:11)(cid:4)(cid:3)(cid:49)(cid:4)(cid:8)(cid:5)(cid:2)(cid:28)(cid:3,Unknown,16029.0
Unknown,Unknown,42,Unknown,Unknown,Unknown,Unknown,cid:10)(cid:11)(cid:10)(cid:46)(cid:14)(cid:2)(cid:9)(cid:11)(cid:4)(cid:3)(cid:49)(cid:4)(cid:8)(cid:5)(cid:2)(cid:28)(cid:3,Unknown,16071.0
Unknown,Unknown,56,Unknown,Unknown,Unknown,Unknown,cid:10)(cid:11)(cid:10)(cid:46)(cid:14)(cid:2)(cid:9)(cid:11)(cid:4)(cid:3)(cid:49)(cid:4)(cid:8)(cid:5)(cid:2)(cid:28)(cid:3,Unknown,16127.0
Unknown,Unknown,57,Unknown,Unknown,Unknown,Unknown,cid:10)(cid:11)(cid:10)(cid:46)(cid:14)(cid:2)(cid:9)(cid:11)(cid:4)(cid:3)(cid:49)(cid:4)(cid:8)(cid:5)(cid:2)(cid:28)(cid:3,Unknown,16184.0
Unknown,Unknown,41,Unknown,Unknown,Unknown,Unknown,cid:10)(cid:11)(cid:10)(cid:46)(cid:14)(cid:2)(cid:9)(cid:11)(cid:4)(cid:3)(cid:49)(cid:4)(cid:8)(cid:5)(cid:2)(cid:28)(cid:3,Unknown,16225.0
Unknown,Unknown,2,Unknown,Unknown,Unknown,Unknown,cid:10)(cid:11)(cid:10)(cid:46)(cid:14)(cid:2)(cid:9)(cid:11)(cid:4)(cid:3)(cid:49)(cid:4)(cid:8)(cid:5)(cid:2)(cid:28)(cid:3,Unknown,16227.0
Unknown,Unknown,48,Unknown,Unknown,Unknown,Unknown,cid:10)(cid:11)(cid:10)(cid:46)(cid:14)(cid:2)(cid:9)(cid:11)(cid:4)(cid:3)(cid:49)(cid:4)(cid:8)(cid:5)(cid:2)(cid:28)(cid:3,Unknown,16275.0
Unknown,Unknown,25,Unknown,Unknown,Unknown,Unknown,cid:10)(cid:11)(cid:10)(cid:46)(cid:14)(cid:2)(cid:9)(cid:11)(cid:4)(cid:3)(cid:49)(cid:4)(cid:8)(cid:5)(cid:2)(cid:28)(cid:3,Unknown,16300.0
Unknown,Unknown,2,Unknown,Unknown,Unknown,Unknown,cid:10)(cid:11)(cid:10)(cid:46)(cid:14)(cid:2)(cid:9)(cid:11)(cid:4)(cid:3)(cid:49)(cid:4)(cid:8)(cid:5)(cid:2)(cid:28)(cid:3,Unknown,16302.0
Unknown,Unknown,31,Unknown,Unknown,Unknown,Unknown,cid:10)(cid:11)(cid:10)(cid:46)(cid:14)(cid:2)(cid:9)(cid:11)(cid:4)(cid:3)(cid:49)(cid:4)(cid:8)(cid:5)(cid:2)(cid:28)(cid:3,Unknown,16333.0
Unknown,Unknown,58,Unknown,Unknown,Unknown,Unknown,cid:10)(cid:11)(cid:10)(cid:46)(cid:14)(cid:2)(cid:9)(cid:11)(cid:4)(cid:3)(cid:49)(cid:4)(cid:8)(cid:5)(cid:2)(cid:28)(cid:3,Unknown,16391.0
Unknown,Unknown,59,Unknown,Unknown,Unknown,Unknown,cid:10)(cid:11)(cid:10)(cid:46)(cid:14)(cid:2)(cid:9)(cid:11)(cid:4)(cid:3)(cid:49)(cid:4)(cid:8)(cid:5)(cid:2)(cid:28)(cid:3,Unknown,16450.0
Unknown,Unknown,60,Unknown,Unknown,Unknown,Unknown,cid:10)(cid:11)(cid:10)(cid:46)(cid:14)(cid:2)(cid:9)(cid:11)(cid:4)(cid:3)(cid:49)(cid:4)(cid:8)(cid:5)(cid:2)(cid:28)(cid:3,Unknown,16510.0
Unknown,Unknown,21,Unknown,Unknown,Unknown,Unknown,cid:10)(cid:11)(cid:10)(cid:46)(cid:14)(cid:2)(cid:9)(cid:11)(cid:4)(cid:3)(cid:49)(cid:4)(cid:8)(cid:5)(cid:2)(cid:28)(cid:3,Unknown,16531.0
Unknown,Unknown,25,Unknown,Unknown,Unknown,Unknown,cid:10)(cid:11)(cid:10)(cid:46)(cid:14)(cid:2)(cid:9)(cid:11)(cid:4)(cid:3)(cid:49)(cid:4)(cid:8)(cid:5)(cid:2)(cid:28)(cid:3,Unknown,16556.0
Unknown,Unknown,18,Unknown,Unknown,Unknown,Unknown,cid:10)(cid:11)(cid:10)(cid:46)(cid:14)(cid:2)(cid:9)(cid:11)(cid:4)(cid:3)(cid:49)(cid:4)(cid:8)(cid:5)(cid:2)(cid:28)(cid:3,Unknown,16574.0
Unknown,Unknown,33,Unknown,Unknown,Unknown,Unknown,cid:10)(cid:11)(cid:10)(cid:46)(cid:14)(cid:2)(cid:9)(cid:11)(cid:4)(cid:3)(cid:49)(cid:4)(cid:8)(cid:5)(cid:2)(cid:28)(cid:3,Unknown,16607.0
Unknown,Unknown,45,Unknown,Unknown,Unknown,Unknown,cid:10)(cid:11)(cid:10)(cid:46)(cid:14)(cid:2)(cid:9)(cid:11)(cid:4)(cid:3)(cid:49)(cid:4)(cid:8)(cid:5)(cid:2)(cid:28)(cid:3,Unknown,16652.0
Unknown,Unknown,18,Unknown,Unknown,Unknown,Unknown,cid:10)(cid:11)(cid:10)(cid:46)(cid:14)(cid:2)(cid:9)(cid:11)(cid:4)(cid:3)(cid:49)(cid:4)(cid:8)(cid:5)(cid:2)(cid:28)(cid:3,Unknown,16670.0
Unknown,Unknown,35,Unknown,Unknown,Unknown,Unknown,cid:10)(cid:11)(cid:10)(cid:46)(cid:14)(cid:2)(cid:9)(cid:11)(cid:4)(cid:3)(cid:49)(cid:4)(cid:8)(cid:5)(cid:2)(cid:28)(cid:3,Unknown,16705.0
Unknown,Unknown,54,Unknown,Unknown,Unknown,Unknown,cid:10)(cid:11)(cid:10)(cid:46)(cid:14)(cid:2)(cid:9)(cid:11)(cid:4)(cid:3)(cid:49)(cid:4)(cid:8)(cid:5)(cid:2)(cid:28)(cid:3,Unknown,16759.0
Unknown,Unknown,46,Unknown,Unknown,Unknown,Unknown,cid:10)(cid:11)(cid:10)(cid:46)(cid:14)(cid:2)(cid:9)(cid:11)(cid:4)(cid:3)(cid:49)(cid:4)(cid:8)(cid:5)(cid:2)(cid:28)(cid:3,Unknown,16805.0
Unknown,Unknown,53,Unknown,Unknown,Unknown,Unknown,cid:10)(cid:11)(cid:10)(cid:46)(cid:14)(cid:2)(cid:9)(cid:11)(cid:4)(cid:3)(cid:49)(cid:4)(cid:8)(cid:5)(cid:2)(cid:28)(cid:3,Unknown,16858.0
Unknown,Unknown,8,Unknown,Unknown,Unknown,Unknown,cid:10)(cid:11)(cid:10)(cid:46)(cid:14)(cid:2)(cid:9)(cid:11)(cid:4)(cid:3)(cid:49)(cid:4)(cid:8)(cid:5)(cid:2)(cid:28)(cid:3,Unknown,16866.0
Unknown,Unknown,46,Unknown,Unknown,Unknown,Unknown,cid:10)(cid:11)(cid:10)(cid:46)(cid:14)(cid:2)(cid:9)(cid:11)(cid:4)(cid:3)(cid:49)(cid:4)(cid:8)(cid:5)(cid:2)(cid:28)(cid:3,Unknown,16912.0
Unknown,Unknown,8,Unknown,Unknown,Unknown,Unknown,cid:10)(cid:11)(cid:10)(cid:46)(cid:14)(cid:2)(cid:9)(cid:11)(cid:4)(cid:3)(cid:49)(cid:4)(cid:8)(cid:5)(cid:2)(cid:28)(cid:3,Unknown,16920.0
Unknown,Unknown,7,Unknown,Unknown,Unknown,Unknown,cid:10)(cid:11)(cid:10)(cid:46)(cid:14)(cid:2)(cid:9)(cid:11)(cid:4)(cid:3)(cid:49)(cid:4)(cid:8)(cid:5)(cid:2)(cid:28)(cid:3,Unknown,16927.0
Unknown,Unknown,43,Unknown,Unknown,Unknown,Unknown,cid:10)(cid:11)(cid:10)(cid:46)(cid:14)(cid:2)(cid:9)(cid:11)(cid:4)(cid:3)(cid:49)(cid:4)(cid:8)(cid:5)(cid:2)(cid:28)(cid:3,Unknown,16970.0
Unknown,Unknown,2,Unknown,Unknown,Unknown,Unknown,cid:10)(cid:11)(cid:10)(cid:46)(cid:14)(cid:2)(cid:9)(cid:11)(cid:4)(cid:3)(cid:49)(cid:4)(cid:8)(cid:5)(cid:2)(cid:28)(cid:3,Unknown,16972.0
Unknown,Unknown,17,Unknown,Unknown,Unknown,Unknown,cid:10)(cid:11)(cid:10)(cid:46)(cid:14)(cid:2)(cid:9)(cid:11)(cid:4)(cid:3)(cid:49)(cid:4)(cid:8)(cid:5)(cid:2)(cid:28)(cid:3,Unknown,16989.0
Unknown,Unknown,36,Unknown,Unknown,Unknown,Unknown,cid:10)(cid:11)(cid:10)(cid:46)(cid:14)(cid:2)(cid:9)(cid:11)(cid:4)(cid:3)(cid:49)(cid:4)(cid:8)(cid:5)(cid:2)(cid:28)(cid:3,Unknown,17025.0
Unknown,Unknown,36,Unknown,Unknown,Unknown,Unknown,cid:10)(cid:11)(cid:10)(cid:46)(cid:14)(cid:2)(cid:9)(cid:11)(cid:4)(cid:3)(cid:49)(cid:4)(cid:8)(cid:5)(cid:2)(cid:28)(cid:3,Unknown,17061.0
Unknown,Unknown,19,Unknown,Unknown,Unknown,Unknown,cid:10)(cid:11)(cid:10)(cid:46)(cid:14)(cid:2)(cid:9)(cid:11)(cid:4)(cid:3)(cid:49)(cid:4)(cid:8)(cid:5)(cid:2)(cid:28)(cid:3,Unknown,17080.0
Unknown,Unknown,18,Unknown,Unknown,Unknown,Unknown,cid:10)(cid:11)(cid:10)(cid:46)(cid:14)(cid:2)(cid:9)(cid:11)(cid:4)(cid:3)(cid:49)(cid:4)(cid:8)(cid:5)(cid:2)(cid:28)(cid:3,Unknown,17098.0
Unknown,Unknown,18,Unknown,Unknown,Unknown,Unknown,cid:10)(cid:11)(cid:10)(cid:46)(cid:14)(cid:2)(cid:9)(cid:11)(cid:4)(cid:3)(cid:49)(cid:4)(cid:8)(cid:5)(cid:2)(cid:28)(cid:3,Unknown,17116.0
Unknown,Unknown,2,Unknown,Unknown,Unknown,Unknown,cid:10)(cid:11)(cid:10)(cid:46)(cid:14)(cid:2)(cid:9)(cid:11)(cid:4)(cid:3)(cid:49)(cid:4)(cid:8)(cid:5)(cid:2)(cid:28)(cid:3,Unknown,17118.0
Unknown,Unknown,44,Unknown,Unknown,Unknown,Unknown,cid:10)(cid:11)(cid:10)(cid:46)(cid:14)(cid:2)(cid:9)(cid:11)(cid:4)(cid:3)(cid:49)(cid:4)(cid:8)(cid:5)(cid:2)(cid:28)(cid:3,Unknown,17162.0
Unknown,Unknown,49,Unknown,Unknown,Unknown,Unknown,cid:10)(cid:11)(cid:10)(cid:46)(cid:14)(cid:2)(cid:9)(cid:11)(cid:4)(cid:3)(cid:49)(cid:4)(cid:8)(cid:5)(cid:2)(cid:28)(cid:3,Unknown,17211.0
Unknown,Unknown,42,Unknown,Unknown,Unknown,Unknown,cid:10)(cid:11)(cid:10)(cid:46)(cid:14)(cid:2)(cid:9)(cid:11)(cid:4)(cid:3)(cid:49)(cid:4)(cid:8)(cid:5)(cid:2)(cid:28)(cid:3,Unknown,17253.0
Unknown,Unknown,56,Unknown,Unknown,Unknown,Unknown,cid:10)(cid:11)(cid:10)(cid:46)(cid:14)(cid:2)(cid:9)(cid:11)(cid:4)(cid:3)(cid:49)(cid:4)(cid:8)(cid:5)(cid:2)(cid:28)(cid:3,Unknown,17309.0
Unknown,Unknown,57,Unknown,Unknown,Unknown,Unknown,cid:10)(cid:11)(cid:10)(cid:46)(cid:14)(cid:2)(cid:9)(cid:11)(cid:4)(cid:3)(cid:49)(cid:4)(cid:8)(cid:5)(cid:2)(cid:28)(cid:3,Unknown,17366.0
Unknown,Unknown,41,Unknown,Unknown,Unknown,Unknown,cid:10)(cid:11)(cid:10)(cid:46)(cid:14)(cid:2)(cid:9)(cid:11)(cid:4)(cid:3)(cid:49)(cid:4)(cid:8)(cid:5)(cid:2)(cid:28)(cid:3,Unknown,17407.0
Unknown,Unknown,2,Unknown,Unknown,Unknown,Unknown,cid:10)(cid:11)(cid:10)(cid:46)(cid:14)(cid:2)(cid:9)(cid:11)(cid:4)(cid:3)(cid:49)(cid:4)(cid:8)(cid:5)(cid:2)(cid:28)(cid:3,Unknown,17409.0
Unknown,Unknown,48,Unknown,Unknown,Unknown,Unknown,cid:10)(cid:11)(cid:10)(cid:46)(cid:14)(cid:2)(cid:9)(cid:11)(cid:4)(cid:3)(cid:49)(cid:4)(cid:8)(cid:5)(cid:2)(cid:28)(cid:3,Unknown,17457.0
Unknown,Unknown,25,Unknown,Unknown,Unknown,Unknown,cid:10)(cid:11)(cid:10)(cid:46)(cid:14)(cid:2)(cid:9)(cid:11)(cid:4)(cid:3)(cid:49)(cid:4)(cid:8)(cid:5)(cid:2)(cid:28)(cid:3,Unknown,17482.0
Unknown,Unknown,2,Unknown,Unknown,Unknown,Unknown,cid:10)(cid:11)(cid:10)(cid:46)(cid:14)(cid:2)(cid:9)(cid:11)(cid:4)(cid:3)(cid:49)(cid:4)(cid:8)(cid:5)(cid:2)(cid:28)(cid:3,Unknown,17484.0
Unknown,Unknown,31,Unknown,Unknown,Unknown,Unknown,cid:10)(cid:11)(cid:10)(cid:46)(cid:14)(cid:2)(cid:9)(cid:11)(cid:4)(cid:3)(cid:49)(cid:4)(cid:8)(cid:5)(cid:2)(cid:28)(cid:3,Unknown,17515.0
Unknown,Unknown,58,Unknown,Unknown,Unknown,Unknown,cid:10)(cid:11)(cid:10)(cid:46)(cid:14)(cid:2)(cid:9)(cid:11)(cid:4)(cid:3)(cid:49)(cid:4)(cid:8)(cid:5)(cid:2)(cid:28)(cid:3,Unknown,17573.0
Unknown,Unknown,59,Unknown,Unknown,Unknown,Unknown,cid:10)(cid:11)(cid:10)(cid:46)(cid:14)(cid:2)(cid:9)(cid:11)(cid:4)(cid:3)(cid:49)(cid:4)(cid:8)(cid:5)(cid:2)(cid:28)(cid:3,Unknown,17632.0
Unknown,Unknown,60,Unknown,Unknown,Unknown,Unknown,cid:10)(cid:11)(cid:10)(cid:46)(cid:14)(cid:2)(cid:9)(cid:11)(cid:4)(cid:3)(cid:49)(cid:4)(cid:8)(cid:5)(cid:2)(cid:28)(cid:3,Unknown,17692.0
Unknown,Unknown,21,Unknown,Unknown,Unknown,Unknown,cid:10)(cid:11)(cid:10)(cid:46)(cid:14)(cid:2)(cid:9)(cid:11)(cid:4)(cid:3)(cid:49)(cid:4)(cid:8)(cid:5)(cid:2)(cid:28)(cid:3,Unknown,17713.0
Unknown,Unknown,25,Unknown,Unknown,Unknown,Unknown,cid:10)(cid:11)(cid:10)(cid:46)(cid:14)(cid:2)(cid:9)(cid:11)(cid:4)(cid:3)(cid:49)(cid:4)(cid:8)(cid:5)(cid:2)(cid:28)(cid:3,Unknown,17738.0
Unknown,Unknown,18,Unknown,Unknown,Unknown,Unknown,cid:10)(cid:11)(cid:10)(cid:46)(cid:14)(cid:2)(cid:9)(cid:11)(cid:4)(cid:3)(cid:49)(cid:4)(cid:8)(cid:5)(cid:2)(cid:28)(cid:3,Unknown,17756.0
Unknown,Unknown,33,Unknown,Unknown,Unknown,Unknown,cid:10)(cid:11)(cid:10)(cid:46)(cid:14)(cid:2)(cid:9)(cid:11)(cid:4)(cid:3)(cid:49)(cid:4)(cid:8)(cid:5)(cid:2)(cid:28)(cid:3,Unknown,17789.0
Unknown,Unknown,45,Unknown,Unknown,Unknown,Unknown,cid:10)(cid:11)(cid:10)(cid:46)(cid:14)(cid:2)(cid:9)(cid:11)(cid:4)(cid:3)(cid:49)(cid:4)(cid:8)(cid:5)(cid:2)(cid:28)(cid:3,Unknown,17834.0
Unknown,Unknown,18,Unknown,Unknown,Unknown,Unknown,cid:10)(cid:11)(cid:10)(cid:46)(cid:14)(cid:2)(cid:9)(cid:11)(cid:4)(cid:3)(cid:49)(cid:4)(cid:8)(cid:5)(cid:2)(cid:28)(cid:3,Unknown,17852.0
Unknown,Unknown,35,Unknown,Unknown,Unknown,Unknown,cid:10)(cid:11)(cid:10)(cid:46)(cid:14)(cid:2)(cid:9)(cid:11)(cid:4)(cid:3)(cid:49)(cid:4)(cid:8)(cid:5)(cid:2)(cid:28)(cid:3,Unknown,17887.0
Unknown,Unknown,38,Unknown,Unknown,Unknown,Unknown,cid:10)(cid:11)(cid:10)(cid:46)(cid:14)(cid:2)(cid:9)(cid:11)(cid:4)(cid:3)(cid:49)(cid:4)(cid:8)(cid:5)(cid:2)(cid:28)(cid:3,Unknown,17925.0
Unknown,Unknown,20,Unknown,Unknown,Unknown,Unknown,cid:10)(cid:11)(cid:10)(cid:46)(cid:14)(cid:2)(cid:9)(cid:11)(cid:4)(cid:3)(cid:49)(cid:4)(cid:8)(cid:5)(cid:2)(cid:28)(cid:3,Unknown,17945.0
Unknown,Unknown,30,Unknown,Unknown,Unknown,Unknown,cid:10)(cid:11)(cid:10)(cid:46)(cid:14)(cid:2)(cid:9)(cid:11)(cid:4)(cid:3)(cid:49)(cid:4)(cid:8)(cid:5)(cid:2)(cid:28)(cid:3,Unknown,17975.0
Unknown,Unknown,41,Unknown,Unknown,Unknown,Unknown,cid:10)(cid:11)(cid:10)(cid:46)(cid:14)(cid:2)(cid:9)(cid:11)(cid:4)(cid:3)(cid:49)(cid:4)(cid:8)(cid:5)(cid:2)(cid:28)(cid:3,Unknown,18016.0
Unknown,Unknown,20,Unknown,Unknown,Unknown,Unknown,cid:10)(cid:11)(cid:10)(cid:46)(cid:14)(cid:2)(cid:9)(cid:11)(cid:4)(cid:3)(cid:49)(cid:4)(cid:8)(cid:5)(cid:2)(cid:28)(cid:3,Unknown,18036.0
Unknown,Unknown,15,Unknown,Unknown,Unknown,Unknown,cid:10)(cid:11)(cid:10)(cid:46)(cid:14)(cid:2)(cid:9)(cid:11)(cid:4)(cid:3)(cid:49)(cid:4)(cid:8)(cid:5)(cid:2)(cid:28)(cid:3,Unknown,18051.0
Unknown,Unknown,2,Unknown,Unknown,Unknown,Unknown,cid:10)(cid:11)(cid:10)(cid:46)(cid:14)(cid:2)(cid:9)(cid:11)(cid:4)(cid:3)(cid:49)(cid:4)(cid:8)(cid:5)(cid:2)(cid:28)(cid:3,Unknown,18053.0
Unknown,Unknown,1,Unknown,Unknown,Unknown,Unknown,cid:10)(cid:11)(cid:10)(cid:46)(cid:14)(cid:2)(cid:9)(cid:11)(cid:4)(cid:3)(cid:49)(cid:4)(cid:8)(cid:5)(cid:2)(cid:28)(cid:3,Unknown,18054.0
Unknown,Unknown,19,Unknown,Unknown,Unknown,Unknown,cid:10)(cid:11)(cid:10)(cid:46)(cid:14)(cid:2)(cid:9)(cid:11)(cid:4)(cid:3)(cid:49)(cid:4)(cid:8)(cid:5)(cid:2)(cid:28)(cid:3,Unknown,18073.0
Unknown,Unknown,36,Unknown,Unknown,Unknown,Unknown,cid:10)(cid:11)(cid:10)(cid:46)(cid:14)(cid:2)(cid:9)(cid:11)(cid:4)(cid:3)(cid:49)(cid:4)(cid:8)(cid:5)(cid:2)(cid:28)(cid:3,Unknown,18109.0
Unknown,Unknown,18,Unknown,Unknown,Unknown,Unknown,cid:10)(cid:11)(cid:10)(cid:46)(cid:14)(cid:2)(cid:9)(cid:11)(cid:4)(cid:3)(cid:49)(cid:4)(cid:8)(cid:5)(cid:2)(cid:28)(cid:3,Unknown,18127.0
Unknown,Unknown,2,Unknown,Unknown,Unknown,Unknown,cid:10)(cid:11)(cid:10)(cid:46)(cid:14)(cid:2)(cid:9)(cid:11)(cid:4)(cid:3)(cid:49)(cid:4)(cid:8)(cid:5)(cid:2)(cid:28)(cid:3,Unknown,18129.0
Unknown,Unknown,44,Unknown,Unknown,Unknown,Unknown,cid:10)(cid:11)(cid:10)(cid:46)(cid:14)(cid:2)(cid:9)(cid:11)(cid:4)(cid:3)(cid:49)(cid:4)(cid:8)(cid:5)(cid:2)(cid:28)(cid:3,Unknown,18173.0
Unknown,Unknown,46,Unknown,Unknown,Unknown,Unknown,cid:10)(cid:11)(cid:10)(cid:46)(cid:14)(cid:2)(cid:9)(cid:11)(cid:4)(cid:3)(cid:49)(cid:4)(cid:8)(cid:5)(cid:2)(cid:28)(cid:3,Unknown,18219.0
Unknown,Unknown,47,Unknown,Unknown,Unknown,Unknown,cid:10)(cid:11)(cid:10)(cid:46)(cid:14)(cid:2)(cid:9)(cid:11)(cid:4)(cid:3)(cid:49)(cid:4)(cid:8)(cid:5)(cid:2)(cid:28)(cid:3,Unknown,18266.0
Unknown,Unknown,20,Unknown,Unknown,Unknown,Unknown,cid:10)(cid:11)(cid:10)(cid:46)(cid:14)(cid:2)(cid:9)(cid:11)(cid:4)(cid:3)(cid:49)(cid:4)(cid:8)(cid:5)(cid:2)(cid:28)(cid:3,Unknown,18286.0
Unknown,Unknown,30,Unknown,Unknown,Unknown,Unknown,cid:10)(cid:11)(cid:10)(cid:46)(cid:14)(cid:2)(cid:9)(cid:11)(cid:4)(cid:3)(cid:49)(cid:4)(cid:8)(cid:5)(cid:2)(cid:28)(cid:3,Unknown,18316.0
Unknown,Unknown,30,Unknown,Unknown,Unknown,Unknown,cid:10)(cid:11)(cid:10)(cid:46)(cid:14)(cid:2)(cid:9)(cid:11)(cid:4)(cid:3)(cid:49)(cid:4)(cid:8)(cid:5)(cid:2)(cid:28)(cid:3,Unknown,18346.0
Unknown,Unknown,25,Unknown,Unknown,Unknown,Unknown,cid:10)(cid:11)(cid:10)(cid:46)(cid:14)(cid:2)(cid:9)(cid:11)(cid:4)(cid:3)(cid:49)(cid:4)(cid:8)(cid:5)(cid:2)(cid:28)(cid:3,Unknown,18371.0
Unknown,Unknown,23,Unknown,Unknown,Unknown,Unknown,cid:10)(cid:11)(cid:10)(cid:46)(cid:14)(cid:2)(cid:9)(cid:11)(cid:4)(cid:3)(cid:49)(cid:4)(cid:8)(cid:5)(cid:2)(cid:28)(cid:3,Unknown,18394.0
Unknown,Unknown,25,Unknown,Unknown,Unknown,Unknown,cid:10)(cid:11)(cid:10)(cid:46)(cid:14)(cid:2)(cid:9)(cid:11)(cid:4)(cid:3)(cid:49)(cid:4)(cid:8)(cid:5)(cid:2)(cid:28)(cid:3,Unknown,18419.0
Unknown,Unknown,30,Unknown,Unknown,Unknown,Unknown,cid:10)(cid:11)(cid:10)(cid:46)(cid:14)(cid:2)(cid:9)(cid:11)(cid:4)(cid:3)(cid:49)(cid:4)(cid:8)(cid:5)(cid:2)(cid:28)(cid:3,Unknown,18449.0
Unknown,Unknown,41,Unknown,Unknown,Unknown,Unknown,cid:10)(cid:11)(cid:10)(cid:46)(cid:14)(cid:2)(cid:9)(cid:11)(cid:4)(cid:3)(cid:49)(cid:4)(cid:8)(cid:5)(cid:2)(cid:28)(cid:3,Unknown,18490.0
Unknown,Unknown,2,Unknown,Unknown,Unknown,Unknown,cid:10)(cid:11)(cid:10)(cid:46)(cid:14)(cid:2)(cid:9)(cid:11)(cid:4)(cid:3)(cid:49)(cid:4)(cid:8)(cid:5)(cid:2)(cid:28)(cid:3,Unknown,18492.0
Unknown,Unknown,45,Unknown,Unknown,Unknown,Unknown,cid:10)(cid:11)(cid:10)(cid:46)(cid:14)(cid:2)(cid:9)(cid:11)(cid:4)(cid:3)(cid:49)(cid:4)(cid:8)(cid:5)(cid:2)(cid:28)(cid:3,Unknown,18537.0
Unknown,Unknown,2,Unknown,Unknown,Unknown,Unknown,cid:10)(cid:11)(cid:10)(cid:46)(cid:14)(cid:2)(cid:9)(cid:11)(cid:4)(cid:3)(cid:49)(cid:4)(cid:8)(cid:5)(cid:2)(cid:28)(cid:3,Unknown,18539.0
Unknown,Unknown,28,Unknown,Unknown,Unknown,Unknown,cid:10)(cid:11)(cid:10)(cid:46)(cid:14)(cid:2)(cid:9)(cid:11)(cid:4)(cid:3)(cid:49)(cid:4)(cid:8)(cid:5)(cid:2)(cid:28)(cid:3,Unknown,18567.0
Unknown,Unknown,26,Unknown,Unknown,Unknown,Unknown,cid:10)(cid:11)(cid:10)(cid:46)(cid:14)(cid:2)(cid:9)(cid:11)(cid:4)(cid:3)(cid:49)(cid:4)(cid:8)(cid:5)(cid:2)(cid:28)(cid:3,Unknown,18593.0
Unknown,Unknown,29,Unknown,Unknown,Unknown,Unknown,cid:10)(cid:11)(cid:10)(cid:46)(cid:14)(cid:2)(cid:9)(cid:11)(cid:4)(cid:3)(cid:49)(cid:4)(cid:8)(cid:5)(cid:2)(cid:28)(cid:3,Unknown,18622.0
Unknown,Unknown,24,Unknown,Unknown,Unknown,Unknown,cid:10)(cid:11)(cid:10)(cid:46)(cid:14)(cid:2)(cid:9)(cid:11)(cid:4)(cid:3)(cid:49)(cid:4)(cid:8)(cid:5)(cid:2)(cid:28)(cid:3,Unknown,18646.0
Unknown,Unknown,27,Unknown,Unknown,Unknown,Unknown,cid:10)(cid:11)(cid:10)(cid:46)(cid:14)(cid:2)(cid:9)(cid:11)(cid:4)(cid:3)(cid:49)(cid:4)(cid:8)(cid:5)(cid:2)(cid:28)(cid:3,Unknown,18673.0
Unknown,Unknown,2,Unknown,Unknown,Unknown,Unknown,cid:10)(cid:11)(cid:10)(cid:46)(cid:14)(cid:2)(cid:9)(cid:11)(cid:4)(cid:3)(cid:49)(cid:4)(cid:8)(cid:5)(cid:2)(cid:28)(cid:3,Unknown,18675.0
Unknown,Unknown,29,Unknown,Unknown,Unknown,Unknown,cid:10)(cid:11)(cid:10)(cid:46)(cid:14)(cid:2)(cid:9)(cid:11)(cid:4)(cid:3)(cid:49)(cid:4)(cid:8)(cid:5)(cid:2)(cid:28)(cid:3,Unknown,18704.0
Unknown,Unknown,48,Unknown,Unknown,Unknown,Unknown,cid:10)(cid:11)(cid:10)(cid:46)(cid:14)(cid:2)(cid:9)(cid:11)(cid:4)(cid:3)(cid:49)(cid:4)(cid:8)(cid:5)(cid:2)(cid:28)(cid:3,Unknown,18752.0
Unknown,Unknown,48,Unknown,Unknown,Unknown,Unknown,cid:10)(cid:11)(cid:10)(cid:46)(cid:14)(cid:2)(cid:9)(cid:11)(cid:4)(cid:3)(cid:49)(cid:4)(cid:8)(cid:5)(cid:2)(cid:28)(cid:3,Unknown,18800.0
Unknown,Unknown,24,Unknown,Unknown,Unknown,Unknown,cid:10)(cid:11)(cid:10)(cid:46)(cid:14)(cid:2)(cid:9)(cid:11)(cid:4)(cid:3)(cid:49)(cid:4)(cid:8)(cid:5)(cid:2)(cid:28)(cid:3,Unknown,18824.0
Unknown,Unknown,41,Unknown,Unknown,Unknown,Unknown,cid:10)(cid:11)(cid:10)(cid:46)(cid:14)(cid:2)(cid:9)(cid:11)(cid:4)(cid:3)(cid:49)(cid:4)(cid:8)(cid:5)(cid:2)(cid:28)(cid:3,Unknown,18865.0
Unknown,Unknown,24,Unknown,Unknown,Unknown,Unknown,cid:10)(cid:11)(cid:10)(cid:46)(cid:14)(cid:2)(cid:9)(cid:11)(cid:4)(cid:3)(cid:49)(cid:4)(cid:8)(cid:5)(cid:2)(cid:28)(cid:3,Unknown,18889.0
Unknown,Unknown,20,Unknown,Unknown,Unknown,Unknown,cid:10)(cid:11)(cid:10)(cid:46)(cid:14)(cid:2)(cid:9)(cid:11)(cid:4)(cid:3)(cid:49)(cid:4)(cid:8)(cid:5)(cid:2)(cid:28)(cid:3,Unknown,18909.0
Unknown,Unknown,30,Unknown,Unknown,Unknown,Unknown,cid:10)(cid:11)(cid:10)(cid:46)(cid:14)(cid:2)(cid:9)(cid:11)(cid:4)(cid:3)(cid:49)(cid:4)(cid:8)(cid:5)(cid:2)(cid:28)(cid:3,Unknown,18939.0
Unknown,Unknown,30,Unknown,Unknown,Unknown,Unknown,cid:10)(cid:11)(cid:10)(cid:46)(cid:14)(cid:2)(cid:9)(cid:11)(cid:4)(cid:3)(cid:49)(cid:4)(cid:8)(cid:5)(cid:2)(cid:28)(cid:3,Unknown,18969.0
Unknown,Unknown,25,Unknown,Unknown,Unknown,Unknown,cid:10)(cid:11)(cid:10)(cid:46)(cid:14)(cid:2)(cid:9)(cid:11)(cid:4)(cid:3)(cid:49)(cid:4)(cid:8)(cid:5)(cid:2)(cid:28)(cid:3,Unknown,18994.0
Unknown,Unknown,22,Unknown,Unknown,Unknown,Unknown,cid:10)(cid:11)(cid:10)(cid:46)(cid:14)(cid:2)(cid:9)(cid:11)(cid:4)(cid:3)(cid:49)(cid:4)(cid:8)(cid:5)(cid:2)(cid:28)(cid:3,Unknown,19016.0
Unknown,Unknown,27,Unknown,Unknown,Unknown,Unknown,cid:10)(cid:11)(cid:10)(cid:46)(cid:14)(cid:2)(cid:9)(cid:11)(cid:4)(cid:3)(cid:49)(cid:4)(cid:8)(cid:5)(cid:2)(cid:28)(cid:3,Unknown,19043.0
Unknown,Unknown,18,Unknown,Unknown,Unknown,Unknown,cid:43)(cid:2)(cid:1)(cid:34)(cid:34)(cid:19)(cid:18)(cid:18)(cid:2)(cid:44,cid:54)(cid:46)(cid:4)(cid:10)(cid:9)(cid:10)(cid:5)(cid:14)(cid:14)(cid:5)(cid:2)(cid:3)(cid:11)(cid:9)(cid:5)(cid:8)(cid:51)(cid:46)(cid:12)(cid:13)(cid:2)(cid:3)(cid:11)(cid:9)(cid:5)(cid:8)(cid:51)(cid:46)(cid:12)(cid:13)(cid:2)(cid:46)(cid:10,18.0
Unknown,Unknown,33,Unknown,Unknown,Unknown,Unknown,cid:43)(cid:2)(cid:1)(cid:34)(cid:34)(cid:19)(cid:18)(cid:18)(cid:2)(cid:44,cid:17)(cid:16)(cid:45)(cid:18)(cid:35,51.0
Unknown,Unknown,45,Unknown,Unknown,Unknown,Unknown,cid:43)(cid:2)(cid:1)(cid:34)(cid:34)(cid:19)(cid:18)(cid:18)(cid:2)(cid:44,cid:52)(cid:7)(cid:52)(cid:46)(cid:2)(cid:28)(cid:3)(cid:5)(cid:9)(cid:13)(cid:2)(cid:28)(cid:5)(cid:3)(cid:7)(cid:64)(cid:46)(cid:65)(cid:2)(cid:38)(cid:64,96.0
Unknown,Unknown,18,Unknown,Unknown,Unknown,Unknown,cid:43)(cid:2)(cid:1)(cid:34)(cid:34)(cid:19)(cid:18)(cid:18)(cid:2)(cid:44,cid:15)(cid:2)(cid:33)(cid:1)(cid:19)(cid:36)(cid:18)(cid:2)(cid:44,114.0
Unknown,Unknown,35,Unknown,Unknown,Unknown,Unknown,cid:43)(cid:2)(cid:1)(cid:34)(cid:34)(cid:19)(cid:18)(cid:18)(cid:2)(cid:44,Unknown,149.0
Unknown,Unknown,38,Unknown,Unknown,Unknown,Unknown,cid:43)(cid:2)(cid:1)(cid:34)(cid:34)(cid:19)(cid:18)(cid:18)(cid:2)(cid:44,Unknown,187.0
Unknown,Unknown,20,Unknown,Unknown,Unknown,Unknown,cid:43)(cid:2)(cid:1)(cid:34)(cid:34)(cid:19)(cid:18)(cid:18)(cid:2)(cid:44,Unknown,207.0
Unknown,Unknown,30,Unknown,Unknown,Unknown,Unknown,cid:43)(cid:2)(cid:1)(cid:34)(cid:34)(cid:19)(cid:18)(cid:18)(cid:2)(cid:44,Unknown,237.0
Unknown,Unknown,41,Unknown,Unknown,Unknown,Unknown,cid:43)(cid:2)(cid:1)(cid:34)(cid:34)(cid:19)(cid:18)(cid:18)(cid:2)(cid:44,Unknown,278.0
Unknown,Unknown,20,Unknown,Unknown,Unknown,Unknown,cid:43)(cid:2)(cid:1)(cid:34)(cid:34)(cid:19)(cid:18)(cid:18)(cid:2)(cid:44,Unknown,298.0
Unknown,Unknown,15,Unknown,Unknown,Unknown,Unknown,cid:43)(cid:2)(cid:1)(cid:34)(cid:34)(cid:19)(cid:18)(cid:18)(cid:2)(cid:44,Unknown,313.0
Unknown,Unknown,2,Unknown,Unknown,Unknown,Unknown,cid:43)(cid:2)(cid:1)(cid:34)(cid:34)(cid:19)(cid:18)(cid:18)(cid:2)(cid:44,Unknown,315.0
Unknown,Unknown,1,Unknown,Unknown,Unknown,Unknown,cid:43)(cid:2)(cid:1)(cid:34)(cid:34)(cid:19)(cid:18)(cid:18)(cid:2)(cid:44,Unknown,316.0
Unknown,Unknown,19,Unknown,Unknown,Unknown,Unknown,cid:43)(cid:2)(cid:1)(cid:34)(cid:34)(cid:19)(cid:18)(cid:18)(cid:2)(cid:44,Unknown,335.0
Unknown,Unknown,36,Unknown,Unknown,Unknown,Unknown,cid:43)(cid:2)(cid:1)(cid:34)(cid:34)(cid:19)(cid:18)(cid:18)(cid:2)(cid:44,Unknown,371.0
Unknown,Unknown,18,Unknown,Unknown,Unknown,Unknown,cid:43)(cid:2)(cid:1)(cid:34)(cid:34)(cid:19)(cid:18)(cid:18)(cid:2)(cid:44,Unknown,389.0
Unknown,Unknown,2,Unknown,Unknown,Unknown,Unknown,cid:43)(cid:2)(cid:1)(cid:34)(cid:34)(cid:19)(cid:18)(cid:18)(cid:2)(cid:44,Unknown,391.0
Unknown,Unknown,44,Unknown,Unknown,Unknown,Unknown,cid:43)(cid:2)(cid:1)(cid:34)(cid:34)(cid:19)(cid:18)(cid:18)(cid:2)(cid:44,Unknown,435.0
Unknown,Unknown,46,Unknown,Unknown,Unknown,Unknown,cid:43)(cid:2)(cid:1)(cid:34)(cid:34)(cid:19)(cid:18)(cid:18)(cid:2)(cid:44,Unknown,481.0
Unknown,Unknown,47,Unknown,Unknown,Unknown,Unknown,cid:43)(cid:2)(cid:1)(cid:34)(cid:34)(cid:19)(cid:18)(cid:18)(cid:2)(cid:44,Unknown,528.0
Unknown,Unknown,20,Unknown,Unknown,Unknown,Unknown,cid:43)(cid:2)(cid:1)(cid:34)(cid:34)(cid:19)(cid:18)(cid:18)(cid:2)(cid:44,Unknown,548.0
Unknown,Unknown,30,Unknown,Unknown,Unknown,Unknown,cid:43)(cid:2)(cid:1)(cid:34)(cid:34)(cid:19)(cid:18)(cid:18)(cid:2)(cid:44,Unknown,578.0
Unknown,Unknown,30,Unknown,Unknown,Unknown,Unknown,cid:43)(cid:2)(cid:1)(cid:34)(cid:34)(cid:19)(cid:18)(cid:18)(cid:2)(cid:44,Unknown,608.0
Unknown,Unknown,25,Unknown,Unknown,Unknown,Unknown,cid:43)(cid:2)(cid:1)(cid:34)(cid:34)(cid:19)(cid:18)(cid:18)(cid:2)(cid:44,Unknown,633.0
Unknown,Unknown,23,Unknown,Unknown,Unknown,Unknown,cid:43)(cid:2)(cid:1)(cid:34)(cid:34)(cid:19)(cid:18)(cid:18)(cid:2)(cid:44,Unknown,656.0
Unknown,Unknown,25,Unknown,Unknown,Unknown,Unknown,cid:43)(cid:2)(cid:1)(cid:34)(cid:34)(cid:19)(cid:18)(cid:18)(cid:2)(cid:44,Unknown,681.0
Unknown,Unknown,30,Unknown,Unknown,Unknown,Unknown,cid:43)(cid:2)(cid:1)(cid:34)(cid:34)(cid:19)(cid:18)(cid:18)(cid:2)(cid:44,Unknown,711.0
Unknown,Unknown,41,Unknown,Unknown,Unknown,Unknown,cid:43)(cid:2)(cid:1)(cid:34)(cid:34)(cid:19)(cid:18)(cid:18)(cid:2)(cid:44,Unknown,752.0
Unknown,Unknown,2,Unknown,Unknown,Unknown,Unknown,cid:43)(cid:2)(cid:1)(cid:34)(cid:34)(cid:19)(cid:18)(cid:18)(cid:2)(cid:44,Unknown,754.0
Unknown,Unknown,45,Unknown,Unknown,Unknown,Unknown,cid:43)(cid:2)(cid:1)(cid:34)(cid:34)(cid:19)(cid:18)(cid:18)(cid:2)(cid:44,Unknown,799.0
Unknown,Unknown,2,Unknown,Unknown,Unknown,Unknown,cid:43)(cid:2)(cid:1)(cid:34)(cid:34)(cid:19)(cid:18)(cid:18)(cid:2)(cid:44,Unknown,801.0
Unknown,Unknown,28,Unknown,Unknown,Unknown,Unknown,cid:43)(cid:2)(cid:1)(cid:34)(cid:34)(cid:19)(cid:18)(cid:18)(cid:2)(cid:44,Unknown,829.0
Unknown,Unknown,26,Unknown,Unknown,Unknown,Unknown,cid:43)(cid:2)(cid:1)(cid:34)(cid:34)(cid:19)(cid:18)(cid:18)(cid:2)(cid:44,Unknown,855.0
Unknown,Unknown,29,Unknown,Unknown,Unknown,Unknown,cid:43)(cid:2)(cid:1)(cid:34)(cid:34)(cid:19)(cid:18)(cid:18)(cid:2)(cid:44,Unknown,884.0
Unknown,Unknown,24,Unknown,Unknown,Unknown,Unknown,cid:43)(cid:2)(cid:1)(cid:34)(cid:34)(cid:19)(cid:18)(cid:18)(cid:2)(cid:44,Unknown,908.0
Unknown,Unknown,27,Unknown,Unknown,Unknown,Unknown,cid:43)(cid:2)(cid:1)(cid:34)(cid:34)(cid:19)(cid:18)(cid:18)(cid:2)(cid:44,Unknown,935.0
Unknown,Unknown,2,Unknown,Unknown,Unknown,Unknown,cid:43)(cid:2)(cid:1)(cid:34)(cid:34)(cid:19)(cid:18)(cid:18)(cid:2)(cid:44,Unknown,937.0
Unknown,Unknown,29,Unknown,Unknown,Unknown,Unknown,cid:43)(cid:2)(cid:1)(cid:34)(cid:34)(cid:19)(cid:18)(cid:18)(cid:2)(cid:44,Unknown,966.0
Unknown,Unknown,48,Unknown,Unknown,Unknown,Unknown,cid:43)(cid:2)(cid:1)(cid:34)(cid:34)(cid:19)(cid:18)(cid:18)(cid:2)(cid:44,Unknown,1014.0
Unknown,Unknown,48,Unknown,Unknown,Unknown,Unknown,cid:43)(cid:2)(cid:1)(cid:34)(cid:34)(cid:19)(cid:18)(cid:18)(cid:2)(cid:44,Unknown,1062.0
Unknown,Unknown,24,Unknown,Unknown,Unknown,Unknown,cid:43)(cid:2)(cid:1)(cid:34)(cid:34)(cid:19)(cid:18)(cid:18)(cid:2)(cid:44,Unknown,1086.0
Unknown,Unknown,41,Unknown,Unknown,Unknown,Unknown,cid:43)(cid:2)(cid:1)(cid:34)(cid:34)(cid:19)(cid:18)(cid:18)(cid:2)(cid:44,Unknown,1127.0
Unknown,Unknown,24,Unknown,Unknown,Unknown,Unknown,cid:43)(cid:2)(cid:1)(cid:34)(cid:34)(cid:19)(cid:18)(cid:18)(cid:2)(cid:44,Unknown,1151.0
Unknown,Unknown,20,Unknown,Unknown,Unknown,Unknown,cid:43)(cid:2)(cid:1)(cid:34)(cid:34)(cid:19)(cid:18)(cid:18)(cid:2)(cid:44,Unknown,1171.0
Unknown,Unknown,30,Unknown,Unknown,Unknown,Unknown,cid:43)(cid:2)(cid:1)(cid:34)(cid:34)(cid:19)(cid:18)(cid:18)(cid:2)(cid:44,Unknown,1201.0
Unknown,Unknown,30,Unknown,Unknown,Unknown,Unknown,cid:43)(cid:2)(cid:1)(cid:34)(cid:34)(cid:19)(cid:18)(cid:18)(cid:2)(cid:44,Unknown,1231.0
Unknown,Unknown,25,Unknown,Unknown,Unknown,Unknown,cid:43)(cid:2)(cid:1)(cid:34)(cid:34)(cid:19)(cid:18)(cid:18)(cid:2)(cid:44,Unknown,1256.0
Unknown,Unknown,22,Unknown,Unknown,Unknown,Unknown,cid:43)(cid:2)(cid:1)(cid:34)(cid:34)(cid:19)(cid:18)(cid:18)(cid:2)(cid:44,Unknown,1278.0
Unknown,Unknown,27,Unknown,Unknown,Unknown,Unknown,cid:43)(cid:2)(cid:1)(cid:34)(cid:34)(cid:19)(cid:18)(cid:18)(cid:2)(cid:44,Unknown,1305.0
Unknown,Unknown,18,Unknown,Unknown,Unknown,Unknown,cid:43)(cid:2)(cid:1)(cid:34)(cid:34)(cid:19)(cid:18)(cid:18)(cid:2)(cid:44,Unknown,1323.0
Unknown,Unknown,33,Unknown,Unknown,Unknown,Unknown,cid:43)(cid:2)(cid:1)(cid:34)(cid:34)(cid:19)(cid:18)(cid:18)(cid:2)(cid:44,Unknown,1356.0
Unknown,Unknown,45,Unknown,Unknown,Unknown,Unknown,cid:43)(cid:2)(cid:1)(cid:34)(cid:34)(cid:19)(cid:18)(cid:18)(cid:2)(cid:44,Unknown,1401.0
Unknown,Unknown,18,Unknown,Unknown,Unknown,Unknown,cid:43)(cid:2)(cid:1)(cid:34)(cid:34)(cid:19)(cid:18)(cid:18)(cid:2)(cid:44,Unknown,1419.0
Unknown,Unknown,35,Unknown,Unknown,Unknown,Unknown,cid:43)(cid:2)(cid:1)(cid:34)(cid:34)(cid:19)(cid:18)(cid:18)(cid:2)(cid:44,Unknown,1454.0
Unknown,Unknown,38,Unknown,Unknown,Unknown,Unknown,cid:43)(cid:2)(cid:1)(cid:34)(cid:34)(cid:19)(cid:18)(cid:18)(cid:2)(cid:44,Unknown,1492.0
Unknown,Unknown,20,Unknown,Unknown,Unknown,Unknown,cid:43)(cid:2)(cid:1)(cid:34)(cid:34)(cid:19)(cid:18)(cid:18)(cid:2)(cid:44,Unknown,1512.0
Unknown,Unknown,30,Unknown,Unknown,Unknown,Unknown,cid:43)(cid:2)(cid:1)(cid:34)(cid:34)(cid:19)(cid:18)(cid:18)(cid:2)(cid:44,Unknown,1542.0
Unknown,Unknown,41,Unknown,Unknown,Unknown,Unknown,cid:43)(cid:2)(cid:1)(cid:34)(cid:34)(cid:19)(cid:18)(cid:18)(cid:2)(cid:44,Unknown,1583.0
Unknown,Unknown,20,Unknown,Unknown,Unknown,Unknown,cid:43)(cid:2)(cid:1)(cid:34)(cid:34)(cid:19)(cid:18)(cid:18)(cid:2)(cid:44,Unknown,1603.0
Unknown,Unknown,15,Unknown,Unknown,Unknown,Unknown,cid:43)(cid:2)(cid:1)(cid:34)(cid:34)(cid:19)(cid:18)(cid:18)(cid:2)(cid:44,Unknown,1618.0
Unknown,Unknown,2,Unknown,Unknown,Unknown,Unknown,cid:43)(cid:2)(cid:1)(cid:34)(cid:34)(cid:19)(cid:18)(cid:18)(cid:2)(cid:44,Unknown,1620.0
Unknown,Unknown,1,Unknown,Unknown,Unknown,Unknown,cid:43)(cid:2)(cid:1)(cid:34)(cid:34)(cid:19)(cid:18)(cid:18)(cid:2)(cid:44,Unknown,1621.0
Unknown,Unknown,19,Unknown,Unknown,Unknown,Unknown,cid:43)(cid:2)(cid:1)(cid:34)(cid:34)(cid:19)(cid:18)(cid:18)(cid:2)(cid:44,Unknown,1640.0
Unknown,Unknown,36,Unknown,Unknown,Unknown,Unknown,cid:43)(cid:2)(cid:1)(cid:34)(cid:34)(cid:19)(cid:18)(cid:18)(cid:2)(cid:44,Unknown,1676.0
Unknown,Unknown,18,Unknown,Unknown,Unknown,Unknown,cid:43)(cid:2)(cid:1)(cid:34)(cid:34)(cid:19)(cid:18)(cid:18)(cid:2)(cid:44,Unknown,1694.0
Unknown,Unknown,2,Unknown,Unknown,Unknown,Unknown,cid:43)(cid:2)(cid:1)(cid:34)(cid:34)(cid:19)(cid:18)(cid:18)(cid:2)(cid:44,Unknown,1696.0
Unknown,Unknown,44,Unknown,Unknown,Unknown,Unknown,cid:43)(cid:2)(cid:1)(cid:34)(cid:34)(cid:19)(cid:18)(cid:18)(cid:2)(cid:44,Unknown,1740.0
Unknown,Unknown,46,Unknown,Unknown,Unknown,Unknown,cid:43)(cid:2)(cid:1)(cid:34)(cid:34)(cid:19)(cid:18)(cid:18)(cid:2)(cid:44,Unknown,1786.0
Unknown,Unknown,47,Unknown,Unknown,Unknown,Unknown,cid:43)(cid:2)(cid:1)(cid:34)(cid:34)(cid:19)(cid:18)(cid:18)(cid:2)(cid:44,Unknown,1833.0
Unknown,Unknown,20,Unknown,Unknown,Unknown,Unknown,cid:43)(cid:2)(cid:1)(cid:34)(cid:34)(cid:19)(cid:18)(cid:18)(cid:2)(cid:44,Unknown,1853.0
Unknown,Unknown,30,Unknown,Unknown,Unknown,Unknown,cid:43)(cid:2)(cid:1)(cid:34)(cid:34)(cid:19)(cid:18)(cid:18)(cid:2)(cid:44,Unknown,1883.0
Unknown,Unknown,30,Unknown,Unknown,Unknown,Unknown,cid:43)(cid:2)(cid:1)(cid:34)(cid:34)(cid:19)(cid:18)(cid:18)(cid:2)(cid:44,Unknown,1913.0
Unknown,Unknown,25,Unknown,Unknown,Unknown,Unknown,cid:43)(cid:2)(cid:1)(cid:34)(cid:34)(cid:19)(cid:18)(cid:18)(cid:2)(cid:44,Unknown,1938.0
Unknown,Unknown,23,Unknown,Unknown,Unknown,Unknown,cid:43)(cid:2)(cid:1)(cid:34)(cid:34)(cid:19)(cid:18)(cid:18)(cid:2)(cid:44,Unknown,1961.0
Unknown,Unknown,25,Unknown,Unknown,Unknown,Unknown,cid:43)(cid:2)(cid:1)(cid:34)(cid:34)(cid:19)(cid:18)(cid:18)(cid:2)(cid:44,Unknown,1986.0
Unknown,Unknown,30,Unknown,Unknown,Unknown,Unknown,cid:43)(cid:2)(cid:1)(cid:34)(cid:34)(cid:19)(cid:18)(cid:18)(cid:2)(cid:44,Unknown,2016.0
Unknown,Unknown,41,Unknown,Unknown,Unknown,Unknown,cid:43)(cid:2)(cid:1)(cid:34)(cid:34)(cid:19)(cid:18)(cid:18)(cid:2)(cid:44,Unknown,2057.0
Unknown,Unknown,2,Unknown,Unknown,Unknown,Unknown,cid:43)(cid:2)(cid:1)(cid:34)(cid:34)(cid:19)(cid:18)(cid:18)(cid:2)(cid:44,Unknown,2059.0
Unknown,Unknown,45,Unknown,Unknown,Unknown,Unknown,cid:43)(cid:2)(cid:1)(cid:34)(cid:34)(cid:19)(cid:18)(cid:18)(cid:2)(cid:44,Unknown,2104.0
Unknown,Unknown,2,Unknown,Unknown,Unknown,Unknown,cid:43)(cid:2)(cid:1)(cid:34)(cid:34)(cid:19)(cid:18)(cid:18)(cid:2)(cid:44,Unknown,2106.0
Unknown,Unknown,28,Unknown,Unknown,Unknown,Unknown,cid:43)(cid:2)(cid:1)(cid:34)(cid:34)(cid:19)(cid:18)(cid:18)(cid:2)(cid:44,Unknown,2134.0
Unknown,Unknown,26,Unknown,Unknown,Unknown,Unknown,cid:43)(cid:2)(cid:1)(cid:34)(cid:34)(cid:19)(cid:18)(cid:18)(cid:2)(cid:44,Unknown,2160.0
Unknown,Unknown,29,Unknown,Unknown,Unknown,Unknown,cid:43)(cid:2)(cid:1)(cid:34)(cid:34)(cid:19)(cid:18)(cid:18)(cid:2)(cid:44,Unknown,2189.0
Unknown,Unknown,24,Unknown,Unknown,Unknown,Unknown,cid:43)(cid:2)(cid:1)(cid:34)(cid:34)(cid:19)(cid:18)(cid:18)(cid:2)(cid:44,Unknown,2213.0
Unknown,Unknown,27,Unknown,Unknown,Unknown,Unknown,cid:43)(cid:2)(cid:1)(cid:34)(cid:34)(cid:19)(cid:18)(cid:18)(cid:2)(cid:44,Unknown,2240.0
Unknown,Unknown,2,Unknown,Unknown,Unknown,Unknown,cid:43)(cid:2)(cid:1)(cid:34)(cid:34)(cid:19)(cid:18)(cid:18)(cid:2)(cid:44,Unknown,2242.0
Unknown,Unknown,29,Unknown,Unknown,Unknown,Unknown,cid:43)(cid:2)(cid:1)(cid:34)(cid:34)(cid:19)(cid:18)(cid:18)(cid:2)(cid:44,Unknown,2271.0
Unknown,Unknown,48,Unknown,Unknown,Unknown,Unknown,cid:43)(cid:2)(cid:1)(cid:34)(cid:34)(cid:19)(cid:18)(cid:18)(cid:2)(cid:44,Unknown,2319.0
Unknown,Unknown,48,Unknown,Unknown,Unknown,Unknown,cid:43)(cid:2)(cid:1)(cid:34)(cid:34)(cid:19)(cid:18)(cid:18)(cid:2)(cid:44,Unknown,2367.0
Unknown,Unknown,24,Unknown,Unknown,Unknown,Unknown,cid:43)(cid:2)(cid:1)(cid:34)(cid:34)(cid:19)(cid:18)(cid:18)(cid:2)(cid:44,Unknown,2391.0
Unknown,Unknown,41,Unknown,Unknown,Unknown,Unknown,cid:43)(cid:2)(cid:1)(cid:34)(cid:34)(cid:19)(cid:18)(cid:18)(cid:2)(cid:44,Unknown,2432.0
Unknown,Unknown,24,Unknown,Unknown,Unknown,Unknown,cid:43)(cid:2)(cid:1)(cid:34)(cid:34)(cid:19)(cid:18)(cid:18)(cid:2)(cid:44,Unknown,2456.0
Unknown,Unknown,20,Unknown,Unknown,Unknown,Unknown,cid:43)(cid:2)(cid:1)(cid:34)(cid:34)(cid:19)(cid:18)(cid:18)(cid:2)(cid:44,Unknown,2476.0
Unknown,Unknown,30,Unknown,Unknown,Unknown,Unknown,cid:43)(cid:2)(cid:1)(cid:34)(cid:34)(cid:19)(cid:18)(cid:18)(cid:2)(cid:44,Unknown,2506.0
Unknown,Unknown,30,Unknown,Unknown,Unknown,Unknown,cid:43)(cid:2)(cid:1)(cid:34)(cid:34)(cid:19)(cid:18)(cid:18)(cid:2)(cid:44,Unknown,2536.0
Unknown,Unknown,25,Unknown,Unknown,Unknown,Unknown,cid:43)(cid:2)(cid:1)(cid:34)(cid:34)(cid:19)(cid:18)(cid:18)(cid:2)(cid:44,Unknown,2561.0
Unknown,Unknown,22,Unknown,Unknown,Unknown,Unknown,cid:43)(cid:2)(cid:1)(cid:34)(cid:34)(cid:19)(cid:18)(cid:18)(cid:2)(cid:44,Unknown,2583.0
Unknown,Unknown,27,Unknown,Unknown,Unknown,Unknown,cid:43)(cid:2)(cid:1)(cid:34)(cid:34)(cid:19)(cid:18)(cid:18)(cid:2)(cid:44,Unknown,2610.0
Unknown,Unknown,17,Unknown,Unknown,Unknown,Unknown,cid:43)(cid:2)(cid:1)(cid:34)(cid:34)(cid:19)(cid:18)(cid:18)(cid:2)(cid:44,Unknown,2627.0
Unknown,Unknown,18,Unknown,Unknown,Unknown,Unknown,cid:43)(cid:2)(cid:1)(cid:34)(cid:34)(cid:19)(cid:18)(cid:18)(cid:2)(cid:44,Unknown,2645.0
Unknown,Unknown,45,Unknown,Unknown,Unknown,Unknown,cid:43)(cid:2)(cid:1)(cid:34)(cid:34)(cid:19)(cid:18)(cid:18)(cid:2)(cid:44,Unknown,2690.0
Unknown,Unknown,18,Unknown,Unknown,Unknown,Unknown,cid:43)(cid:2)(cid:1)(cid:34)(cid:34)(cid:19)(cid:18)(cid:18)(cid:2)(cid:44,Unknown,2708.0
Unknown,Unknown,35,Unknown,Unknown,Unknown,Unknown,cid:43)(cid:2)(cid:1)(cid:34)(cid:34)(cid:19)(cid:18)(cid:18)(cid:2)(cid:44,Unknown,2743.0
Unknown,Unknown,53,Unknown,Unknown,Unknown,Unknown,cid:43)(cid:2)(cid:1)(cid:34)(cid:34)(cid:19)(cid:18)(cid:18)(cid:2)(cid:44,Unknown,2796.0
Unknown,Unknown,3,Unknown,Unknown,Unknown,Unknown,cid:43)(cid:2)(cid:1)(cid:34)(cid:34)(cid:19)(cid:18)(cid:18)(cid:2)(cid:44,Unknown,2799.0
Unknown,Unknown,11,Unknown,Unknown,Unknown,Unknown,cid:43)(cid:2)(cid:1)(cid:34)(cid:34)(cid:19)(cid:18)(cid:18)(cid:2)(cid:44,Unknown,2810.0
Unknown,Unknown,4,Unknown,Unknown,Unknown,Unknown,cid:43)(cid:2)(cid:1)(cid:34)(cid:34)(cid:19)(cid:18)(cid:18)(cid:2)(cid:44,Unknown,2814.0
Unknown,Unknown,39,Unknown,Unknown,Unknown,Unknown,cid:43)(cid:2)(cid:1)(cid:34)(cid:34)(cid:19)(cid:18)(cid:18)(cid:2)(cid:44,Unknown,2853.0
Unknown,Unknown,46,Unknown,Unknown,Unknown,Unknown,cid:43)(cid:2)(cid:1)(cid:34)(cid:34)(cid:19)(cid:18)(cid:18)(cid:2)(cid:44,Unknown,2899.0
Unknown,Unknown,54,Unknown,Unknown,Unknown,Unknown,cid:43)(cid:2)(cid:1)(cid:34)(cid:34)(cid:19)(cid:18)(cid:18)(cid:2)(cid:44,Unknown,2953.0
Unknown,Unknown,46,Unknown,Unknown,Unknown,Unknown,cid:43)(cid:2)(cid:1)(cid:34)(cid:34)(cid:19)(cid:18)(cid:18)(cid:2)(cid:44,Unknown,2999.0
Unknown,Unknown,2,Unknown,Unknown,Unknown,Unknown,cid:43)(cid:2)(cid:1)(cid:34)(cid:34)(cid:19)(cid:18)(cid:18)(cid:2)(cid:44,Unknown,3001.0
Unknown,Unknown,36,Unknown,Unknown,Unknown,Unknown,cid:43)(cid:2)(cid:1)(cid:34)(cid:34)(cid:19)(cid:18)(cid:18)(cid:2)(cid:44,Unknown,3037.0
Unknown,Unknown,18,Unknown,Unknown,Unknown,Unknown,cid:43)(cid:2)(cid:1)(cid:34)(cid:34)(cid:19)(cid:18)(cid:18)(cid:2)(cid:44,Unknown,3055.0
Unknown,Unknown,17,Unknown,Unknown,Unknown,Unknown,cid:43)(cid:2)(cid:1)(cid:34)(cid:34)(cid:19)(cid:18)(cid:18)(cid:2)(cid:44,Unknown,3072.0
Unknown,Unknown,37,Unknown,Unknown,Unknown,Unknown,cid:43)(cid:2)(cid:1)(cid:34)(cid:34)(cid:19)(cid:18)(cid:18)(cid:2)(cid:44,Unknown,3109.0
Unknown,Unknown,16,Unknown,Unknown,Unknown,Unknown,cid:43)(cid:2)(cid:1)(cid:34)(cid:34)(cid:19)(cid:18)(cid:18)(cid:2)(cid:44,Unknown,3125.0
Unknown,Unknown,36,Unknown,Unknown,Unknown,Unknown,cid:43)(cid:2)(cid:1)(cid:34)(cid:34)(cid:19)(cid:18)(cid:18)(cid:2)(cid:44,Unknown,3161.0
Unknown,Unknown,15,Unknown,Unknown,Unknown,Unknown,cid:43)(cid:2)(cid:1)(cid:34)(cid:34)(cid:19)(cid:18)(cid:18)(cid:2)(cid:44,Unknown,3176.0
Unknown,Unknown,2,Unknown,Unknown,Unknown,Unknown,cid:43)(cid:2)(cid:1)(cid:34)(cid:34)(cid:19)(cid:18)(cid:18)(cid:2)(cid:44,Unknown,3178.0
Unknown,Unknown,1,Unknown,Unknown,Unknown,Unknown,cid:43)(cid:2)(cid:1)(cid:34)(cid:34)(cid:19)(cid:18)(cid:18)(cid:2)(cid:44,Unknown,3179.0
Unknown,Unknown,33,Unknown,Unknown,Unknown,Unknown,cid:43)(cid:2)(cid:1)(cid:34)(cid:34)(cid:19)(cid:18)(cid:18)(cid:2)(cid:44,Unknown,3212.0
Unknown,Unknown,19,Unknown,Unknown,Unknown,Unknown,cid:43)(cid:2)(cid:1)(cid:34)(cid:34)(cid:19)(cid:18)(cid:18)(cid:2)(cid:44,Unknown,3231.0
Unknown,Unknown,33,Unknown,Unknown,Unknown,Unknown,cid:43)(cid:2)(cid:1)(cid:34)(cid:34)(cid:19)(cid:18)(cid:18)(cid:2)(cid:44,Unknown,3264.0
Unknown,Unknown,33,Unknown,Unknown,Unknown,Unknown,cid:43)(cid:2)(cid:1)(cid:34)(cid:34)(cid:19)(cid:18)(cid:18)(cid:2)(cid:44,Unknown,3297.0
Unknown,Unknown,2,Unknown,Unknown,Unknown,Unknown,cid:43)(cid:2)(cid:1)(cid:34)(cid:34)(cid:19)(cid:18)(cid:18)(cid:2)(cid:44,Unknown,3299.0
Unknown,Unknown,44,Unknown,Unknown,Unknown,Unknown,cid:43)(cid:2)(cid:1)(cid:34)(cid:34)(cid:19)(cid:18)(cid:18)(cid:2)(cid:44,Unknown,3343.0
Unknown,Unknown,39,Unknown,Unknown,Unknown,Unknown,cid:43)(cid:2)(cid:1)(cid:34)(cid:34)(cid:19)(cid:18)(cid:18)(cid:2)(cid:44,Unknown,3382.0
Unknown,Unknown,18,Unknown,Unknown,Unknown,Unknown,cid:43)(cid:2)(cid:1)(cid:34)(cid:34)(cid:19)(cid:18)(cid:18)(cid:2)(cid:44,Unknown,3400.0
Unknown,Unknown,16,Unknown,Unknown,Unknown,Unknown,cid:43)(cid:2)(cid:1)(cid:34)(cid:34)(cid:19)(cid:18)(cid:18)(cid:2)(cid:44,Unknown,3416.0
Unknown,Unknown,37,Unknown,Unknown,Unknown,Unknown,cid:43)(cid:2)(cid:1)(cid:34)(cid:34)(cid:19)(cid:18)(cid:18)(cid:2)(cid:44,Unknown,3453.0
Unknown,Unknown,18,Unknown,Unknown,Unknown,Unknown,cid:43)(cid:2)(cid:1)(cid:34)(cid:34)(cid:19)(cid:18)(cid:18)(cid:2)(cid:44,Unknown,3471.0
Unknown,Unknown,35,Unknown,Unknown,Unknown,Unknown,cid:43)(cid:2)(cid:1)(cid:34)(cid:34)(cid:19)(cid:18)(cid:18)(cid:2)(cid:44,Unknown,3506.0
Unknown,Unknown,16,Unknown,Unknown,Unknown,Unknown,cid:43)(cid:2)(cid:1)(cid:34)(cid:34)(cid:19)(cid:18)(cid:18)(cid:2)(cid:44,Unknown,3522.0
Unknown,Unknown,17,Unknown,Unknown,Unknown,Unknown,cid:43)(cid:2)(cid:1)(cid:34)(cid:34)(cid:19)(cid:18)(cid:18)(cid:2)(cid:44,Unknown,3539.0
Unknown,Unknown,33,Unknown,Unknown,Unknown,Unknown,cid:43)(cid:2)(cid:1)(cid:34)(cid:34)(cid:19)(cid:18)(cid:18)(cid:2)(cid:44,Unknown,3572.0
Unknown,Unknown,32,Unknown,Unknown,Unknown,Unknown,cid:43)(cid:2)(cid:1)(cid:34)(cid:34)(cid:19)(cid:18)(cid:18)(cid:2)(cid:44,Unknown,3604.0
Unknown,Unknown,2,Unknown,Unknown,Unknown,Unknown,cid:43)(cid:2)(cid:1)(cid:34)(cid:34)(cid:19)(cid:18)(cid:18)(cid:2)(cid:44,Unknown,3606.0
Unknown,Unknown,17,Unknown,Unknown,Unknown,Unknown,cid:43)(cid:2)(cid:1)(cid:34)(cid:34)(cid:19)(cid:18)(cid:18)(cid:2)(cid:44,Unknown,3623.0
Unknown,Unknown,35,Unknown,Unknown,Unknown,Unknown,cid:43)(cid:2)(cid:1)(cid:34)(cid:34)(cid:19)(cid:18)(cid:18)(cid:2)(cid:44,Unknown,3658.0
Unknown,Unknown,37,Unknown,Unknown,Unknown,Unknown,cid:43)(cid:2)(cid:1)(cid:34)(cid:34)(cid:19)(cid:18)(cid:18)(cid:2)(cid:44,Unknown,3695.0
Unknown,Unknown,36,Unknown,Unknown,Unknown,Unknown,cid:43)(cid:2)(cid:1)(cid:34)(cid:34)(cid:19)(cid:18)(cid:18)(cid:2)(cid:44,Unknown,3731.0
Unknown,Unknown,16,Unknown,Unknown,Unknown,Unknown,cid:43)(cid:2)(cid:1)(cid:34)(cid:34)(cid:19)(cid:18)(cid:18)(cid:2)(cid:44,Unknown,3747.0
Unknown,Unknown,36,Unknown,Unknown,Unknown,Unknown,cid:43)(cid:2)(cid:1)(cid:34)(cid:34)(cid:19)(cid:18)(cid:18)(cid:2)(cid:44,Unknown,3783.0
Unknown,Unknown,32,Unknown,Unknown,Unknown,Unknown,cid:43)(cid:2)(cid:1)(cid:34)(cid:34)(cid:19)(cid:18)(cid:18)(cid:2)(cid:44,Unknown,3815.0
Unknown,Unknown,18,Unknown,Unknown,Unknown,Unknown,cid:43)(cid:2)(cid:1)(cid:34)(cid:34)(cid:19)(cid:18)(cid:18)(cid:2)(cid:44,Unknown,3833.0
Unknown,Unknown,18,Unknown,Unknown,Unknown,Unknown,cid:43)(cid:2)(cid:1)(cid:34)(cid:34)(cid:19)(cid:18)(cid:18)(cid:2)(cid:44,Unknown,3851.0
Unknown,Unknown,18,Unknown,Unknown,Unknown,Unknown,cid:43)(cid:2)(cid:1)(cid:34)(cid:34)(cid:19)(cid:18)(cid:18)(cid:2)(cid:44,Unknown,3869.0
Unknown,Unknown,18,Unknown,Unknown,Unknown,Unknown,cid:43)(cid:2)(cid:1)(cid:34)(cid:34)(cid:19)(cid:18)(cid:18)(cid:2)(cid:44,Unknown,3887.0
Unknown,Unknown,18,Unknown,Unknown,Unknown,Unknown,cid:43)(cid:2)(cid:1)(cid:34)(cid:34)(cid:19)(cid:18)(cid:18)(cid:2)(cid:44,Unknown,3905.0
Unknown,Unknown,18,Unknown,Unknown,Unknown,Unknown,cid:43)(cid:2)(cid:1)(cid:34)(cid:34)(cid:19)(cid:18)(cid:18)(cid:2)(cid:44,Unknown,3923.0
Unknown,Unknown,36,Unknown,Unknown,Unknown,Unknown,cid:43)(cid:2)(cid:1)(cid:34)(cid:34)(cid:19)(cid:18)(cid:18)(cid:2)(cid:44,Unknown,3959.0
Unknown,Unknown,17,Unknown,Unknown,Unknown,Unknown,cid:43)(cid:2)(cid:1)(cid:34)(cid:34)(cid:19)(cid:18)(cid:18)(cid:2)(cid:44,Unknown,3976.0
Unknown,Unknown,18,Unknown,Unknown,Unknown,Unknown,cid:43)(cid:2)(cid:1)(cid:34)(cid:34)(cid:19)(cid:18)(cid:18)(cid:2)(cid:44,Unknown,3994.0
Unknown,Unknown,45,Unknown,Unknown,Unknown,Unknown,cid:43)(cid:2)(cid:1)(cid:34)(cid:34)(cid:19)(cid:18)(cid:18)(cid:2)(cid:44,Unknown,4039.0
Unknown,Unknown,18,Unknown,Unknown,Unknown,Unknown,cid:43)(cid:2)(cid:1)(cid:34)(cid:34)(cid:19)(cid:18)(cid:18)(cid:2)(cid:44,Unknown,4057.0
Unknown,Unknown,35,Unknown,Unknown,Unknown,Unknown,cid:43)(cid:2)(cid:1)(cid:34)(cid:34)(cid:19)(cid:18)(cid:18)(cid:2)(cid:44,Unknown,4092.0
Unknown,Unknown,46,Unknown,Unknown,Unknown,Unknown,cid:43)(cid:2)(cid:1)(cid:34)(cid:34)(cid:19)(cid:18)(cid:18)(cid:2)(cid:44,Unknown,4138.0
Unknown,Unknown,14,Unknown,Unknown,Unknown,Unknown,cid:43)(cid:2)(cid:1)(cid:34)(cid:34)(cid:19)(cid:18)(cid:18)(cid:2)(cid:44,Unknown,4152.0
Unknown,Unknown,52,Unknown,Unknown,Unknown,Unknown,cid:43)(cid:2)(cid:1)(cid:34)(cid:34)(cid:19)(cid:18)(cid:18)(cid:2)(cid:44,Unknown,4204.0
Unknown,Unknown,5,Unknown,Unknown,Unknown,Unknown,cid:43)(cid:2)(cid:1)(cid:34)(cid:34)(cid:19)(cid:18)(cid:18)(cid:2)(cid:44,Unknown,4209.0
Unknown,Unknown,9,Unknown,Unknown,Unknown,Unknown,cid:43)(cid:2)(cid:1)(cid:34)(cid:34)(cid:19)(cid:18)(cid:18)(cid:2)(cid:44,Unknown,4218.0
Unknown,Unknown,43,Unknown,Unknown,Unknown,Unknown,cid:43)(cid:2)(cid:1)(cid:34)(cid:34)(cid:19)(cid:18)(cid:18)(cid:2)(cid:44,Unknown,4261.0
Unknown,Unknown,2,Unknown,Unknown,Unknown,Unknown,cid:43)(cid:2)(cid:1)(cid:34)(cid:34)(cid:19)(cid:18)(cid:18)(cid:2)(cid:44,Unknown,4263.0
Unknown,Unknown,1,Unknown,Unknown,Unknown,Unknown,cid:43)(cid:2)(cid:1)(cid:34)(cid:34)(cid:19)(cid:18)(cid:18)(cid:2)(cid:44,Unknown,4264.0
Unknown,Unknown,34,Unknown,Unknown,Unknown,Unknown,cid:43)(cid:2)(cid:1)(cid:34)(cid:34)(cid:19)(cid:18)(cid:18)(cid:2)(cid:44,Unknown,4298.0
Unknown,Unknown,34,Unknown,Unknown,Unknown,Unknown,cid:43)(cid:2)(cid:1)(cid:34)(cid:34)(cid:19)(cid:18)(cid:18)(cid:2)(cid:44,Unknown,4332.0
Unknown,Unknown,19,Unknown,Unknown,Unknown,Unknown,cid:43)(cid:2)(cid:1)(cid:34)(cid:34)(cid:19)(cid:18)(cid:18)(cid:2)(cid:44,Unknown,4351.0
Unknown,Unknown,18,Unknown,Unknown,Unknown,Unknown,cid:43)(cid:2)(cid:1)(cid:34)(cid:34)(cid:19)(cid:18)(cid:18)(cid:2)(cid:44,Unknown,4369.0
Unknown,Unknown,18,Unknown,Unknown,Unknown,Unknown,cid:43)(cid:2)(cid:1)(cid:34)(cid:34)(cid:19)(cid:18)(cid:18)(cid:2)(cid:44,Unknown,4387.0
Unknown,Unknown,2,Unknown,Unknown,Unknown,Unknown,cid:43)(cid:2)(cid:1)(cid:34)(cid:34)(cid:19)(cid:18)(cid:18)(cid:2)(cid:44,Unknown,4389.0
Unknown,Unknown,44,Unknown,Unknown,Unknown,Unknown,cid:43)(cid:2)(cid:1)(cid:34)(cid:34)(cid:19)(cid:18)(cid:18)(cid:2)(cid:44,Unknown,4433.0
Unknown,Unknown,49,Unknown,Unknown,Unknown,Unknown,cid:43)(cid:2)(cid:1)(cid:34)(cid:34)(cid:19)(cid:18)(cid:18)(cid:2)(cid:44,Unknown,4482.0
Unknown,Unknown,42,Unknown,Unknown,Unknown,Unknown,cid:43)(cid:2)(cid:1)(cid:34)(cid:34)(cid:19)(cid:18)(cid:18)(cid:2)(cid:44,Unknown,4524.0
Unknown,Unknown,56,Unknown,Unknown,Unknown,Unknown,cid:43)(cid:2)(cid:1)(cid:34)(cid:34)(cid:19)(cid:18)(cid:18)(cid:2)(cid:44,Unknown,4580.0
Unknown,Unknown,57,Unknown,Unknown,Unknown,Unknown,cid:43)(cid:2)(cid:1)(cid:34)(cid:34)(cid:19)(cid:18)(cid:18)(cid:2)(cid:44,Unknown,4637.0
Unknown,Unknown,41,Unknown,Unknown,Unknown,Unknown,cid:43)(cid:2)(cid:1)(cid:34)(cid:34)(cid:19)(cid:18)(cid:18)(cid:2)(cid:44,Unknown,4678.0
Unknown,Unknown,2,Unknown,Unknown,Unknown,Unknown,cid:43)(cid:2)(cid:1)(cid:34)(cid:34)(cid:19)(cid:18)(cid:18)(cid:2)(cid:44,Unknown,4680.0
Unknown,Unknown,48,Unknown,Unknown,Unknown,Unknown,cid:43)(cid:2)(cid:1)(cid:34)(cid:34)(cid:19)(cid:18)(cid:18)(cid:2)(cid:44,Unknown,4728.0
Unknown,Unknown,25,Unknown,Unknown,Unknown,Unknown,cid:43)(cid:2)(cid:1)(cid:34)(cid:34)(cid:19)(cid:18)(cid:18)(cid:2)(cid:44,Unknown,4753.0
Unknown,Unknown,2,Unknown,Unknown,Unknown,Unknown,cid:43)(cid:2)(cid:1)(cid:34)(cid:34)(cid:19)(cid:18)(cid:18)(cid:2)(cid:44,Unknown,4755.0
Unknown,Unknown,31,Unknown,Unknown,Unknown,Unknown,cid:43)(cid:2)(cid:1)(cid:34)(cid:34)(cid:19)(cid:18)(cid:18)(cid:2)(cid:44,Unknown,4786.0
Unknown,Unknown,58,Unknown,Unknown,Unknown,Unknown,cid:43)(cid:2)(cid:1)(cid:34)(cid:34)(cid:19)(cid:18)(cid:18)(cid:2)(cid:44,Unknown,4844.0
Unknown,Unknown,59,Unknown,Unknown,Unknown,Unknown,cid:43)(cid:2)(cid:1)(cid:34)(cid:34)(cid:19)(cid:18)(cid:18)(cid:2)(cid:44,Unknown,4903.0
Unknown,Unknown,60,Unknown,Unknown,Unknown,Unknown,cid:43)(cid:2)(cid:1)(cid:34)(cid:34)(cid:19)(cid:18)(cid:18)(cid:2)(cid:44,Unknown,4963.0
Unknown,Unknown,21,Unknown,Unknown,Unknown,Unknown,cid:43)(cid:2)(cid:1)(cid:34)(cid:34)(cid:19)(cid:18)(cid:18)(cid:2)(cid:44,Unknown,4984.0
Unknown,Unknown,25,Unknown,Unknown,Unknown,Unknown,cid:43)(cid:2)(cid:1)(cid:34)(cid:34)(cid:19)(cid:18)(cid:18)(cid:2)(cid:44,Unknown,5009.0
Unknown,Unknown,17,Unknown,Unknown,Unknown,Unknown,cid:43)(cid:2)(cid:1)(cid:34)(cid:34)(cid:19)(cid:18)(cid:18)(cid:2)(cid:44,Unknown,5026.0
Unknown,Unknown,18,Unknown,Unknown,Unknown,Unknown,cid:43)(cid:2)(cid:1)(cid:34)(cid:34)(cid:19)(cid:18)(cid:18)(cid:2)(cid:44,Unknown,5044.0
Unknown,Unknown,45,Unknown,Unknown,Unknown,Unknown,cid:43)(cid:2)(cid:1)(cid:34)(cid:34)(cid:19)(cid:18)(cid:18)(cid:2)(cid:44,Unknown,5089.0
Unknown,Unknown,18,Unknown,Unknown,Unknown,Unknown,cid:43)(cid:2)(cid:1)(cid:34)(cid:34)(cid:19)(cid:18)(cid:18)(cid:2)(cid:44,Unknown,5107.0
Unknown,Unknown,35,Unknown,Unknown,Unknown,Unknown,cid:43)(cid:2)(cid:1)(cid:34)(cid:34)(cid:19)(cid:18)(cid:18)(cid:2)(cid:44,Unknown,5142.0
Unknown,Unknown,54,Unknown,Unknown,Unknown,Unknown,cid:43)(cid:2)(cid:1)(cid:34)(cid:34)(cid:19)(cid:18)(cid:18)(cid:2)(cid:44,Unknown,5196.0
Unknown,Unknown,7,Unknown,Unknown,Unknown,Unknown,cid:43)(cid:2)(cid:1)(cid:34)(cid:34)(cid:19)(cid:18)(cid:18)(cid:2)(cid:44,Unknown,5203.0
Unknown,Unknown,5,Unknown,Unknown,Unknown,Unknown,cid:43)(cid:2)(cid:1)(cid:34)(cid:34)(cid:19)(cid:18)(cid:18)(cid:2)(cid:44,Unknown,5208.0
Unknown,Unknown,10,Unknown,Unknown,Unknown,Unknown,cid:43)(cid:2)(cid:1)(cid:34)(cid:34)(cid:19)(cid:18)(cid:18)(cid:2)(cid:44,Unknown,5218.0
Unknown,Unknown,10,Unknown,Unknown,Unknown,Unknown,cid:43)(cid:2)(cid:1)(cid:34)(cid:34)(cid:19)(cid:18)(cid:18)(cid:2)(cid:44,Unknown,5228.0
Unknown,Unknown,5,Unknown,Unknown,Unknown,Unknown,cid:43)(cid:2)(cid:1)(cid:34)(cid:34)(cid:19)(cid:18)(cid:18)(cid:2)(cid:44,Unknown,5233.0
Unknown,Unknown,43,Unknown,Unknown,Unknown,Unknown,cid:43)(cid:2)(cid:1)(cid:34)(cid:34)(cid:19)(cid:18)(cid:18)(cid:2)(cid:44,Unknown,5276.0
Unknown,Unknown,2,Unknown,Unknown,Unknown,Unknown,cid:43)(cid:2)(cid:1)(cid:34)(cid:34)(cid:19)(cid:18)(cid:18)(cid:2)(cid:44,Unknown,5278.0
Unknown,Unknown,37,Unknown,Unknown,Unknown,Unknown,cid:43)(cid:2)(cid:1)(cid:34)(cid:34)(cid:19)(cid:18)(cid:18)(cid:2)(cid:44,Unknown,5315.0
Unknown,Unknown,16,Unknown,Unknown,Unknown,Unknown,cid:43)(cid:2)(cid:1)(cid:34)(cid:34)(cid:19)(cid:18)(cid:18)(cid:2)(cid:44,Unknown,5331.0
Unknown,Unknown,32,Unknown,Unknown,Unknown,Unknown,cid:43)(cid:2)(cid:1)(cid:34)(cid:34)(cid:19)(cid:18)(cid:18)(cid:2)(cid:44,Unknown,5363.0
Unknown,Unknown,19,Unknown,Unknown,Unknown,Unknown,cid:43)(cid:2)(cid:1)(cid:34)(cid:34)(cid:19)(cid:18)(cid:18)(cid:2)(cid:44,Unknown,5382.0
Unknown,Unknown,18,Unknown,Unknown,Unknown,Unknown,cid:43)(cid:2)(cid:1)(cid:34)(cid:34)(cid:19)(cid:18)(cid:18)(cid:2)(cid:44,Unknown,5400.0
Unknown,Unknown,18,Unknown,Unknown,Unknown,Unknown,cid:43)(cid:2)(cid:1)(cid:34)(cid:34)(cid:19)(cid:18)(cid:18)(cid:2)(cid:44,Unknown,5418.0
Unknown,Unknown,2,Unknown,Unknown,Unknown,Unknown,cid:43)(cid:2)(cid:1)(cid:34)(cid:34)(cid:19)(cid:18)(cid:18)(cid:2)(cid:44,Unknown,5420.0
Unknown,Unknown,44,Unknown,Unknown,Unknown,Unknown,cid:43)(cid:2)(cid:1)(cid:34)(cid:34)(cid:19)(cid:18)(cid:18)(cid:2)(cid:44,Unknown,5464.0
Unknown,Unknown,49,Unknown,Unknown,Unknown,Unknown,cid:43)(cid:2)(cid:1)(cid:34)(cid:34)(cid:19)(cid:18)(cid:18)(cid:2)(cid:44,Unknown,5513.0
Unknown,Unknown,42,Unknown,Unknown,Unknown,Unknown,cid:43)(cid:2)(cid:1)(cid:34)(cid:34)(cid:19)(cid:18)(cid:18)(cid:2)(cid:44,Unknown,5555.0
Unknown,Unknown,56,Unknown,Unknown,Unknown,Unknown,cid:43)(cid:2)(cid:1)(cid:34)(cid:34)(cid:19)(cid:18)(cid:18)(cid:2)(cid:44,Unknown,5611.0
Unknown,Unknown,57,Unknown,Unknown,Unknown,Unknown,cid:43)(cid:2)(cid:1)(cid:34)(cid:34)(cid:19)(cid:18)(cid:18)(cid:2)(cid:44,Unknown,5668.0
Unknown,Unknown,41,Unknown,Unknown,Unknown,Unknown,cid:43)(cid:2)(cid:1)(cid:34)(cid:34)(cid:19)(cid:18)(cid:18)(cid:2)(cid:44,Unknown,5709.0
Unknown,Unknown,2,Unknown,Unknown,Unknown,Unknown,cid:43)(cid:2)(cid:1)(cid:34)(cid:34)(cid:19)(cid:18)(cid:18)(cid:2)(cid:44,Unknown,5711.0
Unknown,Unknown,48,Unknown,Unknown,Unknown,Unknown,cid:43)(cid:2)(cid:1)(cid:34)(cid:34)(cid:19)(cid:18)(cid:18)(cid:2)(cid:44,Unknown,5759.0
Unknown,Unknown,25,Unknown,Unknown,Unknown,Unknown,cid:43)(cid:2)(cid:1)(cid:34)(cid:34)(cid:19)(cid:18)(cid:18)(cid:2)(cid:44,Unknown,5784.0
Unknown,Unknown,2,Unknown,Unknown,Unknown,Unknown,cid:43)(cid:2)(cid:1)(cid:34)(cid:34)(cid:19)(cid:18)(cid:18)(cid:2)(cid:44,Unknown,5786.0
Unknown,Unknown,31,Unknown,Unknown,Unknown,Unknown,cid:43)(cid:2)(cid:1)(cid:34)(cid:34)(cid:19)(cid:18)(cid:18)(cid:2)(cid:44,Unknown,5817.0
Unknown,Unknown,58,Unknown,Unknown,Unknown,Unknown,cid:43)(cid:2)(cid:1)(cid:34)(cid:34)(cid:19)(cid:18)(cid:18)(cid:2)(cid:44,Unknown,5875.0
Unknown,Unknown,59,Unknown,Unknown,Unknown,Unknown,cid:43)(cid:2)(cid:1)(cid:34)(cid:34)(cid:19)(cid:18)(cid:18)(cid:2)(cid:44,Unknown,5934.0
Unknown,Unknown,60,Unknown,Unknown,Unknown,Unknown,cid:43)(cid:2)(cid:1)(cid:34)(cid:34)(cid:19)(cid:18)(cid:18)(cid:2)(cid:44,Unknown,5994.0
Unknown,Unknown,21,Unknown,Unknown,Unknown,Unknown,cid:43)(cid:2)(cid:1)(cid:34)(cid:34)(cid:19)(cid:18)(cid:18)(cid:2)(cid:44,Unknown,6015.0
Unknown,Unknown,25,Unknown,Unknown,Unknown,Unknown,cid:43)(cid:2)(cid:1)(cid:34)(cid:34)(cid:19)(cid:18)(cid:18)(cid:2)(cid:44,Unknown,6040.0
Unknown,Unknown,17,Unknown,Unknown,Unknown,Unknown,cid:43)(cid:2)(cid:1)(cid:34)(cid:34)(cid:19)(cid:18)(cid:18)(cid:2)(cid:44,Unknown,6057.0
Unknown,Unknown,18,Unknown,Unknown,Unknown,Unknown,cid:43)(cid:2)(cid:1)(cid:34)(cid:34)(cid:19)(cid:18)(cid:18)(cid:2)(cid:44,Unknown,6075.0
Unknown,Unknown,45,Unknown,Unknown,Unknown,Unknown,cid:43)(cid:2)(cid:1)(cid:34)(cid:34)(cid:19)(cid:18)(cid:18)(cid:2)(cid:44,Unknown,6120.0
Unknown,Unknown,18,Unknown,Unknown,Unknown,Unknown,cid:43)(cid:2)(cid:1)(cid:34)(cid:34)(cid:19)(cid:18)(cid:18)(cid:2)(cid:44,Unknown,6138.0
Unknown,Unknown,35,Unknown,Unknown,Unknown,Unknown,cid:43)(cid:2)(cid:1)(cid:34)(cid:34)(cid:19)(cid:18)(cid:18)(cid:2)(cid:44,Unknown,6173.0
Unknown,Unknown,28,Unknown,Unknown,Unknown,Unknown,cid:43)(cid:2)(cid:1)(cid:34)(cid:34)(cid:19)(cid:18)(cid:18)(cid:2)(cid:44,Unknown,6201.0
Unknown,Unknown,11,Unknown,Unknown,Unknown,Unknown,cid:43)(cid:2)(cid:1)(cid:34)(cid:34)(cid:19)(cid:18)(cid:18)(cid:2)(cid:44,Unknown,6212.0
Unknown,Unknown,4,Unknown,Unknown,Unknown,Unknown,cid:43)(cid:2)(cid:1)(cid:34)(cid:34)(cid:19)(cid:18)(cid:18)(cid:2)(cid:44,Unknown,6216.0
Unknown,Unknown,12,Unknown,Unknown,Unknown,Unknown,cid:43)(cid:2)(cid:1)(cid:34)(cid:34)(cid:19)(cid:18)(cid:18)(cid:2)(cid:44,Unknown,6228.0
Unknown,Unknown,13,Unknown,Unknown,Unknown,Unknown,cid:43)(cid:2)(cid:1)(cid:34)(cid:34)(cid:19)(cid:18)(cid:18)(cid:2)(cid:44,Unknown,6241.0
Unknown,Unknown,5,Unknown,Unknown,Unknown,Unknown,cid:43)(cid:2)(cid:1)(cid:34)(cid:34)(cid:19)(cid:18)(cid:18)(cid:2)(cid:44,Unknown,6246.0
Unknown,Unknown,3,Unknown,Unknown,Unknown,Unknown,cid:43)(cid:2)(cid:1)(cid:34)(cid:34)(cid:19)(cid:18)(cid:18)(cid:2)(cid:44,Unknown,6249.0
Unknown,Unknown,43,Unknown,Unknown,Unknown,Unknown,cid:43)(cid:2)(cid:1)(cid:34)(cid:34)(cid:19)(cid:18)(cid:18)(cid:2)(cid:44,Unknown,6292.0
Unknown,Unknown,2,Unknown,Unknown,Unknown,Unknown,cid:43)(cid:2)(cid:1)(cid:34)(cid:34)(cid:19)(cid:18)(cid:18)(cid:2)(cid:44,Unknown,6294.0
Unknown,Unknown,1,Unknown,Unknown,Unknown,Unknown,cid:43)(cid:2)(cid:1)(cid:34)(cid:34)(cid:19)(cid:18)(cid:18)(cid:2)(cid:44,Unknown,6295.0
Unknown,Unknown,16,Unknown,Unknown,Unknown,Unknown,cid:43)(cid:2)(cid:1)(cid:34)(cid:34)(cid:19)(cid:18)(cid:18)(cid:2)(cid:44,Unknown,6311.0
Unknown,Unknown,34,Unknown,Unknown,Unknown,Unknown,cid:43)(cid:2)(cid:1)(cid:34)(cid:34)(cid:19)(cid:18)(cid:18)(cid:2)(cid:44,Unknown,6345.0
Unknown,Unknown,19,Unknown,Unknown,Unknown,Unknown,cid:43)(cid:2)(cid:1)(cid:34)(cid:34)(cid:19)(cid:18)(cid:18)(cid:2)(cid:44,Unknown,6364.0
Unknown,Unknown,18,Unknown,Unknown,Unknown,Unknown,cid:43)(cid:2)(cid:1)(cid:34)(cid:34)(cid:19)(cid:18)(cid:18)(cid:2)(cid:44,Unknown,6382.0
Unknown,Unknown,18,Unknown,Unknown,Unknown,Unknown,cid:43)(cid:2)(cid:1)(cid:34)(cid:34)(cid:19)(cid:18)(cid:18)(cid:2)(cid:44,Unknown,6400.0
Unknown,Unknown,2,Unknown,Unknown,Unknown,Unknown,cid:43)(cid:2)(cid:1)(cid:34)(cid:34)(cid:19)(cid:18)(cid:18)(cid:2)(cid:44,Unknown,6402.0
Unknown,Unknown,44,Unknown,Unknown,Unknown,Unknown,cid:43)(cid:2)(cid:1)(cid:34)(cid:34)(cid:19)(cid:18)(cid:18)(cid:2)(cid:44,Unknown,6446.0
Unknown,Unknown,49,Unknown,Unknown,Unknown,Unknown,cid:43)(cid:2)(cid:1)(cid:34)(cid:34)(cid:19)(cid:18)(cid:18)(cid:2)(cid:44,Unknown,6495.0
Unknown,Unknown,42,Unknown,Unknown,Unknown,Unknown,cid:43)(cid:2)(cid:1)(cid:34)(cid:34)(cid:19)(cid:18)(cid:18)(cid:2)(cid:44,Unknown,6537.0
Unknown,Unknown,56,Unknown,Unknown,Unknown,Unknown,cid:43)(cid:2)(cid:1)(cid:34)(cid:34)(cid:19)(cid:18)(cid:18)(cid:2)(cid:44,Unknown,6593.0
Unknown,Unknown,57,Unknown,Unknown,Unknown,Unknown,cid:43)(cid:2)(cid:1)(cid:34)(cid:34)(cid:19)(cid:18)(cid:18)(cid:2)(cid:44,Unknown,6650.0
Unknown,Unknown,41,Unknown,Unknown,Unknown,Unknown,cid:43)(cid:2)(cid:1)(cid:34)(cid:34)(cid:19)(cid:18)(cid:18)(cid:2)(cid:44,Unknown,6691.0
Unknown,Unknown,2,Unknown,Unknown,Unknown,Unknown,cid:43)(cid:2)(cid:1)(cid:34)(cid:34)(cid:19)(cid:18)(cid:18)(cid:2)(cid:44,Unknown,6693.0
Unknown,Unknown,48,Unknown,Unknown,Unknown,Unknown,cid:43)(cid:2)(cid:1)(cid:34)(cid:34)(cid:19)(cid:18)(cid:18)(cid:2)(cid:44,Unknown,6741.0
Unknown,Unknown,25,Unknown,Unknown,Unknown,Unknown,cid:43)(cid:2)(cid:1)(cid:34)(cid:34)(cid:19)(cid:18)(cid:18)(cid:2)(cid:44,Unknown,6766.0
Unknown,Unknown,2,Unknown,Unknown,Unknown,Unknown,cid:43)(cid:2)(cid:1)(cid:34)(cid:34)(cid:19)(cid:18)(cid:18)(cid:2)(cid:44,Unknown,6768.0
Unknown,Unknown,31,Unknown,Unknown,Unknown,Unknown,cid:43)(cid:2)(cid:1)(cid:34)(cid:34)(cid:19)(cid:18)(cid:18)(cid:2)(cid:44,Unknown,6799.0
Unknown,Unknown,58,Unknown,Unknown,Unknown,Unknown,cid:43)(cid:2)(cid:1)(cid:34)(cid:34)(cid:19)(cid:18)(cid:18)(cid:2)(cid:44,Unknown,6857.0
Unknown,Unknown,59,Unknown,Unknown,Unknown,Unknown,cid:43)(cid:2)(cid:1)(cid:34)(cid:34)(cid:19)(cid:18)(cid:18)(cid:2)(cid:44,Unknown,6916.0
Unknown,Unknown,60,Unknown,Unknown,Unknown,Unknown,cid:43)(cid:2)(cid:1)(cid:34)(cid:34)(cid:19)(cid:18)(cid:18)(cid:2)(cid:44,Unknown,6976.0
Unknown,Unknown,21,Unknown,Unknown,Unknown,Unknown,cid:43)(cid:2)(cid:1)(cid:34)(cid:34)(cid:19)(cid:18)(cid:18)(cid:2)(cid:44,Unknown,6997.0
Unknown,Unknown,25,Unknown,Unknown,Unknown,Unknown,cid:43)(cid:2)(cid:1)(cid:34)(cid:34)(cid:19)(cid:18)(cid:18)(cid:2)(cid:44,Unknown,7022.0
Unknown,Unknown,17,Unknown,Unknown,Unknown,Unknown,cid:43)(cid:2)(cid:1)(cid:34)(cid:34)(cid:19)(cid:18)(cid:18)(cid:2)(cid:44,Unknown,7039.0
Unknown,Unknown,18,Unknown,Unknown,Unknown,Unknown,cid:43)(cid:2)(cid:1)(cid:34)(cid:34)(cid:19)(cid:18)(cid:18)(cid:2)(cid:44,Unknown,7057.0
Unknown,Unknown,45,Unknown,Unknown,Unknown,Unknown,cid:43)(cid:2)(cid:1)(cid:34)(cid:34)(cid:19)(cid:18)(cid:18)(cid:2)(cid:44,Unknown,7102.0
Unknown,Unknown,18,Unknown,Unknown,Unknown,Unknown,cid:43)(cid:2)(cid:1)(cid:34)(cid:34)(cid:19)(cid:18)(cid:18)(cid:2)(cid:44,Unknown,7120.0
Unknown,Unknown,35,Unknown,Unknown,Unknown,Unknown,cid:43)(cid:2)(cid:1)(cid:34)(cid:34)(cid:19)(cid:18)(cid:18)(cid:2)(cid:44,Unknown,7155.0
Unknown,Unknown,38,Unknown,Unknown,Unknown,Unknown,cid:43)(cid:2)(cid:1)(cid:34)(cid:34)(cid:19)(cid:18)(cid:18)(cid:2)(cid:44,Unknown,7193.0
Unknown,Unknown,20,Unknown,Unknown,Unknown,Unknown,cid:43)(cid:2)(cid:1)(cid:34)(cid:34)(cid:19)(cid:18)(cid:18)(cid:2)(cid:44,Unknown,7213.0
Unknown,Unknown,30,Unknown,Unknown,Unknown,Unknown,cid:43)(cid:2)(cid:1)(cid:34)(cid:34)(cid:19)(cid:18)(cid:18)(cid:2)(cid:44,Unknown,7243.0
Unknown,Unknown,41,Unknown,Unknown,Unknown,Unknown,cid:43)(cid:2)(cid:1)(cid:34)(cid:34)(cid:19)(cid:18)(cid:18)(cid:2)(cid:44,Unknown,7284.0
Unknown,Unknown,20,Unknown,Unknown,Unknown,Unknown,cid:43)(cid:2)(cid:1)(cid:34)(cid:34)(cid:19)(cid:18)(cid:18)(cid:2)(cid:44,Unknown,7304.0
Unknown,Unknown,15,Unknown,Unknown,Unknown,Unknown,cid:43)(cid:2)(cid:1)(cid:34)(cid:34)(cid:19)(cid:18)(cid:18)(cid:2)(cid:44,Unknown,7319.0
Unknown,Unknown,2,Unknown,Unknown,Unknown,Unknown,cid:43)(cid:2)(cid:1)(cid:34)(cid:34)(cid:19)(cid:18)(cid:18)(cid:2)(cid:44,Unknown,7321.0
Unknown,Unknown,1,Unknown,Unknown,Unknown,Unknown,cid:43)(cid:2)(cid:1)(cid:34)(cid:34)(cid:19)(cid:18)(cid:18)(cid:2)(cid:44,Unknown,7322.0
Unknown,Unknown,19,Unknown,Unknown,Unknown,Unknown,cid:43)(cid:2)(cid:1)(cid:34)(cid:34)(cid:19)(cid:18)(cid:18)(cid:2)(cid:44,Unknown,7341.0
Unknown,Unknown,36,Unknown,Unknown,Unknown,Unknown,cid:43)(cid:2)(cid:1)(cid:34)(cid:34)(cid:19)(cid:18)(cid:18)(cid:2)(cid:44,Unknown,7377.0
Unknown,Unknown,18,Unknown,Unknown,Unknown,Unknown,cid:43)(cid:2)(cid:1)(cid:34)(cid:34)(cid:19)(cid:18)(cid:18)(cid:2)(cid:44,Unknown,7395.0
Unknown,Unknown,2,Unknown,Unknown,Unknown,Unknown,cid:43)(cid:2)(cid:1)(cid:34)(cid:34)(cid:19)(cid:18)(cid:18)(cid:2)(cid:44,Unknown,7397.0
Unknown,Unknown,44,Unknown,Unknown,Unknown,Unknown,cid:43)(cid:2)(cid:1)(cid:34)(cid:34)(cid:19)(cid:18)(cid:18)(cid:2)(cid:44,Unknown,7441.0
Unknown,Unknown,46,Unknown,Unknown,Unknown,Unknown,cid:43)(cid:2)(cid:1)(cid:34)(cid:34)(cid:19)(cid:18)(cid:18)(cid:2)(cid:44,Unknown,7487.0
Unknown,Unknown,47,Unknown,Unknown,Unknown,Unknown,cid:43)(cid:2)(cid:1)(cid:34)(cid:34)(cid:19)(cid:18)(cid:18)(cid:2)(cid:44,Unknown,7534.0
Unknown,Unknown,20,Unknown,Unknown,Unknown,Unknown,cid:43)(cid:2)(cid:1)(cid:34)(cid:34)(cid:19)(cid:18)(cid:18)(cid:2)(cid:44,Unknown,7554.0
Unknown,Unknown,30,Unknown,Unknown,Unknown,Unknown,cid:43)(cid:2)(cid:1)(cid:34)(cid:34)(cid:19)(cid:18)(cid:18)(cid:2)(cid:44,Unknown,7584.0
Unknown,Unknown,30,Unknown,Unknown,Unknown,Unknown,cid:43)(cid:2)(cid:1)(cid:34)(cid:34)(cid:19)(cid:18)(cid:18)(cid:2)(cid:44,Unknown,7614.0
Unknown,Unknown,25,Unknown,Unknown,Unknown,Unknown,cid:43)(cid:2)(cid:1)(cid:34)(cid:34)(cid:19)(cid:18)(cid:18)(cid:2)(cid:44,Unknown,7639.0
Unknown,Unknown,23,Unknown,Unknown,Unknown,Unknown,cid:43)(cid:2)(cid:1)(cid:34)(cid:34)(cid:19)(cid:18)(cid:18)(cid:2)(cid:44,Unknown,7662.0
Unknown,Unknown,25,Unknown,Unknown,Unknown,Unknown,cid:43)(cid:2)(cid:1)(cid:34)(cid:34)(cid:19)(cid:18)(cid:18)(cid:2)(cid:44,Unknown,7687.0
Unknown,Unknown,30,Unknown,Unknown,Unknown,Unknown,cid:43)(cid:2)(cid:1)(cid:34)(cid:34)(cid:19)(cid:18)(cid:18)(cid:2)(cid:44,Unknown,7717.0
Unknown,Unknown,41,Unknown,Unknown,Unknown,Unknown,cid:43)(cid:2)(cid:1)(cid:34)(cid:34)(cid:19)(cid:18)(cid:18)(cid:2)(cid:44,Unknown,7758.0
Unknown,Unknown,2,Unknown,Unknown,Unknown,Unknown,cid:43)(cid:2)(cid:1)(cid:34)(cid:34)(cid:19)(cid:18)(cid:18)(cid:2)(cid:44,Unknown,7760.0
Unknown,Unknown,45,Unknown,Unknown,Unknown,Unknown,cid:43)(cid:2)(cid:1)(cid:34)(cid:34)(cid:19)(cid:18)(cid:18)(cid:2)(cid:44,Unknown,7805.0
Unknown,Unknown,2,Unknown,Unknown,Unknown,Unknown,cid:43)(cid:2)(cid:1)(cid:34)(cid:34)(cid:19)(cid:18)(cid:18)(cid:2)(cid:44,Unknown,7807.0
Unknown,Unknown,28,Unknown,Unknown,Unknown,Unknown,cid:43)(cid:2)(cid:1)(cid:34)(cid:34)(cid:19)(cid:18)(cid:18)(cid:2)(cid:44,Unknown,7835.0
Unknown,Unknown,26,Unknown,Unknown,Unknown,Unknown,cid:43)(cid:2)(cid:1)(cid:34)(cid:34)(cid:19)(cid:18)(cid:18)(cid:2)(cid:44,Unknown,7861.0
Unknown,Unknown,29,Unknown,Unknown,Unknown,Unknown,cid:43)(cid:2)(cid:1)(cid:34)(cid:34)(cid:19)(cid:18)(cid:18)(cid:2)(cid:44,Unknown,7890.0
Unknown,Unknown,24,Unknown,Unknown,Unknown,Unknown,cid:43)(cid:2)(cid:1)(cid:34)(cid:34)(cid:19)(cid:18)(cid:18)(cid:2)(cid:44,Unknown,7914.0
Unknown,Unknown,27,Unknown,Unknown,Unknown,Unknown,cid:43)(cid:2)(cid:1)(cid:34)(cid:34)(cid:19)(cid:18)(cid:18)(cid:2)(cid:44,Unknown,7941.0
Unknown,Unknown,2,Unknown,Unknown,Unknown,Unknown,cid:43)(cid:2)(cid:1)(cid:34)(cid:34)(cid:19)(cid:18)(cid:18)(cid:2)(cid:44,Unknown,7943.0
Unknown,Unknown,29,Unknown,Unknown,Unknown,Unknown,cid:43)(cid:2)(cid:1)(cid:34)(cid:34)(cid:19)(cid:18)(cid:18)(cid:2)(cid:44,Unknown,7972.0
Unknown,Unknown,48,Unknown,Unknown,Unknown,Unknown,cid:43)(cid:2)(cid:1)(cid:34)(cid:34)(cid:19)(cid:18)(cid:18)(cid:2)(cid:44,Unknown,8020.0
Unknown,Unknown,48,Unknown,Unknown,Unknown,Unknown,cid:43)(cid:2)(cid:1)(cid:34)(cid:34)(cid:19)(cid:18)(cid:18)(cid:2)(cid:44,Unknown,8068.0
Unknown,Unknown,24,Unknown,Unknown,Unknown,Unknown,cid:43)(cid:2)(cid:1)(cid:34)(cid:34)(cid:19)(cid:18)(cid:18)(cid:2)(cid:44,Unknown,8092.0
Unknown,Unknown,41,Unknown,Unknown,Unknown,Unknown,cid:43)(cid:2)(cid:1)(cid:34)(cid:34)(cid:19)(cid:18)(cid:18)(cid:2)(cid:44,Unknown,8133.0
Unknown,Unknown,24,Unknown,Unknown,Unknown,Unknown,cid:43)(cid:2)(cid:1)(cid:34)(cid:34)(cid:19)(cid:18)(cid:18)(cid:2)(cid:44,Unknown,8157.0
Unknown,Unknown,20,Unknown,Unknown,Unknown,Unknown,cid:43)(cid:2)(cid:1)(cid:34)(cid:34)(cid:19)(cid:18)(cid:18)(cid:2)(cid:44,Unknown,8177.0
Unknown,Unknown,30,Unknown,Unknown,Unknown,Unknown,cid:43)(cid:2)(cid:1)(cid:34)(cid:34)(cid:19)(cid:18)(cid:18)(cid:2)(cid:44,Unknown,8207.0
Unknown,Unknown,30,Unknown,Unknown,Unknown,Unknown,cid:43)(cid:2)(cid:1)(cid:34)(cid:34)(cid:19)(cid:18)(cid:18)(cid:2)(cid:44,Unknown,8237.0
Unknown,Unknown,25,Unknown,Unknown,Unknown,Unknown,cid:43)(cid:2)(cid:1)(cid:34)(cid:34)(cid:19)(cid:18)(cid:18)(cid:2)(cid:44,Unknown,8262.0
Unknown,Unknown,22,Unknown,Unknown,Unknown,Unknown,cid:43)(cid:2)(cid:1)(cid:34)(cid:34)(cid:19)(cid:18)(cid:18)(cid:2)(cid:44,Unknown,8284.0
Unknown,Unknown,27,Unknown,Unknown,Unknown,Unknown,cid:43)(cid:2)(cid:1)(cid:34)(cid:34)(cid:19)(cid:18)(cid:18)(cid:2)(cid:44,Unknown,8311.0
Unknown,Unknown,17,Unknown,Unknown,Unknown,Unknown,cid:43)(cid:2)(cid:1)(cid:34)(cid:34)(cid:19)(cid:18)(cid:18)(cid:2)(cid:44,Unknown,8328.0
Unknown,Unknown,18,Unknown,Unknown,Unknown,Unknown,cid:43)(cid:2)(cid:1)(cid:34)(cid:34)(cid:19)(cid:18)(cid:18)(cid:2)(cid:44,Unknown,8346.0
Unknown,Unknown,45,Unknown,Unknown,Unknown,Unknown,cid:43)(cid:2)(cid:1)(cid:34)(cid:34)(cid:19)(cid:18)(cid:18)(cid:2)(cid:44,Unknown,8391.0
Unknown,Unknown,18,Unknown,Unknown,Unknown,Unknown,cid:43)(cid:2)(cid:1)(cid:34)(cid:34)(cid:19)(cid:18)(cid:18)(cid:2)(cid:44,Unknown,8409.0
Unknown,Unknown,35,Unknown,Unknown,Unknown,Unknown,cid:43)(cid:2)(cid:1)(cid:34)(cid:34)(cid:19)(cid:18)(cid:18)(cid:2)(cid:44,Unknown,8444.0
Unknown,Unknown,38,Unknown,Unknown,Unknown,Unknown,cid:43)(cid:2)(cid:1)(cid:34)(cid:34)(cid:19)(cid:18)(cid:18)(cid:2)(cid:44,Unknown,8482.0
Unknown,Unknown,20,Unknown,Unknown,Unknown,Unknown,cid:43)(cid:2)(cid:1)(cid:34)(cid:34)(cid:19)(cid:18)(cid:18)(cid:2)(cid:44,Unknown,8502.0
Unknown,Unknown,30,Unknown,Unknown,Unknown,Unknown,cid:43)(cid:2)(cid:1)(cid:34)(cid:34)(cid:19)(cid:18)(cid:18)(cid:2)(cid:44,Unknown,8532.0
Unknown,Unknown,41,Unknown,Unknown,Unknown,Unknown,cid:43)(cid:2)(cid:1)(cid:34)(cid:34)(cid:19)(cid:18)(cid:18)(cid:2)(cid:44,Unknown,8573.0
Unknown,Unknown,20,Unknown,Unknown,Unknown,Unknown,cid:43)(cid:2)(cid:1)(cid:34)(cid:34)(cid:19)(cid:18)(cid:18)(cid:2)(cid:44,Unknown,8593.0
Unknown,Unknown,15,Unknown,Unknown,Unknown,Unknown,cid:43)(cid:2)(cid:1)(cid:34)(cid:34)(cid:19)(cid:18)(cid:18)(cid:2)(cid:44,Unknown,8608.0
Unknown,Unknown,2,Unknown,Unknown,Unknown,Unknown,cid:43)(cid:2)(cid:1)(cid:34)(cid:34)(cid:19)(cid:18)(cid:18)(cid:2)(cid:44,Unknown,8610.0
Unknown,Unknown,1,Unknown,Unknown,Unknown,Unknown,cid:43)(cid:2)(cid:1)(cid:34)(cid:34)(cid:19)(cid:18)(cid:18)(cid:2)(cid:44,Unknown,8611.0
Unknown,Unknown,19,Unknown,Unknown,Unknown,Unknown,cid:43)(cid:2)(cid:1)(cid:34)(cid:34)(cid:19)(cid:18)(cid:18)(cid:2)(cid:44,Unknown,8630.0
Unknown,Unknown,36,Unknown,Unknown,Unknown,Unknown,cid:43)(cid:2)(cid:1)(cid:34)(cid:34)(cid:19)(cid:18)(cid:18)(cid:2)(cid:44,Unknown,8666.0
Unknown,Unknown,18,Unknown,Unknown,Unknown,Unknown,cid:43)(cid:2)(cid:1)(cid:34)(cid:34)(cid:19)(cid:18)(cid:18)(cid:2)(cid:44,Unknown,8684.0
Unknown,Unknown,2,Unknown,Unknown,Unknown,Unknown,cid:43)(cid:2)(cid:1)(cid:34)(cid:34)(cid:19)(cid:18)(cid:18)(cid:2)(cid:44,Unknown,8686.0
Unknown,Unknown,44,Unknown,Unknown,Unknown,Unknown,cid:43)(cid:2)(cid:1)(cid:34)(cid:34)(cid:19)(cid:18)(cid:18)(cid:2)(cid:44,Unknown,8730.0
Unknown,Unknown,46,Unknown,Unknown,Unknown,Unknown,cid:43)(cid:2)(cid:1)(cid:34)(cid:34)(cid:19)(cid:18)(cid:18)(cid:2)(cid:44,Unknown,8776.0
Unknown,Unknown,47,Unknown,Unknown,Unknown,Unknown,cid:43)(cid:2)(cid:1)(cid:34)(cid:34)(cid:19)(cid:18)(cid:18)(cid:2)(cid:44,Unknown,8823.0
Unknown,Unknown,20,Unknown,Unknown,Unknown,Unknown,cid:43)(cid:2)(cid:1)(cid:34)(cid:34)(cid:19)(cid:18)(cid:18)(cid:2)(cid:44,Unknown,8843.0
Unknown,Unknown,30,Unknown,Unknown,Unknown,Unknown,cid:43)(cid:2)(cid:1)(cid:34)(cid:34)(cid:19)(cid:18)(cid:18)(cid:2)(cid:44,Unknown,8873.0
Unknown,Unknown,30,Unknown,Unknown,Unknown,Unknown,cid:43)(cid:2)(cid:1)(cid:34)(cid:34)(cid:19)(cid:18)(cid:18)(cid:2)(cid:44,Unknown,8903.0
Unknown,Unknown,25,Unknown,Unknown,Unknown,Unknown,cid:43)(cid:2)(cid:1)(cid:34)(cid:34)(cid:19)(cid:18)(cid:18)(cid:2)(cid:44,Unknown,8928.0
Unknown,Unknown,23,Unknown,Unknown,Unknown,Unknown,cid:43)(cid:2)(cid:1)(cid:34)(cid:34)(cid:19)(cid:18)(cid:18)(cid:2)(cid:44,Unknown,8951.0
Unknown,Unknown,25,Unknown,Unknown,Unknown,Unknown,cid:43)(cid:2)(cid:1)(cid:34)(cid:34)(cid:19)(cid:18)(cid:18)(cid:2)(cid:44,Unknown,8976.0
Unknown,Unknown,30,Unknown,Unknown,Unknown,Unknown,cid:43)(cid:2)(cid:1)(cid:34)(cid:34)(cid:19)(cid:18)(cid:18)(cid:2)(cid:44,Unknown,9006.0
Unknown,Unknown,41,Unknown,Unknown,Unknown,Unknown,cid:43)(cid:2)(cid:1)(cid:34)(cid:34)(cid:19)(cid:18)(cid:18)(cid:2)(cid:44,Unknown,9047.0
Unknown,Unknown,2,Unknown,Unknown,Unknown,Unknown,cid:43)(cid:2)(cid:1)(cid:34)(cid:34)(cid:19)(cid:18)(cid:18)(cid:2)(cid:44,Unknown,9049.0
Unknown,Unknown,45,Unknown,Unknown,Unknown,Unknown,cid:43)(cid:2)(cid:1)(cid:34)(cid:34)(cid:19)(cid:18)(cid:18)(cid:2)(cid:44,Unknown,9094.0
Unknown,Unknown,2,Unknown,Unknown,Unknown,Unknown,cid:43)(cid:2)(cid:1)(cid:34)(cid:34)(cid:19)(cid:18)(cid:18)(cid:2)(cid:44,Unknown,9096.0
Unknown,Unknown,28,Unknown,Unknown,Unknown,Unknown,cid:43)(cid:2)(cid:1)(cid:34)(cid:34)(cid:19)(cid:18)(cid:18)(cid:2)(cid:44,Unknown,9124.0
Unknown,Unknown,26,Unknown,Unknown,Unknown,Unknown,cid:43)(cid:2)(cid:1)(cid:34)(cid:34)(cid:19)(cid:18)(cid:18)(cid:2)(cid:44,Unknown,9150.0
Unknown,Unknown,29,Unknown,Unknown,Unknown,Unknown,cid:43)(cid:2)(cid:1)(cid:34)(cid:34)(cid:19)(cid:18)(cid:18)(cid:2)(cid:44,Unknown,9179.0
Unknown,Unknown,24,Unknown,Unknown,Unknown,Unknown,cid:43)(cid:2)(cid:1)(cid:34)(cid:34)(cid:19)(cid:18)(cid:18)(cid:2)(cid:44,Unknown,9203.0
Unknown,Unknown,27,Unknown,Unknown,Unknown,Unknown,cid:43)(cid:2)(cid:1)(cid:34)(cid:34)(cid:19)(cid:18)(cid:18)(cid:2)(cid:44,Unknown,9230.0
Unknown,Unknown,2,Unknown,Unknown,Unknown,Unknown,cid:43)(cid:2)(cid:1)(cid:34)(cid:34)(cid:19)(cid:18)(cid:18)(cid:2)(cid:44,Unknown,9232.0
Unknown,Unknown,29,Unknown,Unknown,Unknown,Unknown,cid:43)(cid:2)(cid:1)(cid:34)(cid:34)(cid:19)(cid:18)(cid:18)(cid:2)(cid:44,Unknown,9261.0
Unknown,Unknown,48,Unknown,Unknown,Unknown,Unknown,cid:43)(cid:2)(cid:1)(cid:34)(cid:34)(cid:19)(cid:18)(cid:18)(cid:2)(cid:44,Unknown,9309.0
Unknown,Unknown,48,Unknown,Unknown,Unknown,Unknown,cid:43)(cid:2)(cid:1)(cid:34)(cid:34)(cid:19)(cid:18)(cid:18)(cid:2)(cid:44,Unknown,9357.0
Unknown,Unknown,24,Unknown,Unknown,Unknown,Unknown,cid:43)(cid:2)(cid:1)(cid:34)(cid:34)(cid:19)(cid:18)(cid:18)(cid:2)(cid:44,Unknown,9381.0
Unknown,Unknown,41,Unknown,Unknown,Unknown,Unknown,cid:43)(cid:2)(cid:1)(cid:34)(cid:34)(cid:19)(cid:18)(cid:18)(cid:2)(cid:44,Unknown,9422.0
Unknown,Unknown,24,Unknown,Unknown,Unknown,Unknown,cid:43)(cid:2)(cid:1)(cid:34)(cid:34)(cid:19)(cid:18)(cid:18)(cid:2)(cid:44,Unknown,9446.0
Unknown,Unknown,20,Unknown,Unknown,Unknown,Unknown,cid:43)(cid:2)(cid:1)(cid:34)(cid:34)(cid:19)(cid:18)(cid:18)(cid:2)(cid:44,Unknown,9466.0
Unknown,Unknown,30,Unknown,Unknown,Unknown,Unknown,cid:43)(cid:2)(cid:1)(cid:34)(cid:34)(cid:19)(cid:18)(cid:18)(cid:2)(cid:44,Unknown,9496.0
Unknown,Unknown,30,Unknown,Unknown,Unknown,Unknown,cid:43)(cid:2)(cid:1)(cid:34)(cid:34)(cid:19)(cid:18)(cid:18)(cid:2)(cid:44,Unknown,9526.0
Unknown,Unknown,25,Unknown,Unknown,Unknown,Unknown,cid:43)(cid:2)(cid:1)(cid:34)(cid:34)(cid:19)(cid:18)(cid:18)(cid:2)(cid:44,Unknown,9551.0
Unknown,Unknown,22,Unknown,Unknown,Unknown,Unknown,cid:43)(cid:2)(cid:1)(cid:34)(cid:34)(cid:19)(cid:18)(cid:18)(cid:2)(cid:44,Unknown,9573.0
Unknown,Unknown,27,Unknown,Unknown,Unknown,Unknown,cid:43)(cid:2)(cid:1)(cid:34)(cid:34)(cid:19)(cid:18)(cid:18)(cid:2)(cid:44,Unknown,9600.0
Unknown,Unknown,17,Unknown,Unknown,Unknown,Unknown,cid:43)(cid:2)(cid:1)(cid:34)(cid:34)(cid:19)(cid:18)(cid:18)(cid:2)(cid:44,Unknown,9617.0
Unknown,Unknown,18,Unknown,Unknown,Unknown,Unknown,cid:43)(cid:2)(cid:1)(cid:34)(cid:34)(cid:19)(cid:18)(cid:18)(cid:2)(cid:44,Unknown,9635.0
Unknown,Unknown,45,Unknown,Unknown,Unknown,Unknown,cid:43)(cid:2)(cid:1)(cid:34)(cid:34)(cid:19)(cid:18)(cid:18)(cid:2)(cid:44,Unknown,9680.0
Unknown,Unknown,18,Unknown,Unknown,Unknown,Unknown,cid:43)(cid:2)(cid:1)(cid:34)(cid:34)(cid:19)(cid:18)(cid:18)(cid:2)(cid:44,Unknown,9698.0
Unknown,Unknown,35,Unknown,Unknown,Unknown,Unknown,cid:43)(cid:2)(cid:1)(cid:34)(cid:34)(cid:19)(cid:18)(cid:18)(cid:2)(cid:44,Unknown,9733.0
Unknown,Unknown,38,Unknown,Unknown,Unknown,Unknown,cid:43)(cid:2)(cid:1)(cid:34)(cid:34)(cid:19)(cid:18)(cid:18)(cid:2)(cid:44,Unknown,9771.0
Unknown,Unknown,20,Unknown,Unknown,Unknown,Unknown,cid:43)(cid:2)(cid:1)(cid:34)(cid:34)(cid:19)(cid:18)(cid:18)(cid:2)(cid:44,Unknown,9791.0
Unknown,Unknown,30,Unknown,Unknown,Unknown,Unknown,cid:43)(cid:2)(cid:1)(cid:34)(cid:34)(cid:19)(cid:18)(cid:18)(cid:2)(cid:44,Unknown,9821.0
Unknown,Unknown,41,Unknown,Unknown,Unknown,Unknown,cid:43)(cid:2)(cid:1)(cid:34)(cid:34)(cid:19)(cid:18)(cid:18)(cid:2)(cid:44,Unknown,9862.0
Unknown,Unknown,20,Unknown,Unknown,Unknown,Unknown,cid:43)(cid:2)(cid:1)(cid:34)(cid:34)(cid:19)(cid:18)(cid:18)(cid:2)(cid:44,Unknown,9882.0
Unknown,Unknown,15,Unknown,Unknown,Unknown,Unknown,cid:43)(cid:2)(cid:1)(cid:34)(cid:34)(cid:19)(cid:18)(cid:18)(cid:2)(cid:44,Unknown,9897.0
Unknown,Unknown,2,Unknown,Unknown,Unknown,Unknown,cid:43)(cid:2)(cid:1)(cid:34)(cid:34)(cid:19)(cid:18)(cid:18)(cid:2)(cid:44,Unknown,9899.0
Unknown,Unknown,1,Unknown,Unknown,Unknown,Unknown,cid:43)(cid:2)(cid:1)(cid:34)(cid:34)(cid:19)(cid:18)(cid:18)(cid:2)(cid:44,Unknown,9900.0
Unknown,Unknown,19,Unknown,Unknown,Unknown,Unknown,cid:43)(cid:2)(cid:1)(cid:34)(cid:34)(cid:19)(cid:18)(cid:18)(cid:2)(cid:44,Unknown,9919.0
Unknown,Unknown,36,Unknown,Unknown,Unknown,Unknown,cid:43)(cid:2)(cid:1)(cid:34)(cid:34)(cid:19)(cid:18)(cid:18)(cid:2)(cid:44,Unknown,9955.0
Unknown,Unknown,18,Unknown,Unknown,Unknown,Unknown,cid:43)(cid:2)(cid:1)(cid:34)(cid:34)(cid:19)(cid:18)(cid:18)(cid:2)(cid:44,Unknown,9973.0
Unknown,Unknown,2,Unknown,Unknown,Unknown,Unknown,cid:43)(cid:2)(cid:1)(cid:34)(cid:34)(cid:19)(cid:18)(cid:18)(cid:2)(cid:44,Unknown,9975.0
Unknown,Unknown,44,Unknown,Unknown,Unknown,Unknown,cid:43)(cid:2)(cid:1)(cid:34)(cid:34)(cid:19)(cid:18)(cid:18)(cid:2)(cid:44,Unknown,10019.0
Unknown,Unknown,46,Unknown,Unknown,Unknown,Unknown,cid:43)(cid:2)(cid:1)(cid:34)(cid:34)(cid:19)(cid:18)(cid:18)(cid:2)(cid:44,Unknown,10065.0
Unknown,Unknown,47,Unknown,Unknown,Unknown,Unknown,cid:43)(cid:2)(cid:1)(cid:34)(cid:34)(cid:19)(cid:18)(cid:18)(cid:2)(cid:44,Unknown,10112.0
Unknown,Unknown,20,Unknown,Unknown,Unknown,Unknown,cid:43)(cid:2)(cid:1)(cid:34)(cid:34)(cid:19)(cid:18)(cid:18)(cid:2)(cid:44,Unknown,10132.0
Unknown,Unknown,30,Unknown,Unknown,Unknown,Unknown,cid:43)(cid:2)(cid:1)(cid:34)(cid:34)(cid:19)(cid:18)(cid:18)(cid:2)(cid:44,Unknown,10162.0
Unknown,Unknown,30,Unknown,Unknown,Unknown,Unknown,cid:43)(cid:2)(cid:1)(cid:34)(cid:34)(cid:19)(cid:18)(cid:18)(cid:2)(cid:44,Unknown,10192.0
Unknown,Unknown,25,Unknown,Unknown,Unknown,Unknown,cid:43)(cid:2)(cid:1)(cid:34)(cid:34)(cid:19)(cid:18)(cid:18)(cid:2)(cid:44,Unknown,10217.0
Unknown,Unknown,23,Unknown,Unknown,Unknown,Unknown,cid:43)(cid:2)(cid:1)(cid:34)(cid:34)(cid:19)(cid:18)(cid:18)(cid:2)(cid:44,Unknown,10240.0
Unknown,Unknown,25,Unknown,Unknown,Unknown,Unknown,cid:43)(cid:2)(cid:1)(cid:34)(cid:34)(cid:19)(cid:18)(cid:18)(cid:2)(cid:44,Unknown,10265.0
Unknown,Unknown,30,Unknown,Unknown,Unknown,Unknown,cid:43)(cid:2)(cid:1)(cid:34)(cid:34)(cid:19)(cid:18)(cid:18)(cid:2)(cid:44,Unknown,10295.0
Unknown,Unknown,41,Unknown,Unknown,Unknown,Unknown,cid:43)(cid:2)(cid:1)(cid:34)(cid:34)(cid:19)(cid:18)(cid:18)(cid:2)(cid:44,Unknown,10336.0
Unknown,Unknown,2,Unknown,Unknown,Unknown,Unknown,cid:43)(cid:2)(cid:1)(cid:34)(cid:34)(cid:19)(cid:18)(cid:18)(cid:2)(cid:44,Unknown,10338.0
Unknown,Unknown,45,Unknown,Unknown,Unknown,Unknown,cid:43)(cid:2)(cid:1)(cid:34)(cid:34)(cid:19)(cid:18)(cid:18)(cid:2)(cid:44,Unknown,10383.0
Unknown,Unknown,2,Unknown,Unknown,Unknown,Unknown,cid:43)(cid:2)(cid:1)(cid:34)(cid:34)(cid:19)(cid:18)(cid:18)(cid:2)(cid:44,Unknown,10385.0
Unknown,Unknown,28,Unknown,Unknown,Unknown,Unknown,cid:43)(cid:2)(cid:1)(cid:34)(cid:34)(cid:19)(cid:18)(cid:18)(cid:2)(cid:44,Unknown,10413.0
Unknown,Unknown,26,Unknown,Unknown,Unknown,Unknown,cid:43)(cid:2)(cid:1)(cid:34)(cid:34)(cid:19)(cid:18)(cid:18)(cid:2)(cid:44,Unknown,10439.0
Unknown,Unknown,29,Unknown,Unknown,Unknown,Unknown,cid:43)(cid:2)(cid:1)(cid:34)(cid:34)(cid:19)(cid:18)(cid:18)(cid:2)(cid:44,Unknown,10468.0
Unknown,Unknown,24,Unknown,Unknown,Unknown,Unknown,cid:43)(cid:2)(cid:1)(cid:34)(cid:34)(cid:19)(cid:18)(cid:18)(cid:2)(cid:44,Unknown,10492.0
Unknown,Unknown,27,Unknown,Unknown,Unknown,Unknown,cid:43)(cid:2)(cid:1)(cid:34)(cid:34)(cid:19)(cid:18)(cid:18)(cid:2)(cid:44,Unknown,10519.0
Unknown,Unknown,2,Unknown,Unknown,Unknown,Unknown,cid:43)(cid:2)(cid:1)(cid:34)(cid:34)(cid:19)(cid:18)(cid:18)(cid:2)(cid:44,Unknown,10521.0
Unknown,Unknown,29,Unknown,Unknown,Unknown,Unknown,cid:43)(cid:2)(cid:1)(cid:34)(cid:34)(cid:19)(cid:18)(cid:18)(cid:2)(cid:44,Unknown,10550.0
Unknown,Unknown,48,Unknown,Unknown,Unknown,Unknown,cid:43)(cid:2)(cid:1)(cid:34)(cid:34)(cid:19)(cid:18)(cid:18)(cid:2)(cid:44,Unknown,10598.0
Unknown,Unknown,48,Unknown,Unknown,Unknown,Unknown,cid:43)(cid:2)(cid:1)(cid:34)(cid:34)(cid:19)(cid:18)(cid:18)(cid:2)(cid:44,Unknown,10646.0
Unknown,Unknown,24,Unknown,Unknown,Unknown,Unknown,cid:43)(cid:2)(cid:1)(cid:34)(cid:34)(cid:19)(cid:18)(cid:18)(cid:2)(cid:44,Unknown,10670.0
Unknown,Unknown,41,Unknown,Unknown,Unknown,Unknown,cid:43)(cid:2)(cid:1)(cid:34)(cid:34)(cid:19)(cid:18)(cid:18)(cid:2)(cid:44,Unknown,10711.0
Unknown,Unknown,24,Unknown,Unknown,Unknown,Unknown,cid:43)(cid:2)(cid:1)(cid:34)(cid:34)(cid:19)(cid:18)(cid:18)(cid:2)(cid:44,Unknown,10735.0
Unknown,Unknown,20,Unknown,Unknown,Unknown,Unknown,cid:43)(cid:2)(cid:1)(cid:34)(cid:34)(cid:19)(cid:18)(cid:18)(cid:2)(cid:44,Unknown,10755.0
Unknown,Unknown,30,Unknown,Unknown,Unknown,Unknown,cid:43)(cid:2)(cid:1)(cid:34)(cid:34)(cid:19)(cid:18)(cid:18)(cid:2)(cid:44,Unknown,10785.0
Unknown,Unknown,30,Unknown,Unknown,Unknown,Unknown,cid:43)(cid:2)(cid:1)(cid:34)(cid:34)(cid:19)(cid:18)(cid:18)(cid:2)(cid:44,Unknown,10815.0
Unknown,Unknown,25,Unknown,Unknown,Unknown,Unknown,cid:43)(cid:2)(cid:1)(cid:34)(cid:34)(cid:19)(cid:18)(cid:18)(cid:2)(cid:44,Unknown,10840.0
Unknown,Unknown,22,Unknown,Unknown,Unknown,Unknown,cid:43)(cid:2)(cid:1)(cid:34)(cid:34)(cid:19)(cid:18)(cid:18)(cid:2)(cid:44,Unknown,10862.0
Unknown,Unknown,27,Unknown,Unknown,Unknown,Unknown,cid:43)(cid:2)(cid:1)(cid:34)(cid:34)(cid:19)(cid:18)(cid:18)(cid:2)(cid:44,Unknown,10889.0
Unknown,Unknown,17,Unknown,Unknown,Unknown,Unknown,cid:43)(cid:2)(cid:1)(cid:34)(cid:34)(cid:19)(cid:18)(cid:18)(cid:2)(cid:44,Unknown,10906.0
Unknown,Unknown,17,Unknown,Unknown,Unknown,Unknown,cid:43)(cid:2)(cid:1)(cid:34)(cid:34)(cid:19)(cid:18)(cid:18)(cid:2)(cid:44,Unknown,10923.0
Unknown,Unknown,45,Unknown,Unknown,Unknown,Unknown,cid:43)(cid:2)(cid:1)(cid:34)(cid:34)(cid:19)(cid:18)(cid:18)(cid:2)(cid:44,Unknown,10968.0
Unknown,Unknown,18,Unknown,Unknown,Unknown,Unknown,cid:43)(cid:2)(cid:1)(cid:34)(cid:34)(cid:19)(cid:18)(cid:18)(cid:2)(cid:44,Unknown,10986.0
Unknown,Unknown,35,Unknown,Unknown,Unknown,Unknown,cid:43)(cid:2)(cid:1)(cid:34)(cid:34)(cid:19)(cid:18)(cid:18)(cid:2)(cid:44,Unknown,11021.0
Unknown,Unknown,9,Unknown,Unknown,Unknown,Unknown,cid:43)(cid:2)(cid:1)(cid:34)(cid:34)(cid:19)(cid:18)(cid:18)(cid:2)(cid:44,Unknown,11030.0
Unknown,Unknown,46,Unknown,Unknown,Unknown,Unknown,cid:43)(cid:2)(cid:1)(cid:34)(cid:34)(cid:19)(cid:18)(cid:18)(cid:2)(cid:44,Unknown,11076.0
Unknown,Unknown,8,Unknown,Unknown,Unknown,Unknown,cid:43)(cid:2)(cid:1)(cid:34)(cid:34)(cid:19)(cid:18)(cid:18)(cid:2)(cid:44,Unknown,11084.0
Unknown,Unknown,5,Unknown,Unknown,Unknown,Unknown,cid:43)(cid:2)(cid:1)(cid:34)(cid:34)(cid:19)(cid:18)(cid:18)(cid:2)(cid:44,Unknown,11089.0
Unknown,Unknown,28,Unknown,Unknown,Unknown,Unknown,cid:43)(cid:2)(cid:1)(cid:34)(cid:34)(cid:19)(cid:18)(cid:18)(cid:2)(cid:44,Unknown,11117.0
Unknown,Unknown,2,Unknown,Unknown,Unknown,Unknown,cid:43)(cid:2)(cid:1)(cid:34)(cid:34)(cid:19)(cid:18)(cid:18)(cid:2)(cid:44,Unknown,11119.0
Unknown,Unknown,9,Unknown,Unknown,Unknown,Unknown,cid:43)(cid:2)(cid:1)(cid:34)(cid:34)(cid:19)(cid:18)(cid:18)(cid:2)(cid:44,Unknown,11128.0
Unknown,Unknown,5,Unknown,Unknown,Unknown,Unknown,cid:43)(cid:2)(cid:1)(cid:34)(cid:34)(cid:19)(cid:18)(cid:18)(cid:2)(cid:44,Unknown,11133.0
Unknown,Unknown,8,Unknown,Unknown,Unknown,Unknown,cid:43)(cid:2)(cid:1)(cid:34)(cid:34)(cid:19)(cid:18)(cid:18)(cid:2)(cid:44,Unknown,11141.0
Unknown,Unknown,14,Unknown,Unknown,Unknown,Unknown,cid:43)(cid:2)(cid:1)(cid:34)(cid:34)(cid:19)(cid:18)(cid:18)(cid:2)(cid:44,Unknown,11155.0
Unknown,Unknown,7,Unknown,Unknown,Unknown,Unknown,cid:43)(cid:2)(cid:1)(cid:34)(cid:34)(cid:19)(cid:18)(cid:18)(cid:2)(cid:44,Unknown,11162.0
Unknown,Unknown,9,Unknown,Unknown,Unknown,Unknown,cid:43)(cid:2)(cid:1)(cid:34)(cid:34)(cid:19)(cid:18)(cid:18)(cid:2)(cid:44,Unknown,11171.0
Unknown,Unknown,2,Unknown,Unknown,Unknown,Unknown,cid:43)(cid:2)(cid:1)(cid:34)(cid:34)(cid:19)(cid:18)(cid:18)(cid:2)(cid:44,Unknown,11173.0
Unknown,Unknown,28,Unknown,Unknown,Unknown,Unknown,cid:43)(cid:2)(cid:1)(cid:34)(cid:34)(cid:19)(cid:18)(cid:18)(cid:2)(cid:44,Unknown,11201.0
Unknown,Unknown,3,Unknown,Unknown,Unknown,Unknown,cid:43)(cid:2)(cid:1)(cid:34)(cid:34)(cid:19)(cid:18)(cid:18)(cid:2)(cid:44,Unknown,11204.0
Unknown,Unknown,15,Unknown,Unknown,Unknown,Unknown,cid:43)(cid:2)(cid:1)(cid:34)(cid:34)(cid:19)(cid:18)(cid:18)(cid:2)(cid:44,Unknown,11219.0
Unknown,Unknown,2,Unknown,Unknown,Unknown,Unknown,cid:43)(cid:2)(cid:1)(cid:34)(cid:34)(cid:19)(cid:18)(cid:18)(cid:2)(cid:44,Unknown,11221.0
Unknown,Unknown,1,Unknown,Unknown,Unknown,Unknown,cid:43)(cid:2)(cid:1)(cid:34)(cid:34)(cid:19)(cid:18)(cid:18)(cid:2)(cid:44,Unknown,11222.0
Unknown,Unknown,1,Unknown,Unknown,Unknown,Unknown,cid:43)(cid:2)(cid:1)(cid:34)(cid:34)(cid:19)(cid:18)(cid:18)(cid:2)(cid:44,Unknown,11223.0
Unknown,Unknown,19,Unknown,Unknown,Unknown,Unknown,cid:43)(cid:2)(cid:1)(cid:34)(cid:34)(cid:19)(cid:18)(cid:18)(cid:2)(cid:44,Unknown,11242.0
Unknown,Unknown,34,Unknown,Unknown,Unknown,Unknown,cid:43)(cid:2)(cid:1)(cid:34)(cid:34)(cid:19)(cid:18)(cid:18)(cid:2)(cid:44,Unknown,11276.0
Unknown,Unknown,18,Unknown,Unknown,Unknown,Unknown,cid:43)(cid:2)(cid:1)(cid:34)(cid:34)(cid:19)(cid:18)(cid:18)(cid:2)(cid:44,Unknown,11294.0
Unknown,Unknown,2,Unknown,Unknown,Unknown,Unknown,cid:43)(cid:2)(cid:1)(cid:34)(cid:34)(cid:19)(cid:18)(cid:18)(cid:2)(cid:44,Unknown,11296.0
Unknown,Unknown,44,Unknown,Unknown,Unknown,Unknown,cid:43)(cid:2)(cid:1)(cid:34)(cid:34)(cid:19)(cid:18)(cid:18)(cid:2)(cid:44,Unknown,11340.0
Unknown,Unknown,12,Unknown,Unknown,Unknown,Unknown,cid:43)(cid:2)(cid:1)(cid:34)(cid:34)(cid:19)(cid:18)(cid:18)(cid:2)(cid:44,Unknown,11352.0
Unknown,Unknown,29,Unknown,Unknown,Unknown,Unknown,cid:43)(cid:2)(cid:1)(cid:34)(cid:34)(cid:19)(cid:18)(cid:18)(cid:2)(cid:44,Unknown,11381.0
Unknown,Unknown,26,Unknown,Unknown,Unknown,Unknown,cid:43)(cid:2)(cid:1)(cid:34)(cid:34)(cid:19)(cid:18)(cid:18)(cid:2)(cid:44,Unknown,11407.0
Unknown,Unknown,41,Unknown,Unknown,Unknown,Unknown,cid:43)(cid:2)(cid:1)(cid:34)(cid:34)(cid:19)(cid:18)(cid:18)(cid:2)(cid:44,Unknown,11448.0
Unknown,Unknown,25,Unknown,Unknown,Unknown,Unknown,cid:43)(cid:2)(cid:1)(cid:34)(cid:34)(cid:19)(cid:18)(cid:18)(cid:2)(cid:44,Unknown,11473.0
Unknown,Unknown,2,Unknown,Unknown,Unknown,Unknown,cid:43)(cid:2)(cid:1)(cid:34)(cid:34)(cid:19)(cid:18)(cid:18)(cid:2)(cid:44,Unknown,11475.0
Unknown,Unknown,50,Unknown,Unknown,Unknown,Unknown,cid:43)(cid:2)(cid:1)(cid:34)(cid:34)(cid:19)(cid:18)(cid:18)(cid:2)(cid:44,Unknown,11525.0
Unknown,Unknown,50,Unknown,Unknown,Unknown,Unknown,cid:43)(cid:2)(cid:1)(cid:34)(cid:34)(cid:19)(cid:18)(cid:18)(cid:2)(cid:44,Unknown,11575.0
Unknown,Unknown,37,Unknown,Unknown,Unknown,Unknown,cid:43)(cid:2)(cid:1)(cid:34)(cid:34)(cid:19)(cid:18)(cid:18)(cid:2)(cid:44,Unknown,11612.0
Unknown,Unknown,16,Unknown,Unknown,Unknown,Unknown,cid:43)(cid:2)(cid:1)(cid:34)(cid:34)(cid:19)(cid:18)(cid:18)(cid:2)(cid:44,Unknown,11628.0
Unknown,Unknown,34,Unknown,Unknown,Unknown,Unknown,cid:43)(cid:2)(cid:1)(cid:34)(cid:34)(cid:19)(cid:18)(cid:18)(cid:2)(cid:44,Unknown,11662.0
Unknown,Unknown,33,Unknown,Unknown,Unknown,Unknown,cid:43)(cid:2)(cid:1)(cid:34)(cid:34)(cid:19)(cid:18)(cid:18)(cid:2)(cid:44,Unknown,11695.0
Unknown,Unknown,17,Unknown,Unknown,Unknown,Unknown,cid:43)(cid:2)(cid:1)(cid:34)(cid:34)(cid:19)(cid:18)(cid:18)(cid:2)(cid:44,Unknown,11712.0
Unknown,Unknown,17,Unknown,Unknown,Unknown,Unknown,cid:43)(cid:2)(cid:1)(cid:34)(cid:34)(cid:19)(cid:18)(cid:18)(cid:2)(cid:44,Unknown,11729.0
Unknown,Unknown,45,Unknown,Unknown,Unknown,Unknown,cid:43)(cid:2)(cid:1)(cid:34)(cid:34)(cid:19)(cid:18)(cid:18)(cid:2)(cid:44,Unknown,11774.0
Unknown,Unknown,18,Unknown,Unknown,Unknown,Unknown,cid:43)(cid:2)(cid:1)(cid:34)(cid:34)(cid:19)(cid:18)(cid:18)(cid:2)(cid:44,Unknown,11792.0
Unknown,Unknown,35,Unknown,Unknown,Unknown,Unknown,cid:43)(cid:2)(cid:1)(cid:34)(cid:34)(cid:19)(cid:18)(cid:18)(cid:2)(cid:44,Unknown,11827.0
Unknown,Unknown,54,Unknown,Unknown,Unknown,Unknown,cid:43)(cid:2)(cid:1)(cid:34)(cid:34)(cid:19)(cid:18)(cid:18)(cid:2)(cid:44,Unknown,11881.0
Unknown,Unknown,46,Unknown,Unknown,Unknown,Unknown,cid:43)(cid:2)(cid:1)(cid:34)(cid:34)(cid:19)(cid:18)(cid:18)(cid:2)(cid:44,Unknown,11927.0
Unknown,Unknown,4,Unknown,Unknown,Unknown,Unknown,cid:43)(cid:2)(cid:1)(cid:34)(cid:34)(cid:19)(cid:18)(cid:18)(cid:2)(cid:44,Unknown,11931.0
Unknown,Unknown,10,Unknown,Unknown,Unknown,Unknown,cid:43)(cid:2)(cid:1)(cid:34)(cid:34)(cid:19)(cid:18)(cid:18)(cid:2)(cid:44,Unknown,11941.0
Unknown,Unknown,9,Unknown,Unknown,Unknown,Unknown,cid:43)(cid:2)(cid:1)(cid:34)(cid:34)(cid:19)(cid:18)(cid:18)(cid:2)(cid:44,Unknown,11950.0
Unknown,Unknown,10,Unknown,Unknown,Unknown,Unknown,cid:43)(cid:2)(cid:1)(cid:34)(cid:34)(cid:19)(cid:18)(cid:18)(cid:2)(cid:44,Unknown,11960.0
Unknown,Unknown,5,Unknown,Unknown,Unknown,Unknown,cid:43)(cid:2)(cid:1)(cid:34)(cid:34)(cid:19)(cid:18)(cid:18)(cid:2)(cid:44,Unknown,11965.0
Unknown,Unknown,14,Unknown,Unknown,Unknown,Unknown,cid:43)(cid:2)(cid:1)(cid:34)(cid:34)(cid:19)(cid:18)(cid:18)(cid:2)(cid:44,Unknown,11979.0
Unknown,Unknown,14,Unknown,Unknown,Unknown,Unknown,cid:43)(cid:2)(cid:1)(cid:34)(cid:34)(cid:19)(cid:18)(cid:18)(cid:2)(cid:44,Unknown,11993.0
Unknown,Unknown,5,Unknown,Unknown,Unknown,Unknown,cid:43)(cid:2)(cid:1)(cid:34)(cid:34)(cid:19)(cid:18)(cid:18)(cid:2)(cid:44,Unknown,11998.0
Unknown,Unknown,2,Unknown,Unknown,Unknown,Unknown,cid:43)(cid:2)(cid:1)(cid:34)(cid:34)(cid:19)(cid:18)(cid:18)(cid:2)(cid:44,Unknown,12000.0
Unknown,Unknown,3,Unknown,Unknown,Unknown,Unknown,cid:43)(cid:2)(cid:1)(cid:34)(cid:34)(cid:19)(cid:18)(cid:18)(cid:2)(cid:44,Unknown,12003.0
Unknown,Unknown,11,Unknown,Unknown,Unknown,Unknown,cid:43)(cid:2)(cid:1)(cid:34)(cid:34)(cid:19)(cid:18)(cid:18)(cid:2)(cid:44,Unknown,12014.0
Unknown,Unknown,9,Unknown,Unknown,Unknown,Unknown,cid:43)(cid:2)(cid:1)(cid:34)(cid:34)(cid:19)(cid:18)(cid:18)(cid:2)(cid:44,Unknown,12023.0
Unknown,Unknown,5,Unknown,Unknown,Unknown,Unknown,cid:43)(cid:2)(cid:1)(cid:34)(cid:34)(cid:19)(cid:18)(cid:18)(cid:2)(cid:44,Unknown,12028.0
Unknown,Unknown,8,Unknown,Unknown,Unknown,Unknown,cid:43)(cid:2)(cid:1)(cid:34)(cid:34)(cid:19)(cid:18)(cid:18)(cid:2)(cid:44,Unknown,12036.0
Unknown,Unknown,51,Unknown,Unknown,Unknown,Unknown,cid:43)(cid:2)(cid:1)(cid:34)(cid:34)(cid:19)(cid:18)(cid:18)(cid:2)(cid:44,Unknown,12087.0
Unknown,Unknown,46,Unknown,Unknown,Unknown,Unknown,cid:43)(cid:2)(cid:1)(cid:34)(cid:34)(cid:19)(cid:18)(cid:18)(cid:2)(cid:44,Unknown,12133.0
Unknown,Unknown,12,Unknown,Unknown,Unknown,Unknown,cid:43)(cid:2)(cid:1)(cid:34)(cid:34)(cid:19)(cid:18)(cid:18)(cid:2)(cid:44,Unknown,12145.0
Unknown,Unknown,13,Unknown,Unknown,Unknown,Unknown,cid:43)(cid:2)(cid:1)(cid:34)(cid:34)(cid:19)(cid:18)(cid:18)(cid:2)(cid:44,Unknown,12158.0
Unknown,Unknown,2,Unknown,Unknown,Unknown,Unknown,cid:43)(cid:2)(cid:1)(cid:34)(cid:34)(cid:19)(cid:18)(cid:18)(cid:2)(cid:44,Unknown,12160.0
Unknown,Unknown,3,Unknown,Unknown,Unknown,Unknown,cid:43)(cid:2)(cid:1)(cid:34)(cid:34)(cid:19)(cid:18)(cid:18)(cid:2)(cid:44,Unknown,12163.0
Unknown,Unknown,11,Unknown,Unknown,Unknown,Unknown,cid:43)(cid:2)(cid:1)(cid:34)(cid:34)(cid:19)(cid:18)(cid:18)(cid:2)(cid:44,Unknown,12174.0
Unknown,Unknown,9,Unknown,Unknown,Unknown,Unknown,cid:43)(cid:2)(cid:1)(cid:34)(cid:34)(cid:19)(cid:18)(cid:18)(cid:2)(cid:44,Unknown,12183.0
Unknown,Unknown,5,Unknown,Unknown,Unknown,Unknown,cid:43)(cid:2)(cid:1)(cid:34)(cid:34)(cid:19)(cid:18)(cid:18)(cid:2)(cid:44,Unknown,12188.0
Unknown,Unknown,8,Unknown,Unknown,Unknown,Unknown,cid:43)(cid:2)(cid:1)(cid:34)(cid:34)(cid:19)(cid:18)(cid:18)(cid:2)(cid:44,Unknown,12196.0
Unknown,Unknown,51,Unknown,Unknown,Unknown,Unknown,cid:43)(cid:2)(cid:1)(cid:34)(cid:34)(cid:19)(cid:18)(cid:18)(cid:2)(cid:44,Unknown,12247.0
Unknown,Unknown,46,Unknown,Unknown,Unknown,Unknown,cid:43)(cid:2)(cid:1)(cid:34)(cid:34)(cid:19)(cid:18)(cid:18)(cid:2)(cid:44,Unknown,12293.0
Unknown,Unknown,12,Unknown,Unknown,Unknown,Unknown,cid:43)(cid:2)(cid:1)(cid:34)(cid:34)(cid:19)(cid:18)(cid:18)(cid:2)(cid:44,Unknown,12305.0
Unknown,Unknown,13,Unknown,Unknown,Unknown,Unknown,cid:43)(cid:2)(cid:1)(cid:34)(cid:34)(cid:19)(cid:18)(cid:18)(cid:2)(cid:44,Unknown,12318.0
Unknown,Unknown,2,Unknown,Unknown,Unknown,Unknown,cid:43)(cid:2)(cid:1)(cid:34)(cid:34)(cid:19)(cid:18)(cid:18)(cid:2)(cid:44,Unknown,12320.0
Unknown,Unknown,46,Unknown,Unknown,Unknown,Unknown,cid:43)(cid:2)(cid:1)(cid:34)(cid:34)(cid:19)(cid:18)(cid:18)(cid:2)(cid:44,Unknown,12366.0
Unknown,Unknown,10,Unknown,Unknown,Unknown,Unknown,cid:43)(cid:2)(cid:1)(cid:34)(cid:34)(cid:19)(cid:18)(cid:18)(cid:2)(cid:44,Unknown,12376.0
Unknown,Unknown,15,Unknown,Unknown,Unknown,Unknown,cid:43)(cid:2)(cid:1)(cid:34)(cid:34)(cid:19)(cid:18)(cid:18)(cid:2)(cid:44,Unknown,12391.0
Unknown,Unknown,2,Unknown,Unknown,Unknown,Unknown,cid:43)(cid:2)(cid:1)(cid:34)(cid:34)(cid:19)(cid:18)(cid:18)(cid:2)(cid:44,Unknown,12393.0
Unknown,Unknown,16,Unknown,Unknown,Unknown,Unknown,cid:43)(cid:2)(cid:1)(cid:34)(cid:34)(cid:19)(cid:18)(cid:18)(cid:2)(cid:44,Unknown,12409.0
Unknown,Unknown,19,Unknown,Unknown,Unknown,Unknown,cid:43)(cid:2)(cid:1)(cid:34)(cid:34)(cid:19)(cid:18)(cid:18)(cid:2)(cid:44,Unknown,12428.0
Unknown,Unknown,32,Unknown,Unknown,Unknown,Unknown,cid:43)(cid:2)(cid:1)(cid:34)(cid:34)(cid:19)(cid:18)(cid:18)(cid:2)(cid:44,Unknown,12460.0
Unknown,Unknown,18,Unknown,Unknown,Unknown,Unknown,cid:43)(cid:2)(cid:1)(cid:34)(cid:34)(cid:19)(cid:18)(cid:18)(cid:2)(cid:44,Unknown,12478.0
Unknown,Unknown,2,Unknown,Unknown,Unknown,Unknown,cid:43)(cid:2)(cid:1)(cid:34)(cid:34)(cid:19)(cid:18)(cid:18)(cid:2)(cid:44,Unknown,12480.0
Unknown,Unknown,44,Unknown,Unknown,Unknown,Unknown,cid:43)(cid:2)(cid:1)(cid:34)(cid:34)(cid:19)(cid:18)(cid:18)(cid:2)(cid:44,Unknown,12524.0
Unknown,Unknown,12,Unknown,Unknown,Unknown,Unknown,cid:43)(cid:2)(cid:1)(cid:34)(cid:34)(cid:19)(cid:18)(cid:18)(cid:2)(cid:44,Unknown,12536.0
Unknown,Unknown,29,Unknown,Unknown,Unknown,Unknown,cid:43)(cid:2)(cid:1)(cid:34)(cid:34)(cid:19)(cid:18)(cid:18)(cid:2)(cid:44,Unknown,12565.0
Unknown,Unknown,26,Unknown,Unknown,Unknown,Unknown,cid:43)(cid:2)(cid:1)(cid:34)(cid:34)(cid:19)(cid:18)(cid:18)(cid:2)(cid:44,Unknown,12591.0
Unknown,Unknown,41,Unknown,Unknown,Unknown,Unknown,cid:43)(cid:2)(cid:1)(cid:34)(cid:34)(cid:19)(cid:18)(cid:18)(cid:2)(cid:44,Unknown,12632.0
Unknown,Unknown,25,Unknown,Unknown,Unknown,Unknown,cid:43)(cid:2)(cid:1)(cid:34)(cid:34)(cid:19)(cid:18)(cid:18)(cid:2)(cid:44,Unknown,12657.0
Unknown,Unknown,2,Unknown,Unknown,Unknown,Unknown,cid:43)(cid:2)(cid:1)(cid:34)(cid:34)(cid:19)(cid:18)(cid:18)(cid:2)(cid:44,Unknown,12659.0
Unknown,Unknown,50,Unknown,Unknown,Unknown,Unknown,cid:43)(cid:2)(cid:1)(cid:34)(cid:34)(cid:19)(cid:18)(cid:18)(cid:2)(cid:44,Unknown,12709.0
Unknown,Unknown,50,Unknown,Unknown,Unknown,Unknown,cid:43)(cid:2)(cid:1)(cid:34)(cid:34)(cid:19)(cid:18)(cid:18)(cid:2)(cid:44,Unknown,12759.0
Unknown,Unknown,18,Unknown,Unknown,Unknown,Unknown,cid:43)(cid:2)(cid:1)(cid:34)(cid:34)(cid:19)(cid:18)(cid:18)(cid:2)(cid:44,Unknown,12777.0
Unknown,Unknown,1,Unknown,Unknown,Unknown,Unknown,cid:43)(cid:2)(cid:1)(cid:34)(cid:34)(cid:19)(cid:18)(cid:18)(cid:2)(cid:44,Unknown,12778.0
Unknown,Unknown,1,Unknown,Unknown,Unknown,Unknown,cid:43)(cid:2)(cid:1)(cid:34)(cid:34)(cid:19)(cid:18)(cid:18)(cid:2)(cid:44,Unknown,12779.0
Unknown,Unknown,37,Unknown,Unknown,Unknown,Unknown,cid:43)(cid:2)(cid:1)(cid:34)(cid:34)(cid:19)(cid:18)(cid:18)(cid:2)(cid:44,Unknown,12816.0
Unknown,Unknown,17,Unknown,Unknown,Unknown,Unknown,cid:43)(cid:2)(cid:1)(cid:34)(cid:34)(cid:19)(cid:18)(cid:18)(cid:2)(cid:44,Unknown,12833.0
Unknown,Unknown,16,Unknown,Unknown,Unknown,Unknown,cid:43)(cid:2)(cid:1)(cid:34)(cid:34)(cid:19)(cid:18)(cid:18)(cid:2)(cid:44,Unknown,12849.0
Unknown,Unknown,45,Unknown,Unknown,Unknown,Unknown,cid:43)(cid:2)(cid:1)(cid:34)(cid:34)(cid:19)(cid:18)(cid:18)(cid:2)(cid:44,Unknown,12894.0
Unknown,Unknown,18,Unknown,Unknown,Unknown,Unknown,cid:43)(cid:2)(cid:1)(cid:34)(cid:34)(cid:19)(cid:18)(cid:18)(cid:2)(cid:44,Unknown,12912.0
Unknown,Unknown,35,Unknown,Unknown,Unknown,Unknown,cid:43)(cid:2)(cid:1)(cid:34)(cid:34)(cid:19)(cid:18)(cid:18)(cid:2)(cid:44,Unknown,12947.0
Unknown,Unknown,8,Unknown,Unknown,Unknown,Unknown,cid:43)(cid:2)(cid:1)(cid:34)(cid:34)(cid:19)(cid:18)(cid:18)(cid:2)(cid:44,Unknown,12955.0
Unknown,Unknown,5,Unknown,Unknown,Unknown,Unknown,cid:43)(cid:2)(cid:1)(cid:34)(cid:34)(cid:19)(cid:18)(cid:18)(cid:2)(cid:44,Unknown,12960.0
Unknown,Unknown,6,Unknown,Unknown,Unknown,Unknown,cid:43)(cid:2)(cid:1)(cid:34)(cid:34)(cid:19)(cid:18)(cid:18)(cid:2)(cid:44,Unknown,12966.0
Unknown,Unknown,12,Unknown,Unknown,Unknown,Unknown,cid:43)(cid:2)(cid:1)(cid:34)(cid:34)(cid:19)(cid:18)(cid:18)(cid:2)(cid:44,Unknown,12978.0
Unknown,Unknown,11,Unknown,Unknown,Unknown,Unknown,cid:43)(cid:2)(cid:1)(cid:34)(cid:34)(cid:19)(cid:18)(cid:18)(cid:2)(cid:44,Unknown,12989.0
Unknown,Unknown,2,Unknown,Unknown,Unknown,Unknown,cid:43)(cid:2)(cid:1)(cid:34)(cid:34)(cid:19)(cid:18)(cid:18)(cid:2)(cid:44,Unknown,12991.0
Unknown,Unknown,52,Unknown,Unknown,Unknown,Unknown,cid:43)(cid:2)(cid:1)(cid:34)(cid:34)(cid:19)(cid:18)(cid:18)(cid:2)(cid:44,Unknown,13043.0
Unknown,Unknown,7,Unknown,Unknown,Unknown,Unknown,cid:43)(cid:2)(cid:1)(cid:34)(cid:34)(cid:19)(cid:18)(cid:18)(cid:2)(cid:44,Unknown,13050.0
Unknown,Unknown,14,Unknown,Unknown,Unknown,Unknown,cid:43)(cid:2)(cid:1)(cid:34)(cid:34)(cid:19)(cid:18)(cid:18)(cid:2)(cid:44,Unknown,13064.0
Unknown,Unknown,14,Unknown,Unknown,Unknown,Unknown,cid:43)(cid:2)(cid:1)(cid:34)(cid:34)(cid:19)(cid:18)(cid:18)(cid:2)(cid:44,Unknown,13078.0
Unknown,Unknown,46,Unknown,Unknown,Unknown,Unknown,cid:43)(cid:2)(cid:1)(cid:34)(cid:34)(cid:19)(cid:18)(cid:18)(cid:2)(cid:44,Unknown,13124.0
Unknown,Unknown,2,Unknown,Unknown,Unknown,Unknown,cid:43)(cid:2)(cid:1)(cid:34)(cid:34)(cid:19)(cid:18)(cid:18)(cid:2)(cid:44,Unknown,13126.0
Unknown,Unknown,53,Unknown,Unknown,Unknown,Unknown,cid:43)(cid:2)(cid:1)(cid:34)(cid:34)(cid:19)(cid:18)(cid:18)(cid:2)(cid:44,Unknown,13179.0
Unknown,Unknown,5,Unknown,Unknown,Unknown,Unknown,cid:43)(cid:2)(cid:1)(cid:34)(cid:34)(cid:19)(cid:18)(cid:18)(cid:2)(cid:44,Unknown,13184.0
Unknown,Unknown,3,Unknown,Unknown,Unknown,Unknown,cid:43)(cid:2)(cid:1)(cid:34)(cid:34)(cid:19)(cid:18)(cid:18)(cid:2)(cid:44,Unknown,13187.0
Unknown,Unknown,54,Unknown,Unknown,Unknown,Unknown,cid:43)(cid:2)(cid:1)(cid:34)(cid:34)(cid:19)(cid:18)(cid:18)(cid:2)(cid:44,Unknown,13241.0
Unknown,Unknown,7,Unknown,Unknown,Unknown,Unknown,cid:43)(cid:2)(cid:1)(cid:34)(cid:34)(cid:19)(cid:18)(cid:18)(cid:2)(cid:44,Unknown,13248.0
Unknown,Unknown,46,Unknown,Unknown,Unknown,Unknown,cid:43)(cid:2)(cid:1)(cid:34)(cid:34)(cid:19)(cid:18)(cid:18)(cid:2)(cid:44,Unknown,13294.0
Unknown,Unknown,2,Unknown,Unknown,Unknown,Unknown,cid:43)(cid:2)(cid:1)(cid:34)(cid:34)(cid:19)(cid:18)(cid:18)(cid:2)(cid:44,Unknown,13296.0
Unknown,Unknown,14,Unknown,Unknown,Unknown,Unknown,cid:43)(cid:2)(cid:1)(cid:34)(cid:34)(cid:19)(cid:18)(cid:18)(cid:2)(cid:44,Unknown,13310.0
Unknown,Unknown,63,Unknown,Unknown,Unknown,Unknown,cid:43)(cid:2)(cid:1)(cid:34)(cid:34)(cid:19)(cid:18)(cid:18)(cid:2)(cid:44,Unknown,13373.0
Unknown,Unknown,14,Unknown,Unknown,Unknown,Unknown,cid:43)(cid:2)(cid:1)(cid:34)(cid:34)(cid:19)(cid:18)(cid:18)(cid:2)(cid:44,Unknown,13387.0
Unknown,Unknown,2,Unknown,Unknown,Unknown,Unknown,cid:43)(cid:2)(cid:1)(cid:34)(cid:34)(cid:19)(cid:18)(cid:18)(cid:2)(cid:44,Unknown,13389.0
Unknown,Unknown,39,Unknown,Unknown,Unknown,Unknown,cid:43)(cid:2)(cid:1)(cid:34)(cid:34)(cid:19)(cid:18)(cid:18)(cid:2)(cid:44,Unknown,13428.0
Unknown,Unknown,3,Unknown,Unknown,Unknown,Unknown,cid:43)(cid:2)(cid:1)(cid:34)(cid:34)(cid:19)(cid:18)(cid:18)(cid:2)(cid:44,Unknown,13431.0
Unknown,Unknown,7,Unknown,Unknown,Unknown,Unknown,cid:43)(cid:2)(cid:1)(cid:34)(cid:34)(cid:19)(cid:18)(cid:18)(cid:2)(cid:44,Unknown,13438.0
Unknown,Unknown,9,Unknown,Unknown,Unknown,Unknown,cid:43)(cid:2)(cid:1)(cid:34)(cid:34)(cid:19)(cid:18)(cid:18)(cid:2)(cid:44,Unknown,13447.0
Unknown,Unknown,13,Unknown,Unknown,Unknown,Unknown,cid:43)(cid:2)(cid:1)(cid:34)(cid:34)(cid:19)(cid:18)(cid:18)(cid:2)(cid:44,Unknown,13460.0
Unknown,Unknown,10,Unknown,Unknown,Unknown,Unknown,cid:43)(cid:2)(cid:1)(cid:34)(cid:34)(cid:19)(cid:18)(cid:18)(cid:2)(cid:44,Unknown,13470.0
Unknown,Unknown,7,Unknown,Unknown,Unknown,Unknown,cid:43)(cid:2)(cid:1)(cid:34)(cid:34)(cid:19)(cid:18)(cid:18)(cid:2)(cid:44,Unknown,13477.0
Unknown,Unknown,8,Unknown,Unknown,Unknown,Unknown,cid:43)(cid:2)(cid:1)(cid:34)(cid:34)(cid:19)(cid:18)(cid:18)(cid:2)(cid:44,Unknown,13485.0
Unknown,Unknown,46,Unknown,Unknown,Unknown,Unknown,cid:43)(cid:2)(cid:1)(cid:34)(cid:34)(cid:19)(cid:18)(cid:18)(cid:2)(cid:44,Unknown,13531.0
Unknown,Unknown,2,Unknown,Unknown,Unknown,Unknown,cid:43)(cid:2)(cid:1)(cid:34)(cid:34)(cid:19)(cid:18)(cid:18)(cid:2)(cid:44,Unknown,13533.0
Unknown,Unknown,38,Unknown,Unknown,Unknown,Unknown,cid:43)(cid:2)(cid:1)(cid:34)(cid:34)(cid:19)(cid:18)(cid:18)(cid:2)(cid:44,Unknown,13571.0
Unknown,Unknown,64,Unknown,Unknown,Unknown,Unknown,cid:43)(cid:2)(cid:1)(cid:34)(cid:34)(cid:19)(cid:18)(cid:18)(cid:2)(cid:44,Unknown,13635.0
Unknown,Unknown,15,Unknown,Unknown,Unknown,Unknown,cid:43)(cid:2)(cid:1)(cid:34)(cid:34)(cid:19)(cid:18)(cid:18)(cid:2)(cid:44,Unknown,13650.0
Unknown,Unknown,2,Unknown,Unknown,Unknown,Unknown,cid:43)(cid:2)(cid:1)(cid:34)(cid:34)(cid:19)(cid:18)(cid:18)(cid:2)(cid:44,Unknown,13652.0
Unknown,Unknown,35,Unknown,Unknown,Unknown,Unknown,cid:43)(cid:2)(cid:1)(cid:34)(cid:34)(cid:19)(cid:18)(cid:18)(cid:2)(cid:44,Unknown,13687.0
Unknown,Unknown,32,Unknown,Unknown,Unknown,Unknown,cid:43)(cid:2)(cid:1)(cid:34)(cid:34)(cid:19)(cid:18)(cid:18)(cid:2)(cid:44,Unknown,13719.0
Unknown,Unknown,19,Unknown,Unknown,Unknown,Unknown,cid:43)(cid:2)(cid:1)(cid:34)(cid:34)(cid:19)(cid:18)(cid:18)(cid:2)(cid:44,Unknown,13738.0
Unknown,Unknown,18,Unknown,Unknown,Unknown,Unknown,cid:43)(cid:2)(cid:1)(cid:34)(cid:34)(cid:19)(cid:18)(cid:18)(cid:2)(cid:44,Unknown,13756.0
Unknown,Unknown,18,Unknown,Unknown,Unknown,Unknown,cid:43)(cid:2)(cid:1)(cid:34)(cid:34)(cid:19)(cid:18)(cid:18)(cid:2)(cid:44,Unknown,13774.0
Unknown,Unknown,2,Unknown,Unknown,Unknown,Unknown,cid:43)(cid:2)(cid:1)(cid:34)(cid:34)(cid:19)(cid:18)(cid:18)(cid:2)(cid:44,Unknown,13776.0
Unknown,Unknown,44,Unknown,Unknown,Unknown,Unknown,cid:43)(cid:2)(cid:1)(cid:34)(cid:34)(cid:19)(cid:18)(cid:18)(cid:2)(cid:44,Unknown,13820.0
Unknown,Unknown,12,Unknown,Unknown,Unknown,Unknown,cid:43)(cid:2)(cid:1)(cid:34)(cid:34)(cid:19)(cid:18)(cid:18)(cid:2)(cid:44,Unknown,13832.0
Unknown,Unknown,29,Unknown,Unknown,Unknown,Unknown,cid:43)(cid:2)(cid:1)(cid:34)(cid:34)(cid:19)(cid:18)(cid:18)(cid:2)(cid:44,Unknown,13861.0
Unknown,Unknown,26,Unknown,Unknown,Unknown,Unknown,cid:43)(cid:2)(cid:1)(cid:34)(cid:34)(cid:19)(cid:18)(cid:18)(cid:2)(cid:44,Unknown,13887.0
Unknown,Unknown,41,Unknown,Unknown,Unknown,Unknown,cid:43)(cid:2)(cid:1)(cid:34)(cid:34)(cid:19)(cid:18)(cid:18)(cid:2)(cid:44,Unknown,13928.0
Unknown,Unknown,25,Unknown,Unknown,Unknown,Unknown,cid:43)(cid:2)(cid:1)(cid:34)(cid:34)(cid:19)(cid:18)(cid:18)(cid:2)(cid:44,Unknown,13953.0
Unknown,Unknown,2,Unknown,Unknown,Unknown,Unknown,cid:43)(cid:2)(cid:1)(cid:34)(cid:34)(cid:19)(cid:18)(cid:18)(cid:2)(cid:44,Unknown,13955.0
Unknown,Unknown,50,Unknown,Unknown,Unknown,Unknown,cid:43)(cid:2)(cid:1)(cid:34)(cid:34)(cid:19)(cid:18)(cid:18)(cid:2)(cid:44,Unknown,14005.0
Unknown,Unknown,50,Unknown,Unknown,Unknown,Unknown,cid:43)(cid:2)(cid:1)(cid:34)(cid:34)(cid:19)(cid:18)(cid:18)(cid:2)(cid:44,Unknown,14055.0
Unknown,Unknown,37,Unknown,Unknown,Unknown,Unknown,cid:43)(cid:2)(cid:1)(cid:34)(cid:34)(cid:19)(cid:18)(cid:18)(cid:2)(cid:44,Unknown,14092.0
Unknown,Unknown,16,Unknown,Unknown,Unknown,Unknown,cid:43)(cid:2)(cid:1)(cid:34)(cid:34)(cid:19)(cid:18)(cid:18)(cid:2)(cid:44,Unknown,14108.0
Unknown,Unknown,34,Unknown,Unknown,Unknown,Unknown,cid:43)(cid:2)(cid:1)(cid:34)(cid:34)(cid:19)(cid:18)(cid:18)(cid:2)(cid:44,Unknown,14142.0
Unknown,Unknown,33,Unknown,Unknown,Unknown,Unknown,cid:43)(cid:2)(cid:1)(cid:34)(cid:34)(cid:19)(cid:18)(cid:18)(cid:2)(cid:44,Unknown,14175.0
Unknown,Unknown,1,Unknown,Unknown,Unknown,Unknown,cid:43)(cid:2)(cid:1)(cid:34)(cid:34)(cid:19)(cid:18)(cid:18)(cid:2)(cid:44,Unknown,14176.0
Unknown,Unknown,18,Unknown,Unknown,Unknown,Unknown,cid:43)(cid:2)(cid:1)(cid:34)(cid:34)(cid:19)(cid:18)(cid:18)(cid:2)(cid:44,Unknown,14194.0
Unknown,Unknown,45,Unknown,Unknown,Unknown,Unknown,cid:43)(cid:2)(cid:1)(cid:34)(cid:34)(cid:19)(cid:18)(cid:18)(cid:2)(cid:44,Unknown,14239.0
Unknown,Unknown,18,Unknown,Unknown,Unknown,Unknown,cid:43)(cid:2)(cid:1)(cid:34)(cid:34)(cid:19)(cid:18)(cid:18)(cid:2)(cid:44,Unknown,14257.0
Unknown,Unknown,35,Unknown,Unknown,Unknown,Unknown,cid:43)(cid:2)(cid:1)(cid:34)(cid:34)(cid:19)(cid:18)(cid:18)(cid:2)(cid:44,Unknown,14292.0
Unknown,Unknown,46,Unknown,Unknown,Unknown,Unknown,cid:43)(cid:2)(cid:1)(cid:34)(cid:34)(cid:19)(cid:18)(cid:18)(cid:2)(cid:44,Unknown,14338.0
Unknown,Unknown,3,Unknown,Unknown,Unknown,Unknown,cid:43)(cid:2)(cid:1)(cid:34)(cid:34)(cid:19)(cid:18)(cid:18)(cid:2)(cid:44,Unknown,14341.0
Unknown,Unknown,9,Unknown,Unknown,Unknown,Unknown,cid:43)(cid:2)(cid:1)(cid:34)(cid:34)(cid:19)(cid:18)(cid:18)(cid:2)(cid:44,Unknown,14350.0
Unknown,Unknown,5,Unknown,Unknown,Unknown,Unknown,cid:43)(cid:2)(cid:1)(cid:34)(cid:34)(cid:19)(cid:18)(cid:18)(cid:2)(cid:44,Unknown,14355.0
Unknown,Unknown,8,Unknown,Unknown,Unknown,Unknown,cid:43)(cid:2)(cid:1)(cid:34)(cid:34)(cid:19)(cid:18)(cid:18)(cid:2)(cid:44,Unknown,14363.0
Unknown,Unknown,46,Unknown,Unknown,Unknown,Unknown,cid:43)(cid:2)(cid:1)(cid:34)(cid:34)(cid:19)(cid:18)(cid:18)(cid:2)(cid:44,Unknown,14409.0
Unknown,Unknown,14,Unknown,Unknown,Unknown,Unknown,cid:43)(cid:2)(cid:1)(cid:34)(cid:34)(cid:19)(cid:18)(cid:18)(cid:2)(cid:44,Unknown,14423.0
Unknown,Unknown,2,Unknown,Unknown,Unknown,Unknown,cid:43)(cid:2)(cid:1)(cid:34)(cid:34)(cid:19)(cid:18)(cid:18)(cid:2)(cid:44,Unknown,14425.0
Unknown,Unknown,1,Unknown,Unknown,Unknown,Unknown,cid:43)(cid:2)(cid:1)(cid:34)(cid:34)(cid:19)(cid:18)(cid:18)(cid:2)(cid:44,Unknown,14426.0
Unknown,Unknown,2,Unknown,Unknown,Unknown,Unknown,cid:43)(cid:2)(cid:1)(cid:34)(cid:34)(cid:19)(cid:18)(cid:18)(cid:2)(cid:44,Unknown,14428.0
Unknown,Unknown,8,Unknown,Unknown,Unknown,Unknown,cid:43)(cid:2)(cid:1)(cid:34)(cid:34)(cid:19)(cid:18)(cid:18)(cid:2)(cid:44,Unknown,14436.0
Unknown,Unknown,39,Unknown,Unknown,Unknown,Unknown,cid:43)(cid:2)(cid:1)(cid:34)(cid:34)(cid:19)(cid:18)(cid:18)(cid:2)(cid:44,Unknown,14475.0
Unknown,Unknown,10,Unknown,Unknown,Unknown,Unknown,cid:43)(cid:2)(cid:1)(cid:34)(cid:34)(cid:19)(cid:18)(cid:18)(cid:2)(cid:44,Unknown,14485.0
Unknown,Unknown,2,Unknown,Unknown,Unknown,Unknown,cid:43)(cid:2)(cid:1)(cid:34)(cid:34)(cid:19)(cid:18)(cid:18)(cid:2)(cid:44,Unknown,14487.0
Unknown,Unknown,49,Unknown,Unknown,Unknown,Unknown,cid:43)(cid:2)(cid:1)(cid:34)(cid:34)(cid:19)(cid:18)(cid:18)(cid:2)(cid:44,Unknown,14536.0
Unknown,Unknown,46,Unknown,Unknown,Unknown,Unknown,cid:43)(cid:2)(cid:1)(cid:34)(cid:34)(cid:19)(cid:18)(cid:18)(cid:2)(cid:44,Unknown,14582.0
Unknown,Unknown,3,Unknown,Unknown,Unknown,Unknown,cid:43)(cid:2)(cid:1)(cid:34)(cid:34)(cid:19)(cid:18)(cid:18)(cid:2)(cid:44,Unknown,14585.0
Unknown,Unknown,49,Unknown,Unknown,Unknown,Unknown,cid:43)(cid:2)(cid:1)(cid:34)(cid:34)(cid:19)(cid:18)(cid:18)(cid:2)(cid:44,Unknown,14634.0
Unknown,Unknown,46,Unknown,Unknown,Unknown,Unknown,cid:43)(cid:2)(cid:1)(cid:34)(cid:34)(cid:19)(cid:18)(cid:18)(cid:2)(cid:44,Unknown,14680.0
Unknown,Unknown,8,Unknown,Unknown,Unknown,Unknown,cid:43)(cid:2)(cid:1)(cid:34)(cid:34)(cid:19)(cid:18)(cid:18)(cid:2)(cid:44,Unknown,14688.0
Unknown,Unknown,7,Unknown,Unknown,Unknown,Unknown,cid:43)(cid:2)(cid:1)(cid:34)(cid:34)(cid:19)(cid:18)(cid:18)(cid:2)(cid:44,Unknown,14695.0
Unknown,Unknown,46,Unknown,Unknown,Unknown,Unknown,cid:43)(cid:2)(cid:1)(cid:34)(cid:34)(cid:19)(cid:18)(cid:18)(cid:2)(cid:44,Unknown,14741.0
Unknown,Unknown,2,Unknown,Unknown,Unknown,Unknown,cid:43)(cid:2)(cid:1)(cid:34)(cid:34)(cid:19)(cid:18)(cid:18)(cid:2)(cid:44,Unknown,14743.0
Unknown,Unknown,38,Unknown,Unknown,Unknown,Unknown,cid:43)(cid:2)(cid:1)(cid:34)(cid:34)(cid:19)(cid:18)(cid:18)(cid:2)(cid:44,Unknown,14781.0
Unknown,Unknown,64,Unknown,Unknown,Unknown,Unknown,cid:43)(cid:2)(cid:1)(cid:34)(cid:34)(cid:19)(cid:18)(cid:18)(cid:2)(cid:44,Unknown,14845.0
Unknown,Unknown,15,Unknown,Unknown,Unknown,Unknown,cid:43)(cid:2)(cid:1)(cid:34)(cid:34)(cid:19)(cid:18)(cid:18)(cid:2)(cid:44,Unknown,14860.0
Unknown,Unknown,2,Unknown,Unknown,Unknown,Unknown,cid:43)(cid:2)(cid:1)(cid:34)(cid:34)(cid:19)(cid:18)(cid:18)(cid:2)(cid:44,Unknown,14862.0
Unknown,Unknown,17,Unknown,Unknown,Unknown,Unknown,cid:43)(cid:2)(cid:1)(cid:34)(cid:34)(cid:19)(cid:18)(cid:18)(cid:2)(cid:44,Unknown,14879.0
Unknown,Unknown,1,Unknown,Unknown,Unknown,Unknown,cid:43)(cid:2)(cid:1)(cid:34)(cid:34)(cid:19)(cid:18)(cid:18)(cid:2)(cid:44,Unknown,14880.0
Unknown,Unknown,36,Unknown,Unknown,Unknown,Unknown,cid:43)(cid:2)(cid:1)(cid:34)(cid:34)(cid:19)(cid:18)(cid:18)(cid:2)(cid:44,Unknown,14916.0
Unknown,Unknown,19,Unknown,Unknown,Unknown,Unknown,cid:43)(cid:2)(cid:1)(cid:34)(cid:34)(cid:19)(cid:18)(cid:18)(cid:2)(cid:44,Unknown,14935.0
Unknown,Unknown,18,Unknown,Unknown,Unknown,Unknown,cid:43)(cid:2)(cid:1)(cid:34)(cid:34)(cid:19)(cid:18)(cid:18)(cid:2)(cid:44,Unknown,14953.0
Unknown,Unknown,18,Unknown,Unknown,Unknown,Unknown,cid:43)(cid:2)(cid:1)(cid:34)(cid:34)(cid:19)(cid:18)(cid:18)(cid:2)(cid:44,Unknown,14971.0
Unknown,Unknown,2,Unknown,Unknown,Unknown,Unknown,cid:43)(cid:2)(cid:1)(cid:34)(cid:34)(cid:19)(cid:18)(cid:18)(cid:2)(cid:44,Unknown,14973.0
Unknown,Unknown,44,Unknown,Unknown,Unknown,Unknown,cid:43)(cid:2)(cid:1)(cid:34)(cid:34)(cid:19)(cid:18)(cid:18)(cid:2)(cid:44,Unknown,15017.0
Unknown,Unknown,12,Unknown,Unknown,Unknown,Unknown,cid:43)(cid:2)(cid:1)(cid:34)(cid:34)(cid:19)(cid:18)(cid:18)(cid:2)(cid:44,Unknown,15029.0
Unknown,Unknown,29,Unknown,Unknown,Unknown,Unknown,cid:43)(cid:2)(cid:1)(cid:34)(cid:34)(cid:19)(cid:18)(cid:18)(cid:2)(cid:44,Unknown,15058.0
Unknown,Unknown,26,Unknown,Unknown,Unknown,Unknown,cid:43)(cid:2)(cid:1)(cid:34)(cid:34)(cid:19)(cid:18)(cid:18)(cid:2)(cid:44,Unknown,15084.0
Unknown,Unknown,41,Unknown,Unknown,Unknown,Unknown,cid:43)(cid:2)(cid:1)(cid:34)(cid:34)(cid:19)(cid:18)(cid:18)(cid:2)(cid:44,Unknown,15125.0
Unknown,Unknown,25,Unknown,Unknown,Unknown,Unknown,cid:43)(cid:2)(cid:1)(cid:34)(cid:34)(cid:19)(cid:18)(cid:18)(cid:2)(cid:44,Unknown,15150.0
Unknown,Unknown,2,Unknown,Unknown,Unknown,Unknown,cid:43)(cid:2)(cid:1)(cid:34)(cid:34)(cid:19)(cid:18)(cid:18)(cid:2)(cid:44,Unknown,15152.0
Unknown,Unknown,50,Unknown,Unknown,Unknown,Unknown,cid:43)(cid:2)(cid:1)(cid:34)(cid:34)(cid:19)(cid:18)(cid:18)(cid:2)(cid:44,Unknown,15202.0
Unknown,Unknown,50,Unknown,Unknown,Unknown,Unknown,cid:43)(cid:2)(cid:1)(cid:34)(cid:34)(cid:19)(cid:18)(cid:18)(cid:2)(cid:44,Unknown,15252.0
Unknown,Unknown,37,Unknown,Unknown,Unknown,Unknown,cid:43)(cid:2)(cid:1)(cid:34)(cid:34)(cid:19)(cid:18)(cid:18)(cid:2)(cid:44,Unknown,15289.0
Unknown,Unknown,16,Unknown,Unknown,Unknown,Unknown,cid:43)(cid:2)(cid:1)(cid:34)(cid:34)(cid:19)(cid:18)(cid:18)(cid:2)(cid:44,Unknown,15305.0
Unknown,Unknown,34,Unknown,Unknown,Unknown,Unknown,cid:43)(cid:2)(cid:1)(cid:34)(cid:34)(cid:19)(cid:18)(cid:18)(cid:2)(cid:44,Unknown,15339.0
Unknown,Unknown,33,Unknown,Unknown,Unknown,Unknown,cid:43)(cid:2)(cid:1)(cid:34)(cid:34)(cid:19)(cid:18)(cid:18)(cid:2)(cid:44,Unknown,15372.0
Unknown,Unknown,1,Unknown,Unknown,Unknown,Unknown,cid:43)(cid:2)(cid:1)(cid:34)(cid:34)(cid:19)(cid:18)(cid:18)(cid:2)(cid:44,Unknown,15373.0
Unknown,Unknown,37,Unknown,Unknown,Unknown,Unknown,cid:43)(cid:2)(cid:1)(cid:34)(cid:34)(cid:19)(cid:18)(cid:18)(cid:2)(cid:44,Unknown,15410.0
Unknown,Unknown,45,Unknown,Unknown,Unknown,Unknown,cid:43)(cid:2)(cid:1)(cid:34)(cid:34)(cid:19)(cid:18)(cid:18)(cid:2)(cid:44,Unknown,15455.0
Unknown,Unknown,18,Unknown,Unknown,Unknown,Unknown,cid:43)(cid:2)(cid:1)(cid:34)(cid:34)(cid:19)(cid:18)(cid:18)(cid:2)(cid:44,Unknown,15473.0
Unknown,Unknown,35,Unknown,Unknown,Unknown,Unknown,cid:43)(cid:2)(cid:1)(cid:34)(cid:34)(cid:19)(cid:18)(cid:18)(cid:2)(cid:44,Unknown,15508.0
Unknown,Unknown,52,Unknown,Unknown,Unknown,Unknown,cid:43)(cid:2)(cid:1)(cid:34)(cid:34)(cid:19)(cid:18)(cid:18)(cid:2)(cid:44,Unknown,15560.0
Unknown,Unknown,7,Unknown,Unknown,Unknown,Unknown,cid:43)(cid:2)(cid:1)(cid:34)(cid:34)(cid:19)(cid:18)(cid:18)(cid:2)(cid:44,Unknown,15567.0
Unknown,Unknown,52,Unknown,Unknown,Unknown,Unknown,cid:43)(cid:2)(cid:1)(cid:34)(cid:34)(cid:19)(cid:18)(cid:18)(cid:2)(cid:44,Unknown,15619.0
Unknown,Unknown,46,Unknown,Unknown,Unknown,Unknown,cid:43)(cid:2)(cid:1)(cid:34)(cid:34)(cid:19)(cid:18)(cid:18)(cid:2)(cid:44,Unknown,15665.0
Unknown,Unknown,2,Unknown,Unknown,Unknown,Unknown,cid:43)(cid:2)(cid:1)(cid:34)(cid:34)(cid:19)(cid:18)(cid:18)(cid:2)(cid:44,Unknown,15667.0
Unknown,Unknown,28,Unknown,Unknown,Unknown,Unknown,cid:43)(cid:2)(cid:1)(cid:34)(cid:34)(cid:19)(cid:18)(cid:18)(cid:2)(cid:44,Unknown,15695.0
Unknown,Unknown,3,Unknown,Unknown,Unknown,Unknown,cid:43)(cid:2)(cid:1)(cid:34)(cid:34)(cid:19)(cid:18)(cid:18)(cid:2)(cid:44,Unknown,15698.0
Unknown,Unknown,5,Unknown,Unknown,Unknown,Unknown,cid:43)(cid:2)(cid:1)(cid:34)(cid:34)(cid:19)(cid:18)(cid:18)(cid:2)(cid:44,Unknown,15703.0
Unknown,Unknown,9,Unknown,Unknown,Unknown,Unknown,cid:43)(cid:2)(cid:1)(cid:34)(cid:34)(cid:19)(cid:18)(cid:18)(cid:2)(cid:44,Unknown,15712.0
Unknown,Unknown,13,Unknown,Unknown,Unknown,Unknown,cid:43)(cid:2)(cid:1)(cid:34)(cid:34)(cid:19)(cid:18)(cid:18)(cid:2)(cid:44,Unknown,15725.0
Unknown,Unknown,2,Unknown,Unknown,Unknown,Unknown,cid:43)(cid:2)(cid:1)(cid:34)(cid:34)(cid:19)(cid:18)(cid:18)(cid:2)(cid:44,Unknown,15727.0
Unknown,Unknown,28,Unknown,Unknown,Unknown,Unknown,cid:43)(cid:2)(cid:1)(cid:34)(cid:34)(cid:19)(cid:18)(cid:18)(cid:2)(cid:44,Unknown,15755.0
Unknown,Unknown,5,Unknown,Unknown,Unknown,Unknown,cid:43)(cid:2)(cid:1)(cid:34)(cid:34)(cid:19)(cid:18)(cid:18)(cid:2)(cid:44,Unknown,15760.0
Unknown,Unknown,3,Unknown,Unknown,Unknown,Unknown,cid:43)(cid:2)(cid:1)(cid:34)(cid:34)(cid:19)(cid:18)(cid:18)(cid:2)(cid:44,Unknown,15763.0
Unknown,Unknown,7,Unknown,Unknown,Unknown,Unknown,cid:43)(cid:2)(cid:1)(cid:34)(cid:34)(cid:19)(cid:18)(cid:18)(cid:2)(cid:44,Unknown,15770.0
Unknown,Unknown,64,Unknown,Unknown,Unknown,Unknown,cid:43)(cid:2)(cid:1)(cid:34)(cid:34)(cid:19)(cid:18)(cid:18)(cid:2)(cid:44,Unknown,15834.0
Unknown,Unknown,46,Unknown,Unknown,Unknown,Unknown,cid:43)(cid:2)(cid:1)(cid:34)(cid:34)(cid:19)(cid:18)(cid:18)(cid:2)(cid:44,Unknown,15880.0
Unknown,Unknown,65,Unknown,Unknown,Unknown,Unknown,cid:43)(cid:2)(cid:1)(cid:34)(cid:34)(cid:19)(cid:18)(cid:18)(cid:2)(cid:44,Unknown,15945.0
Unknown,Unknown,2,Unknown,Unknown,Unknown,Unknown,cid:43)(cid:2)(cid:1)(cid:34)(cid:34)(cid:19)(cid:18)(cid:18)(cid:2)(cid:44,Unknown,15947.0
Unknown,Unknown,38,Unknown,Unknown,Unknown,Unknown,cid:43)(cid:2)(cid:1)(cid:34)(cid:34)(cid:19)(cid:18)(cid:18)(cid:2)(cid:44,Unknown,15985.0
Unknown,Unknown,64,Unknown,Unknown,Unknown,Unknown,cid:43)(cid:2)(cid:1)(cid:34)(cid:34)(cid:19)(cid:18)(cid:18)(cid:2)(cid:44,Unknown,16049.0
Unknown,Unknown,15,Unknown,Unknown,Unknown,Unknown,cid:43)(cid:2)(cid:1)(cid:34)(cid:34)(cid:19)(cid:18)(cid:18)(cid:2)(cid:44,Unknown,16064.0
Unknown,Unknown,2,Unknown,Unknown,Unknown,Unknown,cid:43)(cid:2)(cid:1)(cid:34)(cid:34)(cid:19)(cid:18)(cid:18)(cid:2)(cid:44,Unknown,16066.0
Unknown,Unknown,37,Unknown,Unknown,Unknown,Unknown,cid:43)(cid:2)(cid:1)(cid:34)(cid:34)(cid:19)(cid:18)(cid:18)(cid:2)(cid:44,Unknown,16103.0
Unknown,Unknown,18,Unknown,Unknown,Unknown,Unknown,cid:43)(cid:2)(cid:1)(cid:34)(cid:34)(cid:19)(cid:18)(cid:18)(cid:2)(cid:44,Unknown,16121.0
Unknown,Unknown,19,Unknown,Unknown,Unknown,Unknown,cid:43)(cid:2)(cid:1)(cid:34)(cid:34)(cid:19)(cid:18)(cid:18)(cid:2)(cid:44,Unknown,16140.0
Unknown,Unknown,32,Unknown,Unknown,Unknown,Unknown,cid:43)(cid:2)(cid:1)(cid:34)(cid:34)(cid:19)(cid:18)(cid:18)(cid:2)(cid:44,Unknown,16172.0
Unknown,Unknown,17,Unknown,Unknown,Unknown,Unknown,cid:43)(cid:2)(cid:1)(cid:34)(cid:34)(cid:19)(cid:18)(cid:18)(cid:2)(cid:44,Unknown,16189.0
Unknown,Unknown,2,Unknown,Unknown,Unknown,Unknown,cid:43)(cid:2)(cid:1)(cid:34)(cid:34)(cid:19)(cid:18)(cid:18)(cid:2)(cid:44,Unknown,16191.0
Unknown,Unknown,44,Unknown,Unknown,Unknown,Unknown,cid:43)(cid:2)(cid:1)(cid:34)(cid:34)(cid:19)(cid:18)(cid:18)(cid:2)(cid:44,Unknown,16235.0
Unknown,Unknown,12,Unknown,Unknown,Unknown,Unknown,cid:43)(cid:2)(cid:1)(cid:34)(cid:34)(cid:19)(cid:18)(cid:18)(cid:2)(cid:44,Unknown,16247.0
Unknown,Unknown,29,Unknown,Unknown,Unknown,Unknown,cid:43)(cid:2)(cid:1)(cid:34)(cid:34)(cid:19)(cid:18)(cid:18)(cid:2)(cid:44,Unknown,16276.0
Unknown,Unknown,26,Unknown,Unknown,Unknown,Unknown,cid:43)(cid:2)(cid:1)(cid:34)(cid:34)(cid:19)(cid:18)(cid:18)(cid:2)(cid:44,Unknown,16302.0
Unknown,Unknown,41,Unknown,Unknown,Unknown,Unknown,cid:43)(cid:2)(cid:1)(cid:34)(cid:34)(cid:19)(cid:18)(cid:18)(cid:2)(cid:44,Unknown,16343.0
Unknown,Unknown,25,Unknown,Unknown,Unknown,Unknown,cid:43)(cid:2)(cid:1)(cid:34)(cid:34)(cid:19)(cid:18)(cid:18)(cid:2)(cid:44,Unknown,16368.0
Unknown,Unknown,2,Unknown,Unknown,Unknown,Unknown,cid:43)(cid:2)(cid:1)(cid:34)(cid:34)(cid:19)(cid:18)(cid:18)(cid:2)(cid:44,Unknown,16370.0
Unknown,Unknown,50,Unknown,Unknown,Unknown,Unknown,cid:43)(cid:2)(cid:1)(cid:34)(cid:34)(cid:19)(cid:18)(cid:18)(cid:2)(cid:44,Unknown,16420.0
Unknown,Unknown,50,Unknown,Unknown,Unknown,Unknown,cid:43)(cid:2)(cid:1)(cid:34)(cid:34)(cid:19)(cid:18)(cid:18)(cid:2)(cid:44,Unknown,16470.0
Unknown,Unknown,37,Unknown,Unknown,Unknown,Unknown,cid:43)(cid:2)(cid:1)(cid:34)(cid:34)(cid:19)(cid:18)(cid:18)(cid:2)(cid:44,Unknown,16507.0
Unknown,Unknown,16,Unknown,Unknown,Unknown,Unknown,cid:43)(cid:2)(cid:1)(cid:34)(cid:34)(cid:19)(cid:18)(cid:18)(cid:2)(cid:44,Unknown,16523.0
Unknown,Unknown,34,Unknown,Unknown,Unknown,Unknown,cid:43)(cid:2)(cid:1)(cid:34)(cid:34)(cid:19)(cid:18)(cid:18)(cid:2)(cid:44,Unknown,16557.0
Unknown,Unknown,33,Unknown,Unknown,Unknown,Unknown,cid:43)(cid:2)(cid:1)(cid:34)(cid:34)(cid:19)(cid:18)(cid:18)(cid:2)(cid:44,Unknown,16590.0
Unknown,Unknown,1,Unknown,Unknown,Unknown,Unknown,cid:43)(cid:2)(cid:1)(cid:34)(cid:34)(cid:19)(cid:18)(cid:18)(cid:2)(cid:44,Unknown,16591.0
Unknown,Unknown,37,Unknown,Unknown,Unknown,Unknown,cid:43)(cid:2)(cid:1)(cid:34)(cid:34)(cid:19)(cid:18)(cid:18)(cid:2)(cid:44,Unknown,16628.0
Unknown,Unknown,45,Unknown,Unknown,Unknown,Unknown,cid:43)(cid:2)(cid:1)(cid:34)(cid:34)(cid:19)(cid:18)(cid:18)(cid:2)(cid:44,Unknown,16673.0
Unknown,Unknown,18,Unknown,Unknown,Unknown,Unknown,cid:43)(cid:2)(cid:1)(cid:34)(cid:34)(cid:19)(cid:18)(cid:18)(cid:2)(cid:44,Unknown,16691.0
Unknown,Unknown,35,Unknown,Unknown,Unknown,Unknown,cid:43)(cid:2)(cid:1)(cid:34)(cid:34)(cid:19)(cid:18)(cid:18)(cid:2)(cid:44,Unknown,16726.0
Unknown,Unknown,46,Unknown,Unknown,Unknown,Unknown,cid:43)(cid:2)(cid:1)(cid:34)(cid:34)(cid:19)(cid:18)(cid:18)(cid:2)(cid:44,Unknown,16772.0
Unknown,Unknown,14,Unknown,Unknown,Unknown,Unknown,cid:43)(cid:2)(cid:1)(cid:34)(cid:34)(cid:19)(cid:18)(cid:18)(cid:2)(cid:44,Unknown,16786.0
Unknown,Unknown,51,Unknown,Unknown,Unknown,Unknown,cid:43)(cid:2)(cid:1)(cid:34)(cid:34)(cid:19)(cid:18)(cid:18)(cid:2)(cid:44,Unknown,16837.0
Unknown,Unknown,7,Unknown,Unknown,Unknown,Unknown,cid:43)(cid:2)(cid:1)(cid:34)(cid:34)(cid:19)(cid:18)(cid:18)(cid:2)(cid:44,Unknown,16844.0
Unknown,Unknown,2,Unknown,Unknown,Unknown,Unknown,cid:43)(cid:2)(cid:1)(cid:34)(cid:34)(cid:19)(cid:18)(cid:18)(cid:2)(cid:44,Unknown,16846.0
Unknown,Unknown,66,Unknown,Unknown,Unknown,Unknown,cid:43)(cid:2)(cid:1)(cid:34)(cid:34)(cid:19)(cid:18)(cid:18)(cid:2)(cid:44,Unknown,16912.0
Unknown,Unknown,2,Unknown,Unknown,Unknown,Unknown,cid:43)(cid:2)(cid:1)(cid:34)(cid:34)(cid:19)(cid:18)(cid:18)(cid:2)(cid:44,Unknown,16914.0
Unknown,Unknown,28,Unknown,Unknown,Unknown,Unknown,cid:43)(cid:2)(cid:1)(cid:34)(cid:34)(cid:19)(cid:18)(cid:18)(cid:2)(cid:44,Unknown,16942.0
Unknown,Unknown,46,Unknown,Unknown,Unknown,Unknown,cid:43)(cid:2)(cid:1)(cid:34)(cid:34)(cid:19)(cid:18)(cid:18)(cid:2)(cid:44,Unknown,16988.0
Unknown,Unknown,9,Unknown,Unknown,Unknown,Unknown,cid:43)(cid:2)(cid:1)(cid:34)(cid:34)(cid:19)(cid:18)(cid:18)(cid:2)(cid:44,Unknown,16997.0
Unknown,Unknown,13,Unknown,Unknown,Unknown,Unknown,cid:43)(cid:2)(cid:1)(cid:34)(cid:34)(cid:19)(cid:18)(cid:18)(cid:2)(cid:44,Unknown,17010.0
Unknown,Unknown,7,Unknown,Unknown,Unknown,Unknown,cid:43)(cid:2)(cid:1)(cid:34)(cid:34)(cid:19)(cid:18)(cid:18)(cid:2)(cid:44,Unknown,17017.0
Unknown,Unknown,11,Unknown,Unknown,Unknown,Unknown,cid:43)(cid:2)(cid:1)(cid:34)(cid:34)(cid:19)(cid:18)(cid:18)(cid:2)(cid:44,Unknown,17028.0
Unknown,Unknown,8,Unknown,Unknown,Unknown,Unknown,cid:43)(cid:2)(cid:1)(cid:34)(cid:34)(cid:19)(cid:18)(cid:18)(cid:2)(cid:44,Unknown,17036.0
Unknown,Unknown,2,Unknown,Unknown,Unknown,Unknown,cid:43)(cid:2)(cid:1)(cid:34)(cid:34)(cid:19)(cid:18)(cid:18)(cid:2)(cid:44,Unknown,17038.0
Unknown,Unknown,15,Unknown,Unknown,Unknown,Unknown,cid:43)(cid:2)(cid:1)(cid:34)(cid:34)(cid:19)(cid:18)(cid:18)(cid:2)(cid:44,Unknown,17053.0
Unknown,Unknown,10,Unknown,Unknown,Unknown,Unknown,cid:43)(cid:2)(cid:1)(cid:34)(cid:34)(cid:19)(cid:18)(cid:18)(cid:2)(cid:44,Unknown,17063.0
Unknown,Unknown,24,Unknown,Unknown,Unknown,Unknown,cid:43)(cid:2)(cid:1)(cid:34)(cid:34)(cid:19)(cid:18)(cid:18)(cid:2)(cid:44,Unknown,17087.0
Unknown,Unknown,23,Unknown,Unknown,Unknown,Unknown,cid:43)(cid:2)(cid:1)(cid:34)(cid:34)(cid:19)(cid:18)(cid:18)(cid:2)(cid:44,Unknown,17110.0
Unknown,Unknown,47,Unknown,Unknown,Unknown,Unknown,cid:43)(cid:2)(cid:1)(cid:34)(cid:34)(cid:19)(cid:18)(cid:18)(cid:2)(cid:44,Unknown,17157.0
Unknown,Unknown,2,Unknown,Unknown,Unknown,Unknown,cid:43)(cid:2)(cid:1)(cid:34)(cid:34)(cid:19)(cid:18)(cid:18)(cid:2)(cid:44,Unknown,17159.0
Unknown,Unknown,39,Unknown,Unknown,Unknown,Unknown,cid:43)(cid:2)(cid:1)(cid:34)(cid:34)(cid:19)(cid:18)(cid:18)(cid:2)(cid:44,Unknown,17198.0
Unknown,Unknown,3,Unknown,Unknown,Unknown,Unknown,cid:43)(cid:2)(cid:1)(cid:34)(cid:34)(cid:19)(cid:18)(cid:18)(cid:2)(cid:44,Unknown,17201.0
Unknown,Unknown,7,Unknown,Unknown,Unknown,Unknown,cid:43)(cid:2)(cid:1)(cid:34)(cid:34)(cid:19)(cid:18)(cid:18)(cid:2)(cid:44,Unknown,17208.0
Unknown,Unknown,9,Unknown,Unknown,Unknown,Unknown,cid:43)(cid:2)(cid:1)(cid:34)(cid:34)(cid:19)(cid:18)(cid:18)(cid:2)(cid:44,Unknown,17217.0
Unknown,Unknown,13,Unknown,Unknown,Unknown,Unknown,cid:43)(cid:2)(cid:1)(cid:34)(cid:34)(cid:19)(cid:18)(cid:18)(cid:2)(cid:44,Unknown,17230.0
Unknown,Unknown,10,Unknown,Unknown,Unknown,Unknown,cid:43)(cid:2)(cid:1)(cid:34)(cid:34)(cid:19)(cid:18)(cid:18)(cid:2)(cid:44,Unknown,17240.0
Unknown,Unknown,7,Unknown,Unknown,Unknown,Unknown,cid:43)(cid:2)(cid:1)(cid:34)(cid:34)(cid:19)(cid:18)(cid:18)(cid:2)(cid:44,Unknown,17247.0
Unknown,Unknown,8,Unknown,Unknown,Unknown,Unknown,cid:43)(cid:2)(cid:1)(cid:34)(cid:34)(cid:19)(cid:18)(cid:18)(cid:2)(cid:44,Unknown,17255.0
Unknown,Unknown,46,Unknown,Unknown,Unknown,Unknown,cid:43)(cid:2)(cid:1)(cid:34)(cid:34)(cid:19)(cid:18)(cid:18)(cid:2)(cid:44,Unknown,17301.0
Unknown,Unknown,2,Unknown,Unknown,Unknown,Unknown,cid:43)(cid:2)(cid:1)(cid:34)(cid:34)(cid:19)(cid:18)(cid:18)(cid:2)(cid:44,Unknown,17303.0
Unknown,Unknown,38,Unknown,Unknown,Unknown,Unknown,cid:43)(cid:2)(cid:1)(cid:34)(cid:34)(cid:19)(cid:18)(cid:18)(cid:2)(cid:44,Unknown,17341.0
Unknown,Unknown,64,Unknown,Unknown,Unknown,Unknown,cid:43)(cid:2)(cid:1)(cid:34)(cid:34)(cid:19)(cid:18)(cid:18)(cid:2)(cid:44,Unknown,17405.0
Unknown,Unknown,15,Unknown,Unknown,Unknown,Unknown,cid:43)(cid:2)(cid:1)(cid:34)(cid:34)(cid:19)(cid:18)(cid:18)(cid:2)(cid:44,Unknown,17420.0
Unknown,Unknown,2,Unknown,Unknown,Unknown,Unknown,cid:43)(cid:2)(cid:1)(cid:34)(cid:34)(cid:19)(cid:18)(cid:18)(cid:2)(cid:44,Unknown,17422.0
Unknown,Unknown,36,Unknown,Unknown,Unknown,Unknown,cid:43)(cid:2)(cid:1)(cid:34)(cid:34)(cid:19)(cid:18)(cid:18)(cid:2)(cid:44,Unknown,17458.0
Unknown,Unknown,33,Unknown,Unknown,Unknown,Unknown,cid:43)(cid:2)(cid:1)(cid:34)(cid:34)(cid:19)(cid:18)(cid:18)(cid:2)(cid:44,Unknown,17491.0
Unknown,Unknown,19,Unknown,Unknown,Unknown,Unknown,cid:43)(cid:2)(cid:1)(cid:34)(cid:34)(cid:19)(cid:18)(cid:18)(cid:2)(cid:44,Unknown,17510.0
Unknown,Unknown,34,Unknown,Unknown,Unknown,Unknown,cid:43)(cid:2)(cid:1)(cid:34)(cid:34)(cid:19)(cid:18)(cid:18)(cid:2)(cid:44,Unknown,17544.0
Unknown,Unknown,18,Unknown,Unknown,Unknown,Unknown,cid:43)(cid:2)(cid:1)(cid:34)(cid:34)(cid:19)(cid:18)(cid:18)(cid:2)(cid:44,Unknown,17562.0
Unknown,Unknown,2,Unknown,Unknown,Unknown,Unknown,cid:43)(cid:2)(cid:1)(cid:34)(cid:34)(cid:19)(cid:18)(cid:18)(cid:2)(cid:44,Unknown,17564.0
Unknown,Unknown,44,Unknown,Unknown,Unknown,Unknown,cid:43)(cid:2)(cid:1)(cid:34)(cid:34)(cid:19)(cid:18)(cid:18)(cid:2)(cid:44,Unknown,17608.0
Unknown,Unknown,12,Unknown,Unknown,Unknown,Unknown,cid:43)(cid:2)(cid:1)(cid:34)(cid:34)(cid:19)(cid:18)(cid:18)(cid:2)(cid:44,Unknown,17620.0
Unknown,Unknown,29,Unknown,Unknown,Unknown,Unknown,cid:43)(cid:2)(cid:1)(cid:34)(cid:34)(cid:19)(cid:18)(cid:18)(cid:2)(cid:44,Unknown,17649.0
Unknown,Unknown,26,Unknown,Unknown,Unknown,Unknown,cid:43)(cid:2)(cid:1)(cid:34)(cid:34)(cid:19)(cid:18)(cid:18)(cid:2)(cid:44,Unknown,17675.0
Unknown,Unknown,41,Unknown,Unknown,Unknown,Unknown,cid:43)(cid:2)(cid:1)(cid:34)(cid:34)(cid:19)(cid:18)(cid:18)(cid:2)(cid:44,Unknown,17716.0
Unknown,Unknown,25,Unknown,Unknown,Unknown,Unknown,cid:43)(cid:2)(cid:1)(cid:34)(cid:34)(cid:19)(cid:18)(cid:18)(cid:2)(cid:44,Unknown,17741.0
Unknown,Unknown,2,Unknown,Unknown,Unknown,Unknown,cid:43)(cid:2)(cid:1)(cid:34)(cid:34)(cid:19)(cid:18)(cid:18)(cid:2)(cid:44,Unknown,17743.0
Unknown,Unknown,50,Unknown,Unknown,Unknown,Unknown,cid:43)(cid:2)(cid:1)(cid:34)(cid:34)(cid:19)(cid:18)(cid:18)(cid:2)(cid:44,Unknown,17793.0
Unknown,Unknown,50,Unknown,Unknown,Unknown,Unknown,cid:43)(cid:2)(cid:1)(cid:34)(cid:34)(cid:19)(cid:18)(cid:18)(cid:2)(cid:44,Unknown,17843.0
Unknown,Unknown,18,Unknown,Unknown,Unknown,Unknown,cid:43)(cid:2)(cid:1)(cid:34)(cid:34)(cid:19)(cid:18)(cid:18)(cid:2)(cid:44,Unknown,17861.0
Unknown,Unknown,1,Unknown,Unknown,Unknown,Unknown,cid:43)(cid:2)(cid:1)(cid:34)(cid:34)(cid:19)(cid:18)(cid:18)(cid:2)(cid:44,Unknown,17862.0
Unknown,Unknown,1,Unknown,Unknown,Unknown,Unknown,cid:43)(cid:2)(cid:1)(cid:34)(cid:34)(cid:19)(cid:18)(cid:18)(cid:2)(cid:44,Unknown,17863.0
Unknown,Unknown,37,Unknown,Unknown,Unknown,Unknown,cid:43)(cid:2)(cid:1)(cid:34)(cid:34)(cid:19)(cid:18)(cid:18)(cid:2)(cid:44,Unknown,17900.0
Unknown,Unknown,1,Unknown,Unknown,Unknown,Unknown,cid:43)(cid:2)(cid:1)(cid:34)(cid:34)(cid:19)(cid:18)(cid:18)(cid:2)(cid:44,Unknown,17901.0
Unknown,Unknown,37,Unknown,Unknown,Unknown,Unknown,cid:43)(cid:2)(cid:1)(cid:34)(cid:34)(cid:19)(cid:18)(cid:18)(cid:2)(cid:44,Unknown,17938.0
Unknown,Unknown,45,Unknown,Unknown,Unknown,Unknown,cid:43)(cid:2)(cid:1)(cid:34)(cid:34)(cid:19)(cid:18)(cid:18)(cid:2)(cid:44,Unknown,17983.0
Unknown,Unknown,18,Unknown,Unknown,Unknown,Unknown,cid:43)(cid:2)(cid:1)(cid:34)(cid:34)(cid:19)(cid:18)(cid:18)(cid:2)(cid:44,Unknown,18001.0
Unknown,Unknown,35,Unknown,Unknown,Unknown,Unknown,cid:43)(cid:2)(cid:1)(cid:34)(cid:34)(cid:19)(cid:18)(cid:18)(cid:2)(cid:44,Unknown,18036.0
Unknown,Unknown,51,Unknown,Unknown,Unknown,Unknown,cid:43)(cid:2)(cid:1)(cid:34)(cid:34)(cid:19)(cid:18)(cid:18)(cid:2)(cid:44,Unknown,18087.0
Unknown,Unknown,5,Unknown,Unknown,Unknown,Unknown,cid:43)(cid:2)(cid:1)(cid:34)(cid:34)(cid:19)(cid:18)(cid:18)(cid:2)(cid:44,Unknown,18092.0
Unknown,Unknown,67,Unknown,Unknown,Unknown,Unknown,cid:43)(cid:2)(cid:1)(cid:34)(cid:34)(cid:19)(cid:18)(cid:18)(cid:2)(cid:44,Unknown,18159.0
Unknown,Unknown,46,Unknown,Unknown,Unknown,Unknown,cid:43)(cid:2)(cid:1)(cid:34)(cid:34)(cid:19)(cid:18)(cid:18)(cid:2)(cid:44,Unknown,18205.0
Unknown,Unknown,2,Unknown,Unknown,Unknown,Unknown,cid:43)(cid:2)(cid:1)(cid:34)(cid:34)(cid:19)(cid:18)(cid:18)(cid:2)(cid:44,Unknown,18207.0
Unknown,Unknown,10,Unknown,Unknown,Unknown,Unknown,cid:43)(cid:2)(cid:1)(cid:34)(cid:34)(cid:19)(cid:18)(cid:18)(cid:2)(cid:44,Unknown,18217.0
Unknown,Unknown,3,Unknown,Unknown,Unknown,Unknown,cid:43)(cid:2)(cid:1)(cid:34)(cid:34)(cid:19)(cid:18)(cid:18)(cid:2)(cid:44,Unknown,18220.0
Unknown,Unknown,46,Unknown,Unknown,Unknown,Unknown,cid:43)(cid:2)(cid:1)(cid:34)(cid:34)(cid:19)(cid:18)(cid:18)(cid:2)(cid:44,Unknown,18266.0
Unknown,Unknown,49,Unknown,Unknown,Unknown,Unknown,cid:43)(cid:2)(cid:1)(cid:34)(cid:34)(cid:19)(cid:18)(cid:18)(cid:2)(cid:44,Unknown,18315.0
Unknown,Unknown,5,Unknown,Unknown,Unknown,Unknown,cid:43)(cid:2)(cid:1)(cid:34)(cid:34)(cid:19)(cid:18)(cid:18)(cid:2)(cid:44,Unknown,18320.0
Unknown,Unknown,2,Unknown,Unknown,Unknown,Unknown,cid:43)(cid:2)(cid:1)(cid:34)(cid:34)(cid:19)(cid:18)(cid:18)(cid:2)(cid:44,Unknown,18322.0
Unknown,Unknown,9,Unknown,Unknown,Unknown,Unknown,cid:43)(cid:2)(cid:1)(cid:34)(cid:34)(cid:19)(cid:18)(cid:18)(cid:2)(cid:44,Unknown,18331.0
Unknown,Unknown,13,Unknown,Unknown,Unknown,Unknown,cid:43)(cid:2)(cid:1)(cid:34)(cid:34)(cid:19)(cid:18)(cid:18)(cid:2)(cid:44,Unknown,18344.0
Unknown,Unknown,39,Unknown,Unknown,Unknown,Unknown,cid:43)(cid:2)(cid:1)(cid:34)(cid:34)(cid:19)(cid:18)(cid:18)(cid:2)(cid:44,Unknown,18383.0
Unknown,Unknown,67,Unknown,Unknown,Unknown,Unknown,cid:43)(cid:2)(cid:1)(cid:34)(cid:34)(cid:19)(cid:18)(cid:18)(cid:2)(cid:44,Unknown,18450.0
Unknown,Unknown,2,Unknown,Unknown,Unknown,Unknown,cid:43)(cid:2)(cid:1)(cid:34)(cid:34)(cid:19)(cid:18)(cid:18)(cid:2)(cid:44,Unknown,18452.0
Unknown,Unknown,39,Unknown,Unknown,Unknown,Unknown,cid:43)(cid:2)(cid:1)(cid:34)(cid:34)(cid:19)(cid:18)(cid:18)(cid:2)(cid:44,Unknown,18491.0
Unknown,Unknown,3,Unknown,Unknown,Unknown,Unknown,cid:43)(cid:2)(cid:1)(cid:34)(cid:34)(cid:19)(cid:18)(cid:18)(cid:2)(cid:44,Unknown,18494.0
Unknown,Unknown,7,Unknown,Unknown,Unknown,Unknown,cid:43)(cid:2)(cid:1)(cid:34)(cid:34)(cid:19)(cid:18)(cid:18)(cid:2)(cid:44,Unknown,18501.0
Unknown,Unknown,9,Unknown,Unknown,Unknown,Unknown,cid:43)(cid:2)(cid:1)(cid:34)(cid:34)(cid:19)(cid:18)(cid:18)(cid:2)(cid:44,Unknown,18510.0
Unknown,Unknown,13,Unknown,Unknown,Unknown,Unknown,cid:43)(cid:2)(cid:1)(cid:34)(cid:34)(cid:19)(cid:18)(cid:18)(cid:2)(cid:44,Unknown,18523.0
Unknown,Unknown,10,Unknown,Unknown,Unknown,Unknown,cid:43)(cid:2)(cid:1)(cid:34)(cid:34)(cid:19)(cid:18)(cid:18)(cid:2)(cid:44,Unknown,18533.0
Unknown,Unknown,7,Unknown,Unknown,Unknown,Unknown,cid:43)(cid:2)(cid:1)(cid:34)(cid:34)(cid:19)(cid:18)(cid:18)(cid:2)(cid:44,Unknown,18540.0
Unknown,Unknown,8,Unknown,Unknown,Unknown,Unknown,cid:43)(cid:2)(cid:1)(cid:34)(cid:34)(cid:19)(cid:18)(cid:18)(cid:2)(cid:44,Unknown,18548.0
Unknown,Unknown,46,Unknown,Unknown,Unknown,Unknown,cid:43)(cid:2)(cid:1)(cid:34)(cid:34)(cid:19)(cid:18)(cid:18)(cid:2)(cid:44,Unknown,18594.0
Unknown,Unknown,2,Unknown,Unknown,Unknown,Unknown,cid:43)(cid:2)(cid:1)(cid:34)(cid:34)(cid:19)(cid:18)(cid:18)(cid:2)(cid:44,Unknown,18596.0
Unknown,Unknown,38,Unknown,Unknown,Unknown,Unknown,cid:43)(cid:2)(cid:1)(cid:34)(cid:34)(cid:19)(cid:18)(cid:18)(cid:2)(cid:44,Unknown,18634.0
Unknown,Unknown,64,Unknown,Unknown,Unknown,Unknown,cid:43)(cid:2)(cid:1)(cid:34)(cid:34)(cid:19)(cid:18)(cid:18)(cid:2)(cid:44,Unknown,18698.0
Unknown,Unknown,15,Unknown,Unknown,Unknown,Unknown,cid:43)(cid:2)(cid:1)(cid:34)(cid:34)(cid:19)(cid:18)(cid:18)(cid:2)(cid:44,Unknown,18713.0
Unknown,Unknown,2,Unknown,Unknown,Unknown,Unknown,cid:43)(cid:2)(cid:1)(cid:34)(cid:34)(cid:19)(cid:18)(cid:18)(cid:2)(cid:44,Unknown,18715.0
Unknown,Unknown,17,Unknown,Unknown,Unknown,Unknown,cid:43)(cid:2)(cid:1)(cid:34)(cid:34)(cid:19)(cid:18)(cid:18)(cid:2)(cid:44,Unknown,18732.0
Unknown,Unknown,18,Unknown,Unknown,Unknown,Unknown,cid:43)(cid:2)(cid:1)(cid:34)(cid:34)(cid:19)(cid:18)(cid:18)(cid:2)(cid:44,Unknown,18750.0
Unknown,Unknown,19,Unknown,Unknown,Unknown,Unknown,cid:43)(cid:2)(cid:1)(cid:34)(cid:34)(cid:19)(cid:18)(cid:18)(cid:2)(cid:44,Unknown,18769.0
Unknown,Unknown,37,Unknown,Unknown,Unknown,Unknown,cid:43)(cid:2)(cid:1)(cid:34)(cid:34)(cid:19)(cid:18)(cid:18)(cid:2)(cid:44,Unknown,18806.0
Unknown,Unknown,33,Unknown,Unknown,Unknown,Unknown,cid:43)(cid:2)(cid:1)(cid:34)(cid:34)(cid:19)(cid:18)(cid:18)(cid:2)(cid:44,Unknown,18839.0
Unknown,Unknown,2,Unknown,Unknown,Unknown,Unknown,cid:43)(cid:2)(cid:1)(cid:34)(cid:34)(cid:19)(cid:18)(cid:18)(cid:2)(cid:44,Unknown,18841.0
Unknown,Unknown,44,Unknown,Unknown,Unknown,Unknown,cid:43)(cid:2)(cid:1)(cid:34)(cid:34)(cid:19)(cid:18)(cid:18)(cid:2)(cid:44,Unknown,18885.0
Unknown,Unknown,12,Unknown,Unknown,Unknown,Unknown,cid:43)(cid:2)(cid:1)(cid:34)(cid:34)(cid:19)(cid:18)(cid:18)(cid:2)(cid:44,Unknown,18897.0
Unknown,Unknown,29,Unknown,Unknown,Unknown,Unknown,cid:43)(cid:2)(cid:1)(cid:34)(cid:34)(cid:19)(cid:18)(cid:18)(cid:2)(cid:44,Unknown,18926.0
Unknown,Unknown,26,Unknown,Unknown,Unknown,Unknown,cid:43)(cid:2)(cid:1)(cid:34)(cid:34)(cid:19)(cid:18)(cid:18)(cid:2)(cid:44,Unknown,18952.0
Unknown,Unknown,41,Unknown,Unknown,Unknown,Unknown,cid:43)(cid:2)(cid:1)(cid:34)(cid:34)(cid:19)(cid:18)(cid:18)(cid:2)(cid:44,Unknown,18993.0
Unknown,Unknown,25,Unknown,Unknown,Unknown,Unknown,cid:43)(cid:2)(cid:1)(cid:34)(cid:34)(cid:19)(cid:18)(cid:18)(cid:2)(cid:44,Unknown,19018.0
Unknown,Unknown,2,Unknown,Unknown,Unknown,Unknown,cid:43)(cid:2)(cid:1)(cid:34)(cid:34)(cid:19)(cid:18)(cid:18)(cid:2)(cid:44,Unknown,19020.0
Unknown,Unknown,50,Unknown,Unknown,Unknown,Unknown,cid:43)(cid:2)(cid:1)(cid:34)(cid:34)(cid:19)(cid:18)(cid:18)(cid:2)(cid:44,Unknown,19070.0
Unknown,Unknown,50,Unknown,Unknown,Unknown,Unknown,cid:43)(cid:2)(cid:1)(cid:34)(cid:34)(cid:19)(cid:18)(cid:18)(cid:2)(cid:44,Unknown,19120.0
Unknown,Unknown,37,Unknown,Unknown,Unknown,Unknown,cid:43)(cid:2)(cid:1)(cid:34)(cid:34)(cid:19)(cid:18)(cid:18)(cid:2)(cid:44,Unknown,19157.0
Unknown,Unknown,16,Unknown,Unknown,Unknown,Unknown,cid:43)(cid:2)(cid:1)(cid:34)(cid:34)(cid:19)(cid:18)(cid:18)(cid:2)(cid:44,Unknown,19173.0
Unknown,Unknown,34,Unknown,Unknown,Unknown,Unknown,cid:43)(cid:2)(cid:1)(cid:34)(cid:34)(cid:19)(cid:18)(cid:18)(cid:2)(cid:44,Unknown,19207.0
Unknown,Unknown,33,Unknown,Unknown,Unknown,Unknown,cid:43)(cid:2)(cid:1)(cid:34)(cid:34)(cid:19)(cid:18)(cid:18)(cid:2)(cid:44,Unknown,19240.0
Unknown,Unknown,1,Unknown,Unknown,Unknown,Unknown,cid:43)(cid:2)(cid:1)(cid:34)(cid:34)(cid:19)(cid:18)(cid:18)(cid:2)(cid:44,Unknown,19241.0
Unknown,Unknown,36,Unknown,Unknown,Unknown,Unknown,cid:43)(cid:2)(cid:1)(cid:34)(cid:34)(cid:19)(cid:18)(cid:18)(cid:2)(cid:44,Unknown,19277.0
Unknown,Unknown,45,Unknown,Unknown,Unknown,Unknown,cid:43)(cid:2)(cid:1)(cid:34)(cid:34)(cid:19)(cid:18)(cid:18)(cid:2)(cid:44,Unknown,19322.0
Unknown,Unknown,18,Unknown,Unknown,Unknown,Unknown,cid:43)(cid:2)(cid:1)(cid:34)(cid:34)(cid:19)(cid:18)(cid:18)(cid:2)(cid:44,Unknown,19340.0
Unknown,Unknown,35,Unknown,Unknown,Unknown,Unknown,cid:43)(cid:2)(cid:1)(cid:34)(cid:34)(cid:19)(cid:18)(cid:18)(cid:2)(cid:44,Unknown,19375.0
Unknown,Unknown,9,Unknown,Unknown,Unknown,Unknown,cid:43)(cid:2)(cid:1)(cid:34)(cid:34)(cid:19)(cid:18)(cid:18)(cid:2)(cid:44,Unknown,19384.0
Unknown,Unknown,39,Unknown,Unknown,Unknown,Unknown,cid:43)(cid:2)(cid:1)(cid:34)(cid:34)(cid:19)(cid:18)(cid:18)(cid:2)(cid:44,Unknown,19423.0
Unknown,Unknown,11,Unknown,Unknown,Unknown,Unknown,cid:43)(cid:2)(cid:1)(cid:34)(cid:34)(cid:19)(cid:18)(cid:18)(cid:2)(cid:44,Unknown,19434.0
Unknown,Unknown,3,Unknown,Unknown,Unknown,Unknown,cid:43)(cid:2)(cid:1)(cid:34)(cid:34)(cid:19)(cid:18)(cid:18)(cid:2)(cid:44,Unknown,19437.0
Unknown,Unknown,10,Unknown,Unknown,Unknown,Unknown,cid:43)(cid:2)(cid:1)(cid:34)(cid:34)(cid:19)(cid:18)(cid:18)(cid:2)(cid:44,Unknown,19447.0
Unknown,Unknown,2,Unknown,Unknown,Unknown,Unknown,cid:43)(cid:2)(cid:1)(cid:34)(cid:34)(cid:19)(cid:18)(cid:18)(cid:2)(cid:44,Unknown,19449.0
Unknown,Unknown,7,Unknown,Unknown,Unknown,Unknown,cid:43)(cid:2)(cid:1)(cid:34)(cid:34)(cid:19)(cid:18)(cid:18)(cid:2)(cid:44,Unknown,19456.0
Unknown,Unknown,8,Unknown,Unknown,Unknown,Unknown,cid:43)(cid:2)(cid:1)(cid:34)(cid:34)(cid:19)(cid:18)(cid:18)(cid:2)(cid:44,Unknown,19464.0
Unknown,Unknown,15,Unknown,Unknown,Unknown,Unknown,cid:43)(cid:2)(cid:1)(cid:34)(cid:34)(cid:19)(cid:18)(cid:18)(cid:2)(cid:44,Unknown,19479.0
Unknown,Unknown,7,Unknown,Unknown,Unknown,Unknown,cid:43)(cid:2)(cid:1)(cid:34)(cid:34)(cid:19)(cid:18)(cid:18)(cid:2)(cid:44,Unknown,19486.0
Unknown,Unknown,8,Unknown,Unknown,Unknown,Unknown,cid:43)(cid:2)(cid:1)(cid:34)(cid:34)(cid:19)(cid:18)(cid:18)(cid:2)(cid:44,Unknown,19494.0
Unknown,Unknown,10,Unknown,Unknown,Unknown,Unknown,cid:43)(cid:2)(cid:1)(cid:34)(cid:34)(cid:19)(cid:18)(cid:18)(cid:2)(cid:44,Unknown,19504.0
Unknown,Unknown,5,Unknown,Unknown,Unknown,Unknown,cid:43)(cid:2)(cid:1)(cid:34)(cid:34)(cid:19)(cid:18)(cid:18)(cid:2)(cid:44,Unknown,19509.0
Unknown,Unknown,3,Unknown,Unknown,Unknown,Unknown,cid:43)(cid:2)(cid:1)(cid:34)(cid:34)(cid:19)(cid:18)(cid:18)(cid:2)(cid:44,Unknown,19512.0
Unknown,Unknown,2,Unknown,Unknown,Unknown,Unknown,cid:43)(cid:2)(cid:1)(cid:34)(cid:34)(cid:19)(cid:18)(cid:18)(cid:2)(cid:44,Unknown,19514.0
Unknown,Unknown,9,Unknown,Unknown,Unknown,Unknown,cid:43)(cid:2)(cid:1)(cid:34)(cid:34)(cid:19)(cid:18)(cid:18)(cid:2)(cid:44,Unknown,19523.0
Unknown,Unknown,39,Unknown,Unknown,Unknown,Unknown,cid:43)(cid:2)(cid:1)(cid:34)(cid:34)(cid:19)(cid:18)(cid:18)(cid:2)(cid:44,Unknown,19562.0
Unknown,Unknown,11,Unknown,Unknown,Unknown,Unknown,cid:43)(cid:2)(cid:1)(cid:34)(cid:34)(cid:19)(cid:18)(cid:18)(cid:2)(cid:44,Unknown,19573.0
Unknown,Unknown,3,Unknown,Unknown,Unknown,Unknown,cid:43)(cid:2)(cid:1)(cid:34)(cid:34)(cid:19)(cid:18)(cid:18)(cid:2)(cid:44,Unknown,19576.0
Unknown,Unknown,10,Unknown,Unknown,Unknown,Unknown,cid:43)(cid:2)(cid:1)(cid:34)(cid:34)(cid:19)(cid:18)(cid:18)(cid:2)(cid:44,Unknown,19586.0
Unknown,Unknown,2,Unknown,Unknown,Unknown,Unknown,cid:43)(cid:2)(cid:1)(cid:34)(cid:34)(cid:19)(cid:18)(cid:18)(cid:2)(cid:44,Unknown,19588.0
Unknown,Unknown,39,Unknown,Unknown,Unknown,Unknown,cid:43)(cid:2)(cid:1)(cid:34)(cid:34)(cid:19)(cid:18)(cid:18)(cid:2)(cid:44,Unknown,19627.0
Unknown,Unknown,3,Unknown,Unknown,Unknown,Unknown,cid:43)(cid:2)(cid:1)(cid:34)(cid:34)(cid:19)(cid:18)(cid:18)(cid:2)(cid:44,Unknown,19630.0
Unknown,Unknown,7,Unknown,Unknown,Unknown,Unknown,cid:43)(cid:2)(cid:1)(cid:34)(cid:34)(cid:19)(cid:18)(cid:18)(cid:2)(cid:44,Unknown,19637.0
Unknown,Unknown,9,Unknown,Unknown,Unknown,Unknown,cid:43)(cid:2)(cid:1)(cid:34)(cid:34)(cid:19)(cid:18)(cid:18)(cid:2)(cid:44,Unknown,19646.0
Unknown,Unknown,13,Unknown,Unknown,Unknown,Unknown,cid:43)(cid:2)(cid:1)(cid:34)(cid:34)(cid:19)(cid:18)(cid:18)(cid:2)(cid:44,Unknown,19659.0
Unknown,Unknown,10,Unknown,Unknown,Unknown,Unknown,cid:43)(cid:2)(cid:1)(cid:34)(cid:34)(cid:19)(cid:18)(cid:18)(cid:2)(cid:44,Unknown,19669.0
Unknown,Unknown,7,Unknown,Unknown,Unknown,Unknown,cid:43)(cid:2)(cid:1)(cid:34)(cid:34)(cid:19)(cid:18)(cid:18)(cid:2)(cid:44,Unknown,19676.0
Unknown,Unknown,8,Unknown,Unknown,Unknown,Unknown,cid:43)(cid:2)(cid:1)(cid:34)(cid:34)(cid:19)(cid:18)(cid:18)(cid:2)(cid:44,Unknown,19684.0
Unknown,Unknown,5,Unknown,Unknown,Unknown,Unknown,cid:43)(cid:2)(cid:1)(cid:34)(cid:34)(cid:19)(cid:18)(cid:18)(cid:2)(cid:44,Unknown,19689.0
Unknown,Unknown,2,Unknown,Unknown,Unknown,Unknown,cid:43)(cid:2)(cid:1)(cid:34)(cid:34)(cid:19)(cid:18)(cid:18)(cid:2)(cid:44,Unknown,19691.0
Unknown,Unknown,38,Unknown,Unknown,Unknown,Unknown,cid:43)(cid:2)(cid:1)(cid:34)(cid:34)(cid:19)(cid:18)(cid:18)(cid:2)(cid:44,Unknown,19729.0
Unknown,Unknown,64,Unknown,Unknown,Unknown,Unknown,cid:43)(cid:2)(cid:1)(cid:34)(cid:34)(cid:19)(cid:18)(cid:18)(cid:2)(cid:44,Unknown,19793.0
Unknown,Unknown,15,Unknown,Unknown,Unknown,Unknown,cid:43)(cid:2)(cid:1)(cid:34)(cid:34)(cid:19)(cid:18)(cid:18)(cid:2)(cid:44,Unknown,19808.0
Unknown,Unknown,2,Unknown,Unknown,Unknown,Unknown,cid:43)(cid:2)(cid:1)(cid:34)(cid:34)(cid:19)(cid:18)(cid:18)(cid:2)(cid:44,Unknown,19810.0
Unknown,Unknown,17,Unknown,Unknown,Unknown,Unknown,cid:43)(cid:2)(cid:1)(cid:34)(cid:34)(cid:19)(cid:18)(cid:18)(cid:2)(cid:44,Unknown,19827.0
Unknown,Unknown,1,Unknown,Unknown,Unknown,Unknown,cid:43)(cid:2)(cid:1)(cid:34)(cid:34)(cid:19)(cid:18)(cid:18)(cid:2)(cid:44,Unknown,19828.0
Unknown,Unknown,1,Unknown,Unknown,Unknown,Unknown,cid:43)(cid:2)(cid:1)(cid:34)(cid:34)(cid:19)(cid:18)(cid:18)(cid:2)(cid:44,Unknown,19829.0
Unknown,Unknown,19,Unknown,Unknown,Unknown,Unknown,cid:43)(cid:2)(cid:1)(cid:34)(cid:34)(cid:19)(cid:18)(cid:18)(cid:2)(cid:44,Unknown,19848.0
Unknown,Unknown,18,Unknown,Unknown,Unknown,Unknown,cid:43)(cid:2)(cid:1)(cid:34)(cid:34)(cid:19)(cid:18)(cid:18)(cid:2)(cid:44,Unknown,19866.0
Unknown,Unknown,18,Unknown,Unknown,Unknown,Unknown,cid:43)(cid:2)(cid:1)(cid:34)(cid:34)(cid:19)(cid:18)(cid:18)(cid:2)(cid:44,Unknown,19884.0
Unknown,Unknown,2,Unknown,Unknown,Unknown,Unknown,cid:43)(cid:2)(cid:1)(cid:34)(cid:34)(cid:19)(cid:18)(cid:18)(cid:2)(cid:44,Unknown,19886.0
Unknown,Unknown,44,Unknown,Unknown,Unknown,Unknown,cid:43)(cid:2)(cid:1)(cid:34)(cid:34)(cid:19)(cid:18)(cid:18)(cid:2)(cid:44,Unknown,19930.0
Unknown,Unknown,12,Unknown,Unknown,Unknown,Unknown,cid:43)(cid:2)(cid:1)(cid:34)(cid:34)(cid:19)(cid:18)(cid:18)(cid:2)(cid:44,Unknown,19942.0
Unknown,Unknown,29,Unknown,Unknown,Unknown,Unknown,cid:43)(cid:2)(cid:1)(cid:34)(cid:34)(cid:19)(cid:18)(cid:18)(cid:2)(cid:44,Unknown,19971.0
Unknown,Unknown,26,Unknown,Unknown,Unknown,Unknown,cid:43)(cid:2)(cid:1)(cid:34)(cid:34)(cid:19)(cid:18)(cid:18)(cid:2)(cid:44,Unknown,19997.0
Unknown,Unknown,41,Unknown,Unknown,Unknown,Unknown,cid:43)(cid:2)(cid:1)(cid:34)(cid:34)(cid:19)(cid:18)(cid:18)(cid:2)(cid:44,Unknown,20038.0
Unknown,Unknown,25,Unknown,Unknown,Unknown,Unknown,cid:43)(cid:2)(cid:1)(cid:34)(cid:34)(cid:19)(cid:18)(cid:18)(cid:2)(cid:44,Unknown,20063.0
Unknown,Unknown,2,Unknown,Unknown,Unknown,Unknown,cid:43)(cid:2)(cid:1)(cid:34)(cid:34)(cid:19)(cid:18)(cid:18)(cid:2)(cid:44,Unknown,20065.0
Unknown,Unknown,50,Unknown,Unknown,Unknown,Unknown,cid:43)(cid:2)(cid:1)(cid:34)(cid:34)(cid:19)(cid:18)(cid:18)(cid:2)(cid:44,Unknown,20115.0
Unknown,Unknown,50,Unknown,Unknown,Unknown,Unknown,cid:43)(cid:2)(cid:1)(cid:34)(cid:34)(cid:19)(cid:18)(cid:18)(cid:2)(cid:44,Unknown,20165.0
Unknown,Unknown,18,Unknown,Unknown,Unknown,Unknown,cid:43)(cid:2)(cid:1)(cid:34)(cid:34)(cid:19)(cid:18)(cid:18)(cid:2)(cid:44,Unknown,20183.0
Unknown,Unknown,1,Unknown,Unknown,Unknown,Unknown,cid:43)(cid:2)(cid:1)(cid:34)(cid:34)(cid:19)(cid:18)(cid:18)(cid:2)(cid:44,Unknown,20184.0
Unknown,Unknown,1,Unknown,Unknown,Unknown,Unknown,cid:43)(cid:2)(cid:1)(cid:34)(cid:34)(cid:19)(cid:18)(cid:18)(cid:2)(cid:44,Unknown,20185.0
Unknown,Unknown,37,Unknown,Unknown,Unknown,Unknown,cid:43)(cid:2)(cid:1)(cid:34)(cid:34)(cid:19)(cid:18)(cid:18)(cid:2)(cid:44,Unknown,20222.0
Unknown,Unknown,1,Unknown,Unknown,Unknown,Unknown,cid:43)(cid:2)(cid:1)(cid:34)(cid:34)(cid:19)(cid:18)(cid:18)(cid:2)(cid:44,Unknown,20223.0
Unknown,Unknown,36,Unknown,Unknown,Unknown,Unknown,cid:43)(cid:2)(cid:1)(cid:34)(cid:34)(cid:19)(cid:18)(cid:18)(cid:2)(cid:44,Unknown,20259.0
Unknown,Unknown,45,Unknown,Unknown,Unknown,Unknown,cid:43)(cid:2)(cid:1)(cid:34)(cid:34)(cid:19)(cid:18)(cid:18)(cid:2)(cid:44,Unknown,20304.0
Unknown,Unknown,18,Unknown,Unknown,Unknown,Unknown,cid:43)(cid:2)(cid:1)(cid:34)(cid:34)(cid:19)(cid:18)(cid:18)(cid:2)(cid:44,Unknown,20322.0
Unknown,Unknown,35,Unknown,Unknown,Unknown,Unknown,cid:43)(cid:2)(cid:1)(cid:34)(cid:34)(cid:19)(cid:18)(cid:18)(cid:2)(cid:44,Unknown,20357.0
Unknown,Unknown,53,Unknown,Unknown,Unknown,Unknown,cid:43)(cid:2)(cid:1)(cid:34)(cid:34)(cid:19)(cid:18)(cid:18)(cid:2)(cid:44,Unknown,20410.0
Unknown,Unknown,5,Unknown,Unknown,Unknown,Unknown,cid:43)(cid:2)(cid:1)(cid:34)(cid:34)(cid:19)(cid:18)(cid:18)(cid:2)(cid:44,Unknown,20415.0
Unknown,Unknown,8,Unknown,Unknown,Unknown,Unknown,cid:43)(cid:2)(cid:1)(cid:34)(cid:34)(cid:19)(cid:18)(cid:18)(cid:2)(cid:44,Unknown,20423.0
Unknown,Unknown,5,Unknown,Unknown,Unknown,Unknown,cid:43)(cid:2)(cid:1)(cid:34)(cid:34)(cid:19)(cid:18)(cid:18)(cid:2)(cid:44,Unknown,20428.0
Unknown,Unknown,3,Unknown,Unknown,Unknown,Unknown,cid:43)(cid:2)(cid:1)(cid:34)(cid:34)(cid:19)(cid:18)(cid:18)(cid:2)(cid:44,Unknown,20431.0
Unknown,Unknown,46,Unknown,Unknown,Unknown,Unknown,cid:43)(cid:2)(cid:1)(cid:34)(cid:34)(cid:19)(cid:18)(cid:18)(cid:2)(cid:44,Unknown,20477.0
Unknown,Unknown,14,Unknown,Unknown,Unknown,Unknown,cid:43)(cid:2)(cid:1)(cid:34)(cid:34)(cid:19)(cid:18)(cid:18)(cid:2)(cid:44,Unknown,20491.0
Unknown,Unknown,7,Unknown,Unknown,Unknown,Unknown,cid:43)(cid:2)(cid:1)(cid:34)(cid:34)(cid:19)(cid:18)(cid:18)(cid:2)(cid:44,Unknown,20498.0
Unknown,Unknown,2,Unknown,Unknown,Unknown,Unknown,cid:43)(cid:2)(cid:1)(cid:34)(cid:34)(cid:19)(cid:18)(cid:18)(cid:2)(cid:44,Unknown,20500.0
Unknown,Unknown,7,Unknown,Unknown,Unknown,Unknown,cid:43)(cid:2)(cid:1)(cid:34)(cid:34)(cid:19)(cid:18)(cid:18)(cid:2)(cid:44,Unknown,20507.0
Unknown,Unknown,46,Unknown,Unknown,Unknown,Unknown,cid:43)(cid:2)(cid:1)(cid:34)(cid:34)(cid:19)(cid:18)(cid:18)(cid:2)(cid:44,Unknown,20553.0
Unknown,Unknown,3,Unknown,Unknown,Unknown,Unknown,cid:43)(cid:2)(cid:1)(cid:34)(cid:34)(cid:19)(cid:18)(cid:18)(cid:2)(cid:44,Unknown,20556.0
Unknown,Unknown,49,Unknown,Unknown,Unknown,Unknown,cid:43)(cid:2)(cid:1)(cid:34)(cid:34)(cid:19)(cid:18)(cid:18)(cid:2)(cid:44,Unknown,20605.0
Unknown,Unknown,2,Unknown,Unknown,Unknown,Unknown,cid:43)(cid:2)(cid:1)(cid:34)(cid:34)(cid:19)(cid:18)(cid:18)(cid:2)(cid:44,Unknown,20607.0
Unknown,Unknown,9,Unknown,Unknown,Unknown,Unknown,cid:43)(cid:2)(cid:1)(cid:34)(cid:34)(cid:19)(cid:18)(cid:18)(cid:2)(cid:44,Unknown,20616.0
Unknown,Unknown,46,Unknown,Unknown,Unknown,Unknown,cid:43)(cid:2)(cid:1)(cid:34)(cid:34)(cid:19)(cid:18)(cid:18)(cid:2)(cid:44,Unknown,20662.0
Unknown,Unknown,15,Unknown,Unknown,Unknown,Unknown,cid:43)(cid:2)(cid:1)(cid:34)(cid:34)(cid:19)(cid:18)(cid:18)(cid:2)(cid:44,Unknown,20677.0
Unknown,Unknown,2,Unknown,Unknown,Unknown,Unknown,cid:43)(cid:2)(cid:1)(cid:34)(cid:34)(cid:19)(cid:18)(cid:18)(cid:2)(cid:44,Unknown,20679.0
Unknown,Unknown,1,Unknown,Unknown,Unknown,Unknown,cid:43)(cid:2)(cid:1)(cid:34)(cid:34)(cid:19)(cid:18)(cid:18)(cid:2)(cid:44,Unknown,20680.0
Unknown,Unknown,37,Unknown,Unknown,Unknown,Unknown,cid:43)(cid:2)(cid:1)(cid:34)(cid:34)(cid:19)(cid:18)(cid:18)(cid:2)(cid:44,Unknown,20717.0
Unknown,Unknown,16,Unknown,Unknown,Unknown,Unknown,cid:43)(cid:2)(cid:1)(cid:34)(cid:34)(cid:19)(cid:18)(cid:18)(cid:2)(cid:44,Unknown,20733.0
Unknown,Unknown,19,Unknown,Unknown,Unknown,Unknown,cid:43)(cid:2)(cid:1)(cid:34)(cid:34)(cid:19)(cid:18)(cid:18)(cid:2)(cid:44,Unknown,20752.0
Unknown,Unknown,16,Unknown,Unknown,Unknown,Unknown,cid:43)(cid:2)(cid:1)(cid:34)(cid:34)(cid:19)(cid:18)(cid:18)(cid:2)(cid:44,Unknown,20768.0
Unknown,Unknown,35,Unknown,Unknown,Unknown,Unknown,cid:43)(cid:2)(cid:1)(cid:34)(cid:34)(cid:19)(cid:18)(cid:18)(cid:2)(cid:44,Unknown,20803.0
Unknown,Unknown,2,Unknown,Unknown,Unknown,Unknown,cid:43)(cid:2)(cid:1)(cid:34)(cid:34)(cid:19)(cid:18)(cid:18)(cid:2)(cid:44,Unknown,20805.0
Unknown,Unknown,44,Unknown,Unknown,Unknown,Unknown,cid:43)(cid:2)(cid:1)(cid:34)(cid:34)(cid:19)(cid:18)(cid:18)(cid:2)(cid:44,Unknown,20849.0
Unknown,Unknown,3,Unknown,Unknown,Unknown,Unknown,cid:43)(cid:2)(cid:1)(cid:34)(cid:34)(cid:19)(cid:18)(cid:18)(cid:2)(cid:44,Unknown,20852.0
Unknown,Unknown,5,Unknown,Unknown,Unknown,Unknown,cid:43)(cid:2)(cid:1)(cid:34)(cid:34)(cid:19)(cid:18)(cid:18)(cid:2)(cid:44,Unknown,20857.0
Unknown,Unknown,39,Unknown,Unknown,Unknown,Unknown,cid:43)(cid:2)(cid:1)(cid:34)(cid:34)(cid:19)(cid:18)(cid:18)(cid:2)(cid:44,Unknown,20896.0
Unknown,Unknown,3,Unknown,Unknown,Unknown,Unknown,cid:43)(cid:2)(cid:1)(cid:34)(cid:34)(cid:19)(cid:18)(cid:18)(cid:2)(cid:44,Unknown,20899.0
Unknown,Unknown,5,Unknown,Unknown,Unknown,Unknown,cid:43)(cid:2)(cid:1)(cid:34)(cid:34)(cid:19)(cid:18)(cid:18)(cid:2)(cid:44,Unknown,20904.0
Unknown,Unknown,9,Unknown,Unknown,Unknown,Unknown,cid:43)(cid:2)(cid:1)(cid:34)(cid:34)(cid:19)(cid:18)(cid:18)(cid:2)(cid:44,Unknown,20913.0
Unknown,Unknown,5,Unknown,Unknown,Unknown,Unknown,cid:43)(cid:2)(cid:1)(cid:34)(cid:34)(cid:19)(cid:18)(cid:18)(cid:2)(cid:44,Unknown,20918.0
Unknown,Unknown,8,Unknown,Unknown,Unknown,Unknown,cid:43)(cid:2)(cid:1)(cid:34)(cid:34)(cid:19)(cid:18)(cid:18)(cid:2)(cid:44,Unknown,20926.0
Unknown,Unknown,10,Unknown,Unknown,Unknown,Unknown,cid:43)(cid:2)(cid:1)(cid:34)(cid:34)(cid:19)(cid:18)(cid:18)(cid:2)(cid:44,Unknown,20936.0
Unknown,Unknown,46,Unknown,Unknown,Unknown,Unknown,cid:43)(cid:2)(cid:1)(cid:34)(cid:34)(cid:19)(cid:18)(cid:18)(cid:2)(cid:44,Unknown,20982.0
Unknown,Unknown,10,Unknown,Unknown,Unknown,Unknown,cid:43)(cid:2)(cid:1)(cid:34)(cid:34)(cid:19)(cid:18)(cid:18)(cid:2)(cid:44,Unknown,20992.0
Unknown,Unknown,7,Unknown,Unknown,Unknown,Unknown,cid:43)(cid:2)(cid:1)(cid:34)(cid:34)(cid:19)(cid:18)(cid:18)(cid:2)(cid:44,Unknown,20999.0
Unknown,Unknown,11,Unknown,Unknown,Unknown,Unknown,cid:43)(cid:2)(cid:1)(cid:34)(cid:34)(cid:19)(cid:18)(cid:18)(cid:2)(cid:44,Unknown,21010.0
Unknown,Unknown,8,Unknown,Unknown,Unknown,Unknown,cid:43)(cid:2)(cid:1)(cid:34)(cid:34)(cid:19)(cid:18)(cid:18)(cid:2)(cid:44,Unknown,21018.0
Unknown,Unknown,2,Unknown,Unknown,Unknown,Unknown,cid:43)(cid:2)(cid:1)(cid:34)(cid:34)(cid:19)(cid:18)(cid:18)(cid:2)(cid:44,Unknown,21020.0
Unknown,Unknown,12,Unknown,Unknown,Unknown,Unknown,cid:43)(cid:2)(cid:1)(cid:34)(cid:34)(cid:19)(cid:18)(cid:18)(cid:2)(cid:44,Unknown,21032.0
Unknown,Unknown,20,Unknown,Unknown,Unknown,Unknown,cid:43)(cid:2)(cid:1)(cid:34)(cid:34)(cid:19)(cid:18)(cid:18)(cid:2)(cid:44,Unknown,21052.0
Unknown,Unknown,30,Unknown,Unknown,Unknown,Unknown,cid:43)(cid:2)(cid:1)(cid:34)(cid:34)(cid:19)(cid:18)(cid:18)(cid:2)(cid:44,Unknown,21082.0
Unknown,Unknown,41,Unknown,Unknown,Unknown,Unknown,cid:43)(cid:2)(cid:1)(cid:34)(cid:34)(cid:19)(cid:18)(cid:18)(cid:2)(cid:44,Unknown,21123.0
Unknown,Unknown,26,Unknown,Unknown,Unknown,Unknown,cid:43)(cid:2)(cid:1)(cid:34)(cid:34)(cid:19)(cid:18)(cid:18)(cid:2)(cid:44,Unknown,21149.0
Unknown,Unknown,29,Unknown,Unknown,Unknown,Unknown,cid:43)(cid:2)(cid:1)(cid:34)(cid:34)(cid:19)(cid:18)(cid:18)(cid:2)(cid:44,Unknown,21178.0
Unknown,Unknown,41,Unknown,Unknown,Unknown,Unknown,cid:43)(cid:2)(cid:1)(cid:34)(cid:34)(cid:19)(cid:18)(cid:18)(cid:2)(cid:44,Unknown,21219.0
Unknown,Unknown,2,Unknown,Unknown,Unknown,Unknown,cid:43)(cid:2)(cid:1)(cid:34)(cid:34)(cid:19)(cid:18)(cid:18)(cid:2)(cid:44,Unknown,21221.0
Unknown,Unknown,46,Unknown,Unknown,Unknown,Unknown,cid:43)(cid:2)(cid:1)(cid:34)(cid:34)(cid:19)(cid:18)(cid:18)(cid:2)(cid:44,Unknown,21267.0
Unknown,Unknown,10,Unknown,Unknown,Unknown,Unknown,cid:43)(cid:2)(cid:1)(cid:34)(cid:34)(cid:19)(cid:18)(cid:18)(cid:2)(cid:44,Unknown,21277.0
Unknown,Unknown,1,Unknown,Unknown,Unknown,Unknown,cid:43)(cid:2)(cid:1)(cid:34)(cid:34)(cid:19)(cid:18)(cid:18)(cid:2)(cid:44,Unknown,21278.0
Unknown,Unknown,37,Unknown,Unknown,Unknown,Unknown,cid:43)(cid:2)(cid:1)(cid:34)(cid:34)(cid:19)(cid:18)(cid:18)(cid:2)(cid:44,Unknown,21315.0
Unknown,Unknown,37,Unknown,Unknown,Unknown,Unknown,cid:43)(cid:2)(cid:1)(cid:34)(cid:34)(cid:19)(cid:18)(cid:18)(cid:2)(cid:44,Unknown,21352.0
Unknown,Unknown,1,Unknown,Unknown,Unknown,Unknown,cid:43)(cid:2)(cid:1)(cid:34)(cid:34)(cid:19)(cid:18)(cid:18)(cid:2)(cid:44,Unknown,21353.0
Unknown,Unknown,34,Unknown,Unknown,Unknown,Unknown,cid:43)(cid:2)(cid:1)(cid:34)(cid:34)(cid:19)(cid:18)(cid:18)(cid:2)(cid:44,Unknown,21387.0
Unknown,Unknown,16,Unknown,Unknown,Unknown,Unknown,cid:43)(cid:2)(cid:1)(cid:34)(cid:34)(cid:19)(cid:18)(cid:18)(cid:2)(cid:44,Unknown,21403.0
Unknown,Unknown,2,Unknown,Unknown,Unknown,Unknown,cid:43)(cid:2)(cid:1)(cid:34)(cid:34)(cid:19)(cid:18)(cid:18)(cid:2)(cid:44,Unknown,21405.0
Unknown,Unknown,15,Unknown,Unknown,Unknown,Unknown,cid:43)(cid:2)(cid:1)(cid:34)(cid:34)(cid:19)(cid:18)(cid:18)(cid:2)(cid:44,Unknown,21420.0
Unknown,Unknown,1,Unknown,Unknown,Unknown,Unknown,cid:43)(cid:2)(cid:1)(cid:34)(cid:34)(cid:19)(cid:18)(cid:18)(cid:2)(cid:44,Unknown,21421.0
Unknown,Unknown,33,Unknown,Unknown,Unknown,Unknown,cid:43)(cid:2)(cid:1)(cid:34)(cid:34)(cid:19)(cid:18)(cid:18)(cid:2)(cid:44,Unknown,21454.0
Unknown,Unknown,18,Unknown,Unknown,Unknown,Unknown,cid:43)(cid:2)(cid:1)(cid:34)(cid:34)(cid:19)(cid:18)(cid:18)(cid:2)(cid:44,Unknown,21472.0
Unknown,Unknown,16,Unknown,Unknown,Unknown,Unknown,cid:43)(cid:2)(cid:1)(cid:34)(cid:34)(cid:19)(cid:18)(cid:18)(cid:2)(cid:44,Unknown,21488.0
Unknown,Unknown,1,Unknown,Unknown,Unknown,Unknown,cid:43)(cid:2)(cid:1)(cid:34)(cid:34)(cid:19)(cid:18)(cid:18)(cid:2)(cid:44,Unknown,21489.0
Unknown,Unknown,18,Unknown,Unknown,Unknown,Unknown,cid:43)(cid:2)(cid:1)(cid:34)(cid:34)(cid:19)(cid:18)(cid:18)(cid:2)(cid:44,Unknown,21507.0
Unknown,Unknown,1,Unknown,Unknown,Unknown,Unknown,cid:43)(cid:2)(cid:1)(cid:34)(cid:34)(cid:19)(cid:18)(cid:18)(cid:2)(cid:44,Unknown,21508.0
Unknown,Unknown,17,Unknown,Unknown,Unknown,Unknown,cid:43)(cid:2)(cid:1)(cid:34)(cid:34)(cid:19)(cid:18)(cid:18)(cid:2)(cid:44,Unknown,21525.0
Unknown,Unknown,17,Unknown,Unknown,Unknown,Unknown,cid:43)(cid:2)(cid:1)(cid:34)(cid:34)(cid:19)(cid:18)(cid:18)(cid:2)(cid:44,Unknown,21542.0
Unknown,Unknown,34,Unknown,Unknown,Unknown,Unknown,cid:43)(cid:2)(cid:1)(cid:34)(cid:34)(cid:19)(cid:18)(cid:18)(cid:2)(cid:44,Unknown,21576.0
Unknown,Unknown,36,Unknown,Unknown,Unknown,Unknown,cid:43)(cid:2)(cid:1)(cid:34)(cid:34)(cid:19)(cid:18)(cid:18)(cid:2)(cid:44,Unknown,21612.0
Unknown,Unknown,32,Unknown,Unknown,Unknown,Unknown,cid:43)(cid:2)(cid:1)(cid:34)(cid:34)(cid:19)(cid:18)(cid:18)(cid:2)(cid:44,Unknown,21644.0
Unknown,Unknown,1,Unknown,Unknown,Unknown,Unknown,cid:43)(cid:2)(cid:1)(cid:34)(cid:34)(cid:19)(cid:18)(cid:18)(cid:2)(cid:44,Unknown,21645.0
Unknown,Unknown,32,Unknown,Unknown,Unknown,Unknown,cid:43)(cid:2)(cid:1)(cid:34)(cid:34)(cid:19)(cid:18)(cid:18)(cid:2)(cid:44,Unknown,21677.0
Unknown,Unknown,17,Unknown,Unknown,Unknown,Unknown,cid:43)(cid:2)(cid:1)(cid:34)(cid:34)(cid:19)(cid:18)(cid:18)(cid:2)(cid:44,Unknown,21694.0
Unknown,Unknown,1,Unknown,Unknown,Unknown,Unknown,cid:43)(cid:2)(cid:1)(cid:34)(cid:34)(cid:19)(cid:18)(cid:18)(cid:2)(cid:44,Unknown,21695.0
Unknown,Unknown,36,Unknown,Unknown,Unknown,Unknown,cid:43)(cid:2)(cid:1)(cid:34)(cid:34)(cid:19)(cid:18)(cid:18)(cid:2)(cid:44,Unknown,21731.0
Unknown,Unknown,45,Unknown,Unknown,Unknown,Unknown,cid:43)(cid:2)(cid:1)(cid:34)(cid:34)(cid:19)(cid:18)(cid:18)(cid:2)(cid:44,Unknown,21776.0
Unknown,Unknown,18,Unknown,Unknown,Unknown,Unknown,cid:43)(cid:2)(cid:1)(cid:34)(cid:34)(cid:19)(cid:18)(cid:18)(cid:2)(cid:44,Unknown,21794.0
Unknown,Unknown,35,Unknown,Unknown,Unknown,Unknown,cid:43)(cid:2)(cid:1)(cid:34)(cid:34)(cid:19)(cid:18)(cid:18)(cid:2)(cid:44,Unknown,21829.0
Unknown,Unknown,52,Unknown,Unknown,Unknown,Unknown,cid:43)(cid:2)(cid:1)(cid:34)(cid:34)(cid:19)(cid:18)(cid:18)(cid:2)(cid:44,Unknown,21881.0
Unknown,Unknown,7,Unknown,Unknown,Unknown,Unknown,cid:43)(cid:2)(cid:1)(cid:34)(cid:34)(cid:19)(cid:18)(cid:18)(cid:2)(cid:44,Unknown,21888.0
Unknown,Unknown,52,Unknown,Unknown,Unknown,Unknown,cid:43)(cid:2)(cid:1)(cid:34)(cid:34)(cid:19)(cid:18)(cid:18)(cid:2)(cid:44,Unknown,21940.0
Unknown,Unknown,46,Unknown,Unknown,Unknown,Unknown,cid:43)(cid:2)(cid:1)(cid:34)(cid:34)(cid:19)(cid:18)(cid:18)(cid:2)(cid:44,Unknown,21986.0
Unknown,Unknown,2,Unknown,Unknown,Unknown,Unknown,cid:43)(cid:2)(cid:1)(cid:34)(cid:34)(cid:19)(cid:18)(cid:18)(cid:2)(cid:44,Unknown,21988.0
Unknown,Unknown,28,Unknown,Unknown,Unknown,Unknown,cid:43)(cid:2)(cid:1)(cid:34)(cid:34)(cid:19)(cid:18)(cid:18)(cid:2)(cid:44,Unknown,22016.0
Unknown,Unknown,3,Unknown,Unknown,Unknown,Unknown,cid:43)(cid:2)(cid:1)(cid:34)(cid:34)(cid:19)(cid:18)(cid:18)(cid:2)(cid:44,Unknown,22019.0
Unknown,Unknown,5,Unknown,Unknown,Unknown,Unknown,cid:43)(cid:2)(cid:1)(cid:34)(cid:34)(cid:19)(cid:18)(cid:18)(cid:2)(cid:44,Unknown,22024.0
Unknown,Unknown,9,Unknown,Unknown,Unknown,Unknown,cid:43)(cid:2)(cid:1)(cid:34)(cid:34)(cid:19)(cid:18)(cid:18)(cid:2)(cid:44,Unknown,22033.0
Unknown,Unknown,13,Unknown,Unknown,Unknown,Unknown,cid:43)(cid:2)(cid:1)(cid:34)(cid:34)(cid:19)(cid:18)(cid:18)(cid:2)(cid:44,Unknown,22046.0
Unknown,Unknown,2,Unknown,Unknown,Unknown,Unknown,cid:43)(cid:2)(cid:1)(cid:34)(cid:34)(cid:19)(cid:18)(cid:18)(cid:2)(cid:44,Unknown,22048.0
Unknown,Unknown,39,Unknown,Unknown,Unknown,Unknown,cid:43)(cid:2)(cid:1)(cid:34)(cid:34)(cid:19)(cid:18)(cid:18)(cid:2)(cid:44,Unknown,22087.0
Unknown,Unknown,3,Unknown,Unknown,Unknown,Unknown,cid:43)(cid:2)(cid:1)(cid:34)(cid:34)(cid:19)(cid:18)(cid:18)(cid:2)(cid:44,Unknown,22090.0
Unknown,Unknown,7,Unknown,Unknown,Unknown,Unknown,cid:43)(cid:2)(cid:1)(cid:34)(cid:34)(cid:19)(cid:18)(cid:18)(cid:2)(cid:44,Unknown,22097.0
Unknown,Unknown,9,Unknown,Unknown,Unknown,Unknown,cid:43)(cid:2)(cid:1)(cid:34)(cid:34)(cid:19)(cid:18)(cid:18)(cid:2)(cid:44,Unknown,22106.0
Unknown,Unknown,13,Unknown,Unknown,Unknown,Unknown,cid:43)(cid:2)(cid:1)(cid:34)(cid:34)(cid:19)(cid:18)(cid:18)(cid:2)(cid:44,Unknown,22119.0
Unknown,Unknown,10,Unknown,Unknown,Unknown,Unknown,cid:43)(cid:2)(cid:1)(cid:34)(cid:34)(cid:19)(cid:18)(cid:18)(cid:2)(cid:44,Unknown,22129.0
Unknown,Unknown,7,Unknown,Unknown,Unknown,Unknown,cid:43)(cid:2)(cid:1)(cid:34)(cid:34)(cid:19)(cid:18)(cid:18)(cid:2)(cid:44,Unknown,22136.0
Unknown,Unknown,8,Unknown,Unknown,Unknown,Unknown,cid:43)(cid:2)(cid:1)(cid:34)(cid:34)(cid:19)(cid:18)(cid:18)(cid:2)(cid:44,Unknown,22144.0
Unknown,Unknown,5,Unknown,Unknown,Unknown,Unknown,cid:43)(cid:2)(cid:1)(cid:34)(cid:34)(cid:19)(cid:18)(cid:18)(cid:2)(cid:44,Unknown,22149.0
Unknown,Unknown,2,Unknown,Unknown,Unknown,Unknown,cid:43)(cid:2)(cid:1)(cid:34)(cid:34)(cid:19)(cid:18)(cid:18)(cid:2)(cid:44,Unknown,22151.0
Unknown,Unknown,38,Unknown,Unknown,Unknown,Unknown,cid:43)(cid:2)(cid:1)(cid:34)(cid:34)(cid:19)(cid:18)(cid:18)(cid:2)(cid:44,Unknown,22189.0
Unknown,Unknown,64,Unknown,Unknown,Unknown,Unknown,cid:43)(cid:2)(cid:1)(cid:34)(cid:34)(cid:19)(cid:18)(cid:18)(cid:2)(cid:44,Unknown,22253.0
Unknown,Unknown,15,Unknown,Unknown,Unknown,Unknown,cid:43)(cid:2)(cid:1)(cid:34)(cid:34)(cid:19)(cid:18)(cid:18)(cid:2)(cid:44,Unknown,22268.0
Unknown,Unknown,2,Unknown,Unknown,Unknown,Unknown,cid:43)(cid:2)(cid:1)(cid:34)(cid:34)(cid:19)(cid:18)(cid:18)(cid:2)(cid:44,Unknown,22270.0
Unknown,Unknown,17,Unknown,Unknown,Unknown,Unknown,cid:43)(cid:2)(cid:1)(cid:34)(cid:34)(cid:19)(cid:18)(cid:18)(cid:2)(cid:44,Unknown,22287.0
Unknown,Unknown,17,Unknown,Unknown,Unknown,Unknown,cid:43)(cid:2)(cid:1)(cid:34)(cid:34)(cid:19)(cid:18)(cid:18)(cid:2)(cid:44,Unknown,22304.0
Unknown,Unknown,19,Unknown,Unknown,Unknown,Unknown,cid:43)(cid:2)(cid:1)(cid:34)(cid:34)(cid:19)(cid:18)(cid:18)(cid:2)(cid:44,Unknown,22323.0
Unknown,Unknown,33,Unknown,Unknown,Unknown,Unknown,cid:43)(cid:2)(cid:1)(cid:34)(cid:34)(cid:19)(cid:18)(cid:18)(cid:2)(cid:44,Unknown,22356.0
Unknown,Unknown,18,Unknown,Unknown,Unknown,Unknown,cid:43)(cid:2)(cid:1)(cid:34)(cid:34)(cid:19)(cid:18)(cid:18)(cid:2)(cid:44,Unknown,22374.0
Unknown,Unknown,2,Unknown,Unknown,Unknown,Unknown,cid:43)(cid:2)(cid:1)(cid:34)(cid:34)(cid:19)(cid:18)(cid:18)(cid:2)(cid:44,Unknown,22376.0
Unknown,Unknown,44,Unknown,Unknown,Unknown,Unknown,cid:43)(cid:2)(cid:1)(cid:34)(cid:34)(cid:19)(cid:18)(cid:18)(cid:2)(cid:44,Unknown,22420.0
Unknown,Unknown,12,Unknown,Unknown,Unknown,Unknown,cid:43)(cid:2)(cid:1)(cid:34)(cid:34)(cid:19)(cid:18)(cid:18)(cid:2)(cid:44,Unknown,22432.0
Unknown,Unknown,29,Unknown,Unknown,Unknown,Unknown,cid:43)(cid:2)(cid:1)(cid:34)(cid:34)(cid:19)(cid:18)(cid:18)(cid:2)(cid:44,Unknown,22461.0
Unknown,Unknown,26,Unknown,Unknown,Unknown,Unknown,cid:43)(cid:2)(cid:1)(cid:34)(cid:34)(cid:19)(cid:18)(cid:18)(cid:2)(cid:44,Unknown,22487.0
Unknown,Unknown,41,Unknown,Unknown,Unknown,Unknown,cid:43)(cid:2)(cid:1)(cid:34)(cid:34)(cid:19)(cid:18)(cid:18)(cid:2)(cid:44,Unknown,22528.0
Unknown,Unknown,25,Unknown,Unknown,Unknown,Unknown,cid:43)(cid:2)(cid:1)(cid:34)(cid:34)(cid:19)(cid:18)(cid:18)(cid:2)(cid:44,Unknown,22553.0
Unknown,Unknown,2,Unknown,Unknown,Unknown,Unknown,cid:43)(cid:2)(cid:1)(cid:34)(cid:34)(cid:19)(cid:18)(cid:18)(cid:2)(cid:44,Unknown,22555.0
Unknown,Unknown,50,Unknown,Unknown,Unknown,Unknown,cid:43)(cid:2)(cid:1)(cid:34)(cid:34)(cid:19)(cid:18)(cid:18)(cid:2)(cid:44,Unknown,22605.0
Unknown,Unknown,50,Unknown,Unknown,Unknown,Unknown,cid:43)(cid:2)(cid:1)(cid:34)(cid:34)(cid:19)(cid:18)(cid:18)(cid:2)(cid:44,Unknown,22655.0
Unknown,Unknown,37,Unknown,Unknown,Unknown,Unknown,cid:43)(cid:2)(cid:1)(cid:34)(cid:34)(cid:19)(cid:18)(cid:18)(cid:2)(cid:44,Unknown,22692.0
Unknown,Unknown,16,Unknown,Unknown,Unknown,Unknown,cid:43)(cid:2)(cid:1)(cid:34)(cid:34)(cid:19)(cid:18)(cid:18)(cid:2)(cid:44,Unknown,22708.0
Unknown,Unknown,34,Unknown,Unknown,Unknown,Unknown,cid:43)(cid:2)(cid:1)(cid:34)(cid:34)(cid:19)(cid:18)(cid:18)(cid:2)(cid:44,Unknown,22742.0
Unknown,Unknown,33,Unknown,Unknown,Unknown,Unknown,cid:43)(cid:2)(cid:1)(cid:34)(cid:34)(cid:19)(cid:18)(cid:18)(cid:2)(cid:44,Unknown,22775.0
Unknown,Unknown,1,Unknown,Unknown,Unknown,Unknown,cid:43)(cid:2)(cid:1)(cid:34)(cid:34)(cid:19)(cid:18)(cid:18)(cid:2)(cid:44,Unknown,22776.0
Unknown,Unknown,36,Unknown,Unknown,Unknown,Unknown,cid:43)(cid:2)(cid:1)(cid:34)(cid:34)(cid:19)(cid:18)(cid:18)(cid:2)(cid:44,Unknown,22812.0
Unknown,Unknown,45,Unknown,Unknown,Unknown,Unknown,cid:43)(cid:2)(cid:1)(cid:34)(cid:34)(cid:19)(cid:18)(cid:18)(cid:2)(cid:44,Unknown,22857.0
Unknown,Unknown,18,Unknown,Unknown,Unknown,Unknown,cid:43)(cid:2)(cid:1)(cid:34)(cid:34)(cid:19)(cid:18)(cid:18)(cid:2)(cid:44,Unknown,22875.0
Unknown,Unknown,35,Unknown,Unknown,Unknown,Unknown,cid:43)(cid:2)(cid:1)(cid:34)(cid:34)(cid:19)(cid:18)(cid:18)(cid:2)(cid:44,Unknown,22910.0
Unknown,Unknown,46,Unknown,Unknown,Unknown,Unknown,cid:43)(cid:2)(cid:1)(cid:34)(cid:34)(cid:19)(cid:18)(cid:18)(cid:2)(cid:44,Unknown,22956.0
Unknown,Unknown,14,Unknown,Unknown,Unknown,Unknown,cid:43)(cid:2)(cid:1)(cid:34)(cid:34)(cid:19)(cid:18)(cid:18)(cid:2)(cid:44,Unknown,22970.0
Unknown,Unknown,51,Unknown,Unknown,Unknown,Unknown,cid:43)(cid:2)(cid:1)(cid:34)(cid:34)(cid:19)(cid:18)(cid:18)(cid:2)(cid:44,Unknown,23021.0
Unknown,Unknown,7,Unknown,Unknown,Unknown,Unknown,cid:43)(cid:2)(cid:1)(cid:34)(cid:34)(cid:19)(cid:18)(cid:18)(cid:2)(cid:44,Unknown,23028.0
Unknown,Unknown,2,Unknown,Unknown,Unknown,Unknown,cid:43)(cid:2)(cid:1)(cid:34)(cid:34)(cid:19)(cid:18)(cid:18)(cid:2)(cid:44,Unknown,23030.0
Unknown,Unknown,28,Unknown,Unknown,Unknown,Unknown,cid:43)(cid:2)(cid:1)(cid:34)(cid:34)(cid:19)(cid:18)(cid:18)(cid:2)(cid:44,Unknown,23058.0
Unknown,Unknown,46,Unknown,Unknown,Unknown,Unknown,cid:43)(cid:2)(cid:1)(cid:34)(cid:34)(cid:19)(cid:18)(cid:18)(cid:2)(cid:44,Unknown,23104.0
Unknown,Unknown,9,Unknown,Unknown,Unknown,Unknown,cid:43)(cid:2)(cid:1)(cid:34)(cid:34)(cid:19)(cid:18)(cid:18)(cid:2)(cid:44,Unknown,23113.0
Unknown,Unknown,13,Unknown,Unknown,Unknown,Unknown,cid:43)(cid:2)(cid:1)(cid:34)(cid:34)(cid:19)(cid:18)(cid:18)(cid:2)(cid:44,Unknown,23126.0
Unknown,Unknown,7,Unknown,Unknown,Unknown,Unknown,cid:43)(cid:2)(cid:1)(cid:34)(cid:34)(cid:19)(cid:18)(cid:18)(cid:2)(cid:44,Unknown,23133.0
Unknown,Unknown,11,Unknown,Unknown,Unknown,Unknown,cid:43)(cid:2)(cid:1)(cid:34)(cid:34)(cid:19)(cid:18)(cid:18)(cid:2)(cid:44,Unknown,23144.0
Unknown,Unknown,8,Unknown,Unknown,Unknown,Unknown,cid:43)(cid:2)(cid:1)(cid:34)(cid:34)(cid:19)(cid:18)(cid:18)(cid:2)(cid:44,Unknown,23152.0
Unknown,Unknown,2,Unknown,Unknown,Unknown,Unknown,cid:43)(cid:2)(cid:1)(cid:34)(cid:34)(cid:19)(cid:18)(cid:18)(cid:2)(cid:44,Unknown,23154.0
Unknown,Unknown,9,Unknown,Unknown,Unknown,Unknown,cid:43)(cid:2)(cid:1)(cid:34)(cid:34)(cid:19)(cid:18)(cid:18)(cid:2)(cid:44,Unknown,23163.0
Unknown,Unknown,13,Unknown,Unknown,Unknown,Unknown,cid:43)(cid:2)(cid:1)(cid:34)(cid:34)(cid:19)(cid:18)(cid:18)(cid:2)(cid:44,Unknown,23176.0
Unknown,Unknown,39,Unknown,Unknown,Unknown,Unknown,cid:43)(cid:2)(cid:1)(cid:34)(cid:34)(cid:19)(cid:18)(cid:18)(cid:2)(cid:44,Unknown,23215.0
Unknown,Unknown,67,Unknown,Unknown,Unknown,Unknown,cid:43)(cid:2)(cid:1)(cid:34)(cid:34)(cid:19)(cid:18)(cid:18)(cid:2)(cid:44,Unknown,23282.0
Unknown,Unknown,2,Unknown,Unknown,Unknown,Unknown,cid:43)(cid:2)(cid:1)(cid:34)(cid:34)(cid:19)(cid:18)(cid:18)(cid:2)(cid:44,Unknown,23284.0
Unknown,Unknown,39,Unknown,Unknown,Unknown,Unknown,cid:43)(cid:2)(cid:1)(cid:34)(cid:34)(cid:19)(cid:18)(cid:18)(cid:2)(cid:44,Unknown,23323.0
Unknown,Unknown,3,Unknown,Unknown,Unknown,Unknown,cid:43)(cid:2)(cid:1)(cid:34)(cid:34)(cid:19)(cid:18)(cid:18)(cid:2)(cid:44,Unknown,23326.0
Unknown,Unknown,7,Unknown,Unknown,Unknown,Unknown,cid:43)(cid:2)(cid:1)(cid:34)(cid:34)(cid:19)(cid:18)(cid:18)(cid:2)(cid:44,Unknown,23333.0
Unknown,Unknown,9,Unknown,Unknown,Unknown,Unknown,cid:43)(cid:2)(cid:1)(cid:34)(cid:34)(cid:19)(cid:18)(cid:18)(cid:2)(cid:44,Unknown,23342.0
Unknown,Unknown,13,Unknown,Unknown,Unknown,Unknown,cid:43)(cid:2)(cid:1)(cid:34)(cid:34)(cid:19)(cid:18)(cid:18)(cid:2)(cid:44,Unknown,23355.0
Unknown,Unknown,10,Unknown,Unknown,Unknown,Unknown,cid:43)(cid:2)(cid:1)(cid:34)(cid:34)(cid:19)(cid:18)(cid:18)(cid:2)(cid:44,Unknown,23365.0
Unknown,Unknown,7,Unknown,Unknown,Unknown,Unknown,cid:43)(cid:2)(cid:1)(cid:34)(cid:34)(cid:19)(cid:18)(cid:18)(cid:2)(cid:44,Unknown,23372.0
Unknown,Unknown,8,Unknown,Unknown,Unknown,Unknown,cid:43)(cid:2)(cid:1)(cid:34)(cid:34)(cid:19)(cid:18)(cid:18)(cid:2)(cid:44,Unknown,23380.0
Unknown,Unknown,46,Unknown,Unknown,Unknown,Unknown,cid:43)(cid:2)(cid:1)(cid:34)(cid:34)(cid:19)(cid:18)(cid:18)(cid:2)(cid:44,Unknown,23426.0
Unknown,Unknown,2,Unknown,Unknown,Unknown,Unknown,cid:43)(cid:2)(cid:1)(cid:34)(cid:34)(cid:19)(cid:18)(cid:18)(cid:2)(cid:44,Unknown,23428.0
Unknown,Unknown,38,Unknown,Unknown,Unknown,Unknown,cid:43)(cid:2)(cid:1)(cid:34)(cid:34)(cid:19)(cid:18)(cid:18)(cid:2)(cid:44,Unknown,23466.0
Unknown,Unknown,64,Unknown,Unknown,Unknown,Unknown,cid:43)(cid:2)(cid:1)(cid:34)(cid:34)(cid:19)(cid:18)(cid:18)(cid:2)(cid:44,Unknown,23530.0
Unknown,Unknown,15,Unknown,Unknown,Unknown,Unknown,cid:43)(cid:2)(cid:1)(cid:34)(cid:34)(cid:19)(cid:18)(cid:18)(cid:2)(cid:44,Unknown,23545.0
Unknown,Unknown,2,Unknown,Unknown,Unknown,Unknown,cid:43)(cid:2)(cid:1)(cid:34)(cid:34)(cid:19)(cid:18)(cid:18)(cid:2)(cid:44,Unknown,23547.0
Unknown,Unknown,17,Unknown,Unknown,Unknown,Unknown,cid:43)(cid:2)(cid:1)(cid:34)(cid:34)(cid:19)(cid:18)(cid:18)(cid:2)(cid:44,Unknown,23564.0
Unknown,Unknown,36,Unknown,Unknown,Unknown,Unknown,cid:43)(cid:2)(cid:1)(cid:34)(cid:34)(cid:19)(cid:18)(cid:18)(cid:2)(cid:44,Unknown,23600.0
Unknown,Unknown,33,Unknown,Unknown,Unknown,Unknown,cid:43)(cid:2)(cid:1)(cid:34)(cid:34)(cid:19)(cid:18)(cid:18)(cid:2)(cid:44,Unknown,23633.0
Unknown,Unknown,19,Unknown,Unknown,Unknown,Unknown,cid:43)(cid:2)(cid:1)(cid:34)(cid:34)(cid:19)(cid:18)(cid:18)(cid:2)(cid:44,Unknown,23652.0
Unknown,Unknown,34,Unknown,Unknown,Unknown,Unknown,cid:43)(cid:2)(cid:1)(cid:34)(cid:34)(cid:19)(cid:18)(cid:18)(cid:2)(cid:44,Unknown,23686.0
Unknown,Unknown,32,Unknown,Unknown,Unknown,Unknown,cid:43)(cid:2)(cid:1)(cid:34)(cid:34)(cid:19)(cid:18)(cid:18)(cid:2)(cid:44,Unknown,23718.0
Unknown,Unknown,2,Unknown,Unknown,Unknown,Unknown,cid:43)(cid:2)(cid:1)(cid:34)(cid:34)(cid:19)(cid:18)(cid:18)(cid:2)(cid:44,Unknown,23720.0
Unknown,Unknown,44,Unknown,Unknown,Unknown,Unknown,cid:43)(cid:2)(cid:1)(cid:34)(cid:34)(cid:19)(cid:18)(cid:18)(cid:2)(cid:44,Unknown,23764.0
Unknown,Unknown,12,Unknown,Unknown,Unknown,Unknown,cid:43)(cid:2)(cid:1)(cid:34)(cid:34)(cid:19)(cid:18)(cid:18)(cid:2)(cid:44,Unknown,23776.0
Unknown,Unknown,29,Unknown,Unknown,Unknown,Unknown,cid:43)(cid:2)(cid:1)(cid:34)(cid:34)(cid:19)(cid:18)(cid:18)(cid:2)(cid:44,Unknown,23805.0
Unknown,Unknown,26,Unknown,Unknown,Unknown,Unknown,cid:43)(cid:2)(cid:1)(cid:34)(cid:34)(cid:19)(cid:18)(cid:18)(cid:2)(cid:44,Unknown,23831.0
Unknown,Unknown,41,Unknown,Unknown,Unknown,Unknown,cid:43)(cid:2)(cid:1)(cid:34)(cid:34)(cid:19)(cid:18)(cid:18)(cid:2)(cid:44,Unknown,23872.0
Unknown,Unknown,25,Unknown,Unknown,Unknown,Unknown,cid:43)(cid:2)(cid:1)(cid:34)(cid:34)(cid:19)(cid:18)(cid:18)(cid:2)(cid:44,Unknown,23897.0
Unknown,Unknown,2,Unknown,Unknown,Unknown,Unknown,cid:43)(cid:2)(cid:1)(cid:34)(cid:34)(cid:19)(cid:18)(cid:18)(cid:2)(cid:44,Unknown,23899.0
Unknown,Unknown,50,Unknown,Unknown,Unknown,Unknown,cid:43)(cid:2)(cid:1)(cid:34)(cid:34)(cid:19)(cid:18)(cid:18)(cid:2)(cid:44,Unknown,23949.0
Unknown,Unknown,50,Unknown,Unknown,Unknown,Unknown,cid:43)(cid:2)(cid:1)(cid:34)(cid:34)(cid:19)(cid:18)(cid:18)(cid:2)(cid:44,Unknown,23999.0
Unknown,Unknown,37,Unknown,Unknown,Unknown,Unknown,cid:43)(cid:2)(cid:1)(cid:34)(cid:34)(cid:19)(cid:18)(cid:18)(cid:2)(cid:44,Unknown,24036.0
Unknown,Unknown,16,Unknown,Unknown,Unknown,Unknown,cid:43)(cid:2)(cid:1)(cid:34)(cid:34)(cid:19)(cid:18)(cid:18)(cid:2)(cid:44,Unknown,24052.0
Unknown,Unknown,34,Unknown,Unknown,Unknown,Unknown,cid:43)(cid:2)(cid:1)(cid:34)(cid:34)(cid:19)(cid:18)(cid:18)(cid:2)(cid:44,Unknown,24086.0
Unknown,Unknown,33,Unknown,Unknown,Unknown,Unknown,cid:43)(cid:2)(cid:1)(cid:34)(cid:34)(cid:19)(cid:18)(cid:18)(cid:2)(cid:44,Unknown,24119.0
Unknown,Unknown,1,Unknown,Unknown,Unknown,Unknown,cid:43)(cid:2)(cid:1)(cid:34)(cid:34)(cid:19)(cid:18)(cid:18)(cid:2)(cid:44,Unknown,24120.0
Unknown,Unknown,32,Unknown,Unknown,Unknown,Unknown,cid:43)(cid:2)(cid:1)(cid:34)(cid:34)(cid:19)(cid:18)(cid:18)(cid:2)(cid:44,Unknown,24152.0
Unknown,Unknown,45,Unknown,Unknown,Unknown,Unknown,cid:43)(cid:2)(cid:1)(cid:34)(cid:34)(cid:19)(cid:18)(cid:18)(cid:2)(cid:44,Unknown,24197.0
Unknown,Unknown,18,Unknown,Unknown,Unknown,Unknown,cid:43)(cid:2)(cid:1)(cid:34)(cid:34)(cid:19)(cid:18)(cid:18)(cid:2)(cid:44,Unknown,24215.0
Unknown,Unknown,35,Unknown,Unknown,Unknown,Unknown,cid:43)(cid:2)(cid:1)(cid:34)(cid:34)(cid:19)(cid:18)(cid:18)(cid:2)(cid:44,Unknown,24250.0
Unknown,Unknown,51,Unknown,Unknown,Unknown,Unknown,cid:43)(cid:2)(cid:1)(cid:34)(cid:34)(cid:19)(cid:18)(cid:18)(cid:2)(cid:44,Unknown,24301.0
Unknown,Unknown,11,Unknown,Unknown,Unknown,Unknown,cid:43)(cid:2)(cid:1)(cid:34)(cid:34)(cid:19)(cid:18)(cid:18)(cid:2)(cid:44,Unknown,24312.0
Unknown,Unknown,4,Unknown,Unknown,Unknown,Unknown,cid:43)(cid:2)(cid:1)(cid:34)(cid:34)(cid:19)(cid:18)(cid:18)(cid:2)(cid:44,Unknown,24316.0
Unknown,Unknown,68,Unknown,Unknown,Unknown,Unknown,cid:43)(cid:2)(cid:1)(cid:34)(cid:34)(cid:19)(cid:18)(cid:18)(cid:2)(cid:44,Unknown,24384.0
Unknown,Unknown,53,Unknown,Unknown,Unknown,Unknown,cid:43)(cid:2)(cid:1)(cid:34)(cid:34)(cid:19)(cid:18)(cid:18)(cid:2)(cid:44,Unknown,24437.0
Unknown,Unknown,10,Unknown,Unknown,Unknown,Unknown,cid:43)(cid:2)(cid:1)(cid:34)(cid:34)(cid:19)(cid:18)(cid:18)(cid:2)(cid:44,Unknown,24447.0
Unknown,Unknown,5,Unknown,Unknown,Unknown,Unknown,cid:43)(cid:2)(cid:1)(cid:34)(cid:34)(cid:19)(cid:18)(cid:18)(cid:2)(cid:44,Unknown,24452.0
Unknown,Unknown,14,Unknown,Unknown,Unknown,Unknown,cid:43)(cid:2)(cid:1)(cid:34)(cid:34)(cid:19)(cid:18)(cid:18)(cid:2)(cid:44,Unknown,24466.0
Unknown,Unknown,2,Unknown,Unknown,Unknown,Unknown,cid:43)(cid:2)(cid:1)(cid:34)(cid:34)(cid:19)(cid:18)(cid:18)(cid:2)(cid:44,Unknown,24468.0
Unknown,Unknown,52,Unknown,Unknown,Unknown,Unknown,cid:43)(cid:2)(cid:1)(cid:34)(cid:34)(cid:19)(cid:18)(cid:18)(cid:2)(cid:44,Unknown,24520.0
Unknown,Unknown,46,Unknown,Unknown,Unknown,Unknown,cid:43)(cid:2)(cid:1)(cid:34)(cid:34)(cid:19)(cid:18)(cid:18)(cid:2)(cid:44,Unknown,24566.0
Unknown,Unknown,49,Unknown,Unknown,Unknown,Unknown,cid:43)(cid:2)(cid:1)(cid:34)(cid:34)(cid:19)(cid:18)(cid:18)(cid:2)(cid:44,Unknown,24615.0
Unknown,Unknown,2,Unknown,Unknown,Unknown,Unknown,cid:43)(cid:2)(cid:1)(cid:34)(cid:34)(cid:19)(cid:18)(cid:18)(cid:2)(cid:44,Unknown,24617.0
Unknown,Unknown,7,Unknown,Unknown,Unknown,Unknown,cid:43)(cid:2)(cid:1)(cid:34)(cid:34)(cid:19)(cid:18)(cid:18)(cid:2)(cid:44,Unknown,24624.0
Unknown,Unknown,9,Unknown,Unknown,Unknown,Unknown,cid:43)(cid:2)(cid:1)(cid:34)(cid:34)(cid:19)(cid:18)(cid:18)(cid:2)(cid:44,Unknown,24633.0
Unknown,Unknown,9,Unknown,Unknown,Unknown,Unknown,cid:43)(cid:2)(cid:1)(cid:34)(cid:34)(cid:19)(cid:18)(cid:18)(cid:2)(cid:44,Unknown,24642.0
Unknown,Unknown,68,Unknown,Unknown,Unknown,Unknown,cid:43)(cid:2)(cid:1)(cid:34)(cid:34)(cid:19)(cid:18)(cid:18)(cid:2)(cid:44,Unknown,24710.0
Unknown,Unknown,2,Unknown,Unknown,Unknown,Unknown,cid:43)(cid:2)(cid:1)(cid:34)(cid:34)(cid:19)(cid:18)(cid:18)(cid:2)(cid:44,Unknown,24712.0
Unknown,Unknown,14,Unknown,Unknown,Unknown,Unknown,cid:43)(cid:2)(cid:1)(cid:34)(cid:34)(cid:19)(cid:18)(cid:18)(cid:2)(cid:44,Unknown,24726.0
Unknown,Unknown,5,Unknown,Unknown,Unknown,Unknown,cid:43)(cid:2)(cid:1)(cid:34)(cid:34)(cid:19)(cid:18)(cid:18)(cid:2)(cid:44,Unknown,24731.0
Unknown,Unknown,9,Unknown,Unknown,Unknown,Unknown,cid:43)(cid:2)(cid:1)(cid:34)(cid:34)(cid:19)(cid:18)(cid:18)(cid:2)(cid:44,Unknown,24740.0
Unknown,Unknown,2,Unknown,Unknown,Unknown,Unknown,cid:43)(cid:2)(cid:1)(cid:34)(cid:34)(cid:19)(cid:18)(cid:18)(cid:2)(cid:44,Unknown,24742.0
Unknown,Unknown,54,Unknown,Unknown,Unknown,Unknown,cid:43)(cid:2)(cid:1)(cid:34)(cid:34)(cid:19)(cid:18)(cid:18)(cid:2)(cid:44,Unknown,24796.0
Unknown,Unknown,11,Unknown,Unknown,Unknown,Unknown,cid:43)(cid:2)(cid:1)(cid:34)(cid:34)(cid:19)(cid:18)(cid:18)(cid:2)(cid:44,Unknown,24807.0
Unknown,Unknown,4,Unknown,Unknown,Unknown,Unknown,cid:43)(cid:2)(cid:1)(cid:34)(cid:34)(cid:19)(cid:18)(cid:18)(cid:2)(cid:44,Unknown,24811.0
Unknown,Unknown,14,Unknown,Unknown,Unknown,Unknown,cid:43)(cid:2)(cid:1)(cid:34)(cid:34)(cid:19)(cid:18)(cid:18)(cid:2)(cid:44,Unknown,24825.0
Unknown,Unknown,2,Unknown,Unknown,Unknown,Unknown,cid:43)(cid:2)(cid:1)(cid:34)(cid:34)(cid:19)(cid:18)(cid:18)(cid:2)(cid:44,Unknown,24827.0
Unknown,Unknown,28,Unknown,Unknown,Unknown,Unknown,cid:43)(cid:2)(cid:1)(cid:34)(cid:34)(cid:19)(cid:18)(cid:18)(cid:2)(cid:44,Unknown,24855.0
Unknown,Unknown,3,Unknown,Unknown,Unknown,Unknown,cid:43)(cid:2)(cid:1)(cid:34)(cid:34)(cid:19)(cid:18)(cid:18)(cid:2)(cid:44,Unknown,24858.0
Unknown,Unknown,15,Unknown,Unknown,Unknown,Unknown,cid:43)(cid:2)(cid:1)(cid:34)(cid:34)(cid:19)(cid:18)(cid:18)(cid:2)(cid:44,Unknown,24873.0
Unknown,Unknown,2,Unknown,Unknown,Unknown,Unknown,cid:43)(cid:2)(cid:1)(cid:34)(cid:34)(cid:19)(cid:18)(cid:18)(cid:2)(cid:44,Unknown,24875.0
Unknown,Unknown,16,Unknown,Unknown,Unknown,Unknown,cid:43)(cid:2)(cid:1)(cid:34)(cid:34)(cid:19)(cid:18)(cid:18)(cid:2)(cid:44,Unknown,24891.0
Unknown,Unknown,37,Unknown,Unknown,Unknown,Unknown,cid:43)(cid:2)(cid:1)(cid:34)(cid:34)(cid:19)(cid:18)(cid:18)(cid:2)(cid:44,Unknown,24928.0
Unknown,Unknown,19,Unknown,Unknown,Unknown,Unknown,cid:43)(cid:2)(cid:1)(cid:34)(cid:34)(cid:19)(cid:18)(cid:18)(cid:2)(cid:44,Unknown,24947.0
Unknown,Unknown,33,Unknown,Unknown,Unknown,Unknown,cid:43)(cid:2)(cid:1)(cid:34)(cid:34)(cid:19)(cid:18)(cid:18)(cid:2)(cid:44,Unknown,24980.0
Unknown,Unknown,33,Unknown,Unknown,Unknown,Unknown,cid:43)(cid:2)(cid:1)(cid:34)(cid:34)(cid:19)(cid:18)(cid:18)(cid:2)(cid:44,Unknown,25013.0
Unknown,Unknown,2,Unknown,Unknown,Unknown,Unknown,cid:43)(cid:2)(cid:1)(cid:34)(cid:34)(cid:19)(cid:18)(cid:18)(cid:2)(cid:44,Unknown,25015.0
Unknown,Unknown,44,Unknown,Unknown,Unknown,Unknown,cid:43)(cid:2)(cid:1)(cid:34)(cid:34)(cid:19)(cid:18)(cid:18)(cid:2)(cid:44,Unknown,25059.0
Unknown,Unknown,12,Unknown,Unknown,Unknown,Unknown,cid:43)(cid:2)(cid:1)(cid:34)(cid:34)(cid:19)(cid:18)(cid:18)(cid:2)(cid:44,Unknown,25071.0
Unknown,Unknown,29,Unknown,Unknown,Unknown,Unknown,cid:43)(cid:2)(cid:1)(cid:34)(cid:34)(cid:19)(cid:18)(cid:18)(cid:2)(cid:44,Unknown,25100.0
Unknown,Unknown,26,Unknown,Unknown,Unknown,Unknown,cid:43)(cid:2)(cid:1)(cid:34)(cid:34)(cid:19)(cid:18)(cid:18)(cid:2)(cid:44,Unknown,25126.0
Unknown,Unknown,41,Unknown,Unknown,Unknown,Unknown,cid:43)(cid:2)(cid:1)(cid:34)(cid:34)(cid:19)(cid:18)(cid:18)(cid:2)(cid:44,Unknown,25167.0
Unknown,Unknown,25,Unknown,Unknown,Unknown,Unknown,cid:43)(cid:2)(cid:1)(cid:34)(cid:34)(cid:19)(cid:18)(cid:18)(cid:2)(cid:44,Unknown,25192.0
Unknown,Unknown,2,Unknown,Unknown,Unknown,Unknown,cid:43)(cid:2)(cid:1)(cid:34)(cid:34)(cid:19)(cid:18)(cid:18)(cid:2)(cid:44,Unknown,25194.0
Unknown,Unknown,50,Unknown,Unknown,Unknown,Unknown,cid:43)(cid:2)(cid:1)(cid:34)(cid:34)(cid:19)(cid:18)(cid:18)(cid:2)(cid:44,Unknown,25244.0
Unknown,Unknown,50,Unknown,Unknown,Unknown,Unknown,cid:43)(cid:2)(cid:1)(cid:34)(cid:34)(cid:19)(cid:18)(cid:18)(cid:2)(cid:44,Unknown,25294.0
Unknown,Unknown,37,Unknown,Unknown,Unknown,Unknown,cid:43)(cid:2)(cid:1)(cid:34)(cid:34)(cid:19)(cid:18)(cid:18)(cid:2)(cid:44,Unknown,25331.0
Unknown,Unknown,16,Unknown,Unknown,Unknown,Unknown,cid:43)(cid:2)(cid:1)(cid:34)(cid:34)(cid:19)(cid:18)(cid:18)(cid:2)(cid:44,Unknown,25347.0
Unknown,Unknown,34,Unknown,Unknown,Unknown,Unknown,cid:43)(cid:2)(cid:1)(cid:34)(cid:34)(cid:19)(cid:18)(cid:18)(cid:2)(cid:44,Unknown,25381.0
Unknown,Unknown,33,Unknown,Unknown,Unknown,Unknown,cid:43)(cid:2)(cid:1)(cid:34)(cid:34)(cid:19)(cid:18)(cid:18)(cid:2)(cid:44,Unknown,25414.0
Unknown,Unknown,1,Unknown,Unknown,Unknown,Unknown,cid:43)(cid:2)(cid:1)(cid:34)(cid:34)(cid:19)(cid:18)(cid:18)(cid:2)(cid:44,Unknown,25415.0
Unknown,Unknown,32,Unknown,Unknown,Unknown,Unknown,cid:43)(cid:2)(cid:1)(cid:34)(cid:34)(cid:19)(cid:18)(cid:18)(cid:2)(cid:44,Unknown,25447.0
Unknown,Unknown,45,Unknown,Unknown,Unknown,Unknown,cid:43)(cid:2)(cid:1)(cid:34)(cid:34)(cid:19)(cid:18)(cid:18)(cid:2)(cid:44,Unknown,25492.0
Unknown,Unknown,18,Unknown,Unknown,Unknown,Unknown,cid:43)(cid:2)(cid:1)(cid:34)(cid:34)(cid:19)(cid:18)(cid:18)(cid:2)(cid:44,Unknown,25510.0
Unknown,Unknown,35,Unknown,Unknown,Unknown,Unknown,cid:43)(cid:2)(cid:1)(cid:34)(cid:34)(cid:19)(cid:18)(cid:18)(cid:2)(cid:44,Unknown,25545.0
Unknown,Unknown,51,Unknown,Unknown,Unknown,Unknown,cid:43)(cid:2)(cid:1)(cid:34)(cid:34)(cid:19)(cid:18)(cid:18)(cid:2)(cid:44,Unknown,25596.0
Unknown,Unknown,11,Unknown,Unknown,Unknown,Unknown,cid:43)(cid:2)(cid:1)(cid:34)(cid:34)(cid:19)(cid:18)(cid:18)(cid:2)(cid:44,Unknown,25607.0
Unknown,Unknown,4,Unknown,Unknown,Unknown,Unknown,cid:43)(cid:2)(cid:1)(cid:34)(cid:34)(cid:19)(cid:18)(cid:18)(cid:2)(cid:44,Unknown,25611.0
Unknown,Unknown,68,Unknown,Unknown,Unknown,Unknown,cid:43)(cid:2)(cid:1)(cid:34)(cid:34)(cid:19)(cid:18)(cid:18)(cid:2)(cid:44,Unknown,25679.0
Unknown,Unknown,53,Unknown,Unknown,Unknown,Unknown,cid:43)(cid:2)(cid:1)(cid:34)(cid:34)(cid:19)(cid:18)(cid:18)(cid:2)(cid:44,Unknown,25732.0
Unknown,Unknown,10,Unknown,Unknown,Unknown,Unknown,cid:43)(cid:2)(cid:1)(cid:34)(cid:34)(cid:19)(cid:18)(cid:18)(cid:2)(cid:44,Unknown,25742.0
Unknown,Unknown,5,Unknown,Unknown,Unknown,Unknown,cid:43)(cid:2)(cid:1)(cid:34)(cid:34)(cid:19)(cid:18)(cid:18)(cid:2)(cid:44,Unknown,25747.0
Unknown,Unknown,14,Unknown,Unknown,Unknown,Unknown,cid:43)(cid:2)(cid:1)(cid:34)(cid:34)(cid:19)(cid:18)(cid:18)(cid:2)(cid:44,Unknown,25761.0
Unknown,Unknown,2,Unknown,Unknown,Unknown,Unknown,cid:43)(cid:2)(cid:1)(cid:34)(cid:34)(cid:19)(cid:18)(cid:18)(cid:2)(cid:44,Unknown,25763.0
Unknown,Unknown,52,Unknown,Unknown,Unknown,Unknown,cid:43)(cid:2)(cid:1)(cid:34)(cid:34)(cid:19)(cid:18)(cid:18)(cid:2)(cid:44,Unknown,25815.0
Unknown,Unknown,46,Unknown,Unknown,Unknown,Unknown,cid:43)(cid:2)(cid:1)(cid:34)(cid:34)(cid:19)(cid:18)(cid:18)(cid:2)(cid:44,Unknown,25861.0
Unknown,Unknown,49,Unknown,Unknown,Unknown,Unknown,cid:43)(cid:2)(cid:1)(cid:34)(cid:34)(cid:19)(cid:18)(cid:18)(cid:2)(cid:44,Unknown,25910.0
Unknown,Unknown,2,Unknown,Unknown,Unknown,Unknown,cid:43)(cid:2)(cid:1)(cid:34)(cid:34)(cid:19)(cid:18)(cid:18)(cid:2)(cid:44,Unknown,25912.0
Unknown,Unknown,7,Unknown,Unknown,Unknown,Unknown,cid:43)(cid:2)(cid:1)(cid:34)(cid:34)(cid:19)(cid:18)(cid:18)(cid:2)(cid:44,Unknown,25919.0
Unknown,Unknown,9,Unknown,Unknown,Unknown,Unknown,cid:43)(cid:2)(cid:1)(cid:34)(cid:34)(cid:19)(cid:18)(cid:18)(cid:2)(cid:44,Unknown,25928.0
Unknown,Unknown,9,Unknown,Unknown,Unknown,Unknown,cid:43)(cid:2)(cid:1)(cid:34)(cid:34)(cid:19)(cid:18)(cid:18)(cid:2)(cid:44,Unknown,25937.0
Unknown,Unknown,68,Unknown,Unknown,Unknown,Unknown,cid:43)(cid:2)(cid:1)(cid:34)(cid:34)(cid:19)(cid:18)(cid:18)(cid:2)(cid:44,Unknown,26005.0
Unknown,Unknown,2,Unknown,Unknown,Unknown,Unknown,cid:43)(cid:2)(cid:1)(cid:34)(cid:34)(cid:19)(cid:18)(cid:18)(cid:2)(cid:44,Unknown,26007.0
Unknown,Unknown,14,Unknown,Unknown,Unknown,Unknown,cid:43)(cid:2)(cid:1)(cid:34)(cid:34)(cid:19)(cid:18)(cid:18)(cid:2)(cid:44,Unknown,26021.0
Unknown,Unknown,5,Unknown,Unknown,Unknown,Unknown,cid:43)(cid:2)(cid:1)(cid:34)(cid:34)(cid:19)(cid:18)(cid:18)(cid:2)(cid:44,Unknown,26026.0
Unknown,Unknown,9,Unknown,Unknown,Unknown,Unknown,cid:43)(cid:2)(cid:1)(cid:34)(cid:34)(cid:19)(cid:18)(cid:18)(cid:2)(cid:44,Unknown,26035.0
Unknown,Unknown,2,Unknown,Unknown,Unknown,Unknown,cid:43)(cid:2)(cid:1)(cid:34)(cid:34)(cid:19)(cid:18)(cid:18)(cid:2)(cid:44,Unknown,26037.0
Unknown,Unknown,54,Unknown,Unknown,Unknown,Unknown,cid:43)(cid:2)(cid:1)(cid:34)(cid:34)(cid:19)(cid:18)(cid:18)(cid:2)(cid:44,Unknown,26091.0
Unknown,Unknown,11,Unknown,Unknown,Unknown,Unknown,cid:43)(cid:2)(cid:1)(cid:34)(cid:34)(cid:19)(cid:18)(cid:18)(cid:2)(cid:44,Unknown,26102.0
Unknown,Unknown,4,Unknown,Unknown,Unknown,Unknown,cid:43)(cid:2)(cid:1)(cid:34)(cid:34)(cid:19)(cid:18)(cid:18)(cid:2)(cid:44,Unknown,26106.0
Unknown,Unknown,14,Unknown,Unknown,Unknown,Unknown,cid:43)(cid:2)(cid:1)(cid:34)(cid:34)(cid:19)(cid:18)(cid:18)(cid:2)(cid:44,Unknown,26120.0
Unknown,Unknown,2,Unknown,Unknown,Unknown,Unknown,cid:43)(cid:2)(cid:1)(cid:34)(cid:34)(cid:19)(cid:18)(cid:18)(cid:2)(cid:44,Unknown,26122.0
Unknown,Unknown,28,Unknown,Unknown,Unknown,Unknown,cid:43)(cid:2)(cid:1)(cid:34)(cid:34)(cid:19)(cid:18)(cid:18)(cid:2)(cid:44,Unknown,26150.0
Unknown,Unknown,3,Unknown,Unknown,Unknown,Unknown,cid:43)(cid:2)(cid:1)(cid:34)(cid:34)(cid:19)(cid:18)(cid:18)(cid:2)(cid:44,Unknown,26153.0
Unknown,Unknown,15,Unknown,Unknown,Unknown,Unknown,cid:43)(cid:2)(cid:1)(cid:34)(cid:34)(cid:19)(cid:18)(cid:18)(cid:2)(cid:44,Unknown,26168.0
Unknown,Unknown,2,Unknown,Unknown,Unknown,Unknown,cid:43)(cid:2)(cid:1)(cid:34)(cid:34)(cid:19)(cid:18)(cid:18)(cid:2)(cid:44,Unknown,26170.0
Unknown,Unknown,35,Unknown,Unknown,Unknown,Unknown,cid:43)(cid:2)(cid:1)(cid:34)(cid:34)(cid:19)(cid:18)(cid:18)(cid:2)(cid:44,Unknown,26205.0
Unknown,Unknown,1,Unknown,Unknown,Unknown,Unknown,cid:43)(cid:2)(cid:1)(cid:34)(cid:34)(cid:19)(cid:18)(cid:18)(cid:2)(cid:44,Unknown,26206.0
Unknown,Unknown,19,Unknown,Unknown,Unknown,Unknown,cid:43)(cid:2)(cid:1)(cid:34)(cid:34)(cid:19)(cid:18)(cid:18)(cid:2)(cid:44,Unknown,26225.0
Unknown,Unknown,33,Unknown,Unknown,Unknown,Unknown,cid:43)(cid:2)(cid:1)(cid:34)(cid:34)(cid:19)(cid:18)(cid:18)(cid:2)(cid:44,Unknown,26258.0
Unknown,Unknown,16,Unknown,Unknown,Unknown,Unknown,cid:43)(cid:2)(cid:1)(cid:34)(cid:34)(cid:19)(cid:18)(cid:18)(cid:2)(cid:44,Unknown,26274.0
Unknown,Unknown,2,Unknown,Unknown,Unknown,Unknown,cid:43)(cid:2)(cid:1)(cid:34)(cid:34)(cid:19)(cid:18)(cid:18)(cid:2)(cid:44,Unknown,26276.0
Unknown,Unknown,44,Unknown,Unknown,Unknown,Unknown,cid:43)(cid:2)(cid:1)(cid:34)(cid:34)(cid:19)(cid:18)(cid:18)(cid:2)(cid:44,Unknown,26320.0
Unknown,Unknown,12,Unknown,Unknown,Unknown,Unknown,cid:43)(cid:2)(cid:1)(cid:34)(cid:34)(cid:19)(cid:18)(cid:18)(cid:2)(cid:44,Unknown,26332.0
Unknown,Unknown,29,Unknown,Unknown,Unknown,Unknown,cid:43)(cid:2)(cid:1)(cid:34)(cid:34)(cid:19)(cid:18)(cid:18)(cid:2)(cid:44,Unknown,26361.0
Unknown,Unknown,26,Unknown,Unknown,Unknown,Unknown,cid:43)(cid:2)(cid:1)(cid:34)(cid:34)(cid:19)(cid:18)(cid:18)(cid:2)(cid:44,Unknown,26387.0
Unknown,Unknown,41,Unknown,Unknown,Unknown,Unknown,cid:43)(cid:2)(cid:1)(cid:34)(cid:34)(cid:19)(cid:18)(cid:18)(cid:2)(cid:44,Unknown,26428.0
Unknown,Unknown,25,Unknown,Unknown,Unknown,Unknown,cid:43)(cid:2)(cid:1)(cid:34)(cid:34)(cid:19)(cid:18)(cid:18)(cid:2)(cid:44,Unknown,26453.0
Unknown,Unknown,2,Unknown,Unknown,Unknown,Unknown,cid:43)(cid:2)(cid:1)(cid:34)(cid:34)(cid:19)(cid:18)(cid:18)(cid:2)(cid:44,Unknown,26455.0
Unknown,Unknown,50,Unknown,Unknown,Unknown,Unknown,cid:43)(cid:2)(cid:1)(cid:34)(cid:34)(cid:19)(cid:18)(cid:18)(cid:2)(cid:44,Unknown,26505.0
Unknown,Unknown,50,Unknown,Unknown,Unknown,Unknown,cid:43)(cid:2)(cid:1)(cid:34)(cid:34)(cid:19)(cid:18)(cid:18)(cid:2)(cid:44,Unknown,26555.0
Unknown,Unknown,37,Unknown,Unknown,Unknown,Unknown,cid:43)(cid:2)(cid:1)(cid:34)(cid:34)(cid:19)(cid:18)(cid:18)(cid:2)(cid:44,Unknown,26592.0
Unknown,Unknown,16,Unknown,Unknown,Unknown,Unknown,cid:43)(cid:2)(cid:1)(cid:34)(cid:34)(cid:19)(cid:18)(cid:18)(cid:2)(cid:44,Unknown,26608.0
Unknown,Unknown,34,Unknown,Unknown,Unknown,Unknown,cid:43)(cid:2)(cid:1)(cid:34)(cid:34)(cid:19)(cid:18)(cid:18)(cid:2)(cid:44,Unknown,26642.0
Unknown,Unknown,33,Unknown,Unknown,Unknown,Unknown,cid:43)(cid:2)(cid:1)(cid:34)(cid:34)(cid:19)(cid:18)(cid:18)(cid:2)(cid:44,Unknown,26675.0
Unknown,Unknown,1,Unknown,Unknown,Unknown,Unknown,cid:43)(cid:2)(cid:1)(cid:34)(cid:34)(cid:19)(cid:18)(cid:18)(cid:2)(cid:44,Unknown,26676.0
Unknown,Unknown,32,Unknown,Unknown,Unknown,Unknown,cid:43)(cid:2)(cid:1)(cid:34)(cid:34)(cid:19)(cid:18)(cid:18)(cid:2)(cid:44,Unknown,26708.0
Unknown,Unknown,45,Unknown,Unknown,Unknown,Unknown,cid:43)(cid:2)(cid:1)(cid:34)(cid:34)(cid:19)(cid:18)(cid:18)(cid:2)(cid:44,Unknown,26753.0
Unknown,Unknown,18,Unknown,Unknown,Unknown,Unknown,cid:43)(cid:2)(cid:1)(cid:34)(cid:34)(cid:19)(cid:18)(cid:18)(cid:2)(cid:44,Unknown,26771.0
Unknown,Unknown,35,Unknown,Unknown,Unknown,Unknown,cid:43)(cid:2)(cid:1)(cid:34)(cid:34)(cid:19)(cid:18)(cid:18)(cid:2)(cid:44,Unknown,26806.0
Unknown,Unknown,52,Unknown,Unknown,Unknown,Unknown,cid:43)(cid:2)(cid:1)(cid:34)(cid:34)(cid:19)(cid:18)(cid:18)(cid:2)(cid:44,Unknown,26858.0
Unknown,Unknown,7,Unknown,Unknown,Unknown,Unknown,cid:43)(cid:2)(cid:1)(cid:34)(cid:34)(cid:19)(cid:18)(cid:18)(cid:2)(cid:44,Unknown,26865.0
Unknown,Unknown,14,Unknown,Unknown,Unknown,Unknown,cid:43)(cid:2)(cid:1)(cid:34)(cid:34)(cid:19)(cid:18)(cid:18)(cid:2)(cid:44,Unknown,26879.0
Unknown,Unknown,46,Unknown,Unknown,Unknown,Unknown,cid:43)(cid:2)(cid:1)(cid:34)(cid:34)(cid:19)(cid:18)(cid:18)(cid:2)(cid:44,Unknown,26925.0
Unknown,Unknown,2,Unknown,Unknown,Unknown,Unknown,cid:43)(cid:2)(cid:1)(cid:34)(cid:34)(cid:19)(cid:18)(cid:18)(cid:2)(cid:44,Unknown,26927.0
Unknown,Unknown,53,Unknown,Unknown,Unknown,Unknown,cid:43)(cid:2)(cid:1)(cid:34)(cid:34)(cid:19)(cid:18)(cid:18)(cid:2)(cid:44,Unknown,26980.0
Unknown,Unknown,5,Unknown,Unknown,Unknown,Unknown,cid:43)(cid:2)(cid:1)(cid:34)(cid:34)(cid:19)(cid:18)(cid:18)(cid:2)(cid:44,Unknown,26985.0
Unknown,Unknown,3,Unknown,Unknown,Unknown,Unknown,cid:43)(cid:2)(cid:1)(cid:34)(cid:34)(cid:19)(cid:18)(cid:18)(cid:2)(cid:44,Unknown,26988.0
Unknown,Unknown,54,Unknown,Unknown,Unknown,Unknown,cid:43)(cid:2)(cid:1)(cid:34)(cid:34)(cid:19)(cid:18)(cid:18)(cid:2)(cid:44,Unknown,27042.0
Unknown,Unknown,7,Unknown,Unknown,Unknown,Unknown,cid:43)(cid:2)(cid:1)(cid:34)(cid:34)(cid:19)(cid:18)(cid:18)(cid:2)(cid:44,Unknown,27049.0
Unknown,Unknown,46,Unknown,Unknown,Unknown,Unknown,cid:43)(cid:2)(cid:1)(cid:34)(cid:34)(cid:19)(cid:18)(cid:18)(cid:2)(cid:44,Unknown,27095.0
Unknown,Unknown,2,Unknown,Unknown,Unknown,Unknown,cid:43)(cid:2)(cid:1)(cid:34)(cid:34)(cid:19)(cid:18)(cid:18)(cid:2)(cid:44,Unknown,27097.0
Unknown,Unknown,39,Unknown,Unknown,Unknown,Unknown,cid:43)(cid:2)(cid:1)(cid:34)(cid:34)(cid:19)(cid:18)(cid:18)(cid:2)(cid:44,Unknown,27136.0
Unknown,Unknown,26,Unknown,Unknown,Unknown,Unknown,cid:43)(cid:2)(cid:1)(cid:34)(cid:34)(cid:19)(cid:18)(cid:18)(cid:2)(cid:44,Unknown,27162.0
Unknown,Unknown,24,Unknown,Unknown,Unknown,Unknown,cid:43)(cid:2)(cid:1)(cid:34)(cid:34)(cid:19)(cid:18)(cid:18)(cid:2)(cid:44,Unknown,27186.0
Unknown,Unknown,27,Unknown,Unknown,Unknown,Unknown,cid:43)(cid:2)(cid:1)(cid:34)(cid:34)(cid:19)(cid:18)(cid:18)(cid:2)(cid:44,Unknown,27213.0
Unknown,Unknown,58,Unknown,Unknown,Unknown,Unknown,cid:43)(cid:2)(cid:1)(cid:34)(cid:34)(cid:19)(cid:18)(cid:18)(cid:2)(cid:44,Unknown,27271.0
Unknown,Unknown,41,Unknown,Unknown,Unknown,Unknown,cid:43)(cid:2)(cid:1)(cid:34)(cid:34)(cid:19)(cid:18)(cid:18)(cid:2)(cid:44,Unknown,27312.0
Unknown,Unknown,24,Unknown,Unknown,Unknown,Unknown,cid:43)(cid:2)(cid:1)(cid:34)(cid:34)(cid:19)(cid:18)(cid:18)(cid:2)(cid:44,Unknown,27336.0
Unknown,Unknown,30,Unknown,Unknown,Unknown,Unknown,cid:43)(cid:2)(cid:1)(cid:34)(cid:34)(cid:19)(cid:18)(cid:18)(cid:2)(cid:44,Unknown,27366.0
Unknown,Unknown,25,Unknown,Unknown,Unknown,Unknown,cid:43)(cid:2)(cid:1)(cid:34)(cid:34)(cid:19)(cid:18)(cid:18)(cid:2)(cid:44,Unknown,27391.0
Unknown,Unknown,2,Unknown,Unknown,Unknown,Unknown,cid:43)(cid:2)(cid:1)(cid:34)(cid:34)(cid:19)(cid:18)(cid:18)(cid:2)(cid:44,Unknown,27393.0
Unknown,Unknown,38,Unknown,Unknown,Unknown,Unknown,cid:43)(cid:2)(cid:1)(cid:34)(cid:34)(cid:19)(cid:18)(cid:18)(cid:2)(cid:44,Unknown,27431.0
Unknown,Unknown,64,Unknown,Unknown,Unknown,Unknown,cid:43)(cid:2)(cid:1)(cid:34)(cid:34)(cid:19)(cid:18)(cid:18)(cid:2)(cid:44,Unknown,27495.0
Unknown,Unknown,15,Unknown,Unknown,Unknown,Unknown,cid:43)(cid:2)(cid:1)(cid:34)(cid:34)(cid:19)(cid:18)(cid:18)(cid:2)(cid:44,Unknown,27510.0
Unknown,Unknown,2,Unknown,Unknown,Unknown,Unknown,cid:43)(cid:2)(cid:1)(cid:34)(cid:34)(cid:19)(cid:18)(cid:18)(cid:2)(cid:44,Unknown,27512.0
Unknown,Unknown,33,Unknown,Unknown,Unknown,Unknown,cid:43)(cid:2)(cid:1)(cid:34)(cid:34)(cid:19)(cid:18)(cid:18)(cid:2)(cid:44,Unknown,27545.0
Unknown,Unknown,1,Unknown,Unknown,Unknown,Unknown,cid:43)(cid:2)(cid:1)(cid:34)(cid:34)(cid:19)(cid:18)(cid:18)(cid:2)(cid:44,Unknown,27546.0
Unknown,Unknown,19,Unknown,Unknown,Unknown,Unknown,cid:43)(cid:2)(cid:1)(cid:34)(cid:34)(cid:19)(cid:18)(cid:18)(cid:2)(cid:44,Unknown,27565.0
Unknown,Unknown,36,Unknown,Unknown,Unknown,Unknown,cid:43)(cid:2)(cid:1)(cid:34)(cid:34)(cid:19)(cid:18)(cid:18)(cid:2)(cid:44,Unknown,27601.0
Unknown,Unknown,18,Unknown,Unknown,Unknown,Unknown,cid:43)(cid:2)(cid:1)(cid:34)(cid:34)(cid:19)(cid:18)(cid:18)(cid:2)(cid:44,Unknown,27619.0
Unknown,Unknown,2,Unknown,Unknown,Unknown,Unknown,cid:43)(cid:2)(cid:1)(cid:34)(cid:34)(cid:19)(cid:18)(cid:18)(cid:2)(cid:44,Unknown,27621.0
Unknown,Unknown,44,Unknown,Unknown,Unknown,Unknown,cid:43)(cid:2)(cid:1)(cid:34)(cid:34)(cid:19)(cid:18)(cid:18)(cid:2)(cid:44,Unknown,27665.0
Unknown,Unknown,12,Unknown,Unknown,Unknown,Unknown,cid:43)(cid:2)(cid:1)(cid:34)(cid:34)(cid:19)(cid:18)(cid:18)(cid:2)(cid:44,Unknown,27677.0
Unknown,Unknown,29,Unknown,Unknown,Unknown,Unknown,cid:43)(cid:2)(cid:1)(cid:34)(cid:34)(cid:19)(cid:18)(cid:18)(cid:2)(cid:44,Unknown,27706.0
Unknown,Unknown,26,Unknown,Unknown,Unknown,Unknown,cid:43)(cid:2)(cid:1)(cid:34)(cid:34)(cid:19)(cid:18)(cid:18)(cid:2)(cid:44,Unknown,27732.0
Unknown,Unknown,41,Unknown,Unknown,Unknown,Unknown,cid:43)(cid:2)(cid:1)(cid:34)(cid:34)(cid:19)(cid:18)(cid:18)(cid:2)(cid:44,Unknown,27773.0
Unknown,Unknown,25,Unknown,Unknown,Unknown,Unknown,cid:43)(cid:2)(cid:1)(cid:34)(cid:34)(cid:19)(cid:18)(cid:18)(cid:2)(cid:44,Unknown,27798.0
Unknown,Unknown,2,Unknown,Unknown,Unknown,Unknown,cid:43)(cid:2)(cid:1)(cid:34)(cid:34)(cid:19)(cid:18)(cid:18)(cid:2)(cid:44,Unknown,27800.0
Unknown,Unknown,50,Unknown,Unknown,Unknown,Unknown,cid:43)(cid:2)(cid:1)(cid:34)(cid:34)(cid:19)(cid:18)(cid:18)(cid:2)(cid:44,Unknown,27850.0
Unknown,Unknown,50,Unknown,Unknown,Unknown,Unknown,cid:43)(cid:2)(cid:1)(cid:34)(cid:34)(cid:19)(cid:18)(cid:18)(cid:2)(cid:44,Unknown,27900.0
Unknown,Unknown,37,Unknown,Unknown,Unknown,Unknown,cid:43)(cid:2)(cid:1)(cid:34)(cid:34)(cid:19)(cid:18)(cid:18)(cid:2)(cid:44,Unknown,27937.0
Unknown,Unknown,16,Unknown,Unknown,Unknown,Unknown,cid:43)(cid:2)(cid:1)(cid:34)(cid:34)(cid:19)(cid:18)(cid:18)(cid:2)(cid:44,Unknown,27953.0
Unknown,Unknown,34,Unknown,Unknown,Unknown,Unknown,cid:43)(cid:2)(cid:1)(cid:34)(cid:34)(cid:19)(cid:18)(cid:18)(cid:2)(cid:44,Unknown,27987.0
Unknown,Unknown,33,Unknown,Unknown,Unknown,Unknown,cid:43)(cid:2)(cid:1)(cid:34)(cid:34)(cid:19)(cid:18)(cid:18)(cid:2)(cid:44,Unknown,28020.0
Unknown,Unknown,1,Unknown,Unknown,Unknown,Unknown,cid:43)(cid:2)(cid:1)(cid:34)(cid:34)(cid:19)(cid:18)(cid:18)(cid:2)(cid:44,Unknown,28021.0
Unknown,Unknown,32,Unknown,Unknown,Unknown,Unknown,cid:43)(cid:2)(cid:1)(cid:34)(cid:34)(cid:19)(cid:18)(cid:18)(cid:2)(cid:44,Unknown,28053.0
Unknown,Unknown,45,Unknown,Unknown,Unknown,Unknown,cid:43)(cid:2)(cid:1)(cid:34)(cid:34)(cid:19)(cid:18)(cid:18)(cid:2)(cid:44,Unknown,28098.0
Unknown,Unknown,18,Unknown,Unknown,Unknown,Unknown,cid:43)(cid:2)(cid:1)(cid:34)(cid:34)(cid:19)(cid:18)(cid:18)(cid:2)(cid:44,Unknown,28116.0
Unknown,Unknown,35,Unknown,Unknown,Unknown,Unknown,cid:43)(cid:2)(cid:1)(cid:34)(cid:34)(cid:19)(cid:18)(cid:18)(cid:2)(cid:44,Unknown,28151.0
Unknown,Unknown,51,Unknown,Unknown,Unknown,Unknown,cid:43)(cid:2)(cid:1)(cid:34)(cid:34)(cid:19)(cid:18)(cid:18)(cid:2)(cid:44,Unknown,28202.0
Unknown,Unknown,5,Unknown,Unknown,Unknown,Unknown,cid:43)(cid:2)(cid:1)(cid:34)(cid:34)(cid:19)(cid:18)(cid:18)(cid:2)(cid:44,Unknown,28207.0
Unknown,Unknown,67,Unknown,Unknown,Unknown,Unknown,cid:43)(cid:2)(cid:1)(cid:34)(cid:34)(cid:19)(cid:18)(cid:18)(cid:2)(cid:44,Unknown,28274.0
Unknown,Unknown,46,Unknown,Unknown,Unknown,Unknown,cid:43)(cid:2)(cid:1)(cid:34)(cid:34)(cid:19)(cid:18)(cid:18)(cid:2)(cid:44,Unknown,28320.0
Unknown,Unknown,2,Unknown,Unknown,Unknown,Unknown,cid:43)(cid:2)(cid:1)(cid:34)(cid:34)(cid:19)(cid:18)(cid:18)(cid:2)(cid:44,Unknown,28322.0
Unknown,Unknown,10,Unknown,Unknown,Unknown,Unknown,cid:43)(cid:2)(cid:1)(cid:34)(cid:34)(cid:19)(cid:18)(cid:18)(cid:2)(cid:44,Unknown,28332.0
Unknown,Unknown,3,Unknown,Unknown,Unknown,Unknown,cid:43)(cid:2)(cid:1)(cid:34)(cid:34)(cid:19)(cid:18)(cid:18)(cid:2)(cid:44,Unknown,28335.0
Unknown,Unknown,46,Unknown,Unknown,Unknown,Unknown,cid:43)(cid:2)(cid:1)(cid:34)(cid:34)(cid:19)(cid:18)(cid:18)(cid:2)(cid:44,Unknown,28381.0
Unknown,Unknown,49,Unknown,Unknown,Unknown,Unknown,cid:43)(cid:2)(cid:1)(cid:34)(cid:34)(cid:19)(cid:18)(cid:18)(cid:2)(cid:44,Unknown,28430.0
Unknown,Unknown,5,Unknown,Unknown,Unknown,Unknown,cid:43)(cid:2)(cid:1)(cid:34)(cid:34)(cid:19)(cid:18)(cid:18)(cid:2)(cid:44,Unknown,28435.0
Unknown,Unknown,2,Unknown,Unknown,Unknown,Unknown,cid:43)(cid:2)(cid:1)(cid:34)(cid:34)(cid:19)(cid:18)(cid:18)(cid:2)(cid:44,Unknown,28437.0
Unknown,Unknown,9,Unknown,Unknown,Unknown,Unknown,cid:43)(cid:2)(cid:1)(cid:34)(cid:34)(cid:19)(cid:18)(cid:18)(cid:2)(cid:44,Unknown,28446.0
Unknown,Unknown,13,Unknown,Unknown,Unknown,Unknown,cid:43)(cid:2)(cid:1)(cid:34)(cid:34)(cid:19)(cid:18)(cid:18)(cid:2)(cid:44,Unknown,28459.0
Unknown,Unknown,39,Unknown,Unknown,Unknown,Unknown,cid:43)(cid:2)(cid:1)(cid:34)(cid:34)(cid:19)(cid:18)(cid:18)(cid:2)(cid:44,Unknown,28498.0
Unknown,Unknown,67,Unknown,Unknown,Unknown,Unknown,cid:43)(cid:2)(cid:1)(cid:34)(cid:34)(cid:19)(cid:18)(cid:18)(cid:2)(cid:44,Unknown,28565.0
Unknown,Unknown,2,Unknown,Unknown,Unknown,Unknown,cid:43)(cid:2)(cid:1)(cid:34)(cid:34)(cid:19)(cid:18)(cid:18)(cid:2)(cid:44,Unknown,28567.0
Unknown,Unknown,39,Unknown,Unknown,Unknown,Unknown,cid:43)(cid:2)(cid:1)(cid:34)(cid:34)(cid:19)(cid:18)(cid:18)(cid:2)(cid:44,Unknown,28606.0
Unknown,Unknown,3,Unknown,Unknown,Unknown,Unknown,cid:43)(cid:2)(cid:1)(cid:34)(cid:34)(cid:19)(cid:18)(cid:18)(cid:2)(cid:44,Unknown,28609.0
Unknown,Unknown,7,Unknown,Unknown,Unknown,Unknown,cid:43)(cid:2)(cid:1)(cid:34)(cid:34)(cid:19)(cid:18)(cid:18)(cid:2)(cid:44,Unknown,28616.0
Unknown,Unknown,9,Unknown,Unknown,Unknown,Unknown,cid:43)(cid:2)(cid:1)(cid:34)(cid:34)(cid:19)(cid:18)(cid:18)(cid:2)(cid:44,Unknown,28625.0
Unknown,Unknown,13,Unknown,Unknown,Unknown,Unknown,cid:43)(cid:2)(cid:1)(cid:34)(cid:34)(cid:19)(cid:18)(cid:18)(cid:2)(cid:44,Unknown,28638.0
Unknown,Unknown,10,Unknown,Unknown,Unknown,Unknown,cid:43)(cid:2)(cid:1)(cid:34)(cid:34)(cid:19)(cid:18)(cid:18)(cid:2)(cid:44,Unknown,28648.0
Unknown,Unknown,7,Unknown,Unknown,Unknown,Unknown,cid:43)(cid:2)(cid:1)(cid:34)(cid:34)(cid:19)(cid:18)(cid:18)(cid:2)(cid:44,Unknown,28655.0
Unknown,Unknown,8,Unknown,Unknown,Unknown,Unknown,cid:43)(cid:2)(cid:1)(cid:34)(cid:34)(cid:19)(cid:18)(cid:18)(cid:2)(cid:44,Unknown,28663.0
Unknown,Unknown,46,Unknown,Unknown,Unknown,Unknown,cid:43)(cid:2)(cid:1)(cid:34)(cid:34)(cid:19)(cid:18)(cid:18)(cid:2)(cid:44,Unknown,28709.0
Unknown,Unknown,2,Unknown,Unknown,Unknown,Unknown,cid:43)(cid:2)(cid:1)(cid:34)(cid:34)(cid:19)(cid:18)(cid:18)(cid:2)(cid:44,Unknown,28711.0
Unknown,Unknown,38,Unknown,Unknown,Unknown,Unknown,cid:43)(cid:2)(cid:1)(cid:34)(cid:34)(cid:19)(cid:18)(cid:18)(cid:2)(cid:44,Unknown,28749.0
Unknown,Unknown,64,Unknown,Unknown,Unknown,Unknown,cid:43)(cid:2)(cid:1)(cid:34)(cid:34)(cid:19)(cid:18)(cid:18)(cid:2)(cid:44,Unknown,28813.0
Unknown,Unknown,15,Unknown,Unknown,Unknown,Unknown,cid:43)(cid:2)(cid:1)(cid:34)(cid:34)(cid:19)(cid:18)(cid:18)(cid:2)(cid:44,Unknown,28828.0
Unknown,Unknown,2,Unknown,Unknown,Unknown,Unknown,cid:43)(cid:2)(cid:1)(cid:34)(cid:34)(cid:19)(cid:18)(cid:18)(cid:2)(cid:44,Unknown,28830.0
Unknown,Unknown,37,Unknown,Unknown,Unknown,Unknown,cid:43)(cid:2)(cid:1)(cid:34)(cid:34)(cid:19)(cid:18)(cid:18)(cid:2)(cid:44,Unknown,28867.0
Unknown,Unknown,18,Unknown,Unknown,Unknown,Unknown,cid:43)(cid:2)(cid:1)(cid:34)(cid:34)(cid:19)(cid:18)(cid:18)(cid:2)(cid:44,Unknown,28885.0
Unknown,Unknown,19,Unknown,Unknown,Unknown,Unknown,cid:43)(cid:2)(cid:1)(cid:34)(cid:34)(cid:19)(cid:18)(cid:18)(cid:2)(cid:44,Unknown,28904.0
Unknown,Unknown,17,Unknown,Unknown,Unknown,Unknown,cid:43)(cid:2)(cid:1)(cid:34)(cid:34)(cid:19)(cid:18)(cid:18)(cid:2)(cid:44,Unknown,28921.0
Unknown,Unknown,16,Unknown,Unknown,Unknown,Unknown,cid:43)(cid:2)(cid:1)(cid:34)(cid:34)(cid:19)(cid:18)(cid:18)(cid:2)(cid:44,Unknown,28937.0
Unknown,Unknown,2,Unknown,Unknown,Unknown,Unknown,cid:43)(cid:2)(cid:1)(cid:34)(cid:34)(cid:19)(cid:18)(cid:18)(cid:2)(cid:44,Unknown,28939.0
Unknown,Unknown,44,Unknown,Unknown,Unknown,Unknown,cid:43)(cid:2)(cid:1)(cid:34)(cid:34)(cid:19)(cid:18)(cid:18)(cid:2)(cid:44,Unknown,28983.0
Unknown,Unknown,12,Unknown,Unknown,Unknown,Unknown,cid:43)(cid:2)(cid:1)(cid:34)(cid:34)(cid:19)(cid:18)(cid:18)(cid:2)(cid:44,Unknown,28995.0
Unknown,Unknown,29,Unknown,Unknown,Unknown,Unknown,cid:43)(cid:2)(cid:1)(cid:34)(cid:34)(cid:19)(cid:18)(cid:18)(cid:2)(cid:44,Unknown,29024.0
Unknown,Unknown,26,Unknown,Unknown,Unknown,Unknown,cid:43)(cid:2)(cid:1)(cid:34)(cid:34)(cid:19)(cid:18)(cid:18)(cid:2)(cid:44,Unknown,29050.0
Unknown,Unknown,41,Unknown,Unknown,Unknown,Unknown,cid:43)(cid:2)(cid:1)(cid:34)(cid:34)(cid:19)(cid:18)(cid:18)(cid:2)(cid:44,Unknown,29091.0
Unknown,Unknown,25,Unknown,Unknown,Unknown,Unknown,cid:43)(cid:2)(cid:1)(cid:34)(cid:34)(cid:19)(cid:18)(cid:18)(cid:2)(cid:44,Unknown,29116.0
Unknown,Unknown,2,Unknown,Unknown,Unknown,Unknown,cid:43)(cid:2)(cid:1)(cid:34)(cid:34)(cid:19)(cid:18)(cid:18)(cid:2)(cid:44,Unknown,29118.0
Unknown,Unknown,50,Unknown,Unknown,Unknown,Unknown,cid:43)(cid:2)(cid:1)(cid:34)(cid:34)(cid:19)(cid:18)(cid:18)(cid:2)(cid:44,Unknown,29168.0
Unknown,Unknown,50,Unknown,Unknown,Unknown,Unknown,cid:43)(cid:2)(cid:1)(cid:34)(cid:34)(cid:19)(cid:18)(cid:18)(cid:2)(cid:44,Unknown,29218.0
Unknown,Unknown,18,Unknown,Unknown,Unknown,Unknown,cid:43)(cid:2)(cid:1)(cid:34)(cid:34)(cid:19)(cid:18)(cid:18)(cid:2)(cid:44,Unknown,29236.0
Unknown,Unknown,1,Unknown,Unknown,Unknown,Unknown,cid:43)(cid:2)(cid:1)(cid:34)(cid:34)(cid:19)(cid:18)(cid:18)(cid:2)(cid:44,Unknown,29237.0
Unknown,Unknown,1,Unknown,Unknown,Unknown,Unknown,cid:43)(cid:2)(cid:1)(cid:34)(cid:34)(cid:19)(cid:18)(cid:18)(cid:2)(cid:44,Unknown,29238.0
Unknown,Unknown,37,Unknown,Unknown,Unknown,Unknown,cid:43)(cid:2)(cid:1)(cid:34)(cid:34)(cid:19)(cid:18)(cid:18)(cid:2)(cid:44,Unknown,29275.0
Unknown,Unknown,1,Unknown,Unknown,Unknown,Unknown,cid:15)(cid:2)(cid:17)(cid:2)(cid:18)(cid:1)(cid:18)(cid:19)(cid:18)(cid:18)(cid:2)(cid:1)(cid:2)(cid:3,cid:16)(cid:19)(cid:36)(cid:36)(cid:32)(cid:35)(cid:18)(cid:35)(cid:34)(cid:17)(cid:18)(cid:32)(cid:37)(cid:35)(cid:37)(cid:2)(cid:74)(cid:30)(cid:2)(cid:73)(cid:2)(cid:17)(cid:19)(cid:18)(cid:18)(cid:2)(cid:44,1.0
Unknown,Unknown,16,Unknown,Unknown,Unknown,Unknown,cid:15)(cid:2)(cid:17)(cid:2)(cid:18)(cid:1)(cid:18)(cid:19)(cid:18)(cid:18)(cid:2)(cid:1)(cid:2)(cid:3,cid:15)(cid:2)(cid:17)(cid:32)(cid:37)(cid:19)(cid:17)(cid:33)(cid:2)(cid:44,17.0
Unknown,Unknown,45,Unknown,Unknown,Unknown,Unknown,cid:15)(cid:2)(cid:17)(cid:2)(cid:18)(cid:1)(cid:18)(cid:19)(cid:18)(cid:18)(cid:2)(cid:1)(cid:2)(cid:3,cid:9)(cid:46)(cid:8)(cid:5)(cid:28)(cid:2)(cid:9)(cid:5)(cid:8)(cid:14)(cid:7)(cid:9)(cid:2)(cid:28)(cid:3,62.0
Unknown,Unknown,18,Unknown,Unknown,Unknown,Unknown,cid:15)(cid:2)(cid:17)(cid:2)(cid:18)(cid:1)(cid:18)(cid:19)(cid:18)(cid:18)(cid:2)(cid:1)(cid:2)(cid:3,cid:9)(cid:46)(cid:8)(cid:5)(cid:28)(cid:2)(cid:9)(cid:5)(cid:8)(cid:14)(cid:7)(cid:9)(cid:2)(cid:28)(cid:3,80.0
Unknown,Unknown,35,Unknown,Unknown,Unknown,Unknown,cid:15)(cid:2)(cid:17)(cid:2)(cid:18)(cid:1)(cid:18)(cid:19)(cid:18)(cid:18)(cid:2)(cid:1)(cid:2)(cid:3,Unknown,115.0
Unknown,Unknown,65,Unknown,Unknown,Unknown,Unknown,cid:15)(cid:2)(cid:17)(cid:2)(cid:18)(cid:1)(cid:18)(cid:19)(cid:18)(cid:18)(cid:2)(cid:1)(cid:2)(cid:3,Unknown,180.0
Unknown,Unknown,39,Unknown,Unknown,Unknown,Unknown,cid:15)(cid:2)(cid:17)(cid:2)(cid:18)(cid:1)(cid:18)(cid:19)(cid:18)(cid:18)(cid:2)(cid:1)(cid:2)(cid:3,Unknown,219.0
Unknown,Unknown,2,Unknown,Unknown,Unknown,Unknown,cid:15)(cid:2)(cid:17)(cid:2)(cid:18)(cid:1)(cid:18)(cid:19)(cid:18)(cid:18)(cid:2)(cid:1)(cid:2)(cid:3,Unknown,221.0
Unknown,Unknown,39,Unknown,Unknown,Unknown,Unknown,cid:15)(cid:2)(cid:17)(cid:2)(cid:18)(cid:1)(cid:18)(cid:19)(cid:18)(cid:18)(cid:2)(cid:1)(cid:2)(cid:3,Unknown,260.0
Unknown,Unknown,4,Unknown,Unknown,Unknown,Unknown,cid:15)(cid:2)(cid:17)(cid:2)(cid:18)(cid:1)(cid:18)(cid:19)(cid:18)(cid:18)(cid:2)(cid:1)(cid:2)(cid:3,Unknown,264.0
Unknown,Unknown,10,Unknown,Unknown,Unknown,Unknown,cid:15)(cid:2)(cid:17)(cid:2)(cid:18)(cid:1)(cid:18)(cid:19)(cid:18)(cid:18)(cid:2)(cid:1)(cid:2)(cid:3,Unknown,274.0
Unknown,Unknown,5,Unknown,Unknown,Unknown,Unknown,cid:15)(cid:2)(cid:17)(cid:2)(cid:18)(cid:1)(cid:18)(cid:19)(cid:18)(cid:18)(cid:2)(cid:1)(cid:2)(cid:3,Unknown,279.0
Unknown,Unknown,52,Unknown,Unknown,Unknown,Unknown,cid:15)(cid:2)(cid:17)(cid:2)(cid:18)(cid:1)(cid:18)(cid:19)(cid:18)(cid:18)(cid:2)(cid:1)(cid:2)(cid:3,Unknown,331.0
Unknown,Unknown,7,Unknown,Unknown,Unknown,Unknown,cid:15)(cid:2)(cid:17)(cid:2)(cid:18)(cid:1)(cid:18)(cid:19)(cid:18)(cid:18)(cid:2)(cid:1)(cid:2)(cid:3,Unknown,338.0
Unknown,Unknown,2,Unknown,Unknown,Unknown,Unknown,cid:15)(cid:2)(cid:17)(cid:2)(cid:18)(cid:1)(cid:18)(cid:19)(cid:18)(cid:18)(cid:2)(cid:1)(cid:2)(cid:3,Unknown,340.0
Unknown,Unknown,51,Unknown,Unknown,Unknown,Unknown,cid:15)(cid:2)(cid:17)(cid:2)(cid:18)(cid:1)(cid:18)(cid:19)(cid:18)(cid:18)(cid:2)(cid:1)(cid:2)(cid:3,Unknown,391.0
Unknown,Unknown,5,Unknown,Unknown,Unknown,Unknown,cid:15)(cid:2)(cid:17)(cid:2)(cid:18)(cid:1)(cid:18)(cid:19)(cid:18)(cid:18)(cid:2)(cid:1)(cid:2)(cid:3,Unknown,396.0
Unknown,Unknown,11,Unknown,Unknown,Unknown,Unknown,cid:15)(cid:2)(cid:17)(cid:2)(cid:18)(cid:1)(cid:18)(cid:19)(cid:18)(cid:18)(cid:2)(cid:1)(cid:2)(cid:3,Unknown,407.0
Unknown,Unknown,53,Unknown,Unknown,Unknown,Unknown,cid:15)(cid:2)(cid:17)(cid:2)(cid:18)(cid:1)(cid:18)(cid:19)(cid:18)(cid:18)(cid:2)(cid:1)(cid:2)(cid:3,Unknown,460.0
Unknown,Unknown,3,Unknown,Unknown,Unknown,Unknown,cid:15)(cid:2)(cid:17)(cid:2)(cid:18)(cid:1)(cid:18)(cid:19)(cid:18)(cid:18)(cid:2)(cid:1)(cid:2)(cid:3,Unknown,463.0
Unknown,Unknown,46,Unknown,Unknown,Unknown,Unknown,cid:15)(cid:2)(cid:17)(cid:2)(cid:18)(cid:1)(cid:18)(cid:19)(cid:18)(cid:18)(cid:2)(cid:1)(cid:2)(cid:3,Unknown,509.0
Unknown,Unknown,49,Unknown,Unknown,Unknown,Unknown,cid:15)(cid:2)(cid:17)(cid:2)(cid:18)(cid:1)(cid:18)(cid:19)(cid:18)(cid:18)(cid:2)(cid:1)(cid:2)(cid:3,Unknown,558.0
Unknown,Unknown,2,Unknown,Unknown,Unknown,Unknown,cid:15)(cid:2)(cid:17)(cid:2)(cid:18)(cid:1)(cid:18)(cid:19)(cid:18)(cid:18)(cid:2)(cid:1)(cid:2)(cid:3,Unknown,560.0
Unknown,Unknown,17,Unknown,Unknown,Unknown,Unknown,cid:15)(cid:2)(cid:17)(cid:2)(cid:18)(cid:1)(cid:18)(cid:19)(cid:18)(cid:18)(cid:2)(cid:1)(cid:2)(cid:3,Unknown,577.0
Unknown,Unknown,37,Unknown,Unknown,Unknown,Unknown,cid:15)(cid:2)(cid:17)(cid:2)(cid:18)(cid:1)(cid:18)(cid:19)(cid:18)(cid:18)(cid:2)(cid:1)(cid:2)(cid:3,Unknown,614.0
Unknown,Unknown,2,Unknown,Unknown,Unknown,Unknown,cid:15)(cid:2)(cid:17)(cid:2)(cid:18)(cid:1)(cid:18)(cid:19)(cid:18)(cid:18)(cid:2)(cid:1)(cid:2)(cid:3,Unknown,616.0
Unknown,Unknown,51,Unknown,Unknown,Unknown,Unknown,cid:15)(cid:2)(cid:17)(cid:2)(cid:18)(cid:1)(cid:18)(cid:19)(cid:18)(cid:18)(cid:2)(cid:1)(cid:2)(cid:3,Unknown,667.0
Unknown,Unknown,5,Unknown,Unknown,Unknown,Unknown,cid:15)(cid:2)(cid:17)(cid:2)(cid:18)(cid:1)(cid:18)(cid:19)(cid:18)(cid:18)(cid:2)(cid:1)(cid:2)(cid:3,Unknown,672.0
Unknown,Unknown,11,Unknown,Unknown,Unknown,Unknown,cid:15)(cid:2)(cid:17)(cid:2)(cid:18)(cid:1)(cid:18)(cid:19)(cid:18)(cid:18)(cid:2)(cid:1)(cid:2)(cid:3,Unknown,683.0
Unknown,Unknown,53,Unknown,Unknown,Unknown,Unknown,cid:15)(cid:2)(cid:17)(cid:2)(cid:18)(cid:1)(cid:18)(cid:19)(cid:18)(cid:18)(cid:2)(cid:1)(cid:2)(cid:3,Unknown,736.0
Unknown,Unknown,3,Unknown,Unknown,Unknown,Unknown,cid:15)(cid:2)(cid:17)(cid:2)(cid:18)(cid:1)(cid:18)(cid:19)(cid:18)(cid:18)(cid:2)(cid:1)(cid:2)(cid:3,Unknown,739.0
Unknown,Unknown,46,Unknown,Unknown,Unknown,Unknown,cid:15)(cid:2)(cid:17)(cid:2)(cid:18)(cid:1)(cid:18)(cid:19)(cid:18)(cid:18)(cid:2)(cid:1)(cid:2)(cid:3,Unknown,785.0
Unknown,Unknown,49,Unknown,Unknown,Unknown,Unknown,cid:15)(cid:2)(cid:17)(cid:2)(cid:18)(cid:1)(cid:18)(cid:19)(cid:18)(cid:18)(cid:2)(cid:1)(cid:2)(cid:3,Unknown,834.0
Unknown,Unknown,2,Unknown,Unknown,Unknown,Unknown,cid:15)(cid:2)(cid:17)(cid:2)(cid:18)(cid:1)(cid:18)(cid:19)(cid:18)(cid:18)(cid:2)(cid:1)(cid:2)(cid:3,Unknown,836.0
Unknown,Unknown,3,Unknown,Unknown,Unknown,Unknown,cid:15)(cid:2)(cid:17)(cid:2)(cid:18)(cid:1)(cid:18)(cid:19)(cid:18)(cid:18)(cid:2)(cid:1)(cid:2)(cid:3,Unknown,839.0
Unknown,Unknown,9,Unknown,Unknown,Unknown,Unknown,cid:15)(cid:2)(cid:17)(cid:2)(cid:18)(cid:1)(cid:18)(cid:19)(cid:18)(cid:18)(cid:2)(cid:1)(cid:2)(cid:3,Unknown,848.0
Unknown,Unknown,15,Unknown,Unknown,Unknown,Unknown,cid:15)(cid:2)(cid:17)(cid:2)(cid:18)(cid:1)(cid:18)(cid:19)(cid:18)(cid:18)(cid:2)(cid:1)(cid:2)(cid:3,Unknown,863.0
Unknown,Unknown,2,Unknown,Unknown,Unknown,Unknown,cid:15)(cid:2)(cid:17)(cid:2)(cid:18)(cid:1)(cid:18)(cid:19)(cid:18)(cid:18)(cid:2)(cid:1)(cid:2)(cid:3,Unknown,865.0
Unknown,Unknown,35,Unknown,Unknown,Unknown,Unknown,cid:15)(cid:2)(cid:17)(cid:2)(cid:18)(cid:1)(cid:18)(cid:19)(cid:18)(cid:18)(cid:2)(cid:1)(cid:2)(cid:3,Unknown,900.0
Unknown,Unknown,19,Unknown,Unknown,Unknown,Unknown,cid:15)(cid:2)(cid:17)(cid:2)(cid:18)(cid:1)(cid:18)(cid:19)(cid:18)(cid:18)(cid:2)(cid:1)(cid:2)(cid:3,Unknown,919.0
Unknown,Unknown,16,Unknown,Unknown,Unknown,Unknown,cid:15)(cid:2)(cid:17)(cid:2)(cid:18)(cid:1)(cid:18)(cid:19)(cid:18)(cid:18)(cid:2)(cid:1)(cid:2)(cid:3,Unknown,935.0
Unknown,Unknown,18,Unknown,Unknown,Unknown,Unknown,cid:15)(cid:2)(cid:17)(cid:2)(cid:18)(cid:1)(cid:18)(cid:19)(cid:18)(cid:18)(cid:2)(cid:1)(cid:2)(cid:3,Unknown,953.0
Unknown,Unknown,2,Unknown,Unknown,Unknown,Unknown,cid:15)(cid:2)(cid:17)(cid:2)(cid:18)(cid:1)(cid:18)(cid:19)(cid:18)(cid:18)(cid:2)(cid:1)(cid:2)(cid:3,Unknown,955.0
Unknown,Unknown,44,Unknown,Unknown,Unknown,Unknown,cid:15)(cid:2)(cid:17)(cid:2)(cid:18)(cid:1)(cid:18)(cid:19)(cid:18)(cid:18)(cid:2)(cid:1)(cid:2)(cid:3,Unknown,999.0
Unknown,Unknown,17,Unknown,Unknown,Unknown,Unknown,cid:15)(cid:2)(cid:17)(cid:2)(cid:18)(cid:1)(cid:18)(cid:19)(cid:18)(cid:18)(cid:2)(cid:1)(cid:2)(cid:3,Unknown,1016.0
Unknown,Unknown,17,Unknown,Unknown,Unknown,Unknown,cid:15)(cid:2)(cid:17)(cid:2)(cid:18)(cid:1)(cid:18)(cid:19)(cid:18)(cid:18)(cid:2)(cid:1)(cid:2)(cid:3,Unknown,1033.0
Unknown,Unknown,16,Unknown,Unknown,Unknown,Unknown,cid:15)(cid:2)(cid:17)(cid:2)(cid:18)(cid:1)(cid:18)(cid:19)(cid:18)(cid:18)(cid:2)(cid:1)(cid:2)(cid:3,Unknown,1049.0
Unknown,Unknown,19,Unknown,Unknown,Unknown,Unknown,cid:15)(cid:2)(cid:17)(cid:2)(cid:18)(cid:1)(cid:18)(cid:19)(cid:18)(cid:18)(cid:2)(cid:1)(cid:2)(cid:3,Unknown,1068.0
Unknown,Unknown,1,Unknown,Unknown,Unknown,Unknown,cid:15)(cid:2)(cid:17)(cid:2)(cid:18)(cid:1)(cid:18)(cid:19)(cid:18)(cid:18)(cid:2)(cid:1)(cid:2)(cid:3,Unknown,1069.0
Unknown,Unknown,36,Unknown,Unknown,Unknown,Unknown,cid:15)(cid:2)(cid:17)(cid:2)(cid:18)(cid:1)(cid:18)(cid:19)(cid:18)(cid:18)(cid:2)(cid:1)(cid:2)(cid:3,Unknown,1105.0
Unknown,Unknown,17,Unknown,Unknown,Unknown,Unknown,cid:15)(cid:2)(cid:17)(cid:2)(cid:18)(cid:1)(cid:18)(cid:19)(cid:18)(cid:18)(cid:2)(cid:1)(cid:2)(cid:3,Unknown,1122.0
Unknown,Unknown,37,Unknown,Unknown,Unknown,Unknown,cid:15)(cid:2)(cid:17)(cid:2)(cid:18)(cid:1)(cid:18)(cid:19)(cid:18)(cid:18)(cid:2)(cid:1)(cid:2)(cid:3,Unknown,1159.0
Unknown,Unknown,16,Unknown,Unknown,Unknown,Unknown,cid:15)(cid:2)(cid:17)(cid:2)(cid:18)(cid:1)(cid:18)(cid:19)(cid:18)(cid:18)(cid:2)(cid:1)(cid:2)(cid:3,Unknown,1175.0
Unknown,Unknown,33,Unknown,Unknown,Unknown,Unknown,cid:15)(cid:2)(cid:17)(cid:2)(cid:18)(cid:1)(cid:18)(cid:19)(cid:18)(cid:18)(cid:2)(cid:1)(cid:2)(cid:3,Unknown,1208.0
Unknown,Unknown,37,Unknown,Unknown,Unknown,Unknown,cid:15)(cid:2)(cid:17)(cid:2)(cid:18)(cid:1)(cid:18)(cid:19)(cid:18)(cid:18)(cid:2)(cid:1)(cid:2)(cid:3,Unknown,1245.0
Unknown,Unknown,17,Unknown,Unknown,Unknown,Unknown,cid:15)(cid:2)(cid:17)(cid:2)(cid:18)(cid:1)(cid:18)(cid:19)(cid:18)(cid:18)(cid:2)(cid:1)(cid:2)(cid:3,Unknown,1262.0
Unknown,Unknown,18,Unknown,Unknown,Unknown,Unknown,cid:15)(cid:2)(cid:17)(cid:2)(cid:18)(cid:1)(cid:18)(cid:19)(cid:18)(cid:18)(cid:2)(cid:1)(cid:2)(cid:3,Unknown,1280.0
Unknown,Unknown,37,Unknown,Unknown,Unknown,Unknown,cid:15)(cid:2)(cid:17)(cid:2)(cid:18)(cid:1)(cid:18)(cid:19)(cid:18)(cid:18)(cid:2)(cid:1)(cid:2)(cid:3,Unknown,1317.0
Unknown,Unknown,36,Unknown,Unknown,Unknown,Unknown,cid:15)(cid:2)(cid:17)(cid:2)(cid:18)(cid:1)(cid:18)(cid:19)(cid:18)(cid:18)(cid:2)(cid:1)(cid:2)(cid:3,Unknown,1353.0
Unknown,Unknown,34,Unknown,Unknown,Unknown,Unknown,cid:15)(cid:2)(cid:17)(cid:2)(cid:18)(cid:1)(cid:18)(cid:19)(cid:18)(cid:18)(cid:2)(cid:1)(cid:2)(cid:3,Unknown,1387.0
Unknown,Unknown,2,Unknown,Unknown,Unknown,Unknown,cid:15)(cid:2)(cid:17)(cid:2)(cid:18)(cid:1)(cid:18)(cid:19)(cid:18)(cid:18)(cid:2)(cid:1)(cid:2)(cid:3,Unknown,1389.0
Unknown,Unknown,1,Unknown,Unknown,Unknown,Unknown,cid:15)(cid:2)(cid:17)(cid:2)(cid:18)(cid:1)(cid:18)(cid:19)(cid:18)(cid:18)(cid:2)(cid:1)(cid:2)(cid:3,Unknown,1390.0
Unknown,Unknown,2,Unknown,Unknown,Unknown,Unknown,cid:15)(cid:2)(cid:17)(cid:2)(cid:18)(cid:1)(cid:18)(cid:19)(cid:18)(cid:18)(cid:2)(cid:1)(cid:2)(cid:3,Unknown,1392.0
Unknown,Unknown,3,Unknown,Unknown,Unknown,Unknown,cid:15)(cid:2)(cid:17)(cid:2)(cid:18)(cid:1)(cid:18)(cid:19)(cid:18)(cid:18)(cid:2)(cid:1)(cid:2)(cid:3,Unknown,1395.0
Unknown,Unknown,2,Unknown,Unknown,Unknown,Unknown,cid:15)(cid:2)(cid:17)(cid:2)(cid:18)(cid:1)(cid:18)(cid:19)(cid:18)(cid:18)(cid:2)(cid:1)(cid:2)(cid:3,Unknown,1397.0
Unknown,Unknown,73,Unknown,Unknown,Unknown,Unknown,cid:15)(cid:2)(cid:17)(cid:2)(cid:18)(cid:1)(cid:18)(cid:19)(cid:18)(cid:18)(cid:2)(cid:1)(cid:2)(cid:3,Unknown,1470.0
Unknown,Unknown,2,Unknown,Unknown,Unknown,Unknown,cid:15)(cid:2)(cid:17)(cid:2)(cid:18)(cid:1)(cid:18)(cid:19)(cid:18)(cid:18)(cid:2)(cid:1)(cid:2)(cid:3,Unknown,1472.0
Unknown,Unknown,17,Unknown,Unknown,Unknown,Unknown,cid:15)(cid:2)(cid:17)(cid:2)(cid:18)(cid:1)(cid:18)(cid:19)(cid:18)(cid:18)(cid:2)(cid:1)(cid:2)(cid:3,Unknown,1489.0
Unknown,Unknown,19,Unknown,Unknown,Unknown,Unknown,cid:15)(cid:2)(cid:17)(cid:2)(cid:18)(cid:1)(cid:18)(cid:19)(cid:18)(cid:18)(cid:2)(cid:1)(cid:2)(cid:3,Unknown,1508.0
Unknown,Unknown,18,Unknown,Unknown,Unknown,Unknown,cid:15)(cid:2)(cid:17)(cid:2)(cid:18)(cid:1)(cid:18)(cid:19)(cid:18)(cid:18)(cid:2)(cid:1)(cid:2)(cid:3,Unknown,1526.0
Unknown,Unknown,18,Unknown,Unknown,Unknown,Unknown,cid:15)(cid:2)(cid:17)(cid:2)(cid:18)(cid:1)(cid:18)(cid:19)(cid:18)(cid:18)(cid:2)(cid:1)(cid:2)(cid:3,Unknown,1544.0
Unknown,Unknown,2,Unknown,Unknown,Unknown,Unknown,cid:15)(cid:2)(cid:17)(cid:2)(cid:18)(cid:1)(cid:18)(cid:19)(cid:18)(cid:18)(cid:2)(cid:1)(cid:2)(cid:3,Unknown,1546.0
Unknown,Unknown,44,Unknown,Unknown,Unknown,Unknown,cid:15)(cid:2)(cid:17)(cid:2)(cid:18)(cid:1)(cid:18)(cid:19)(cid:18)(cid:18)(cid:2)(cid:1)(cid:2)(cid:3,Unknown,1590.0
Unknown,Unknown,15,Unknown,Unknown,Unknown,Unknown,cid:15)(cid:2)(cid:17)(cid:2)(cid:18)(cid:1)(cid:18)(cid:19)(cid:18)(cid:18)(cid:2)(cid:1)(cid:2)(cid:3,Unknown,1605.0
Unknown,Unknown,2,Unknown,Unknown,Unknown,Unknown,cid:15)(cid:2)(cid:17)(cid:2)(cid:18)(cid:1)(cid:18)(cid:19)(cid:18)(cid:18)(cid:2)(cid:1)(cid:2)(cid:3,Unknown,1607.0
Unknown,Unknown,17,Unknown,Unknown,Unknown,Unknown,cid:15)(cid:2)(cid:17)(cid:2)(cid:18)(cid:1)(cid:18)(cid:19)(cid:18)(cid:18)(cid:2)(cid:1)(cid:2)(cid:3,Unknown,1624.0
Unknown,Unknown,2,Unknown,Unknown,Unknown,Unknown,cid:15)(cid:2)(cid:17)(cid:2)(cid:18)(cid:1)(cid:18)(cid:19)(cid:18)(cid:18)(cid:2)(cid:1)(cid:2)(cid:3,Unknown,1626.0
Unknown,Unknown,18,Unknown,Unknown,Unknown,Unknown,cid:15)(cid:2)(cid:17)(cid:2)(cid:18)(cid:1)(cid:18)(cid:19)(cid:18)(cid:18)(cid:2)(cid:1)(cid:2)(cid:3,Unknown,1644.0
Unknown,Unknown,1,Unknown,Unknown,Unknown,Unknown,cid:15)(cid:2)(cid:17)(cid:2)(cid:18)(cid:1)(cid:18)(cid:19)(cid:18)(cid:18)(cid:2)(cid:1)(cid:2)(cid:3,Unknown,1645.0
Unknown,Unknown,18,Unknown,Unknown,Unknown,Unknown,cid:15)(cid:2)(cid:17)(cid:2)(cid:18)(cid:1)(cid:18)(cid:19)(cid:18)(cid:18)(cid:2)(cid:1)(cid:2)(cid:3,Unknown,1663.0
Unknown,Unknown,19,Unknown,Unknown,Unknown,Unknown,cid:15)(cid:2)(cid:17)(cid:2)(cid:18)(cid:1)(cid:18)(cid:19)(cid:18)(cid:18)(cid:2)(cid:1)(cid:2)(cid:3,Unknown,1682.0
Unknown,Unknown,18,Unknown,Unknown,Unknown,Unknown,cid:15)(cid:2)(cid:17)(cid:2)(cid:18)(cid:1)(cid:18)(cid:19)(cid:18)(cid:18)(cid:2)(cid:1)(cid:2)(cid:3,Unknown,1700.0
Unknown,Unknown,18,Unknown,Unknown,Unknown,Unknown,cid:15)(cid:2)(cid:17)(cid:2)(cid:18)(cid:1)(cid:18)(cid:19)(cid:18)(cid:18)(cid:2)(cid:1)(cid:2)(cid:3,Unknown,1718.0
Unknown,Unknown,2,Unknown,Unknown,Unknown,Unknown,cid:15)(cid:2)(cid:17)(cid:2)(cid:18)(cid:1)(cid:18)(cid:19)(cid:18)(cid:18)(cid:2)(cid:1)(cid:2)(cid:3,Unknown,1720.0
Unknown,Unknown,1,Unknown,Unknown,Unknown,Unknown,cid:15)(cid:2)(cid:17)(cid:2)(cid:18)(cid:1)(cid:18)(cid:19)(cid:18)(cid:18)(cid:2)(cid:1)(cid:2)(cid:3,Unknown,1721.0
Unknown,Unknown,2,Unknown,Unknown,Unknown,Unknown,cid:15)(cid:2)(cid:17)(cid:2)(cid:18)(cid:1)(cid:18)(cid:19)(cid:18)(cid:18)(cid:2)(cid:1)(cid:2)(cid:3,Unknown,1723.0
Unknown,Unknown,3,Unknown,Unknown,Unknown,Unknown,cid:15)(cid:2)(cid:17)(cid:2)(cid:18)(cid:1)(cid:18)(cid:19)(cid:18)(cid:18)(cid:2)(cid:1)(cid:2)(cid:3,Unknown,1726.0
Unknown,Unknown,12,Unknown,Unknown,Unknown,Unknown,cid:15)(cid:2)(cid:17)(cid:2)(cid:18)(cid:1)(cid:18)(cid:19)(cid:18)(cid:18)(cid:2)(cid:1)(cid:2)(cid:3,Unknown,1738.0
Unknown,Unknown,29,Unknown,Unknown,Unknown,Unknown,cid:15)(cid:2)(cid:17)(cid:2)(cid:18)(cid:1)(cid:18)(cid:19)(cid:18)(cid:18)(cid:2)(cid:1)(cid:2)(cid:3,Unknown,1767.0
Unknown,Unknown,26,Unknown,Unknown,Unknown,Unknown,cid:15)(cid:2)(cid:17)(cid:2)(cid:18)(cid:1)(cid:18)(cid:19)(cid:18)(cid:18)(cid:2)(cid:1)(cid:2)(cid:3,Unknown,1793.0
Unknown,Unknown,41,Unknown,Unknown,Unknown,Unknown,cid:15)(cid:2)(cid:17)(cid:2)(cid:18)(cid:1)(cid:18)(cid:19)(cid:18)(cid:18)(cid:2)(cid:1)(cid:2)(cid:3,Unknown,1834.0
Unknown,Unknown,25,Unknown,Unknown,Unknown,Unknown,cid:15)(cid:2)(cid:17)(cid:2)(cid:18)(cid:1)(cid:18)(cid:19)(cid:18)(cid:18)(cid:2)(cid:1)(cid:2)(cid:3,Unknown,1859.0
Unknown,Unknown,2,Unknown,Unknown,Unknown,Unknown,cid:15)(cid:2)(cid:17)(cid:2)(cid:18)(cid:1)(cid:18)(cid:19)(cid:18)(cid:18)(cid:2)(cid:1)(cid:2)(cid:3,Unknown,1861.0
Unknown,Unknown,50,Unknown,Unknown,Unknown,Unknown,cid:15)(cid:2)(cid:17)(cid:2)(cid:18)(cid:1)(cid:18)(cid:19)(cid:18)(cid:18)(cid:2)(cid:1)(cid:2)(cid:3,Unknown,1911.0
Unknown,Unknown,50,Unknown,Unknown,Unknown,Unknown,cid:15)(cid:2)(cid:17)(cid:2)(cid:18)(cid:1)(cid:18)(cid:19)(cid:18)(cid:18)(cid:2)(cid:1)(cid:2)(cid:3,Unknown,1961.0
Unknown,Unknown,18,Unknown,Unknown,Unknown,Unknown,cid:15)(cid:2)(cid:17)(cid:2)(cid:18)(cid:1)(cid:18)(cid:19)(cid:18)(cid:18)(cid:2)(cid:1)(cid:2)(cid:3,Unknown,1979.0
Unknown,Unknown,1,Unknown,Unknown,Unknown,Unknown,cid:15)(cid:2)(cid:17)(cid:2)(cid:18)(cid:1)(cid:18)(cid:19)(cid:18)(cid:18)(cid:2)(cid:1)(cid:2)(cid:3,Unknown,1980.0
Unknown,Unknown,1,Unknown,Unknown,Unknown,Unknown,cid:15)(cid:2)(cid:17)(cid:2)(cid:18)(cid:1)(cid:18)(cid:19)(cid:18)(cid:18)(cid:2)(cid:1)(cid:2)(cid:3,Unknown,1981.0
Unknown,Unknown,37,Unknown,Unknown,Unknown,Unknown,cid:15)(cid:2)(cid:17)(cid:2)(cid:18)(cid:1)(cid:18)(cid:19)(cid:18)(cid:18)(cid:2)(cid:1)(cid:2)(cid:3,Unknown,2018.0
Unknown,Unknown,1,Unknown,Unknown,Unknown,Unknown,cid:15)(cid:2)(cid:17)(cid:2)(cid:18)(cid:1)(cid:18)(cid:19)(cid:18)(cid:18)(cid:2)(cid:1)(cid:2)(cid:3,Unknown,2019.0
Unknown,Unknown,35,Unknown,Unknown,Unknown,Unknown,cid:15)(cid:2)(cid:17)(cid:2)(cid:18)(cid:1)(cid:18)(cid:19)(cid:18)(cid:18)(cid:2)(cid:1)(cid:2)(cid:3,Unknown,2054.0
Unknown,Unknown,45,Unknown,Unknown,Unknown,Unknown,cid:15)(cid:2)(cid:17)(cid:2)(cid:18)(cid:1)(cid:18)(cid:19)(cid:18)(cid:18)(cid:2)(cid:1)(cid:2)(cid:3,Unknown,2099.0
Unknown,Unknown,18,Unknown,Unknown,Unknown,Unknown,cid:15)(cid:2)(cid:17)(cid:2)(cid:18)(cid:1)(cid:18)(cid:19)(cid:18)(cid:18)(cid:2)(cid:1)(cid:2)(cid:3,Unknown,2117.0
Unknown,Unknown,35,Unknown,Unknown,Unknown,Unknown,cid:15)(cid:2)(cid:17)(cid:2)(cid:18)(cid:1)(cid:18)(cid:19)(cid:18)(cid:18)(cid:2)(cid:1)(cid:2)(cid:3,Unknown,2152.0
Unknown,Unknown,46,Unknown,Unknown,Unknown,Unknown,cid:15)(cid:2)(cid:17)(cid:2)(cid:18)(cid:1)(cid:18)(cid:19)(cid:18)(cid:18)(cid:2)(cid:1)(cid:2)(cid:3,Unknown,2198.0
Unknown,Unknown,37,Unknown,Unknown,Unknown,Unknown,cid:15)(cid:2)(cid:17)(cid:2)(cid:18)(cid:1)(cid:18)(cid:19)(cid:18)(cid:18)(cid:2)(cid:1)(cid:2)(cid:3,Unknown,2235.0
Unknown,Unknown,2,Unknown,Unknown,Unknown,Unknown,cid:15)(cid:2)(cid:17)(cid:2)(cid:18)(cid:1)(cid:18)(cid:19)(cid:18)(cid:18)(cid:2)(cid:1)(cid:2)(cid:3,Unknown,2237.0
Unknown,Unknown,7,Unknown,Unknown,Unknown,Unknown,cid:15)(cid:2)(cid:17)(cid:2)(cid:18)(cid:1)(cid:18)(cid:19)(cid:18)(cid:18)(cid:2)(cid:1)(cid:2)(cid:3,Unknown,2244.0
Unknown,Unknown,52,Unknown,Unknown,Unknown,Unknown,cid:15)(cid:2)(cid:17)(cid:2)(cid:18)(cid:1)(cid:18)(cid:19)(cid:18)(cid:18)(cid:2)(cid:1)(cid:2)(cid:3,Unknown,2296.0
Unknown,Unknown,46,Unknown,Unknown,Unknown,Unknown,cid:15)(cid:2)(cid:17)(cid:2)(cid:18)(cid:1)(cid:18)(cid:19)(cid:18)(cid:18)(cid:2)(cid:1)(cid:2)(cid:3,Unknown,2342.0
Unknown,Unknown,8,Unknown,Unknown,Unknown,Unknown,cid:15)(cid:2)(cid:17)(cid:2)(cid:18)(cid:1)(cid:18)(cid:19)(cid:18)(cid:18)(cid:2)(cid:1)(cid:2)(cid:3,Unknown,2350.0
Unknown,Unknown,65,Unknown,Unknown,Unknown,Unknown,cid:15)(cid:2)(cid:17)(cid:2)(cid:18)(cid:1)(cid:18)(cid:19)(cid:18)(cid:18)(cid:2)(cid:1)(cid:2)(cid:3,Unknown,2415.0
Unknown,Unknown,46,Unknown,Unknown,Unknown,Unknown,cid:15)(cid:2)(cid:17)(cid:2)(cid:18)(cid:1)(cid:18)(cid:19)(cid:18)(cid:18)(cid:2)(cid:1)(cid:2)(cid:3,Unknown,2461.0
Unknown,Unknown,2,Unknown,Unknown,Unknown,Unknown,cid:15)(cid:2)(cid:17)(cid:2)(cid:18)(cid:1)(cid:18)(cid:19)(cid:18)(cid:18)(cid:2)(cid:1)(cid:2)(cid:3,Unknown,2463.0
Unknown,Unknown,3,Unknown,Unknown,Unknown,Unknown,cid:15)(cid:2)(cid:17)(cid:2)(cid:18)(cid:1)(cid:18)(cid:19)(cid:18)(cid:18)(cid:2)(cid:1)(cid:2)(cid:3,Unknown,2466.0
Unknown,Unknown,5,Unknown,Unknown,Unknown,Unknown,cid:15)(cid:2)(cid:17)(cid:2)(cid:18)(cid:1)(cid:18)(cid:19)(cid:18)(cid:18)(cid:2)(cid:1)(cid:2)(cid:3,Unknown,2471.0
Unknown,Unknown,67,Unknown,Unknown,Unknown,Unknown,cid:15)(cid:2)(cid:17)(cid:2)(cid:18)(cid:1)(cid:18)(cid:19)(cid:18)(cid:18)(cid:2)(cid:1)(cid:2)(cid:3,Unknown,2538.0
Unknown,Unknown,46,Unknown,Unknown,Unknown,Unknown,cid:15)(cid:2)(cid:17)(cid:2)(cid:18)(cid:1)(cid:18)(cid:19)(cid:18)(cid:18)(cid:2)(cid:1)(cid:2)(cid:3,Unknown,2584.0
Unknown,Unknown,2,Unknown,Unknown,Unknown,Unknown,cid:15)(cid:2)(cid:17)(cid:2)(cid:18)(cid:1)(cid:18)(cid:19)(cid:18)(cid:18)(cid:2)(cid:1)(cid:2)(cid:3,Unknown,2586.0
Unknown,Unknown,67,Unknown,Unknown,Unknown,Unknown,cid:15)(cid:2)(cid:17)(cid:2)(cid:18)(cid:1)(cid:18)(cid:19)(cid:18)(cid:18)(cid:2)(cid:1)(cid:2)(cid:3,Unknown,2653.0
Unknown,Unknown,4,Unknown,Unknown,Unknown,Unknown,cid:15)(cid:2)(cid:17)(cid:2)(cid:18)(cid:1)(cid:18)(cid:19)(cid:18)(cid:18)(cid:2)(cid:1)(cid:2)(cid:3,Unknown,2657.0
Unknown,Unknown,10,Unknown,Unknown,Unknown,Unknown,cid:15)(cid:2)(cid:17)(cid:2)(cid:18)(cid:1)(cid:18)(cid:19)(cid:18)(cid:18)(cid:2)(cid:1)(cid:2)(cid:3,Unknown,2667.0
Unknown,Unknown,7,Unknown,Unknown,Unknown,Unknown,cid:15)(cid:2)(cid:17)(cid:2)(cid:18)(cid:1)(cid:18)(cid:19)(cid:18)(cid:18)(cid:2)(cid:1)(cid:2)(cid:3,Unknown,2674.0
Unknown,Unknown,8,Unknown,Unknown,Unknown,Unknown,cid:15)(cid:2)(cid:17)(cid:2)(cid:18)(cid:1)(cid:18)(cid:19)(cid:18)(cid:18)(cid:2)(cid:1)(cid:2)(cid:3,Unknown,2682.0
Unknown,Unknown,46,Unknown,Unknown,Unknown,Unknown,cid:15)(cid:2)(cid:17)(cid:2)(cid:18)(cid:1)(cid:18)(cid:19)(cid:18)(cid:18)(cid:2)(cid:1)(cid:2)(cid:3,Unknown,2728.0
Unknown,Unknown,2,Unknown,Unknown,Unknown,Unknown,cid:15)(cid:2)(cid:17)(cid:2)(cid:18)(cid:1)(cid:18)(cid:19)(cid:18)(cid:18)(cid:2)(cid:1)(cid:2)(cid:3,Unknown,2730.0
Unknown,Unknown,49,Unknown,Unknown,Unknown,Unknown,cid:15)(cid:2)(cid:17)(cid:2)(cid:18)(cid:1)(cid:18)(cid:19)(cid:18)(cid:18)(cid:2)(cid:1)(cid:2)(cid:3,Unknown,2779.0
Unknown,Unknown,21,Unknown,Unknown,Unknown,Unknown,cid:15)(cid:2)(cid:17)(cid:2)(cid:18)(cid:1)(cid:18)(cid:19)(cid:18)(cid:18)(cid:2)(cid:1)(cid:2)(cid:3,Unknown,2800.0
Unknown,Unknown,71,Unknown,Unknown,Unknown,Unknown,cid:15)(cid:2)(cid:17)(cid:2)(cid:18)(cid:1)(cid:18)(cid:19)(cid:18)(cid:18)(cid:2)(cid:1)(cid:2)(cid:3,Unknown,2871.0
Unknown,Unknown,20,Unknown,Unknown,Unknown,Unknown,cid:15)(cid:2)(cid:17)(cid:2)(cid:18)(cid:1)(cid:18)(cid:19)(cid:18)(cid:18)(cid:2)(cid:1)(cid:2)(cid:3,Unknown,2891.0
Unknown,Unknown,2,Unknown,Unknown,Unknown,Unknown,cid:15)(cid:2)(cid:17)(cid:2)(cid:18)(cid:1)(cid:18)(cid:19)(cid:18)(cid:18)(cid:2)(cid:1)(cid:2)(cid:3,Unknown,2893.0
Unknown,Unknown,9,Unknown,Unknown,Unknown,Unknown,cid:15)(cid:2)(cid:17)(cid:2)(cid:18)(cid:1)(cid:18)(cid:19)(cid:18)(cid:18)(cid:2)(cid:1)(cid:2)(cid:3,Unknown,2902.0
Unknown,Unknown,25,Unknown,Unknown,Unknown,Unknown,cid:15)(cid:2)(cid:17)(cid:2)(cid:18)(cid:1)(cid:18)(cid:19)(cid:18)(cid:18)(cid:2)(cid:1)(cid:2)(cid:3,Unknown,2927.0
Unknown,Unknown,22,Unknown,Unknown,Unknown,Unknown,cid:15)(cid:2)(cid:17)(cid:2)(cid:18)(cid:1)(cid:18)(cid:19)(cid:18)(cid:18)(cid:2)(cid:1)(cid:2)(cid:3,Unknown,2949.0
Unknown,Unknown,20,Unknown,Unknown,Unknown,Unknown,cid:15)(cid:2)(cid:17)(cid:2)(cid:18)(cid:1)(cid:18)(cid:19)(cid:18)(cid:18)(cid:2)(cid:1)(cid:2)(cid:3,Unknown,2969.0
Unknown,Unknown,2,Unknown,Unknown,Unknown,Unknown,cid:15)(cid:2)(cid:17)(cid:2)(cid:18)(cid:1)(cid:18)(cid:19)(cid:18)(cid:18)(cid:2)(cid:1)(cid:2)(cid:3,Unknown,2971.0
Unknown,Unknown,13,Unknown,Unknown,Unknown,Unknown,cid:15)(cid:2)(cid:17)(cid:2)(cid:18)(cid:1)(cid:18)(cid:19)(cid:18)(cid:18)(cid:2)(cid:1)(cid:2)(cid:3,Unknown,2984.0
Unknown,Unknown,3,Unknown,Unknown,Unknown,Unknown,cid:15)(cid:2)(cid:17)(cid:2)(cid:18)(cid:1)(cid:18)(cid:19)(cid:18)(cid:18)(cid:2)(cid:1)(cid:2)(cid:3,Unknown,2987.0
Unknown,Unknown,15,Unknown,Unknown,Unknown,Unknown,cid:15)(cid:2)(cid:17)(cid:2)(cid:18)(cid:1)(cid:18)(cid:19)(cid:18)(cid:18)(cid:2)(cid:1)(cid:2)(cid:3,Unknown,3002.0
Unknown,Unknown,2,Unknown,Unknown,Unknown,Unknown,cid:15)(cid:2)(cid:17)(cid:2)(cid:18)(cid:1)(cid:18)(cid:19)(cid:18)(cid:18)(cid:2)(cid:1)(cid:2)(cid:3,Unknown,3004.0
Unknown,Unknown,17,Unknown,Unknown,Unknown,Unknown,cid:15)(cid:2)(cid:17)(cid:2)(cid:18)(cid:1)(cid:18)(cid:19)(cid:18)(cid:18)(cid:2)(cid:1)(cid:2)(cid:3,Unknown,3021.0
Unknown,Unknown,16,Unknown,Unknown,Unknown,Unknown,cid:15)(cid:2)(cid:17)(cid:2)(cid:18)(cid:1)(cid:18)(cid:19)(cid:18)(cid:18)(cid:2)(cid:1)(cid:2)(cid:3,Unknown,3037.0
Unknown,Unknown,19,Unknown,Unknown,Unknown,Unknown,cid:15)(cid:2)(cid:17)(cid:2)(cid:18)(cid:1)(cid:18)(cid:19)(cid:18)(cid:18)(cid:2)(cid:1)(cid:2)(cid:3,Unknown,3056.0
Unknown,Unknown,17,Unknown,Unknown,Unknown,Unknown,cid:15)(cid:2)(cid:17)(cid:2)(cid:18)(cid:1)(cid:18)(cid:19)(cid:18)(cid:18)(cid:2)(cid:1)(cid:2)(cid:3,Unknown,3073.0
Unknown,Unknown,34,Unknown,Unknown,Unknown,Unknown,cid:15)(cid:2)(cid:17)(cid:2)(cid:18)(cid:1)(cid:18)(cid:19)(cid:18)(cid:18)(cid:2)(cid:1)(cid:2)(cid:3,Unknown,3107.0
Unknown,Unknown,2,Unknown,Unknown,Unknown,Unknown,cid:15)(cid:2)(cid:17)(cid:2)(cid:18)(cid:1)(cid:18)(cid:19)(cid:18)(cid:18)(cid:2)(cid:1)(cid:2)(cid:3,Unknown,3109.0
Unknown,Unknown,44,Unknown,Unknown,Unknown,Unknown,cid:15)(cid:2)(cid:17)(cid:2)(cid:18)(cid:1)(cid:18)(cid:19)(cid:18)(cid:18)(cid:2)(cid:1)(cid:2)(cid:3,Unknown,3153.0
Unknown,Unknown,16,Unknown,Unknown,Unknown,Unknown,cid:15)(cid:2)(cid:17)(cid:2)(cid:18)(cid:1)(cid:18)(cid:19)(cid:18)(cid:18)(cid:2)(cid:1)(cid:2)(cid:3,Unknown,3169.0
Unknown,Unknown,19,Unknown,Unknown,Unknown,Unknown,cid:15)(cid:2)(cid:17)(cid:2)(cid:18)(cid:1)(cid:18)(cid:19)(cid:18)(cid:18)(cid:2)(cid:1)(cid:2)(cid:3,Unknown,3188.0
Unknown,Unknown,36,Unknown,Unknown,Unknown,Unknown,cid:15)(cid:2)(cid:17)(cid:2)(cid:18)(cid:1)(cid:18)(cid:19)(cid:18)(cid:18)(cid:2)(cid:1)(cid:2)(cid:3,Unknown,3224.0
Unknown,Unknown,32,Unknown,Unknown,Unknown,Unknown,cid:15)(cid:2)(cid:17)(cid:2)(cid:18)(cid:1)(cid:18)(cid:19)(cid:18)(cid:18)(cid:2)(cid:1)(cid:2)(cid:3,Unknown,3256.0
Unknown,Unknown,37,Unknown,Unknown,Unknown,Unknown,cid:15)(cid:2)(cid:17)(cid:2)(cid:18)(cid:1)(cid:18)(cid:19)(cid:18)(cid:18)(cid:2)(cid:1)(cid:2)(cid:3,Unknown,3293.0
Unknown,Unknown,34,Unknown,Unknown,Unknown,Unknown,cid:15)(cid:2)(cid:17)(cid:2)(cid:18)(cid:1)(cid:18)(cid:19)(cid:18)(cid:18)(cid:2)(cid:1)(cid:2)(cid:3,Unknown,3327.0
Unknown,Unknown,34,Unknown,Unknown,Unknown,Unknown,cid:15)(cid:2)(cid:17)(cid:2)(cid:18)(cid:1)(cid:18)(cid:19)(cid:18)(cid:18)(cid:2)(cid:1)(cid:2)(cid:3,Unknown,3361.0
Unknown,Unknown,32,Unknown,Unknown,Unknown,Unknown,cid:15)(cid:2)(cid:17)(cid:2)(cid:18)(cid:1)(cid:18)(cid:19)(cid:18)(cid:18)(cid:2)(cid:1)(cid:2)(cid:3,Unknown,3393.0
Unknown,Unknown,35,Unknown,Unknown,Unknown,Unknown,cid:15)(cid:2)(cid:17)(cid:2)(cid:18)(cid:1)(cid:18)(cid:19)(cid:18)(cid:18)(cid:2)(cid:1)(cid:2)(cid:3,Unknown,3428.0
Unknown,Unknown,34,Unknown,Unknown,Unknown,Unknown,cid:15)(cid:2)(cid:17)(cid:2)(cid:18)(cid:1)(cid:18)(cid:19)(cid:18)(cid:18)(cid:2)(cid:1)(cid:2)(cid:3,Unknown,3462.0
Unknown,Unknown,17,Unknown,Unknown,Unknown,Unknown,cid:15)(cid:2)(cid:17)(cid:2)(cid:18)(cid:1)(cid:18)(cid:19)(cid:18)(cid:18)(cid:2)(cid:1)(cid:2)(cid:3,Unknown,3479.0
Unknown,Unknown,37,Unknown,Unknown,Unknown,Unknown,cid:15)(cid:2)(cid:17)(cid:2)(cid:18)(cid:1)(cid:18)(cid:19)(cid:18)(cid:18)(cid:2)(cid:1)(cid:2)(cid:3,Unknown,3516.0
Unknown,Unknown,17,Unknown,Unknown,Unknown,Unknown,cid:15)(cid:2)(cid:17)(cid:2)(cid:18)(cid:1)(cid:18)(cid:19)(cid:18)(cid:18)(cid:2)(cid:1)(cid:2)(cid:3,Unknown,3533.0
Unknown,Unknown,17,Unknown,Unknown,Unknown,Unknown,cid:15)(cid:2)(cid:17)(cid:2)(cid:18)(cid:1)(cid:18)(cid:19)(cid:18)(cid:18)(cid:2)(cid:1)(cid:2)(cid:3,Unknown,3550.0
Unknown,Unknown,33,Unknown,Unknown,Unknown,Unknown,cid:15)(cid:2)(cid:17)(cid:2)(cid:18)(cid:1)(cid:18)(cid:19)(cid:18)(cid:18)(cid:2)(cid:1)(cid:2)(cid:3,Unknown,3583.0
Unknown,Unknown,34,Unknown,Unknown,Unknown,Unknown,cid:15)(cid:2)(cid:17)(cid:2)(cid:18)(cid:1)(cid:18)(cid:19)(cid:18)(cid:18)(cid:2)(cid:1)(cid:2)(cid:3,Unknown,3617.0
Unknown,Unknown,2,Unknown,Unknown,Unknown,Unknown,cid:15)(cid:2)(cid:17)(cid:2)(cid:18)(cid:1)(cid:18)(cid:19)(cid:18)(cid:18)(cid:2)(cid:1)(cid:2)(cid:3,Unknown,3619.0
Unknown,Unknown,74,Unknown,Unknown,Unknown,Unknown,cid:15)(cid:2)(cid:17)(cid:2)(cid:18)(cid:1)(cid:18)(cid:19)(cid:18)(cid:18)(cid:2)(cid:1)(cid:2)(cid:3,Unknown,3693.0
Unknown,Unknown,30,Unknown,Unknown,Unknown,Unknown,cid:15)(cid:2)(cid:17)(cid:2)(cid:18)(cid:1)(cid:18)(cid:19)(cid:18)(cid:18)(cid:2)(cid:1)(cid:2)(cid:3,Unknown,3723.0
Unknown,Unknown,2,Unknown,Unknown,Unknown,Unknown,cid:15)(cid:2)(cid:17)(cid:2)(cid:18)(cid:1)(cid:18)(cid:19)(cid:18)(cid:18)(cid:2)(cid:1)(cid:2)(cid:3,Unknown,3725.0
Unknown,Unknown,73,Unknown,Unknown,Unknown,Unknown,cid:15)(cid:2)(cid:17)(cid:2)(cid:18)(cid:1)(cid:18)(cid:19)(cid:18)(cid:18)(cid:2)(cid:1)(cid:2)(cid:3,Unknown,3798.0
Unknown,Unknown,2,Unknown,Unknown,Unknown,Unknown,cid:15)(cid:2)(cid:17)(cid:2)(cid:18)(cid:1)(cid:18)(cid:19)(cid:18)(cid:18)(cid:2)(cid:1)(cid:2)(cid:3,Unknown,3800.0
Unknown,Unknown,17,Unknown,Unknown,Unknown,Unknown,cid:15)(cid:2)(cid:17)(cid:2)(cid:18)(cid:1)(cid:18)(cid:19)(cid:18)(cid:18)(cid:2)(cid:1)(cid:2)(cid:3,Unknown,3817.0
Unknown,Unknown,19,Unknown,Unknown,Unknown,Unknown,cid:15)(cid:2)(cid:17)(cid:2)(cid:18)(cid:1)(cid:18)(cid:19)(cid:18)(cid:18)(cid:2)(cid:1)(cid:2)(cid:3,Unknown,3836.0
Unknown,Unknown,18,Unknown,Unknown,Unknown,Unknown,cid:15)(cid:2)(cid:17)(cid:2)(cid:18)(cid:1)(cid:18)(cid:19)(cid:18)(cid:18)(cid:2)(cid:1)(cid:2)(cid:3,Unknown,3854.0
Unknown,Unknown,18,Unknown,Unknown,Unknown,Unknown,cid:15)(cid:2)(cid:17)(cid:2)(cid:18)(cid:1)(cid:18)(cid:19)(cid:18)(cid:18)(cid:2)(cid:1)(cid:2)(cid:3,Unknown,3872.0
Unknown,Unknown,2,Unknown,Unknown,Unknown,Unknown,cid:15)(cid:2)(cid:17)(cid:2)(cid:18)(cid:1)(cid:18)(cid:19)(cid:18)(cid:18)(cid:2)(cid:1)(cid:2)(cid:3,Unknown,3874.0
Unknown,Unknown,44,Unknown,Unknown,Unknown,Unknown,cid:15)(cid:2)(cid:17)(cid:2)(cid:18)(cid:1)(cid:18)(cid:19)(cid:18)(cid:18)(cid:2)(cid:1)(cid:2)(cid:3,Unknown,3918.0
Unknown,Unknown,15,Unknown,Unknown,Unknown,Unknown,cid:15)(cid:2)(cid:17)(cid:2)(cid:18)(cid:1)(cid:18)(cid:19)(cid:18)(cid:18)(cid:2)(cid:1)(cid:2)(cid:3,Unknown,3933.0
Unknown,Unknown,2,Unknown,Unknown,Unknown,Unknown,cid:15)(cid:2)(cid:17)(cid:2)(cid:18)(cid:1)(cid:18)(cid:19)(cid:18)(cid:18)(cid:2)(cid:1)(cid:2)(cid:3,Unknown,3935.0
Unknown,Unknown,17,Unknown,Unknown,Unknown,Unknown,cid:15)(cid:2)(cid:17)(cid:2)(cid:18)(cid:1)(cid:18)(cid:19)(cid:18)(cid:18)(cid:2)(cid:1)(cid:2)(cid:3,Unknown,3952.0
Unknown,Unknown,1,Unknown,Unknown,Unknown,Unknown,cid:15)(cid:2)(cid:17)(cid:2)(cid:18)(cid:1)(cid:18)(cid:19)(cid:18)(cid:18)(cid:2)(cid:1)(cid:2)(cid:3,Unknown,3953.0
Unknown,Unknown,35,Unknown,Unknown,Unknown,Unknown,cid:15)(cid:2)(cid:17)(cid:2)(cid:18)(cid:1)(cid:18)(cid:19)(cid:18)(cid:18)(cid:2)(cid:1)(cid:2)(cid:3,Unknown,3988.0
Unknown,Unknown,19,Unknown,Unknown,Unknown,Unknown,cid:15)(cid:2)(cid:17)(cid:2)(cid:18)(cid:1)(cid:18)(cid:19)(cid:18)(cid:18)(cid:2)(cid:1)(cid:2)(cid:3,Unknown,4007.0
Unknown,Unknown,18,Unknown,Unknown,Unknown,Unknown,cid:15)(cid:2)(cid:17)(cid:2)(cid:18)(cid:1)(cid:18)(cid:19)(cid:18)(cid:18)(cid:2)(cid:1)(cid:2)(cid:3,Unknown,4025.0
Unknown,Unknown,18,Unknown,Unknown,Unknown,Unknown,cid:15)(cid:2)(cid:17)(cid:2)(cid:18)(cid:1)(cid:18)(cid:19)(cid:18)(cid:18)(cid:2)(cid:1)(cid:2)(cid:3,Unknown,4043.0
Unknown,Unknown,2,Unknown,Unknown,Unknown,Unknown,cid:15)(cid:2)(cid:17)(cid:2)(cid:18)(cid:1)(cid:18)(cid:19)(cid:18)(cid:18)(cid:2)(cid:1)(cid:2)(cid:3,Unknown,4045.0
Unknown,Unknown,74,Unknown,Unknown,Unknown,Unknown,cid:15)(cid:2)(cid:17)(cid:2)(cid:18)(cid:1)(cid:18)(cid:19)(cid:18)(cid:18)(cid:2)(cid:1)(cid:2)(cid:3,Unknown,4119.0
Unknown,Unknown,30,Unknown,Unknown,Unknown,Unknown,cid:15)(cid:2)(cid:17)(cid:2)(cid:18)(cid:1)(cid:18)(cid:19)(cid:18)(cid:18)(cid:2)(cid:1)(cid:2)(cid:3,Unknown,4149.0
Unknown,Unknown,12,Unknown,Unknown,Unknown,Unknown,cid:15)(cid:2)(cid:17)(cid:2)(cid:18)(cid:1)(cid:18)(cid:19)(cid:18)(cid:18)(cid:2)(cid:1)(cid:2)(cid:3,Unknown,4161.0
Unknown,Unknown,29,Unknown,Unknown,Unknown,Unknown,cid:15)(cid:2)(cid:17)(cid:2)(cid:18)(cid:1)(cid:18)(cid:19)(cid:18)(cid:18)(cid:2)(cid:1)(cid:2)(cid:3,Unknown,4190.0
Unknown,Unknown,26,Unknown,Unknown,Unknown,Unknown,cid:15)(cid:2)(cid:17)(cid:2)(cid:18)(cid:1)(cid:18)(cid:19)(cid:18)(cid:18)(cid:2)(cid:1)(cid:2)(cid:3,Unknown,4216.0
Unknown,Unknown,41,Unknown,Unknown,Unknown,Unknown,cid:15)(cid:2)(cid:17)(cid:2)(cid:18)(cid:1)(cid:18)(cid:19)(cid:18)(cid:18)(cid:2)(cid:1)(cid:2)(cid:3,Unknown,4257.0
Unknown,Unknown,25,Unknown,Unknown,Unknown,Unknown,cid:15)(cid:2)(cid:17)(cid:2)(cid:18)(cid:1)(cid:18)(cid:19)(cid:18)(cid:18)(cid:2)(cid:1)(cid:2)(cid:3,Unknown,4282.0
Unknown,Unknown,2,Unknown,Unknown,Unknown,Unknown,cid:15)(cid:2)(cid:17)(cid:2)(cid:18)(cid:1)(cid:18)(cid:19)(cid:18)(cid:18)(cid:2)(cid:1)(cid:2)(cid:3,Unknown,4284.0
Unknown,Unknown,50,Unknown,Unknown,Unknown,Unknown,cid:15)(cid:2)(cid:17)(cid:2)(cid:18)(cid:1)(cid:18)(cid:19)(cid:18)(cid:18)(cid:2)(cid:1)(cid:2)(cid:3,Unknown,4334.0
Unknown,Unknown,50,Unknown,Unknown,Unknown,Unknown,cid:15)(cid:2)(cid:17)(cid:2)(cid:18)(cid:1)(cid:18)(cid:19)(cid:18)(cid:18)(cid:2)(cid:1)(cid:2)(cid:3,Unknown,4384.0
Unknown,Unknown,18,Unknown,Unknown,Unknown,Unknown,cid:15)(cid:2)(cid:17)(cid:2)(cid:18)(cid:1)(cid:18)(cid:19)(cid:18)(cid:18)(cid:2)(cid:1)(cid:2)(cid:3,Unknown,4402.0
Unknown,Unknown,1,Unknown,Unknown,Unknown,Unknown,cid:15)(cid:2)(cid:17)(cid:2)(cid:18)(cid:1)(cid:18)(cid:19)(cid:18)(cid:18)(cid:2)(cid:1)(cid:2)(cid:3,Unknown,4403.0
Unknown,Unknown,1,Unknown,Unknown,Unknown,Unknown,cid:15)(cid:2)(cid:17)(cid:2)(cid:18)(cid:1)(cid:18)(cid:19)(cid:18)(cid:18)(cid:2)(cid:1)(cid:2)(cid:3,Unknown,4404.0
Unknown,Unknown,37,Unknown,Unknown,Unknown,Unknown,cid:15)(cid:2)(cid:17)(cid:2)(cid:18)(cid:1)(cid:18)(cid:19)(cid:18)(cid:18)(cid:2)(cid:1)(cid:2)(cid:3,Unknown,4441.0
Unknown,Unknown,1,Unknown,Unknown,Unknown,Unknown,cid:15)(cid:2)(cid:17)(cid:2)(cid:18)(cid:1)(cid:18)(cid:19)(cid:18)(cid:18)(cid:2)(cid:1)(cid:2)(cid:3,Unknown,4442.0
Unknown,Unknown,35,Unknown,Unknown,Unknown,Unknown,cid:15)(cid:2)(cid:17)(cid:2)(cid:18)(cid:1)(cid:18)(cid:19)(cid:18)(cid:18)(cid:2)(cid:1)(cid:2)(cid:3,Unknown,4477.0
Unknown,Unknown,45,Unknown,Unknown,Unknown,Unknown,cid:15)(cid:2)(cid:17)(cid:2)(cid:18)(cid:1)(cid:18)(cid:19)(cid:18)(cid:18)(cid:2)(cid:1)(cid:2)(cid:3,Unknown,4522.0
Unknown,Unknown,18,Unknown,Unknown,Unknown,Unknown,cid:15)(cid:2)(cid:17)(cid:2)(cid:18)(cid:1)(cid:18)(cid:19)(cid:18)(cid:18)(cid:2)(cid:1)(cid:2)(cid:3,Unknown,4540.0
Unknown,Unknown,35,Unknown,Unknown,Unknown,Unknown,cid:15)(cid:2)(cid:17)(cid:2)(cid:18)(cid:1)(cid:18)(cid:19)(cid:18)(cid:18)(cid:2)(cid:1)(cid:2)(cid:3,Unknown,4575.0
Unknown,Unknown,46,Unknown,Unknown,Unknown,Unknown,cid:15)(cid:2)(cid:17)(cid:2)(cid:18)(cid:1)(cid:18)(cid:19)(cid:18)(cid:18)(cid:2)(cid:1)(cid:2)(cid:3,Unknown,4621.0
Unknown,Unknown,4,Unknown,Unknown,Unknown,Unknown,cid:15)(cid:2)(cid:17)(cid:2)(cid:18)(cid:1)(cid:18)(cid:19)(cid:18)(cid:18)(cid:2)(cid:1)(cid:2)(cid:3,Unknown,4625.0
Unknown,Unknown,10,Unknown,Unknown,Unknown,Unknown,cid:15)(cid:2)(cid:17)(cid:2)(cid:18)(cid:1)(cid:18)(cid:19)(cid:18)(cid:18)(cid:2)(cid:1)(cid:2)(cid:3,Unknown,4635.0
Unknown,Unknown,11,Unknown,Unknown,Unknown,Unknown,cid:15)(cid:2)(cid:17)(cid:2)(cid:18)(cid:1)(cid:18)(cid:19)(cid:18)(cid:18)(cid:2)(cid:1)(cid:2)(cid:3,Unknown,4646.0
Unknown,Unknown,12,Unknown,Unknown,Unknown,Unknown,cid:15)(cid:2)(cid:17)(cid:2)(cid:18)(cid:1)(cid:18)(cid:19)(cid:18)(cid:18)(cid:2)(cid:1)(cid:2)(cid:3,Unknown,4658.0
Unknown,Unknown,5,Unknown,Unknown,Unknown,Unknown,cid:15)(cid:2)(cid:17)(cid:2)(cid:18)(cid:1)(cid:18)(cid:19)(cid:18)(cid:18)(cid:2)(cid:1)(cid:2)(cid:3,Unknown,4663.0
Unknown,Unknown,9,Unknown,Unknown,Unknown,Unknown,cid:15)(cid:2)(cid:17)(cid:2)(cid:18)(cid:1)(cid:18)(cid:19)(cid:18)(cid:18)(cid:2)(cid:1)(cid:2)(cid:3,Unknown,4672.0
Unknown,Unknown,10,Unknown,Unknown,Unknown,Unknown,cid:15)(cid:2)(cid:17)(cid:2)(cid:18)(cid:1)(cid:18)(cid:19)(cid:18)(cid:18)(cid:2)(cid:1)(cid:2)(cid:3,Unknown,4682.0
Unknown,Unknown,46,Unknown,Unknown,Unknown,Unknown,cid:15)(cid:2)(cid:17)(cid:2)(cid:18)(cid:1)(cid:18)(cid:19)(cid:18)(cid:18)(cid:2)(cid:1)(cid:2)(cid:3,Unknown,4728.0
Unknown,Unknown,2,Unknown,Unknown,Unknown,Unknown,cid:15)(cid:2)(cid:17)(cid:2)(cid:18)(cid:1)(cid:18)(cid:19)(cid:18)(cid:18)(cid:2)(cid:1)(cid:2)(cid:3,Unknown,4730.0
Unknown,Unknown,46,Unknown,Unknown,Unknown,Unknown,cid:15)(cid:2)(cid:17)(cid:2)(cid:18)(cid:1)(cid:18)(cid:19)(cid:18)(cid:18)(cid:2)(cid:1)(cid:2)(cid:3,Unknown,4776.0
Unknown,Unknown,37,Unknown,Unknown,Unknown,Unknown,cid:15)(cid:2)(cid:17)(cid:2)(cid:18)(cid:1)(cid:18)(cid:19)(cid:18)(cid:18)(cid:2)(cid:1)(cid:2)(cid:3,Unknown,4813.0
Unknown,Unknown,2,Unknown,Unknown,Unknown,Unknown,cid:15)(cid:2)(cid:17)(cid:2)(cid:18)(cid:1)(cid:18)(cid:19)(cid:18)(cid:18)(cid:2)(cid:1)(cid:2)(cid:3,Unknown,4815.0
Unknown,Unknown,51,Unknown,Unknown,Unknown,Unknown,cid:15)(cid:2)(cid:17)(cid:2)(cid:18)(cid:1)(cid:18)(cid:19)(cid:18)(cid:18)(cid:2)(cid:1)(cid:2)(cid:3,Unknown,4866.0
Unknown,Unknown,3,Unknown,Unknown,Unknown,Unknown,cid:15)(cid:2)(cid:17)(cid:2)(cid:18)(cid:1)(cid:18)(cid:19)(cid:18)(cid:18)(cid:2)(cid:1)(cid:2)(cid:3,Unknown,4869.0
Unknown,Unknown,5,Unknown,Unknown,Unknown,Unknown,cid:15)(cid:2)(cid:17)(cid:2)(cid:18)(cid:1)(cid:18)(cid:19)(cid:18)(cid:18)(cid:2)(cid:1)(cid:2)(cid:3,Unknown,4874.0
Unknown,Unknown,53,Unknown,Unknown,Unknown,Unknown,cid:15)(cid:2)(cid:17)(cid:2)(cid:18)(cid:1)(cid:18)(cid:19)(cid:18)(cid:18)(cid:2)(cid:1)(cid:2)(cid:3,Unknown,4927.0
Unknown,Unknown,46,Unknown,Unknown,Unknown,Unknown,cid:15)(cid:2)(cid:17)(cid:2)(cid:18)(cid:1)(cid:18)(cid:19)(cid:18)(cid:18)(cid:2)(cid:1)(cid:2)(cid:3,Unknown,4973.0
Unknown,Unknown,8,Unknown,Unknown,Unknown,Unknown,cid:15)(cid:2)(cid:17)(cid:2)(cid:18)(cid:1)(cid:18)(cid:19)(cid:18)(cid:18)(cid:2)(cid:1)(cid:2)(cid:3,Unknown,4981.0
Unknown,Unknown,46,Unknown,Unknown,Unknown,Unknown,cid:15)(cid:2)(cid:17)(cid:2)(cid:18)(cid:1)(cid:18)(cid:19)(cid:18)(cid:18)(cid:2)(cid:1)(cid:2)(cid:3,Unknown,5027.0
Unknown,Unknown,2,Unknown,Unknown,Unknown,Unknown,cid:15)(cid:2)(cid:17)(cid:2)(cid:18)(cid:1)(cid:18)(cid:19)(cid:18)(cid:18)(cid:2)(cid:1)(cid:2)(cid:3,Unknown,5029.0
Unknown,Unknown,9,Unknown,Unknown,Unknown,Unknown,cid:15)(cid:2)(cid:17)(cid:2)(cid:18)(cid:1)(cid:18)(cid:19)(cid:18)(cid:18)(cid:2)(cid:1)(cid:2)(cid:3,Unknown,5038.0
Unknown,Unknown,29,Unknown,Unknown,Unknown,Unknown,cid:15)(cid:2)(cid:17)(cid:2)(cid:18)(cid:1)(cid:18)(cid:19)(cid:18)(cid:18)(cid:2)(cid:1)(cid:2)(cid:3,Unknown,5067.0
Unknown,Unknown,23,Unknown,Unknown,Unknown,Unknown,cid:15)(cid:2)(cid:17)(cid:2)(cid:18)(cid:1)(cid:18)(cid:19)(cid:18)(cid:18)(cid:2)(cid:1)(cid:2)(cid:3,Unknown,5090.0
Unknown,Unknown,20,Unknown,Unknown,Unknown,Unknown,cid:15)(cid:2)(cid:17)(cid:2)(cid:18)(cid:1)(cid:18)(cid:19)(cid:18)(cid:18)(cid:2)(cid:1)(cid:2)(cid:3,Unknown,5110.0
Unknown,Unknown,47,Unknown,Unknown,Unknown,Unknown,cid:15)(cid:2)(cid:17)(cid:2)(cid:18)(cid:1)(cid:18)(cid:19)(cid:18)(cid:18)(cid:2)(cid:1)(cid:2)(cid:3,Unknown,5157.0
Unknown,Unknown,20,Unknown,Unknown,Unknown,Unknown,cid:15)(cid:2)(cid:17)(cid:2)(cid:18)(cid:1)(cid:18)(cid:19)(cid:18)(cid:18)(cid:2)(cid:1)(cid:2)(cid:3,Unknown,5177.0
Unknown,Unknown,26,Unknown,Unknown,Unknown,Unknown,cid:15)(cid:2)(cid:17)(cid:2)(cid:18)(cid:1)(cid:18)(cid:19)(cid:18)(cid:18)(cid:2)(cid:1)(cid:2)(cid:3,Unknown,5203.0
Unknown,Unknown,2,Unknown,Unknown,Unknown,Unknown,cid:15)(cid:2)(cid:17)(cid:2)(cid:18)(cid:1)(cid:18)(cid:19)(cid:18)(cid:18)(cid:2)(cid:1)(cid:2)(cid:3,Unknown,5205.0
Unknown,Unknown,13,Unknown,Unknown,Unknown,Unknown,cid:15)(cid:2)(cid:17)(cid:2)(cid:18)(cid:1)(cid:18)(cid:19)(cid:18)(cid:18)(cid:2)(cid:1)(cid:2)(cid:3,Unknown,5218.0
Unknown,Unknown,3,Unknown,Unknown,Unknown,Unknown,cid:15)(cid:2)(cid:17)(cid:2)(cid:18)(cid:1)(cid:18)(cid:19)(cid:18)(cid:18)(cid:2)(cid:1)(cid:2)(cid:3,Unknown,5221.0
Unknown,Unknown,15,Unknown,Unknown,Unknown,Unknown,cid:15)(cid:2)(cid:17)(cid:2)(cid:18)(cid:1)(cid:18)(cid:19)(cid:18)(cid:18)(cid:2)(cid:1)(cid:2)(cid:3,Unknown,5236.0
Unknown,Unknown,2,Unknown,Unknown,Unknown,Unknown,cid:15)(cid:2)(cid:17)(cid:2)(cid:18)(cid:1)(cid:18)(cid:19)(cid:18)(cid:18)(cid:2)(cid:1)(cid:2)(cid:3,Unknown,5238.0
Unknown,Unknown,18,Unknown,Unknown,Unknown,Unknown,cid:15)(cid:2)(cid:17)(cid:2)(cid:18)(cid:1)(cid:18)(cid:19)(cid:18)(cid:18)(cid:2)(cid:1)(cid:2)(cid:3,Unknown,5256.0
Unknown,Unknown,19,Unknown,Unknown,Unknown,Unknown,cid:15)(cid:2)(cid:17)(cid:2)(cid:18)(cid:1)(cid:18)(cid:19)(cid:18)(cid:18)(cid:2)(cid:1)(cid:2)(cid:3,Unknown,5275.0
Unknown,Unknown,33,Unknown,Unknown,Unknown,Unknown,cid:15)(cid:2)(cid:17)(cid:2)(cid:18)(cid:1)(cid:18)(cid:19)(cid:18)(cid:18)(cid:2)(cid:1)(cid:2)(cid:3,Unknown,5308.0
Unknown,Unknown,36,Unknown,Unknown,Unknown,Unknown,cid:15)(cid:2)(cid:17)(cid:2)(cid:18)(cid:1)(cid:18)(cid:19)(cid:18)(cid:18)(cid:2)(cid:1)(cid:2)(cid:3,Unknown,5344.0
Unknown,Unknown,2,Unknown,Unknown,Unknown,Unknown,cid:15)(cid:2)(cid:17)(cid:2)(cid:18)(cid:1)(cid:18)(cid:19)(cid:18)(cid:18)(cid:2)(cid:1)(cid:2)(cid:3,Unknown,5346.0
Unknown,Unknown,44,Unknown,Unknown,Unknown,Unknown,cid:15)(cid:2)(cid:17)(cid:2)(cid:18)(cid:1)(cid:18)(cid:19)(cid:18)(cid:18)(cid:2)(cid:1)(cid:2)(cid:3,Unknown,5390.0
Unknown,Unknown,16,Unknown,Unknown,Unknown,Unknown,cid:15)(cid:2)(cid:17)(cid:2)(cid:18)(cid:1)(cid:18)(cid:19)(cid:18)(cid:18)(cid:2)(cid:1)(cid:2)(cid:3,Unknown,5406.0
Unknown,Unknown,19,Unknown,Unknown,Unknown,Unknown,cid:15)(cid:2)(cid:17)(cid:2)(cid:18)(cid:1)(cid:18)(cid:19)(cid:18)(cid:18)(cid:2)(cid:1)(cid:2)(cid:3,Unknown,5425.0
Unknown,Unknown,36,Unknown,Unknown,Unknown,Unknown,cid:15)(cid:2)(cid:17)(cid:2)(cid:18)(cid:1)(cid:18)(cid:19)(cid:18)(cid:18)(cid:2)(cid:1)(cid:2)(cid:3,Unknown,5461.0
Unknown,Unknown,36,Unknown,Unknown,Unknown,Unknown,cid:15)(cid:2)(cid:17)(cid:2)(cid:18)(cid:1)(cid:18)(cid:19)(cid:18)(cid:18)(cid:2)(cid:1)(cid:2)(cid:3,Unknown,5497.0
Unknown,Unknown,32,Unknown,Unknown,Unknown,Unknown,cid:15)(cid:2)(cid:17)(cid:2)(cid:18)(cid:1)(cid:18)(cid:19)(cid:18)(cid:18)(cid:2)(cid:1)(cid:2)(cid:3,Unknown,5529.0
Unknown,Unknown,35,Unknown,Unknown,Unknown,Unknown,cid:15)(cid:2)(cid:17)(cid:2)(cid:18)(cid:1)(cid:18)(cid:19)(cid:18)(cid:18)(cid:2)(cid:1)(cid:2)(cid:3,Unknown,5564.0
Unknown,Unknown,18,Unknown,Unknown,Unknown,Unknown,cid:15)(cid:2)(cid:17)(cid:2)(cid:18)(cid:1)(cid:18)(cid:19)(cid:18)(cid:18)(cid:2)(cid:1)(cid:2)(cid:3,Unknown,5582.0
Unknown,Unknown,35,Unknown,Unknown,Unknown,Unknown,cid:15)(cid:2)(cid:17)(cid:2)(cid:18)(cid:1)(cid:18)(cid:19)(cid:18)(cid:18)(cid:2)(cid:1)(cid:2)(cid:3,Unknown,5617.0
Unknown,Unknown,34,Unknown,Unknown,Unknown,Unknown,cid:15)(cid:2)(cid:17)(cid:2)(cid:18)(cid:1)(cid:18)(cid:19)(cid:18)(cid:18)(cid:2)(cid:1)(cid:2)(cid:3,Unknown,5651.0
Unknown,Unknown,17,Unknown,Unknown,Unknown,Unknown,cid:15)(cid:2)(cid:17)(cid:2)(cid:18)(cid:1)(cid:18)(cid:19)(cid:18)(cid:18)(cid:2)(cid:1)(cid:2)(cid:3,Unknown,5668.0
Unknown,Unknown,18,Unknown,Unknown,Unknown,Unknown,cid:15)(cid:2)(cid:17)(cid:2)(cid:18)(cid:1)(cid:18)(cid:19)(cid:18)(cid:18)(cid:2)(cid:1)(cid:2)(cid:3,Unknown,5686.0
Unknown,Unknown,32,Unknown,Unknown,Unknown,Unknown,cid:15)(cid:2)(cid:17)(cid:2)(cid:18)(cid:1)(cid:18)(cid:19)(cid:18)(cid:18)(cid:2)(cid:1)(cid:2)(cid:3,Unknown,5718.0
Unknown,Unknown,37,Unknown,Unknown,Unknown,Unknown,cid:15)(cid:2)(cid:17)(cid:2)(cid:18)(cid:1)(cid:18)(cid:19)(cid:18)(cid:18)(cid:2)(cid:1)(cid:2)(cid:3,Unknown,5755.0
Unknown,Unknown,35,Unknown,Unknown,Unknown,Unknown,cid:15)(cid:2)(cid:17)(cid:2)(cid:18)(cid:1)(cid:18)(cid:19)(cid:18)(cid:18)(cid:2)(cid:1)(cid:2)(cid:3,Unknown,5790.0
Unknown,Unknown,37,Unknown,Unknown,Unknown,Unknown,cid:15)(cid:2)(cid:17)(cid:2)(cid:18)(cid:1)(cid:18)(cid:19)(cid:18)(cid:18)(cid:2)(cid:1)(cid:2)(cid:3,Unknown,5827.0
Unknown,Unknown,2,Unknown,Unknown,Unknown,Unknown,cid:15)(cid:2)(cid:17)(cid:2)(cid:18)(cid:1)(cid:18)(cid:19)(cid:18)(cid:18)(cid:2)(cid:1)(cid:2)(cid:3,Unknown,5829.0
Unknown,Unknown,74,Unknown,Unknown,Unknown,Unknown,cid:15)(cid:2)(cid:17)(cid:2)(cid:18)(cid:1)(cid:18)(cid:19)(cid:18)(cid:18)(cid:2)(cid:1)(cid:2)(cid:3,Unknown,5903.0
Unknown,Unknown,30,Unknown,Unknown,Unknown,Unknown,cid:15)(cid:2)(cid:17)(cid:2)(cid:18)(cid:1)(cid:18)(cid:19)(cid:18)(cid:18)(cid:2)(cid:1)(cid:2)(cid:3,Unknown,5933.0
Unknown,Unknown,2,Unknown,Unknown,Unknown,Unknown,cid:15)(cid:2)(cid:17)(cid:2)(cid:18)(cid:1)(cid:18)(cid:19)(cid:18)(cid:18)(cid:2)(cid:1)(cid:2)(cid:3,Unknown,5935.0
Unknown,Unknown,73,Unknown,Unknown,Unknown,Unknown,cid:15)(cid:2)(cid:17)(cid:2)(cid:18)(cid:1)(cid:18)(cid:19)(cid:18)(cid:18)(cid:2)(cid:1)(cid:2)(cid:3,Unknown,6008.0
Unknown,Unknown,2,Unknown,Unknown,Unknown,Unknown,cid:15)(cid:2)(cid:17)(cid:2)(cid:18)(cid:1)(cid:18)(cid:19)(cid:18)(cid:18)(cid:2)(cid:1)(cid:2)(cid:3,Unknown,6010.0
Unknown,Unknown,17,Unknown,Unknown,Unknown,Unknown,cid:15)(cid:2)(cid:17)(cid:2)(cid:18)(cid:1)(cid:18)(cid:19)(cid:18)(cid:18)(cid:2)(cid:1)(cid:2)(cid:3,Unknown,6027.0
Unknown,Unknown,19,Unknown,Unknown,Unknown,Unknown,cid:15)(cid:2)(cid:17)(cid:2)(cid:18)(cid:1)(cid:18)(cid:19)(cid:18)(cid:18)(cid:2)(cid:1)(cid:2)(cid:3,Unknown,6046.0
Unknown,Unknown,18,Unknown,Unknown,Unknown,Unknown,cid:15)(cid:2)(cid:17)(cid:2)(cid:18)(cid:1)(cid:18)(cid:19)(cid:18)(cid:18)(cid:2)(cid:1)(cid:2)(cid:3,Unknown,6064.0
Unknown,Unknown,18,Unknown,Unknown,Unknown,Unknown,cid:15)(cid:2)(cid:17)(cid:2)(cid:18)(cid:1)(cid:18)(cid:19)(cid:18)(cid:18)(cid:2)(cid:1)(cid:2)(cid:3,Unknown,6082.0
Unknown,Unknown,2,Unknown,Unknown,Unknown,Unknown,cid:15)(cid:2)(cid:17)(cid:2)(cid:18)(cid:1)(cid:18)(cid:19)(cid:18)(cid:18)(cid:2)(cid:1)(cid:2)(cid:3,Unknown,6084.0
Unknown,Unknown,44,Unknown,Unknown,Unknown,Unknown,cid:15)(cid:2)(cid:17)(cid:2)(cid:18)(cid:1)(cid:18)(cid:19)(cid:18)(cid:18)(cid:2)(cid:1)(cid:2)(cid:3,Unknown,6128.0
Unknown,Unknown,15,Unknown,Unknown,Unknown,Unknown,cid:15)(cid:2)(cid:17)(cid:2)(cid:18)(cid:1)(cid:18)(cid:19)(cid:18)(cid:18)(cid:2)(cid:1)(cid:2)(cid:3,Unknown,6143.0
Unknown,Unknown,2,Unknown,Unknown,Unknown,Unknown,cid:15)(cid:2)(cid:17)(cid:2)(cid:18)(cid:1)(cid:18)(cid:19)(cid:18)(cid:18)(cid:2)(cid:1)(cid:2)(cid:3,Unknown,6145.0
Unknown,Unknown,16,Unknown,Unknown,Unknown,Unknown,cid:15)(cid:2)(cid:17)(cid:2)(cid:18)(cid:1)(cid:18)(cid:19)(cid:18)(cid:18)(cid:2)(cid:1)(cid:2)(cid:3,Unknown,6161.0
Unknown,Unknown,19,Unknown,Unknown,Unknown,Unknown,cid:15)(cid:2)(cid:17)(cid:2)(cid:18)(cid:1)(cid:18)(cid:19)(cid:18)(cid:18)(cid:2)(cid:1)(cid:2)(cid:3,Unknown,6180.0
Unknown,Unknown,18,Unknown,Unknown,Unknown,Unknown,cid:15)(cid:2)(cid:17)(cid:2)(cid:18)(cid:1)(cid:18)(cid:19)(cid:18)(cid:18)(cid:2)(cid:1)(cid:2)(cid:3,Unknown,6198.0
Unknown,Unknown,18,Unknown,Unknown,Unknown,Unknown,cid:15)(cid:2)(cid:17)(cid:2)(cid:18)(cid:1)(cid:18)(cid:19)(cid:18)(cid:18)(cid:2)(cid:1)(cid:2)(cid:3,Unknown,6216.0
Unknown,Unknown,2,Unknown,Unknown,Unknown,Unknown,cid:15)(cid:2)(cid:17)(cid:2)(cid:18)(cid:1)(cid:18)(cid:19)(cid:18)(cid:18)(cid:2)(cid:1)(cid:2)(cid:3,Unknown,6218.0
Unknown,Unknown,74,Unknown,Unknown,Unknown,Unknown,cid:15)(cid:2)(cid:17)(cid:2)(cid:18)(cid:1)(cid:18)(cid:19)(cid:18)(cid:18)(cid:2)(cid:1)(cid:2)(cid:3,Unknown,6292.0
Unknown,Unknown,30,Unknown,Unknown,Unknown,Unknown,cid:15)(cid:2)(cid:17)(cid:2)(cid:18)(cid:1)(cid:18)(cid:19)(cid:18)(cid:18)(cid:2)(cid:1)(cid:2)(cid:3,Unknown,6322.0
Unknown,Unknown,12,Unknown,Unknown,Unknown,Unknown,cid:15)(cid:2)(cid:17)(cid:2)(cid:18)(cid:1)(cid:18)(cid:19)(cid:18)(cid:18)(cid:2)(cid:1)(cid:2)(cid:3,Unknown,6334.0
Unknown,Unknown,29,Unknown,Unknown,Unknown,Unknown,cid:15)(cid:2)(cid:17)(cid:2)(cid:18)(cid:1)(cid:18)(cid:19)(cid:18)(cid:18)(cid:2)(cid:1)(cid:2)(cid:3,Unknown,6363.0
Unknown,Unknown,26,Unknown,Unknown,Unknown,Unknown,cid:15)(cid:2)(cid:17)(cid:2)(cid:18)(cid:1)(cid:18)(cid:19)(cid:18)(cid:18)(cid:2)(cid:1)(cid:2)(cid:3,Unknown,6389.0
Unknown,Unknown,41,Unknown,Unknown,Unknown,Unknown,cid:15)(cid:2)(cid:17)(cid:2)(cid:18)(cid:1)(cid:18)(cid:19)(cid:18)(cid:18)(cid:2)(cid:1)(cid:2)(cid:3,Unknown,6430.0
Unknown,Unknown,25,Unknown,Unknown,Unknown,Unknown,cid:15)(cid:2)(cid:17)(cid:2)(cid:18)(cid:1)(cid:18)(cid:19)(cid:18)(cid:18)(cid:2)(cid:1)(cid:2)(cid:3,Unknown,6455.0
Unknown,Unknown,2,Unknown,Unknown,Unknown,Unknown,cid:15)(cid:2)(cid:17)(cid:2)(cid:18)(cid:1)(cid:18)(cid:19)(cid:18)(cid:18)(cid:2)(cid:1)(cid:2)(cid:3,Unknown,6457.0
Unknown,Unknown,50,Unknown,Unknown,Unknown,Unknown,cid:15)(cid:2)(cid:17)(cid:2)(cid:18)(cid:1)(cid:18)(cid:19)(cid:18)(cid:18)(cid:2)(cid:1)(cid:2)(cid:3,Unknown,6507.0
Unknown,Unknown,50,Unknown,Unknown,Unknown,Unknown,cid:15)(cid:2)(cid:17)(cid:2)(cid:18)(cid:1)(cid:18)(cid:19)(cid:18)(cid:18)(cid:2)(cid:1)(cid:2)(cid:3,Unknown,6557.0
Unknown,Unknown,18,Unknown,Unknown,Unknown,Unknown,cid:15)(cid:2)(cid:17)(cid:2)(cid:18)(cid:1)(cid:18)(cid:19)(cid:18)(cid:18)(cid:2)(cid:1)(cid:2)(cid:3,Unknown,6575.0
Unknown,Unknown,1,Unknown,Unknown,Unknown,Unknown,cid:15)(cid:2)(cid:17)(cid:2)(cid:18)(cid:1)(cid:18)(cid:19)(cid:18)(cid:18)(cid:2)(cid:1)(cid:2)(cid:3,Unknown,6576.0
Unknown,Unknown,1,Unknown,Unknown,Unknown,Unknown,cid:15)(cid:2)(cid:17)(cid:2)(cid:18)(cid:1)(cid:18)(cid:19)(cid:18)(cid:18)(cid:2)(cid:1)(cid:2)(cid:3,Unknown,6577.0
Unknown,Unknown,37,Unknown,Unknown,Unknown,Unknown,cid:15)(cid:2)(cid:17)(cid:2)(cid:18)(cid:1)(cid:18)(cid:19)(cid:18)(cid:18)(cid:2)(cid:1)(cid:2)(cid:3,Unknown,6614.0
Unknown,Unknown,1,Unknown,Unknown,Unknown,Unknown,cid:15)(cid:2)(cid:17)(cid:2)(cid:18)(cid:1)(cid:18)(cid:19)(cid:18)(cid:18)(cid:2)(cid:1)(cid:2)(cid:3,Unknown,6615.0
Unknown,Unknown,33,Unknown,Unknown,Unknown,Unknown,cid:15)(cid:2)(cid:17)(cid:2)(cid:18)(cid:1)(cid:18)(cid:19)(cid:18)(cid:18)(cid:2)(cid:1)(cid:2)(cid:3,Unknown,6648.0
Unknown,Unknown,45,Unknown,Unknown,Unknown,Unknown,cid:15)(cid:2)(cid:17)(cid:2)(cid:18)(cid:1)(cid:18)(cid:19)(cid:18)(cid:18)(cid:2)(cid:1)(cid:2)(cid:3,Unknown,6693.0
Unknown,Unknown,18,Unknown,Unknown,Unknown,Unknown,cid:15)(cid:2)(cid:17)(cid:2)(cid:18)(cid:1)(cid:18)(cid:19)(cid:18)(cid:18)(cid:2)(cid:1)(cid:2)(cid:3,Unknown,6711.0
Unknown,Unknown,35,Unknown,Unknown,Unknown,Unknown,cid:15)(cid:2)(cid:17)(cid:2)(cid:18)(cid:1)(cid:18)(cid:19)(cid:18)(cid:18)(cid:2)(cid:1)(cid:2)(cid:3,Unknown,6746.0
Unknown,Unknown,9,Unknown,Unknown,Unknown,Unknown,cid:15)(cid:2)(cid:17)(cid:2)(cid:18)(cid:1)(cid:18)(cid:19)(cid:18)(cid:18)(cid:2)(cid:1)(cid:2)(cid:3,Unknown,6755.0
Unknown,Unknown,13,Unknown,Unknown,Unknown,Unknown,cid:15)(cid:2)(cid:17)(cid:2)(cid:18)(cid:1)(cid:18)(cid:19)(cid:18)(cid:18)(cid:2)(cid:1)(cid:2)(cid:3,Unknown,6768.0
Unknown,Unknown,5,Unknown,Unknown,Unknown,Unknown,cid:15)(cid:2)(cid:17)(cid:2)(cid:18)(cid:1)(cid:18)(cid:19)(cid:18)(cid:18)(cid:2)(cid:1)(cid:2)(cid:3,Unknown,6773.0
Unknown,Unknown,14,Unknown,Unknown,Unknown,Unknown,cid:15)(cid:2)(cid:17)(cid:2)(cid:18)(cid:1)(cid:18)(cid:19)(cid:18)(cid:18)(cid:2)(cid:1)(cid:2)(cid:3,Unknown,6787.0
Unknown,Unknown,14,Unknown,Unknown,Unknown,Unknown,cid:15)(cid:2)(cid:17)(cid:2)(cid:18)(cid:1)(cid:18)(cid:19)(cid:18)(cid:18)(cid:2)(cid:1)(cid:2)(cid:3,Unknown,6801.0
Unknown,Unknown,2,Unknown,Unknown,Unknown,Unknown,cid:15)(cid:2)(cid:17)(cid:2)(cid:18)(cid:1)(cid:18)(cid:19)(cid:18)(cid:18)(cid:2)(cid:1)(cid:2)(cid:3,Unknown,6803.0
Unknown,Unknown,17,Unknown,Unknown,Unknown,Unknown,cid:15)(cid:2)(cid:17)(cid:2)(cid:18)(cid:1)(cid:18)(cid:19)(cid:18)(cid:18)(cid:2)(cid:1)(cid:2)(cid:3,Unknown,6820.0
Unknown,Unknown,1,Unknown,Unknown,Unknown,Unknown,cid:15)(cid:2)(cid:17)(cid:2)(cid:18)(cid:1)(cid:18)(cid:19)(cid:18)(cid:18)(cid:2)(cid:1)(cid:2)(cid:3,Unknown,6821.0
Unknown,Unknown,16,Unknown,Unknown,Unknown,Unknown,cid:15)(cid:2)(cid:17)(cid:2)(cid:18)(cid:1)(cid:18)(cid:19)(cid:18)(cid:18)(cid:2)(cid:1)(cid:2)(cid:3,Unknown,6837.0
Unknown,Unknown,17,Unknown,Unknown,Unknown,Unknown,cid:15)(cid:2)(cid:17)(cid:2)(cid:18)(cid:1)(cid:18)(cid:19)(cid:18)(cid:18)(cid:2)(cid:1)(cid:2)(cid:3,Unknown,6854.0
Unknown,Unknown,2,Unknown,Unknown,Unknown,Unknown,cid:15)(cid:2)(cid:17)(cid:2)(cid:18)(cid:1)(cid:18)(cid:19)(cid:18)(cid:18)(cid:2)(cid:1)(cid:2)(cid:3,Unknown,6856.0
Unknown,Unknown,13,Unknown,Unknown,Unknown,Unknown,cid:15)(cid:2)(cid:17)(cid:2)(cid:18)(cid:1)(cid:18)(cid:19)(cid:18)(cid:18)(cid:2)(cid:1)(cid:2)(cid:3,Unknown,6869.0
Unknown,Unknown,20,Unknown,Unknown,Unknown,Unknown,cid:15)(cid:2)(cid:17)(cid:2)(cid:18)(cid:1)(cid:18)(cid:19)(cid:18)(cid:18)(cid:2)(cid:1)(cid:2)(cid:3,Unknown,6889.0
Unknown,Unknown,22,Unknown,Unknown,Unknown,Unknown,cid:15)(cid:2)(cid:17)(cid:2)(cid:18)(cid:1)(cid:18)(cid:19)(cid:18)(cid:18)(cid:2)(cid:1)(cid:2)(cid:3,Unknown,6911.0
Unknown,Unknown,75,Unknown,Unknown,Unknown,Unknown,cid:15)(cid:2)(cid:17)(cid:2)(cid:18)(cid:1)(cid:18)(cid:19)(cid:18)(cid:18)(cid:2)(cid:1)(cid:2)(cid:3,Unknown,6986.0
Unknown,Unknown,74,Unknown,Unknown,Unknown,Unknown,cid:15)(cid:2)(cid:17)(cid:2)(cid:18)(cid:1)(cid:18)(cid:19)(cid:18)(cid:18)(cid:2)(cid:1)(cid:2)(cid:3,Unknown,7060.0
Unknown,Unknown,24,Unknown,Unknown,Unknown,Unknown,cid:15)(cid:2)(cid:17)(cid:2)(cid:18)(cid:1)(cid:18)(cid:19)(cid:18)(cid:18)(cid:2)(cid:1)(cid:2)(cid:3,Unknown,7084.0
Unknown,Unknown,26,Unknown,Unknown,Unknown,Unknown,cid:15)(cid:2)(cid:17)(cid:2)(cid:18)(cid:1)(cid:18)(cid:19)(cid:18)(cid:18)(cid:2)(cid:1)(cid:2)(cid:3,Unknown,7110.0
Unknown,Unknown,31,Unknown,Unknown,Unknown,Unknown,cid:15)(cid:2)(cid:17)(cid:2)(cid:18)(cid:1)(cid:18)(cid:19)(cid:18)(cid:18)(cid:2)(cid:1)(cid:2)(cid:3,Unknown,7141.0
Unknown,Unknown,58,Unknown,Unknown,Unknown,Unknown,cid:15)(cid:2)(cid:17)(cid:2)(cid:18)(cid:1)(cid:18)(cid:19)(cid:18)(cid:18)(cid:2)(cid:1)(cid:2)(cid:3,Unknown,7199.0
Unknown,Unknown,25,Unknown,Unknown,Unknown,Unknown,cid:15)(cid:2)(cid:17)(cid:2)(cid:18)(cid:1)(cid:18)(cid:19)(cid:18)(cid:18)(cid:2)(cid:1)(cid:2)(cid:3,Unknown,7224.0
Unknown,Unknown,30,Unknown,Unknown,Unknown,Unknown,cid:15)(cid:2)(cid:17)(cid:2)(cid:18)(cid:1)(cid:18)(cid:19)(cid:18)(cid:18)(cid:2)(cid:1)(cid:2)(cid:3,Unknown,7254.0
Unknown,Unknown,2,Unknown,Unknown,Unknown,Unknown,cid:15)(cid:2)(cid:17)(cid:2)(cid:18)(cid:1)(cid:18)(cid:19)(cid:18)(cid:18)(cid:2)(cid:1)(cid:2)(cid:3,Unknown,7256.0
Unknown,Unknown,11,Unknown,Unknown,Unknown,Unknown,cid:15)(cid:2)(cid:17)(cid:2)(cid:18)(cid:1)(cid:18)(cid:19)(cid:18)(cid:18)(cid:2)(cid:1)(cid:2)(cid:3,Unknown,7267.0
Unknown,Unknown,2,Unknown,Unknown,Unknown,Unknown,cid:15)(cid:2)(cid:17)(cid:2)(cid:18)(cid:1)(cid:18)(cid:19)(cid:18)(cid:18)(cid:2)(cid:1)(cid:2)(cid:3,Unknown,7269.0
Unknown,Unknown,49,Unknown,Unknown,Unknown,Unknown,cid:15)(cid:2)(cid:17)(cid:2)(cid:18)(cid:1)(cid:18)(cid:19)(cid:18)(cid:18)(cid:2)(cid:1)(cid:2)(cid:3,Unknown,7318.0
Unknown,Unknown,5,Unknown,Unknown,Unknown,Unknown,cid:15)(cid:2)(cid:17)(cid:2)(cid:18)(cid:1)(cid:18)(cid:19)(cid:18)(cid:18)(cid:2)(cid:1)(cid:2)(cid:3,Unknown,7323.0
Unknown,Unknown,15,Unknown,Unknown,Unknown,Unknown,cid:15)(cid:2)(cid:17)(cid:2)(cid:18)(cid:1)(cid:18)(cid:19)(cid:18)(cid:18)(cid:2)(cid:1)(cid:2)(cid:3,Unknown,7338.0
Unknown,Unknown,2,Unknown,Unknown,Unknown,Unknown,cid:15)(cid:2)(cid:17)(cid:2)(cid:18)(cid:1)(cid:18)(cid:19)(cid:18)(cid:18)(cid:2)(cid:1)(cid:2)(cid:3,Unknown,7340.0
Unknown,Unknown,17,Unknown,Unknown,Unknown,Unknown,cid:15)(cid:2)(cid:17)(cid:2)(cid:18)(cid:1)(cid:18)(cid:19)(cid:18)(cid:18)(cid:2)(cid:1)(cid:2)(cid:3,Unknown,7357.0
Unknown,Unknown,32,Unknown,Unknown,Unknown,Unknown,cid:15)(cid:2)(cid:17)(cid:2)(cid:18)(cid:1)(cid:18)(cid:19)(cid:18)(cid:18)(cid:2)(cid:1)(cid:2)(cid:3,Unknown,7389.0
Unknown,Unknown,37,Unknown,Unknown,Unknown,Unknown,cid:15)(cid:2)(cid:17)(cid:2)(cid:18)(cid:1)(cid:18)(cid:19)(cid:18)(cid:18)(cid:2)(cid:1)(cid:2)(cid:3,Unknown,7426.0
Unknown,Unknown,19,Unknown,Unknown,Unknown,Unknown,cid:15)(cid:2)(cid:17)(cid:2)(cid:18)(cid:1)(cid:18)(cid:19)(cid:18)(cid:18)(cid:2)(cid:1)(cid:2)(cid:3,Unknown,7445.0
Unknown,Unknown,17,Unknown,Unknown,Unknown,Unknown,cid:15)(cid:2)(cid:17)(cid:2)(cid:18)(cid:1)(cid:18)(cid:19)(cid:18)(cid:18)(cid:2)(cid:1)(cid:2)(cid:3,Unknown,7462.0
Unknown,Unknown,33,Unknown,Unknown,Unknown,Unknown,cid:15)(cid:2)(cid:17)(cid:2)(cid:18)(cid:1)(cid:18)(cid:19)(cid:18)(cid:18)(cid:2)(cid:1)(cid:2)(cid:3,Unknown,7495.0
Unknown,Unknown,2,Unknown,Unknown,Unknown,Unknown,cid:15)(cid:2)(cid:17)(cid:2)(cid:18)(cid:1)(cid:18)(cid:19)(cid:18)(cid:18)(cid:2)(cid:1)(cid:2)(cid:3,Unknown,7497.0
Unknown,Unknown,44,Unknown,Unknown,Unknown,Unknown,cid:15)(cid:2)(cid:17)(cid:2)(cid:18)(cid:1)(cid:18)(cid:19)(cid:18)(cid:18)(cid:2)(cid:1)(cid:2)(cid:3,Unknown,7541.0
Unknown,Unknown,12,Unknown,Unknown,Unknown,Unknown,cid:15)(cid:2)(cid:17)(cid:2)(cid:18)(cid:1)(cid:18)(cid:19)(cid:18)(cid:18)(cid:2)(cid:1)(cid:2)(cid:3,Unknown,7553.0
Unknown,Unknown,29,Unknown,Unknown,Unknown,Unknown,cid:15)(cid:2)(cid:17)(cid:2)(cid:18)(cid:1)(cid:18)(cid:19)(cid:18)(cid:18)(cid:2)(cid:1)(cid:2)(cid:3,Unknown,7582.0
Unknown,Unknown,26,Unknown,Unknown,Unknown,Unknown,cid:15)(cid:2)(cid:17)(cid:2)(cid:18)(cid:1)(cid:18)(cid:19)(cid:18)(cid:18)(cid:2)(cid:1)(cid:2)(cid:3,Unknown,7608.0
Unknown,Unknown,41,Unknown,Unknown,Unknown,Unknown,cid:15)(cid:2)(cid:17)(cid:2)(cid:18)(cid:1)(cid:18)(cid:19)(cid:18)(cid:18)(cid:2)(cid:1)(cid:2)(cid:3,Unknown,7649.0
Unknown,Unknown,25,Unknown,Unknown,Unknown,Unknown,cid:15)(cid:2)(cid:17)(cid:2)(cid:18)(cid:1)(cid:18)(cid:19)(cid:18)(cid:18)(cid:2)(cid:1)(cid:2)(cid:3,Unknown,7674.0
Unknown,Unknown,2,Unknown,Unknown,Unknown,Unknown,cid:15)(cid:2)(cid:17)(cid:2)(cid:18)(cid:1)(cid:18)(cid:19)(cid:18)(cid:18)(cid:2)(cid:1)(cid:2)(cid:3,Unknown,7676.0
Unknown,Unknown,50,Unknown,Unknown,Unknown,Unknown,cid:15)(cid:2)(cid:17)(cid:2)(cid:18)(cid:1)(cid:18)(cid:19)(cid:18)(cid:18)(cid:2)(cid:1)(cid:2)(cid:3,Unknown,7726.0
Unknown,Unknown,50,Unknown,Unknown,Unknown,Unknown,cid:15)(cid:2)(cid:17)(cid:2)(cid:18)(cid:1)(cid:18)(cid:19)(cid:18)(cid:18)(cid:2)(cid:1)(cid:2)(cid:3,Unknown,7776.0
Unknown,Unknown,37,Unknown,Unknown,Unknown,Unknown,cid:15)(cid:2)(cid:17)(cid:2)(cid:18)(cid:1)(cid:18)(cid:19)(cid:18)(cid:18)(cid:2)(cid:1)(cid:2)(cid:3,Unknown,7813.0
Unknown,Unknown,16,Unknown,Unknown,Unknown,Unknown,cid:15)(cid:2)(cid:17)(cid:2)(cid:18)(cid:1)(cid:18)(cid:19)(cid:18)(cid:18)(cid:2)(cid:1)(cid:2)(cid:3,Unknown,7829.0
Unknown,Unknown,34,Unknown,Unknown,Unknown,Unknown,cid:15)(cid:2)(cid:17)(cid:2)(cid:18)(cid:1)(cid:18)(cid:19)(cid:18)(cid:18)(cid:2)(cid:1)(cid:2)(cid:3,Unknown,7863.0
Unknown,Unknown,33,Unknown,Unknown,Unknown,Unknown,cid:15)(cid:2)(cid:17)(cid:2)(cid:18)(cid:1)(cid:18)(cid:19)(cid:18)(cid:18)(cid:2)(cid:1)(cid:2)(cid:3,Unknown,7896.0
Unknown,Unknown,37,Unknown,Unknown,Unknown,Unknown,cid:15)(cid:2)(cid:17)(cid:2)(cid:18)(cid:1)(cid:18)(cid:19)(cid:18)(cid:18)(cid:2)(cid:1)(cid:2)(cid:3,Unknown,7933.0
Unknown,Unknown,18,Unknown,Unknown,Unknown,Unknown,cid:15)(cid:2)(cid:17)(cid:2)(cid:18)(cid:1)(cid:18)(cid:19)(cid:18)(cid:18)(cid:2)(cid:1)(cid:2)(cid:3,Unknown,7951.0
Unknown,Unknown,45,Unknown,Unknown,Unknown,Unknown,cid:15)(cid:2)(cid:17)(cid:2)(cid:18)(cid:1)(cid:18)(cid:19)(cid:18)(cid:18)(cid:2)(cid:1)(cid:2)(cid:3,Unknown,7996.0
Unknown,Unknown,18,Unknown,Unknown,Unknown,Unknown,cid:15)(cid:2)(cid:17)(cid:2)(cid:18)(cid:1)(cid:18)(cid:19)(cid:18)(cid:18)(cid:2)(cid:1)(cid:2)(cid:3,Unknown,8014.0
Unknown,Unknown,35,Unknown,Unknown,Unknown,Unknown,cid:15)(cid:2)(cid:17)(cid:2)(cid:18)(cid:1)(cid:18)(cid:19)(cid:18)(cid:18)(cid:2)(cid:1)(cid:2)(cid:3,Unknown,8049.0
Unknown,Unknown,12,Unknown,Unknown,Unknown,Unknown,cid:15)(cid:2)(cid:17)(cid:2)(cid:18)(cid:1)(cid:18)(cid:19)(cid:18)(cid:18)(cid:2)(cid:1)(cid:2)(cid:3,Unknown,8061.0
Unknown,Unknown,39,Unknown,Unknown,Unknown,Unknown,cid:15)(cid:2)(cid:17)(cid:2)(cid:18)(cid:1)(cid:18)(cid:19)(cid:18)(cid:18)(cid:2)(cid:1)(cid:2)(cid:3,Unknown,8100.0
Unknown,Unknown,2,Unknown,Unknown,Unknown,Unknown,cid:15)(cid:2)(cid:17)(cid:2)(cid:18)(cid:1)(cid:18)(cid:19)(cid:18)(cid:18)(cid:2)(cid:1)(cid:2)(cid:3,Unknown,8102.0
Unknown,Unknown,13,Unknown,Unknown,Unknown,Unknown,cid:15)(cid:2)(cid:17)(cid:2)(cid:18)(cid:1)(cid:18)(cid:19)(cid:18)(cid:18)(cid:2)(cid:1)(cid:2)(cid:3,Unknown,8115.0
Unknown,Unknown,3,Unknown,Unknown,Unknown,Unknown,cid:15)(cid:2)(cid:17)(cid:2)(cid:18)(cid:1)(cid:18)(cid:19)(cid:18)(cid:18)(cid:2)(cid:1)(cid:2)(cid:3,Unknown,8118.0
Unknown,Unknown,4,Unknown,Unknown,Unknown,Unknown,cid:15)(cid:2)(cid:17)(cid:2)(cid:18)(cid:1)(cid:18)(cid:19)(cid:18)(cid:18)(cid:2)(cid:1)(cid:2)(cid:3,Unknown,8122.0
Unknown,Unknown,9,Unknown,Unknown,Unknown,Unknown,cid:15)(cid:2)(cid:17)(cid:2)(cid:18)(cid:1)(cid:18)(cid:19)(cid:18)(cid:18)(cid:2)(cid:1)(cid:2)(cid:3,Unknown,8131.0
Unknown,Unknown,7,Unknown,Unknown,Unknown,Unknown,cid:15)(cid:2)(cid:17)(cid:2)(cid:18)(cid:1)(cid:18)(cid:19)(cid:18)(cid:18)(cid:2)(cid:1)(cid:2)(cid:3,Unknown,8138.0
Unknown,Unknown,12,Unknown,Unknown,Unknown,Unknown,cid:15)(cid:2)(cid:17)(cid:2)(cid:18)(cid:1)(cid:18)(cid:19)(cid:18)(cid:18)(cid:2)(cid:1)(cid:2)(cid:3,Unknown,8150.0
Unknown,Unknown,46,Unknown,Unknown,Unknown,Unknown,cid:15)(cid:2)(cid:17)(cid:2)(cid:18)(cid:1)(cid:18)(cid:19)(cid:18)(cid:18)(cid:2)(cid:1)(cid:2)(cid:3,Unknown,8196.0
Unknown,Unknown,2,Unknown,Unknown,Unknown,Unknown,cid:15)(cid:2)(cid:17)(cid:2)(cid:18)(cid:1)(cid:18)(cid:19)(cid:18)(cid:18)(cid:2)(cid:1)(cid:2)(cid:3,Unknown,8198.0
Unknown,Unknown,13,Unknown,Unknown,Unknown,Unknown,cid:15)(cid:2)(cid:17)(cid:2)(cid:18)(cid:1)(cid:18)(cid:19)(cid:18)(cid:18)(cid:2)(cid:1)(cid:2)(cid:3,Unknown,8211.0
Unknown,Unknown,3,Unknown,Unknown,Unknown,Unknown,cid:15)(cid:2)(cid:17)(cid:2)(cid:18)(cid:1)(cid:18)(cid:19)(cid:18)(cid:18)(cid:2)(cid:1)(cid:2)(cid:3,Unknown,8214.0
Unknown,Unknown,4,Unknown,Unknown,Unknown,Unknown,cid:15)(cid:2)(cid:17)(cid:2)(cid:18)(cid:1)(cid:18)(cid:19)(cid:18)(cid:18)(cid:2)(cid:1)(cid:2)(cid:3,Unknown,8218.0
Unknown,Unknown,9,Unknown,Unknown,Unknown,Unknown,cid:15)(cid:2)(cid:17)(cid:2)(cid:18)(cid:1)(cid:18)(cid:19)(cid:18)(cid:18)(cid:2)(cid:1)(cid:2)(cid:3,Unknown,8227.0
Unknown,Unknown,7,Unknown,Unknown,Unknown,Unknown,cid:15)(cid:2)(cid:17)(cid:2)(cid:18)(cid:1)(cid:18)(cid:19)(cid:18)(cid:18)(cid:2)(cid:1)(cid:2)(cid:3,Unknown,8234.0
Unknown,Unknown,12,Unknown,Unknown,Unknown,Unknown,cid:15)(cid:2)(cid:17)(cid:2)(cid:18)(cid:1)(cid:18)(cid:19)(cid:18)(cid:18)(cid:2)(cid:1)(cid:2)(cid:3,Unknown,8246.0
Unknown,Unknown,46,Unknown,Unknown,Unknown,Unknown,cid:15)(cid:2)(cid:17)(cid:2)(cid:18)(cid:1)(cid:18)(cid:19)(cid:18)(cid:18)(cid:2)(cid:1)(cid:2)(cid:3,Unknown,8292.0
Unknown,Unknown,2,Unknown,Unknown,Unknown,Unknown,cid:15)(cid:2)(cid:17)(cid:2)(cid:18)(cid:1)(cid:18)(cid:19)(cid:18)(cid:18)(cid:2)(cid:1)(cid:2)(cid:3,Unknown,8294.0
Unknown,Unknown,9,Unknown,Unknown,Unknown,Unknown,cid:15)(cid:2)(cid:17)(cid:2)(cid:18)(cid:1)(cid:18)(cid:19)(cid:18)(cid:18)(cid:2)(cid:1)(cid:2)(cid:3,Unknown,8303.0
Unknown,Unknown,7,Unknown,Unknown,Unknown,Unknown,cid:15)(cid:2)(cid:17)(cid:2)(cid:18)(cid:1)(cid:18)(cid:19)(cid:18)(cid:18)(cid:2)(cid:1)(cid:2)(cid:3,Unknown,8310.0
Unknown,Unknown,15,Unknown,Unknown,Unknown,Unknown,cid:15)(cid:2)(cid:17)(cid:2)(cid:18)(cid:1)(cid:18)(cid:19)(cid:18)(cid:18)(cid:2)(cid:1)(cid:2)(cid:3,Unknown,8325.0
Unknown,Unknown,2,Unknown,Unknown,Unknown,Unknown,cid:15)(cid:2)(cid:17)(cid:2)(cid:18)(cid:1)(cid:18)(cid:19)(cid:18)(cid:18)(cid:2)(cid:1)(cid:2)(cid:3,Unknown,8327.0
Unknown,Unknown,16,Unknown,Unknown,Unknown,Unknown,cid:15)(cid:2)(cid:17)(cid:2)(cid:18)(cid:1)(cid:18)(cid:19)(cid:18)(cid:18)(cid:2)(cid:1)(cid:2)(cid:3,Unknown,8343.0
Unknown,Unknown,19,Unknown,Unknown,Unknown,Unknown,cid:15)(cid:2)(cid:17)(cid:2)(cid:18)(cid:1)(cid:18)(cid:19)(cid:18)(cid:18)(cid:2)(cid:1)(cid:2)(cid:3,Unknown,8362.0
Unknown,Unknown,32,Unknown,Unknown,Unknown,Unknown,cid:15)(cid:2)(cid:17)(cid:2)(cid:18)(cid:1)(cid:18)(cid:19)(cid:18)(cid:18)(cid:2)(cid:1)(cid:2)(cid:3,Unknown,8394.0
Unknown,Unknown,18,Unknown,Unknown,Unknown,Unknown,cid:15)(cid:2)(cid:17)(cid:2)(cid:18)(cid:1)(cid:18)(cid:19)(cid:18)(cid:18)(cid:2)(cid:1)(cid:2)(cid:3,Unknown,8412.0
Unknown,Unknown,2,Unknown,Unknown,Unknown,Unknown,cid:15)(cid:2)(cid:17)(cid:2)(cid:18)(cid:1)(cid:18)(cid:19)(cid:18)(cid:18)(cid:2)(cid:1)(cid:2)(cid:3,Unknown,8414.0
Unknown,Unknown,44,Unknown,Unknown,Unknown,Unknown,cid:15)(cid:2)(cid:17)(cid:2)(cid:18)(cid:1)(cid:18)(cid:19)(cid:18)(cid:18)(cid:2)(cid:1)(cid:2)(cid:3,Unknown,8458.0
Unknown,Unknown,12,Unknown,Unknown,Unknown,Unknown,cid:15)(cid:2)(cid:17)(cid:2)(cid:18)(cid:1)(cid:18)(cid:19)(cid:18)(cid:18)(cid:2)(cid:1)(cid:2)(cid:3,Unknown,8470.0
Unknown,Unknown,29,Unknown,Unknown,Unknown,Unknown,cid:15)(cid:2)(cid:17)(cid:2)(cid:18)(cid:1)(cid:18)(cid:19)(cid:18)(cid:18)(cid:2)(cid:1)(cid:2)(cid:3,Unknown,8499.0
Unknown,Unknown,26,Unknown,Unknown,Unknown,Unknown,cid:15)(cid:2)(cid:17)(cid:2)(cid:18)(cid:1)(cid:18)(cid:19)(cid:18)(cid:18)(cid:2)(cid:1)(cid:2)(cid:3,Unknown,8525.0
Unknown,Unknown,41,Unknown,Unknown,Unknown,Unknown,cid:15)(cid:2)(cid:17)(cid:2)(cid:18)(cid:1)(cid:18)(cid:19)(cid:18)(cid:18)(cid:2)(cid:1)(cid:2)(cid:3,Unknown,8566.0
Unknown,Unknown,25,Unknown,Unknown,Unknown,Unknown,cid:15)(cid:2)(cid:17)(cid:2)(cid:18)(cid:1)(cid:18)(cid:19)(cid:18)(cid:18)(cid:2)(cid:1)(cid:2)(cid:3,Unknown,8591.0
Unknown,Unknown,2,Unknown,Unknown,Unknown,Unknown,cid:15)(cid:2)(cid:17)(cid:2)(cid:18)(cid:1)(cid:18)(cid:19)(cid:18)(cid:18)(cid:2)(cid:1)(cid:2)(cid:3,Unknown,8593.0
Unknown,Unknown,50,Unknown,Unknown,Unknown,Unknown,cid:15)(cid:2)(cid:17)(cid:2)(cid:18)(cid:1)(cid:18)(cid:19)(cid:18)(cid:18)(cid:2)(cid:1)(cid:2)(cid:3,Unknown,8643.0
Unknown,Unknown,50,Unknown,Unknown,Unknown,Unknown,cid:15)(cid:2)(cid:17)(cid:2)(cid:18)(cid:1)(cid:18)(cid:19)(cid:18)(cid:18)(cid:2)(cid:1)(cid:2)(cid:3,Unknown,8693.0
Unknown,Unknown,18,Unknown,Unknown,Unknown,Unknown,cid:15)(cid:2)(cid:17)(cid:2)(cid:18)(cid:1)(cid:18)(cid:19)(cid:18)(cid:18)(cid:2)(cid:1)(cid:2)(cid:3,Unknown,8711.0
Unknown,Unknown,1,Unknown,Unknown,Unknown,Unknown,cid:15)(cid:2)(cid:17)(cid:2)(cid:18)(cid:1)(cid:18)(cid:19)(cid:18)(cid:18)(cid:2)(cid:1)(cid:2)(cid:3,Unknown,8712.0
Unknown,Unknown,1,Unknown,Unknown,Unknown,Unknown,cid:15)(cid:2)(cid:17)(cid:2)(cid:18)(cid:1)(cid:18)(cid:19)(cid:18)(cid:18)(cid:2)(cid:1)(cid:2)(cid:3,Unknown,8713.0
Unknown,Unknown,37,Unknown,Unknown,Unknown,Unknown,cid:15)(cid:2)(cid:17)(cid:2)(cid:18)(cid:1)(cid:18)(cid:19)(cid:18)(cid:18)(cid:2)(cid:1)(cid:2)(cid:3,Unknown,8750.0
Unknown,Unknown,37,Unknown,Unknown,Unknown,Unknown,cid:15)(cid:2)(cid:17)(cid:2)(cid:18)(cid:1)(cid:18)(cid:19)(cid:18)(cid:18)(cid:2)(cid:1)(cid:2)(cid:3,Unknown,8787.0
Unknown,Unknown,18,Unknown,Unknown,Unknown,Unknown,cid:15)(cid:2)(cid:17)(cid:2)(cid:18)(cid:1)(cid:18)(cid:19)(cid:18)(cid:18)(cid:2)(cid:1)(cid:2)(cid:3,Unknown,8805.0
Unknown,Unknown,45,Unknown,Unknown,Unknown,Unknown,cid:15)(cid:2)(cid:17)(cid:2)(cid:18)(cid:1)(cid:18)(cid:19)(cid:18)(cid:18)(cid:2)(cid:1)(cid:2)(cid:3,Unknown,8850.0
Unknown,Unknown,18,Unknown,Unknown,Unknown,Unknown,cid:15)(cid:2)(cid:17)(cid:2)(cid:18)(cid:1)(cid:18)(cid:19)(cid:18)(cid:18)(cid:2)(cid:1)(cid:2)(cid:3,Unknown,8868.0
Unknown,Unknown,35,Unknown,Unknown,Unknown,Unknown,cid:15)(cid:2)(cid:17)(cid:2)(cid:18)(cid:1)(cid:18)(cid:19)(cid:18)(cid:18)(cid:2)(cid:1)(cid:2)(cid:3,Unknown,8903.0
Unknown,Unknown,10,Unknown,Unknown,Unknown,Unknown,cid:15)(cid:2)(cid:17)(cid:2)(cid:18)(cid:1)(cid:18)(cid:19)(cid:18)(cid:18)(cid:2)(cid:1)(cid:2)(cid:3,Unknown,8913.0
Unknown,Unknown,11,Unknown,Unknown,Unknown,Unknown,cid:15)(cid:2)(cid:17)(cid:2)(cid:18)(cid:1)(cid:18)(cid:19)(cid:18)(cid:18)(cid:2)(cid:1)(cid:2)(cid:3,Unknown,8924.0
Unknown,Unknown,10,Unknown,Unknown,Unknown,Unknown,cid:15)(cid:2)(cid:17)(cid:2)(cid:18)(cid:1)(cid:18)(cid:19)(cid:18)(cid:18)(cid:2)(cid:1)(cid:2)(cid:3,Unknown,8934.0
Unknown,Unknown,46,Unknown,Unknown,Unknown,Unknown,cid:15)(cid:2)(cid:17)(cid:2)(cid:18)(cid:1)(cid:18)(cid:19)(cid:18)(cid:18)(cid:2)(cid:1)(cid:2)(cid:3,Unknown,8980.0
Unknown,Unknown,14,Unknown,Unknown,Unknown,Unknown,cid:15)(cid:2)(cid:17)(cid:2)(cid:18)(cid:1)(cid:18)(cid:19)(cid:18)(cid:18)(cid:2)(cid:1)(cid:2)(cid:3,Unknown,8994.0
Unknown,Unknown,49,Unknown,Unknown,Unknown,Unknown,cid:15)(cid:2)(cid:17)(cid:2)(cid:18)(cid:1)(cid:18)(cid:19)(cid:18)(cid:18)(cid:2)(cid:1)(cid:2)(cid:3,Unknown,9043.0
Unknown,Unknown,46,Unknown,Unknown,Unknown,Unknown,cid:15)(cid:2)(cid:17)(cid:2)(cid:18)(cid:1)(cid:18)(cid:19)(cid:18)(cid:18)(cid:2)(cid:1)(cid:2)(cid:3,Unknown,9089.0
Unknown,Unknown,14,Unknown,Unknown,Unknown,Unknown,cid:15)(cid:2)(cid:17)(cid:2)(cid:18)(cid:1)(cid:18)(cid:19)(cid:18)(cid:18)(cid:2)(cid:1)(cid:2)(cid:3,Unknown,9103.0
Unknown,Unknown,10,Unknown,Unknown,Unknown,Unknown,cid:15)(cid:2)(cid:17)(cid:2)(cid:18)(cid:1)(cid:18)(cid:19)(cid:18)(cid:18)(cid:2)(cid:1)(cid:2)(cid:3,Unknown,9113.0
Unknown,Unknown,68,Unknown,Unknown,Unknown,Unknown,cid:15)(cid:2)(cid:17)(cid:2)(cid:18)(cid:1)(cid:18)(cid:19)(cid:18)(cid:18)(cid:2)(cid:1)(cid:2)(cid:3,Unknown,9181.0
Unknown,Unknown,9,Unknown,Unknown,Unknown,Unknown,cid:15)(cid:2)(cid:17)(cid:2)(cid:18)(cid:1)(cid:18)(cid:19)(cid:18)(cid:18)(cid:2)(cid:1)(cid:2)(cid:3,Unknown,9190.0
Unknown,Unknown,46,Unknown,Unknown,Unknown,Unknown,cid:15)(cid:2)(cid:17)(cid:2)(cid:18)(cid:1)(cid:18)(cid:19)(cid:18)(cid:18)(cid:2)(cid:1)(cid:2)(cid:3,Unknown,9236.0
Unknown,Unknown,36,Unknown,Unknown,Unknown,Unknown,cid:15)(cid:2)(cid:17)(cid:2)(cid:18)(cid:1)(cid:18)(cid:19)(cid:18)(cid:18)(cid:2)(cid:1)(cid:2)(cid:3,Unknown,9272.0
Unknown,Unknown,2,Unknown,Unknown,Unknown,Unknown,cid:15)(cid:2)(cid:17)(cid:2)(cid:18)(cid:1)(cid:18)(cid:19)(cid:18)(cid:18)(cid:2)(cid:1)(cid:2)(cid:3,Unknown,9274.0
Unknown,Unknown,9,Unknown,Unknown,Unknown,Unknown,cid:15)(cid:2)(cid:17)(cid:2)(cid:18)(cid:1)(cid:18)(cid:19)(cid:18)(cid:18)(cid:2)(cid:1)(cid:2)(cid:3,Unknown,9283.0
Unknown,Unknown,10,Unknown,Unknown,Unknown,Unknown,cid:15)(cid:2)(cid:17)(cid:2)(cid:18)(cid:1)(cid:18)(cid:19)(cid:18)(cid:18)(cid:2)(cid:1)(cid:2)(cid:3,Unknown,9293.0
Unknown,Unknown,2,Unknown,Unknown,Unknown,Unknown,cid:15)(cid:2)(cid:17)(cid:2)(cid:18)(cid:1)(cid:18)(cid:19)(cid:18)(cid:18)(cid:2)(cid:1)(cid:2)(cid:3,Unknown,9295.0
Unknown,Unknown,39,Unknown,Unknown,Unknown,Unknown,cid:15)(cid:2)(cid:17)(cid:2)(cid:18)(cid:1)(cid:18)(cid:19)(cid:18)(cid:18)(cid:2)(cid:1)(cid:2)(cid:3,Unknown,9334.0
Unknown,Unknown,3,Unknown,Unknown,Unknown,Unknown,cid:15)(cid:2)(cid:17)(cid:2)(cid:18)(cid:1)(cid:18)(cid:19)(cid:18)(cid:18)(cid:2)(cid:1)(cid:2)(cid:3,Unknown,9337.0
Unknown,Unknown,7,Unknown,Unknown,Unknown,Unknown,cid:15)(cid:2)(cid:17)(cid:2)(cid:18)(cid:1)(cid:18)(cid:19)(cid:18)(cid:18)(cid:2)(cid:1)(cid:2)(cid:3,Unknown,9344.0
Unknown,Unknown,52,Unknown,Unknown,Unknown,Unknown,cid:15)(cid:2)(cid:17)(cid:2)(cid:18)(cid:1)(cid:18)(cid:19)(cid:18)(cid:18)(cid:2)(cid:1)(cid:2)(cid:3,Unknown,9396.0
Unknown,Unknown,46,Unknown,Unknown,Unknown,Unknown,cid:15)(cid:2)(cid:17)(cid:2)(cid:18)(cid:1)(cid:18)(cid:19)(cid:18)(cid:18)(cid:2)(cid:1)(cid:2)(cid:3,Unknown,9442.0
Unknown,Unknown,10,Unknown,Unknown,Unknown,Unknown,cid:15)(cid:2)(cid:17)(cid:2)(cid:18)(cid:1)(cid:18)(cid:19)(cid:18)(cid:18)(cid:2)(cid:1)(cid:2)(cid:3,Unknown,9452.0
Unknown,Unknown,2,Unknown,Unknown,Unknown,Unknown,cid:15)(cid:2)(cid:17)(cid:2)(cid:18)(cid:1)(cid:18)(cid:19)(cid:18)(cid:18)(cid:2)(cid:1)(cid:2)(cid:3,Unknown,9454.0
Unknown,Unknown,14,Unknown,Unknown,Unknown,Unknown,cid:15)(cid:2)(cid:17)(cid:2)(cid:18)(cid:1)(cid:18)(cid:19)(cid:18)(cid:18)(cid:2)(cid:1)(cid:2)(cid:3,Unknown,9468.0
Unknown,Unknown,46,Unknown,Unknown,Unknown,Unknown,cid:15)(cid:2)(cid:17)(cid:2)(cid:18)(cid:1)(cid:18)(cid:19)(cid:18)(cid:18)(cid:2)(cid:1)(cid:2)(cid:3,Unknown,9514.0
Unknown,Unknown,2,Unknown,Unknown,Unknown,Unknown,cid:15)(cid:2)(cid:17)(cid:2)(cid:18)(cid:1)(cid:18)(cid:19)(cid:18)(cid:18)(cid:2)(cid:1)(cid:2)(cid:3,Unknown,9516.0
Unknown,Unknown,28,Unknown,Unknown,Unknown,Unknown,cid:15)(cid:2)(cid:17)(cid:2)(cid:18)(cid:1)(cid:18)(cid:19)(cid:18)(cid:18)(cid:2)(cid:1)(cid:2)(cid:3,Unknown,9544.0
Unknown,Unknown,3,Unknown,Unknown,Unknown,Unknown,cid:15)(cid:2)(cid:17)(cid:2)(cid:18)(cid:1)(cid:18)(cid:19)(cid:18)(cid:18)(cid:2)(cid:1)(cid:2)(cid:3,Unknown,9547.0
Unknown,Unknown,15,Unknown,Unknown,Unknown,Unknown,cid:15)(cid:2)(cid:17)(cid:2)(cid:18)(cid:1)(cid:18)(cid:19)(cid:18)(cid:18)(cid:2)(cid:1)(cid:2)(cid:3,Unknown,9562.0
Unknown,Unknown,2,Unknown,Unknown,Unknown,Unknown,cid:15)(cid:2)(cid:17)(cid:2)(cid:18)(cid:1)(cid:18)(cid:19)(cid:18)(cid:18)(cid:2)(cid:1)(cid:2)(cid:3,Unknown,9564.0
Unknown,Unknown,1,Unknown,Unknown,Unknown,Unknown,cid:15)(cid:2)(cid:17)(cid:2)(cid:18)(cid:1)(cid:18)(cid:19)(cid:18)(cid:18)(cid:2)(cid:1)(cid:2)(cid:3,Unknown,9565.0
Unknown,Unknown,19,Unknown,Unknown,Unknown,Unknown,cid:15)(cid:2)(cid:17)(cid:2)(cid:18)(cid:1)(cid:18)(cid:19)(cid:18)(cid:18)(cid:2)(cid:1)(cid:2)(cid:3,Unknown,9584.0
Unknown,Unknown,18,Unknown,Unknown,Unknown,Unknown,cid:15)(cid:2)(cid:17)(cid:2)(cid:18)(cid:1)(cid:18)(cid:19)(cid:18)(cid:18)(cid:2)(cid:1)(cid:2)(cid:3,Unknown,9602.0
Unknown,Unknown,18,Unknown,Unknown,Unknown,Unknown,cid:15)(cid:2)(cid:17)(cid:2)(cid:18)(cid:1)(cid:18)(cid:19)(cid:18)(cid:18)(cid:2)(cid:1)(cid:2)(cid:3,Unknown,9620.0
Unknown,Unknown,2,Unknown,Unknown,Unknown,Unknown,cid:15)(cid:2)(cid:17)(cid:2)(cid:18)(cid:1)(cid:18)(cid:19)(cid:18)(cid:18)(cid:2)(cid:1)(cid:2)(cid:3,Unknown,9622.0
Unknown,Unknown,44,Unknown,Unknown,Unknown,Unknown,cid:15)(cid:2)(cid:17)(cid:2)(cid:18)(cid:1)(cid:18)(cid:19)(cid:18)(cid:18)(cid:2)(cid:1)(cid:2)(cid:3,Unknown,9666.0
Unknown,Unknown,12,Unknown,Unknown,Unknown,Unknown,cid:15)(cid:2)(cid:17)(cid:2)(cid:18)(cid:1)(cid:18)(cid:19)(cid:18)(cid:18)(cid:2)(cid:1)(cid:2)(cid:3,Unknown,9678.0
Unknown,Unknown,29,Unknown,Unknown,Unknown,Unknown,cid:15)(cid:2)(cid:17)(cid:2)(cid:18)(cid:1)(cid:18)(cid:19)(cid:18)(cid:18)(cid:2)(cid:1)(cid:2)(cid:3,Unknown,9707.0
Unknown,Unknown,26,Unknown,Unknown,Unknown,Unknown,cid:15)(cid:2)(cid:17)(cid:2)(cid:18)(cid:1)(cid:18)(cid:19)(cid:18)(cid:18)(cid:2)(cid:1)(cid:2)(cid:3,Unknown,9733.0
Unknown,Unknown,41,Unknown,Unknown,Unknown,Unknown,cid:15)(cid:2)(cid:17)(cid:2)(cid:18)(cid:1)(cid:18)(cid:19)(cid:18)(cid:18)(cid:2)(cid:1)(cid:2)(cid:3,Unknown,9774.0
Unknown,Unknown,25,Unknown,Unknown,Unknown,Unknown,cid:15)(cid:2)(cid:17)(cid:2)(cid:18)(cid:1)(cid:18)(cid:19)(cid:18)(cid:18)(cid:2)(cid:1)(cid:2)(cid:3,Unknown,9799.0
Unknown,Unknown,2,Unknown,Unknown,Unknown,Unknown,cid:15)(cid:2)(cid:17)(cid:2)(cid:18)(cid:1)(cid:18)(cid:19)(cid:18)(cid:18)(cid:2)(cid:1)(cid:2)(cid:3,Unknown,9801.0
Unknown,Unknown,50,Unknown,Unknown,Unknown,Unknown,cid:15)(cid:2)(cid:17)(cid:2)(cid:18)(cid:1)(cid:18)(cid:19)(cid:18)(cid:18)(cid:2)(cid:1)(cid:2)(cid:3,Unknown,9851.0
Unknown,Unknown,50,Unknown,Unknown,Unknown,Unknown,cid:15)(cid:2)(cid:17)(cid:2)(cid:18)(cid:1)(cid:18)(cid:19)(cid:18)(cid:18)(cid:2)(cid:1)(cid:2)(cid:3,Unknown,9901.0
Unknown,Unknown,18,Unknown,Unknown,Unknown,Unknown,cid:15)(cid:2)(cid:17)(cid:2)(cid:18)(cid:1)(cid:18)(cid:19)(cid:18)(cid:18)(cid:2)(cid:1)(cid:2)(cid:3,Unknown,9919.0
Unknown,Unknown,1,Unknown,Unknown,Unknown,Unknown,cid:15)(cid:2)(cid:17)(cid:2)(cid:18)(cid:1)(cid:18)(cid:19)(cid:18)(cid:18)(cid:2)(cid:1)(cid:2)(cid:3,Unknown,9920.0
Unknown,Unknown,1,Unknown,Unknown,Unknown,Unknown,cid:15)(cid:2)(cid:17)(cid:2)(cid:18)(cid:1)(cid:18)(cid:19)(cid:18)(cid:18)(cid:2)(cid:1)(cid:2)(cid:3,Unknown,9921.0
Unknown,Unknown,37,Unknown,Unknown,Unknown,Unknown,cid:15)(cid:2)(cid:17)(cid:2)(cid:18)(cid:1)(cid:18)(cid:19)(cid:18)(cid:18)(cid:2)(cid:1)(cid:2)(cid:3,Unknown,9958.0
Unknown,Unknown,37,Unknown,Unknown,Unknown,Unknown,cid:15)(cid:2)(cid:17)(cid:2)(cid:18)(cid:1)(cid:18)(cid:19)(cid:18)(cid:18)(cid:2)(cid:1)(cid:2)(cid:3,Unknown,9995.0
Unknown,Unknown,18,Unknown,Unknown,Unknown,Unknown,cid:15)(cid:2)(cid:17)(cid:2)(cid:18)(cid:1)(cid:18)(cid:19)(cid:18)(cid:18)(cid:2)(cid:1)(cid:2)(cid:3,Unknown,10013.0
Unknown,Unknown,45,Unknown,Unknown,Unknown,Unknown,cid:15)(cid:2)(cid:17)(cid:2)(cid:18)(cid:1)(cid:18)(cid:19)(cid:18)(cid:18)(cid:2)(cid:1)(cid:2)(cid:3,Unknown,10058.0
Unknown,Unknown,18,Unknown,Unknown,Unknown,Unknown,cid:15)(cid:2)(cid:17)(cid:2)(cid:18)(cid:1)(cid:18)(cid:19)(cid:18)(cid:18)(cid:2)(cid:1)(cid:2)(cid:3,Unknown,10076.0
Unknown,Unknown,35,Unknown,Unknown,Unknown,Unknown,cid:15)(cid:2)(cid:17)(cid:2)(cid:18)(cid:1)(cid:18)(cid:19)(cid:18)(cid:18)(cid:2)(cid:1)(cid:2)(cid:3,Unknown,10111.0
Unknown,Unknown,54,Unknown,Unknown,Unknown,Unknown,cid:15)(cid:2)(cid:17)(cid:2)(cid:18)(cid:1)(cid:18)(cid:19)(cid:18)(cid:18)(cid:2)(cid:1)(cid:2)(cid:3,Unknown,10165.0
Unknown,Unknown,46,Unknown,Unknown,Unknown,Unknown,cid:15)(cid:2)(cid:17)(cid:2)(cid:18)(cid:1)(cid:18)(cid:19)(cid:18)(cid:18)(cid:2)(cid:1)(cid:2)(cid:3,Unknown,10211.0
Unknown,Unknown,4,Unknown,Unknown,Unknown,Unknown,cid:15)(cid:2)(cid:17)(cid:2)(cid:18)(cid:1)(cid:18)(cid:19)(cid:18)(cid:18)(cid:2)(cid:1)(cid:2)(cid:3,Unknown,10215.0
Unknown,Unknown,10,Unknown,Unknown,Unknown,Unknown,cid:15)(cid:2)(cid:17)(cid:2)(cid:18)(cid:1)(cid:18)(cid:19)(cid:18)(cid:18)(cid:2)(cid:1)(cid:2)(cid:3,Unknown,10225.0
Unknown,Unknown,9,Unknown,Unknown,Unknown,Unknown,cid:15)(cid:2)(cid:17)(cid:2)(cid:18)(cid:1)(cid:18)(cid:19)(cid:18)(cid:18)(cid:2)(cid:1)(cid:2)(cid:3,Unknown,10234.0
Unknown,Unknown,10,Unknown,Unknown,Unknown,Unknown,cid:15)(cid:2)(cid:17)(cid:2)(cid:18)(cid:1)(cid:18)(cid:19)(cid:18)(cid:18)(cid:2)(cid:1)(cid:2)(cid:3,Unknown,10244.0
Unknown,Unknown,5,Unknown,Unknown,Unknown,Unknown,cid:15)(cid:2)(cid:17)(cid:2)(cid:18)(cid:1)(cid:18)(cid:19)(cid:18)(cid:18)(cid:2)(cid:1)(cid:2)(cid:3,Unknown,10249.0
Unknown,Unknown,14,Unknown,Unknown,Unknown,Unknown,cid:15)(cid:2)(cid:17)(cid:2)(cid:18)(cid:1)(cid:18)(cid:19)(cid:18)(cid:18)(cid:2)(cid:1)(cid:2)(cid:3,Unknown,10263.0
Unknown,Unknown,14,Unknown,Unknown,Unknown,Unknown,cid:15)(cid:2)(cid:17)(cid:2)(cid:18)(cid:1)(cid:18)(cid:19)(cid:18)(cid:18)(cid:2)(cid:1)(cid:2)(cid:3,Unknown,10277.0
Unknown,Unknown,5,Unknown,Unknown,Unknown,Unknown,cid:15)(cid:2)(cid:17)(cid:2)(cid:18)(cid:1)(cid:18)(cid:19)(cid:18)(cid:18)(cid:2)(cid:1)(cid:2)(cid:3,Unknown,10282.0
Unknown,Unknown,2,Unknown,Unknown,Unknown,Unknown,cid:15)(cid:2)(cid:17)(cid:2)(cid:18)(cid:1)(cid:18)(cid:19)(cid:18)(cid:18)(cid:2)(cid:1)(cid:2)(cid:3,Unknown,10284.0
Unknown,Unknown,9,Unknown,Unknown,Unknown,Unknown,cid:15)(cid:2)(cid:17)(cid:2)(cid:18)(cid:1)(cid:18)(cid:19)(cid:18)(cid:18)(cid:2)(cid:1)(cid:2)(cid:3,Unknown,10293.0
Unknown,Unknown,10,Unknown,Unknown,Unknown,Unknown,cid:15)(cid:2)(cid:17)(cid:2)(cid:18)(cid:1)(cid:18)(cid:19)(cid:18)(cid:18)(cid:2)(cid:1)(cid:2)(cid:3,Unknown,10303.0
Unknown,Unknown,2,Unknown,Unknown,Unknown,Unknown,cid:15)(cid:2)(cid:17)(cid:2)(cid:18)(cid:1)(cid:18)(cid:19)(cid:18)(cid:18)(cid:2)(cid:1)(cid:2)(cid:3,Unknown,10305.0
Unknown,Unknown,54,Unknown,Unknown,Unknown,Unknown,cid:15)(cid:2)(cid:17)(cid:2)(cid:18)(cid:1)(cid:18)(cid:19)(cid:18)(cid:18)(cid:2)(cid:1)(cid:2)(cid:3,Unknown,10359.0
Unknown,Unknown,7,Unknown,Unknown,Unknown,Unknown,cid:15)(cid:2)(cid:17)(cid:2)(cid:18)(cid:1)(cid:18)(cid:19)(cid:18)(cid:18)(cid:2)(cid:1)(cid:2)(cid:3,Unknown,10366.0
Unknown,Unknown,12,Unknown,Unknown,Unknown,Unknown,cid:15)(cid:2)(cid:17)(cid:2)(cid:18)(cid:1)(cid:18)(cid:19)(cid:18)(cid:18)(cid:2)(cid:1)(cid:2)(cid:3,Unknown,10378.0
Unknown,Unknown,13,Unknown,Unknown,Unknown,Unknown,cid:15)(cid:2)(cid:17)(cid:2)(cid:18)(cid:1)(cid:18)(cid:19)(cid:18)(cid:18)(cid:2)(cid:1)(cid:2)(cid:3,Unknown,10391.0
Unknown,Unknown,46,Unknown,Unknown,Unknown,Unknown,cid:15)(cid:2)(cid:17)(cid:2)(cid:18)(cid:1)(cid:18)(cid:19)(cid:18)(cid:18)(cid:2)(cid:1)(cid:2)(cid:3,Unknown,10437.0
Unknown,Unknown,5,Unknown,Unknown,Unknown,Unknown,cid:15)(cid:2)(cid:17)(cid:2)(cid:18)(cid:1)(cid:18)(cid:19)(cid:18)(cid:18)(cid:2)(cid:1)(cid:2)(cid:3,Unknown,10442.0
Unknown,Unknown,14,Unknown,Unknown,Unknown,Unknown,cid:15)(cid:2)(cid:17)(cid:2)(cid:18)(cid:1)(cid:18)(cid:19)(cid:18)(cid:18)(cid:2)(cid:1)(cid:2)(cid:3,Unknown,10456.0
Unknown,Unknown,2,Unknown,Unknown,Unknown,Unknown,cid:15)(cid:2)(cid:17)(cid:2)(cid:18)(cid:1)(cid:18)(cid:19)(cid:18)(cid:18)(cid:2)(cid:1)(cid:2)(cid:3,Unknown,10458.0
Unknown,Unknown,9,Unknown,Unknown,Unknown,Unknown,cid:15)(cid:2)(cid:17)(cid:2)(cid:18)(cid:1)(cid:18)(cid:19)(cid:18)(cid:18)(cid:2)(cid:1)(cid:2)(cid:3,Unknown,10467.0
Unknown,Unknown,10,Unknown,Unknown,Unknown,Unknown,cid:15)(cid:2)(cid:17)(cid:2)(cid:18)(cid:1)(cid:18)(cid:19)(cid:18)(cid:18)(cid:2)(cid:1)(cid:2)(cid:3,Unknown,10477.0
Unknown,Unknown,63,Unknown,Unknown,Unknown,Unknown,cid:15)(cid:2)(cid:17)(cid:2)(cid:18)(cid:1)(cid:18)(cid:19)(cid:18)(cid:18)(cid:2)(cid:1)(cid:2)(cid:3,Unknown,10540.0
Unknown,Unknown,54,Unknown,Unknown,Unknown,Unknown,cid:15)(cid:2)(cid:17)(cid:2)(cid:18)(cid:1)(cid:18)(cid:19)(cid:18)(cid:18)(cid:2)(cid:1)(cid:2)(cid:3,Unknown,10594.0
Unknown,Unknown,7,Unknown,Unknown,Unknown,Unknown,cid:15)(cid:2)(cid:17)(cid:2)(cid:18)(cid:1)(cid:18)(cid:19)(cid:18)(cid:18)(cid:2)(cid:1)(cid:2)(cid:3,Unknown,10601.0
Unknown,Unknown,12,Unknown,Unknown,Unknown,Unknown,cid:15)(cid:2)(cid:17)(cid:2)(cid:18)(cid:1)(cid:18)(cid:19)(cid:18)(cid:18)(cid:2)(cid:1)(cid:2)(cid:3,Unknown,10613.0
Unknown,Unknown,13,Unknown,Unknown,Unknown,Unknown,cid:15)(cid:2)(cid:17)(cid:2)(cid:18)(cid:1)(cid:18)(cid:19)(cid:18)(cid:18)(cid:2)(cid:1)(cid:2)(cid:3,Unknown,10626.0
Unknown,Unknown,46,Unknown,Unknown,Unknown,Unknown,cid:15)(cid:2)(cid:17)(cid:2)(cid:18)(cid:1)(cid:18)(cid:19)(cid:18)(cid:18)(cid:2)(cid:1)(cid:2)(cid:3,Unknown,10672.0
Unknown,Unknown,5,Unknown,Unknown,Unknown,Unknown,cid:15)(cid:2)(cid:17)(cid:2)(cid:18)(cid:1)(cid:18)(cid:19)(cid:18)(cid:18)(cid:2)(cid:1)(cid:2)(cid:3,Unknown,10677.0
Unknown,Unknown,14,Unknown,Unknown,Unknown,Unknown,cid:15)(cid:2)(cid:17)(cid:2)(cid:18)(cid:1)(cid:18)(cid:19)(cid:18)(cid:18)(cid:2)(cid:1)(cid:2)(cid:3,Unknown,10691.0
Unknown,Unknown,45,Unknown,Unknown,Unknown,Unknown,cid:15)(cid:2)(cid:17)(cid:2)(cid:18)(cid:1)(cid:18)(cid:19)(cid:18)(cid:18)(cid:2)(cid:1)(cid:2)(cid:3,Unknown,10736.0
Unknown,Unknown,14,Unknown,Unknown,Unknown,Unknown,cid:15)(cid:2)(cid:17)(cid:2)(cid:18)(cid:1)(cid:18)(cid:19)(cid:18)(cid:18)(cid:2)(cid:1)(cid:2)(cid:3,Unknown,10750.0
Unknown,Unknown,4,Unknown,Unknown,Unknown,Unknown,cid:15)(cid:2)(cid:17)(cid:2)(cid:18)(cid:1)(cid:18)(cid:19)(cid:18)(cid:18)(cid:2)(cid:1)(cid:2)(cid:3,Unknown,10754.0
Unknown,Unknown,2,Unknown,Unknown,Unknown,Unknown,cid:15)(cid:2)(cid:17)(cid:2)(cid:18)(cid:1)(cid:18)(cid:19)(cid:18)(cid:18)(cid:2)(cid:1)(cid:2)(cid:3,Unknown,10756.0
Unknown,Unknown,46,Unknown,Unknown,Unknown,Unknown,cid:15)(cid:2)(cid:17)(cid:2)(cid:18)(cid:1)(cid:18)(cid:19)(cid:18)(cid:18)(cid:2)(cid:1)(cid:2)(cid:3,Unknown,10802.0
Unknown,Unknown,10,Unknown,Unknown,Unknown,Unknown,cid:15)(cid:2)(cid:17)(cid:2)(cid:18)(cid:1)(cid:18)(cid:19)(cid:18)(cid:18)(cid:2)(cid:1)(cid:2)(cid:3,Unknown,10812.0
Unknown,Unknown,15,Unknown,Unknown,Unknown,Unknown,cid:15)(cid:2)(cid:17)(cid:2)(cid:18)(cid:1)(cid:18)(cid:19)(cid:18)(cid:18)(cid:2)(cid:1)(cid:2)(cid:3,Unknown,10827.0
Unknown,Unknown,2,Unknown,Unknown,Unknown,Unknown,cid:15)(cid:2)(cid:17)(cid:2)(cid:18)(cid:1)(cid:18)(cid:19)(cid:18)(cid:18)(cid:2)(cid:1)(cid:2)(cid:3,Unknown,10829.0
Unknown,Unknown,17,Unknown,Unknown,Unknown,Unknown,cid:15)(cid:2)(cid:17)(cid:2)(cid:18)(cid:1)(cid:18)(cid:19)(cid:18)(cid:18)(cid:2)(cid:1)(cid:2)(cid:3,Unknown,10846.0
Unknown,Unknown,1,Unknown,Unknown,Unknown,Unknown,cid:15)(cid:2)(cid:17)(cid:2)(cid:18)(cid:1)(cid:18)(cid:19)(cid:18)(cid:18)(cid:2)(cid:1)(cid:2)(cid:3,Unknown,10847.0
Unknown,Unknown,19,Unknown,Unknown,Unknown,Unknown,cid:15)(cid:2)(cid:17)(cid:2)(cid:18)(cid:1)(cid:18)(cid:19)(cid:18)(cid:18)(cid:2)(cid:1)(cid:2)(cid:3,Unknown,10866.0
Unknown,Unknown,34,Unknown,Unknown,Unknown,Unknown,cid:15)(cid:2)(cid:17)(cid:2)(cid:18)(cid:1)(cid:18)(cid:19)(cid:18)(cid:18)(cid:2)(cid:1)(cid:2)(cid:3,Unknown,10900.0
Unknown,Unknown,18,Unknown,Unknown,Unknown,Unknown,cid:15)(cid:2)(cid:17)(cid:2)(cid:18)(cid:1)(cid:18)(cid:19)(cid:18)(cid:18)(cid:2)(cid:1)(cid:2)(cid:3,Unknown,10918.0
Unknown,Unknown,2,Unknown,Unknown,Unknown,Unknown,cid:15)(cid:2)(cid:17)(cid:2)(cid:18)(cid:1)(cid:18)(cid:19)(cid:18)(cid:18)(cid:2)(cid:1)(cid:2)(cid:3,Unknown,10920.0
Unknown,Unknown,44,Unknown,Unknown,Unknown,Unknown,cid:15)(cid:2)(cid:17)(cid:2)(cid:18)(cid:1)(cid:18)(cid:19)(cid:18)(cid:18)(cid:2)(cid:1)(cid:2)(cid:3,Unknown,10964.0
Unknown,Unknown,12,Unknown,Unknown,Unknown,Unknown,cid:15)(cid:2)(cid:17)(cid:2)(cid:18)(cid:1)(cid:18)(cid:19)(cid:18)(cid:18)(cid:2)(cid:1)(cid:2)(cid:3,Unknown,10976.0
Unknown,Unknown,29,Unknown,Unknown,Unknown,Unknown,cid:15)(cid:2)(cid:17)(cid:2)(cid:18)(cid:1)(cid:18)(cid:19)(cid:18)(cid:18)(cid:2)(cid:1)(cid:2)(cid:3,Unknown,11005.0
Unknown,Unknown,26,Unknown,Unknown,Unknown,Unknown,cid:15)(cid:2)(cid:17)(cid:2)(cid:18)(cid:1)(cid:18)(cid:19)(cid:18)(cid:18)(cid:2)(cid:1)(cid:2)(cid:3,Unknown,11031.0
Unknown,Unknown,41,Unknown,Unknown,Unknown,Unknown,cid:15)(cid:2)(cid:17)(cid:2)(cid:18)(cid:1)(cid:18)(cid:19)(cid:18)(cid:18)(cid:2)(cid:1)(cid:2)(cid:3,Unknown,11072.0
Unknown,Unknown,25,Unknown,Unknown,Unknown,Unknown,cid:15)(cid:2)(cid:17)(cid:2)(cid:18)(cid:1)(cid:18)(cid:19)(cid:18)(cid:18)(cid:2)(cid:1)(cid:2)(cid:3,Unknown,11097.0
Unknown,Unknown,2,Unknown,Unknown,Unknown,Unknown,cid:15)(cid:2)(cid:17)(cid:2)(cid:18)(cid:1)(cid:18)(cid:19)(cid:18)(cid:18)(cid:2)(cid:1)(cid:2)(cid:3,Unknown,11099.0
Unknown,Unknown,50,Unknown,Unknown,Unknown,Unknown,cid:15)(cid:2)(cid:17)(cid:2)(cid:18)(cid:1)(cid:18)(cid:19)(cid:18)(cid:18)(cid:2)(cid:1)(cid:2)(cid:3,Unknown,11149.0
Unknown,Unknown,50,Unknown,Unknown,Unknown,Unknown,cid:15)(cid:2)(cid:17)(cid:2)(cid:18)(cid:1)(cid:18)(cid:19)(cid:18)(cid:18)(cid:2)(cid:1)(cid:2)(cid:3,Unknown,11199.0
Unknown,Unknown,18,Unknown,Unknown,Unknown,Unknown,cid:15)(cid:2)(cid:17)(cid:2)(cid:18)(cid:1)(cid:18)(cid:19)(cid:18)(cid:18)(cid:2)(cid:1)(cid:2)(cid:3,Unknown,11217.0
Unknown,Unknown,1,Unknown,Unknown,Unknown,Unknown,cid:15)(cid:2)(cid:17)(cid:2)(cid:18)(cid:1)(cid:18)(cid:19)(cid:18)(cid:18)(cid:2)(cid:1)(cid:2)(cid:3,Unknown,11218.0
Unknown,Unknown,1,Unknown,Unknown,Unknown,Unknown,cid:15)(cid:2)(cid:17)(cid:2)(cid:18)(cid:1)(cid:18)(cid:19)(cid:18)(cid:18)(cid:2)(cid:1)(cid:2)(cid:3,Unknown,11219.0
Unknown,Unknown,37,Unknown,Unknown,Unknown,Unknown,cid:15)(cid:2)(cid:17)(cid:2)(cid:18)(cid:1)(cid:18)(cid:19)(cid:18)(cid:18)(cid:2)(cid:1)(cid:2)(cid:3,Unknown,11256.0
Unknown,Unknown,37,Unknown,Unknown,Unknown,Unknown,cid:15)(cid:2)(cid:17)(cid:2)(cid:18)(cid:1)(cid:18)(cid:19)(cid:18)(cid:18)(cid:2)(cid:1)(cid:2)(cid:3,Unknown,11293.0
Unknown,Unknown,17,Unknown,Unknown,Unknown,Unknown,cid:15)(cid:2)(cid:17)(cid:2)(cid:18)(cid:1)(cid:18)(cid:19)(cid:18)(cid:18)(cid:2)(cid:1)(cid:2)(cid:3,Unknown,11310.0
Unknown,Unknown,45,Unknown,Unknown,Unknown,Unknown,cid:15)(cid:2)(cid:17)(cid:2)(cid:18)(cid:1)(cid:18)(cid:19)(cid:18)(cid:18)(cid:2)(cid:1)(cid:2)(cid:3,Unknown,11355.0
Unknown,Unknown,18,Unknown,Unknown,Unknown,Unknown,cid:15)(cid:2)(cid:17)(cid:2)(cid:18)(cid:1)(cid:18)(cid:19)(cid:18)(cid:18)(cid:2)(cid:1)(cid:2)(cid:3,Unknown,11373.0
Unknown,Unknown,35,Unknown,Unknown,Unknown,Unknown,cid:15)(cid:2)(cid:17)(cid:2)(cid:18)(cid:1)(cid:18)(cid:19)(cid:18)(cid:18)(cid:2)(cid:1)(cid:2)(cid:3,Unknown,11408.0
Unknown,Unknown,65,Unknown,Unknown,Unknown,Unknown,cid:15)(cid:2)(cid:17)(cid:2)(cid:18)(cid:1)(cid:18)(cid:19)(cid:18)(cid:18)(cid:2)(cid:1)(cid:2)(cid:3,Unknown,11473.0
Unknown,Unknown,39,Unknown,Unknown,Unknown,Unknown,cid:15)(cid:2)(cid:17)(cid:2)(cid:18)(cid:1)(cid:18)(cid:19)(cid:18)(cid:18)(cid:2)(cid:1)(cid:2)(cid:3,Unknown,11512.0
Unknown,Unknown,2,Unknown,Unknown,Unknown,Unknown,cid:15)(cid:2)(cid:17)(cid:2)(cid:18)(cid:1)(cid:18)(cid:19)(cid:18)(cid:18)(cid:2)(cid:1)(cid:2)(cid:3,Unknown,11514.0
Unknown,Unknown,39,Unknown,Unknown,Unknown,Unknown,cid:15)(cid:2)(cid:17)(cid:2)(cid:18)(cid:1)(cid:18)(cid:19)(cid:18)(cid:18)(cid:2)(cid:1)(cid:2)(cid:3,Unknown,11553.0
Unknown,Unknown,4,Unknown,Unknown,Unknown,Unknown,cid:15)(cid:2)(cid:17)(cid:2)(cid:18)(cid:1)(cid:18)(cid:19)(cid:18)(cid:18)(cid:2)(cid:1)(cid:2)(cid:3,Unknown,11557.0
Unknown,Unknown,10,Unknown,Unknown,Unknown,Unknown,cid:15)(cid:2)(cid:17)(cid:2)(cid:18)(cid:1)(cid:18)(cid:19)(cid:18)(cid:18)(cid:2)(cid:1)(cid:2)(cid:3,Unknown,11567.0
Unknown,Unknown,5,Unknown,Unknown,Unknown,Unknown,cid:15)(cid:2)(cid:17)(cid:2)(cid:18)(cid:1)(cid:18)(cid:19)(cid:18)(cid:18)(cid:2)(cid:1)(cid:2)(cid:3,Unknown,11572.0
Unknown,Unknown,52,Unknown,Unknown,Unknown,Unknown,cid:15)(cid:2)(cid:17)(cid:2)(cid:18)(cid:1)(cid:18)(cid:19)(cid:18)(cid:18)(cid:2)(cid:1)(cid:2)(cid:3,Unknown,11624.0
Unknown,Unknown,7,Unknown,Unknown,Unknown,Unknown,cid:15)(cid:2)(cid:17)(cid:2)(cid:18)(cid:1)(cid:18)(cid:19)(cid:18)(cid:18)(cid:2)(cid:1)(cid:2)(cid:3,Unknown,11631.0
Unknown,Unknown,2,Unknown,Unknown,Unknown,Unknown,cid:15)(cid:2)(cid:17)(cid:2)(cid:18)(cid:1)(cid:18)(cid:19)(cid:18)(cid:18)(cid:2)(cid:1)(cid:2)(cid:3,Unknown,11633.0
Unknown,Unknown,9,Unknown,Unknown,Unknown,Unknown,cid:15)(cid:2)(cid:17)(cid:2)(cid:18)(cid:1)(cid:18)(cid:19)(cid:18)(cid:18)(cid:2)(cid:1)(cid:2)(cid:3,Unknown,11642.0
Unknown,Unknown,7,Unknown,Unknown,Unknown,Unknown,cid:15)(cid:2)(cid:17)(cid:2)(cid:18)(cid:1)(cid:18)(cid:19)(cid:18)(cid:18)(cid:2)(cid:1)(cid:2)(cid:3,Unknown,11649.0
Unknown,Unknown,49,Unknown,Unknown,Unknown,Unknown,cid:15)(cid:2)(cid:17)(cid:2)(cid:18)(cid:1)(cid:18)(cid:19)(cid:18)(cid:18)(cid:2)(cid:1)(cid:2)(cid:3,Unknown,11698.0
Unknown,Unknown,2,Unknown,Unknown,Unknown,Unknown,cid:15)(cid:2)(cid:17)(cid:2)(cid:18)(cid:1)(cid:18)(cid:19)(cid:18)(cid:18)(cid:2)(cid:1)(cid:2)(cid:3,Unknown,11700.0
Unknown,Unknown,37,Unknown,Unknown,Unknown,Unknown,cid:15)(cid:2)(cid:17)(cid:2)(cid:18)(cid:1)(cid:18)(cid:19)(cid:18)(cid:18)(cid:2)(cid:1)(cid:2)(cid:3,Unknown,11737.0
Unknown,Unknown,2,Unknown,Unknown,Unknown,Unknown,cid:15)(cid:2)(cid:17)(cid:2)(cid:18)(cid:1)(cid:18)(cid:19)(cid:18)(cid:18)(cid:2)(cid:1)(cid:2)(cid:3,Unknown,11739.0
Unknown,Unknown,9,Unknown,Unknown,Unknown,Unknown,cid:15)(cid:2)(cid:17)(cid:2)(cid:18)(cid:1)(cid:18)(cid:19)(cid:18)(cid:18)(cid:2)(cid:1)(cid:2)(cid:3,Unknown,11748.0
Unknown,Unknown,7,Unknown,Unknown,Unknown,Unknown,cid:15)(cid:2)(cid:17)(cid:2)(cid:18)(cid:1)(cid:18)(cid:19)(cid:18)(cid:18)(cid:2)(cid:1)(cid:2)(cid:3,Unknown,11755.0
Unknown,Unknown,49,Unknown,Unknown,Unknown,Unknown,cid:15)(cid:2)(cid:17)(cid:2)(cid:18)(cid:1)(cid:18)(cid:19)(cid:18)(cid:18)(cid:2)(cid:1)(cid:2)(cid:3,Unknown,11804.0
Unknown,Unknown,2,Unknown,Unknown,Unknown,Unknown,cid:15)(cid:2)(cid:17)(cid:2)(cid:18)(cid:1)(cid:18)(cid:19)(cid:18)(cid:18)(cid:2)(cid:1)(cid:2)(cid:3,Unknown,11806.0
Unknown,Unknown,3,Unknown,Unknown,Unknown,Unknown,cid:15)(cid:2)(cid:17)(cid:2)(cid:18)(cid:1)(cid:18)(cid:19)(cid:18)(cid:18)(cid:2)(cid:1)(cid:2)(cid:3,Unknown,11809.0
Unknown,Unknown,9,Unknown,Unknown,Unknown,Unknown,cid:15)(cid:2)(cid:17)(cid:2)(cid:18)(cid:1)(cid:18)(cid:19)(cid:18)(cid:18)(cid:2)(cid:1)(cid:2)(cid:3,Unknown,11818.0
Unknown,Unknown,15,Unknown,Unknown,Unknown,Unknown,cid:15)(cid:2)(cid:17)(cid:2)(cid:18)(cid:1)(cid:18)(cid:19)(cid:18)(cid:18)(cid:2)(cid:1)(cid:2)(cid:3,Unknown,11833.0
Unknown,Unknown,2,Unknown,Unknown,Unknown,Unknown,cid:15)(cid:2)(cid:17)(cid:2)(cid:18)(cid:1)(cid:18)(cid:19)(cid:18)(cid:18)(cid:2)(cid:1)(cid:2)(cid:3,Unknown,11835.0
Unknown,Unknown,37,Unknown,Unknown,Unknown,Unknown,cid:15)(cid:2)(cid:17)(cid:2)(cid:18)(cid:1)(cid:18)(cid:19)(cid:18)(cid:18)(cid:2)(cid:1)(cid:2)(cid:3,Unknown,11872.0
Unknown,Unknown,19,Unknown,Unknown,Unknown,Unknown,cid:15)(cid:2)(cid:17)(cid:2)(cid:18)(cid:1)(cid:18)(cid:19)(cid:18)(cid:18)(cid:2)(cid:1)(cid:2)(cid:3,Unknown,11891.0
Unknown,Unknown,34,Unknown,Unknown,Unknown,Unknown,cid:15)(cid:2)(cid:17)(cid:2)(cid:18)(cid:1)(cid:18)(cid:19)(cid:18)(cid:18)(cid:2)(cid:1)(cid:2)(cid:3,Unknown,11925.0
Unknown,Unknown,35,Unknown,Unknown,Unknown,Unknown,cid:15)(cid:2)(cid:17)(cid:2)(cid:18)(cid:1)(cid:18)(cid:19)(cid:18)(cid:18)(cid:2)(cid:1)(cid:2)(cid:3,Unknown,11960.0
Unknown,Unknown,2,Unknown,Unknown,Unknown,Unknown,cid:15)(cid:2)(cid:17)(cid:2)(cid:18)(cid:1)(cid:18)(cid:19)(cid:18)(cid:18)(cid:2)(cid:1)(cid:2)(cid:3,Unknown,11962.0
Unknown,Unknown,44,Unknown,Unknown,Unknown,Unknown,cid:15)(cid:2)(cid:17)(cid:2)(cid:18)(cid:1)(cid:18)(cid:19)(cid:18)(cid:18)(cid:2)(cid:1)(cid:2)(cid:3,Unknown,12006.0
Unknown,Unknown,17,Unknown,Unknown,Unknown,Unknown,cid:15)(cid:2)(cid:17)(cid:2)(cid:18)(cid:1)(cid:18)(cid:19)(cid:18)(cid:18)(cid:2)(cid:1)(cid:2)(cid:3,Unknown,12023.0
Unknown,Unknown,17,Unknown,Unknown,Unknown,Unknown,cid:15)(cid:2)(cid:17)(cid:2)(cid:18)(cid:1)(cid:18)(cid:19)(cid:18)(cid:18)(cid:2)(cid:1)(cid:2)(cid:3,Unknown,12040.0
Unknown,Unknown,16,Unknown,Unknown,Unknown,Unknown,cid:15)(cid:2)(cid:17)(cid:2)(cid:18)(cid:1)(cid:18)(cid:19)(cid:18)(cid:18)(cid:2)(cid:1)(cid:2)(cid:3,Unknown,12056.0
Unknown,Unknown,19,Unknown,Unknown,Unknown,Unknown,cid:15)(cid:2)(cid:17)(cid:2)(cid:18)(cid:1)(cid:18)(cid:19)(cid:18)(cid:18)(cid:2)(cid:1)(cid:2)(cid:3,Unknown,12075.0
Unknown,Unknown,37,Unknown,Unknown,Unknown,Unknown,cid:15)(cid:2)(cid:17)(cid:2)(cid:18)(cid:1)(cid:18)(cid:19)(cid:18)(cid:18)(cid:2)(cid:1)(cid:2)(cid:3,Unknown,12112.0
Unknown,Unknown,17,Unknown,Unknown,Unknown,Unknown,cid:15)(cid:2)(cid:17)(cid:2)(cid:18)(cid:1)(cid:18)(cid:19)(cid:18)(cid:18)(cid:2)(cid:1)(cid:2)(cid:3,Unknown,12129.0
Unknown,Unknown,35,Unknown,Unknown,Unknown,Unknown,cid:15)(cid:2)(cid:17)(cid:2)(cid:18)(cid:1)(cid:18)(cid:19)(cid:18)(cid:18)(cid:2)(cid:1)(cid:2)(cid:3,Unknown,12164.0
Unknown,Unknown,36,Unknown,Unknown,Unknown,Unknown,cid:15)(cid:2)(cid:17)(cid:2)(cid:18)(cid:1)(cid:18)(cid:19)(cid:18)(cid:18)(cid:2)(cid:1)(cid:2)(cid:3,Unknown,12200.0
Unknown,Unknown,37,Unknown,Unknown,Unknown,Unknown,cid:15)(cid:2)(cid:17)(cid:2)(cid:18)(cid:1)(cid:18)(cid:19)(cid:18)(cid:18)(cid:2)(cid:1)(cid:2)(cid:3,Unknown,12237.0
Unknown,Unknown,34,Unknown,Unknown,Unknown,Unknown,cid:15)(cid:2)(cid:17)(cid:2)(cid:18)(cid:1)(cid:18)(cid:19)(cid:18)(cid:18)(cid:2)(cid:1)(cid:2)(cid:3,Unknown,12271.0
Unknown,Unknown,16,Unknown,Unknown,Unknown,Unknown,cid:15)(cid:2)(cid:17)(cid:2)(cid:18)(cid:1)(cid:18)(cid:19)(cid:18)(cid:18)(cid:2)(cid:1)(cid:2)(cid:3,Unknown,12287.0
Unknown,Unknown,34,Unknown,Unknown,Unknown,Unknown,cid:15)(cid:2)(cid:17)(cid:2)(cid:18)(cid:1)(cid:18)(cid:19)(cid:18)(cid:18)(cid:2)(cid:1)(cid:2)(cid:3,Unknown,12321.0
Unknown,Unknown,36,Unknown,Unknown,Unknown,Unknown,cid:15)(cid:2)(cid:17)(cid:2)(cid:18)(cid:1)(cid:18)(cid:19)(cid:18)(cid:18)(cid:2)(cid:1)(cid:2)(cid:3,Unknown,12357.0
Unknown,Unknown,17,Unknown,Unknown,Unknown,Unknown,cid:15)(cid:2)(cid:17)(cid:2)(cid:18)(cid:1)(cid:18)(cid:19)(cid:18)(cid:18)(cid:2)(cid:1)(cid:2)(cid:3,Unknown,12374.0
Unknown,Unknown,33,Unknown,Unknown,Unknown,Unknown,cid:15)(cid:2)(cid:17)(cid:2)(cid:18)(cid:1)(cid:18)(cid:19)(cid:18)(cid:18)(cid:2)(cid:1)(cid:2)(cid:3,Unknown,12407.0
Unknown,Unknown,2,Unknown,Unknown,Unknown,Unknown,cid:15)(cid:2)(cid:17)(cid:2)(cid:18)(cid:1)(cid:18)(cid:19)(cid:18)(cid:18)(cid:2)(cid:1)(cid:2)(cid:3,Unknown,12409.0
Unknown,Unknown,1,Unknown,Unknown,Unknown,Unknown,cid:15)(cid:2)(cid:17)(cid:2)(cid:18)(cid:1)(cid:18)(cid:19)(cid:18)(cid:18)(cid:2)(cid:1)(cid:2)(cid:3,Unknown,12410.0
Unknown,Unknown,2,Unknown,Unknown,Unknown,Unknown,cid:15)(cid:2)(cid:17)(cid:2)(cid:18)(cid:1)(cid:18)(cid:19)(cid:18)(cid:18)(cid:2)(cid:1)(cid:2)(cid:3,Unknown,12412.0
Unknown,Unknown,3,Unknown,Unknown,Unknown,Unknown,cid:15)(cid:2)(cid:17)(cid:2)(cid:18)(cid:1)(cid:18)(cid:19)(cid:18)(cid:18)(cid:2)(cid:1)(cid:2)(cid:3,Unknown,12415.0
Unknown,Unknown,2,Unknown,Unknown,Unknown,Unknown,cid:15)(cid:2)(cid:17)(cid:2)(cid:18)(cid:1)(cid:18)(cid:19)(cid:18)(cid:18)(cid:2)(cid:1)(cid:2)(cid:3,Unknown,12417.0
Unknown,Unknown,73,Unknown,Unknown,Unknown,Unknown,cid:15)(cid:2)(cid:17)(cid:2)(cid:18)(cid:1)(cid:18)(cid:19)(cid:18)(cid:18)(cid:2)(cid:1)(cid:2)(cid:3,Unknown,12490.0
Unknown,Unknown,2,Unknown,Unknown,Unknown,Unknown,cid:15)(cid:2)(cid:17)(cid:2)(cid:18)(cid:1)(cid:18)(cid:19)(cid:18)(cid:18)(cid:2)(cid:1)(cid:2)(cid:3,Unknown,12492.0
Unknown,Unknown,17,Unknown,Unknown,Unknown,Unknown,cid:15)(cid:2)(cid:17)(cid:2)(cid:18)(cid:1)(cid:18)(cid:19)(cid:18)(cid:18)(cid:2)(cid:1)(cid:2)(cid:3,Unknown,12509.0
Unknown,Unknown,19,Unknown,Unknown,Unknown,Unknown,cid:15)(cid:2)(cid:17)(cid:2)(cid:18)(cid:1)(cid:18)(cid:19)(cid:18)(cid:18)(cid:2)(cid:1)(cid:2)(cid:3,Unknown,12528.0
Unknown,Unknown,18,Unknown,Unknown,Unknown,Unknown,cid:15)(cid:2)(cid:17)(cid:2)(cid:18)(cid:1)(cid:18)(cid:19)(cid:18)(cid:18)(cid:2)(cid:1)(cid:2)(cid:3,Unknown,12546.0
Unknown,Unknown,18,Unknown,Unknown,Unknown,Unknown,cid:15)(cid:2)(cid:17)(cid:2)(cid:18)(cid:1)(cid:18)(cid:19)(cid:18)(cid:18)(cid:2)(cid:1)(cid:2)(cid:3,Unknown,12564.0
Unknown,Unknown,2,Unknown,Unknown,Unknown,Unknown,cid:15)(cid:2)(cid:17)(cid:2)(cid:18)(cid:1)(cid:18)(cid:19)(cid:18)(cid:18)(cid:2)(cid:1)(cid:2)(cid:3,Unknown,12566.0
Unknown,Unknown,44,Unknown,Unknown,Unknown,Unknown,cid:15)(cid:2)(cid:17)(cid:2)(cid:18)(cid:1)(cid:18)(cid:19)(cid:18)(cid:18)(cid:2)(cid:1)(cid:2)(cid:3,Unknown,12610.0
Unknown,Unknown,15,Unknown,Unknown,Unknown,Unknown,cid:15)(cid:2)(cid:17)(cid:2)(cid:18)(cid:1)(cid:18)(cid:19)(cid:18)(cid:18)(cid:2)(cid:1)(cid:2)(cid:3,Unknown,12625.0
Unknown,Unknown,2,Unknown,Unknown,Unknown,Unknown,cid:15)(cid:2)(cid:17)(cid:2)(cid:18)(cid:1)(cid:18)(cid:19)(cid:18)(cid:18)(cid:2)(cid:1)(cid:2)(cid:3,Unknown,12627.0
Unknown,Unknown,36,Unknown,Unknown,Unknown,Unknown,cid:15)(cid:2)(cid:17)(cid:2)(cid:18)(cid:1)(cid:18)(cid:19)(cid:18)(cid:18)(cid:2)(cid:1)(cid:2)(cid:3,Unknown,12663.0
Unknown,Unknown,1,Unknown,Unknown,Unknown,Unknown,cid:15)(cid:2)(cid:17)(cid:2)(cid:18)(cid:1)(cid:18)(cid:19)(cid:18)(cid:18)(cid:2)(cid:1)(cid:2)(cid:3,Unknown,12664.0
Unknown,Unknown,18,Unknown,Unknown,Unknown,Unknown,cid:15)(cid:2)(cid:17)(cid:2)(cid:18)(cid:1)(cid:18)(cid:19)(cid:18)(cid:18)(cid:2)(cid:1)(cid:2)(cid:3,Unknown,12682.0
Unknown,Unknown,19,Unknown,Unknown,Unknown,Unknown,cid:15)(cid:2)(cid:17)(cid:2)(cid:18)(cid:1)(cid:18)(cid:19)(cid:18)(cid:18)(cid:2)(cid:1)(cid:2)(cid:3,Unknown,12701.0
Unknown,Unknown,18,Unknown,Unknown,Unknown,Unknown,cid:15)(cid:2)(cid:17)(cid:2)(cid:18)(cid:1)(cid:18)(cid:19)(cid:18)(cid:18)(cid:2)(cid:1)(cid:2)(cid:3,Unknown,12719.0
Unknown,Unknown,18,Unknown,Unknown,Unknown,Unknown,cid:15)(cid:2)(cid:17)(cid:2)(cid:18)(cid:1)(cid:18)(cid:19)(cid:18)(cid:18)(cid:2)(cid:1)(cid:2)(cid:3,Unknown,12737.0
Unknown,Unknown,2,Unknown,Unknown,Unknown,Unknown,cid:15)(cid:2)(cid:17)(cid:2)(cid:18)(cid:1)(cid:18)(cid:19)(cid:18)(cid:18)(cid:2)(cid:1)(cid:2)(cid:3,Unknown,12739.0
Unknown,Unknown,1,Unknown,Unknown,Unknown,Unknown,cid:15)(cid:2)(cid:17)(cid:2)(cid:18)(cid:1)(cid:18)(cid:19)(cid:18)(cid:18)(cid:2)(cid:1)(cid:2)(cid:3,Unknown,12740.0
Unknown,Unknown,2,Unknown,Unknown,Unknown,Unknown,cid:15)(cid:2)(cid:17)(cid:2)(cid:18)(cid:1)(cid:18)(cid:19)(cid:18)(cid:18)(cid:2)(cid:1)(cid:2)(cid:3,Unknown,12742.0
Unknown,Unknown,3,Unknown,Unknown,Unknown,Unknown,cid:15)(cid:2)(cid:17)(cid:2)(cid:18)(cid:1)(cid:18)(cid:19)(cid:18)(cid:18)(cid:2)(cid:1)(cid:2)(cid:3,Unknown,12745.0
Unknown,Unknown,12,Unknown,Unknown,Unknown,Unknown,cid:15)(cid:2)(cid:17)(cid:2)(cid:18)(cid:1)(cid:18)(cid:19)(cid:18)(cid:18)(cid:2)(cid:1)(cid:2)(cid:3,Unknown,12757.0
Unknown,Unknown,29,Unknown,Unknown,Unknown,Unknown,cid:15)(cid:2)(cid:17)(cid:2)(cid:18)(cid:1)(cid:18)(cid:19)(cid:18)(cid:18)(cid:2)(cid:1)(cid:2)(cid:3,Unknown,12786.0
Unknown,Unknown,26,Unknown,Unknown,Unknown,Unknown,cid:15)(cid:2)(cid:17)(cid:2)(cid:18)(cid:1)(cid:18)(cid:19)(cid:18)(cid:18)(cid:2)(cid:1)(cid:2)(cid:3,Unknown,12812.0
Unknown,Unknown,41,Unknown,Unknown,Unknown,Unknown,cid:15)(cid:2)(cid:17)(cid:2)(cid:18)(cid:1)(cid:18)(cid:19)(cid:18)(cid:18)(cid:2)(cid:1)(cid:2)(cid:3,Unknown,12853.0
Unknown,Unknown,25,Unknown,Unknown,Unknown,Unknown,cid:15)(cid:2)(cid:17)(cid:2)(cid:18)(cid:1)(cid:18)(cid:19)(cid:18)(cid:18)(cid:2)(cid:1)(cid:2)(cid:3,Unknown,12878.0
Unknown,Unknown,2,Unknown,Unknown,Unknown,Unknown,cid:15)(cid:2)(cid:17)(cid:2)(cid:18)(cid:1)(cid:18)(cid:19)(cid:18)(cid:18)(cid:2)(cid:1)(cid:2)(cid:3,Unknown,12880.0
Unknown,Unknown,50,Unknown,Unknown,Unknown,Unknown,cid:15)(cid:2)(cid:17)(cid:2)(cid:18)(cid:1)(cid:18)(cid:19)(cid:18)(cid:18)(cid:2)(cid:1)(cid:2)(cid:3,Unknown,12930.0
Unknown,Unknown,50,Unknown,Unknown,Unknown,Unknown,cid:15)(cid:2)(cid:17)(cid:2)(cid:18)(cid:1)(cid:18)(cid:19)(cid:18)(cid:18)(cid:2)(cid:1)(cid:2)(cid:3,Unknown,12980.0
Unknown,Unknown,18,Unknown,Unknown,Unknown,Unknown,cid:15)(cid:2)(cid:17)(cid:2)(cid:18)(cid:1)(cid:18)(cid:19)(cid:18)(cid:18)(cid:2)(cid:1)(cid:2)(cid:3,Unknown,12998.0
Unknown,Unknown,1,Unknown,Unknown,Unknown,Unknown,cid:15)(cid:2)(cid:17)(cid:2)(cid:18)(cid:1)(cid:18)(cid:19)(cid:18)(cid:18)(cid:2)(cid:1)(cid:2)(cid:3,Unknown,12999.0
Unknown,Unknown,1,Unknown,Unknown,Unknown,Unknown,cid:15)(cid:2)(cid:17)(cid:2)(cid:18)(cid:1)(cid:18)(cid:19)(cid:18)(cid:18)(cid:2)(cid:1)(cid:2)(cid:3,Unknown,13000.0
Unknown,Unknown,37,Unknown,Unknown,Unknown,Unknown,cid:15)(cid:2)(cid:17)(cid:2)(cid:18)(cid:1)(cid:18)(cid:19)(cid:18)(cid:18)(cid:2)(cid:1)(cid:2)(cid:3,Unknown,13037.0
Unknown,Unknown,37,Unknown,Unknown,Unknown,Unknown,cid:15)(cid:2)(cid:17)(cid:2)(cid:18)(cid:1)(cid:18)(cid:19)(cid:18)(cid:18)(cid:2)(cid:1)(cid:2)(cid:3,Unknown,13074.0
Unknown,Unknown,17,Unknown,Unknown,Unknown,Unknown,cid:15)(cid:2)(cid:17)(cid:2)(cid:18)(cid:1)(cid:18)(cid:19)(cid:18)(cid:18)(cid:2)(cid:1)(cid:2)(cid:3,Unknown,13091.0
Unknown,Unknown,45,Unknown,Unknown,Unknown,Unknown,cid:15)(cid:2)(cid:17)(cid:2)(cid:18)(cid:1)(cid:18)(cid:19)(cid:18)(cid:18)(cid:2)(cid:1)(cid:2)(cid:3,Unknown,13136.0
Unknown,Unknown,18,Unknown,Unknown,Unknown,Unknown,cid:15)(cid:2)(cid:17)(cid:2)(cid:18)(cid:1)(cid:18)(cid:19)(cid:18)(cid:18)(cid:2)(cid:1)(cid:2)(cid:3,Unknown,13154.0
Unknown,Unknown,35,Unknown,Unknown,Unknown,Unknown,cid:15)(cid:2)(cid:17)(cid:2)(cid:18)(cid:1)(cid:18)(cid:19)(cid:18)(cid:18)(cid:2)(cid:1)(cid:2)(cid:3,Unknown,13189.0
Unknown,Unknown,11,Unknown,Unknown,Unknown,Unknown,cid:15)(cid:2)(cid:17)(cid:2)(cid:18)(cid:1)(cid:18)(cid:19)(cid:18)(cid:18)(cid:2)(cid:1)(cid:2)(cid:3,Unknown,13200.0
Unknown,Unknown,3,Unknown,Unknown,Unknown,Unknown,cid:15)(cid:2)(cid:17)(cid:2)(cid:18)(cid:1)(cid:18)(cid:19)(cid:18)(cid:18)(cid:2)(cid:1)(cid:2)(cid:3,Unknown,13203.0
Unknown,Unknown,46,Unknown,Unknown,Unknown,Unknown,cid:15)(cid:2)(cid:17)(cid:2)(cid:18)(cid:1)(cid:18)(cid:19)(cid:18)(cid:18)(cid:2)(cid:1)(cid:2)(cid:3,Unknown,13249.0
Unknown,Unknown,8,Unknown,Unknown,Unknown,Unknown,cid:15)(cid:2)(cid:17)(cid:2)(cid:18)(cid:1)(cid:18)(cid:19)(cid:18)(cid:18)(cid:2)(cid:1)(cid:2)(cid:3,Unknown,13257.0
Unknown,Unknown,53,Unknown,Unknown,Unknown,Unknown,cid:15)(cid:2)(cid:17)(cid:2)(cid:18)(cid:1)(cid:18)(cid:19)(cid:18)(cid:18)(cid:2)(cid:1)(cid:2)(cid:3,Unknown,13310.0
Unknown,Unknown,5,Unknown,Unknown,Unknown,Unknown,cid:15)(cid:2)(cid:17)(cid:2)(cid:18)(cid:1)(cid:18)(cid:19)(cid:18)(cid:18)(cid:2)(cid:1)(cid:2)(cid:3,Unknown,13315.0
Unknown,Unknown,2,Unknown,Unknown,Unknown,Unknown,cid:15)(cid:2)(cid:17)(cid:2)(cid:18)(cid:1)(cid:18)(cid:19)(cid:18)(cid:18)(cid:2)(cid:1)(cid:2)(cid:3,Unknown,13317.0
Unknown,Unknown,28,Unknown,Unknown,Unknown,Unknown,cid:15)(cid:2)(cid:17)(cid:2)(cid:18)(cid:1)(cid:18)(cid:19)(cid:18)(cid:18)(cid:2)(cid:1)(cid:2)(cid:3,Unknown,13345.0
Unknown,Unknown,46,Unknown,Unknown,Unknown,Unknown,cid:15)(cid:2)(cid:17)(cid:2)(cid:18)(cid:1)(cid:18)(cid:19)(cid:18)(cid:18)(cid:2)(cid:1)(cid:2)(cid:3,Unknown,13391.0
Unknown,Unknown,12,Unknown,Unknown,Unknown,Unknown,cid:15)(cid:2)(cid:17)(cid:2)(cid:18)(cid:1)(cid:18)(cid:19)(cid:18)(cid:18)(cid:2)(cid:1)(cid:2)(cid:3,Unknown,13403.0
Unknown,Unknown,10,Unknown,Unknown,Unknown,Unknown,cid:15)(cid:2)(cid:17)(cid:2)(cid:18)(cid:1)(cid:18)(cid:19)(cid:18)(cid:18)(cid:2)(cid:1)(cid:2)(cid:3,Unknown,13413.0
Unknown,Unknown,2,Unknown,Unknown,Unknown,Unknown,cid:15)(cid:2)(cid:17)(cid:2)(cid:18)(cid:1)(cid:18)(cid:19)(cid:18)(cid:18)(cid:2)(cid:1)(cid:2)(cid:3,Unknown,13415.0
Unknown,Unknown,16,Unknown,Unknown,Unknown,Unknown,cid:15)(cid:2)(cid:17)(cid:2)(cid:18)(cid:1)(cid:18)(cid:19)(cid:18)(cid:18)(cid:2)(cid:1)(cid:2)(cid:3,Unknown,13431.0
Unknown,Unknown,36,Unknown,Unknown,Unknown,Unknown,cid:15)(cid:2)(cid:17)(cid:2)(cid:18)(cid:1)(cid:18)(cid:19)(cid:18)(cid:18)(cid:2)(cid:1)(cid:2)(cid:3,Unknown,13467.0
Unknown,Unknown,2,Unknown,Unknown,Unknown,Unknown,cid:15)(cid:2)(cid:17)(cid:2)(cid:18)(cid:1)(cid:18)(cid:19)(cid:18)(cid:18)(cid:2)(cid:1)(cid:2)(cid:3,Unknown,13469.0
Unknown,Unknown,39,Unknown,Unknown,Unknown,Unknown,cid:15)(cid:2)(cid:17)(cid:2)(cid:18)(cid:1)(cid:18)(cid:19)(cid:18)(cid:18)(cid:2)(cid:1)(cid:2)(cid:3,Unknown,13508.0
Unknown,Unknown,46,Unknown,Unknown,Unknown,Unknown,cid:15)(cid:2)(cid:17)(cid:2)(cid:18)(cid:1)(cid:18)(cid:19)(cid:18)(cid:18)(cid:2)(cid:1)(cid:2)(cid:3,Unknown,13554.0
Unknown,Unknown,3,Unknown,Unknown,Unknown,Unknown,cid:15)(cid:2)(cid:17)(cid:2)(cid:18)(cid:1)(cid:18)(cid:19)(cid:18)(cid:18)(cid:2)(cid:1)(cid:2)(cid:3,Unknown,13557.0
Unknown,Unknown,7,Unknown,Unknown,Unknown,Unknown,cid:15)(cid:2)(cid:17)(cid:2)(cid:18)(cid:1)(cid:18)(cid:19)(cid:18)(cid:18)(cid:2)(cid:1)(cid:2)(cid:3,Unknown,13564.0
Unknown,Unknown,9,Unknown,Unknown,Unknown,Unknown,cid:15)(cid:2)(cid:17)(cid:2)(cid:18)(cid:1)(cid:18)(cid:19)(cid:18)(cid:18)(cid:2)(cid:1)(cid:2)(cid:3,Unknown,13573.0
Unknown,Unknown,2,Unknown,Unknown,Unknown,Unknown,cid:15)(cid:2)(cid:17)(cid:2)(cid:18)(cid:1)(cid:18)(cid:19)(cid:18)(cid:18)(cid:2)(cid:1)(cid:2)(cid:3,Unknown,13575.0
Unknown,Unknown,28,Unknown,Unknown,Unknown,Unknown,cid:15)(cid:2)(cid:17)(cid:2)(cid:18)(cid:1)(cid:18)(cid:19)(cid:18)(cid:18)(cid:2)(cid:1)(cid:2)(cid:3,Unknown,13603.0
Unknown,Unknown,3,Unknown,Unknown,Unknown,Unknown,cid:15)(cid:2)(cid:17)(cid:2)(cid:18)(cid:1)(cid:18)(cid:19)(cid:18)(cid:18)(cid:2)(cid:1)(cid:2)(cid:3,Unknown,13606.0
Unknown,Unknown,15,Unknown,Unknown,Unknown,Unknown,cid:15)(cid:2)(cid:17)(cid:2)(cid:18)(cid:1)(cid:18)(cid:19)(cid:18)(cid:18)(cid:2)(cid:1)(cid:2)(cid:3,Unknown,13621.0
Unknown,Unknown,2,Unknown,Unknown,Unknown,Unknown,cid:15)(cid:2)(cid:17)(cid:2)(cid:18)(cid:1)(cid:18)(cid:19)(cid:18)(cid:18)(cid:2)(cid:1)(cid:2)(cid:3,Unknown,13623.0
Unknown,Unknown,32,Unknown,Unknown,Unknown,Unknown,cid:15)(cid:2)(cid:17)(cid:2)(cid:18)(cid:1)(cid:18)(cid:19)(cid:18)(cid:18)(cid:2)(cid:1)(cid:2)(cid:3,Unknown,13655.0
Unknown,Unknown,36,Unknown,Unknown,Unknown,Unknown,cid:15)(cid:2)(cid:17)(cid:2)(cid:18)(cid:1)(cid:18)(cid:19)(cid:18)(cid:18)(cid:2)(cid:1)(cid:2)(cid:3,Unknown,13691.0
Unknown,Unknown,19,Unknown,Unknown,Unknown,Unknown,cid:15)(cid:2)(cid:17)(cid:2)(cid:18)(cid:1)(cid:18)(cid:19)(cid:18)(cid:18)(cid:2)(cid:1)(cid:2)(cid:3,Unknown,13710.0
Unknown,Unknown,33,Unknown,Unknown,Unknown,Unknown,cid:15)(cid:2)(cid:17)(cid:2)(cid:18)(cid:1)(cid:18)(cid:19)(cid:18)(cid:18)(cid:2)(cid:1)(cid:2)(cid:3,Unknown,13743.0
Unknown,Unknown,33,Unknown,Unknown,Unknown,Unknown,cid:15)(cid:2)(cid:17)(cid:2)(cid:18)(cid:1)(cid:18)(cid:19)(cid:18)(cid:18)(cid:2)(cid:1)(cid:2)(cid:3,Unknown,13776.0
Unknown,Unknown,2,Unknown,Unknown,Unknown,Unknown,cid:15)(cid:2)(cid:17)(cid:2)(cid:18)(cid:1)(cid:18)(cid:19)(cid:18)(cid:18)(cid:2)(cid:1)(cid:2)(cid:3,Unknown,13778.0
Unknown,Unknown,44,Unknown,Unknown,Unknown,Unknown,cid:15)(cid:2)(cid:17)(cid:2)(cid:18)(cid:1)(cid:18)(cid:19)(cid:18)(cid:18)(cid:2)(cid:1)(cid:2)(cid:3,Unknown,13822.0
Unknown,Unknown,12,Unknown,Unknown,Unknown,Unknown,cid:15)(cid:2)(cid:17)(cid:2)(cid:18)(cid:1)(cid:18)(cid:19)(cid:18)(cid:18)(cid:2)(cid:1)(cid:2)(cid:3,Unknown,13834.0
Unknown,Unknown,29,Unknown,Unknown,Unknown,Unknown,cid:15)(cid:2)(cid:17)(cid:2)(cid:18)(cid:1)(cid:18)(cid:19)(cid:18)(cid:18)(cid:2)(cid:1)(cid:2)(cid:3,Unknown,13863.0
Unknown,Unknown,26,Unknown,Unknown,Unknown,Unknown,cid:15)(cid:2)(cid:17)(cid:2)(cid:18)(cid:1)(cid:18)(cid:19)(cid:18)(cid:18)(cid:2)(cid:1)(cid:2)(cid:3,Unknown,13889.0
Unknown,Unknown,41,Unknown,Unknown,Unknown,Unknown,cid:15)(cid:2)(cid:17)(cid:2)(cid:18)(cid:1)(cid:18)(cid:19)(cid:18)(cid:18)(cid:2)(cid:1)(cid:2)(cid:3,Unknown,13930.0
Unknown,Unknown,25,Unknown,Unknown,Unknown,Unknown,cid:15)(cid:2)(cid:17)(cid:2)(cid:18)(cid:1)(cid:18)(cid:19)(cid:18)(cid:18)(cid:2)(cid:1)(cid:2)(cid:3,Unknown,13955.0
Unknown,Unknown,2,Unknown,Unknown,Unknown,Unknown,cid:15)(cid:2)(cid:17)(cid:2)(cid:18)(cid:1)(cid:18)(cid:19)(cid:18)(cid:18)(cid:2)(cid:1)(cid:2)(cid:3,Unknown,13957.0
Unknown,Unknown,50,Unknown,Unknown,Unknown,Unknown,cid:15)(cid:2)(cid:17)(cid:2)(cid:18)(cid:1)(cid:18)(cid:19)(cid:18)(cid:18)(cid:2)(cid:1)(cid:2)(cid:3,Unknown,14007.0
Unknown,Unknown,50,Unknown,Unknown,Unknown,Unknown,cid:15)(cid:2)(cid:17)(cid:2)(cid:18)(cid:1)(cid:18)(cid:19)(cid:18)(cid:18)(cid:2)(cid:1)(cid:2)(cid:3,Unknown,14057.0
Unknown,Unknown,37,Unknown,Unknown,Unknown,Unknown,cid:15)(cid:2)(cid:17)(cid:2)(cid:18)(cid:1)(cid:18)(cid:19)(cid:18)(cid:18)(cid:2)(cid:1)(cid:2)(cid:3,Unknown,14094.0
Unknown,Unknown,16,Unknown,Unknown,Unknown,Unknown,cid:15)(cid:2)(cid:17)(cid:2)(cid:18)(cid:1)(cid:18)(cid:19)(cid:18)(cid:18)(cid:2)(cid:1)(cid:2)(cid:3,Unknown,14110.0
Unknown,Unknown,34,Unknown,Unknown,Unknown,Unknown,cid:15)(cid:2)(cid:17)(cid:2)(cid:18)(cid:1)(cid:18)(cid:19)(cid:18)(cid:18)(cid:2)(cid:1)(cid:2)(cid:3,Unknown,14144.0
Unknown,Unknown,33,Unknown,Unknown,Unknown,Unknown,cid:15)(cid:2)(cid:17)(cid:2)(cid:18)(cid:1)(cid:18)(cid:19)(cid:18)(cid:18)(cid:2)(cid:1)(cid:2)(cid:3,Unknown,14177.0
Unknown,Unknown,37,Unknown,Unknown,Unknown,Unknown,cid:15)(cid:2)(cid:17)(cid:2)(cid:18)(cid:1)(cid:18)(cid:19)(cid:18)(cid:18)(cid:2)(cid:1)(cid:2)(cid:3,Unknown,14214.0
Unknown,Unknown,17,Unknown,Unknown,Unknown,Unknown,cid:15)(cid:2)(cid:17)(cid:2)(cid:18)(cid:1)(cid:18)(cid:19)(cid:18)(cid:18)(cid:2)(cid:1)(cid:2)(cid:3,Unknown,14231.0
Unknown,Unknown,45,Unknown,Unknown,Unknown,Unknown,cid:15)(cid:2)(cid:17)(cid:2)(cid:18)(cid:1)(cid:18)(cid:19)(cid:18)(cid:18)(cid:2)(cid:1)(cid:2)(cid:3,Unknown,14276.0
Unknown,Unknown,18,Unknown,Unknown,Unknown,Unknown,cid:15)(cid:2)(cid:17)(cid:2)(cid:18)(cid:1)(cid:18)(cid:19)(cid:18)(cid:18)(cid:2)(cid:1)(cid:2)(cid:3,Unknown,14294.0
Unknown,Unknown,35,Unknown,Unknown,Unknown,Unknown,cid:15)(cid:2)(cid:17)(cid:2)(cid:18)(cid:1)(cid:18)(cid:19)(cid:18)(cid:18)(cid:2)(cid:1)(cid:2)(cid:3,Unknown,14329.0
Unknown,Unknown,5,Unknown,Unknown,Unknown,Unknown,cid:15)(cid:2)(cid:17)(cid:2)(cid:18)(cid:1)(cid:18)(cid:19)(cid:18)(cid:18)(cid:2)(cid:1)(cid:2)(cid:3,Unknown,14334.0
Unknown,Unknown,14,Unknown,Unknown,Unknown,Unknown,cid:15)(cid:2)(cid:17)(cid:2)(cid:18)(cid:1)(cid:18)(cid:19)(cid:18)(cid:18)(cid:2)(cid:1)(cid:2)(cid:3,Unknown,14348.0
Unknown,Unknown,5,Unknown,Unknown,Unknown,Unknown,cid:15)(cid:2)(cid:17)(cid:2)(cid:18)(cid:1)(cid:18)(cid:19)(cid:18)(cid:18)(cid:2)(cid:1)(cid:2)(cid:3,Unknown,14353.0
Unknown,Unknown,39,Unknown,Unknown,Unknown,Unknown,cid:15)(cid:2)(cid:17)(cid:2)(cid:18)(cid:1)(cid:18)(cid:19)(cid:18)(cid:18)(cid:2)(cid:1)(cid:2)(cid:3,Unknown,14392.0
Unknown,Unknown,13,Unknown,Unknown,Unknown,Unknown,cid:15)(cid:2)(cid:17)(cid:2)(cid:18)(cid:1)(cid:18)(cid:19)(cid:18)(cid:18)(cid:2)(cid:1)(cid:2)(cid:3,Unknown,14405.0
Unknown,Unknown,46,Unknown,Unknown,Unknown,Unknown,cid:15)(cid:2)(cid:17)(cid:2)(cid:18)(cid:1)(cid:18)(cid:19)(cid:18)(cid:18)(cid:2)(cid:1)(cid:2)(cid:3,Unknown,14451.0
Unknown,Unknown,8,Unknown,Unknown,Unknown,Unknown,cid:15)(cid:2)(cid:17)(cid:2)(cid:18)(cid:1)(cid:18)(cid:19)(cid:18)(cid:18)(cid:2)(cid:1)(cid:2)(cid:3,Unknown,14459.0
Unknown,Unknown,10,Unknown,Unknown,Unknown,Unknown,cid:15)(cid:2)(cid:17)(cid:2)(cid:18)(cid:1)(cid:18)(cid:19)(cid:18)(cid:18)(cid:2)(cid:1)(cid:2)(cid:3,Unknown,14469.0
Unknown,Unknown,2,Unknown,Unknown,Unknown,Unknown,cid:15)(cid:2)(cid:17)(cid:2)(cid:18)(cid:1)(cid:18)(cid:19)(cid:18)(cid:18)(cid:2)(cid:1)(cid:2)(cid:3,Unknown,14471.0
Unknown,Unknown,51,Unknown,Unknown,Unknown,Unknown,cid:15)(cid:2)(cid:17)(cid:2)(cid:18)(cid:1)(cid:18)(cid:19)(cid:18)(cid:18)(cid:2)(cid:1)(cid:2)(cid:3,Unknown,14522.0
Unknown,Unknown,14,Unknown,Unknown,Unknown,Unknown,cid:15)(cid:2)(cid:17)(cid:2)(cid:18)(cid:1)(cid:18)(cid:19)(cid:18)(cid:18)(cid:2)(cid:1)(cid:2)(cid:3,Unknown,14536.0
Unknown,Unknown,5,Unknown,Unknown,Unknown,Unknown,cid:15)(cid:2)(cid:17)(cid:2)(cid:18)(cid:1)(cid:18)(cid:19)(cid:18)(cid:18)(cid:2)(cid:1)(cid:2)(cid:3,Unknown,14541.0
Unknown,Unknown,4,Unknown,Unknown,Unknown,Unknown,cid:15)(cid:2)(cid:17)(cid:2)(cid:18)(cid:1)(cid:18)(cid:19)(cid:18)(cid:18)(cid:2)(cid:1)(cid:2)(cid:3,Unknown,14545.0
Unknown,Unknown,2,Unknown,Unknown,Unknown,Unknown,cid:15)(cid:2)(cid:17)(cid:2)(cid:18)(cid:1)(cid:18)(cid:19)(cid:18)(cid:18)(cid:2)(cid:1)(cid:2)(cid:3,Unknown,14547.0
Unknown,Unknown,12,Unknown,Unknown,Unknown,Unknown,cid:15)(cid:2)(cid:17)(cid:2)(cid:18)(cid:1)(cid:18)(cid:19)(cid:18)(cid:18)(cid:2)(cid:1)(cid:2)(cid:3,Unknown,14559.0
Unknown,Unknown,11,Unknown,Unknown,Unknown,Unknown,cid:15)(cid:2)(cid:17)(cid:2)(cid:18)(cid:1)(cid:18)(cid:19)(cid:18)(cid:18)(cid:2)(cid:1)(cid:2)(cid:3,Unknown,14570.0
Unknown,Unknown,4,Unknown,Unknown,Unknown,Unknown,cid:15)(cid:2)(cid:17)(cid:2)(cid:18)(cid:1)(cid:18)(cid:19)(cid:18)(cid:18)(cid:2)(cid:1)(cid:2)(cid:3,Unknown,14574.0
Unknown,Unknown,14,Unknown,Unknown,Unknown,Unknown,cid:15)(cid:2)(cid:17)(cid:2)(cid:18)(cid:1)(cid:18)(cid:19)(cid:18)(cid:18)(cid:2)(cid:1)(cid:2)(cid:3,Unknown,14588.0
Unknown,Unknown,11,Unknown,Unknown,Unknown,Unknown,cid:15)(cid:2)(cid:17)(cid:2)(cid:18)(cid:1)(cid:18)(cid:19)(cid:18)(cid:18)(cid:2)(cid:1)(cid:2)(cid:3,Unknown,14599.0
Unknown,Unknown,54,Unknown,Unknown,Unknown,Unknown,cid:15)(cid:2)(cid:17)(cid:2)(cid:18)(cid:1)(cid:18)(cid:19)(cid:18)(cid:18)(cid:2)(cid:1)(cid:2)(cid:3,Unknown,14653.0
Unknown,Unknown,54,Unknown,Unknown,Unknown,Unknown,cid:15)(cid:2)(cid:17)(cid:2)(cid:18)(cid:1)(cid:18)(cid:19)(cid:18)(cid:18)(cid:2)(cid:1)(cid:2)(cid:3,Unknown,14707.0
Unknown,Unknown,7,Unknown,Unknown,Unknown,Unknown,cid:15)(cid:2)(cid:17)(cid:2)(cid:18)(cid:1)(cid:18)(cid:19)(cid:18)(cid:18)(cid:2)(cid:1)(cid:2)(cid:3,Unknown,14714.0
Unknown,Unknown,5,Unknown,Unknown,Unknown,Unknown,cid:15)(cid:2)(cid:17)(cid:2)(cid:18)(cid:1)(cid:18)(cid:19)(cid:18)(cid:18)(cid:2)(cid:1)(cid:2)(cid:3,Unknown,14719.0
Unknown,Unknown,3,Unknown,Unknown,Unknown,Unknown,cid:15)(cid:2)(cid:17)(cid:2)(cid:18)(cid:1)(cid:18)(cid:19)(cid:18)(cid:18)(cid:2)(cid:1)(cid:2)(cid:3,Unknown,14722.0
Unknown,Unknown,2,Unknown,Unknown,Unknown,Unknown,cid:15)(cid:2)(cid:17)(cid:2)(cid:18)(cid:1)(cid:18)(cid:19)(cid:18)(cid:18)(cid:2)(cid:1)(cid:2)(cid:3,Unknown,14724.0
Unknown,Unknown,28,Unknown,Unknown,Unknown,Unknown,cid:15)(cid:2)(cid:17)(cid:2)(cid:18)(cid:1)(cid:18)(cid:19)(cid:18)(cid:18)(cid:2)(cid:1)(cid:2)(cid:3,Unknown,14752.0
Unknown,Unknown,3,Unknown,Unknown,Unknown,Unknown,cid:15)(cid:2)(cid:17)(cid:2)(cid:18)(cid:1)(cid:18)(cid:19)(cid:18)(cid:18)(cid:2)(cid:1)(cid:2)(cid:3,Unknown,14755.0
Unknown,Unknown,15,Unknown,Unknown,Unknown,Unknown,cid:15)(cid:2)(cid:17)(cid:2)(cid:18)(cid:1)(cid:18)(cid:19)(cid:18)(cid:18)(cid:2)(cid:1)(cid:2)(cid:3,Unknown,14770.0
Unknown,Unknown,2,Unknown,Unknown,Unknown,Unknown,cid:15)(cid:2)(cid:17)(cid:2)(cid:18)(cid:1)(cid:18)(cid:19)(cid:18)(cid:18)(cid:2)(cid:1)(cid:2)(cid:3,Unknown,14772.0
Unknown,Unknown,17,Unknown,Unknown,Unknown,Unknown,cid:15)(cid:2)(cid:17)(cid:2)(cid:18)(cid:1)(cid:18)(cid:19)(cid:18)(cid:18)(cid:2)(cid:1)(cid:2)(cid:3,Unknown,14789.0
Unknown,Unknown,32,Unknown,Unknown,Unknown,Unknown,cid:15)(cid:2)(cid:17)(cid:2)(cid:18)(cid:1)(cid:18)(cid:19)(cid:18)(cid:18)(cid:2)(cid:1)(cid:2)(cid:3,Unknown,14821.0
Unknown,Unknown,19,Unknown,Unknown,Unknown,Unknown,cid:15)(cid:2)(cid:17)(cid:2)(cid:18)(cid:1)(cid:18)(cid:19)(cid:18)(cid:18)(cid:2)(cid:1)(cid:2)(cid:3,Unknown,14840.0
Unknown,Unknown,18,Unknown,Unknown,Unknown,Unknown,cid:15)(cid:2)(cid:17)(cid:2)(cid:18)(cid:1)(cid:18)(cid:19)(cid:18)(cid:18)(cid:2)(cid:1)(cid:2)(cid:3,Unknown,14858.0
Unknown,Unknown,18,Unknown,Unknown,Unknown,Unknown,cid:15)(cid:2)(cid:17)(cid:2)(cid:18)(cid:1)(cid:18)(cid:19)(cid:18)(cid:18)(cid:2)(cid:1)(cid:2)(cid:3,Unknown,14876.0
Unknown,Unknown,2,Unknown,Unknown,Unknown,Unknown,cid:15)(cid:2)(cid:17)(cid:2)(cid:18)(cid:1)(cid:18)(cid:19)(cid:18)(cid:18)(cid:2)(cid:1)(cid:2)(cid:3,Unknown,14878.0
Unknown,Unknown,44,Unknown,Unknown,Unknown,Unknown,cid:15)(cid:2)(cid:17)(cid:2)(cid:18)(cid:1)(cid:18)(cid:19)(cid:18)(cid:18)(cid:2)(cid:1)(cid:2)(cid:3,Unknown,14922.0
Unknown,Unknown,12,Unknown,Unknown,Unknown,Unknown,cid:15)(cid:2)(cid:17)(cid:2)(cid:18)(cid:1)(cid:18)(cid:19)(cid:18)(cid:18)(cid:2)(cid:1)(cid:2)(cid:3,Unknown,14934.0
Unknown,Unknown,29,Unknown,Unknown,Unknown,Unknown,cid:15)(cid:2)(cid:17)(cid:2)(cid:18)(cid:1)(cid:18)(cid:19)(cid:18)(cid:18)(cid:2)(cid:1)(cid:2)(cid:3,Unknown,14963.0
Unknown,Unknown,26,Unknown,Unknown,Unknown,Unknown,cid:15)(cid:2)(cid:17)(cid:2)(cid:18)(cid:1)(cid:18)(cid:19)(cid:18)(cid:18)(cid:2)(cid:1)(cid:2)(cid:3,Unknown,14989.0
Unknown,Unknown,41,Unknown,Unknown,Unknown,Unknown,cid:15)(cid:2)(cid:17)(cid:2)(cid:18)(cid:1)(cid:18)(cid:19)(cid:18)(cid:18)(cid:2)(cid:1)(cid:2)(cid:3,Unknown,15030.0
Unknown,Unknown,25,Unknown,Unknown,Unknown,Unknown,cid:15)(cid:2)(cid:17)(cid:2)(cid:18)(cid:1)(cid:18)(cid:19)(cid:18)(cid:18)(cid:2)(cid:1)(cid:2)(cid:3,Unknown,15055.0
Unknown,Unknown,2,Unknown,Unknown,Unknown,Unknown,cid:15)(cid:2)(cid:17)(cid:2)(cid:18)(cid:1)(cid:18)(cid:19)(cid:18)(cid:18)(cid:2)(cid:1)(cid:2)(cid:3,Unknown,15057.0
Unknown,Unknown,50,Unknown,Unknown,Unknown,Unknown,cid:15)(cid:2)(cid:17)(cid:2)(cid:18)(cid:1)(cid:18)(cid:19)(cid:18)(cid:18)(cid:2)(cid:1)(cid:2)(cid:3,Unknown,15107.0
Unknown,Unknown,50,Unknown,Unknown,Unknown,Unknown,cid:15)(cid:2)(cid:17)(cid:2)(cid:18)(cid:1)(cid:18)(cid:19)(cid:18)(cid:18)(cid:2)(cid:1)(cid:2)(cid:3,Unknown,15157.0
Unknown,Unknown,18,Unknown,Unknown,Unknown,Unknown,cid:15)(cid:2)(cid:17)(cid:2)(cid:18)(cid:1)(cid:18)(cid:19)(cid:18)(cid:18)(cid:2)(cid:1)(cid:2)(cid:3,Unknown,15175.0
Unknown,Unknown,1,Unknown,Unknown,Unknown,Unknown,cid:15)(cid:2)(cid:17)(cid:2)(cid:18)(cid:1)(cid:18)(cid:19)(cid:18)(cid:18)(cid:2)(cid:1)(cid:2)(cid:3,Unknown,15176.0
Unknown,Unknown,1,Unknown,Unknown,Unknown,Unknown,cid:15)(cid:2)(cid:17)(cid:2)(cid:18)(cid:1)(cid:18)(cid:19)(cid:18)(cid:18)(cid:2)(cid:1)(cid:2)(cid:3,Unknown,15177.0
Unknown,Unknown,37,Unknown,Unknown,Unknown,Unknown,cid:15)(cid:2)(cid:17)(cid:2)(cid:18)(cid:1)(cid:18)(cid:19)(cid:18)(cid:18)(cid:2)(cid:1)(cid:2)(cid:3,Unknown,15214.0
Unknown,Unknown,37,Unknown,Unknown,Unknown,Unknown,cid:15)(cid:2)(cid:17)(cid:2)(cid:18)(cid:1)(cid:18)(cid:19)(cid:18)(cid:18)(cid:2)(cid:1)(cid:2)(cid:3,Unknown,15251.0
Unknown,Unknown,17,Unknown,Unknown,Unknown,Unknown,cid:15)(cid:2)(cid:17)(cid:2)(cid:18)(cid:1)(cid:18)(cid:19)(cid:18)(cid:18)(cid:2)(cid:1)(cid:2)(cid:3,Unknown,15268.0
Unknown,Unknown,45,Unknown,Unknown,Unknown,Unknown,cid:15)(cid:2)(cid:17)(cid:2)(cid:18)(cid:1)(cid:18)(cid:19)(cid:18)(cid:18)(cid:2)(cid:1)(cid:2)(cid:3,Unknown,15313.0
Unknown,Unknown,18,Unknown,Unknown,Unknown,Unknown,cid:15)(cid:2)(cid:17)(cid:2)(cid:18)(cid:1)(cid:18)(cid:19)(cid:18)(cid:18)(cid:2)(cid:1)(cid:2)(cid:3,Unknown,15331.0
Unknown,Unknown,35,Unknown,Unknown,Unknown,Unknown,cid:15)(cid:2)(cid:17)(cid:2)(cid:18)(cid:1)(cid:18)(cid:19)(cid:18)(cid:18)(cid:2)(cid:1)(cid:2)(cid:3,Unknown,15366.0
Unknown,Unknown,9,Unknown,Unknown,Unknown,Unknown,cid:15)(cid:2)(cid:17)(cid:2)(cid:18)(cid:1)(cid:18)(cid:19)(cid:18)(cid:18)(cid:2)(cid:1)(cid:2)(cid:3,Unknown,15375.0
Unknown,Unknown,46,Unknown,Unknown,Unknown,Unknown,cid:15)(cid:2)(cid:17)(cid:2)(cid:18)(cid:1)(cid:18)(cid:19)(cid:18)(cid:18)(cid:2)(cid:1)(cid:2)(cid:3,Unknown,15421.0
Unknown,Unknown,8,Unknown,Unknown,Unknown,Unknown,cid:15)(cid:2)(cid:17)(cid:2)(cid:18)(cid:1)(cid:18)(cid:19)(cid:18)(cid:18)(cid:2)(cid:1)(cid:2)(cid:3,Unknown,15429.0
Unknown,Unknown,5,Unknown,Unknown,Unknown,Unknown,cid:15)(cid:2)(cid:17)(cid:2)(cid:18)(cid:1)(cid:18)(cid:19)(cid:18)(cid:18)(cid:2)(cid:1)(cid:2)(cid:3,Unknown,15434.0
Unknown,Unknown,28,Unknown,Unknown,Unknown,Unknown,cid:15)(cid:2)(cid:17)(cid:2)(cid:18)(cid:1)(cid:18)(cid:19)(cid:18)(cid:18)(cid:2)(cid:1)(cid:2)(cid:3,Unknown,15462.0
Unknown,Unknown,2,Unknown,Unknown,Unknown,Unknown,cid:15)(cid:2)(cid:17)(cid:2)(cid:18)(cid:1)(cid:18)(cid:19)(cid:18)(cid:18)(cid:2)(cid:1)(cid:2)(cid:3,Unknown,15464.0
Unknown,Unknown,9,Unknown,Unknown,Unknown,Unknown,cid:15)(cid:2)(cid:17)(cid:2)(cid:18)(cid:1)(cid:18)(cid:19)(cid:18)(cid:18)(cid:2)(cid:1)(cid:2)(cid:3,Unknown,15473.0
Unknown,Unknown,5,Unknown,Unknown,Unknown,Unknown,cid:15)(cid:2)(cid:17)(cid:2)(cid:18)(cid:1)(cid:18)(cid:19)(cid:18)(cid:18)(cid:2)(cid:1)(cid:2)(cid:3,Unknown,15478.0
Unknown,Unknown,8,Unknown,Unknown,Unknown,Unknown,cid:15)(cid:2)(cid:17)(cid:2)(cid:18)(cid:1)(cid:18)(cid:19)(cid:18)(cid:18)(cid:2)(cid:1)(cid:2)(cid:3,Unknown,15486.0
Unknown,Unknown,14,Unknown,Unknown,Unknown,Unknown,cid:15)(cid:2)(cid:17)(cid:2)(cid:18)(cid:1)(cid:18)(cid:19)(cid:18)(cid:18)(cid:2)(cid:1)(cid:2)(cid:3,Unknown,15500.0
Unknown,Unknown,7,Unknown,Unknown,Unknown,Unknown,cid:15)(cid:2)(cid:17)(cid:2)(cid:18)(cid:1)(cid:18)(cid:19)(cid:18)(cid:18)(cid:2)(cid:1)(cid:2)(cid:3,Unknown,15507.0
Unknown,Unknown,9,Unknown,Unknown,Unknown,Unknown,cid:15)(cid:2)(cid:17)(cid:2)(cid:18)(cid:1)(cid:18)(cid:19)(cid:18)(cid:18)(cid:2)(cid:1)(cid:2)(cid:3,Unknown,15516.0
Unknown,Unknown,2,Unknown,Unknown,Unknown,Unknown,cid:15)(cid:2)(cid:17)(cid:2)(cid:18)(cid:1)(cid:18)(cid:19)(cid:18)(cid:18)(cid:2)(cid:1)(cid:2)(cid:3,Unknown,15518.0
Unknown,Unknown,28,Unknown,Unknown,Unknown,Unknown,cid:15)(cid:2)(cid:17)(cid:2)(cid:18)(cid:1)(cid:18)(cid:19)(cid:18)(cid:18)(cid:2)(cid:1)(cid:2)(cid:3,Unknown,15546.0
Unknown,Unknown,3,Unknown,Unknown,Unknown,Unknown,cid:15)(cid:2)(cid:17)(cid:2)(cid:18)(cid:1)(cid:18)(cid:19)(cid:18)(cid:18)(cid:2)(cid:1)(cid:2)(cid:3,Unknown,15549.0
Unknown,Unknown,15,Unknown,Unknown,Unknown,Unknown,cid:15)(cid:2)(cid:17)(cid:2)(cid:18)(cid:1)(cid:18)(cid:19)(cid:18)(cid:18)(cid:2)(cid:1)(cid:2)(cid:3,Unknown,15564.0
Unknown,Unknown,2,Unknown,Unknown,Unknown,Unknown,cid:15)(cid:2)(cid:17)(cid:2)(cid:18)(cid:1)(cid:18)(cid:19)(cid:18)(cid:18)(cid:2)(cid:1)(cid:2)(cid:3,Unknown,15566.0
Unknown,Unknown,1,Unknown,Unknown,Unknown,Unknown,cid:15)(cid:2)(cid:17)(cid:2)(cid:18)(cid:1)(cid:18)(cid:19)(cid:18)(cid:18)(cid:2)(cid:1)(cid:2)(cid:3,Unknown,15567.0
Unknown,Unknown,1,Unknown,Unknown,Unknown,Unknown,cid:15)(cid:2)(cid:17)(cid:2)(cid:18)(cid:1)(cid:18)(cid:19)(cid:18)(cid:18)(cid:2)(cid:1)(cid:2)(cid:3,Unknown,15568.0
Unknown,Unknown,19,Unknown,Unknown,Unknown,Unknown,cid:15)(cid:2)(cid:17)(cid:2)(cid:18)(cid:1)(cid:18)(cid:19)(cid:18)(cid:18)(cid:2)(cid:1)(cid:2)(cid:3,Unknown,15587.0
Unknown,Unknown,34,Unknown,Unknown,Unknown,Unknown,cid:15)(cid:2)(cid:17)(cid:2)(cid:18)(cid:1)(cid:18)(cid:19)(cid:18)(cid:18)(cid:2)(cid:1)(cid:2)(cid:3,Unknown,15621.0
Unknown,Unknown,18,Unknown,Unknown,Unknown,Unknown,cid:15)(cid:2)(cid:17)(cid:2)(cid:18)(cid:1)(cid:18)(cid:19)(cid:18)(cid:18)(cid:2)(cid:1)(cid:2)(cid:3,Unknown,15639.0
Unknown,Unknown,2,Unknown,Unknown,Unknown,Unknown,cid:15)(cid:2)(cid:17)(cid:2)(cid:18)(cid:1)(cid:18)(cid:19)(cid:18)(cid:18)(cid:2)(cid:1)(cid:2)(cid:3,Unknown,15641.0
Unknown,Unknown,44,Unknown,Unknown,Unknown,Unknown,cid:15)(cid:2)(cid:17)(cid:2)(cid:18)(cid:1)(cid:18)(cid:19)(cid:18)(cid:18)(cid:2)(cid:1)(cid:2)(cid:3,Unknown,15685.0
Unknown,Unknown,12,Unknown,Unknown,Unknown,Unknown,cid:15)(cid:2)(cid:17)(cid:2)(cid:18)(cid:1)(cid:18)(cid:19)(cid:18)(cid:18)(cid:2)(cid:1)(cid:2)(cid:3,Unknown,15697.0
Unknown,Unknown,29,Unknown,Unknown,Unknown,Unknown,cid:15)(cid:2)(cid:17)(cid:2)(cid:18)(cid:1)(cid:18)(cid:19)(cid:18)(cid:18)(cid:2)(cid:1)(cid:2)(cid:3,Unknown,15726.0
Unknown,Unknown,26,Unknown,Unknown,Unknown,Unknown,cid:15)(cid:2)(cid:17)(cid:2)(cid:18)(cid:1)(cid:18)(cid:19)(cid:18)(cid:18)(cid:2)(cid:1)(cid:2)(cid:3,Unknown,15752.0
Unknown,Unknown,41,Unknown,Unknown,Unknown,Unknown,cid:15)(cid:2)(cid:17)(cid:2)(cid:18)(cid:1)(cid:18)(cid:19)(cid:18)(cid:18)(cid:2)(cid:1)(cid:2)(cid:3,Unknown,15793.0
Unknown,Unknown,25,Unknown,Unknown,Unknown,Unknown,cid:15)(cid:2)(cid:17)(cid:2)(cid:18)(cid:1)(cid:18)(cid:19)(cid:18)(cid:18)(cid:2)(cid:1)(cid:2)(cid:3,Unknown,15818.0
Unknown,Unknown,2,Unknown,Unknown,Unknown,Unknown,cid:15)(cid:2)(cid:17)(cid:2)(cid:18)(cid:1)(cid:18)(cid:19)(cid:18)(cid:18)(cid:2)(cid:1)(cid:2)(cid:3,Unknown,15820.0
Unknown,Unknown,50,Unknown,Unknown,Unknown,Unknown,cid:15)(cid:2)(cid:17)(cid:2)(cid:18)(cid:1)(cid:18)(cid:19)(cid:18)(cid:18)(cid:2)(cid:1)(cid:2)(cid:3,Unknown,15870.0
Unknown,Unknown,50,Unknown,Unknown,Unknown,Unknown,cid:15)(cid:2)(cid:17)(cid:2)(cid:18)(cid:1)(cid:18)(cid:19)(cid:18)(cid:18)(cid:2)(cid:1)(cid:2)(cid:3,Unknown,15920.0
Unknown,Unknown,37,Unknown,Unknown,Unknown,Unknown,cid:15)(cid:2)(cid:17)(cid:2)(cid:18)(cid:1)(cid:18)(cid:19)(cid:18)(cid:18)(cid:2)(cid:1)(cid:2)(cid:3,Unknown,15957.0
Unknown,Unknown,16,Unknown,Unknown,Unknown,Unknown,cid:15)(cid:2)(cid:17)(cid:2)(cid:18)(cid:1)(cid:18)(cid:19)(cid:18)(cid:18)(cid:2)(cid:1)(cid:2)(cid:3,Unknown,15973.0
Unknown,Unknown,34,Unknown,Unknown,Unknown,Unknown,cid:15)(cid:2)(cid:17)(cid:2)(cid:18)(cid:1)(cid:18)(cid:19)(cid:18)(cid:18)(cid:2)(cid:1)(cid:2)(cid:3,Unknown,16007.0
Unknown,Unknown,33,Unknown,Unknown,Unknown,Unknown,cid:15)(cid:2)(cid:17)(cid:2)(cid:18)(cid:1)(cid:18)(cid:19)(cid:18)(cid:18)(cid:2)(cid:1)(cid:2)(cid:3,Unknown,16040.0
Unknown,Unknown,37,Unknown,Unknown,Unknown,Unknown,cid:15)(cid:2)(cid:17)(cid:2)(cid:18)(cid:1)(cid:18)(cid:19)(cid:18)(cid:18)(cid:2)(cid:1)(cid:2)(cid:3,Unknown,16077.0
Unknown,Unknown,17,Unknown,Unknown,Unknown,Unknown,cid:15)(cid:2)(cid:17)(cid:2)(cid:18)(cid:1)(cid:18)(cid:19)(cid:18)(cid:18)(cid:2)(cid:1)(cid:2)(cid:3,Unknown,16094.0
Unknown,Unknown,45,Unknown,Unknown,Unknown,Unknown,cid:15)(cid:2)(cid:17)(cid:2)(cid:18)(cid:1)(cid:18)(cid:19)(cid:18)(cid:18)(cid:2)(cid:1)(cid:2)(cid:3,Unknown,16139.0
Unknown,Unknown,18,Unknown,Unknown,Unknown,Unknown,cid:15)(cid:2)(cid:17)(cid:2)(cid:18)(cid:1)(cid:18)(cid:19)(cid:18)(cid:18)(cid:2)(cid:1)(cid:2)(cid:3,Unknown,16157.0
Unknown,Unknown,35,Unknown,Unknown,Unknown,Unknown,cid:15)(cid:2)(cid:17)(cid:2)(cid:18)(cid:1)(cid:18)(cid:19)(cid:18)(cid:18)(cid:2)(cid:1)(cid:2)(cid:3,Unknown,16192.0
Unknown,Unknown,9,Unknown,Unknown,Unknown,Unknown,cid:15)(cid:2)(cid:17)(cid:2)(cid:18)(cid:1)(cid:18)(cid:19)(cid:18)(cid:18)(cid:2)(cid:1)(cid:2)(cid:3,Unknown,16201.0
Unknown,Unknown,46,Unknown,Unknown,Unknown,Unknown,cid:15)(cid:2)(cid:17)(cid:2)(cid:18)(cid:1)(cid:18)(cid:19)(cid:18)(cid:18)(cid:2)(cid:1)(cid:2)(cid:3,Unknown,16247.0
Unknown,Unknown,8,Unknown,Unknown,Unknown,Unknown,cid:15)(cid:2)(cid:17)(cid:2)(cid:18)(cid:1)(cid:18)(cid:19)(cid:18)(cid:18)(cid:2)(cid:1)(cid:2)(cid:3,Unknown,16255.0
Unknown,Unknown,5,Unknown,Unknown,Unknown,Unknown,cid:15)(cid:2)(cid:17)(cid:2)(cid:18)(cid:1)(cid:18)(cid:19)(cid:18)(cid:18)(cid:2)(cid:1)(cid:2)(cid:3,Unknown,16260.0
Unknown,Unknown,28,Unknown,Unknown,Unknown,Unknown,cid:15)(cid:2)(cid:17)(cid:2)(cid:18)(cid:1)(cid:18)(cid:19)(cid:18)(cid:18)(cid:2)(cid:1)(cid:2)(cid:3,Unknown,16288.0
Unknown,Unknown,2,Unknown,Unknown,Unknown,Unknown,cid:15)(cid:2)(cid:17)(cid:2)(cid:18)(cid:1)(cid:18)(cid:19)(cid:18)(cid:18)(cid:2)(cid:1)(cid:2)(cid:3,Unknown,16290.0
Unknown,Unknown,9,Unknown,Unknown,Unknown,Unknown,cid:15)(cid:2)(cid:17)(cid:2)(cid:18)(cid:1)(cid:18)(cid:19)(cid:18)(cid:18)(cid:2)(cid:1)(cid:2)(cid:3,Unknown,16299.0
Unknown,Unknown,5,Unknown,Unknown,Unknown,Unknown,cid:15)(cid:2)(cid:17)(cid:2)(cid:18)(cid:1)(cid:18)(cid:19)(cid:18)(cid:18)(cid:2)(cid:1)(cid:2)(cid:3,Unknown,16304.0
Unknown,Unknown,8,Unknown,Unknown,Unknown,Unknown,cid:15)(cid:2)(cid:17)(cid:2)(cid:18)(cid:1)(cid:18)(cid:19)(cid:18)(cid:18)(cid:2)(cid:1)(cid:2)(cid:3,Unknown,16312.0
Unknown,Unknown,14,Unknown,Unknown,Unknown,Unknown,cid:15)(cid:2)(cid:17)(cid:2)(cid:18)(cid:1)(cid:18)(cid:19)(cid:18)(cid:18)(cid:2)(cid:1)(cid:2)(cid:3,Unknown,16326.0
Unknown,Unknown,7,Unknown,Unknown,Unknown,Unknown,cid:15)(cid:2)(cid:17)(cid:2)(cid:18)(cid:1)(cid:18)(cid:19)(cid:18)(cid:18)(cid:2)(cid:1)(cid:2)(cid:3,Unknown,16333.0
Unknown,Unknown,9,Unknown,Unknown,Unknown,Unknown,cid:15)(cid:2)(cid:17)(cid:2)(cid:18)(cid:1)(cid:18)(cid:19)(cid:18)(cid:18)(cid:2)(cid:1)(cid:2)(cid:3,Unknown,16342.0
Unknown,Unknown,2,Unknown,Unknown,Unknown,Unknown,cid:15)(cid:2)(cid:17)(cid:2)(cid:18)(cid:1)(cid:18)(cid:19)(cid:18)(cid:18)(cid:2)(cid:1)(cid:2)(cid:3,Unknown,16344.0
Unknown,Unknown,28,Unknown,Unknown,Unknown,Unknown,cid:15)(cid:2)(cid:17)(cid:2)(cid:18)(cid:1)(cid:18)(cid:19)(cid:18)(cid:18)(cid:2)(cid:1)(cid:2)(cid:3,Unknown,16372.0
Unknown,Unknown,3,Unknown,Unknown,Unknown,Unknown,cid:15)(cid:2)(cid:17)(cid:2)(cid:18)(cid:1)(cid:18)(cid:19)(cid:18)(cid:18)(cid:2)(cid:1)(cid:2)(cid:3,Unknown,16375.0
Unknown,Unknown,15,Unknown,Unknown,Unknown,Unknown,cid:15)(cid:2)(cid:17)(cid:2)(cid:18)(cid:1)(cid:18)(cid:19)(cid:18)(cid:18)(cid:2)(cid:1)(cid:2)(cid:3,Unknown,16390.0
Unknown,Unknown,2,Unknown,Unknown,Unknown,Unknown,cid:15)(cid:2)(cid:17)(cid:2)(cid:18)(cid:1)(cid:18)(cid:19)(cid:18)(cid:18)(cid:2)(cid:1)(cid:2)(cid:3,Unknown,16392.0
Unknown,Unknown,33,Unknown,Unknown,Unknown,Unknown,cid:15)(cid:2)(cid:17)(cid:2)(cid:18)(cid:1)(cid:18)(cid:19)(cid:18)(cid:18)(cid:2)(cid:1)(cid:2)(cid:3,Unknown,16425.0
Unknown,Unknown,19,Unknown,Unknown,Unknown,Unknown,cid:15)(cid:2)(cid:17)(cid:2)(cid:18)(cid:1)(cid:18)(cid:19)(cid:18)(cid:18)(cid:2)(cid:1)(cid:2)(cid:3,Unknown,16444.0
Unknown,Unknown,17,Unknown,Unknown,Unknown,Unknown,cid:15)(cid:2)(cid:17)(cid:2)(cid:18)(cid:1)(cid:18)(cid:19)(cid:18)(cid:18)(cid:2)(cid:1)(cid:2)(cid:3,Unknown,16461.0
Unknown,Unknown,18,Unknown,Unknown,Unknown,Unknown,cid:15)(cid:2)(cid:17)(cid:2)(cid:18)(cid:1)(cid:18)(cid:19)(cid:18)(cid:18)(cid:2)(cid:1)(cid:2)(cid:3,Unknown,16479.0
Unknown,Unknown,2,Unknown,Unknown,Unknown,Unknown,cid:15)(cid:2)(cid:17)(cid:2)(cid:18)(cid:1)(cid:18)(cid:19)(cid:18)(cid:18)(cid:2)(cid:1)(cid:2)(cid:3,Unknown,16481.0
Unknown,Unknown,44,Unknown,Unknown,Unknown,Unknown,cid:15)(cid:2)(cid:17)(cid:2)(cid:18)(cid:1)(cid:18)(cid:19)(cid:18)(cid:18)(cid:2)(cid:1)(cid:2)(cid:3,Unknown,16525.0
Unknown,Unknown,12,Unknown,Unknown,Unknown,Unknown,cid:15)(cid:2)(cid:17)(cid:2)(cid:18)(cid:1)(cid:18)(cid:19)(cid:18)(cid:18)(cid:2)(cid:1)(cid:2)(cid:3,Unknown,16537.0
Unknown,Unknown,29,Unknown,Unknown,Unknown,Unknown,cid:15)(cid:2)(cid:17)(cid:2)(cid:18)(cid:1)(cid:18)(cid:19)(cid:18)(cid:18)(cid:2)(cid:1)(cid:2)(cid:3,Unknown,16566.0
Unknown,Unknown,26,Unknown,Unknown,Unknown,Unknown,cid:15)(cid:2)(cid:17)(cid:2)(cid:18)(cid:1)(cid:18)(cid:19)(cid:18)(cid:18)(cid:2)(cid:1)(cid:2)(cid:3,Unknown,16592.0
Unknown,Unknown,41,Unknown,Unknown,Unknown,Unknown,cid:15)(cid:2)(cid:17)(cid:2)(cid:18)(cid:1)(cid:18)(cid:19)(cid:18)(cid:18)(cid:2)(cid:1)(cid:2)(cid:3,Unknown,16633.0
Unknown,Unknown,25,Unknown,Unknown,Unknown,Unknown,cid:15)(cid:2)(cid:17)(cid:2)(cid:18)(cid:1)(cid:18)(cid:19)(cid:18)(cid:18)(cid:2)(cid:1)(cid:2)(cid:3,Unknown,16658.0
Unknown,Unknown,2,Unknown,Unknown,Unknown,Unknown,cid:15)(cid:2)(cid:17)(cid:2)(cid:18)(cid:1)(cid:18)(cid:19)(cid:18)(cid:18)(cid:2)(cid:1)(cid:2)(cid:3,Unknown,16660.0
Unknown,Unknown,50,Unknown,Unknown,Unknown,Unknown,cid:15)(cid:2)(cid:17)(cid:2)(cid:18)(cid:1)(cid:18)(cid:19)(cid:18)(cid:18)(cid:2)(cid:1)(cid:2)(cid:3,Unknown,16710.0
Unknown,Unknown,50,Unknown,Unknown,Unknown,Unknown,cid:15)(cid:2)(cid:17)(cid:2)(cid:18)(cid:1)(cid:18)(cid:19)(cid:18)(cid:18)(cid:2)(cid:1)(cid:2)(cid:3,Unknown,16760.0
Unknown,Unknown,18,Unknown,Unknown,Unknown,Unknown,cid:15)(cid:2)(cid:17)(cid:2)(cid:18)(cid:1)(cid:18)(cid:19)(cid:18)(cid:18)(cid:2)(cid:1)(cid:2)(cid:3,Unknown,16778.0
Unknown,Unknown,1,Unknown,Unknown,Unknown,Unknown,cid:15)(cid:2)(cid:17)(cid:2)(cid:18)(cid:1)(cid:18)(cid:19)(cid:18)(cid:18)(cid:2)(cid:1)(cid:2)(cid:3,Unknown,16779.0
Unknown,Unknown,1,Unknown,Unknown,Unknown,Unknown,cid:15)(cid:2)(cid:17)(cid:2)(cid:18)(cid:1)(cid:18)(cid:19)(cid:18)(cid:18)(cid:2)(cid:1)(cid:2)(cid:3,Unknown,16780.0
Unknown,Unknown,37,Unknown,Unknown,Unknown,Unknown,cid:15)(cid:2)(cid:17)(cid:2)(cid:18)(cid:1)(cid:18)(cid:19)(cid:18)(cid:18)(cid:2)(cid:1)(cid:2)(cid:3,Unknown,16817.0
Unknown,Unknown,37,Unknown,Unknown,Unknown,Unknown,cid:15)(cid:2)(cid:17)(cid:2)(cid:18)(cid:1)(cid:18)(cid:19)(cid:18)(cid:18)(cid:2)(cid:1)(cid:2)(cid:3,Unknown,16854.0
Unknown,Unknown,17,Unknown,Unknown,Unknown,Unknown,cid:15)(cid:2)(cid:17)(cid:2)(cid:18)(cid:1)(cid:18)(cid:19)(cid:18)(cid:18)(cid:2)(cid:1)(cid:2)(cid:3,Unknown,16871.0
Unknown,Unknown,45,Unknown,Unknown,Unknown,Unknown,cid:15)(cid:2)(cid:17)(cid:2)(cid:18)(cid:1)(cid:18)(cid:19)(cid:18)(cid:18)(cid:2)(cid:1)(cid:2)(cid:3,Unknown,16916.0
Unknown,Unknown,18,Unknown,Unknown,Unknown,Unknown,cid:15)(cid:2)(cid:17)(cid:2)(cid:18)(cid:1)(cid:18)(cid:19)(cid:18)(cid:18)(cid:2)(cid:1)(cid:2)(cid:3,Unknown,16934.0
Unknown,Unknown,35,Unknown,Unknown,Unknown,Unknown,cid:15)(cid:2)(cid:17)(cid:2)(cid:18)(cid:1)(cid:18)(cid:19)(cid:18)(cid:18)(cid:2)(cid:1)(cid:2)(cid:3,Unknown,16969.0
Unknown,Unknown,10,Unknown,Unknown,Unknown,Unknown,cid:15)(cid:2)(cid:17)(cid:2)(cid:18)(cid:1)(cid:18)(cid:19)(cid:18)(cid:18)(cid:2)(cid:1)(cid:2)(cid:3,Unknown,16979.0
Unknown,Unknown,11,Unknown,Unknown,Unknown,Unknown,cid:15)(cid:2)(cid:17)(cid:2)(cid:18)(cid:1)(cid:18)(cid:19)(cid:18)(cid:18)(cid:2)(cid:1)(cid:2)(cid:3,Unknown,16990.0
Unknown,Unknown,10,Unknown,Unknown,Unknown,Unknown,cid:15)(cid:2)(cid:17)(cid:2)(cid:18)(cid:1)(cid:18)(cid:19)(cid:18)(cid:18)(cid:2)(cid:1)(cid:2)(cid:3,Unknown,17000.0
Unknown,Unknown,46,Unknown,Unknown,Unknown,Unknown,cid:15)(cid:2)(cid:17)(cid:2)(cid:18)(cid:1)(cid:18)(cid:19)(cid:18)(cid:18)(cid:2)(cid:1)(cid:2)(cid:3,Unknown,17046.0
Unknown,Unknown,14,Unknown,Unknown,Unknown,Unknown,cid:15)(cid:2)(cid:17)(cid:2)(cid:18)(cid:1)(cid:18)(cid:19)(cid:18)(cid:18)(cid:2)(cid:1)(cid:2)(cid:3,Unknown,17060.0
Unknown,Unknown,2,Unknown,Unknown,Unknown,Unknown,cid:15)(cid:2)(cid:17)(cid:2)(cid:18)(cid:1)(cid:18)(cid:19)(cid:18)(cid:18)(cid:2)(cid:1)(cid:2)(cid:3,Unknown,17062.0
Unknown,Unknown,12,Unknown,Unknown,Unknown,Unknown,cid:15)(cid:2)(cid:17)(cid:2)(cid:18)(cid:1)(cid:18)(cid:19)(cid:18)(cid:18)(cid:2)(cid:1)(cid:2)(cid:3,Unknown,17074.0
Unknown,Unknown,11,Unknown,Unknown,Unknown,Unknown,cid:15)(cid:2)(cid:17)(cid:2)(cid:18)(cid:1)(cid:18)(cid:19)(cid:18)(cid:18)(cid:2)(cid:1)(cid:2)(cid:3,Unknown,17085.0
Unknown,Unknown,4,Unknown,Unknown,Unknown,Unknown,cid:15)(cid:2)(cid:17)(cid:2)(cid:18)(cid:1)(cid:18)(cid:19)(cid:18)(cid:18)(cid:2)(cid:1)(cid:2)(cid:3,Unknown,17089.0
Unknown,Unknown,14,Unknown,Unknown,Unknown,Unknown,cid:15)(cid:2)(cid:17)(cid:2)(cid:18)(cid:1)(cid:18)(cid:19)(cid:18)(cid:18)(cid:2)(cid:1)(cid:2)(cid:3,Unknown,17103.0
Unknown,Unknown,11,Unknown,Unknown,Unknown,Unknown,cid:15)(cid:2)(cid:17)(cid:2)(cid:18)(cid:1)(cid:18)(cid:19)(cid:18)(cid:18)(cid:2)(cid:1)(cid:2)(cid:3,Unknown,17114.0
Unknown,Unknown,54,Unknown,Unknown,Unknown,Unknown,cid:15)(cid:2)(cid:17)(cid:2)(cid:18)(cid:1)(cid:18)(cid:19)(cid:18)(cid:18)(cid:2)(cid:1)(cid:2)(cid:3,Unknown,17168.0
Unknown,Unknown,54,Unknown,Unknown,Unknown,Unknown,cid:15)(cid:2)(cid:17)(cid:2)(cid:18)(cid:1)(cid:18)(cid:19)(cid:18)(cid:18)(cid:2)(cid:1)(cid:2)(cid:3,Unknown,17222.0
Unknown,Unknown,7,Unknown,Unknown,Unknown,Unknown,cid:15)(cid:2)(cid:17)(cid:2)(cid:18)(cid:1)(cid:18)(cid:19)(cid:18)(cid:18)(cid:2)(cid:1)(cid:2)(cid:3,Unknown,17229.0
Unknown,Unknown,5,Unknown,Unknown,Unknown,Unknown,cid:15)(cid:2)(cid:17)(cid:2)(cid:18)(cid:1)(cid:18)(cid:19)(cid:18)(cid:18)(cid:2)(cid:1)(cid:2)(cid:3,Unknown,17234.0
Unknown,Unknown,3,Unknown,Unknown,Unknown,Unknown,cid:15)(cid:2)(cid:17)(cid:2)(cid:18)(cid:1)(cid:18)(cid:19)(cid:18)(cid:18)(cid:2)(cid:1)(cid:2)(cid:3,Unknown,17237.0
Unknown,Unknown,9,Unknown,Unknown,Unknown,Unknown,cid:15)(cid:2)(cid:17)(cid:2)(cid:18)(cid:1)(cid:18)(cid:19)(cid:18)(cid:18)(cid:2)(cid:1)(cid:2)(cid:3,Unknown,17246.0
Unknown,Unknown,2,Unknown,Unknown,Unknown,Unknown,cid:15)(cid:2)(cid:17)(cid:2)(cid:18)(cid:1)(cid:18)(cid:19)(cid:18)(cid:18)(cid:2)(cid:1)(cid:2)(cid:3,Unknown,17248.0
Unknown,Unknown,28,Unknown,Unknown,Unknown,Unknown,cid:15)(cid:2)(cid:17)(cid:2)(cid:18)(cid:1)(cid:18)(cid:19)(cid:18)(cid:18)(cid:2)(cid:1)(cid:2)(cid:3,Unknown,17276.0
Unknown,Unknown,3,Unknown,Unknown,Unknown,Unknown,cid:15)(cid:2)(cid:17)(cid:2)(cid:18)(cid:1)(cid:18)(cid:19)(cid:18)(cid:18)(cid:2)(cid:1)(cid:2)(cid:3,Unknown,17279.0
Unknown,Unknown,15,Unknown,Unknown,Unknown,Unknown,cid:15)(cid:2)(cid:17)(cid:2)(cid:18)(cid:1)(cid:18)(cid:19)(cid:18)(cid:18)(cid:2)(cid:1)(cid:2)(cid:3,Unknown,17294.0
Unknown,Unknown,2,Unknown,Unknown,Unknown,Unknown,cid:15)(cid:2)(cid:17)(cid:2)(cid:18)(cid:1)(cid:18)(cid:19)(cid:18)(cid:18)(cid:2)(cid:1)(cid:2)(cid:3,Unknown,17296.0
Unknown,Unknown,16,Unknown,Unknown,Unknown,Unknown,cid:15)(cid:2)(cid:17)(cid:2)(cid:18)(cid:1)(cid:18)(cid:19)(cid:18)(cid:18)(cid:2)(cid:1)(cid:2)(cid:3,Unknown,17312.0
Unknown,Unknown,18,Unknown,Unknown,Unknown,Unknown,cid:15)(cid:2)(cid:17)(cid:2)(cid:18)(cid:1)(cid:18)(cid:19)(cid:18)(cid:18)(cid:2)(cid:1)(cid:2)(cid:3,Unknown,17330.0
Unknown,Unknown,19,Unknown,Unknown,Unknown,Unknown,cid:15)(cid:2)(cid:17)(cid:2)(cid:18)(cid:1)(cid:18)(cid:19)(cid:18)(cid:18)(cid:2)(cid:1)(cid:2)(cid:3,Unknown,17349.0
Unknown,Unknown,18,Unknown,Unknown,Unknown,Unknown,cid:15)(cid:2)(cid:17)(cid:2)(cid:18)(cid:1)(cid:18)(cid:19)(cid:18)(cid:18)(cid:2)(cid:1)(cid:2)(cid:3,Unknown,17367.0
Unknown,Unknown,34,Unknown,Unknown,Unknown,Unknown,cid:15)(cid:2)(cid:17)(cid:2)(cid:18)(cid:1)(cid:18)(cid:19)(cid:18)(cid:18)(cid:2)(cid:1)(cid:2)(cid:3,Unknown,17401.0
Unknown,Unknown,2,Unknown,Unknown,Unknown,Unknown,cid:15)(cid:2)(cid:17)(cid:2)(cid:18)(cid:1)(cid:18)(cid:19)(cid:18)(cid:18)(cid:2)(cid:1)(cid:2)(cid:3,Unknown,17403.0
Unknown,Unknown,44,Unknown,Unknown,Unknown,Unknown,cid:15)(cid:2)(cid:17)(cid:2)(cid:18)(cid:1)(cid:18)(cid:19)(cid:18)(cid:18)(cid:2)(cid:1)(cid:2)(cid:3,Unknown,17447.0
Unknown,Unknown,12,Unknown,Unknown,Unknown,Unknown,cid:15)(cid:2)(cid:17)(cid:2)(cid:18)(cid:1)(cid:18)(cid:19)(cid:18)(cid:18)(cid:2)(cid:1)(cid:2)(cid:3,Unknown,17459.0
Unknown,Unknown,29,Unknown,Unknown,Unknown,Unknown,cid:15)(cid:2)(cid:17)(cid:2)(cid:18)(cid:1)(cid:18)(cid:19)(cid:18)(cid:18)(cid:2)(cid:1)(cid:2)(cid:3,Unknown,17488.0
Unknown,Unknown,26,Unknown,Unknown,Unknown,Unknown,cid:15)(cid:2)(cid:17)(cid:2)(cid:18)(cid:1)(cid:18)(cid:19)(cid:18)(cid:18)(cid:2)(cid:1)(cid:2)(cid:3,Unknown,17514.0
Unknown,Unknown,41,Unknown,Unknown,Unknown,Unknown,cid:15)(cid:2)(cid:17)(cid:2)(cid:18)(cid:1)(cid:18)(cid:19)(cid:18)(cid:18)(cid:2)(cid:1)(cid:2)(cid:3,Unknown,17555.0
Unknown,Unknown,25,Unknown,Unknown,Unknown,Unknown,cid:15)(cid:2)(cid:17)(cid:2)(cid:18)(cid:1)(cid:18)(cid:19)(cid:18)(cid:18)(cid:2)(cid:1)(cid:2)(cid:3,Unknown,17580.0
Unknown,Unknown,2,Unknown,Unknown,Unknown,Unknown,cid:15)(cid:2)(cid:17)(cid:2)(cid:18)(cid:1)(cid:18)(cid:19)(cid:18)(cid:18)(cid:2)(cid:1)(cid:2)(cid:3,Unknown,17582.0
Unknown,Unknown,50,Unknown,Unknown,Unknown,Unknown,cid:15)(cid:2)(cid:17)(cid:2)(cid:18)(cid:1)(cid:18)(cid:19)(cid:18)(cid:18)(cid:2)(cid:1)(cid:2)(cid:3,Unknown,17632.0
Unknown,Unknown,50,Unknown,Unknown,Unknown,Unknown,cid:15)(cid:2)(cid:17)(cid:2)(cid:18)(cid:1)(cid:18)(cid:19)(cid:18)(cid:18)(cid:2)(cid:1)(cid:2)(cid:3,Unknown,17682.0
Unknown,Unknown,18,Unknown,Unknown,Unknown,Unknown,cid:15)(cid:2)(cid:17)(cid:2)(cid:18)(cid:1)(cid:18)(cid:19)(cid:18)(cid:18)(cid:2)(cid:1)(cid:2)(cid:3,Unknown,17700.0
Unknown,Unknown,1,Unknown,Unknown,Unknown,Unknown,cid:15)(cid:2)(cid:17)(cid:2)(cid:18)(cid:1)(cid:18)(cid:19)(cid:18)(cid:18)(cid:2)(cid:1)(cid:2)(cid:3,Unknown,17701.0
Unknown,Unknown,1,Unknown,Unknown,Unknown,Unknown,cid:15)(cid:2)(cid:17)(cid:2)(cid:18)(cid:1)(cid:18)(cid:19)(cid:18)(cid:18)(cid:2)(cid:1)(cid:2)(cid:3,Unknown,17702.0
Unknown,Unknown,37,Unknown,Unknown,Unknown,Unknown,cid:15)(cid:2)(cid:17)(cid:2)(cid:18)(cid:1)(cid:18)(cid:19)(cid:18)(cid:18)(cid:2)(cid:1)(cid:2)(cid:3,Unknown,17739.0
Unknown,Unknown,37,Unknown,Unknown,Unknown,Unknown,cid:15)(cid:2)(cid:17)(cid:2)(cid:18)(cid:1)(cid:18)(cid:19)(cid:18)(cid:18)(cid:2)(cid:1)(cid:2)(cid:3,Unknown,17776.0
Unknown,Unknown,17,Unknown,Unknown,Unknown,Unknown,cid:15)(cid:2)(cid:17)(cid:2)(cid:18)(cid:1)(cid:18)(cid:19)(cid:18)(cid:18)(cid:2)(cid:1)(cid:2)(cid:3,Unknown,17793.0
Unknown,Unknown,45,Unknown,Unknown,Unknown,Unknown,cid:15)(cid:2)(cid:17)(cid:2)(cid:18)(cid:1)(cid:18)(cid:19)(cid:18)(cid:18)(cid:2)(cid:1)(cid:2)(cid:3,Unknown,17838.0
Unknown,Unknown,18,Unknown,Unknown,Unknown,Unknown,cid:15)(cid:2)(cid:17)(cid:2)(cid:18)(cid:1)(cid:18)(cid:19)(cid:18)(cid:18)(cid:2)(cid:1)(cid:2)(cid:3,Unknown,17856.0
Unknown,Unknown,35,Unknown,Unknown,Unknown,Unknown,cid:15)(cid:2)(cid:17)(cid:2)(cid:18)(cid:1)(cid:18)(cid:19)(cid:18)(cid:18)(cid:2)(cid:1)(cid:2)(cid:3,Unknown,17891.0
Unknown,Unknown,54,Unknown,Unknown,Unknown,Unknown,cid:15)(cid:2)(cid:17)(cid:2)(cid:18)(cid:1)(cid:18)(cid:19)(cid:18)(cid:18)(cid:2)(cid:1)(cid:2)(cid:3,Unknown,17945.0
Unknown,Unknown,12,Unknown,Unknown,Unknown,Unknown,cid:15)(cid:2)(cid:17)(cid:2)(cid:18)(cid:1)(cid:18)(cid:19)(cid:18)(cid:18)(cid:2)(cid:1)(cid:2)(cid:3,Unknown,17957.0
Unknown,Unknown,2,Unknown,Unknown,Unknown,Unknown,cid:15)(cid:2)(cid:17)(cid:2)(cid:18)(cid:1)(cid:18)(cid:19)(cid:18)(cid:18)(cid:2)(cid:1)(cid:2)(cid:3,Unknown,17959.0
Unknown,Unknown,49,Unknown,Unknown,Unknown,Unknown,cid:15)(cid:2)(cid:17)(cid:2)(cid:18)(cid:1)(cid:18)(cid:19)(cid:18)(cid:18)(cid:2)(cid:1)(cid:2)(cid:3,Unknown,18008.0
Unknown,Unknown,11,Unknown,Unknown,Unknown,Unknown,cid:15)(cid:2)(cid:17)(cid:2)(cid:18)(cid:1)(cid:18)(cid:19)(cid:18)(cid:18)(cid:2)(cid:1)(cid:2)(cid:3,Unknown,18019.0
Unknown,Unknown,8,Unknown,Unknown,Unknown,Unknown,cid:15)(cid:2)(cid:17)(cid:2)(cid:18)(cid:1)(cid:18)(cid:19)(cid:18)(cid:18)(cid:2)(cid:1)(cid:2)(cid:3,Unknown,18027.0
Unknown,Unknown,46,Unknown,Unknown,Unknown,Unknown,cid:15)(cid:2)(cid:17)(cid:2)(cid:18)(cid:1)(cid:18)(cid:19)(cid:18)(cid:18)(cid:2)(cid:1)(cid:2)(cid:3,Unknown,18073.0
Unknown,Unknown,14,Unknown,Unknown,Unknown,Unknown,cid:15)(cid:2)(cid:17)(cid:2)(cid:18)(cid:1)(cid:18)(cid:19)(cid:18)(cid:18)(cid:2)(cid:1)(cid:2)(cid:3,Unknown,18087.0
Unknown,Unknown,49,Unknown,Unknown,Unknown,Unknown,cid:15)(cid:2)(cid:17)(cid:2)(cid:18)(cid:1)(cid:18)(cid:19)(cid:18)(cid:18)(cid:2)(cid:1)(cid:2)(cid:3,Unknown,18136.0
Unknown,Unknown,55,Unknown,Unknown,Unknown,Unknown,cid:15)(cid:2)(cid:17)(cid:2)(cid:18)(cid:1)(cid:18)(cid:19)(cid:18)(cid:18)(cid:2)(cid:1)(cid:2)(cid:3,Unknown,18191.0
Unknown,Unknown,9,Unknown,Unknown,Unknown,Unknown,cid:15)(cid:2)(cid:17)(cid:2)(cid:18)(cid:1)(cid:18)(cid:19)(cid:18)(cid:18)(cid:2)(cid:1)(cid:2)(cid:3,Unknown,18200.0
Unknown,Unknown,2,Unknown,Unknown,Unknown,Unknown,cid:15)(cid:2)(cid:17)(cid:2)(cid:18)(cid:1)(cid:18)(cid:19)(cid:18)(cid:18)(cid:2)(cid:1)(cid:2)(cid:3,Unknown,18202.0
Unknown,Unknown,12,Unknown,Unknown,Unknown,Unknown,cid:15)(cid:2)(cid:17)(cid:2)(cid:18)(cid:1)(cid:18)(cid:19)(cid:18)(cid:18)(cid:2)(cid:1)(cid:2)(cid:3,Unknown,18214.0
Unknown,Unknown,11,Unknown,Unknown,Unknown,Unknown,cid:15)(cid:2)(cid:17)(cid:2)(cid:18)(cid:1)(cid:18)(cid:19)(cid:18)(cid:18)(cid:2)(cid:1)(cid:2)(cid:3,Unknown,18225.0
Unknown,Unknown,4,Unknown,Unknown,Unknown,Unknown,cid:15)(cid:2)(cid:17)(cid:2)(cid:18)(cid:1)(cid:18)(cid:19)(cid:18)(cid:18)(cid:2)(cid:1)(cid:2)(cid:3,Unknown,18229.0
Unknown,Unknown,14,Unknown,Unknown,Unknown,Unknown,cid:15)(cid:2)(cid:17)(cid:2)(cid:18)(cid:1)(cid:18)(cid:19)(cid:18)(cid:18)(cid:2)(cid:1)(cid:2)(cid:3,Unknown,18243.0
Unknown,Unknown,11,Unknown,Unknown,Unknown,Unknown,cid:15)(cid:2)(cid:17)(cid:2)(cid:18)(cid:1)(cid:18)(cid:19)(cid:18)(cid:18)(cid:2)(cid:1)(cid:2)(cid:3,Unknown,18254.0
Unknown,Unknown,54,Unknown,Unknown,Unknown,Unknown,cid:15)(cid:2)(cid:17)(cid:2)(cid:18)(cid:1)(cid:18)(cid:19)(cid:18)(cid:18)(cid:2)(cid:1)(cid:2)(cid:3,Unknown,18308.0
Unknown,Unknown,54,Unknown,Unknown,Unknown,Unknown,cid:15)(cid:2)(cid:17)(cid:2)(cid:18)(cid:1)(cid:18)(cid:19)(cid:18)(cid:18)(cid:2)(cid:1)(cid:2)(cid:3,Unknown,18362.0
Unknown,Unknown,7,Unknown,Unknown,Unknown,Unknown,cid:15)(cid:2)(cid:17)(cid:2)(cid:18)(cid:1)(cid:18)(cid:19)(cid:18)(cid:18)(cid:2)(cid:1)(cid:2)(cid:3,Unknown,18369.0
Unknown,Unknown,5,Unknown,Unknown,Unknown,Unknown,cid:15)(cid:2)(cid:17)(cid:2)(cid:18)(cid:1)(cid:18)(cid:19)(cid:18)(cid:18)(cid:2)(cid:1)(cid:2)(cid:3,Unknown,18374.0
Unknown,Unknown,3,Unknown,Unknown,Unknown,Unknown,cid:15)(cid:2)(cid:17)(cid:2)(cid:18)(cid:1)(cid:18)(cid:19)(cid:18)(cid:18)(cid:2)(cid:1)(cid:2)(cid:3,Unknown,18377.0
Unknown,Unknown,2,Unknown,Unknown,Unknown,Unknown,cid:15)(cid:2)(cid:17)(cid:2)(cid:18)(cid:1)(cid:18)(cid:19)(cid:18)(cid:18)(cid:2)(cid:1)(cid:2)(cid:3,Unknown,18379.0
Unknown,Unknown,28,Unknown,Unknown,Unknown,Unknown,cid:15)(cid:2)(cid:17)(cid:2)(cid:18)(cid:1)(cid:18)(cid:19)(cid:18)(cid:18)(cid:2)(cid:1)(cid:2)(cid:3,Unknown,18407.0
Unknown,Unknown,3,Unknown,Unknown,Unknown,Unknown,cid:15)(cid:2)(cid:17)(cid:2)(cid:18)(cid:1)(cid:18)(cid:19)(cid:18)(cid:18)(cid:2)(cid:1)(cid:2)(cid:3,Unknown,18410.0
Unknown,Unknown,15,Unknown,Unknown,Unknown,Unknown,cid:15)(cid:2)(cid:17)(cid:2)(cid:18)(cid:1)(cid:18)(cid:19)(cid:18)(cid:18)(cid:2)(cid:1)(cid:2)(cid:3,Unknown,18425.0
Unknown,Unknown,2,Unknown,Unknown,Unknown,Unknown,cid:15)(cid:2)(cid:17)(cid:2)(cid:18)(cid:1)(cid:18)(cid:19)(cid:18)(cid:18)(cid:2)(cid:1)(cid:2)(cid:3,Unknown,18427.0
Unknown,Unknown,37,Unknown,Unknown,Unknown,Unknown,cid:15)(cid:2)(cid:17)(cid:2)(cid:18)(cid:1)(cid:18)(cid:19)(cid:18)(cid:18)(cid:2)(cid:1)(cid:2)(cid:3,Unknown,18464.0
Unknown,Unknown,33,Unknown,Unknown,Unknown,Unknown,cid:15)(cid:2)(cid:17)(cid:2)(cid:18)(cid:1)(cid:18)(cid:19)(cid:18)(cid:18)(cid:2)(cid:1)(cid:2)(cid:3,Unknown,18497.0
Unknown,Unknown,19,Unknown,Unknown,Unknown,Unknown,cid:15)(cid:2)(cid:17)(cid:2)(cid:18)(cid:1)(cid:18)(cid:19)(cid:18)(cid:18)(cid:2)(cid:1)(cid:2)(cid:3,Unknown,18516.0
Unknown,Unknown,34,Unknown,Unknown,Unknown,Unknown,cid:15)(cid:2)(cid:17)(cid:2)(cid:18)(cid:1)(cid:18)(cid:19)(cid:18)(cid:18)(cid:2)(cid:1)(cid:2)(cid:3,Unknown,18550.0
Unknown,Unknown,34,Unknown,Unknown,Unknown,Unknown,cid:15)(cid:2)(cid:17)(cid:2)(cid:18)(cid:1)(cid:18)(cid:19)(cid:18)(cid:18)(cid:2)(cid:1)(cid:2)(cid:3,Unknown,18584.0
Unknown,Unknown,2,Unknown,Unknown,Unknown,Unknown,cid:15)(cid:2)(cid:17)(cid:2)(cid:18)(cid:1)(cid:18)(cid:19)(cid:18)(cid:18)(cid:2)(cid:1)(cid:2)(cid:3,Unknown,18586.0
Unknown,Unknown,44,Unknown,Unknown,Unknown,Unknown,cid:15)(cid:2)(cid:17)(cid:2)(cid:18)(cid:1)(cid:18)(cid:19)(cid:18)(cid:18)(cid:2)(cid:1)(cid:2)(cid:3,Unknown,18630.0
Unknown,Unknown,12,Unknown,Unknown,Unknown,Unknown,cid:15)(cid:2)(cid:17)(cid:2)(cid:18)(cid:1)(cid:18)(cid:19)(cid:18)(cid:18)(cid:2)(cid:1)(cid:2)(cid:3,Unknown,18642.0
Unknown,Unknown,29,Unknown,Unknown,Unknown,Unknown,cid:15)(cid:2)(cid:17)(cid:2)(cid:18)(cid:1)(cid:18)(cid:19)(cid:18)(cid:18)(cid:2)(cid:1)(cid:2)(cid:3,Unknown,18671.0
Unknown,Unknown,26,Unknown,Unknown,Unknown,Unknown,cid:15)(cid:2)(cid:17)(cid:2)(cid:18)(cid:1)(cid:18)(cid:19)(cid:18)(cid:18)(cid:2)(cid:1)(cid:2)(cid:3,Unknown,18697.0
Unknown,Unknown,41,Unknown,Unknown,Unknown,Unknown,cid:15)(cid:2)(cid:17)(cid:2)(cid:18)(cid:1)(cid:18)(cid:19)(cid:18)(cid:18)(cid:2)(cid:1)(cid:2)(cid:3,Unknown,18738.0
Unknown,Unknown,25,Unknown,Unknown,Unknown,Unknown,cid:15)(cid:2)(cid:17)(cid:2)(cid:18)(cid:1)(cid:18)(cid:19)(cid:18)(cid:18)(cid:2)(cid:1)(cid:2)(cid:3,Unknown,18763.0
Unknown,Unknown,2,Unknown,Unknown,Unknown,Unknown,cid:15)(cid:2)(cid:17)(cid:2)(cid:18)(cid:1)(cid:18)(cid:19)(cid:18)(cid:18)(cid:2)(cid:1)(cid:2)(cid:3,Unknown,18765.0
Unknown,Unknown,50,Unknown,Unknown,Unknown,Unknown,cid:15)(cid:2)(cid:17)(cid:2)(cid:18)(cid:1)(cid:18)(cid:19)(cid:18)(cid:18)(cid:2)(cid:1)(cid:2)(cid:3,Unknown,18815.0
Unknown,Unknown,50,Unknown,Unknown,Unknown,Unknown,cid:15)(cid:2)(cid:17)(cid:2)(cid:18)(cid:1)(cid:18)(cid:19)(cid:18)(cid:18)(cid:2)(cid:1)(cid:2)(cid:3,Unknown,18865.0
Unknown,Unknown,18,Unknown,Unknown,Unknown,Unknown,cid:15)(cid:2)(cid:17)(cid:2)(cid:18)(cid:1)(cid:18)(cid:19)(cid:18)(cid:18)(cid:2)(cid:1)(cid:2)(cid:3,Unknown,18883.0
Unknown,Unknown,1,Unknown,Unknown,Unknown,Unknown,cid:15)(cid:2)(cid:17)(cid:2)(cid:18)(cid:1)(cid:18)(cid:19)(cid:18)(cid:18)(cid:2)(cid:1)(cid:2)(cid:3,Unknown,18884.0
Unknown,Unknown,1,Unknown,Unknown,Unknown,Unknown,cid:15)(cid:2)(cid:17)(cid:2)(cid:18)(cid:1)(cid:18)(cid:19)(cid:18)(cid:18)(cid:2)(cid:1)(cid:2)(cid:3,Unknown,18885.0
Unknown,Unknown,37,Unknown,Unknown,Unknown,Unknown,cid:15)(cid:2)(cid:17)(cid:2)(cid:18)(cid:1)(cid:18)(cid:19)(cid:18)(cid:18)(cid:2)(cid:1)(cid:2)(cid:3,Unknown,18922.0
Unknown,Unknown,37,Unknown,Unknown,Unknown,Unknown,cid:15)(cid:2)(cid:17)(cid:2)(cid:18)(cid:1)(cid:18)(cid:19)(cid:18)(cid:18)(cid:2)(cid:1)(cid:2)(cid:3,Unknown,18959.0
Unknown,Unknown,17,Unknown,Unknown,Unknown,Unknown,cid:15)(cid:2)(cid:17)(cid:2)(cid:18)(cid:1)(cid:18)(cid:19)(cid:18)(cid:18)(cid:2)(cid:1)(cid:2)(cid:3,Unknown,18976.0
Unknown,Unknown,45,Unknown,Unknown,Unknown,Unknown,cid:15)(cid:2)(cid:17)(cid:2)(cid:18)(cid:1)(cid:18)(cid:19)(cid:18)(cid:18)(cid:2)(cid:1)(cid:2)(cid:3,Unknown,19021.0
Unknown,Unknown,18,Unknown,Unknown,Unknown,Unknown,cid:15)(cid:2)(cid:17)(cid:2)(cid:18)(cid:1)(cid:18)(cid:19)(cid:18)(cid:18)(cid:2)(cid:1)(cid:2)(cid:3,Unknown,19039.0
Unknown,Unknown,35,Unknown,Unknown,Unknown,Unknown,cid:15)(cid:2)(cid:17)(cid:2)(cid:18)(cid:1)(cid:18)(cid:19)(cid:18)(cid:18)(cid:2)(cid:1)(cid:2)(cid:3,Unknown,19074.0
Unknown,Unknown,9,Unknown,Unknown,Unknown,Unknown,cid:15)(cid:2)(cid:17)(cid:2)(cid:18)(cid:1)(cid:18)(cid:19)(cid:18)(cid:18)(cid:2)(cid:1)(cid:2)(cid:3,Unknown,19083.0
Unknown,Unknown,46,Unknown,Unknown,Unknown,Unknown,cid:15)(cid:2)(cid:17)(cid:2)(cid:18)(cid:1)(cid:18)(cid:19)(cid:18)(cid:18)(cid:2)(cid:1)(cid:2)(cid:3,Unknown,19129.0
Unknown,Unknown,8,Unknown,Unknown,Unknown,Unknown,cid:15)(cid:2)(cid:17)(cid:2)(cid:18)(cid:1)(cid:18)(cid:19)(cid:18)(cid:18)(cid:2)(cid:1)(cid:2)(cid:3,Unknown,19137.0
Unknown,Unknown,5,Unknown,Unknown,Unknown,Unknown,cid:15)(cid:2)(cid:17)(cid:2)(cid:18)(cid:1)(cid:18)(cid:19)(cid:18)(cid:18)(cid:2)(cid:1)(cid:2)(cid:3,Unknown,19142.0
Unknown,Unknown,28,Unknown,Unknown,Unknown,Unknown,cid:15)(cid:2)(cid:17)(cid:2)(cid:18)(cid:1)(cid:18)(cid:19)(cid:18)(cid:18)(cid:2)(cid:1)(cid:2)(cid:3,Unknown,19170.0
Unknown,Unknown,2,Unknown,Unknown,Unknown,Unknown,cid:15)(cid:2)(cid:17)(cid:2)(cid:18)(cid:1)(cid:18)(cid:19)(cid:18)(cid:18)(cid:2)(cid:1)(cid:2)(cid:3,Unknown,19172.0
Unknown,Unknown,46,Unknown,Unknown,Unknown,Unknown,cid:15)(cid:2)(cid:17)(cid:2)(cid:18)(cid:1)(cid:18)(cid:19)(cid:18)(cid:18)(cid:2)(cid:1)(cid:2)(cid:3,Unknown,19218.0
Unknown,Unknown,4,Unknown,Unknown,Unknown,Unknown,cid:15)(cid:2)(cid:17)(cid:2)(cid:18)(cid:1)(cid:18)(cid:19)(cid:18)(cid:18)(cid:2)(cid:1)(cid:2)(cid:3,Unknown,19222.0
Unknown,Unknown,10,Unknown,Unknown,Unknown,Unknown,cid:15)(cid:2)(cid:17)(cid:2)(cid:18)(cid:1)(cid:18)(cid:19)(cid:18)(cid:18)(cid:2)(cid:1)(cid:2)(cid:3,Unknown,19232.0
Unknown,Unknown,11,Unknown,Unknown,Unknown,Unknown,cid:15)(cid:2)(cid:17)(cid:2)(cid:18)(cid:1)(cid:18)(cid:19)(cid:18)(cid:18)(cid:2)(cid:1)(cid:2)(cid:3,Unknown,19243.0
Unknown,Unknown,3,Unknown,Unknown,Unknown,Unknown,cid:15)(cid:2)(cid:17)(cid:2)(cid:18)(cid:1)(cid:18)(cid:19)(cid:18)(cid:18)(cid:2)(cid:1)(cid:2)(cid:3,Unknown,19246.0
Unknown,Unknown,11,Unknown,Unknown,Unknown,Unknown,cid:15)(cid:2)(cid:17)(cid:2)(cid:18)(cid:1)(cid:18)(cid:19)(cid:18)(cid:18)(cid:2)(cid:1)(cid:2)(cid:3,Unknown,19257.0
Unknown,Unknown,4,Unknown,Unknown,Unknown,Unknown,cid:15)(cid:2)(cid:17)(cid:2)(cid:18)(cid:1)(cid:18)(cid:19)(cid:18)(cid:18)(cid:2)(cid:1)(cid:2)(cid:3,Unknown,19261.0
Unknown,Unknown,10,Unknown,Unknown,Unknown,Unknown,cid:15)(cid:2)(cid:17)(cid:2)(cid:18)(cid:1)(cid:18)(cid:19)(cid:18)(cid:18)(cid:2)(cid:1)(cid:2)(cid:3,Unknown,19271.0
Unknown,Unknown,5,Unknown,Unknown,Unknown,Unknown,cid:15)(cid:2)(cid:17)(cid:2)(cid:18)(cid:1)(cid:18)(cid:19)(cid:18)(cid:18)(cid:2)(cid:1)(cid:2)(cid:3,Unknown,19276.0
Unknown,Unknown,2,Unknown,Unknown,Unknown,Unknown,cid:15)(cid:2)(cid:17)(cid:2)(cid:18)(cid:1)(cid:18)(cid:19)(cid:18)(cid:18)(cid:2)(cid:1)(cid:2)(cid:3,Unknown,19278.0
Unknown,Unknown,9,Unknown,Unknown,Unknown,Unknown,cid:15)(cid:2)(cid:17)(cid:2)(cid:18)(cid:1)(cid:18)(cid:19)(cid:18)(cid:18)(cid:2)(cid:1)(cid:2)(cid:3,Unknown,19287.0
Unknown,Unknown,5,Unknown,Unknown,Unknown,Unknown,cid:15)(cid:2)(cid:17)(cid:2)(cid:18)(cid:1)(cid:18)(cid:19)(cid:18)(cid:18)(cid:2)(cid:1)(cid:2)(cid:3,Unknown,19292.0
Unknown,Unknown,8,Unknown,Unknown,Unknown,Unknown,cid:15)(cid:2)(cid:17)(cid:2)(cid:18)(cid:1)(cid:18)(cid:19)(cid:18)(cid:18)(cid:2)(cid:1)(cid:2)(cid:3,Unknown,19300.0
Unknown,Unknown,14,Unknown,Unknown,Unknown,Unknown,cid:15)(cid:2)(cid:17)(cid:2)(cid:18)(cid:1)(cid:18)(cid:19)(cid:18)(cid:18)(cid:2)(cid:1)(cid:2)(cid:3,Unknown,19314.0
Unknown,Unknown,7,Unknown,Unknown,Unknown,Unknown,cid:15)(cid:2)(cid:17)(cid:2)(cid:18)(cid:1)(cid:18)(cid:19)(cid:18)(cid:18)(cid:2)(cid:1)(cid:2)(cid:3,Unknown,19321.0
Unknown,Unknown,9,Unknown,Unknown,Unknown,Unknown,cid:15)(cid:2)(cid:17)(cid:2)(cid:18)(cid:1)(cid:18)(cid:19)(cid:18)(cid:18)(cid:2)(cid:1)(cid:2)(cid:3,Unknown,19330.0
Unknown,Unknown,2,Unknown,Unknown,Unknown,Unknown,cid:15)(cid:2)(cid:17)(cid:2)(cid:18)(cid:1)(cid:18)(cid:19)(cid:18)(cid:18)(cid:2)(cid:1)(cid:2)(cid:3,Unknown,19332.0
Unknown,Unknown,12,Unknown,Unknown,Unknown,Unknown,cid:15)(cid:2)(cid:17)(cid:2)(cid:18)(cid:1)(cid:18)(cid:19)(cid:18)(cid:18)(cid:2)(cid:1)(cid:2)(cid:3,Unknown,19344.0
Unknown,Unknown,5,Unknown,Unknown,Unknown,Unknown,cid:15)(cid:2)(cid:17)(cid:2)(cid:18)(cid:1)(cid:18)(cid:19)(cid:18)(cid:18)(cid:2)(cid:1)(cid:2)(cid:3,Unknown,19349.0
Unknown,Unknown,49,Unknown,Unknown,Unknown,Unknown,cid:15)(cid:2)(cid:17)(cid:2)(cid:18)(cid:1)(cid:18)(cid:19)(cid:18)(cid:18)(cid:2)(cid:1)(cid:2)(cid:3,Unknown,19398.0
Unknown,Unknown,5,Unknown,Unknown,Unknown,Unknown,cid:15)(cid:2)(cid:17)(cid:2)(cid:18)(cid:1)(cid:18)(cid:19)(cid:18)(cid:18)(cid:2)(cid:1)(cid:2)(cid:3,Unknown,19403.0
Unknown,Unknown,40,Unknown,Unknown,Unknown,Unknown,cid:15)(cid:2)(cid:17)(cid:2)(cid:18)(cid:1)(cid:18)(cid:19)(cid:18)(cid:18)(cid:2)(cid:1)(cid:2)(cid:3,Unknown,19443.0
Unknown,Unknown,2,Unknown,Unknown,Unknown,Unknown,cid:15)(cid:2)(cid:17)(cid:2)(cid:18)(cid:1)(cid:18)(cid:19)(cid:18)(cid:18)(cid:2)(cid:1)(cid:2)(cid:3,Unknown,19445.0
Unknown,Unknown,28,Unknown,Unknown,Unknown,Unknown,cid:15)(cid:2)(cid:17)(cid:2)(cid:18)(cid:1)(cid:18)(cid:19)(cid:18)(cid:18)(cid:2)(cid:1)(cid:2)(cid:3,Unknown,19473.0
Unknown,Unknown,3,Unknown,Unknown,Unknown,Unknown,cid:15)(cid:2)(cid:17)(cid:2)(cid:18)(cid:1)(cid:18)(cid:19)(cid:18)(cid:18)(cid:2)(cid:1)(cid:2)(cid:3,Unknown,19476.0
Unknown,Unknown,15,Unknown,Unknown,Unknown,Unknown,cid:15)(cid:2)(cid:17)(cid:2)(cid:18)(cid:1)(cid:18)(cid:19)(cid:18)(cid:18)(cid:2)(cid:1)(cid:2)(cid:3,Unknown,19491.0
Unknown,Unknown,2,Unknown,Unknown,Unknown,Unknown,cid:15)(cid:2)(cid:17)(cid:2)(cid:18)(cid:1)(cid:18)(cid:19)(cid:18)(cid:18)(cid:2)(cid:1)(cid:2)(cid:3,Unknown,19493.0
Unknown,Unknown,36,Unknown,Unknown,Unknown,Unknown,cid:15)(cid:2)(cid:17)(cid:2)(cid:18)(cid:1)(cid:18)(cid:19)(cid:18)(cid:18)(cid:2)(cid:1)(cid:2)(cid:3,Unknown,19529.0
Unknown,Unknown,19,Unknown,Unknown,Unknown,Unknown,cid:15)(cid:2)(cid:17)(cid:2)(cid:18)(cid:1)(cid:18)(cid:19)(cid:18)(cid:18)(cid:2)(cid:1)(cid:2)(cid:3,Unknown,19548.0
Unknown,Unknown,32,Unknown,Unknown,Unknown,Unknown,cid:15)(cid:2)(cid:17)(cid:2)(cid:18)(cid:1)(cid:18)(cid:19)(cid:18)(cid:18)(cid:2)(cid:1)(cid:2)(cid:3,Unknown,19580.0
Unknown,Unknown,18,Unknown,Unknown,Unknown,Unknown,cid:15)(cid:2)(cid:17)(cid:2)(cid:18)(cid:1)(cid:18)(cid:19)(cid:18)(cid:18)(cid:2)(cid:1)(cid:2)(cid:3,Unknown,19598.0
Unknown,Unknown,2,Unknown,Unknown,Unknown,Unknown,cid:15)(cid:2)(cid:17)(cid:2)(cid:18)(cid:1)(cid:18)(cid:19)(cid:18)(cid:18)(cid:2)(cid:1)(cid:2)(cid:3,Unknown,19600.0
Unknown,Unknown,44,Unknown,Unknown,Unknown,Unknown,cid:15)(cid:2)(cid:17)(cid:2)(cid:18)(cid:1)(cid:18)(cid:19)(cid:18)(cid:18)(cid:2)(cid:1)(cid:2)(cid:3,Unknown,19644.0
Unknown,Unknown,12,Unknown,Unknown,Unknown,Unknown,cid:15)(cid:2)(cid:17)(cid:2)(cid:18)(cid:1)(cid:18)(cid:19)(cid:18)(cid:18)(cid:2)(cid:1)(cid:2)(cid:3,Unknown,19656.0
Unknown,Unknown,29,Unknown,Unknown,Unknown,Unknown,cid:15)(cid:2)(cid:17)(cid:2)(cid:18)(cid:1)(cid:18)(cid:19)(cid:18)(cid:18)(cid:2)(cid:1)(cid:2)(cid:3,Unknown,19685.0
Unknown,Unknown,26,Unknown,Unknown,Unknown,Unknown,cid:15)(cid:2)(cid:17)(cid:2)(cid:18)(cid:1)(cid:18)(cid:19)(cid:18)(cid:18)(cid:2)(cid:1)(cid:2)(cid:3,Unknown,19711.0
Unknown,Unknown,41,Unknown,Unknown,Unknown,Unknown,cid:15)(cid:2)(cid:17)(cid:2)(cid:18)(cid:1)(cid:18)(cid:19)(cid:18)(cid:18)(cid:2)(cid:1)(cid:2)(cid:3,Unknown,19752.0
Unknown,Unknown,25,Unknown,Unknown,Unknown,Unknown,cid:15)(cid:2)(cid:17)(cid:2)(cid:18)(cid:1)(cid:18)(cid:19)(cid:18)(cid:18)(cid:2)(cid:1)(cid:2)(cid:3,Unknown,19777.0
Unknown,Unknown,2,Unknown,Unknown,Unknown,Unknown,cid:15)(cid:2)(cid:17)(cid:2)(cid:18)(cid:1)(cid:18)(cid:19)(cid:18)(cid:18)(cid:2)(cid:1)(cid:2)(cid:3,Unknown,19779.0
Unknown,Unknown,50,Unknown,Unknown,Unknown,Unknown,cid:15)(cid:2)(cid:17)(cid:2)(cid:18)(cid:1)(cid:18)(cid:19)(cid:18)(cid:18)(cid:2)(cid:1)(cid:2)(cid:3,Unknown,19829.0
Unknown,Unknown,50,Unknown,Unknown,Unknown,Unknown,cid:15)(cid:2)(cid:17)(cid:2)(cid:18)(cid:1)(cid:18)(cid:19)(cid:18)(cid:18)(cid:2)(cid:1)(cid:2)(cid:3,Unknown,19879.0
Unknown,Unknown,18,Unknown,Unknown,Unknown,Unknown,cid:15)(cid:2)(cid:17)(cid:2)(cid:18)(cid:1)(cid:18)(cid:19)(cid:18)(cid:18)(cid:2)(cid:1)(cid:2)(cid:3,Unknown,19897.0
Unknown,Unknown,1,Unknown,Unknown,Unknown,Unknown,cid:15)(cid:2)(cid:17)(cid:2)(cid:18)(cid:1)(cid:18)(cid:19)(cid:18)(cid:18)(cid:2)(cid:1)(cid:2)(cid:3,Unknown,19898.0
Unknown,Unknown,1,Unknown,Unknown,Unknown,Unknown,cid:15)(cid:2)(cid:17)(cid:2)(cid:18)(cid:1)(cid:18)(cid:19)(cid:18)(cid:18)(cid:2)(cid:1)(cid:2)(cid:3,Unknown,19899.0
Unknown,Unknown,37,Unknown,Unknown,Unknown,Unknown,cid:15)(cid:2)(cid:17)(cid:2)(cid:18)(cid:1)(cid:18)(cid:19)(cid:18)(cid:18)(cid:2)(cid:1)(cid:2)(cid:3,Unknown,19936.0
14/02/2022,Unknown,18,Unknown,Unknown,Cheque,Unknown,C8,VOTRE COMPTE COURANT N' 02421381795 DATE,18.0
31/03/2022,Unknown,03,Unknown,Unknown,Cheque,Unknown,C8,DEPOT AGENCE 0006,21.0
Unknown,Unknown,19,Unknown,Unknown,Cheque,Unknown,C8,SOUS RESERVEDE CoMptaGE,40.0
Unknown,Unknown,03,Unknown,Unknown,Cheque,Unknown,C8,ReMISE,43.0
Unknown,Unknown,388,Unknown,Unknown,Cheque,Unknown,C8,BRUT 388 12e,431.0
Unknown,Unknown,1,Unknown,Unknown,Cheque,Unknown,C8,ReMISE,432.0
Unknown,Unknown,21,Unknown,Unknown,Cheque,Unknown,C8,CoMoooE M80o51/131122,453.0
Unknown,Unknown,03,Unknown,Unknown,Cheque,Unknown,C8,REMISE,456.0
Unknown,Unknown,467 456,Unknown,Unknown,Cheque,Unknown,C8,BRUT 30 0E COH 0 0OE,467912.0
Unknown,Unknown,21,Unknown,Unknown,Cheque,Unknown,C8,ReMISE,467933.0
Unknown,Unknown,03,Unknown,Unknown,Cheque,Unknown,C8,Soe CoM,467936.0
Unknown,Unknown,50,Unknown,Unknown,Cheque,Unknown,C8,REMISE C8,467986.0
Unknown,Unknown,30,Unknown,Unknown,Cheque,Unknown,C8,REMISE,468016.0
Unknown,Unknown,0,Unknown,Unknown,Cheque,Unknown,C8,BRUT 471 896 Cou 0oe,468016.0
Unknown,Unknown,21,Unknown,Unknown,Cheque,Unknown,C8,DAC CASINOSS867O1CO FRAICON,468037.0
Unknown,Unknown,03,Unknown,Unknown,Cheque,Unknown,C8,DEPOT AGENCE 0006,468040.0
Unknown,Unknown,3,Unknown,Unknown,Cheque,Unknown,C8,SOUS ReSERVEDE CoMPTAGE,468043.0
Unknown,Unknown,21,Unknown,Unknown,Cheque,Unknown,C8,"DOT CAP 247,30",468064.0
Unknown,Unknown,03,Unknown,Unknown,Cheque,Unknown,C8,COM,468067.0
Unknown,Unknown,326,Unknown,Unknown,Cheque,Unknown,C8,REMISE,468393.0
Unknown,Unknown,0,Unknown,Unknown,Cheque,Unknown,C8,Goe CoH,468393.0
Unknown,Unknown,21,Unknown,Unknown,Cheque,Unknown,C8,DATE DaTE OPERATION,468414.0
Unknown,Unknown,03,Unknown,Unknown,Cheque,Unknown,C8,OAIV7H3,468417.0
Unknown,Unknown,540,Unknown,Unknown,Cheque,Unknown,C8,OAJSHIK,468957.0
Unknown,Unknown,21,Unknown,Unknown,Cheque,Unknown,C8,Franche-Conté,468978.0
Unknown,Unknown,03,Unknown,Unknown,Cheque,Unknown,C8,QOMIE,468981.0
Unknown,Unknown,40,Unknown,Unknown,Cheque,Unknown,C8,Q5 0235,469021.0
Unknown,Unknown,0 136,Unknown,Unknown,Cheque,Unknown,C8,Bd0le Iremoulle,469157.0
Unknown,Unknown,21,Unknown,Unknown,Cheque,Unknown,C8,Coer F CCP Dion,469178.0
Unknown,Unknown,03,Unknown,Unknown,Cheque,Unknown,C8,Carba Assuaces,469181.0
Unknown,Unknown,471 896,Unknown,Unknown,Cheque,Unknown,C8,Unknown,941077.0
Unknown,Unknown,21,Unknown,Unknown,Cheque,Unknown,C8,Unknown,941098.0
Unknown,Unknown,03,Unknown,Unknown,Cheque,Unknown,C8,Unknown,941101.0
Unknown,Unknown,50,Unknown,Unknown,Cheque,Unknown,C8,Unknown,941151.0
Unknown,Unknown,311,Unknown,Unknown,Cheque,Unknown,C8,Unknown,941462.0
Unknown,Unknown,21,Unknown,Unknown,Cheque,Unknown,C8,Unknown,941483.0
Unknown,Unknown,03,Unknown,Unknown,Cheque,Unknown,C8,Unknown,941486.0
Unknown,Unknown,128,Unknown,Unknown,Cheque,Unknown,C8,Unknown,941614.0
Unknown,Unknown,05 21,Unknown,Unknown,Cheque,Unknown,C8,Unknown,942135.0
Unknown,Unknown,03,Unknown,Unknown,Cheque,Unknown,C8,Unknown,942138.0
Unknown,Unknown,21,Unknown,Unknown,Cheque,Unknown,C8,Unknown,942159.0
Unknown,Unknown,03,Unknown,Unknown,Cheque,Unknown,C8,Unknown,942162.0
Unknown,Unknown,470,Unknown,Unknown,Cheque,Unknown,C8,Unknown,942632.0
Unknown,Unknown,21,Unknown,Unknown,Cheque,Unknown,C8,Unknown,942653.0
Unknown,Unknown,03,Unknown,Unknown,Cheque,Unknown,C8,Unknown,942656.0
Unknown,Unknown,21,Unknown,Unknown,Cheque,Unknown,C8,Unknown,942677.0
Unknown,Unknown,03,Unknown,Unknown,Cheque,Unknown,C8,Unknown,942680.0
Unknown,Unknown,21,Unknown,Unknown,Cheque,Unknown,C8,Unknown,942701.0
Unknown,Unknown,03,Unknown,Unknown,Cheque,Unknown,C8,Unknown,942704.0
Unknown,Unknown,320 21,Unknown,Unknown,Cheque,Unknown,C8,Unknown,974725.0
Unknown,Unknown,03,Unknown,Unknown,Cheque,Unknown,C8,Unknown,974728.0
Unknown,Unknown,21,Unknown,Unknown,Cheque,Unknown,C8,Unknown,974749.0
Unknown,Unknown,03,Unknown,Unknown,Cheque,Unknown,C8,Unknown,974752.0
Unknown,Unknown,14,Unknown,Unknown,Cheque,Unknown,C8,Unknown,974766.0
Unknown,Unknown,02,Unknown,Unknown,Cheque,Unknown,C8,Unknown,974768.0
Unknown,Unknown,21,Unknown,Unknown,Cheque,Unknown,C8,Unknown,974789.0
Unknown,Unknown,03,Unknown,Unknown,Cheque,Unknown,C8,Unknown,974792.0
Unknown,Unknown,22,Unknown,Unknown,Cheque,Unknown,C8,Unknown,974814.0
Unknown,Unknown,03,Unknown,Unknown,Cheque,Unknown,C8,Unknown,974817.0
Unknown,Unknown,"247,30",Unknown,Unknown,Cheque,Unknown,C8,Unknown,999547.0
Unknown,Unknown,"12,35",Unknown,Unknown,Cheque,Unknown,C8,Unknown,1000782.0
Unknown,Unknown,22,Unknown,Unknown,Cheque,Unknown,C8,Unknown,1000804.0
Unknown,Unknown,03,Unknown,Unknown,Cheque,Unknown,C8,Unknown,1000807.0
Unknown,Unknown,335,Unknown,Unknown,Cheque,Unknown,C8,Unknown,1001142.0
Unknown,Unknown,22,Unknown,Unknown,Cheque,Unknown,C8,Unknown,1001164.0
Unknown,Unknown,03,Unknown,Unknown,Cheque,Unknown,C8,Unknown,1001167.0
Unknown,Unknown,50,Unknown,Unknown,Cheque,Unknown,C8,Unknown,1001217.0
Unknown,Unknown,185,Unknown,Unknown,Cheque,Unknown,C8,Unknown,1001402.0
Unknown,Unknown,0,Unknown,Unknown,Cheque,Unknown,C8,Unknown,1001402.0
Unknown,Unknown,22,Unknown,Unknown,Cheque,Unknown,C8,Unknown,1001424.0
Unknown,Unknown,03,Unknown,Unknown,Cheque,Unknown,C8,Unknown,1001427.0
Unknown,Unknown,22,Unknown,Unknown,Cheque,Unknown,C8,Unknown,1001449.0
Unknown,Unknown,03,Unknown,Unknown,Cheque,Unknown,C8,Unknown,1001452.0
Unknown,Unknown,22,Unknown,Unknown,Cheque,Unknown,C8,Unknown,1001474.0
Unknown,Unknown,03,Unknown,Unknown,Cheque,Unknown,C8,Unknown,1001477.0
Unknown,Unknown,22,Unknown,Unknown,Cheque,Unknown,C8,Unknown,1001499.0
Unknown,Unknown,03,Unknown,Unknown,Cheque,Unknown,C8,Unknown,1001502.0
Unknown,Unknown,000,Unknown,Unknown,Cheque,Unknown,C8,Unknown,1001502.0
Unknown,Unknown,2,Unknown,Unknown,Cheque,Unknown,C8,Unknown,1001504.0
Unknown,Unknown,31,Unknown,Unknown,Cheque,Unknown,C8,Unknown,1001535.0
Unknown,Unknown,03,Unknown,Unknown,Cheque,Unknown,C8,Unknown,1001538.0
Unknown,Unknown,"610,00",Unknown,Unknown,Cheque,Unknown,C8,Unknown,1062538.0
Unknown,Unknown,18,Unknown,Unknown,Cheque,Unknown,C8,Unknown,1062556.0
Unknown,Unknown,03 18,Unknown,Unknown,Cheque,Unknown,C8,Unknown,1062874.0
Unknown,Unknown,03,Unknown,Unknown,Cheque,Unknown,C8,Unknown,1062877.0
Unknown,Unknown,18,Unknown,Unknown,Cheque,Unknown,C8,Unknown,1062895.0
Unknown,Unknown,03 18,Unknown,Unknown,Cheque,Unknown,C8,Unknown,1063213.0
Unknown,Unknown,03 386 89,Unknown,Unknown,Cheque,Unknown,C8,Unknown,1401902.0
Unknown,Unknown,21,Unknown,Unknown,Cheque,Unknown,C8,Unknown,1401923.0
Unknown,Unknown,03 21,Unknown,Unknown,Cheque,Unknown,C8,Unknown,1402244.0
Unknown,Unknown,03 467 45,Unknown,Unknown,Cheque,Unknown,C8,Unknown,1748989.0
Unknown,Unknown,21,Unknown,Unknown,Cheque,Unknown,C8,Unknown,1749010.0
Unknown,Unknown,03 21,Unknown,Unknown,Cheque,Unknown,C8,Unknown,1749331.0
Unknown,Unknown,03 30,Unknown,Unknown,Cheque,Unknown,C8,Unknown,1749661.0
Unknown,Unknown,00,Unknown,Unknown,Cheque,Unknown,C8,Unknown,1749661.0
Unknown,Unknown,21,Unknown,Unknown,Cheque,Unknown,C8,Unknown,1749682.0
Unknown,Unknown,03 21,Unknown,Unknown,Cheque,Unknown,C8,Unknown,1750003.0
Unknown,Unknown,03,Unknown,Unknown,Cheque,Unknown,C8,Unknown,1750006.0
Unknown,Unknown,"3,49",Unknown,Unknown,Cheque,Unknown,C8,Unknown,1750355.0
Unknown,Unknown,21,Unknown,Unknown,Cheque,Unknown,C8,Unknown,1750376.0
Unknown,Unknown,03 21,Unknown,Unknown,Cheque,Unknown,C8,Unknown,1750697.0
Unknown,Unknown,"03 253,50",Unknown,Unknown,Cheque,Unknown,C8,Unknown,2076047.0
Unknown,Unknown,21,Unknown,Unknown,Cheque,Unknown,C8,Unknown,2076068.0
Unknown,Unknown,03 21,Unknown,Unknown,Cheque,Unknown,C8,Unknown,2076389.0
Unknown,Unknown,"03 540,24",Unknown,Unknown,Cheque,Unknown,C8,Unknown,2430413.0
Unknown,Unknown,21,Unknown,Unknown,Cheque,Unknown,C8,Unknown,2430434.0
Unknown,Unknown,03 21,Unknown,Unknown,Cheque,Unknown,C8,Unknown,2430755.0
Unknown,Unknown,03 39,Unknown,Unknown,Cheque,Unknown,C8,Unknown,2431094.0
Unknown,Unknown,87,Unknown,Unknown,Cheque,Unknown,C8,Unknown,2431181.0
Unknown,Unknown,21,Unknown,Unknown,Cheque,Unknown,C8,Unknown,2431202.0
Unknown,Unknown,03 21,Unknown,Unknown,Cheque,Unknown,C8,Unknown,2431523.0
Unknown,Unknown,"03 471,89",Unknown,Unknown,Cheque,Unknown,C8,Unknown,2778712.0
Unknown,Unknown,21,Unknown,Unknown,Cheque,Unknown,C8,Unknown,2778733.0
Unknown,Unknown,03 21,Unknown,Unknown,Cheque,Unknown,C8,Unknown,2779054.0
Unknown,Unknown,03 310 20,Unknown,Unknown,Cheque,Unknown,C8,Unknown,3110074.0
Unknown,Unknown,21,Unknown,Unknown,Cheque,Unknown,C8,Unknown,3110095.0
Unknown,Unknown,03 21,Unknown,Unknown,Cheque,Unknown,C8,Unknown,3110416.0
Unknown,Unknown,03,Unknown,Unknown,Cheque,Unknown,C8,Unknown,3110419.0
Unknown,Unknown,"5,38",Unknown,Unknown,Cheque,Unknown,C8,Unknown,3110957.0
Unknown,Unknown,21,Unknown,Unknown,Cheque,Unknown,C8,Unknown,3110978.0
Unknown,Unknown,03 21,Unknown,Unknown,Cheque,Unknown,C8,Unknown,3111299.0
Unknown,Unknown,03,Unknown,Unknown,Cheque,Unknown,C8,Unknown,3111302.0
Unknown,Unknown,21,Unknown,Unknown,Cheque,Unknown,C8,Unknown,3111323.0
Unknown,Unknown,03 21,Unknown,Unknown,Cheque,Unknown,C8,Unknown,3111644.0
Unknown,Unknown,"03 103,01",Unknown,Unknown,Cheque,Unknown,C8,Unknown,3421945.0
Unknown,Unknown,21,Unknown,Unknown,Cheque,Unknown,C8,Unknown,3421966.0
Unknown,Unknown,03 21,Unknown,Unknown,Cheque,Unknown,C8,Unknown,3422287.0
Unknown,Unknown,"03 546,70",Unknown,Unknown,Cheque,Unknown,C8,Unknown,3776957.0
Unknown,Unknown,21,Unknown,Unknown,Cheque,Unknown,C8,Unknown,3776978.0
Unknown,Unknown,03 21,Unknown,Unknown,Cheque,Unknown,C8,Unknown,3777299.0
Unknown,Unknown,03 21,Unknown,Unknown,Cheque,Unknown,C8,Unknown,3777620.0
Unknown,Unknown,03 21,Unknown,Unknown,Cheque,Unknown,C8,Unknown,3777941.0
Unknown,Unknown,03,Unknown,Unknown,Cheque,Unknown,C8,Unknown,3777944.0
Unknown,Unknown,"3 260,00",Unknown,Unknown,Cheque,Unknown,C8,Unknown,4103944.0
Unknown,Unknown,"292,54",Unknown,Unknown,Cheque,Unknown,C8,Unknown,4133198.0
Unknown,Unknown,17,Unknown,Unknown,Cheque,Unknown,C8,Unknown,4133215.0
Unknown,Unknown,03,Unknown,Unknown,Cheque,Unknown,C8,Unknown,4133218.0
Unknown,Unknown,17,Unknown,Unknown,Cheque,Unknown,C8,Unknown,4133235.0
Unknown,Unknown,03,Unknown,Unknown,Cheque,Unknown,C8,Unknown,4133238.0
Unknown,Unknown,388 26,Unknown,Unknown,Cheque,Unknown,C8,Unknown,4172064.0
Unknown,Unknown,"820,00",Unknown,Unknown,Cheque,Unknown,C8,Unknown,4254064.0
Unknown,Unknown,21,Unknown,Unknown,Cheque,Unknown,C8,Unknown,4254085.0
Unknown,Unknown,03,Unknown,Unknown,Cheque,Unknown,C8,Unknown,4254088.0
Unknown,Unknown,21,Unknown,Unknown,Cheque,Unknown,C8,Unknown,4254109.0
Unknown,Unknown,03 21,Unknown,Unknown,Cheque,Unknown,C8,Unknown,4254430.0
Unknown,Unknown,03 19,Unknown,Unknown,Cheque,Unknown,C8,Unknown,4254749.0
Unknown,Unknown,"03 571,75",Unknown,Unknown,Cheque,Unknown,C8,Unknown,4611924.0
Unknown,Unknown,"267,55",Unknown,Unknown,Cheque,Unknown,C8,Unknown,4638679.0
Unknown,Unknown,21,Unknown,Unknown,Cheque,Unknown,C8,Unknown,4638700.0
Unknown,Unknown,03 21,Unknown,Unknown,Cheque,Unknown,C8,Unknown,4639021.0
Unknown,Unknown,"03 335,19",Unknown,Unknown,Cheque,Unknown,C8,Unknown,4972540.0
Unknown,Unknown,21,Unknown,Unknown,Cheque,Unknown,C8,Unknown,4972561.0
Unknown,Unknown,03 21,Unknown,Unknown,Cheque,Unknown,C8,Unknown,4972882.0
Unknown,Unknown,03,Unknown,Unknown,Cheque,Unknown,C8,Unknown,4972885.0
Unknown,Unknown,21,Unknown,Unknown,Cheque,Unknown,C8,Unknown,4972906.0
Unknown,Unknown,03 21,Unknown,Unknown,Cheque,Unknown,C8,Unknown,4973227.0
Unknown,Unknown,03 14,Unknown,Unknown,Cheque,Unknown,C8,Unknown,4973541.0
Unknown,Unknown,00,Unknown,Unknown,Cheque,Unknown,C8,Unknown,4973541.0
Unknown,Unknown,21,Unknown,Unknown,Cheque,Unknown,C8,Unknown,4973562.0
Unknown,Unknown,03 21,Unknown,Unknown,Cheque,Unknown,C8,Unknown,4973883.0
Unknown,Unknown,03,Unknown,Unknown,Cheque,Unknown,C8,Unknown,4973886.0
Unknown,Unknown,"3,90",Unknown,Unknown,Cheque,Unknown,C8,Unknown,4974276.0
Unknown,Unknown,22,Unknown,Unknown,Cheque,Unknown,C8,Unknown,4974298.0
Unknown,Unknown,03,Unknown,Unknown,Cheque,Unknown,C8,Unknown,4974301.0
Unknown,Unknown,"12,00",Unknown,Unknown,Cheque,Unknown,C8,Unknown,4975501.0
Unknown,Unknown,22,Unknown,Unknown,Cheque,Unknown,C8,Unknown,4975523.0
Unknown,Unknown,03,Unknown,Unknown,Cheque,Unknown,C8,Unknown,4975526.0
Unknown,Unknown,"4,60",Unknown,Unknown,Cheque,Unknown,C8,Unknown,4975986.0
Unknown,Unknown,6,Unknown,Unknown,Cheque,Unknown,C8,Unknown,4975992.0
Unknown,Unknown,0,Unknown,Unknown,Cheque,Unknown,C8,Unknown,4975992.0
Unknown,Unknown,2,Unknown,Unknown,Cheque,Unknown,C8,Unknown,4975994.0
Unknown,Unknown,14,Unknown,Unknown,Cheque,Unknown,C8,Unknown,4976008.0
Unknown,Unknown,07,Unknown,Unknown,Cheque,Unknown,C8,Unknown,4976015.0
31/03/2022,Unknown,23,Unknown,Unknown,Cheque,Unknown,RELNS,BANQUE POPULAIRE +X BOURGOGNE FRANCHE,23.0
Unknown,Unknown,03,Unknown,Unknown,Cheque,Unknown,RELNS,DATE,26.0
Unknown,Unknown,23,Unknown,Unknown,Cheque,Unknown,RELNS,Codi,49.0
Unknown,Unknown,03,Unknown,Unknown,Cheque,Unknown,RELNS,Sas Promnogros,52.0
Unknown,Unknown,50,Unknown,Unknown,Cheque,Unknown,RELNS,BRUT,102.0
Unknown,Unknown,481,Unknown,Unknown,Cheque,Unknown,RELNS,V7e,583.0
Unknown,Unknown,0,Unknown,Unknown,Cheque,Unknown,RELNS,REMISE,583.0
Unknown,Unknown,23,Unknown,Unknown,Cheque,Unknown,RELNS,CoM 0 79e Me0016/176756,606.0
Unknown,Unknown,03,Unknown,Unknown,Cheque,Unknown,RELNS,ReMISE,609.0
Unknown,Unknown,241,Unknown,Unknown,Cheque,Unknown,RELNS,CoM,850.0
Unknown,Unknown,0,Unknown,Unknown,Cheque,Unknown,RELNS,INFONET FR-IEL ES BaRceloiu,850.0
Unknown,Unknown,23,Unknown,Unknown,Cheque,Unknown,RELNS,ChEquE 24/03 REMISE,873.0
Unknown,Unknown,03,Unknown,Unknown,Cheque,Unknown,RELNS,BRUT,876.0
Unknown,Unknown,23,Unknown,Unknown,Cheque,Unknown,RELNS,CoM,899.0
Unknown,Unknown,03,Unknown,Unknown,Cheque,Unknown,RELNS,REMISE C8,902.0
Unknown,Unknown,23,Unknown,Unknown,Cheque,Unknown,RELNS,ReMISE,925.0
Unknown,Unknown,03,Unknown,Unknown,Cheque,Unknown,RELNS,CoM,928.0
Unknown,Unknown,23,Unknown,Unknown,Cheque,Unknown,RELNS,DEPOT,951.0
Unknown,Unknown,03,Unknown,Unknown,Cheque,Unknown,RELNS,AGENCE 00064,954.0
Unknown,Unknown,470,Unknown,Unknown,Cheque,Unknown,RELNS,ReMISE,1424.0
Unknown,Unknown,23,Unknown,Unknown,Cheque,Unknown,RELNS,BRUT 147 74E,1447.0
Unknown,Unknown,03,Unknown,Unknown,Cheque,Unknown,RELNS,REMISE,1450.0
Unknown,Unknown,24,Unknown,Unknown,Cheque,Unknown,RELNS,BRUT 86e,1474.0
Unknown,Unknown,03,Unknown,Unknown,Cheque,Unknown,RELNS,BRUT 49E,1477.0
Unknown,Unknown,128 606,Unknown,Unknown,Cheque,Unknown,RELNS,BRUT 1 8e,130083.0
Unknown,Unknown,5,Unknown,Unknown,Cheque,Unknown,RELNS,ReMISE,130088.0
Unknown,Unknown,24,Unknown,Unknown,Cheque,Unknown,RELNS,BRUT 202,130112.0
Unknown,Unknown,03,Unknown,Unknown,Cheque,Unknown,RELNS,"CoM 0,62E M80016/163163 28/03",130115.0
Unknown,Unknown,501 826,Unknown,Unknown,Cheque,Unknown,RELNS,ReMISE,631941.0
Unknown,Unknown,0,Unknown,Unknown,Cheque,Unknown,RELNS,Cou Oo7E,631941.0
Unknown,Unknown,24,Unknown,Unknown,Cheque,Unknown,RELNS,ReMISE,631965.0
Unknown,Unknown,03,Unknown,Unknown,Cheque,Unknown,RELNS,BRUT 124 38e,631968.0
Unknown,Unknown,23,Unknown,Unknown,Cheque,Unknown,RELNS,38E MBooo8 163331,631991.0
Unknown,Unknown,24,Unknown,Unknown,Cheque,Unknown,RELNS,BRUT,632015.0
Unknown,Unknown,03,Unknown,Unknown,Cheque,Unknown,RELNS,Ye CoH,632018.0
Unknown,Unknown,24,Unknown,Unknown,Cheque,Unknown,RELNS,Cheque RELEVE,632042.0
Unknown,Unknown,03,Unknown,Unknown,Cheque,Unknown,RELNS,DATE DaTE OPERATION VALEUR,632045.0
Unknown,Unknown,25,Unknown,Unknown,Cheque,Unknown,RELNS,Franche-Conté,632070.0
Unknown,Unknown,03,Unknown,Unknown,Cheque,Unknown,RELNS,QOMIE,632073.0
Unknown,Unknown,50,Unknown,Unknown,Cheque,Unknown,RELNS,Bd0le Iremoulle,632123.0
Unknown,Unknown,401,Unknown,Unknown,Cheque,Unknown,RELNS,Coer F CCP Dion,632524.0
Unknown,Unknown,0,Unknown,Unknown,Cheque,Unknown,RELNS,CCBPFFPPOMI 01s,632524.0
Unknown,Unknown,25,Unknown,Unknown,Cheque,Unknown,RELNS,Unknown,632549.0
Unknown,Unknown,03,Unknown,Unknown,Cheque,Unknown,RELNS,Unknown,632552.0
Unknown,Unknown,147,Unknown,Unknown,Cheque,Unknown,RELNS,Unknown,632699.0
Unknown,Unknown,0,Unknown,Unknown,Cheque,Unknown,RELNS,Unknown,632699.0
Unknown,Unknown,25,Unknown,Unknown,Cheque,Unknown,RELNS,Unknown,632724.0
Unknown,Unknown,03,Unknown,Unknown,Cheque,Unknown,RELNS,Unknown,632727.0
Unknown,Unknown,25,Unknown,Unknown,Cheque,Unknown,RELNS,Unknown,632752.0
Unknown,Unknown,03,Unknown,Unknown,Cheque,Unknown,RELNS,Unknown,632755.0
Unknown,Unknown,25,Unknown,Unknown,Cheque,Unknown,RELNS,Unknown,632780.0
Unknown,Unknown,03,Unknown,Unknown,Cheque,Unknown,RELNS,Unknown,632783.0
Unknown,Unknown,1,Unknown,Unknown,Cheque,Unknown,RELNS,Unknown,632784.0
Unknown,Unknown,00,Unknown,Unknown,Cheque,Unknown,RELNS,Unknown,632784.0
Unknown,Unknown,26,Unknown,Unknown,Cheque,Unknown,RELNS,Unknown,632810.0
Unknown,Unknown,03,Unknown,Unknown,Cheque,Unknown,RELNS,Unknown,632813.0
Unknown,Unknown,202,Unknown,Unknown,Cheque,Unknown,RELNS,Unknown,633015.0
Unknown,Unknown,0,Unknown,Unknown,Cheque,Unknown,RELNS,Unknown,633015.0
Unknown,Unknown,28,Unknown,Unknown,Cheque,Unknown,RELNS,Unknown,633043.0
Unknown,Unknown,03,Unknown,Unknown,Cheque,Unknown,RELNS,Unknown,633046.0
Unknown,Unknown,456,Unknown,Unknown,Cheque,Unknown,RELNS,Unknown,633502.0
Unknown,Unknown,0,Unknown,Unknown,Cheque,Unknown,RELNS,Unknown,633502.0
Unknown,Unknown,28,Unknown,Unknown,Cheque,Unknown,RELNS,Unknown,633530.0
Unknown,Unknown,03,Unknown,Unknown,Cheque,Unknown,RELNS,Unknown,633533.0
Unknown,Unknown,28,Unknown,Unknown,Cheque,Unknown,RELNS,Unknown,633561.0
Unknown,Unknown,03,Unknown,Unknown,Cheque,Unknown,RELNS,Unknown,633564.0
Unknown,Unknown,124,Unknown,Unknown,Cheque,Unknown,RELNS,Unknown,633688.0
Unknown,Unknown,0,Unknown,Unknown,Cheque,Unknown,RELNS,Unknown,633688.0
Unknown,Unknown,28,Unknown,Unknown,Cheque,Unknown,RELNS,Unknown,633716.0
Unknown,Unknown,03,Unknown,Unknown,Cheque,Unknown,RELNS,Unknown,633719.0
Unknown,Unknown,"747,396",Unknown,Unknown,Cheque,Unknown,RELNS,Unknown,1381115.0
Unknown,Unknown,28,Unknown,Unknown,Cheque,Unknown,RELNS,Unknown,1381143.0
Unknown,Unknown,03,Unknown,Unknown,Cheque,Unknown,RELNS,Unknown,1381146.0
Unknown,Unknown,50,Unknown,Unknown,Cheque,Unknown,RELNS,Unknown,1381196.0
Unknown,Unknown,6,Unknown,Unknown,Cheque,Unknown,RELNS,Unknown,1381202.0
Unknown,Unknown,28,Unknown,Unknown,Cheque,Unknown,RELNS,Unknown,1381230.0
Unknown,Unknown,03,Unknown,Unknown,Cheque,Unknown,RELNS,Unknown,1381233.0
Unknown,Unknown,2,Unknown,Unknown,Cheque,Unknown,RELNS,Unknown,1381235.0
Unknown,Unknown,31,Unknown,Unknown,Cheque,Unknown,RELNS,Unknown,1381266.0
Unknown,Unknown,03,Unknown,Unknown,Cheque,Unknown,RELNS,Unknown,1381269.0
Unknown,Unknown,"3 629,70",Unknown,Unknown,Cheque,Unknown,RELNS,Unknown,1744239.0
Unknown,Unknown,23,Unknown,Unknown,Cheque,Unknown,RELNS,Unknown,1744262.0
Unknown,Unknown,03,Unknown,Unknown,Cheque,Unknown,RELNS,Unknown,1744265.0
Unknown,Unknown,22,Unknown,Unknown,Cheque,Unknown,RELNS,Unknown,1744287.0
Unknown,Unknown,03,Unknown,Unknown,Cheque,Unknown,RELNS,Unknown,1744290.0
Unknown,Unknown,"481,17",Unknown,Unknown,Cheque,Unknown,RELNS,Unknown,1792407.0
Unknown,Unknown,22,Unknown,Unknown,Cheque,Unknown,RELNS,Unknown,1792429.0
Unknown,Unknown,03,Unknown,Unknown,Cheque,Unknown,RELNS,Unknown,1792432.0
Unknown,Unknown,"240,45",Unknown,Unknown,Cheque,Unknown,RELNS,Unknown,1816477.0
Unknown,Unknown,22,Unknown,Unknown,Cheque,Unknown,RELNS,Unknown,1816499.0
Unknown,Unknown,03,Unknown,Unknown,Cheque,Unknown,RELNS,Unknown,1816502.0
Unknown,Unknown,"4,49",Unknown,Unknown,Cheque,Unknown,RELNS,Unknown,1816951.0
Unknown,Unknown,21,Unknown,Unknown,Cheque,Unknown,RELNS,Unknown,1816972.0
Unknown,Unknown,03 21,Unknown,Unknown,Cheque,Unknown,RELNS,Unknown,1817293.0
Unknown,Unknown,03 35,Unknown,Unknown,Cheque,Unknown,RELNS,Unknown,1817628.0
Unknown,Unknown,60,Unknown,Unknown,Cheque,Unknown,RELNS,Unknown,1817688.0
Unknown,Unknown,23,Unknown,Unknown,Cheque,Unknown,RELNS,Unknown,1817711.0
Unknown,Unknown,03 85,Unknown,Unknown,Cheque,Unknown,RELNS,Unknown,1818096.0
Unknown,Unknown,30,Unknown,Unknown,Cheque,Unknown,RELNS,Unknown,1818126.0
Unknown,Unknown,23,Unknown,Unknown,Cheque,Unknown,RELNS,Unknown,1818149.0
Unknown,Unknown,03 23,Unknown,Unknown,Cheque,Unknown,RELNS,Unknown,1818472.0
Unknown,Unknown,03,Unknown,Unknown,Cheque,Unknown,RELNS,Unknown,1818475.0
Unknown,Unknown,"1,90",Unknown,Unknown,Cheque,Unknown,RELNS,Unknown,1818665.0
Unknown,Unknown,23,Unknown,Unknown,Cheque,Unknown,RELNS,Unknown,1818688.0
Unknown,Unknown,03 23,Unknown,Unknown,Cheque,Unknown,RELNS,Unknown,1819011.0
Unknown,Unknown,03 23,Unknown,Unknown,Cheque,Unknown,RELNS,Unknown,1819334.0
Unknown,Unknown,03 23,Unknown,Unknown,Cheque,Unknown,RELNS,Unknown,1819657.0
Unknown,Unknown,03 006 30,Unknown,Unknown,Cheque,Unknown,RELNS,Unknown,2120287.0
Unknown,Unknown,"128,19",Unknown,Unknown,Cheque,Unknown,RELNS,Unknown,2133106.0
Unknown,Unknown,8,Unknown,Unknown,Cheque,Unknown,RELNS,Unknown,2133114.0
Unknown,Unknown,24,Unknown,Unknown,Cheque,Unknown,RELNS,Unknown,2133138.0
Unknown,Unknown,03 24,Unknown,Unknown,Cheque,Unknown,RELNS,Unknown,2133462.0
Unknown,Unknown,03 501 82,Unknown,Unknown,Cheque,Unknown,RELNS,Unknown,2483644.0
Unknown,Unknown,24,Unknown,Unknown,Cheque,Unknown,RELNS,Unknown,2483668.0
Unknown,Unknown,03 24,Unknown,Unknown,Cheque,Unknown,RELNS,Unknown,2483992.0
Unknown,Unknown,03,Unknown,Unknown,Cheque,Unknown,RELNS,Unknown,2483995.0
Unknown,Unknown,24,Unknown,Unknown,Cheque,Unknown,RELNS,Unknown,2484019.0
Unknown,Unknown,03 24,Unknown,Unknown,Cheque,Unknown,RELNS,Unknown,2484343.0
Unknown,Unknown,"03 400,00",Unknown,Unknown,Cheque,Unknown,RELNS,Unknown,2824343.0
Unknown,Unknown,24,Unknown,Unknown,Cheque,Unknown,RELNS,Unknown,2824367.0
Unknown,Unknown,03 24,Unknown,Unknown,Cheque,Unknown,RELNS,Unknown,2824691.0
Unknown,Unknown,"03 600,00",Unknown,Unknown,Cheque,Unknown,RELNS,Unknown,3184691.0
Unknown,Unknown,"401,46",Unknown,Unknown,Cheque,Unknown,RELNS,Unknown,3224837.0
Unknown,Unknown,24,Unknown,Unknown,Cheque,Unknown,RELNS,Unknown,3224861.0
Unknown,Unknown,03 24,Unknown,Unknown,Cheque,Unknown,RELNS,Unknown,3225185.0
Unknown,Unknown,03,Unknown,Unknown,Cheque,Unknown,RELNS,Unknown,3225188.0
Unknown,Unknown,24,Unknown,Unknown,Cheque,Unknown,RELNS,Unknown,3225212.0
Unknown,Unknown,03 24,Unknown,Unknown,Cheque,Unknown,RELNS,Unknown,3225536.0
Unknown,Unknown,"03 147,26",Unknown,Unknown,Cheque,Unknown,RELNS,Unknown,3540262.0
Unknown,Unknown,24,Unknown,Unknown,Cheque,Unknown,RELNS,Unknown,3540286.0
Unknown,Unknown,03 24,Unknown,Unknown,Cheque,Unknown,RELNS,Unknown,3540610.0
Unknown,Unknown,03 285,Unknown,Unknown,Cheque,Unknown,RELNS,Unknown,3543895.0
Unknown,Unknown,24,Unknown,Unknown,Cheque,Unknown,RELNS,Unknown,3543919.0
Unknown,Unknown,03 24,Unknown,Unknown,Cheque,Unknown,RELNS,Unknown,3544243.0
Unknown,Unknown,03,Unknown,Unknown,Cheque,Unknown,RELNS,Unknown,3544246.0
Unknown,Unknown,"4,48",Unknown,Unknown,Cheque,Unknown,RELNS,Unknown,3544694.0
Unknown,Unknown,25,Unknown,Unknown,Cheque,Unknown,RELNS,Unknown,3544719.0
Unknown,Unknown,03 25,Unknown,Unknown,Cheque,Unknown,RELNS,Unknown,3545044.0
Unknown,Unknown,03,Unknown,Unknown,Cheque,Unknown,RELNS,Unknown,3545047.0
Unknown,Unknown,"1,80",Unknown,Unknown,Cheque,Unknown,RELNS,Unknown,3545227.0
Unknown,Unknown,8,Unknown,Unknown,Cheque,Unknown,RELNS,Unknown,3545235.0
Unknown,Unknown,25,Unknown,Unknown,Cheque,Unknown,RELNS,Unknown,3545260.0
Unknown,Unknown,03 25,Unknown,Unknown,Cheque,Unknown,RELNS,Unknown,3545585.0
Unknown,Unknown,"03 201,45",Unknown,Unknown,Cheque,Unknown,RELNS,Unknown,3865730.0
Unknown,Unknown,8,Unknown,Unknown,Cheque,Unknown,RELNS,Unknown,3865738.0
Unknown,Unknown,28,Unknown,Unknown,Cheque,Unknown,RELNS,Unknown,3865766.0
Unknown,Unknown,03 28,Unknown,Unknown,Cheque,Unknown,RELNS,Unknown,3866094.0
Unknown,Unknown,"03 456,07",Unknown,Unknown,Cheque,Unknown,RELNS,Unknown,4211701.0
Unknown,Unknown,28,Unknown,Unknown,Cheque,Unknown,RELNS,Unknown,4211729.0
Unknown,Unknown,03 28,Unknown,Unknown,Cheque,Unknown,RELNS,Unknown,4212057.0
Unknown,Unknown,03 22,Unknown,Unknown,Cheque,Unknown,RELNS,Unknown,4212379.0
Unknown,Unknown,33,Unknown,Unknown,Cheque,Unknown,RELNS,Unknown,4212412.0
Unknown,Unknown,28,Unknown,Unknown,Cheque,Unknown,RELNS,Unknown,4212440.0
Unknown,Unknown,03 28,Unknown,Unknown,Cheque,Unknown,RELNS,Unknown,4212768.0
Unknown,Unknown,"03 123,98",Unknown,Unknown,Cheque,Unknown,RELNS,Unknown,4525166.0
Unknown,Unknown,28,Unknown,Unknown,Cheque,Unknown,RELNS,Unknown,4525194.0
Unknown,Unknown,03 28,Unknown,Unknown,Cheque,Unknown,RELNS,Unknown,4525522.0
Unknown,Unknown,"03 747,39",Unknown,Unknown,Cheque,Unknown,RELNS,Unknown,4900261.0
Unknown,Unknown,28,Unknown,Unknown,Cheque,Unknown,RELNS,Unknown,4900289.0
Unknown,Unknown,03 28,Unknown,Unknown,Cheque,Unknown,RELNS,Unknown,4900617.0
Unknown,Unknown,03,Unknown,Unknown,Cheque,Unknown,RELNS,Unknown,4900620.0
Unknown,Unknown,"6,42",Unknown,Unknown,Cheque,Unknown,RELNS,Unknown,4901262.0
Unknown,Unknown,28,Unknown,Unknown,Cheque,Unknown,RELNS,Unknown,4901290.0
Unknown,Unknown,03 28,Unknown,Unknown,Cheque,Unknown,RELNS,Unknown,4901618.0
Unknown,Unknown,03,Unknown,Unknown,Cheque,Unknown,RELNS,Unknown,4901621.0
Unknown,Unknown,7,Unknown,Unknown,Cheque,Unknown,RELNS,Unknown,4901628.0
Unknown,Unknown,0,Unknown,Unknown,Cheque,Unknown,RELNS,Unknown,4901628.0
Unknown,Unknown,25,Unknown,Unknown,Cheque,Unknown,RELNS,Unknown,4901653.0
Unknown,Unknown,14,Unknown,Unknown,Cheque,Unknown,RELNS,Unknown,4901667.0
Unknown,Unknown,07,Unknown,Unknown,Cheque,Unknown,RELNS,Unknown,4901674.0
31/10/2019,Unknown,9,Unknown,Unknown,Credit,Unknown,Mall magale sevin@nvesparis banquepopulaire t RELEVE N 9,BANQUE POPULAIRE +X,9.0
01/12/2019,Unknown,31,Unknown,Unknown,Credit,Unknown,Mall magale sevin@nvesparis banquepopulaire t RELEVE N 9,MAGALIE,40.0
30/09/2019,Unknown,10,Unknown,Unknown,Credit,Unknown,Mall magale sevin@nvesparis banquepopulaire t RELEVE N 9,DOURDAN 6 RUE,50.0
Unknown,Unknown,6,Unknown,Unknown,Credit,Unknown,Mall magale sevin@nvesparis banquepopulaire t RELEVE N 9,OUFAUBOURG DE CHARTRES,56.0
Unknown,Unknown,01 70,Unknown,Unknown,Credit,Unknown,Mall magale sevin@nvesparis banquepopulaire t RELEVE N 9,DoURON,226.0
Unknown,Unknown,91 98,Unknown,Unknown,Credit,Unknown,Mall magale sevin@nvesparis banquepopulaire t RELEVE N 9,Far:01,9424.0
Unknown,Unknown,34,Unknown,Unknown,Credit,Unknown,Mall magale sevin@nvesparis banquepopulaire t RELEVE N 9,Cyberplus Identhant,9458.0
Unknown,Unknown,01 80,Unknown,Unknown,Credit,Unknown,Mall magale sevin@nvesparis banquepopulaire t RELEVE N 9,TONALITE,9638.0
Unknown,Unknown,36,Unknown,Unknown,Credit,Unknown,Mall magale sevin@nvesparis banquepopulaire t RELEVE N 9,SERVCE,9674.0
Unknown,Unknown,892 092,Unknown,Unknown,Credit,Unknown,Mall magale sevin@nvesparis banquepopulaire t RELEVE N 9,PRix Appel,901766.0
Unknown,Unknown,0,Unknown,Unknown,Credit,Unknown,Mall magale sevin@nvesparis banquepopulaire t RELEVE N 9,LE MARCHE DE GARLANDE,901766.0
Unknown,Unknown,6 11,Unknown,Unknown,Credit,Unknown,Mall magale sevin@nvesparis banquepopulaire t RELEVE N 9,NOTRE,902377.0
Unknown,Unknown,10,Unknown,Unknown,Credit,Unknown,Mall magale sevin@nvesparis banquepopulaire t RELEVE N 9,METTONS A VOTRE DISPOSITION A COMPTER DU,902387.0
Unknown,Unknown,01,Unknown,Unknown,Credit,Unknown,Mall magale sevin@nvesparis banquepopulaire t RELEVE N 9,DANS TOUTES NOS,902388.0
Unknown,Unknown,12,Unknown,Unknown,Credit,Unknown,Mall magale sevin@nvesparis banquepopulaire t RELEVE N 9,TARIFAIRES APPLICABLES,902400.0
Unknown,Unknown,8,Unknown,Unknown,Credit,Unknown,Mall magale sevin@nvesparis banquepopulaire t RELEVE N 9,LE MARCHE DE GARLANDE BIC,902408.0
Unknown,Unknown,859,Unknown,Unknown,Credit,Unknown,Mall magale sevin@nvesparis banquepopulaire t RELEVE N 9,DaTE,903267.0
Unknown,Unknown,"300,96",Unknown,Unknown,Credit,Unknown,Mall magale sevin@nvesparis banquepopulaire t RELEVE N 9,DATE DaTE,933363.0
Unknown,Unknown,"48,19",Unknown,Unknown,Credit,Unknown,Mall magale sevin@nvesparis banquepopulaire t RELEVE N 9,UBELLEREFERENCE,938182.0
Unknown,Unknown,30,Unknown,Unknown,Credit,Unknown,Mall magale sevin@nvesparis banquepopulaire t RELEVE N 9,Cou O3E,938212.0
Unknown,Unknown,09,Unknown,Unknown,Credit,Unknown,Mall magale sevin@nvesparis banquepopulaire t RELEVE N 9,C8 5142949015,938221.0
Unknown,Unknown,48,Unknown,Unknown,Credit,Unknown,Mall magale sevin@nvesparis banquepopulaire t RELEVE N 9,M80005,938269.0
Unknown,Unknown,136,Unknown,Unknown,Credit,Unknown,Mall magale sevin@nvesparis banquepopulaire t RELEVE N 9,LLOY,938405.0
Unknown,Unknown,0,Unknown,Unknown,Credit,Unknown,Mall magale sevin@nvesparis banquepopulaire t RELEVE N 9,MoiS,938405.0
Unknown,Unknown,35,Unknown,Unknown,Credit,Unknown,Mall magale sevin@nvesparis banquepopulaire t RELEVE N 9,SEPTEMBRE 2019 HT 35 I/IVAZ0 0O,938440.0
Unknown,Unknown,703,Unknown,Unknown,Credit,Unknown,Mall magale sevin@nvesparis banquepopulaire t RELEVE N 9,CLT38JO ElECERC,939143.0
Unknown,Unknown,92,Unknown,Unknown,Credit,Unknown,Mall magale sevin@nvesparis banquepopulaire t RELEVE N 9,ChATILLO,939235.0
Unknown,Unknown,0,Unknown,Unknown,Credit,Unknown,Mall magale sevin@nvesparis banquepopulaire t RELEVE N 9,LCR DoMiCILIeE,939235.0
Unknown,Unknown,380,Unknown,Unknown,Credit,Unknown,Mall magale sevin@nvesparis banquepopulaire t RELEVE N 9,REMISE,939615.0
Unknown,Unknown,2,Unknown,Unknown,Credit,Unknown,Mall magale sevin@nvesparis banquepopulaire t RELEVE N 9,Cou 2,939617.0
Unknown,Unknown,173 886,Unknown,Unknown,Credit,Unknown,Mall magale sevin@nvesparis banquepopulaire t RELEVE N 9,ChEQUE 0000186 CHEQUE 0000185,1113503.0
Unknown,Unknown,146,Unknown,Unknown,Credit,Unknown,Mall magale sevin@nvesparis banquepopulaire t RELEVE N 9,Co 2e 180013164397,1113649.0
Unknown,Unknown,03,Unknown,Unknown,Credit,Unknown,Mall magale sevin@nvesparis banquepopulaire t RELEVE N 9,CoM 102E,1113652.0
Unknown,Unknown,10,Unknown,Unknown,Credit,Unknown,Mall magale sevin@nvesparis banquepopulaire t RELEVE N 9,DOUROA/ OCV REMISE,1113662.0
Unknown,Unknown,01,Unknown,Unknown,Credit,Unknown,Mall magale sevin@nvesparis banquepopulaire t RELEVE N 9,CHEQUES,1113663.0
Unknown,Unknown,10 01,Unknown,Unknown,Credit,Unknown,Mall magale sevin@nvesparis banquepopulaire t RELEVE N 9,ReM Cho,1114664.0
Unknown,Unknown,10 01,Unknown,Unknown,Credit,Unknown,Mall magale sevin@nvesparis banquepopulaire t RELEVE N 9,ChEquE 0000187,1115665.0
Unknown,Unknown,10 01,Unknown,Unknown,Credit,Unknown,Mall magale sevin@nvesparis banquepopulaire t RELEVE N 9,Banque Populaire Rives,1116666.0
Unknown,Unknown,10 01,Unknown,Unknown,Credit,Unknown,Mall magale sevin@nvesparis banquepopulaire t RELEVE N 9,Paris,1117667.0
Unknown,Unknown,10 01,Unknown,Unknown,Credit,Unknown,Mall magale sevin@nvesparis banquepopulaire t RELEVE N 9,Aswna sousk,1118668.0
Unknown,Unknown,10 135 25,Unknown,Unknown,Credit,Unknown,Mall magale sevin@nvesparis banquepopulaire t RELEVE N 9,Sko sai 11 ano fino,2132193.0
Unknown,Unknown,01,Unknown,Unknown,Credit,Unknown,Mall magale sevin@nvesparis banquepopulaire t RELEVE N 9,pouZ(Poulor,2132194.0
Unknown,Unknown,10 01,Unknown,Unknown,Credit,Unknown,Mall magale sevin@nvesparis banquepopulaire t RELEVE N 9,Pourlo,2133195.0
Unknown,Unknown,10 01,Unknown,Unknown,Credit,Unknown,Mall magale sevin@nvesparis banquepopulaire t RELEVE N 9,Sltelntna,2134196.0
Unknown,Unknown,10 42,Unknown,Unknown,Credit,Unknown,Mall magale sevin@nvesparis banquepopulaire t RELEVE N 9,Unknown,2135238.0
Unknown,Unknown,17 01,Unknown,Unknown,Credit,Unknown,Mall magale sevin@nvesparis banquepopulaire t RELEVE N 9,Unknown,2136939.0
Unknown,Unknown,10 01,Unknown,Unknown,Credit,Unknown,Mall magale sevin@nvesparis banquepopulaire t RELEVE N 9,Unknown,2137940.0
Unknown,Unknown,10 01,Unknown,Unknown,Credit,Unknown,Mall magale sevin@nvesparis banquepopulaire t RELEVE N 9,Unknown,2138941.0
Unknown,Unknown,"10 278,18",Unknown,Unknown,Credit,Unknown,Mall magale sevin@nvesparis banquepopulaire t RELEVE N 9,Unknown,3166759.0
Unknown,Unknown,02,Unknown,Unknown,Credit,Unknown,Mall magale sevin@nvesparis banquepopulaire t RELEVE N 9,Unknown,3166761.0
Unknown,Unknown,10 02,Unknown,Unknown,Credit,Unknown,Mall magale sevin@nvesparis banquepopulaire t RELEVE N 9,Unknown,3167763.0
Unknown,Unknown,10 02,Unknown,Unknown,Credit,Unknown,Mall magale sevin@nvesparis banquepopulaire t RELEVE N 9,Unknown,3168765.0
Unknown,Unknown,10 02,Unknown,Unknown,Credit,Unknown,Mall magale sevin@nvesparis banquepopulaire t RELEVE N 9,Unknown,3169767.0
Unknown,Unknown,10 01,Unknown,Unknown,Credit,Unknown,Mall magale sevin@nvesparis banquepopulaire t RELEVE N 9,Unknown,3170768.0
Unknown,Unknown,10 02,Unknown,Unknown,Credit,Unknown,Mall magale sevin@nvesparis banquepopulaire t RELEVE N 9,Unknown,3171770.0
Unknown,Unknown,10,Unknown,Unknown,Credit,Unknown,Mall magale sevin@nvesparis banquepopulaire t RELEVE N 9,Unknown,3171780.0
Unknown,Unknown,"2 152,53",Unknown,Unknown,Credit,Unknown,Mall magale sevin@nvesparis banquepopulaire t RELEVE N 9,Unknown,3387033.0
Unknown,Unknown,"91,53",Unknown,Unknown,Credit,Unknown,Mall magale sevin@nvesparis banquepopulaire t RELEVE N 9,Unknown,3396186.0
Unknown,Unknown,02,Unknown,Unknown,Credit,Unknown,Mall magale sevin@nvesparis banquepopulaire t RELEVE N 9,Unknown,3396188.0
Unknown,Unknown,10 02,Unknown,Unknown,Credit,Unknown,Mall magale sevin@nvesparis banquepopulaire t RELEVE N 9,Unknown,3397190.0
Unknown,Unknown,10 02,Unknown,Unknown,Credit,Unknown,Mall magale sevin@nvesparis banquepopulaire t RELEVE N 9,Unknown,3398192.0
Unknown,Unknown,"10 377,79",Unknown,Unknown,Credit,Unknown,Mall magale sevin@nvesparis banquepopulaire t RELEVE N 9,Unknown,4435971.0
Unknown,Unknown,9 02,Unknown,Unknown,Credit,Unknown,Mall magale sevin@nvesparis banquepopulaire t RELEVE N 9,Unknown,4436873.0
Unknown,Unknown,10 02,Unknown,Unknown,Credit,Unknown,Mall magale sevin@nvesparis banquepopulaire t RELEVE N 9,Unknown,4437875.0
Unknown,Unknown,10 03,Unknown,Unknown,Credit,Unknown,Mall magale sevin@nvesparis banquepopulaire t RELEVE N 9,Unknown,4438878.0
Unknown,Unknown,10 02,Unknown,Unknown,Credit,Unknown,Mall magale sevin@nvesparis banquepopulaire t RELEVE N 9,Unknown,4439880.0
Unknown,Unknown,10 02,Unknown,Unknown,Credit,Unknown,Mall magale sevin@nvesparis banquepopulaire t RELEVE N 9,Unknown,4440882.0
Unknown,Unknown,10 03,Unknown,Unknown,Credit,Unknown,Mall magale sevin@nvesparis banquepopulaire t RELEVE N 9,Unknown,4441885.0
Unknown,Unknown,10 02,Unknown,Unknown,Credit,Unknown,Mall magale sevin@nvesparis banquepopulaire t RELEVE N 9,Unknown,4442887.0
Unknown,Unknown,10 02,Unknown,Unknown,Credit,Unknown,Mall magale sevin@nvesparis banquepopulaire t RELEVE N 9,Unknown,4443889.0
Unknown,Unknown,10 03,Unknown,Unknown,Credit,Unknown,Mall magale sevin@nvesparis banquepopulaire t RELEVE N 9,Unknown,4444892.0
Unknown,Unknown,10 26,Unknown,Unknown,Credit,Unknown,Mall magale sevin@nvesparis banquepopulaire t RELEVE N 9,Unknown,4445918.0
Unknown,Unknown,00 26,Unknown,Unknown,Credit,Unknown,Mall magale sevin@nvesparis banquepopulaire t RELEVE N 9,Unknown,4445944.0
Unknown,Unknown,00 172.64,Unknown,Unknown,Credit,Unknown,Mall magale sevin@nvesparis banquepopulaire t RELEVE N 9,Unknown,4446116.64
Unknown,Unknown,03,Unknown,Unknown,Credit,Unknown,Mall magale sevin@nvesparis banquepopulaire t RELEVE N 9,Unknown,4446119.64
Unknown,Unknown,10 03,Unknown,Unknown,Credit,Unknown,Mall magale sevin@nvesparis banquepopulaire t RELEVE N 9,Unknown,4447122.64
Unknown,Unknown,10 03,Unknown,Unknown,Credit,Unknown,Mall magale sevin@nvesparis banquepopulaire t RELEVE N 9,Unknown,4448125.64
Unknown,Unknown,"10 145,44",Unknown,Unknown,Credit,Unknown,Mall magale sevin@nvesparis banquepopulaire t RELEVE N 9,Unknown,5462669.64
Unknown,Unknown,03,Unknown,Unknown,Credit,Unknown,Mall magale sevin@nvesparis banquepopulaire t RELEVE N 9,Unknown,5462672.64
Unknown,Unknown,10 03,Unknown,Unknown,Credit,Unknown,Mall magale sevin@nvesparis banquepopulaire t RELEVE N 9,Unknown,5463675.64
Unknown,Unknown,10 03,Unknown,Unknown,Credit,Unknown,Mall magale sevin@nvesparis banquepopulaire t RELEVE N 9,Unknown,5464678.64
Unknown,Unknown,"10 550,00",Unknown,Unknown,Credit,Unknown,Mall magale sevin@nvesparis banquepopulaire t RELEVE N 9,Unknown,6519678.64
Unknown,Unknown,03,Unknown,Unknown,Credit,Unknown,Mall magale sevin@nvesparis banquepopulaire t RELEVE N 9,Unknown,6519681.64
Unknown,Unknown,10 03,Unknown,Unknown,Credit,Unknown,Mall magale sevin@nvesparis banquepopulaire t RELEVE N 9,Unknown,6520684.64
Unknown,Unknown,10 02,Unknown,Unknown,Credit,Unknown,Mall magale sevin@nvesparis banquepopulaire t RELEVE N 9,Unknown,6521686.64
Unknown,Unknown,10 03,Unknown,Unknown,Credit,Unknown,Mall magale sevin@nvesparis banquepopulaire t RELEVE N 9,Unknown,6522689.64
Unknown,Unknown,"10 260,26",Unknown,Unknown,Credit,Unknown,Mall magale sevin@nvesparis banquepopulaire t RELEVE N 9,Unknown,7548715.64
Unknown,Unknown,02,Unknown,Unknown,Credit,Unknown,Mall magale sevin@nvesparis banquepopulaire t RELEVE N 9,Unknown,7548717.64
Unknown,Unknown,10 02,Unknown,Unknown,Credit,Unknown,Mall magale sevin@nvesparis banquepopulaire t RELEVE N 9,Unknown,7549719.64
Unknown,Unknown,"10 629,64",Unknown,Unknown,Credit,Unknown,Mall magale sevin@nvesparis banquepopulaire t RELEVE N 9,Unknown,8612683.64
Unknown,Unknown,0,Unknown,Unknown,Credit,Unknown,Mall magale sevin@nvesparis banquepopulaire t RELEVE N 9,Unknown,8612683.64
Unknown,Unknown,11,Unknown,Unknown,Credit,Unknown,Mall magale sevin@nvesparis banquepopulaire t RELEVE N 9,Unknown,8612694.64
Unknown,Unknown,75,Unknown,Unknown,Credit,Unknown,Mall magale sevin@nvesparis banquepopulaire t RELEVE N 9,Unknown,8612769.64
Unknown,Unknown,004,Unknown,Unknown,Credit,Unknown,Mall magale sevin@nvesparis banquepopulaire t RELEVE N 9,Unknown,8612773.64
Unknown,Unknown,151,Unknown,Unknown,Credit,Unknown,Mall magale sevin@nvesparis banquepopulaire t RELEVE N 9,Unknown,8612924.64
Unknown,Unknown,0,Unknown,Unknown,Credit,Unknown,Mall magale sevin@nvesparis banquepopulaire t RELEVE N 9,Unknown,8612924.64
29/11/2019,Unknown,10,Unknown,Unknown,Debit,Unknown,Mall magale sevin@nvesparis banquepopulaire tr RELEVE,BANQUE POPULAIRE +X,10.0
31/10/2019,Unknown,29,Unknown,Unknown,Debit,Unknown,Mall magale sevin@nvesparis banquepopulaire tr RELEVE,MAGALIE,39.0
Unknown,Unknown,11,Unknown,Unknown,Debit,Unknown,Mall magale sevin@nvesparis banquepopulaire tr RELEVE,N 10 AU,50.0
Unknown,Unknown,6,Unknown,Unknown,Debit,Unknown,Mall magale sevin@nvesparis banquepopulaire tr RELEVE,OUFAUBOURG DE CHARTRES,56.0
Unknown,Unknown,01,Unknown,Unknown,Debit,Unknown,Mall magale sevin@nvesparis banquepopulaire tr RELEVE,DoURON,57.0
Unknown,Unknown,98 34,Unknown,Unknown,Debit,Unknown,Mall magale sevin@nvesparis banquepopulaire tr RELEVE,Far:01,9891.0
Unknown,Unknown,01 80,Unknown,Unknown,Debit,Unknown,Mall magale sevin@nvesparis banquepopulaire tr RELEVE,Cyberplus Identhant,10071.0
Unknown,Unknown,36,Unknown,Unknown,Debit,Unknown,Mall magale sevin@nvesparis banquepopulaire tr RELEVE,TONALITE,10107.0
Unknown,Unknown,892 092,Unknown,Unknown,Debit,Unknown,Mall magale sevin@nvesparis banquepopulaire tr RELEVE,SERVCE,902199.0
Unknown,Unknown,0,Unknown,Unknown,Debit,Unknown,Mall magale sevin@nvesparis banquepopulaire tr RELEVE,PRix Appel,902199.0
Unknown,Unknown,6 11,Unknown,Unknown,Debit,Unknown,Mall magale sevin@nvesparis banquepopulaire tr RELEVE,LE MARCHE DE GARLANDE,902810.0
Unknown,Unknown,10,Unknown,Unknown,Debit,Unknown,Mall magale sevin@nvesparis banquepopulaire tr RELEVE,LE MARCHE DE GARLANDE,902820.0
Unknown,Unknown,859,Unknown,Unknown,Debit,Unknown,Mall magale sevin@nvesparis banquepopulaire tr RELEVE,DaTE,903679.0
Unknown,Unknown,8,Unknown,Unknown,Debit,Unknown,Mall magale sevin@nvesparis banquepopulaire tr RELEVE,DATE DaTE,903687.0
Unknown,Unknown,"398,37",Unknown,Unknown,Debit,Unknown,Mall magale sevin@nvesparis banquepopulaire tr RELEVE,UBELLEREFERENCE,943524.0
Unknown,Unknown,"42,17",Unknown,Unknown,Debit,Unknown,Mall magale sevin@nvesparis banquepopulaire tr RELEVE,DEBITEUR AU,947741.0
Unknown,Unknown,31,Unknown,Unknown,Debit,Unknown,Mall magale sevin@nvesparis banquepopulaire tr RELEVE,LLOY,947772.0
Unknown,Unknown,10,Unknown,Unknown,Debit,Unknown,Mall magale sevin@nvesparis banquepopulaire tr RELEVE,TPEELC,947782.0
Unknown,Unknown,01,Unknown,Unknown,Debit,Unknown,Mall magale sevin@nvesparis banquepopulaire tr RELEVE,MOIS,947783.0
Unknown,Unknown,11,Unknown,Unknown,Debit,Unknown,Mall magale sevin@nvesparis banquepopulaire tr RELEVE,TVA200,947794.0
Unknown,Unknown,35,Unknown,Unknown,Debit,Unknown,Mall magale sevin@nvesparis banquepopulaire tr RELEVE,REMISE,947829.0
Unknown,Unknown,"7,03",Unknown,Unknown,Debit,Unknown,Mall magale sevin@nvesparis banquepopulaire tr RELEVE,CoM,948532.0
Unknown,Unknown,04,Unknown,Unknown,Debit,Unknown,Mall magale sevin@nvesparis banquepopulaire tr RELEVE,REMISE,948536.0
Unknown,Unknown,11,Unknown,Unknown,Debit,Unknown,Mall magale sevin@nvesparis banquepopulaire tr RELEVE,REMISE C8 5142949015,948547.0
Unknown,Unknown,142,Unknown,Unknown,Debit,Unknown,Mall magale sevin@nvesparis banquepopulaire tr RELEVE,Cou,948689.0
Unknown,Unknown,04,Unknown,Unknown,Debit,Unknown,Mall magale sevin@nvesparis banquepopulaire tr RELEVE,PRELEVEMENT CMR000o78008o01 PRLV SEPAPROXIMY,948693.0
Unknown,Unknown,11,Unknown,Unknown,Debit,Unknown,Mall magale sevin@nvesparis banquepopulaire tr RELEVE,M8o010,948704.0
Unknown,Unknown,228,Unknown,Unknown,Debit,Unknown,Mall magale sevin@nvesparis banquepopulaire tr RELEVE,Se CoM 1,948932.0
Unknown,Unknown,1,Unknown,Unknown,Debit,Unknown,Mall magale sevin@nvesparis banquepopulaire tr RELEVE,REMISE,948933.0
Unknown,Unknown,04,Unknown,Unknown,Debit,Unknown,Mall magale sevin@nvesparis banquepopulaire tr RELEVE,ReMCHho,948937.0
Unknown,Unknown,11,Unknown,Unknown,Debit,Unknown,Mall magale sevin@nvesparis banquepopulaire tr RELEVE,CB*-*7366 EG1EOFG,948948.0
Unknown,Unknown,314,Unknown,Unknown,Debit,Unknown,Mall magale sevin@nvesparis banquepopulaire tr RELEVE,DUFER,949262.0
Unknown,Unknown,2,Unknown,Unknown,Debit,Unknown,Mall magale sevin@nvesparis banquepopulaire tr RELEVE,LARU,949264.0
Unknown,Unknown,04,Unknown,Unknown,Debit,Unknown,Mall magale sevin@nvesparis banquepopulaire tr RELEVE,Eg1EOFH,949268.0
Unknown,Unknown,11,Unknown,Unknown,Debit,Unknown,Mall magale sevin@nvesparis banquepopulaire tr RELEVE,Rem,949279.0
Unknown,Unknown,573,Unknown,Unknown,Debit,Unknown,Mall magale sevin@nvesparis banquepopulaire tr RELEVE,LARU,949852.0
Unknown,Unknown,04,Unknown,Unknown,Debit,Unknown,Mall magale sevin@nvesparis banquepopulaire tr RELEVE,CB;- 7366,949856.0
Unknown,Unknown,11,Unknown,Unknown,Debit,Unknown,Mall magale sevin@nvesparis banquepopulaire tr RELEVE,SAlEDELAS,949867.0
Unknown,Unknown,04,Unknown,Unknown,Debit,Unknown,Mall magale sevin@nvesparis banquepopulaire tr RELEVE,LARU,949871.0
Unknown,Unknown,11,Unknown,Unknown,Debit,Unknown,Mall magale sevin@nvesparis banquepopulaire tr RELEVE,E61EOFJ,949882.0
Unknown,Unknown,51,Unknown,Unknown,Debit,Unknown,Mall magale sevin@nvesparis banquepopulaire tr RELEVE,ChAtilLo,949933.0
Unknown,Unknown,04,Unknown,Unknown,Debit,Unknown,Mall magale sevin@nvesparis banquepopulaire tr RELEVE,Banque Populaire Rives,949937.0
Unknown,Unknown,11,Unknown,Unknown,Debit,Unknown,Mall magale sevin@nvesparis banquepopulaire tr RELEVE,Paris,949948.0
Unknown,Unknown,04,Unknown,Unknown,Debit,Unknown,Mall magale sevin@nvesparis banquepopulaire tr RELEVE,Aswna sousk,949952.0
Unknown,Unknown,11,Unknown,Unknown,Debit,Unknown,Mall magale sevin@nvesparis banquepopulaire tr RELEVE,Sko sai 11 ano fino,949963.0
Unknown,Unknown,189,Unknown,Unknown,Debit,Unknown,Mall magale sevin@nvesparis banquepopulaire tr RELEVE,Po ueleclamnion umua,950152.0
Unknown,Unknown,1,Unknown,Unknown,Debit,Unknown,Mall magale sevin@nvesparis banquepopulaire tr RELEVE,Yous pouZ(poulor,950153.0
Unknown,Unknown,01,Unknown,Unknown,Debit,Unknown,Mall magale sevin@nvesparis banquepopulaire tr RELEVE,Mos coah,950154.0
Unknown,Unknown,11,Unknown,Unknown,Debit,Unknown,Mall magale sevin@nvesparis banquepopulaire tr RELEVE,Pourlo,950165.0
Unknown,Unknown,6,Unknown,Unknown,Debit,Unknown,Mall magale sevin@nvesparis banquepopulaire tr RELEVE,Slteintna @ncoay,950171.0
Unknown,Unknown,04,Unknown,Unknown,Debit,Unknown,Mall magale sevin@nvesparis banquepopulaire tr RELEVE,Madaa CS,950175.0
Unknown,Unknown,11,Unknown,Unknown,Debit,Unknown,Mall magale sevin@nvesparis banquepopulaire tr RELEVE,Unknown,950186.0
Unknown,Unknown,04,Unknown,Unknown,Debit,Unknown,Mall magale sevin@nvesparis banquepopulaire tr RELEVE,Unknown,950190.0
Unknown,Unknown,11,Unknown,Unknown,Debit,Unknown,Mall magale sevin@nvesparis banquepopulaire tr RELEVE,Unknown,950201.0
Unknown,Unknown,04,Unknown,Unknown,Debit,Unknown,Mall magale sevin@nvesparis banquepopulaire tr RELEVE,Unknown,950205.0
Unknown,Unknown,11,Unknown,Unknown,Debit,Unknown,Mall magale sevin@nvesparis banquepopulaire tr RELEVE,Unknown,950216.0
Unknown,Unknown,04,Unknown,Unknown,Debit,Unknown,Mall magale sevin@nvesparis banquepopulaire tr RELEVE,Unknown,950220.0
Unknown,Unknown,11,Unknown,Unknown,Debit,Unknown,Mall magale sevin@nvesparis banquepopulaire tr RELEVE,Unknown,950231.0
Unknown,Unknown,04,Unknown,Unknown,Debit,Unknown,Mall magale sevin@nvesparis banquepopulaire tr RELEVE,Unknown,950235.0
Unknown,Unknown,11,Unknown,Unknown,Debit,Unknown,Mall magale sevin@nvesparis banquepopulaire tr RELEVE,Unknown,950246.0
Unknown,Unknown,01,Unknown,Unknown,Debit,Unknown,Mall magale sevin@nvesparis banquepopulaire tr RELEVE,Unknown,950247.0
Unknown,Unknown,11 01,Unknown,Unknown,Debit,Unknown,Mall magale sevin@nvesparis banquepopulaire tr RELEVE,Unknown,951348.0
Unknown,Unknown,11 09,Unknown,Unknown,Debit,Unknown,Mall magale sevin@nvesparis banquepopulaire tr RELEVE,Unknown,952457.0
Unknown,Unknown,11 04,Unknown,Unknown,Debit,Unknown,Mall magale sevin@nvesparis banquepopulaire tr RELEVE,Unknown,953561.0
Unknown,Unknown,"11 141,23",Unknown,Unknown,Debit,Unknown,Mall magale sevin@nvesparis banquepopulaire tr RELEVE,Unknown,2067684.0
Unknown,Unknown,04,Unknown,Unknown,Debit,Unknown,Mall magale sevin@nvesparis banquepopulaire tr RELEVE,Unknown,2067688.0
Unknown,Unknown,11 04,Unknown,Unknown,Debit,Unknown,Mall magale sevin@nvesparis banquepopulaire tr RELEVE,Unknown,2068792.0
Unknown,Unknown,"11 226,70",Unknown,Unknown,Debit,Unknown,Mall magale sevin@nvesparis banquepopulaire tr RELEVE,Unknown,3191462.0
Unknown,Unknown,11 04,Unknown,Unknown,Debit,Unknown,Mall magale sevin@nvesparis banquepopulaire tr RELEVE,Unknown,3192566.0
Unknown,Unknown,11,Unknown,Unknown,Debit,Unknown,Mall magale sevin@nvesparis banquepopulaire tr RELEVE,Unknown,3192577.0
Unknown,Unknown,04,Unknown,Unknown,Debit,Unknown,Mall magale sevin@nvesparis banquepopulaire tr RELEVE,Unknown,3192581.0
Unknown,Unknown,11 04,Unknown,Unknown,Debit,Unknown,Mall magale sevin@nvesparis banquepopulaire tr RELEVE,Unknown,3193685.0
Unknown,Unknown,11 569 77,Unknown,Unknown,Debit,Unknown,Mall magale sevin@nvesparis banquepopulaire tr RELEVE,Unknown,4350662.0
Unknown,Unknown,04,Unknown,Unknown,Debit,Unknown,Mall magale sevin@nvesparis banquepopulaire tr RELEVE,Unknown,4350666.0
Unknown,Unknown,11 04,Unknown,Unknown,Debit,Unknown,Mall magale sevin@nvesparis banquepopulaire tr RELEVE,Unknown,4351770.0
Unknown,Unknown,"11 218,74",Unknown,Unknown,Debit,Unknown,Mall magale sevin@nvesparis banquepopulaire tr RELEVE,Unknown,5473644.0
Unknown,Unknown,04,Unknown,Unknown,Debit,Unknown,Mall magale sevin@nvesparis banquepopulaire tr RELEVE,Unknown,5473648.0
Unknown,Unknown,11 04,Unknown,Unknown,Debit,Unknown,Mall magale sevin@nvesparis banquepopulaire tr RELEVE,Unknown,5474752.0
Unknown,Unknown,11 18,Unknown,Unknown,Debit,Unknown,Mall magale sevin@nvesparis banquepopulaire tr RELEVE,Unknown,5475870.0
Unknown,Unknown,54,Unknown,Unknown,Debit,Unknown,Mall magale sevin@nvesparis banquepopulaire tr RELEVE,Unknown,5475924.0
Unknown,Unknown,8,Unknown,Unknown,Debit,Unknown,Mall magale sevin@nvesparis banquepopulaire tr RELEVE,Unknown,5475932.0
Unknown,Unknown,8 04,Unknown,Unknown,Debit,Unknown,Mall magale sevin@nvesparis banquepopulaire tr RELEVE,Unknown,5476736.0
Unknown,Unknown,11 04,Unknown,Unknown,Debit,Unknown,Mall magale sevin@nvesparis banquepopulaire tr RELEVE,Unknown,5477840.0
Unknown,Unknown,"11 117,94",Unknown,Unknown,Debit,Unknown,Mall magale sevin@nvesparis banquepopulaire tr RELEVE,Unknown,6589634.0
Unknown,Unknown,04,Unknown,Unknown,Debit,Unknown,Mall magale sevin@nvesparis banquepopulaire tr RELEVE,Unknown,6589638.0
Unknown,Unknown,11 04,Unknown,Unknown,Debit,Unknown,Mall magale sevin@nvesparis banquepopulaire tr RELEVE,Unknown,6590742.0
Unknown,Unknown,"11 188,21",Unknown,Unknown,Debit,Unknown,Mall magale sevin@nvesparis banquepopulaire tr RELEVE,Unknown,7709563.0
Unknown,Unknown,01,Unknown,Unknown,Debit,Unknown,Mall magale sevin@nvesparis banquepopulaire tr RELEVE,Unknown,7709564.0
Unknown,Unknown,11 05,Unknown,Unknown,Debit,Unknown,Mall magale sevin@nvesparis banquepopulaire tr RELEVE,Unknown,7710669.0
Unknown,Unknown,"11 333,42",Unknown,Unknown,Debit,Unknown,Mall magale sevin@nvesparis banquepopulaire tr RELEVE,Unknown,8844011.0
Unknown,Unknown,04,Unknown,Unknown,Debit,Unknown,Mall magale sevin@nvesparis banquepopulaire tr RELEVE,Unknown,8844015.0
Unknown,Unknown,11 01,Unknown,Unknown,Debit,Unknown,Mall magale sevin@nvesparis banquepopulaire tr RELEVE,Unknown,8845116.0
Unknown,Unknown,11 04,Unknown,Unknown,Debit,Unknown,Mall magale sevin@nvesparis banquepopulaire tr RELEVE,Unknown,8846220.0
Unknown,Unknown,11 04,Unknown,Unknown,Debit,Unknown,Mall magale sevin@nvesparis banquepopulaire tr RELEVE,Unknown,8847324.0
Unknown,Unknown,"11 358,34",Unknown,Unknown,Debit,Unknown,Mall magale sevin@nvesparis banquepopulaire tr RELEVE,Unknown,9983158.0
Unknown,Unknown,"56,72",Unknown,Unknown,Debit,Unknown,Mall magale sevin@nvesparis banquepopulaire tr RELEVE,Unknown,9988830.0
Unknown,Unknown,04,Unknown,Unknown,Debit,Unknown,Mall magale sevin@nvesparis banquepopulaire tr RELEVE,Unknown,9988834.0
Unknown,Unknown,11 04,Unknown,Unknown,Debit,Unknown,Mall magale sevin@nvesparis banquepopulaire tr RELEVE,Unknown,9989938.0
Unknown,Unknown,11 65,Unknown,Unknown,Debit,Unknown,Mall magale sevin@nvesparis banquepopulaire tr RELEVE,Unknown,9991103.0
Unknown,Unknown,16 86,Unknown,Unknown,Debit,Unknown,Mall magale sevin@nvesparis banquepopulaire tr RELEVE,Unknown,9992789.0
Unknown,Unknown,11 01,Unknown,Unknown,Debit,Unknown,Mall magale sevin@nvesparis banquepopulaire tr RELEVE,Unknown,9993890.0
Unknown,Unknown,11 04,Unknown,Unknown,Debit,Unknown,Mall magale sevin@nvesparis banquepopulaire tr RELEVE,Unknown,9994994.0
Unknown,Unknown,11 04,Unknown,Unknown,Debit,Unknown,Mall magale sevin@nvesparis banquepopulaire tr RELEVE,Unknown,9996098.0
Unknown,Unknown,11 04,Unknown,Unknown,Debit,Unknown,Mall magale sevin@nvesparis banquepopulaire tr RELEVE,Unknown,9997202.0
Unknown,Unknown,"11 561,20",Unknown,Unknown,Debit,Unknown,Mall magale sevin@nvesparis banquepopulaire tr RELEVE,Unknown,11153322.0
Unknown,Unknown,0,Unknown,Unknown,Debit,Unknown,Mall magale sevin@nvesparis banquepopulaire tr RELEVE,Unknown,11153322.0
Unknown,Unknown,11,Unknown,Unknown,Debit,Unknown,Mall magale sevin@nvesparis banquepopulaire tr RELEVE,Unknown,11153333.0
Unknown,Unknown,75,Unknown,Unknown,Debit,Unknown,Mall magale sevin@nvesparis banquepopulaire tr RELEVE,Unknown,11153408.0
Unknown,Unknown,0,Unknown,Unknown,Debit,Unknown,Mall magale sevin@nvesparis banquepopulaire tr RELEVE,Unknown,11153408.0
21.02.2020,Unknown,21.02,Unknown,Unknown,Credit,Unknown,Banque Indicatif,LCL RELEVE DE COMPTE,21.02
28.02.2020,Unknown,28.02,Unknown,Unknown,Credit,Unknown,Banque Indicatif,D'IDENTITE,49.04
Unknown,Unknown,282,Unknown,Unknown,Credit,Unknown,Banque Indicatif,BICETRE,331.04
Unknown,Unknown,58,Unknown,Unknown,Credit,Unknown,Banque Indicatif,MONS,389.04
Unknown,Unknown,12,Unknown,Unknown,Credit,Unknown,Banque Indicatif,MONSIEUR AMOKRANE,401.04
Unknown,Unknown,50,Unknown,Unknown,Credit,Unknown,Banque Indicatif,BICETRE,451.04
Unknown,Unknown,01 46,Unknown,Unknown,Credit,Unknown,Banque Indicatif,Reférences bancaires nationales,597.04
Unknown,Unknown,70 13,Unknown,Unknown,Credit,Unknown,Banque Indicatif,Cle,7610.04
Unknown,Unknown,21,Unknown,Unknown,Credit,Unknown,Banque Indicatif,T 50 References bancaires internationales,7631.04
Unknown,Unknown,14,Unknown,Unknown,Credit,Unknown,Banque Indicatif,OOOO,7645.04
Unknown,Unknown,"39,50",Unknown,Unknown,Credit,Unknown,Banque Indicatif,7121 T5O,11595.04
Unknown,Unknown,"40,30",Unknown,Unknown,Credit,Unknown,Banque Indicatif,NICOLAS JULIEN,15625.04
Unknown,Unknown,20.02,Unknown,Unknown,Credit,Unknown,Banque Indicatif,votre Identifiant,15645.06
Unknown,Unknown,"16 656,89",Unknown,Unknown,Credit,Unknown,Banque Indicatif,Internet wwW,1681334.06
Unknown,Unknown,25.02,Unknown,Unknown,Credit,Unknown,Banque Indicatif,Mobile,1681359.08
Unknown,Unknown,26.02,Unknown,Unknown,Credit,Unknown,Banque Indicatif,Mes Comptes Nous,1681385.1
Unknown,Unknown,27.02,Unknown,Unknown,Credit,Unknown,Banque Indicatif,Ier,1681412.12
Unknown,Unknown,28 02,Unknown,Unknown,Credit,Unknown,Banque Indicatif,ZEN PRO,1684214.12
Unknown,Unknown,25.02,Unknown,Unknown,Credit,Unknown,Banque Indicatif,ECRITURES DE LA PERIODE DATE,1684239.14
Unknown,Unknown,20 27,Unknown,Unknown,Credit,Unknown,Banque Indicatif,VALEUR,1686266.14
Unknown,Unknown,02.20,Unknown,Unknown,Credit,Unknown,Banque Indicatif,CREDIT 20.02 ANCIEN SOLDE 16,1686268.34
Unknown,Unknown,27.02,Unknown,Unknown,Credit,Unknown,Banque Indicatif,CHQ,1686295.36
Unknown,Unknown,"20 187,60",Unknown,Unknown,Credit,Unknown,Banque Indicatif,REM CHQ,3705055.36
Unknown,Unknown,"483,00",Unknown,Unknown,Credit,Unknown,Banque Indicatif,OOOOOOO,3753355.36
Unknown,Unknown,"359,48",Unknown,Unknown,Credit,Unknown,Banque Indicatif,995272 6916 ID Facture,3789303.36
Unknown,Unknown,28.02,Unknown,Unknown,Credit,Unknown,Banque Indicatif,REF CLIENT iuOFUOApMk929952726916995217230413 ID CREANCIER FR47EDFOO10O7,3789331.38
Unknown,Unknown,"20 265,67",Unknown,Unknown,Credit,Unknown,Banque Indicatif,CHQ,5815898.380000001
Unknown,Unknown,"812,75",Unknown,Unknown,Credit,Unknown,Banque Indicatif,TOTAUX,5897173.380000001
Unknown,Unknown,"17 139,89",Unknown,Unknown,Credit,Unknown,Banque Indicatif,SOLDE,7611162.380000001
Unknown,Unknown,28.02,Unknown,Unknown,Credit,Unknown,Banque Indicatif,Unknown,7611190.4
Unknown,Unknown,"16 327,14",Unknown,Unknown,Credit,Unknown,Banque Indicatif,Unknown,9243904.4
11.02.2020,Unknown,11.02,Unknown,Unknown,Credit,Unknown,LCL,Aoa7 RELEVE DE COMPTE,11.02
20.02.2020,Unknown,20.02,Unknown,Unknown,Credit,Unknown,LCL,D'IDENTITE,31.04
Unknown,Unknown,281,Unknown,Unknown,Credit,Unknown,LCL,BICETRE,312.04
Unknown,Unknown,58,Unknown,Unknown,Credit,Unknown,LCL,MONS,370.04
Unknown,Unknown,12,Unknown,Unknown,Credit,Unknown,LCL,MONSIEUR AMOKRANE,382.04
Unknown,Unknown,50,Unknown,Unknown,Credit,Unknown,LCL,BICETRE,432.04
Unknown,Unknown,10.02,Unknown,Unknown,Credit,Unknown,LCL,Cle,442.06
Unknown,Unknown,"20 170,26",Unknown,Unknown,Credit,Unknown,LCL,References,2017468.06
Unknown,Unknown,11 02,Unknown,Unknown,Credit,Unknown,LCL,FR85,2018570.06
Unknown,Unknown,14 02,Unknown,Unknown,Credit,Unknown,LCL,OOOO,2019972.06
Unknown,Unknown,20.02,Unknown,Unknown,Credit,Unknown,LCL,7121 T5O,2019992.08
Unknown,Unknown,828,Unknown,Unknown,Credit,Unknown,LCL,CREDIT 10.02 ANCIEN SOLDE,2020820.08
Unknown,Unknown,11.02,Unknown,Unknown,Credit,Unknown,LCL,CHQ,2020831.1
Unknown,Unknown,20 14,Unknown,Unknown,Credit,Unknown,LCL,CHQ,2022845.1
Unknown,Unknown,02 20,Unknown,Unknown,Credit,Unknown,LCL,DGFIP CREANCIER,2023065.1
Unknown,Unknown,20.02,Unknown,Unknown,Credit,Unknown,LCL,CLIENT 220940430700080378332 ID CREANCIER FR46ZZZ005002 REF MANDAT: ++315510958DGFIP2015OOIZCKIGINBAMA,2023085.12
Unknown,Unknown,20,Unknown,Unknown,Credit,Unknown,LCL,TOTAUX,2023105.12
Unknown,Unknown,"3 364,37",Unknown,Unknown,Credit,Unknown,LCL,SOLDE,2359542.12
Unknown,Unknown,"115,00",Unknown,Unknown,Credit,Unknown,LCL,Resolution,2371042.12
Unknown,Unknown,"34,00",Unknown,Unknown,Credit,Unknown,LCL,Dispositions generales de banque disponibles,2374442.12
Unknown,Unknown,"3 513,37",Unknown,Unknown,Credit,Unknown,LCL,Unknown,2725779.12
Unknown,Unknown,"20 170,26",Unknown,Unknown,Credit,Unknown,LCL,Unknown,4742805.12
Unknown,Unknown,20.02,Unknown,Unknown,Credit,Unknown,LCL,Unknown,4742825.14
Unknown,Unknown,"16 656,89",Unknown,Unknown,Credit,Unknown,LCL,Unknown,6408514.14
Unknown,Unknown,1,Unknown,Unknown,Credit,Unknown,LCL,Unknown,6408515.14
Unknown,Unknown,7,Unknown,Unknown,Unknown,Unknown,Banque Inconnue,cid:7)(cid:35)(cid:36,7.0
Unknown,Unknown,35,Unknown,Unknown,Unknown,Unknown,Banque Inconnue,cid:32)(cid:32)(cid:33)(cid:20)(cid:34)(cid:35)(cid:8)(cid:28)(cid:5)(cid:9)(cid:12)(cid:5)(cid:14)(cid:14)(cid:4)(cid:7)(cid:3)(cid:19,42.0
Unknown,Unknown,36,Unknown,Unknown,Unknown,Unknown,Banque Inconnue,cid:37)(cid:36)(cid:38)(cid:3)(cid:39)(cid:1)(cid:2)(cid:3)(cid:4)(cid:5)(cid:1)(cid:6)(cid:5)(cid:7)(cid:8)(cid:1)(cid:9)(cid:10)(cid:10)(cid:10)(cid:1)(cid:10)(cid:6)(cid:7)(cid:9)(cid:1)(cid:6)(cid:11)(cid:12)(cid:13)(cid:1)(cid:7)(cid:9)(cid:7)(cid:11)(cid:1)(cid:11)(cid:10)(cid:8,78.0
Unknown,Unknown,20,Unknown,Unknown,Unknown,Unknown,Banque Inconnue,Unknown,98.0
Unknown,Unknown,8,Unknown,Unknown,Unknown,Unknown,Banque Inconnue,Unknown,106.0
Unknown,Unknown,21,Unknown,Unknown,Unknown,Unknown,Banque Inconnue,Unknown,127.0
Unknown,Unknown,22,Unknown,Unknown,Unknown,Unknown,Banque Inconnue,Unknown,149.0
Unknown,Unknown,23,Unknown,Unknown,Unknown,Unknown,Banque Inconnue,Unknown,172.0
Unknown,Unknown,8,Unknown,Unknown,Unknown,Unknown,Banque Inconnue,Unknown,180.0
Unknown,Unknown,24,Unknown,Unknown,Unknown,Unknown,Banque Inconnue,Unknown,204.0
Unknown,Unknown,25,Unknown,Unknown,Unknown,Unknown,Banque Inconnue,Unknown,229.0
Unknown,Unknown,26,Unknown,Unknown,Unknown,Unknown,Banque Inconnue,Unknown,255.0
Unknown,Unknown,11,Unknown,Unknown,Unknown,Unknown,Banque Inconnue,Unknown,266.0
Unknown,Unknown,17,Unknown,Unknown,Unknown,Unknown,Banque Inconnue,Unknown,283.0
Unknown,Unknown,27,Unknown,Unknown,Unknown,Unknown,Banque Inconnue,Unknown,310.0
Unknown,Unknown,26,Unknown,Unknown,Unknown,Unknown,Banque Inconnue,Unknown,336.0
Unknown,Unknown,8,Unknown,Unknown,Unknown,Unknown,Banque Inconnue,Unknown,344.0
Unknown,Unknown,28,Unknown,Unknown,Unknown,Unknown,Banque Inconnue,Unknown,372.0
Unknown,Unknown,29,Unknown,Unknown,Unknown,Unknown,Banque Inconnue,Unknown,401.0
Unknown,Unknown,22,Unknown,Unknown,Unknown,Unknown,Banque Inconnue,Unknown,423.0
Unknown,Unknown,21,Unknown,Unknown,Unknown,Unknown,Banque Inconnue,Unknown,444.0
Unknown,Unknown,28,Unknown,Unknown,Unknown,Unknown,Banque Inconnue,Unknown,472.0
Unknown,Unknown,29,Unknown,Unknown,Unknown,Unknown,Banque Inconnue,Unknown,501.0
Unknown,Unknown,25,Unknown,Unknown,Unknown,Unknown,Banque Inconnue,Unknown,526.0
Unknown,Unknown,30,Unknown,Unknown,Unknown,Unknown,Banque Inconnue,Unknown,556.0
Unknown,Unknown,30,Unknown,Unknown,Unknown,Unknown,Banque Inconnue,Unknown,586.0
Unknown,Unknown,8,Unknown,Unknown,Unknown,Unknown,Banque Inconnue,Unknown,594.0
Unknown,Unknown,31,Unknown,Unknown,Unknown,Unknown,Banque Inconnue,Unknown,625.0
Unknown,Unknown,8,Unknown,Unknown,Unknown,Unknown,Banque Inconnue,Unknown,633.0
Unknown,Unknown,32,Unknown,Unknown,Unknown,Unknown,Banque Inconnue,Unknown,665.0
Unknown,Unknown,32,Unknown,Unknown,Unknown,Unknown,Banque Inconnue,Unknown,697.0
Unknown,Unknown,33,Unknown,Unknown,Unknown,Unknown,Banque Inconnue,Unknown,730.0
Unknown,Unknown,20,Unknown,Unknown,Unknown,Unknown,Banque Inconnue,Unknown,750.0
Unknown,Unknown,34,Unknown,Unknown,Unknown,Unknown,Banque Inconnue,Unknown,784.0
Unknown,Unknown,35,Unknown,Unknown,Unknown,Unknown,Banque Inconnue,Unknown,819.0
Unknown,Unknown,8,Unknown,Unknown,Unknown,Unknown,Banque Inconnue,Unknown,827.0
Unknown,Unknown,28,Unknown,Unknown,Unknown,Unknown,Banque Inconnue,Unknown,855.0
Unknown,Unknown,5,Unknown,Unknown,Unknown,Unknown,Banque Inconnue,Unknown,860.0
Unknown,Unknown,9,Unknown,Unknown,Unknown,Unknown,Banque Inconnue,Unknown,869.0
Unknown,Unknown,12,Unknown,Unknown,Unknown,Unknown,Banque Inconnue,Unknown,881.0
Unknown,Unknown,5,Unknown,Unknown,Unknown,Unknown,Banque Inconnue,Unknown,886.0
Unknown,Unknown,14,Unknown,Unknown,Unknown,Unknown,Banque Inconnue,Unknown,900.0
Unknown,Unknown,14,Unknown,Unknown,Unknown,Unknown,Banque Inconnue,Unknown,914.0
Unknown,Unknown,4,Unknown,Unknown,Unknown,Unknown,Banque Inconnue,Unknown,918.0
Unknown,Unknown,7,Unknown,Unknown,Unknown,Unknown,Banque Inconnue,Unknown,925.0
Unknown,Unknown,3,Unknown,Unknown,Unknown,Unknown,Banque Inconnue,Unknown,928.0
Unknown,Unknown,19,Unknown,Unknown,Unknown,Unknown,Banque Inconnue,Unknown,947.0
Unknown,Unknown,36,Unknown,Unknown,Unknown,Unknown,Banque Inconnue,Unknown,983.0
Unknown,Unknown,3,Unknown,Unknown,Unknown,Unknown,Banque Inconnue,Unknown,986.0
Unknown,Unknown,10,Unknown,Unknown,Unknown,Unknown,Banque Inconnue,Unknown,996.0
Unknown,Unknown,18,Unknown,Unknown,Unknown,Unknown,Banque Inconnue,Unknown,1014.0
Unknown,Unknown,13,Unknown,Unknown,Unknown,Unknown,Banque Inconnue,Unknown,1027.0
Unknown,Unknown,7,Unknown,Unknown,Unknown,Unknown,Banque Inconnue,Unknown,1034.0
Unknown,Unknown,37,Unknown,Unknown,Unknown,Unknown,Banque Inconnue,Unknown,1071.0
Unknown,Unknown,36,Unknown,Unknown,Unknown,Unknown,Banque Inconnue,Unknown,1107.0
Unknown,Unknown,38,Unknown,Unknown,Unknown,Unknown,Banque Inconnue,Unknown,1145.0
Unknown,Unknown,3,Unknown,Unknown,Unknown,Unknown,Banque Inconnue,Unknown,1148.0
Unknown,Unknown,39,Unknown,Unknown,Unknown,Unknown,Banque Inconnue,Unknown,1187.0
Unknown,Unknown,1,Unknown,Unknown,Unknown,Unknown,Banque Inconnue,Unknown,1188.0
Unknown,Unknown,2,Unknown,Unknown,Unknown,Unknown,Banque Inconnue,Unknown,1190.0
Unknown,Unknown,3,Unknown,Unknown,Unknown,Unknown,Banque Inconnue,Unknown,1193.0
Unknown,Unknown,4,Unknown,Unknown,Unknown,Unknown,Banque Inconnue,Unknown,1197.0
Unknown,Unknown,5,Unknown,Unknown,Unknown,Unknown,Banque Inconnue,Unknown,1202.0
Unknown,Unknown,1,Unknown,Unknown,Unknown,Unknown,Banque Inconnue,Unknown,1203.0
Unknown,Unknown,6,Unknown,Unknown,Unknown,Unknown,Banque Inconnue,Unknown,1209.0
Unknown,Unknown,5,Unknown,Unknown,Unknown,Unknown,Banque Inconnue,Unknown,1214.0
Unknown,Unknown,7,Unknown,Unknown,Unknown,Unknown,Banque Inconnue,Unknown,1221.0
Unknown,Unknown,8,Unknown,Unknown,Unknown,Unknown,Banque Inconnue,Unknown,1229.0
Unknown,Unknown,1,Unknown,Unknown,Unknown,Unknown,Banque Inconnue,Unknown,1230.0
Unknown,Unknown,9,Unknown,Unknown,Unknown,Unknown,Banque Inconnue,Unknown,1239.0
Unknown,Unknown,10,Unknown,Unknown,Unknown,Unknown,Banque Inconnue,Unknown,1249.0
Unknown,Unknown,10,Unknown,Unknown,Unknown,Unknown,Banque Inconnue,Unknown,1259.0
Unknown,Unknown,10,Unknown,Unknown,Unknown,Unknown,Banque Inconnue,Unknown,1269.0
Unknown,Unknown,1,Unknown,Unknown,Unknown,Unknown,Banque Inconnue,Unknown,1270.0
Unknown,Unknown,10,Unknown,Unknown,Unknown,Unknown,Banque Inconnue,Unknown,1280.0
Unknown,Unknown,6,Unknown,Unknown,Unknown,Unknown,Banque Inconnue,Unknown,1286.0
Unknown,Unknown,7,Unknown,Unknown,Unknown,Unknown,Banque Inconnue,Unknown,1293.0
Unknown,Unknown,9,Unknown,Unknown,Unknown,Unknown,Banque Inconnue,Unknown,1302.0
Unknown,Unknown,1,Unknown,Unknown,Unknown,Unknown,Banque Inconnue,Unknown,1303.0
Unknown,Unknown,6,Unknown,Unknown,Unknown,Unknown,Banque Inconnue,Unknown,1309.0
Unknown,Unknown,11,Unknown,Unknown,Unknown,Unknown,Banque Inconnue,Unknown,1320.0
Unknown,Unknown,12,Unknown,Unknown,Unknown,Unknown,Banque Inconnue,Unknown,1332.0
Unknown,Unknown,13,Unknown,Unknown,Unknown,Unknown,Banque Inconnue,Unknown,1345.0
Unknown,Unknown,1,Unknown,Unknown,Unknown,Unknown,Banque Inconnue,Unknown,1346.0
Unknown,Unknown,7,Unknown,Unknown,Unknown,Unknown,Banque Inconnue,Unknown,1353.0
Unknown,Unknown,9,Unknown,Unknown,Unknown,Unknown,Banque Inconnue,Unknown,1362.0
Unknown,Unknown,7,Unknown,Unknown,Unknown,Unknown,Banque Inconnue,Unknown,1369.0
Unknown,Unknown,11,Unknown,Unknown,Unknown,Unknown,Banque Inconnue,Unknown,1380.0
Unknown,Unknown,1,Unknown,Unknown,Unknown,Unknown,Banque Inconnue,Unknown,1381.0
Unknown,Unknown,11,Unknown,Unknown,Unknown,Unknown,Banque Inconnue,Unknown,1392.0
Unknown,Unknown,10,Unknown,Unknown,Unknown,Unknown,Banque Inconnue,Unknown,1402.0
Unknown,Unknown,8,Unknown,Unknown,Unknown,Unknown,Banque Inconnue,Unknown,1410.0
Unknown,Unknown,36,Unknown,Unknown,Unknown,Unknown,Banque Inconnue,Unknown,1446.0
Unknown,Unknown,37,Unknown,Unknown,Unknown,Unknown,Banque Inconnue,Unknown,1483.0
Unknown,Unknown,13,Unknown,Unknown,Unknown,Unknown,Banque Inconnue,Unknown,1496.0
Unknown,Unknown,39,Unknown,Unknown,Unknown,Unknown,Banque Inconnue,Unknown,1535.0
Unknown,Unknown,1,Unknown,Unknown,Unknown,Unknown,Banque Inconnue,Unknown,1536.0
Unknown,Unknown,14,Unknown,Unknown,Unknown,Unknown,Banque Inconnue,Unknown,1550.0
Unknown,Unknown,15,Unknown,Unknown,Unknown,Unknown,Banque Inconnue,Unknown,1565.0
Unknown,Unknown,16,Unknown,Unknown,Unknown,Unknown,Banque Inconnue,Unknown,1581.0
Unknown,Unknown,17,Unknown,Unknown,Unknown,Unknown,Banque Inconnue,Unknown,1598.0
Unknown,Unknown,2,Unknown,Unknown,Unknown,Unknown,Banque Inconnue,Unknown,1600.0
Unknown,Unknown,3,Unknown,Unknown,Unknown,Unknown,Banque Inconnue,Unknown,1603.0
Unknown,Unknown,18,Unknown,Unknown,Unknown,Unknown,Banque Inconnue,Unknown,1621.0
Unknown,Unknown,6,Unknown,Unknown,Unknown,Unknown,Banque Inconnue,Unknown,1627.0
Unknown,Unknown,19,Unknown,Unknown,Unknown,Unknown,Banque Inconnue,Unknown,1646.0
Unknown,Unknown,19,Unknown,Unknown,Unknown,Unknown,Banque Inconnue,Unknown,1665.0
Unknown,Unknown,19,Unknown,Unknown,Unknown,Unknown,Banque Inconnue,Unknown,1684.0
Unknown,Unknown,17,Unknown,Unknown,Unknown,Unknown,Banque Inconnue,Unknown,1701.0
Unknown,Unknown,5,Unknown,Unknown,Unknown,Unknown,Banque Inconnue,Unknown,1706.0
Unknown,Unknown,9,Unknown,Unknown,Unknown,Unknown,Banque Inconnue,Unknown,1715.0
Unknown,Unknown,16,Unknown,Unknown,Unknown,Unknown,Banque Inconnue,Unknown,1731.0
Unknown,Unknown,7,Unknown,Unknown,Unknown,Unknown,Banque Inconnue,Unknown,1738.0
Unknown,Unknown,19,Unknown,Unknown,Unknown,Unknown,Banque Inconnue,Unknown,1757.0
Unknown,Unknown,8,Unknown,Unknown,Unknown,Unknown,Banque Inconnue,Unknown,1765.0
Unknown,Unknown,12,Unknown,Unknown,Unknown,Unknown,Banque Inconnue,Unknown,1777.0
Unknown,Unknown,7,Unknown,Unknown,Unknown,Unknown,Banque Inconnue,Unknown,1784.0
Unknown,Unknown,19,Unknown,Unknown,Unknown,Unknown,Banque Inconnue,Unknown,1803.0
Unknown,Unknown,8,Unknown,Unknown,Unknown,Unknown,Banque Inconnue,Unknown,1811.0
Unknown,Unknown,13,Unknown,Unknown,Unknown,Unknown,Banque Inconnue,Unknown,1824.0
Unknown,Unknown,10,Unknown,Unknown,Unknown,Unknown,Banque Inconnue,Unknown,1834.0
Unknown,Unknown,3,Unknown,Unknown,Unknown,Unknown,Banque Inconnue,Unknown,1837.0
Unknown,Unknown,16,Unknown,Unknown,Unknown,Unknown,Banque Inconnue,Unknown,1853.0
Unknown,Unknown,7,Unknown,Unknown,Unknown,Unknown,Banque Inconnue,Unknown,1860.0
Unknown,Unknown,19,Unknown,Unknown,Unknown,Unknown,Banque Inconnue,Unknown,1879.0
Unknown,Unknown,8,Unknown,Unknown,Unknown,Unknown,Banque Inconnue,Unknown,1887.0
Unknown,Unknown,6,Unknown,Unknown,Unknown,Unknown,Banque Inconnue,Unknown,1893.0
Unknown,Unknown,7,Unknown,Unknown,Unknown,Unknown,Banque Inconnue,Unknown,1900.0
Unknown,Unknown,8,Unknown,Unknown,Unknown,Unknown,Banque Inconnue,Unknown,1908.0
Unknown,Unknown,37,Unknown,Unknown,Unknown,Unknown,Banque Inconnue,Unknown,1945.0
Unknown,Unknown,5,Unknown,Unknown,Unknown,Unknown,Banque Inconnue,Unknown,1950.0
Unknown,Unknown,16,Unknown,Unknown,Unknown,Unknown,Banque Inconnue,Unknown,1966.0
Unknown,Unknown,3,Unknown,Unknown,Unknown,Unknown,Banque Inconnue,Unknown,1969.0
Unknown,Unknown,7,Unknown,Unknown,Unknown,Unknown,Banque Inconnue,Unknown,1976.0
Unknown,Unknown,8,Unknown,Unknown,Unknown,Unknown,Banque Inconnue,Unknown,1984.0
Unknown,Unknown,13,Unknown,Unknown,Unknown,Unknown,Banque Inconnue,Unknown,1997.0
Unknown,Unknown,5,Unknown,Unknown,Unknown,Unknown,Banque Inconnue,Unknown,2002.0
Unknown,Unknown,14,Unknown,Unknown,Unknown,Unknown,Banque Inconnue,Unknown,2016.0
Unknown,Unknown,15,Unknown,Unknown,Unknown,Unknown,Banque Inconnue,Unknown,2031.0
Unknown,Unknown,16,Unknown,Unknown,Unknown,Unknown,Banque Inconnue,Unknown,2047.0
Unknown,Unknown,7,Unknown,Unknown,Unknown,Unknown,Banque Inconnue,Unknown,2054.0
Unknown,Unknown,8,Unknown,Unknown,Unknown,Unknown,Banque Inconnue,Unknown,2062.0
Unknown,Unknown,38,Unknown,Unknown,Unknown,Unknown,Banque Inconnue,Unknown,2100.0
Unknown,Unknown,5,Unknown,Unknown,Unknown,Unknown,Banque Inconnue,Unknown,2105.0
Unknown,Unknown,18,Unknown,Unknown,Unknown,Unknown,Banque Inconnue,Unknown,2123.0
Unknown,Unknown,16,Unknown,Unknown,Unknown,Unknown,Banque Inconnue,Unknown,2139.0
Unknown,Unknown,5,Unknown,Unknown,Unknown,Unknown,Banque Inconnue,Unknown,2144.0
Unknown,Unknown,8,Unknown,Unknown,Unknown,Unknown,Banque Inconnue,Unknown,2152.0
Unknown,Unknown,19,Unknown,Unknown,Unknown,Unknown,Banque Inconnue,Unknown,2171.0
Unknown,Unknown,5,Unknown,Unknown,Unknown,Unknown,Banque Inconnue,Unknown,2176.0
Unknown,Unknown,18,Unknown,Unknown,Unknown,Unknown,Banque Inconnue,Unknown,2194.0
Unknown,Unknown,16,Unknown,Unknown,Unknown,Unknown,Banque Inconnue,Unknown,2210.0
Unknown,Unknown,8,Unknown,Unknown,Unknown,Unknown,Banque Inconnue,Unknown,2218.0
Unknown,Unknown,13,Unknown,Unknown,Unknown,Unknown,Banque Inconnue,Unknown,2231.0
Unknown,Unknown,5,Unknown,Unknown,Unknown,Unknown,Banque Inconnue,Unknown,2236.0
Unknown,Unknown,14,Unknown,Unknown,Unknown,Unknown,Banque Inconnue,Unknown,2250.0
Unknown,Unknown,15,Unknown,Unknown,Unknown,Unknown,Banque Inconnue,Unknown,2265.0
Unknown,Unknown,10,Unknown,Unknown,Unknown,Unknown,Banque Inconnue,Unknown,2275.0
Unknown,Unknown,16,Unknown,Unknown,Unknown,Unknown,Banque Inconnue,Unknown,2291.0
Unknown,Unknown,4,Unknown,Unknown,Unknown,Unknown,Banque Inconnue,Unknown,2295.0
Unknown,Unknown,39,Unknown,Unknown,Unknown,Unknown,Banque Inconnue,Unknown,2334.0
Unknown,Unknown,12,Unknown,Unknown,Unknown,Unknown,Banque Inconnue,Unknown,2346.0
Unknown,Unknown,7,Unknown,Unknown,Unknown,Unknown,Banque Inconnue,Unknown,2353.0
Unknown,Unknown,19,Unknown,Unknown,Unknown,Unknown,Banque Inconnue,Unknown,2372.0
Unknown,Unknown,8,Unknown,Unknown,Unknown,Unknown,Banque Inconnue,Unknown,2380.0
Unknown,Unknown,10,Unknown,Unknown,Unknown,Unknown,Banque Inconnue,Unknown,2390.0
Unknown,Unknown,37,Unknown,Unknown,Unknown,Unknown,Banque Inconnue,Unknown,2427.0
Unknown,Unknown,7,Unknown,Unknown,Unknown,Unknown,Banque Inconnue,Unknown,2434.0
Unknown,Unknown,13,Unknown,Unknown,Unknown,Unknown,Banque Inconnue,Unknown,2447.0
Unknown,Unknown,8,Unknown,Unknown,Unknown,Unknown,Banque Inconnue,Unknown,2455.0
Unknown,Unknown,40,Unknown,Unknown,Unknown,Unknown,Banque Inconnue,Unknown,2495.0
Unknown,Unknown,15,Unknown,Unknown,Unknown,Unknown,Banque Inconnue,Unknown,2510.0
Unknown,Unknown,15,Unknown,Unknown,Unknown,Unknown,Banque Inconnue,Unknown,2525.0
Unknown,Unknown,12,Unknown,Unknown,Unknown,Unknown,Banque Inconnue,Unknown,2537.0
Unknown,Unknown,7,Unknown,Unknown,Unknown,Unknown,Banque Inconnue,Unknown,2544.0
Unknown,Unknown,8,Unknown,Unknown,Unknown,Unknown,Banque Inconnue,Unknown,2552.0
Unknown,Unknown,1,Unknown,Unknown,Unknown,Unknown,Banque Inconnue,Unknown,2553.0
Unknown,Unknown,10,Unknown,Unknown,Unknown,Unknown,Banque Inconnue,Unknown,2563.0
Unknown,Unknown,41,Unknown,Unknown,Unknown,Unknown,Banque Inconnue,Unknown,2604.0
Unknown,Unknown,8,Unknown,Unknown,Unknown,Unknown,Banque Inconnue,Unknown,2612.0
Unknown,Unknown,7,Unknown,Unknown,Unknown,Unknown,Banque Inconnue,Unknown,2619.0
Unknown,Unknown,16,Unknown,Unknown,Unknown,Unknown,Banque Inconnue,Unknown,2635.0
Unknown,Unknown,8,Unknown,Unknown,Unknown,Unknown,Banque Inconnue,Unknown,2643.0
Unknown,Unknown,42,Unknown,Unknown,Unknown,Unknown,Banque Inconnue,Unknown,2685.0
Unknown,Unknown,5,Unknown,Unknown,Unknown,Unknown,Banque Inconnue,Unknown,2690.0
Unknown,Unknown,5,Unknown,Unknown,Unknown,Unknown,Banque Inconnue,Unknown,2695.0
Unknown,Unknown,43,Unknown,Unknown,Unknown,Unknown,Banque Inconnue,Unknown,2738.0
Unknown,Unknown,12,Unknown,Unknown,Unknown,Unknown,Banque Inconnue,Unknown,2750.0
Unknown,Unknown,7,Unknown,Unknown,Unknown,Unknown,Banque Inconnue,Unknown,2757.0
Unknown,Unknown,8,Unknown,Unknown,Unknown,Unknown,Banque Inconnue,Unknown,2765.0
Unknown,Unknown,1,Unknown,Unknown,Unknown,Unknown,Banque Inconnue,Unknown,2766.0
Unknown,Unknown,10,Unknown,Unknown,Unknown,Unknown,Banque Inconnue,Unknown,2776.0
Unknown,Unknown,41,Unknown,Unknown,Unknown,Unknown,Banque Inconnue,Unknown,2817.0
Unknown,Unknown,44,Unknown,Unknown,Unknown,Unknown,Banque Inconnue,Unknown,2861.0
Unknown,Unknown,9,Unknown,Unknown,Unknown,Unknown,cid:16)(cid:17)(cid:16)(cid:27)(cid:28)(cid:1)(cid:29)(cid:30)(cid:28)(cid:28)(cid:31)(cid:29)(cid:27)(cid:32)(cid:33)(cid:31)(cid:1)(cid:2)(cid:3,cid:24)(cid:1)(cid:9)(cid:11)(cid:25)(cid:7)(cid:4)(cid:1)(cid:26,9.0
Unknown,Unknown,40,Unknown,Unknown,Unknown,Unknown,cid:16)(cid:17)(cid:16)(cid:27)(cid:28)(cid:1)(cid:29)(cid:30)(cid:28)(cid:28)(cid:31)(cid:29)(cid:27)(cid:32)(cid:33)(cid:31)(cid:1)(cid:2)(cid:3,Unknown,49.0
Unknown,Unknown,41,Unknown,Unknown,Unknown,Unknown,cid:16)(cid:17)(cid:16)(cid:27)(cid:28)(cid:1)(cid:29)(cid:30)(cid:28)(cid:28)(cid:31)(cid:29)(cid:27)(cid:32)(cid:33)(cid:31)(cid:1)(cid:2)(cid:3,Unknown,90.0
Unknown,Unknown,22,Unknown,Unknown,Unknown,Unknown,cid:16)(cid:17)(cid:16)(cid:27)(cid:28)(cid:1)(cid:29)(cid:30)(cid:28)(cid:28)(cid:31)(cid:29)(cid:27)(cid:32)(cid:33)(cid:31)(cid:1)(cid:2)(cid:3,Unknown,112.0
Unknown,Unknown,4,Unknown,Unknown,Unknown,Unknown,cid:16)(cid:17)(cid:16)(cid:27)(cid:28)(cid:1)(cid:29)(cid:30)(cid:28)(cid:28)(cid:31)(cid:29)(cid:27)(cid:32)(cid:33)(cid:31)(cid:1)(cid:2)(cid:3,Unknown,116.0
Unknown,Unknown,20,Unknown,Unknown,Unknown,Unknown,cid:16)(cid:17)(cid:16)(cid:27)(cid:28)(cid:1)(cid:29)(cid:30)(cid:28)(cid:28)(cid:31)(cid:29)(cid:27)(cid:32)(cid:33)(cid:31)(cid:1)(cid:2)(cid:3,Unknown,136.0
Unknown,Unknown,40,Unknown,Unknown,Unknown,Unknown,cid:16)(cid:17)(cid:16)(cid:27)(cid:28)(cid:1)(cid:29)(cid:30)(cid:28)(cid:28)(cid:31)(cid:29)(cid:27)(cid:32)(cid:33)(cid:31)(cid:1)(cid:2)(cid:3,Unknown,176.0
Unknown,Unknown,42,Unknown,Unknown,Unknown,Unknown,cid:16)(cid:17)(cid:16)(cid:27)(cid:28)(cid:1)(cid:29)(cid:30)(cid:28)(cid:28)(cid:31)(cid:29)(cid:27)(cid:32)(cid:33)(cid:31)(cid:1)(cid:2)(cid:3,Unknown,218.0
Unknown,Unknown,43,Unknown,Unknown,Unknown,Unknown,cid:16)(cid:17)(cid:16)(cid:27)(cid:28)(cid:1)(cid:29)(cid:30)(cid:28)(cid:28)(cid:31)(cid:29)(cid:27)(cid:32)(cid:33)(cid:31)(cid:1)(cid:2)(cid:3,Unknown,261.0
Unknown,Unknown,40,Unknown,Unknown,Unknown,Unknown,cid:16)(cid:17)(cid:16)(cid:27)(cid:28)(cid:1)(cid:29)(cid:30)(cid:28)(cid:28)(cid:31)(cid:29)(cid:27)(cid:32)(cid:33)(cid:31)(cid:1)(cid:2)(cid:3,Unknown,301.0
Unknown,Unknown,44,Unknown,Unknown,Unknown,Unknown,cid:16)(cid:17)(cid:16)(cid:27)(cid:28)(cid:1)(cid:29)(cid:30)(cid:28)(cid:28)(cid:31)(cid:29)(cid:27)(cid:32)(cid:33)(cid:31)(cid:1)(cid:2)(cid:3,Unknown,345.0
Unknown,Unknown,41,Unknown,Unknown,Unknown,Unknown,cid:16)(cid:17)(cid:16)(cid:27)(cid:28)(cid:1)(cid:29)(cid:30)(cid:28)(cid:28)(cid:31)(cid:29)(cid:27)(cid:32)(cid:33)(cid:31)(cid:1)(cid:2)(cid:3,Unknown,386.0
Unknown,Unknown,21,Unknown,Unknown,Unknown,Unknown,cid:16)(cid:17)(cid:16)(cid:27)(cid:28)(cid:1)(cid:29)(cid:30)(cid:28)(cid:28)(cid:31)(cid:29)(cid:27)(cid:32)(cid:33)(cid:31)(cid:1)(cid:2)(cid:3,Unknown,407.0
Unknown,Unknown,45,Unknown,Unknown,Unknown,Unknown,cid:16)(cid:17)(cid:16)(cid:27)(cid:28)(cid:1)(cid:29)(cid:30)(cid:28)(cid:28)(cid:31)(cid:29)(cid:27)(cid:32)(cid:33)(cid:31)(cid:1)(cid:2)(cid:3,Unknown,452.0
Unknown,Unknown,42,Unknown,Unknown,Unknown,Unknown,cid:16)(cid:17)(cid:16)(cid:27)(cid:28)(cid:1)(cid:29)(cid:30)(cid:28)(cid:28)(cid:31)(cid:29)(cid:27)(cid:32)(cid:33)(cid:31)(cid:1)(cid:2)(cid:3,Unknown,494.0
Unknown,Unknown,43,Unknown,Unknown,Unknown,Unknown,cid:16)(cid:17)(cid:16)(cid:27)(cid:28)(cid:1)(cid:29)(cid:30)(cid:28)(cid:28)(cid:31)(cid:29)(cid:27)(cid:32)(cid:33)(cid:31)(cid:1)(cid:2)(cid:3,Unknown,537.0
Unknown,Unknown,9,Unknown,Unknown,Unknown,Unknown,cid:16)(cid:17)(cid:16)(cid:27)(cid:28)(cid:1)(cid:29)(cid:30)(cid:28)(cid:28)(cid:31)(cid:29)(cid:27)(cid:32)(cid:33)(cid:31)(cid:1)(cid:2)(cid:3,Unknown,546.0
Unknown,Unknown,18,Unknown,Unknown,Unknown,Unknown,cid:16)(cid:17)(cid:16)(cid:27)(cid:28)(cid:1)(cid:29)(cid:30)(cid:28)(cid:28)(cid:31)(cid:29)(cid:27)(cid:32)(cid:33)(cid:31)(cid:1)(cid:2)(cid:3,Unknown,564.0
Unknown,Unknown,46,Unknown,Unknown,Unknown,Unknown,cid:16)(cid:17)(cid:16)(cid:27)(cid:28)(cid:1)(cid:29)(cid:30)(cid:28)(cid:28)(cid:31)(cid:29)(cid:27)(cid:32)(cid:33)(cid:31)(cid:1)(cid:2)(cid:3,Unknown,610.0
Unknown,Unknown,21,Unknown,Unknown,Unknown,Unknown,cid:16)(cid:17)(cid:16)(cid:27)(cid:28)(cid:1)(cid:29)(cid:30)(cid:28)(cid:28)(cid:31)(cid:29)(cid:27)(cid:32)(cid:33)(cid:31)(cid:1)(cid:2)(cid:3,Unknown,631.0
Unknown,Unknown,41,Unknown,Unknown,Unknown,Unknown,cid:16)(cid:17)(cid:16)(cid:27)(cid:28)(cid:1)(cid:29)(cid:30)(cid:28)(cid:28)(cid:31)(cid:29)(cid:27)(cid:32)(cid:33)(cid:31)(cid:1)(cid:2)(cid:3,Unknown,672.0
Unknown,Unknown,13,Unknown,Unknown,Unknown,Unknown,cid:16)(cid:17)(cid:16)(cid:27)(cid:28)(cid:1)(cid:29)(cid:30)(cid:28)(cid:28)(cid:31)(cid:29)(cid:27)(cid:32)(cid:33)(cid:31)(cid:1)(cid:2)(cid:3,Unknown,685.0
Unknown,Unknown,20,Unknown,Unknown,Unknown,Unknown,cid:16)(cid:17)(cid:16)(cid:27)(cid:28)(cid:1)(cid:29)(cid:30)(cid:28)(cid:28)(cid:31)(cid:29)(cid:27)(cid:32)(cid:33)(cid:31)(cid:1)(cid:2)(cid:3,Unknown,705.0
Unknown,Unknown,18,Unknown,Unknown,Unknown,Unknown,cid:16)(cid:17)(cid:16)(cid:27)(cid:28)(cid:1)(cid:29)(cid:30)(cid:28)(cid:28)(cid:31)(cid:29)(cid:27)(cid:32)(cid:33)(cid:31)(cid:1)(cid:2)(cid:3,Unknown,723.0
Unknown,Unknown,47,Unknown,Unknown,Unknown,Unknown,cid:16)(cid:17)(cid:16)(cid:27)(cid:28)(cid:1)(cid:29)(cid:30)(cid:28)(cid:28)(cid:31)(cid:29)(cid:27)(cid:32)(cid:33)(cid:31)(cid:1)(cid:2)(cid:3,Unknown,770.0
Unknown,Unknown,21,Unknown,Unknown,Unknown,Unknown,cid:16)(cid:17)(cid:16)(cid:27)(cid:28)(cid:1)(cid:29)(cid:30)(cid:28)(cid:28)(cid:31)(cid:29)(cid:27)(cid:32)(cid:33)(cid:31)(cid:1)(cid:2)(cid:3,Unknown,791.0
Unknown,Unknown,41,Unknown,Unknown,Unknown,Unknown,cid:16)(cid:17)(cid:16)(cid:27)(cid:28)(cid:1)(cid:29)(cid:30)(cid:28)(cid:28)(cid:31)(cid:29)(cid:27)(cid:32)(cid:33)(cid:31)(cid:1)(cid:2)(cid:3,Unknown,832.0
Unknown,Unknown,10,Unknown,Unknown,Unknown,Unknown,cid:16)(cid:17)(cid:16)(cid:27)(cid:28)(cid:1)(cid:29)(cid:30)(cid:28)(cid:28)(cid:31)(cid:29)(cid:27)(cid:32)(cid:33)(cid:31)(cid:1)(cid:2)(cid:3,Unknown,842.0
Unknown,Unknown,6,Unknown,Unknown,Unknown,Unknown,cid:16)(cid:17)(cid:16)(cid:27)(cid:28)(cid:1)(cid:29)(cid:30)(cid:28)(cid:28)(cid:31)(cid:29)(cid:27)(cid:32)(cid:33)(cid:31)(cid:1)(cid:2)(cid:3,Unknown,848.0
Unknown,Unknown,20,Unknown,Unknown,Unknown,Unknown,cid:16)(cid:17)(cid:16)(cid:27)(cid:28)(cid:1)(cid:29)(cid:30)(cid:28)(cid:28)(cid:31)(cid:29)(cid:27)(cid:32)(cid:33)(cid:31)(cid:1)(cid:2)(cid:3,Unknown,868.0
Unknown,Unknown,10,Unknown,Unknown,Unknown,Unknown,cid:16)(cid:17)(cid:16)(cid:27)(cid:28)(cid:1)(cid:29)(cid:30)(cid:28)(cid:28)(cid:31)(cid:29)(cid:27)(cid:32)(cid:33)(cid:31)(cid:1)(cid:2)(cid:3,Unknown,878.0
Unknown,Unknown,11,Unknown,Unknown,Unknown,Unknown,cid:16)(cid:17)(cid:16)(cid:27)(cid:28)(cid:1)(cid:29)(cid:30)(cid:28)(cid:28)(cid:31)(cid:29)(cid:27)(cid:32)(cid:33)(cid:31)(cid:1)(cid:2)(cid:3,Unknown,889.0
Unknown,Unknown,14,Unknown,Unknown,Unknown,Unknown,cid:16)(cid:17)(cid:16)(cid:27)(cid:28)(cid:1)(cid:29)(cid:30)(cid:28)(cid:28)(cid:31)(cid:29)(cid:27)(cid:32)(cid:33)(cid:31)(cid:1)(cid:2)(cid:3,Unknown,903.0
Unknown,Unknown,21,Unknown,Unknown,Unknown,Unknown,cid:16)(cid:17)(cid:16)(cid:27)(cid:28)(cid:1)(cid:29)(cid:30)(cid:28)(cid:28)(cid:31)(cid:29)(cid:27)(cid:32)(cid:33)(cid:31)(cid:1)(cid:2)(cid:3,Unknown,924.0
Unknown,Unknown,22,Unknown,Unknown,Unknown,Unknown,cid:16)(cid:17)(cid:16)(cid:27)(cid:28)(cid:1)(cid:29)(cid:30)(cid:28)(cid:28)(cid:31)(cid:29)(cid:27)(cid:32)(cid:33)(cid:31)(cid:1)(cid:2)(cid:3,Unknown,946.0
Unknown,Unknown,23,Unknown,Unknown,Unknown,Unknown,cid:16)(cid:17)(cid:16)(cid:27)(cid:28)(cid:1)(cid:29)(cid:30)(cid:28)(cid:28)(cid:31)(cid:29)(cid:27)(cid:32)(cid:33)(cid:31)(cid:1)(cid:2)(cid:3,Unknown,969.0
Unknown,Unknown,21,Unknown,Unknown,Unknown,Unknown,cid:16)(cid:17)(cid:16)(cid:27)(cid:28)(cid:1)(cid:29)(cid:30)(cid:28)(cid:28)(cid:31)(cid:29)(cid:27)(cid:32)(cid:33)(cid:31)(cid:1)(cid:2)(cid:3,Unknown,990.0
Unknown,Unknown,24,Unknown,Unknown,Unknown,Unknown,cid:16)(cid:17)(cid:16)(cid:27)(cid:28)(cid:1)(cid:29)(cid:30)(cid:28)(cid:28)(cid:31)(cid:29)(cid:27)(cid:32)(cid:33)(cid:31)(cid:1)(cid:2)(cid:3,Unknown,1014.0
Unknown,Unknown,1,Unknown,Unknown,Unknown,Unknown,cid:16)(cid:17)(cid:16)(cid:27)(cid:28)(cid:1)(cid:29)(cid:30)(cid:28)(cid:28)(cid:31)(cid:29)(cid:27)(cid:32)(cid:33)(cid:31)(cid:1)(cid:2)(cid:3,Unknown,1015.0
Unknown,Unknown,6,Unknown,Unknown,Unknown,Unknown,cid:16)(cid:17)(cid:16)(cid:27)(cid:28)(cid:1)(cid:29)(cid:30)(cid:28)(cid:28)(cid:31)(cid:29)(cid:27)(cid:32)(cid:33)(cid:31)(cid:1)(cid:2)(cid:3,Unknown,1021.0
Unknown,Unknown,9,Unknown,Unknown,Unknown,Unknown,cid:16)(cid:17)(cid:16)(cid:27)(cid:28)(cid:1)(cid:29)(cid:30)(cid:28)(cid:28)(cid:31)(cid:29)(cid:27)(cid:32)(cid:33)(cid:31)(cid:1)(cid:2)(cid:3,Unknown,1030.0
Unknown,Unknown,25,Unknown,Unknown,Unknown,Unknown,cid:16)(cid:17)(cid:16)(cid:27)(cid:28)(cid:1)(cid:29)(cid:30)(cid:28)(cid:28)(cid:31)(cid:29)(cid:27)(cid:32)(cid:33)(cid:31)(cid:1)(cid:2)(cid:3,Unknown,1055.0
Unknown,Unknown,10,Unknown,Unknown,Unknown,Unknown,cid:16)(cid:17)(cid:16)(cid:27)(cid:28)(cid:1)(cid:29)(cid:30)(cid:28)(cid:28)(cid:31)(cid:29)(cid:27)(cid:32)(cid:33)(cid:31)(cid:1)(cid:2)(cid:3,Unknown,1065.0
Unknown,Unknown,10,Unknown,Unknown,Unknown,Unknown,cid:16)(cid:17)(cid:16)(cid:27)(cid:28)(cid:1)(cid:29)(cid:30)(cid:28)(cid:28)(cid:31)(cid:29)(cid:27)(cid:32)(cid:33)(cid:31)(cid:1)(cid:2)(cid:3,Unknown,1075.0
Unknown,Unknown,1,Unknown,Unknown,Unknown,Unknown,cid:16)(cid:17)(cid:16)(cid:27)(cid:28)(cid:1)(cid:29)(cid:30)(cid:28)(cid:28)(cid:31)(cid:29)(cid:27)(cid:32)(cid:33)(cid:31)(cid:1)(cid:2)(cid:3,Unknown,1076.0
Unknown,Unknown,26,Unknown,Unknown,Unknown,Unknown,cid:16)(cid:17)(cid:16)(cid:27)(cid:28)(cid:1)(cid:29)(cid:30)(cid:28)(cid:28)(cid:31)(cid:29)(cid:27)(cid:32)(cid:33)(cid:31)(cid:1)(cid:2)(cid:3,Unknown,1102.0
Unknown,Unknown,16,Unknown,Unknown,Unknown,Unknown,cid:16)(cid:17)(cid:16)(cid:27)(cid:28)(cid:1)(cid:29)(cid:30)(cid:28)(cid:28)(cid:31)(cid:29)(cid:27)(cid:32)(cid:33)(cid:31)(cid:1)(cid:2)(cid:3,Unknown,1118.0
Unknown,Unknown,17,Unknown,Unknown,Unknown,Unknown,cid:16)(cid:17)(cid:16)(cid:27)(cid:28)(cid:1)(cid:29)(cid:30)(cid:28)(cid:28)(cid:31)(cid:29)(cid:27)(cid:32)(cid:33)(cid:31)(cid:1)(cid:2)(cid:3,Unknown,1135.0
Unknown,Unknown,16,Unknown,Unknown,Unknown,Unknown,cid:16)(cid:17)(cid:16)(cid:27)(cid:28)(cid:1)(cid:29)(cid:30)(cid:28)(cid:28)(cid:31)(cid:29)(cid:27)(cid:32)(cid:33)(cid:31)(cid:1)(cid:2)(cid:3,Unknown,1151.0
Unknown,Unknown,27,Unknown,Unknown,Unknown,Unknown,cid:16)(cid:17)(cid:16)(cid:27)(cid:28)(cid:1)(cid:29)(cid:30)(cid:28)(cid:28)(cid:31)(cid:29)(cid:27)(cid:32)(cid:33)(cid:31)(cid:1)(cid:2)(cid:3,Unknown,1178.0
Unknown,Unknown,28,Unknown,Unknown,Unknown,Unknown,cid:16)(cid:17)(cid:16)(cid:27)(cid:28)(cid:1)(cid:29)(cid:30)(cid:28)(cid:28)(cid:31)(cid:29)(cid:27)(cid:32)(cid:33)(cid:31)(cid:1)(cid:2)(cid:3,Unknown,1206.0
Unknown,Unknown,1,Unknown,Unknown,Unknown,Unknown,cid:16)(cid:17)(cid:16)(cid:27)(cid:28)(cid:1)(cid:29)(cid:30)(cid:28)(cid:28)(cid:31)(cid:29)(cid:27)(cid:32)(cid:33)(cid:31)(cid:1)(cid:2)(cid:3,Unknown,1207.0
Unknown,Unknown,29,Unknown,Unknown,Unknown,Unknown,cid:16)(cid:17)(cid:16)(cid:27)(cid:28)(cid:1)(cid:29)(cid:30)(cid:28)(cid:28)(cid:31)(cid:29)(cid:27)(cid:32)(cid:33)(cid:31)(cid:1)(cid:2)(cid:3,Unknown,1236.0
Unknown,Unknown,30,Unknown,Unknown,Unknown,Unknown,cid:16)(cid:17)(cid:16)(cid:27)(cid:28)(cid:1)(cid:29)(cid:30)(cid:28)(cid:28)(cid:31)(cid:29)(cid:27)(cid:32)(cid:33)(cid:31)(cid:1)(cid:2)(cid:3,Unknown,1266.0
Unknown,Unknown,28,Unknown,Unknown,Unknown,Unknown,cid:16)(cid:17)(cid:16)(cid:27)(cid:28)(cid:1)(cid:29)(cid:30)(cid:28)(cid:28)(cid:31)(cid:29)(cid:27)(cid:32)(cid:33)(cid:31)(cid:1)(cid:2)(cid:3,Unknown,1294.0
Unknown,Unknown,28,Unknown,Unknown,Unknown,Unknown,cid:16)(cid:17)(cid:16)(cid:27)(cid:28)(cid:1)(cid:29)(cid:30)(cid:28)(cid:28)(cid:31)(cid:29)(cid:27)(cid:32)(cid:33)(cid:31)(cid:1)(cid:2)(cid:3,Unknown,1322.0
Unknown,Unknown,31,Unknown,Unknown,Unknown,Unknown,cid:16)(cid:17)(cid:16)(cid:27)(cid:28)(cid:1)(cid:29)(cid:30)(cid:28)(cid:28)(cid:31)(cid:29)(cid:27)(cid:32)(cid:33)(cid:31)(cid:1)(cid:2)(cid:3,Unknown,1353.0
Unknown,Unknown,29,Unknown,Unknown,Unknown,Unknown,cid:16)(cid:17)(cid:16)(cid:27)(cid:28)(cid:1)(cid:29)(cid:30)(cid:28)(cid:28)(cid:31)(cid:29)(cid:27)(cid:32)(cid:33)(cid:31)(cid:1)(cid:2)(cid:3,Unknown,1382.0
Unknown,Unknown,27,Unknown,Unknown,Unknown,Unknown,cid:16)(cid:17)(cid:16)(cid:27)(cid:28)(cid:1)(cid:29)(cid:30)(cid:28)(cid:28)(cid:31)(cid:29)(cid:27)(cid:32)(cid:33)(cid:31)(cid:1)(cid:2)(cid:3,Unknown,1409.0
Unknown,Unknown,32,Unknown,Unknown,Unknown,Unknown,cid:16)(cid:17)(cid:16)(cid:27)(cid:28)(cid:1)(cid:29)(cid:30)(cid:28)(cid:28)(cid:31)(cid:29)(cid:27)(cid:32)(cid:33)(cid:31)(cid:1)(cid:2)(cid:3,Unknown,1441.0
Unknown,Unknown,33,Unknown,Unknown,Unknown,Unknown,cid:16)(cid:17)(cid:16)(cid:27)(cid:28)(cid:1)(cid:29)(cid:30)(cid:28)(cid:28)(cid:31)(cid:29)(cid:27)(cid:32)(cid:33)(cid:31)(cid:1)(cid:2)(cid:3,Unknown,1474.0
Unknown,Unknown,31,Unknown,Unknown,Unknown,Unknown,cid:16)(cid:17)(cid:16)(cid:27)(cid:28)(cid:1)(cid:29)(cid:30)(cid:28)(cid:28)(cid:31)(cid:29)(cid:27)(cid:32)(cid:33)(cid:31)(cid:1)(cid:2)(cid:3,Unknown,1505.0
Unknown,Unknown,1,Unknown,Unknown,Unknown,Unknown,cid:16)(cid:17)(cid:16)(cid:27)(cid:28)(cid:1)(cid:29)(cid:30)(cid:28)(cid:28)(cid:31)(cid:29)(cid:27)(cid:32)(cid:33)(cid:31)(cid:1)(cid:2)(cid:3,Unknown,1506.0
Unknown,Unknown,2,Unknown,Unknown,Unknown,Unknown,cid:16)(cid:17)(cid:16)(cid:27)(cid:28)(cid:1)(cid:29)(cid:30)(cid:28)(cid:28)(cid:31)(cid:29)(cid:27)(cid:32)(cid:33)(cid:31)(cid:1)(cid:2)(cid:3,Unknown,1508.0
Unknown,Unknown,3,Unknown,Unknown,Unknown,Unknown,cid:16)(cid:17)(cid:16)(cid:27)(cid:28)(cid:1)(cid:29)(cid:30)(cid:28)(cid:28)(cid:31)(cid:29)(cid:27)(cid:32)(cid:33)(cid:31)(cid:1)(cid:2)(cid:3,Unknown,1511.0
Unknown,Unknown,10,Unknown,Unknown,Unknown,Unknown,cid:16)(cid:17)(cid:16)(cid:27)(cid:28)(cid:1)(cid:29)(cid:30)(cid:28)(cid:28)(cid:31)(cid:29)(cid:27)(cid:32)(cid:33)(cid:31)(cid:1)(cid:2)(cid:3,Unknown,1521.0
Unknown,Unknown,6,Unknown,Unknown,Unknown,Unknown,cid:16)(cid:17)(cid:16)(cid:27)(cid:28)(cid:1)(cid:29)(cid:30)(cid:28)(cid:28)(cid:31)(cid:29)(cid:27)(cid:32)(cid:33)(cid:31)(cid:1)(cid:2)(cid:3,Unknown,1527.0
Unknown,Unknown,20,Unknown,Unknown,Unknown,Unknown,cid:16)(cid:17)(cid:16)(cid:27)(cid:28)(cid:1)(cid:29)(cid:30)(cid:28)(cid:28)(cid:31)(cid:29)(cid:27)(cid:32)(cid:33)(cid:31)(cid:1)(cid:2)(cid:3,Unknown,1547.0
Unknown,Unknown,10,Unknown,Unknown,Unknown,Unknown,cid:16)(cid:17)(cid:16)(cid:27)(cid:28)(cid:1)(cid:29)(cid:30)(cid:28)(cid:28)(cid:31)(cid:29)(cid:27)(cid:32)(cid:33)(cid:31)(cid:1)(cid:2)(cid:3,Unknown,1557.0
Unknown,Unknown,11,Unknown,Unknown,Unknown,Unknown,cid:16)(cid:17)(cid:16)(cid:27)(cid:28)(cid:1)(cid:29)(cid:30)(cid:28)(cid:28)(cid:31)(cid:29)(cid:27)(cid:32)(cid:33)(cid:31)(cid:1)(cid:2)(cid:3,Unknown,1568.0
Unknown,Unknown,24,Unknown,Unknown,Unknown,Unknown,cid:16)(cid:17)(cid:16)(cid:27)(cid:28)(cid:1)(cid:29)(cid:30)(cid:28)(cid:28)(cid:31)(cid:29)(cid:27)(cid:32)(cid:33)(cid:31)(cid:1)(cid:2)(cid:3,Unknown,1592.0
Unknown,Unknown,1,Unknown,Unknown,Unknown,Unknown,cid:16)(cid:17)(cid:16)(cid:27)(cid:28)(cid:1)(cid:29)(cid:30)(cid:28)(cid:28)(cid:31)(cid:29)(cid:27)(cid:32)(cid:33)(cid:31)(cid:1)(cid:2)(cid:3,Unknown,1593.0
Unknown,Unknown,8,Unknown,Unknown,Unknown,Unknown,cid:16)(cid:17)(cid:16)(cid:27)(cid:28)(cid:1)(cid:29)(cid:30)(cid:28)(cid:28)(cid:31)(cid:29)(cid:27)(cid:32)(cid:33)(cid:31)(cid:1)(cid:2)(cid:3,Unknown,1601.0
Unknown,Unknown,6,Unknown,Unknown,Unknown,Unknown,cid:16)(cid:17)(cid:16)(cid:27)(cid:28)(cid:1)(cid:29)(cid:30)(cid:28)(cid:28)(cid:31)(cid:29)(cid:27)(cid:32)(cid:33)(cid:31)(cid:1)(cid:2)(cid:3,Unknown,1607.0
Unknown,Unknown,25,Unknown,Unknown,Unknown,Unknown,cid:16)(cid:17)(cid:16)(cid:27)(cid:28)(cid:1)(cid:29)(cid:30)(cid:28)(cid:28)(cid:31)(cid:29)(cid:27)(cid:32)(cid:33)(cid:31)(cid:1)(cid:2)(cid:3,Unknown,1632.0
Unknown,Unknown,4,Unknown,Unknown,Unknown,Unknown,cid:16)(cid:17)(cid:16)(cid:27)(cid:28)(cid:1)(cid:29)(cid:30)(cid:28)(cid:28)(cid:31)(cid:29)(cid:27)(cid:32)(cid:33)(cid:31)(cid:1)(cid:2)(cid:3,Unknown,1636.0
Unknown,Unknown,10,Unknown,Unknown,Unknown,Unknown,cid:16)(cid:17)(cid:16)(cid:27)(cid:28)(cid:1)(cid:29)(cid:30)(cid:28)(cid:28)(cid:31)(cid:29)(cid:27)(cid:32)(cid:33)(cid:31)(cid:1)(cid:2)(cid:3,Unknown,1646.0
Unknown,Unknown,1,Unknown,Unknown,Unknown,Unknown,cid:16)(cid:17)(cid:16)(cid:27)(cid:28)(cid:1)(cid:29)(cid:30)(cid:28)(cid:28)(cid:31)(cid:29)(cid:27)(cid:32)(cid:33)(cid:31)(cid:1)(cid:2)(cid:3,Unknown,1647.0
Unknown,Unknown,26,Unknown,Unknown,Unknown,Unknown,cid:16)(cid:17)(cid:16)(cid:27)(cid:28)(cid:1)(cid:29)(cid:30)(cid:28)(cid:28)(cid:31)(cid:29)(cid:27)(cid:32)(cid:33)(cid:31)(cid:1)(cid:2)(cid:3,Unknown,1673.0
Unknown,Unknown,45,Unknown,Unknown,Unknown,Unknown,cid:16)(cid:17)(cid:16)(cid:27)(cid:28)(cid:1)(cid:29)(cid:30)(cid:28)(cid:28)(cid:31)(cid:29)(cid:27)(cid:32)(cid:33)(cid:31)(cid:1)(cid:2)(cid:3,Unknown,1718.0
Unknown,Unknown,10,Unknown,Unknown,Unknown,Unknown,cid:16)(cid:17)(cid:16)(cid:27)(cid:28)(cid:1)(cid:29)(cid:30)(cid:28)(cid:28)(cid:31)(cid:29)(cid:27)(cid:32)(cid:33)(cid:31)(cid:1)(cid:2)(cid:3,Unknown,1728.0
Unknown,Unknown,19,Unknown,Unknown,Unknown,Unknown,cid:16)(cid:17)(cid:16)(cid:27)(cid:28)(cid:1)(cid:29)(cid:30)(cid:28)(cid:28)(cid:31)(cid:29)(cid:27)(cid:32)(cid:33)(cid:31)(cid:1)(cid:2)(cid:3,Unknown,1747.0
Unknown,Unknown,16,Unknown,Unknown,Unknown,Unknown,cid:16)(cid:17)(cid:16)(cid:27)(cid:28)(cid:1)(cid:29)(cid:30)(cid:28)(cid:28)(cid:31)(cid:29)(cid:27)(cid:32)(cid:33)(cid:31)(cid:1)(cid:2)(cid:3,Unknown,1763.0
Unknown,Unknown,7,Unknown,Unknown,Unknown,Unknown,cid:16)(cid:17)(cid:16)(cid:27)(cid:28)(cid:1)(cid:29)(cid:30)(cid:28)(cid:28)(cid:31)(cid:29)(cid:27)(cid:32)(cid:33)(cid:31)(cid:1)(cid:2)(cid:3,Unknown,1770.0
Unknown,Unknown,3,Unknown,Unknown,Unknown,Unknown,cid:16)(cid:17)(cid:16)(cid:27)(cid:28)(cid:1)(cid:29)(cid:30)(cid:28)(cid:28)(cid:31)(cid:29)(cid:27)(cid:32)(cid:33)(cid:31)(cid:1)(cid:2)(cid:3,Unknown,1773.0
Unknown,Unknown,8,Unknown,Unknown,Unknown,Unknown,cid:16)(cid:17)(cid:16)(cid:27)(cid:28)(cid:1)(cid:29)(cid:30)(cid:28)(cid:28)(cid:31)(cid:29)(cid:27)(cid:32)(cid:33)(cid:31)(cid:1)(cid:2)(cid:3,Unknown,1781.0
Unknown,Unknown,28,Unknown,Unknown,Unknown,Unknown,cid:16)(cid:17)(cid:16)(cid:27)(cid:28)(cid:1)(cid:29)(cid:30)(cid:28)(cid:28)(cid:31)(cid:29)(cid:27)(cid:32)(cid:33)(cid:31)(cid:1)(cid:2)(cid:3,Unknown,1809.0
Unknown,Unknown,10,Unknown,Unknown,Unknown,Unknown,cid:16)(cid:17)(cid:16)(cid:27)(cid:28)(cid:1)(cid:29)(cid:30)(cid:28)(cid:28)(cid:31)(cid:29)(cid:27)(cid:32)(cid:33)(cid:31)(cid:1)(cid:2)(cid:3,Unknown,1819.0
Unknown,Unknown,3,Unknown,Unknown,Unknown,Unknown,cid:16)(cid:17)(cid:16)(cid:27)(cid:28)(cid:1)(cid:29)(cid:30)(cid:28)(cid:28)(cid:31)(cid:29)(cid:27)(cid:32)(cid:33)(cid:31)(cid:1)(cid:2)(cid:3,Unknown,1822.0
Unknown,Unknown,6,Unknown,Unknown,Unknown,Unknown,cid:16)(cid:17)(cid:16)(cid:27)(cid:28)(cid:1)(cid:29)(cid:30)(cid:28)(cid:28)(cid:31)(cid:29)(cid:27)(cid:32)(cid:33)(cid:31)(cid:1)(cid:2)(cid:3,Unknown,1828.0
Unknown,Unknown,8,Unknown,Unknown,Unknown,Unknown,cid:16)(cid:17)(cid:16)(cid:27)(cid:28)(cid:1)(cid:29)(cid:30)(cid:28)(cid:28)(cid:31)(cid:29)(cid:27)(cid:32)(cid:33)(cid:31)(cid:1)(cid:2)(cid:3,Unknown,1836.0
Unknown,Unknown,46,Unknown,Unknown,Unknown,Unknown,cid:16)(cid:17)(cid:16)(cid:27)(cid:28)(cid:1)(cid:29)(cid:30)(cid:28)(cid:28)(cid:31)(cid:29)(cid:27)(cid:32)(cid:33)(cid:31)(cid:1)(cid:2)(cid:3,Unknown,1882.0
Unknown,Unknown,46,Unknown,Unknown,Unknown,Unknown,cid:16)(cid:17)(cid:16)(cid:27)(cid:28)(cid:1)(cid:29)(cid:30)(cid:28)(cid:28)(cid:31)(cid:29)(cid:27)(cid:32)(cid:33)(cid:31)(cid:1)(cid:2)(cid:3,Unknown,1928.0
Unknown,Unknown,47,Unknown,Unknown,Unknown,Unknown,cid:16)(cid:17)(cid:16)(cid:27)(cid:28)(cid:1)(cid:29)(cid:30)(cid:28)(cid:28)(cid:31)(cid:29)(cid:27)(cid:32)(cid:33)(cid:31)(cid:1)(cid:2)(cid:3,Unknown,1975.0
Unknown,Unknown,32,Unknown,Unknown,Unknown,Unknown,cid:16)(cid:17)(cid:16)(cid:27)(cid:28)(cid:1)(cid:29)(cid:30)(cid:28)(cid:28)(cid:31)(cid:29)(cid:27)(cid:32)(cid:33)(cid:31)(cid:1)(cid:2)(cid:3,Unknown,2007.0
Unknown,Unknown,48,Unknown,Unknown,Unknown,Unknown,cid:16)(cid:17)(cid:16)(cid:27)(cid:28)(cid:1)(cid:29)(cid:30)(cid:28)(cid:28)(cid:31)(cid:29)(cid:27)(cid:32)(cid:33)(cid:31)(cid:1)(cid:2)(cid:3,Unknown,2055.0
Unknown,Unknown,49,Unknown,Unknown,Unknown,Unknown,cid:16)(cid:17)(cid:16)(cid:27)(cid:28)(cid:1)(cid:29)(cid:30)(cid:28)(cid:28)(cid:31)(cid:29)(cid:27)(cid:32)(cid:33)(cid:31)(cid:1)(cid:2)(cid:3,Unknown,2104.0
Unknown,Unknown,16,Unknown,Unknown,Unknown,Unknown,cid:16)(cid:17)(cid:16)(cid:27)(cid:28)(cid:1)(cid:29)(cid:30)(cid:28)(cid:28)(cid:31)(cid:29)(cid:27)(cid:32)(cid:33)(cid:31)(cid:1)(cid:2)(cid:3,Unknown,2120.0
Unknown,Unknown,31,Unknown,Unknown,Unknown,Unknown,cid:16)(cid:17)(cid:16)(cid:27)(cid:28)(cid:1)(cid:29)(cid:30)(cid:28)(cid:28)(cid:31)(cid:29)(cid:27)(cid:32)(cid:33)(cid:31)(cid:1)(cid:2)(cid:3,Unknown,2151.0
Unknown,Unknown,28,Unknown,Unknown,Unknown,Unknown,cid:16)(cid:17)(cid:16)(cid:27)(cid:28)(cid:1)(cid:29)(cid:30)(cid:28)(cid:28)(cid:31)(cid:29)(cid:27)(cid:32)(cid:33)(cid:31)(cid:1)(cid:2)(cid:3,Unknown,2179.0
Unknown,Unknown,1,Unknown,Unknown,Unknown,Unknown,cid:16)(cid:17)(cid:16)(cid:27)(cid:28)(cid:1)(cid:29)(cid:30)(cid:28)(cid:28)(cid:31)(cid:29)(cid:27)(cid:32)(cid:33)(cid:31)(cid:1)(cid:2)(cid:3,Unknown,2180.0
Unknown,Unknown,34,Unknown,Unknown,Unknown,Unknown,cid:16)(cid:17)(cid:16)(cid:27)(cid:28)(cid:1)(cid:29)(cid:30)(cid:28)(cid:28)(cid:31)(cid:29)(cid:27)(cid:32)(cid:33)(cid:31)(cid:1)(cid:2)(cid:3,Unknown,2214.0
Unknown,Unknown,1,Unknown,Unknown,Unknown,Unknown,cid:16)(cid:17)(cid:16)(cid:27)(cid:28)(cid:1)(cid:29)(cid:30)(cid:28)(cid:28)(cid:31)(cid:29)(cid:27)(cid:32)(cid:33)(cid:31)(cid:1)(cid:2)(cid:3,Unknown,2215.0
Unknown,Unknown,34,Unknown,Unknown,Unknown,Unknown,cid:16)(cid:17)(cid:16)(cid:27)(cid:28)(cid:1)(cid:29)(cid:30)(cid:28)(cid:28)(cid:31)(cid:29)(cid:27)(cid:32)(cid:33)(cid:31)(cid:1)(cid:2)(cid:3,Unknown,2249.0
Unknown,Unknown,31,Unknown,Unknown,Unknown,Unknown,cid:16)(cid:17)(cid:16)(cid:27)(cid:28)(cid:1)(cid:29)(cid:30)(cid:28)(cid:28)(cid:31)(cid:29)(cid:27)(cid:32)(cid:33)(cid:31)(cid:1)(cid:2)(cid:3,Unknown,2280.0
Unknown,Unknown,32,Unknown,Unknown,Unknown,Unknown,cid:16)(cid:17)(cid:16)(cid:27)(cid:28)(cid:1)(cid:29)(cid:30)(cid:28)(cid:28)(cid:31)(cid:29)(cid:27)(cid:32)(cid:33)(cid:31)(cid:1)(cid:2)(cid:3,Unknown,2312.0
Unknown,Unknown,33,Unknown,Unknown,Unknown,Unknown,cid:16)(cid:17)(cid:16)(cid:27)(cid:28)(cid:1)(cid:29)(cid:30)(cid:28)(cid:28)(cid:31)(cid:29)(cid:27)(cid:32)(cid:33)(cid:31)(cid:1)(cid:2)(cid:3,Unknown,2345.0
Unknown,Unknown,17,Unknown,Unknown,Unknown,Unknown,cid:16)(cid:17)(cid:16)(cid:27)(cid:28)(cid:1)(cid:29)(cid:30)(cid:28)(cid:28)(cid:31)(cid:29)(cid:27)(cid:32)(cid:33)(cid:31)(cid:1)(cid:2)(cid:3,Unknown,2362.0
Unknown,Unknown,15,Unknown,Unknown,Unknown,Unknown,cid:16)(cid:17)(cid:16)(cid:27)(cid:28)(cid:1)(cid:29)(cid:30)(cid:28)(cid:28)(cid:31)(cid:29)(cid:27)(cid:32)(cid:33)(cid:31)(cid:1)(cid:2)(cid:3,Unknown,2377.0
Unknown,Unknown,1,Unknown,Unknown,Unknown,Unknown,cid:16)(cid:17)(cid:16)(cid:27)(cid:28)(cid:1)(cid:29)(cid:30)(cid:28)(cid:28)(cid:31)(cid:29)(cid:27)(cid:32)(cid:33)(cid:31)(cid:1)(cid:2)(cid:3,Unknown,2378.0
Unknown,Unknown,28,Unknown,Unknown,Unknown,Unknown,cid:16)(cid:17)(cid:16)(cid:27)(cid:28)(cid:1)(cid:29)(cid:30)(cid:28)(cid:28)(cid:31)(cid:29)(cid:27)(cid:32)(cid:33)(cid:31)(cid:1)(cid:2)(cid:3,Unknown,2406.0
Unknown,Unknown,27,Unknown,Unknown,Unknown,Unknown,cid:16)(cid:17)(cid:16)(cid:27)(cid:28)(cid:1)(cid:29)(cid:30)(cid:28)(cid:28)(cid:31)(cid:29)(cid:27)(cid:32)(cid:33)(cid:31)(cid:1)(cid:2)(cid:3,Unknown,2433.0
Unknown,Unknown,1,Unknown,Unknown,Unknown,Unknown,cid:16)(cid:17)(cid:16)(cid:27)(cid:28)(cid:1)(cid:29)(cid:30)(cid:28)(cid:28)(cid:31)(cid:29)(cid:27)(cid:32)(cid:33)(cid:31)(cid:1)(cid:2)(cid:3,Unknown,2434.0
Unknown,Unknown,2,Unknown,Unknown,Unknown,Unknown,cid:16)(cid:17)(cid:16)(cid:27)(cid:28)(cid:1)(cid:29)(cid:30)(cid:28)(cid:28)(cid:31)(cid:29)(cid:27)(cid:32)(cid:33)(cid:31)(cid:1)(cid:2)(cid:3,Unknown,2436.0
Unknown,Unknown,17,Unknown,Unknown,Unknown,Unknown,cid:16)(cid:17)(cid:16)(cid:27)(cid:28)(cid:1)(cid:29)(cid:30)(cid:28)(cid:28)(cid:31)(cid:29)(cid:27)(cid:32)(cid:33)(cid:31)(cid:1)(cid:2)(cid:3,Unknown,2453.0
Unknown,Unknown,3,Unknown,Unknown,Unknown,Unknown,cid:16)(cid:17)(cid:16)(cid:27)(cid:28)(cid:1)(cid:29)(cid:30)(cid:28)(cid:28)(cid:31)(cid:29)(cid:27)(cid:32)(cid:33)(cid:31)(cid:1)(cid:2)(cid:3,Unknown,2456.0
Unknown,Unknown,1,Unknown,Unknown,Unknown,Unknown,cid:16)(cid:17)(cid:16)(cid:27)(cid:28)(cid:1)(cid:29)(cid:30)(cid:28)(cid:28)(cid:31)(cid:29)(cid:27)(cid:32)(cid:33)(cid:31)(cid:1)(cid:2)(cid:3,Unknown,2457.0
Unknown,Unknown,2,Unknown,Unknown,Unknown,Unknown,cid:16)(cid:17)(cid:16)(cid:27)(cid:28)(cid:1)(cid:29)(cid:30)(cid:28)(cid:28)(cid:31)(cid:29)(cid:27)(cid:32)(cid:33)(cid:31)(cid:1)(cid:2)(cid:3,Unknown,2459.0
Unknown,Unknown,3,Unknown,Unknown,Unknown,Unknown,cid:16)(cid:17)(cid:16)(cid:27)(cid:28)(cid:1)(cid:29)(cid:30)(cid:28)(cid:28)(cid:31)(cid:29)(cid:27)(cid:32)(cid:33)(cid:31)(cid:1)(cid:2)(cid:3,Unknown,2462.0
Unknown,Unknown,10,Unknown,Unknown,Unknown,Unknown,cid:16)(cid:17)(cid:16)(cid:27)(cid:28)(cid:1)(cid:29)(cid:30)(cid:28)(cid:28)(cid:31)(cid:29)(cid:27)(cid:32)(cid:33)(cid:31)(cid:1)(cid:2)(cid:3,Unknown,2472.0
Unknown,Unknown,6,Unknown,Unknown,Unknown,Unknown,cid:16)(cid:17)(cid:16)(cid:27)(cid:28)(cid:1)(cid:29)(cid:30)(cid:28)(cid:28)(cid:31)(cid:29)(cid:27)(cid:32)(cid:33)(cid:31)(cid:1)(cid:2)(cid:3,Unknown,2478.0
Unknown,Unknown,20,Unknown,Unknown,Unknown,Unknown,cid:16)(cid:17)(cid:16)(cid:27)(cid:28)(cid:1)(cid:29)(cid:30)(cid:28)(cid:28)(cid:31)(cid:29)(cid:27)(cid:32)(cid:33)(cid:31)(cid:1)(cid:2)(cid:3,Unknown,2498.0
Unknown,Unknown,10,Unknown,Unknown,Unknown,Unknown,cid:16)(cid:17)(cid:16)(cid:27)(cid:28)(cid:1)(cid:29)(cid:30)(cid:28)(cid:28)(cid:31)(cid:29)(cid:27)(cid:32)(cid:33)(cid:31)(cid:1)(cid:2)(cid:3,Unknown,2508.0
Unknown,Unknown,11,Unknown,Unknown,Unknown,Unknown,cid:16)(cid:17)(cid:16)(cid:27)(cid:28)(cid:1)(cid:29)(cid:30)(cid:28)(cid:28)(cid:31)(cid:29)(cid:27)(cid:32)(cid:33)(cid:31)(cid:1)(cid:2)(cid:3,Unknown,2519.0
Unknown,Unknown,24,Unknown,Unknown,Unknown,Unknown,cid:16)(cid:17)(cid:16)(cid:27)(cid:28)(cid:1)(cid:29)(cid:30)(cid:28)(cid:28)(cid:31)(cid:29)(cid:27)(cid:32)(cid:33)(cid:31)(cid:1)(cid:2)(cid:3,Unknown,2543.0
Unknown,Unknown,1,Unknown,Unknown,Unknown,Unknown,cid:16)(cid:17)(cid:16)(cid:27)(cid:28)(cid:1)(cid:29)(cid:30)(cid:28)(cid:28)(cid:31)(cid:29)(cid:27)(cid:32)(cid:33)(cid:31)(cid:1)(cid:2)(cid:3,Unknown,2544.0
Unknown,Unknown,9,Unknown,Unknown,Unknown,Unknown,cid:16)(cid:17)(cid:16)(cid:27)(cid:28)(cid:1)(cid:29)(cid:30)(cid:28)(cid:28)(cid:31)(cid:29)(cid:27)(cid:32)(cid:33)(cid:31)(cid:1)(cid:2)(cid:3,Unknown,2553.0
Unknown,Unknown,11,Unknown,Unknown,Unknown,Unknown,cid:16)(cid:17)(cid:16)(cid:27)(cid:28)(cid:1)(cid:29)(cid:30)(cid:28)(cid:28)(cid:31)(cid:29)(cid:27)(cid:32)(cid:33)(cid:31)(cid:1)(cid:2)(cid:3,Unknown,2564.0
Unknown,Unknown,25,Unknown,Unknown,Unknown,Unknown,cid:16)(cid:17)(cid:16)(cid:27)(cid:28)(cid:1)(cid:29)(cid:30)(cid:28)(cid:28)(cid:31)(cid:29)(cid:27)(cid:32)(cid:33)(cid:31)(cid:1)(cid:2)(cid:3,Unknown,2589.0
Unknown,Unknown,7,Unknown,Unknown,Unknown,Unknown,cid:16)(cid:17)(cid:16)(cid:27)(cid:28)(cid:1)(cid:29)(cid:30)(cid:28)(cid:28)(cid:31)(cid:29)(cid:27)(cid:32)(cid:33)(cid:31)(cid:1)(cid:2)(cid:3,Unknown,2596.0
Unknown,Unknown,4,Unknown,Unknown,Unknown,Unknown,cid:16)(cid:17)(cid:16)(cid:27)(cid:28)(cid:1)(cid:29)(cid:30)(cid:28)(cid:28)(cid:31)(cid:29)(cid:27)(cid:32)(cid:33)(cid:31)(cid:1)(cid:2)(cid:3,Unknown,2600.0
Unknown,Unknown,1,Unknown,Unknown,Unknown,Unknown,cid:16)(cid:17)(cid:16)(cid:27)(cid:28)(cid:1)(cid:29)(cid:30)(cid:28)(cid:28)(cid:31)(cid:29)(cid:27)(cid:32)(cid:33)(cid:31)(cid:1)(cid:2)(cid:3,Unknown,2601.0
Unknown,Unknown,26,Unknown,Unknown,Unknown,Unknown,cid:16)(cid:17)(cid:16)(cid:27)(cid:28)(cid:1)(cid:29)(cid:30)(cid:28)(cid:28)(cid:31)(cid:29)(cid:27)(cid:32)(cid:33)(cid:31)(cid:1)(cid:2)(cid:3,Unknown,2627.0
Unknown,Unknown,45,Unknown,Unknown,Unknown,Unknown,cid:16)(cid:17)(cid:16)(cid:27)(cid:28)(cid:1)(cid:29)(cid:30)(cid:28)(cid:28)(cid:31)(cid:29)(cid:27)(cid:32)(cid:33)(cid:31)(cid:1)(cid:2)(cid:3,Unknown,2672.0
Unknown,Unknown,10,Unknown,Unknown,Unknown,Unknown,cid:16)(cid:17)(cid:16)(cid:27)(cid:28)(cid:1)(cid:29)(cid:30)(cid:28)(cid:28)(cid:31)(cid:29)(cid:27)(cid:32)(cid:33)(cid:31)(cid:1)(cid:2)(cid:3,Unknown,2682.0
Unknown,Unknown,19,Unknown,Unknown,Unknown,Unknown,cid:16)(cid:17)(cid:16)(cid:27)(cid:28)(cid:1)(cid:29)(cid:30)(cid:28)(cid:28)(cid:31)(cid:29)(cid:27)(cid:32)(cid:33)(cid:31)(cid:1)(cid:2)(cid:3,Unknown,2701.0
Unknown,Unknown,16,Unknown,Unknown,Unknown,Unknown,cid:16)(cid:17)(cid:16)(cid:27)(cid:28)(cid:1)(cid:29)(cid:30)(cid:28)(cid:28)(cid:31)(cid:29)(cid:27)(cid:32)(cid:33)(cid:31)(cid:1)(cid:2)(cid:3,Unknown,2717.0
Unknown,Unknown,7,Unknown,Unknown,Unknown,Unknown,cid:16)(cid:17)(cid:16)(cid:27)(cid:28)(cid:1)(cid:29)(cid:30)(cid:28)(cid:28)(cid:31)(cid:29)(cid:27)(cid:32)(cid:33)(cid:31)(cid:1)(cid:2)(cid:3,Unknown,2724.0
Unknown,Unknown,3,Unknown,Unknown,Unknown,Unknown,cid:16)(cid:17)(cid:16)(cid:27)(cid:28)(cid:1)(cid:29)(cid:30)(cid:28)(cid:28)(cid:31)(cid:29)(cid:27)(cid:32)(cid:33)(cid:31)(cid:1)(cid:2)(cid:3,Unknown,2727.0
Unknown,Unknown,8,Unknown,Unknown,Unknown,Unknown,cid:16)(cid:17)(cid:16)(cid:27)(cid:28)(cid:1)(cid:29)(cid:30)(cid:28)(cid:28)(cid:31)(cid:29)(cid:27)(cid:32)(cid:33)(cid:31)(cid:1)(cid:2)(cid:3,Unknown,2735.0
Unknown,Unknown,28,Unknown,Unknown,Unknown,Unknown,cid:16)(cid:17)(cid:16)(cid:27)(cid:28)(cid:1)(cid:29)(cid:30)(cid:28)(cid:28)(cid:31)(cid:29)(cid:27)(cid:32)(cid:33)(cid:31)(cid:1)(cid:2)(cid:3,Unknown,2763.0
Unknown,Unknown,10,Unknown,Unknown,Unknown,Unknown,cid:16)(cid:17)(cid:16)(cid:27)(cid:28)(cid:1)(cid:29)(cid:30)(cid:28)(cid:28)(cid:31)(cid:29)(cid:27)(cid:32)(cid:33)(cid:31)(cid:1)(cid:2)(cid:3,Unknown,2773.0
Unknown,Unknown,3,Unknown,Unknown,Unknown,Unknown,cid:16)(cid:17)(cid:16)(cid:27)(cid:28)(cid:1)(cid:29)(cid:30)(cid:28)(cid:28)(cid:31)(cid:29)(cid:27)(cid:32)(cid:33)(cid:31)(cid:1)(cid:2)(cid:3,Unknown,2776.0
Unknown,Unknown,6,Unknown,Unknown,Unknown,Unknown,cid:16)(cid:17)(cid:16)(cid:27)(cid:28)(cid:1)(cid:29)(cid:30)(cid:28)(cid:28)(cid:31)(cid:29)(cid:27)(cid:32)(cid:33)(cid:31)(cid:1)(cid:2)(cid:3,Unknown,2782.0
Unknown,Unknown,8,Unknown,Unknown,Unknown,Unknown,cid:16)(cid:17)(cid:16)(cid:27)(cid:28)(cid:1)(cid:29)(cid:30)(cid:28)(cid:28)(cid:31)(cid:29)(cid:27)(cid:32)(cid:33)(cid:31)(cid:1)(cid:2)(cid:3,Unknown,2790.0
Unknown,Unknown,46,Unknown,Unknown,Unknown,Unknown,cid:16)(cid:17)(cid:16)(cid:27)(cid:28)(cid:1)(cid:29)(cid:30)(cid:28)(cid:28)(cid:31)(cid:29)(cid:27)(cid:32)(cid:33)(cid:31)(cid:1)(cid:2)(cid:3,Unknown,2836.0
Unknown,Unknown,46,Unknown,Unknown,Unknown,Unknown,cid:16)(cid:17)(cid:16)(cid:27)(cid:28)(cid:1)(cid:29)(cid:30)(cid:28)(cid:28)(cid:31)(cid:29)(cid:27)(cid:32)(cid:33)(cid:31)(cid:1)(cid:2)(cid:3,Unknown,2882.0
Unknown,Unknown,47,Unknown,Unknown,Unknown,Unknown,cid:16)(cid:17)(cid:16)(cid:27)(cid:28)(cid:1)(cid:29)(cid:30)(cid:28)(cid:28)(cid:31)(cid:29)(cid:27)(cid:32)(cid:33)(cid:31)(cid:1)(cid:2)(cid:3,Unknown,2929.0
Unknown,Unknown,32,Unknown,Unknown,Unknown,Unknown,cid:16)(cid:17)(cid:16)(cid:27)(cid:28)(cid:1)(cid:29)(cid:30)(cid:28)(cid:28)(cid:31)(cid:29)(cid:27)(cid:32)(cid:33)(cid:31)(cid:1)(cid:2)(cid:3,Unknown,2961.0
Unknown,Unknown,48,Unknown,Unknown,Unknown,Unknown,cid:16)(cid:17)(cid:16)(cid:27)(cid:28)(cid:1)(cid:29)(cid:30)(cid:28)(cid:28)(cid:31)(cid:29)(cid:27)(cid:32)(cid:33)(cid:31)(cid:1)(cid:2)(cid:3,Unknown,3009.0
Unknown,Unknown,49,Unknown,Unknown,Unknown,Unknown,cid:16)(cid:17)(cid:16)(cid:27)(cid:28)(cid:1)(cid:29)(cid:30)(cid:28)(cid:28)(cid:31)(cid:29)(cid:27)(cid:32)(cid:33)(cid:31)(cid:1)(cid:2)(cid:3,Unknown,3058.0
Unknown,Unknown,16,Unknown,Unknown,Unknown,Unknown,cid:16)(cid:17)(cid:16)(cid:27)(cid:28)(cid:1)(cid:29)(cid:30)(cid:28)(cid:28)(cid:31)(cid:29)(cid:27)(cid:32)(cid:33)(cid:31)(cid:1)(cid:2)(cid:3,Unknown,3074.0
Unknown,Unknown,17,Unknown,Unknown,Unknown,Unknown,cid:16)(cid:17)(cid:16)(cid:27)(cid:28)(cid:1)(cid:29)(cid:30)(cid:28)(cid:28)(cid:31)(cid:29)(cid:27)(cid:32)(cid:33)(cid:31)(cid:1)(cid:2)(cid:3,Unknown,3091.0
Unknown,Unknown,16,Unknown,Unknown,Unknown,Unknown,cid:16)(cid:17)(cid:16)(cid:27)(cid:28)(cid:1)(cid:29)(cid:30)(cid:28)(cid:28)(cid:31)(cid:29)(cid:27)(cid:32)(cid:33)(cid:31)(cid:1)(cid:2)(cid:3,Unknown,3107.0
Unknown,Unknown,27,Unknown,Unknown,Unknown,Unknown,cid:16)(cid:17)(cid:16)(cid:27)(cid:28)(cid:1)(cid:29)(cid:30)(cid:28)(cid:28)(cid:31)(cid:29)(cid:27)(cid:32)(cid:33)(cid:31)(cid:1)(cid:2)(cid:3,Unknown,3134.0
Unknown,Unknown,28,Unknown,Unknown,Unknown,Unknown,cid:16)(cid:17)(cid:16)(cid:27)(cid:28)(cid:1)(cid:29)(cid:30)(cid:28)(cid:28)(cid:31)(cid:29)(cid:27)(cid:32)(cid:33)(cid:31)(cid:1)(cid:2)(cid:3,Unknown,3162.0
Unknown,Unknown,1,Unknown,Unknown,Unknown,Unknown,cid:16)(cid:17)(cid:16)(cid:27)(cid:28)(cid:1)(cid:29)(cid:30)(cid:28)(cid:28)(cid:31)(cid:29)(cid:27)(cid:32)(cid:33)(cid:31)(cid:1)(cid:2)(cid:3,Unknown,3163.0
Unknown,Unknown,35,Unknown,Unknown,Unknown,Unknown,cid:16)(cid:17)(cid:16)(cid:27)(cid:28)(cid:1)(cid:29)(cid:30)(cid:28)(cid:28)(cid:31)(cid:29)(cid:27)(cid:32)(cid:33)(cid:31)(cid:1)(cid:2)(cid:3,Unknown,3198.0
Unknown,Unknown,17,Unknown,Unknown,Unknown,Unknown,cid:16)(cid:17)(cid:16)(cid:27)(cid:28)(cid:1)(cid:29)(cid:30)(cid:28)(cid:28)(cid:31)(cid:29)(cid:27)(cid:32)(cid:33)(cid:31)(cid:1)(cid:2)(cid:3,Unknown,3215.0
Unknown,Unknown,32,Unknown,Unknown,Unknown,Unknown,cid:16)(cid:17)(cid:16)(cid:27)(cid:28)(cid:1)(cid:29)(cid:30)(cid:28)(cid:28)(cid:31)(cid:29)(cid:27)(cid:32)(cid:33)(cid:31)(cid:1)(cid:2)(cid:3,Unknown,3247.0
Unknown,Unknown,28,Unknown,Unknown,Unknown,Unknown,cid:16)(cid:17)(cid:16)(cid:27)(cid:28)(cid:1)(cid:29)(cid:30)(cid:28)(cid:28)(cid:31)(cid:29)(cid:27)(cid:32)(cid:33)(cid:31)(cid:1)(cid:2)(cid:3,Unknown,3275.0
Unknown,Unknown,17,Unknown,Unknown,Unknown,Unknown,cid:16)(cid:17)(cid:16)(cid:27)(cid:28)(cid:1)(cid:29)(cid:30)(cid:28)(cid:28)(cid:31)(cid:29)(cid:27)(cid:32)(cid:33)(cid:31)(cid:1)(cid:2)(cid:3,Unknown,3292.0
Unknown,Unknown,34,Unknown,Unknown,Unknown,Unknown,cid:16)(cid:17)(cid:16)(cid:27)(cid:28)(cid:1)(cid:29)(cid:30)(cid:28)(cid:28)(cid:31)(cid:29)(cid:27)(cid:32)(cid:33)(cid:31)(cid:1)(cid:2)(cid:3,Unknown,3326.0
Unknown,Unknown,34,Unknown,Unknown,Unknown,Unknown,cid:16)(cid:17)(cid:16)(cid:27)(cid:28)(cid:1)(cid:29)(cid:30)(cid:28)(cid:28)(cid:31)(cid:29)(cid:27)(cid:32)(cid:33)(cid:31)(cid:1)(cid:2)(cid:3,Unknown,3360.0
Unknown,Unknown,30,Unknown,Unknown,Unknown,Unknown,cid:16)(cid:17)(cid:16)(cid:27)(cid:28)(cid:1)(cid:29)(cid:30)(cid:28)(cid:28)(cid:31)(cid:29)(cid:27)(cid:32)(cid:33)(cid:31)(cid:1)(cid:2)(cid:3,Unknown,3390.0
Unknown,Unknown,31,Unknown,Unknown,Unknown,Unknown,cid:16)(cid:17)(cid:16)(cid:27)(cid:28)(cid:1)(cid:29)(cid:30)(cid:28)(cid:28)(cid:31)(cid:29)(cid:27)(cid:32)(cid:33)(cid:31)(cid:1)(cid:2)(cid:3,Unknown,3421.0
Unknown,Unknown,3,Unknown,Unknown,Unknown,Unknown,cid:16)(cid:17)(cid:16)(cid:27)(cid:28)(cid:1)(cid:29)(cid:30)(cid:28)(cid:28)(cid:31)(cid:29)(cid:27)(cid:32)(cid:33)(cid:31)(cid:1)(cid:2)(cid:3,Unknown,3424.0
Unknown,Unknown,36,Unknown,Unknown,Unknown,Unknown,cid:16)(cid:17)(cid:16)(cid:27)(cid:28)(cid:1)(cid:29)(cid:30)(cid:28)(cid:28)(cid:31)(cid:29)(cid:27)(cid:32)(cid:33)(cid:31)(cid:1)(cid:2)(cid:3,Unknown,3460.0
Unknown,Unknown,1,Unknown,Unknown,Unknown,Unknown,cid:16)(cid:17)(cid:16)(cid:27)(cid:28)(cid:1)(cid:29)(cid:30)(cid:28)(cid:28)(cid:31)(cid:29)(cid:27)(cid:32)(cid:33)(cid:31)(cid:1)(cid:2)(cid:3,Unknown,3461.0
Unknown,Unknown,2,Unknown,Unknown,Unknown,Unknown,cid:16)(cid:17)(cid:16)(cid:27)(cid:28)(cid:1)(cid:29)(cid:30)(cid:28)(cid:28)(cid:31)(cid:29)(cid:27)(cid:32)(cid:33)(cid:31)(cid:1)(cid:2)(cid:3,Unknown,3463.0
Unknown,Unknown,3,Unknown,Unknown,Unknown,Unknown,cid:16)(cid:17)(cid:16)(cid:27)(cid:28)(cid:1)(cid:29)(cid:30)(cid:28)(cid:28)(cid:31)(cid:29)(cid:27)(cid:32)(cid:33)(cid:31)(cid:1)(cid:2)(cid:3,Unknown,3466.0
Unknown,Unknown,10,Unknown,Unknown,Unknown,Unknown,cid:16)(cid:17)(cid:16)(cid:27)(cid:28)(cid:1)(cid:29)(cid:30)(cid:28)(cid:28)(cid:31)(cid:29)(cid:27)(cid:32)(cid:33)(cid:31)(cid:1)(cid:2)(cid:3,Unknown,3476.0
Unknown,Unknown,11,Unknown,Unknown,Unknown,Unknown,cid:16)(cid:17)(cid:16)(cid:27)(cid:28)(cid:1)(cid:29)(cid:30)(cid:28)(cid:28)(cid:31)(cid:29)(cid:27)(cid:32)(cid:33)(cid:31)(cid:1)(cid:2)(cid:3,Unknown,3487.0
Unknown,Unknown,20,Unknown,Unknown,Unknown,Unknown,cid:16)(cid:17)(cid:16)(cid:27)(cid:28)(cid:1)(cid:29)(cid:30)(cid:28)(cid:28)(cid:31)(cid:29)(cid:27)(cid:32)(cid:33)(cid:31)(cid:1)(cid:2)(cid:3,Unknown,3507.0
Unknown,Unknown,10,Unknown,Unknown,Unknown,Unknown,cid:16)(cid:17)(cid:16)(cid:27)(cid:28)(cid:1)(cid:29)(cid:30)(cid:28)(cid:28)(cid:31)(cid:29)(cid:27)(cid:32)(cid:33)(cid:31)(cid:1)(cid:2)(cid:3,Unknown,3517.0
Unknown,Unknown,11,Unknown,Unknown,Unknown,Unknown,cid:16)(cid:17)(cid:16)(cid:27)(cid:28)(cid:1)(cid:29)(cid:30)(cid:28)(cid:28)(cid:31)(cid:29)(cid:27)(cid:32)(cid:33)(cid:31)(cid:1)(cid:2)(cid:3,Unknown,3528.0
Unknown,Unknown,24,Unknown,Unknown,Unknown,Unknown,cid:16)(cid:17)(cid:16)(cid:27)(cid:28)(cid:1)(cid:29)(cid:30)(cid:28)(cid:28)(cid:31)(cid:29)(cid:27)(cid:32)(cid:33)(cid:31)(cid:1)(cid:2)(cid:3,Unknown,3552.0
Unknown,Unknown,1,Unknown,Unknown,Unknown,Unknown,cid:16)(cid:17)(cid:16)(cid:27)(cid:28)(cid:1)(cid:29)(cid:30)(cid:28)(cid:28)(cid:31)(cid:29)(cid:27)(cid:32)(cid:33)(cid:31)(cid:1)(cid:2)(cid:3,Unknown,3553.0
Unknown,Unknown,13,Unknown,Unknown,Unknown,Unknown,cid:16)(cid:17)(cid:16)(cid:27)(cid:28)(cid:1)(cid:29)(cid:30)(cid:28)(cid:28)(cid:31)(cid:29)(cid:27)(cid:32)(cid:33)(cid:31)(cid:1)(cid:2)(cid:3,Unknown,3566.0
Unknown,Unknown,10,Unknown,Unknown,Unknown,Unknown,cid:16)(cid:17)(cid:16)(cid:27)(cid:28)(cid:1)(cid:29)(cid:30)(cid:28)(cid:28)(cid:31)(cid:29)(cid:27)(cid:32)(cid:33)(cid:31)(cid:1)(cid:2)(cid:3,Unknown,3576.0
Unknown,Unknown,25,Unknown,Unknown,Unknown,Unknown,cid:16)(cid:17)(cid:16)(cid:27)(cid:28)(cid:1)(cid:29)(cid:30)(cid:28)(cid:28)(cid:31)(cid:29)(cid:27)(cid:32)(cid:33)(cid:31)(cid:1)(cid:2)(cid:3,Unknown,3601.0
Unknown,Unknown,10,Unknown,Unknown,Unknown,Unknown,cid:16)(cid:17)(cid:16)(cid:27)(cid:28)(cid:1)(cid:29)(cid:30)(cid:28)(cid:28)(cid:31)(cid:29)(cid:27)(cid:32)(cid:33)(cid:31)(cid:1)(cid:2)(cid:3,Unknown,3611.0
Unknown,Unknown,13,Unknown,Unknown,Unknown,Unknown,cid:16)(cid:17)(cid:16)(cid:27)(cid:28)(cid:1)(cid:29)(cid:30)(cid:28)(cid:28)(cid:31)(cid:29)(cid:27)(cid:32)(cid:33)(cid:31)(cid:1)(cid:2)(cid:3,Unknown,3624.0
Unknown,Unknown,1,Unknown,Unknown,Unknown,Unknown,cid:16)(cid:17)(cid:16)(cid:27)(cid:28)(cid:1)(cid:29)(cid:30)(cid:28)(cid:28)(cid:31)(cid:29)(cid:27)(cid:32)(cid:33)(cid:31)(cid:1)(cid:2)(cid:3,Unknown,3625.0
Unknown,Unknown,26,Unknown,Unknown,Unknown,Unknown,cid:16)(cid:17)(cid:16)(cid:27)(cid:28)(cid:1)(cid:29)(cid:30)(cid:28)(cid:28)(cid:31)(cid:29)(cid:27)(cid:32)(cid:33)(cid:31)(cid:1)(cid:2)(cid:3,Unknown,3651.0
Unknown,Unknown,45,Unknown,Unknown,Unknown,Unknown,cid:16)(cid:17)(cid:16)(cid:27)(cid:28)(cid:1)(cid:29)(cid:30)(cid:28)(cid:28)(cid:31)(cid:29)(cid:27)(cid:32)(cid:33)(cid:31)(cid:1)(cid:2)(cid:3,Unknown,3696.0
Unknown,Unknown,10,Unknown,Unknown,Unknown,Unknown,cid:16)(cid:17)(cid:16)(cid:27)(cid:28)(cid:1)(cid:29)(cid:30)(cid:28)(cid:28)(cid:31)(cid:29)(cid:27)(cid:32)(cid:33)(cid:31)(cid:1)(cid:2)(cid:3,Unknown,3706.0
Unknown,Unknown,19,Unknown,Unknown,Unknown,Unknown,cid:16)(cid:17)(cid:16)(cid:27)(cid:28)(cid:1)(cid:29)(cid:30)(cid:28)(cid:28)(cid:31)(cid:29)(cid:27)(cid:32)(cid:33)(cid:31)(cid:1)(cid:2)(cid:3,Unknown,3725.0
Unknown,Unknown,16,Unknown,Unknown,Unknown,Unknown,cid:16)(cid:17)(cid:16)(cid:27)(cid:28)(cid:1)(cid:29)(cid:30)(cid:28)(cid:28)(cid:31)(cid:29)(cid:27)(cid:32)(cid:33)(cid:31)(cid:1)(cid:2)(cid:3,Unknown,3741.0
Unknown,Unknown,7,Unknown,Unknown,Unknown,Unknown,cid:16)(cid:17)(cid:16)(cid:27)(cid:28)(cid:1)(cid:29)(cid:30)(cid:28)(cid:28)(cid:31)(cid:29)(cid:27)(cid:32)(cid:33)(cid:31)(cid:1)(cid:2)(cid:3,Unknown,3748.0
Unknown,Unknown,3,Unknown,Unknown,Unknown,Unknown,cid:16)(cid:17)(cid:16)(cid:27)(cid:28)(cid:1)(cid:29)(cid:30)(cid:28)(cid:28)(cid:31)(cid:29)(cid:27)(cid:32)(cid:33)(cid:31)(cid:1)(cid:2)(cid:3,Unknown,3751.0
Unknown,Unknown,8,Unknown,Unknown,Unknown,Unknown,cid:16)(cid:17)(cid:16)(cid:27)(cid:28)(cid:1)(cid:29)(cid:30)(cid:28)(cid:28)(cid:31)(cid:29)(cid:27)(cid:32)(cid:33)(cid:31)(cid:1)(cid:2)(cid:3,Unknown,3759.0
Unknown,Unknown,28,Unknown,Unknown,Unknown,Unknown,cid:16)(cid:17)(cid:16)(cid:27)(cid:28)(cid:1)(cid:29)(cid:30)(cid:28)(cid:28)(cid:31)(cid:29)(cid:27)(cid:32)(cid:33)(cid:31)(cid:1)(cid:2)(cid:3,Unknown,3787.0
Unknown,Unknown,10,Unknown,Unknown,Unknown,Unknown,cid:16)(cid:17)(cid:16)(cid:27)(cid:28)(cid:1)(cid:29)(cid:30)(cid:28)(cid:28)(cid:31)(cid:29)(cid:27)(cid:32)(cid:33)(cid:31)(cid:1)(cid:2)(cid:3,Unknown,3797.0
Unknown,Unknown,3,Unknown,Unknown,Unknown,Unknown,cid:16)(cid:17)(cid:16)(cid:27)(cid:28)(cid:1)(cid:29)(cid:30)(cid:28)(cid:28)(cid:31)(cid:29)(cid:27)(cid:32)(cid:33)(cid:31)(cid:1)(cid:2)(cid:3,Unknown,3800.0
Unknown,Unknown,6,Unknown,Unknown,Unknown,Unknown,cid:16)(cid:17)(cid:16)(cid:27)(cid:28)(cid:1)(cid:29)(cid:30)(cid:28)(cid:28)(cid:31)(cid:29)(cid:27)(cid:32)(cid:33)(cid:31)(cid:1)(cid:2)(cid:3,Unknown,3806.0
Unknown,Unknown,8,Unknown,Unknown,Unknown,Unknown,cid:16)(cid:17)(cid:16)(cid:27)(cid:28)(cid:1)(cid:29)(cid:30)(cid:28)(cid:28)(cid:31)(cid:29)(cid:27)(cid:32)(cid:33)(cid:31)(cid:1)(cid:2)(cid:3,Unknown,3814.0
Unknown,Unknown,46,Unknown,Unknown,Unknown,Unknown,cid:16)(cid:17)(cid:16)(cid:27)(cid:28)(cid:1)(cid:29)(cid:30)(cid:28)(cid:28)(cid:31)(cid:29)(cid:27)(cid:32)(cid:33)(cid:31)(cid:1)(cid:2)(cid:3,Unknown,3860.0
Unknown,Unknown,46,Unknown,Unknown,Unknown,Unknown,cid:16)(cid:17)(cid:16)(cid:27)(cid:28)(cid:1)(cid:29)(cid:30)(cid:28)(cid:28)(cid:31)(cid:29)(cid:27)(cid:32)(cid:33)(cid:31)(cid:1)(cid:2)(cid:3,Unknown,3906.0
Unknown,Unknown,47,Unknown,Unknown,Unknown,Unknown,cid:16)(cid:17)(cid:16)(cid:27)(cid:28)(cid:1)(cid:29)(cid:30)(cid:28)(cid:28)(cid:31)(cid:29)(cid:27)(cid:32)(cid:33)(cid:31)(cid:1)(cid:2)(cid:3,Unknown,3953.0
Unknown,Unknown,32,Unknown,Unknown,Unknown,Unknown,cid:16)(cid:17)(cid:16)(cid:27)(cid:28)(cid:1)(cid:29)(cid:30)(cid:28)(cid:28)(cid:31)(cid:29)(cid:27)(cid:32)(cid:33)(cid:31)(cid:1)(cid:2)(cid:3,Unknown,3985.0
Unknown,Unknown,48,Unknown,Unknown,Unknown,Unknown,cid:16)(cid:17)(cid:16)(cid:27)(cid:28)(cid:1)(cid:29)(cid:30)(cid:28)(cid:28)(cid:31)(cid:29)(cid:27)(cid:32)(cid:33)(cid:31)(cid:1)(cid:2)(cid:3,Unknown,4033.0
Unknown,Unknown,49,Unknown,Unknown,Unknown,Unknown,cid:16)(cid:17)(cid:16)(cid:27)(cid:28)(cid:1)(cid:29)(cid:30)(cid:28)(cid:28)(cid:31)(cid:29)(cid:27)(cid:32)(cid:33)(cid:31)(cid:1)(cid:2)(cid:3,Unknown,4082.0
Unknown,Unknown,16,Unknown,Unknown,Unknown,Unknown,cid:16)(cid:17)(cid:16)(cid:27)(cid:28)(cid:1)(cid:29)(cid:30)(cid:28)(cid:28)(cid:31)(cid:29)(cid:27)(cid:32)(cid:33)(cid:31)(cid:1)(cid:2)(cid:3,Unknown,4098.0
Unknown,Unknown,17,Unknown,Unknown,Unknown,Unknown,cid:16)(cid:17)(cid:16)(cid:27)(cid:28)(cid:1)(cid:29)(cid:30)(cid:28)(cid:28)(cid:31)(cid:29)(cid:27)(cid:32)(cid:33)(cid:31)(cid:1)(cid:2)(cid:3,Unknown,4115.0
Unknown,Unknown,16,Unknown,Unknown,Unknown,Unknown,cid:16)(cid:17)(cid:16)(cid:27)(cid:28)(cid:1)(cid:29)(cid:30)(cid:28)(cid:28)(cid:31)(cid:29)(cid:27)(cid:32)(cid:33)(cid:31)(cid:1)(cid:2)(cid:3,Unknown,4131.0
Unknown,Unknown,27,Unknown,Unknown,Unknown,Unknown,cid:16)(cid:17)(cid:16)(cid:27)(cid:28)(cid:1)(cid:29)(cid:30)(cid:28)(cid:28)(cid:31)(cid:29)(cid:27)(cid:32)(cid:33)(cid:31)(cid:1)(cid:2)(cid:3,Unknown,4158.0
Unknown,Unknown,28,Unknown,Unknown,Unknown,Unknown,cid:16)(cid:17)(cid:16)(cid:27)(cid:28)(cid:1)(cid:29)(cid:30)(cid:28)(cid:28)(cid:31)(cid:29)(cid:27)(cid:32)(cid:33)(cid:31)(cid:1)(cid:2)(cid:3,Unknown,4186.0
Unknown,Unknown,1,Unknown,Unknown,Unknown,Unknown,cid:16)(cid:17)(cid:16)(cid:27)(cid:28)(cid:1)(cid:29)(cid:30)(cid:28)(cid:28)(cid:31)(cid:29)(cid:27)(cid:32)(cid:33)(cid:31)(cid:1)(cid:2)(cid:3,Unknown,4187.0
Unknown,Unknown,35,Unknown,Unknown,Unknown,Unknown,cid:16)(cid:17)(cid:16)(cid:27)(cid:28)(cid:1)(cid:29)(cid:30)(cid:28)(cid:28)(cid:31)(cid:29)(cid:27)(cid:32)(cid:33)(cid:31)(cid:1)(cid:2)(cid:3,Unknown,4222.0
Unknown,Unknown,17,Unknown,Unknown,Unknown,Unknown,cid:16)(cid:17)(cid:16)(cid:27)(cid:28)(cid:1)(cid:29)(cid:30)(cid:28)(cid:28)(cid:31)(cid:29)(cid:27)(cid:32)(cid:33)(cid:31)(cid:1)(cid:2)(cid:3,Unknown,4239.0
Unknown,Unknown,32,Unknown,Unknown,Unknown,Unknown,cid:16)(cid:17)(cid:16)(cid:27)(cid:28)(cid:1)(cid:29)(cid:30)(cid:28)(cid:28)(cid:31)(cid:29)(cid:27)(cid:32)(cid:33)(cid:31)(cid:1)(cid:2)(cid:3,Unknown,4271.0
Unknown,Unknown,28,Unknown,Unknown,Unknown,Unknown,cid:16)(cid:17)(cid:16)(cid:27)(cid:28)(cid:1)(cid:29)(cid:30)(cid:28)(cid:28)(cid:31)(cid:29)(cid:27)(cid:32)(cid:33)(cid:31)(cid:1)(cid:2)(cid:3,Unknown,4299.0
Unknown,Unknown,17,Unknown,Unknown,Unknown,Unknown,cid:16)(cid:17)(cid:16)(cid:27)(cid:28)(cid:1)(cid:29)(cid:30)(cid:28)(cid:28)(cid:31)(cid:29)(cid:27)(cid:32)(cid:33)(cid:31)(cid:1)(cid:2)(cid:3,Unknown,4316.0
Unknown,Unknown,34,Unknown,Unknown,Unknown,Unknown,cid:16)(cid:17)(cid:16)(cid:27)(cid:28)(cid:1)(cid:29)(cid:30)(cid:28)(cid:28)(cid:31)(cid:29)(cid:27)(cid:32)(cid:33)(cid:31)(cid:1)(cid:2)(cid:3,Unknown,4350.0
Unknown,Unknown,34,Unknown,Unknown,Unknown,Unknown,cid:16)(cid:17)(cid:16)(cid:27)(cid:28)(cid:1)(cid:29)(cid:30)(cid:28)(cid:28)(cid:31)(cid:29)(cid:27)(cid:32)(cid:33)(cid:31)(cid:1)(cid:2)(cid:3,Unknown,4384.0
Unknown,Unknown,30,Unknown,Unknown,Unknown,Unknown,cid:16)(cid:17)(cid:16)(cid:27)(cid:28)(cid:1)(cid:29)(cid:30)(cid:28)(cid:28)(cid:31)(cid:29)(cid:27)(cid:32)(cid:33)(cid:31)(cid:1)(cid:2)(cid:3,Unknown,4414.0
Unknown,Unknown,31,Unknown,Unknown,Unknown,Unknown,cid:16)(cid:17)(cid:16)(cid:27)(cid:28)(cid:1)(cid:29)(cid:30)(cid:28)(cid:28)(cid:31)(cid:29)(cid:27)(cid:32)(cid:33)(cid:31)(cid:1)(cid:2)(cid:3,Unknown,4445.0
Unknown,Unknown,3,Unknown,Unknown,Unknown,Unknown,cid:16)(cid:17)(cid:16)(cid:27)(cid:28)(cid:1)(cid:29)(cid:30)(cid:28)(cid:28)(cid:31)(cid:29)(cid:27)(cid:32)(cid:33)(cid:31)(cid:1)(cid:2)(cid:3,Unknown,4448.0
Unknown,Unknown,36,Unknown,Unknown,Unknown,Unknown,cid:16)(cid:17)(cid:16)(cid:27)(cid:28)(cid:1)(cid:29)(cid:30)(cid:28)(cid:28)(cid:31)(cid:29)(cid:27)(cid:32)(cid:33)(cid:31)(cid:1)(cid:2)(cid:3,Unknown,4484.0
Unknown,Unknown,1,Unknown,Unknown,Unknown,Unknown,cid:16)(cid:17)(cid:16)(cid:27)(cid:28)(cid:1)(cid:29)(cid:30)(cid:28)(cid:28)(cid:31)(cid:29)(cid:27)(cid:32)(cid:33)(cid:31)(cid:1)(cid:2)(cid:3,Unknown,4485.0
Unknown,Unknown,2,Unknown,Unknown,Unknown,Unknown,cid:16)(cid:17)(cid:16)(cid:27)(cid:28)(cid:1)(cid:29)(cid:30)(cid:28)(cid:28)(cid:31)(cid:29)(cid:27)(cid:32)(cid:33)(cid:31)(cid:1)(cid:2)(cid:3,Unknown,4487.0
Unknown,Unknown,3,Unknown,Unknown,Unknown,Unknown,cid:16)(cid:17)(cid:16)(cid:27)(cid:28)(cid:1)(cid:29)(cid:30)(cid:28)(cid:28)(cid:31)(cid:29)(cid:27)(cid:32)(cid:33)(cid:31)(cid:1)(cid:2)(cid:3,Unknown,4490.0
Unknown,Unknown,10,Unknown,Unknown,Unknown,Unknown,cid:16)(cid:17)(cid:16)(cid:27)(cid:28)(cid:1)(cid:29)(cid:30)(cid:28)(cid:28)(cid:31)(cid:29)(cid:27)(cid:32)(cid:33)(cid:31)(cid:1)(cid:2)(cid:3,Unknown,4500.0
Unknown,Unknown,11,Unknown,Unknown,Unknown,Unknown,cid:16)(cid:17)(cid:16)(cid:27)(cid:28)(cid:1)(cid:29)(cid:30)(cid:28)(cid:28)(cid:31)(cid:29)(cid:27)(cid:32)(cid:33)(cid:31)(cid:1)(cid:2)(cid:3,Unknown,4511.0
Unknown,Unknown,20,Unknown,Unknown,Unknown,Unknown,cid:16)(cid:17)(cid:16)(cid:27)(cid:28)(cid:1)(cid:29)(cid:30)(cid:28)(cid:28)(cid:31)(cid:29)(cid:27)(cid:32)(cid:33)(cid:31)(cid:1)(cid:2)(cid:3,Unknown,4531.0
Unknown,Unknown,10,Unknown,Unknown,Unknown,Unknown,cid:16)(cid:17)(cid:16)(cid:27)(cid:28)(cid:1)(cid:29)(cid:30)(cid:28)(cid:28)(cid:31)(cid:29)(cid:27)(cid:32)(cid:33)(cid:31)(cid:1)(cid:2)(cid:3,Unknown,4541.0
Unknown,Unknown,11,Unknown,Unknown,Unknown,Unknown,cid:16)(cid:17)(cid:16)(cid:27)(cid:28)(cid:1)(cid:29)(cid:30)(cid:28)(cid:28)(cid:31)(cid:29)(cid:27)(cid:32)(cid:33)(cid:31)(cid:1)(cid:2)(cid:3,Unknown,4552.0
Unknown,Unknown,24,Unknown,Unknown,Unknown,Unknown,cid:16)(cid:17)(cid:16)(cid:27)(cid:28)(cid:1)(cid:29)(cid:30)(cid:28)(cid:28)(cid:31)(cid:29)(cid:27)(cid:32)(cid:33)(cid:31)(cid:1)(cid:2)(cid:3,Unknown,4576.0
Unknown,Unknown,1,Unknown,Unknown,Unknown,Unknown,cid:16)(cid:17)(cid:16)(cid:27)(cid:28)(cid:1)(cid:29)(cid:30)(cid:28)(cid:28)(cid:31)(cid:29)(cid:27)(cid:32)(cid:33)(cid:31)(cid:1)(cid:2)(cid:3,Unknown,4577.0
Unknown,Unknown,4,Unknown,Unknown,Unknown,Unknown,cid:16)(cid:17)(cid:16)(cid:27)(cid:28)(cid:1)(cid:29)(cid:30)(cid:28)(cid:28)(cid:31)(cid:29)(cid:27)(cid:32)(cid:33)(cid:31)(cid:1)(cid:2)(cid:3,Unknown,4581.0
Unknown,Unknown,11,Unknown,Unknown,Unknown,Unknown,cid:16)(cid:17)(cid:16)(cid:27)(cid:28)(cid:1)(cid:29)(cid:30)(cid:28)(cid:28)(cid:31)(cid:29)(cid:27)(cid:32)(cid:33)(cid:31)(cid:1)(cid:2)(cid:3,Unknown,4592.0
Unknown,Unknown,25,Unknown,Unknown,Unknown,Unknown,cid:16)(cid:17)(cid:16)(cid:27)(cid:28)(cid:1)(cid:29)(cid:30)(cid:28)(cid:28)(cid:31)(cid:29)(cid:27)(cid:32)(cid:33)(cid:31)(cid:1)(cid:2)(cid:3,Unknown,4617.0
Unknown,Unknown,10,Unknown,Unknown,Unknown,Unknown,cid:16)(cid:17)(cid:16)(cid:27)(cid:28)(cid:1)(cid:29)(cid:30)(cid:28)(cid:28)(cid:31)(cid:29)(cid:27)(cid:32)(cid:33)(cid:31)(cid:1)(cid:2)(cid:3,Unknown,4627.0
Unknown,Unknown,10,Unknown,Unknown,Unknown,Unknown,cid:16)(cid:17)(cid:16)(cid:27)(cid:28)(cid:1)(cid:29)(cid:30)(cid:28)(cid:28)(cid:31)(cid:29)(cid:27)(cid:32)(cid:33)(cid:31)(cid:1)(cid:2)(cid:3,Unknown,4637.0
Unknown,Unknown,1,Unknown,Unknown,Unknown,Unknown,cid:16)(cid:17)(cid:16)(cid:27)(cid:28)(cid:1)(cid:29)(cid:30)(cid:28)(cid:28)(cid:31)(cid:29)(cid:27)(cid:32)(cid:33)(cid:31)(cid:1)(cid:2)(cid:3,Unknown,4638.0
Unknown,Unknown,26,Unknown,Unknown,Unknown,Unknown,cid:16)(cid:17)(cid:16)(cid:27)(cid:28)(cid:1)(cid:29)(cid:30)(cid:28)(cid:28)(cid:31)(cid:29)(cid:27)(cid:32)(cid:33)(cid:31)(cid:1)(cid:2)(cid:3,Unknown,4664.0
Unknown,Unknown,45,Unknown,Unknown,Unknown,Unknown,cid:16)(cid:17)(cid:16)(cid:27)(cid:28)(cid:1)(cid:29)(cid:30)(cid:28)(cid:28)(cid:31)(cid:29)(cid:27)(cid:32)(cid:33)(cid:31)(cid:1)(cid:2)(cid:3,Unknown,4709.0
Unknown,Unknown,10,Unknown,Unknown,Unknown,Unknown,cid:16)(cid:17)(cid:16)(cid:27)(cid:28)(cid:1)(cid:29)(cid:30)(cid:28)(cid:28)(cid:31)(cid:29)(cid:27)(cid:32)(cid:33)(cid:31)(cid:1)(cid:2)(cid:3,Unknown,4719.0
Unknown,Unknown,19,Unknown,Unknown,Unknown,Unknown,cid:16)(cid:17)(cid:16)(cid:27)(cid:28)(cid:1)(cid:29)(cid:30)(cid:28)(cid:28)(cid:31)(cid:29)(cid:27)(cid:32)(cid:33)(cid:31)(cid:1)(cid:2)(cid:3,Unknown,4738.0
Unknown,Unknown,16,Unknown,Unknown,Unknown,Unknown,cid:16)(cid:17)(cid:16)(cid:27)(cid:28)(cid:1)(cid:29)(cid:30)(cid:28)(cid:28)(cid:31)(cid:29)(cid:27)(cid:32)(cid:33)(cid:31)(cid:1)(cid:2)(cid:3,Unknown,4754.0
Unknown,Unknown,7,Unknown,Unknown,Unknown,Unknown,cid:16)(cid:17)(cid:16)(cid:27)(cid:28)(cid:1)(cid:29)(cid:30)(cid:28)(cid:28)(cid:31)(cid:29)(cid:27)(cid:32)(cid:33)(cid:31)(cid:1)(cid:2)(cid:3,Unknown,4761.0
Unknown,Unknown,3,Unknown,Unknown,Unknown,Unknown,cid:16)(cid:17)(cid:16)(cid:27)(cid:28)(cid:1)(cid:29)(cid:30)(cid:28)(cid:28)(cid:31)(cid:29)(cid:27)(cid:32)(cid:33)(cid:31)(cid:1)(cid:2)(cid:3,Unknown,4764.0
Unknown,Unknown,8,Unknown,Unknown,Unknown,Unknown,cid:16)(cid:17)(cid:16)(cid:27)(cid:28)(cid:1)(cid:29)(cid:30)(cid:28)(cid:28)(cid:31)(cid:29)(cid:27)(cid:32)(cid:33)(cid:31)(cid:1)(cid:2)(cid:3,Unknown,4772.0
Unknown,Unknown,28,Unknown,Unknown,Unknown,Unknown,cid:16)(cid:17)(cid:16)(cid:27)(cid:28)(cid:1)(cid:29)(cid:30)(cid:28)(cid:28)(cid:31)(cid:29)(cid:27)(cid:32)(cid:33)(cid:31)(cid:1)(cid:2)(cid:3,Unknown,4800.0
Unknown,Unknown,10,Unknown,Unknown,Unknown,Unknown,cid:16)(cid:17)(cid:16)(cid:27)(cid:28)(cid:1)(cid:29)(cid:30)(cid:28)(cid:28)(cid:31)(cid:29)(cid:27)(cid:32)(cid:33)(cid:31)(cid:1)(cid:2)(cid:3,Unknown,4810.0
Unknown,Unknown,3,Unknown,Unknown,Unknown,Unknown,cid:16)(cid:17)(cid:16)(cid:27)(cid:28)(cid:1)(cid:29)(cid:30)(cid:28)(cid:28)(cid:31)(cid:29)(cid:27)(cid:32)(cid:33)(cid:31)(cid:1)(cid:2)(cid:3,Unknown,4813.0
Unknown,Unknown,6,Unknown,Unknown,Unknown,Unknown,cid:16)(cid:17)(cid:16)(cid:27)(cid:28)(cid:1)(cid:29)(cid:30)(cid:28)(cid:28)(cid:31)(cid:29)(cid:27)(cid:32)(cid:33)(cid:31)(cid:1)(cid:2)(cid:3,Unknown,4819.0
Unknown,Unknown,8,Unknown,Unknown,Unknown,Unknown,cid:16)(cid:17)(cid:16)(cid:27)(cid:28)(cid:1)(cid:29)(cid:30)(cid:28)(cid:28)(cid:31)(cid:29)(cid:27)(cid:32)(cid:33)(cid:31)(cid:1)(cid:2)(cid:3,Unknown,4827.0
Unknown,Unknown,46,Unknown,Unknown,Unknown,Unknown,cid:16)(cid:17)(cid:16)(cid:27)(cid:28)(cid:1)(cid:29)(cid:30)(cid:28)(cid:28)(cid:31)(cid:29)(cid:27)(cid:32)(cid:33)(cid:31)(cid:1)(cid:2)(cid:3,Unknown,4873.0
Unknown,Unknown,46,Unknown,Unknown,Unknown,Unknown,cid:16)(cid:17)(cid:16)(cid:27)(cid:28)(cid:1)(cid:29)(cid:30)(cid:28)(cid:28)(cid:31)(cid:29)(cid:27)(cid:32)(cid:33)(cid:31)(cid:1)(cid:2)(cid:3,Unknown,4919.0
Unknown,Unknown,47,Unknown,Unknown,Unknown,Unknown,cid:16)(cid:17)(cid:16)(cid:27)(cid:28)(cid:1)(cid:29)(cid:30)(cid:28)(cid:28)(cid:31)(cid:29)(cid:27)(cid:32)(cid:33)(cid:31)(cid:1)(cid:2)(cid:3,Unknown,4966.0
Unknown,Unknown,32,Unknown,Unknown,Unknown,Unknown,cid:16)(cid:17)(cid:16)(cid:27)(cid:28)(cid:1)(cid:29)(cid:30)(cid:28)(cid:28)(cid:31)(cid:29)(cid:27)(cid:32)(cid:33)(cid:31)(cid:1)(cid:2)(cid:3,Unknown,4998.0
Unknown,Unknown,48,Unknown,Unknown,Unknown,Unknown,cid:16)(cid:17)(cid:16)(cid:27)(cid:28)(cid:1)(cid:29)(cid:30)(cid:28)(cid:28)(cid:31)(cid:29)(cid:27)(cid:32)(cid:33)(cid:31)(cid:1)(cid:2)(cid:3,Unknown,5046.0
Unknown,Unknown,49,Unknown,Unknown,Unknown,Unknown,cid:16)(cid:17)(cid:16)(cid:27)(cid:28)(cid:1)(cid:29)(cid:30)(cid:28)(cid:28)(cid:31)(cid:29)(cid:27)(cid:32)(cid:33)(cid:31)(cid:1)(cid:2)(cid:3,Unknown,5095.0
Unknown,Unknown,36,Unknown,Unknown,Unknown,Unknown,cid:16)(cid:17)(cid:16)(cid:27)(cid:28)(cid:1)(cid:29)(cid:30)(cid:28)(cid:28)(cid:31)(cid:29)(cid:27)(cid:32)(cid:33)(cid:31)(cid:1)(cid:2)(cid:3,Unknown,5131.0
Unknown,Unknown,27,Unknown,Unknown,Unknown,Unknown,cid:16)(cid:17)(cid:16)(cid:27)(cid:28)(cid:1)(cid:29)(cid:30)(cid:28)(cid:28)(cid:31)(cid:29)(cid:27)(cid:32)(cid:33)(cid:31)(cid:1)(cid:2)(cid:3,Unknown,5158.0
Unknown,Unknown,15,Unknown,Unknown,Unknown,Unknown,cid:16)(cid:17)(cid:16)(cid:27)(cid:28)(cid:1)(cid:29)(cid:30)(cid:28)(cid:28)(cid:31)(cid:29)(cid:27)(cid:32)(cid:33)(cid:31)(cid:1)(cid:2)(cid:3,Unknown,5173.0
Unknown,Unknown,31,Unknown,Unknown,Unknown,Unknown,cid:16)(cid:17)(cid:16)(cid:27)(cid:28)(cid:1)(cid:29)(cid:30)(cid:28)(cid:28)(cid:31)(cid:29)(cid:27)(cid:32)(cid:33)(cid:31)(cid:1)(cid:2)(cid:3,Unknown,5204.0
Unknown,Unknown,2,Unknown,Unknown,Unknown,Unknown,cid:16)(cid:17)(cid:16)(cid:27)(cid:28)(cid:1)(cid:29)(cid:30)(cid:28)(cid:28)(cid:31)(cid:29)(cid:27)(cid:32)(cid:33)(cid:31)(cid:1)(cid:2)(cid:3,Unknown,5206.0
Unknown,Unknown,1,Unknown,Unknown,Unknown,Unknown,cid:16)(cid:17)(cid:16)(cid:27)(cid:28)(cid:1)(cid:29)(cid:30)(cid:28)(cid:28)(cid:31)(cid:29)(cid:27)(cid:32)(cid:33)(cid:31)(cid:1)(cid:2)(cid:3,Unknown,5207.0
Unknown,Unknown,27,Unknown,Unknown,Unknown,Unknown,cid:16)(cid:17)(cid:16)(cid:27)(cid:28)(cid:1)(cid:29)(cid:30)(cid:28)(cid:28)(cid:31)(cid:29)(cid:27)(cid:32)(cid:33)(cid:31)(cid:1)(cid:2)(cid:3,Unknown,5234.0
Unknown,Unknown,32,Unknown,Unknown,Unknown,Unknown,cid:16)(cid:17)(cid:16)(cid:27)(cid:28)(cid:1)(cid:29)(cid:30)(cid:28)(cid:28)(cid:31)(cid:29)(cid:27)(cid:32)(cid:33)(cid:31)(cid:1)(cid:2)(cid:3,Unknown,5266.0
Unknown,Unknown,16,Unknown,Unknown,Unknown,Unknown,cid:16)(cid:17)(cid:16)(cid:27)(cid:28)(cid:1)(cid:29)(cid:30)(cid:28)(cid:28)(cid:31)(cid:29)(cid:27)(cid:32)(cid:33)(cid:31)(cid:1)(cid:2)(cid:3,Unknown,5282.0
Unknown,Unknown,17,Unknown,Unknown,Unknown,Unknown,cid:16)(cid:17)(cid:16)(cid:27)(cid:28)(cid:1)(cid:29)(cid:30)(cid:28)(cid:28)(cid:31)(cid:29)(cid:27)(cid:32)(cid:33)(cid:31)(cid:1)(cid:2)(cid:3,Unknown,5299.0
Unknown,Unknown,3,Unknown,Unknown,Unknown,Unknown,cid:16)(cid:17)(cid:16)(cid:27)(cid:28)(cid:1)(cid:29)(cid:30)(cid:28)(cid:28)(cid:31)(cid:29)(cid:27)(cid:32)(cid:33)(cid:31)(cid:1)(cid:2)(cid:3,Unknown,5302.0
Unknown,Unknown,17,Unknown,Unknown,Unknown,Unknown,cid:16)(cid:17)(cid:16)(cid:27)(cid:28)(cid:1)(cid:29)(cid:30)(cid:28)(cid:28)(cid:31)(cid:29)(cid:27)(cid:32)(cid:33)(cid:31)(cid:1)(cid:2)(cid:3,Unknown,5319.0
Unknown,Unknown,32,Unknown,Unknown,Unknown,Unknown,cid:16)(cid:17)(cid:16)(cid:27)(cid:28)(cid:1)(cid:29)(cid:30)(cid:28)(cid:28)(cid:31)(cid:29)(cid:27)(cid:32)(cid:33)(cid:31)(cid:1)(cid:2)(cid:3,Unknown,5351.0
Unknown,Unknown,16,Unknown,Unknown,Unknown,Unknown,cid:16)(cid:17)(cid:16)(cid:27)(cid:28)(cid:1)(cid:29)(cid:30)(cid:28)(cid:28)(cid:31)(cid:29)(cid:27)(cid:32)(cid:33)(cid:31)(cid:1)(cid:2)(cid:3,Unknown,5367.0
Unknown,Unknown,31,Unknown,Unknown,Unknown,Unknown,cid:16)(cid:17)(cid:16)(cid:27)(cid:28)(cid:1)(cid:29)(cid:30)(cid:28)(cid:28)(cid:31)(cid:29)(cid:27)(cid:32)(cid:33)(cid:31)(cid:1)(cid:2)(cid:3,Unknown,5398.0
Unknown,Unknown,1,Unknown,Unknown,Unknown,Unknown,cid:16)(cid:17)(cid:16)(cid:27)(cid:28)(cid:1)(cid:29)(cid:30)(cid:28)(cid:28)(cid:31)(cid:29)(cid:27)(cid:32)(cid:33)(cid:31)(cid:1)(cid:2)(cid:3,Unknown,5399.0
Unknown,Unknown,36,Unknown,Unknown,Unknown,Unknown,cid:16)(cid:17)(cid:16)(cid:27)(cid:28)(cid:1)(cid:29)(cid:30)(cid:28)(cid:28)(cid:31)(cid:29)(cid:27)(cid:32)(cid:33)(cid:31)(cid:1)(cid:2)(cid:3,Unknown,5435.0
Unknown,Unknown,31,Unknown,Unknown,Unknown,Unknown,cid:16)(cid:17)(cid:16)(cid:27)(cid:28)(cid:1)(cid:29)(cid:30)(cid:28)(cid:28)(cid:31)(cid:29)(cid:27)(cid:32)(cid:33)(cid:31)(cid:1)(cid:2)(cid:3,Unknown,5466.0
Unknown,Unknown,15,Unknown,Unknown,Unknown,Unknown,cid:16)(cid:17)(cid:16)(cid:27)(cid:28)(cid:1)(cid:29)(cid:30)(cid:28)(cid:28)(cid:31)(cid:29)(cid:27)(cid:32)(cid:33)(cid:31)(cid:1)(cid:2)(cid:3,Unknown,5481.0
Unknown,Unknown,28,Unknown,Unknown,Unknown,Unknown,cid:16)(cid:17)(cid:16)(cid:27)(cid:28)(cid:1)(cid:29)(cid:30)(cid:28)(cid:28)(cid:31)(cid:29)(cid:27)(cid:32)(cid:33)(cid:31)(cid:1)(cid:2)(cid:3,Unknown,5509.0
Unknown,Unknown,30,Unknown,Unknown,Unknown,Unknown,cid:16)(cid:17)(cid:16)(cid:27)(cid:28)(cid:1)(cid:29)(cid:30)(cid:28)(cid:28)(cid:31)(cid:29)(cid:27)(cid:32)(cid:33)(cid:31)(cid:1)(cid:2)(cid:3,Unknown,5539.0
Unknown,Unknown,36,Unknown,Unknown,Unknown,Unknown,cid:16)(cid:17)(cid:16)(cid:27)(cid:28)(cid:1)(cid:29)(cid:30)(cid:28)(cid:28)(cid:31)(cid:29)(cid:27)(cid:32)(cid:33)(cid:31)(cid:1)(cid:2)(cid:3,Unknown,5575.0
Unknown,Unknown,1,Unknown,Unknown,Unknown,Unknown,cid:16)(cid:17)(cid:16)(cid:27)(cid:28)(cid:1)(cid:29)(cid:30)(cid:28)(cid:28)(cid:31)(cid:29)(cid:27)(cid:32)(cid:33)(cid:31)(cid:1)(cid:2)(cid:3,Unknown,5576.0
Unknown,Unknown,35,Unknown,Unknown,Unknown,Unknown,cid:16)(cid:17)(cid:16)(cid:27)(cid:28)(cid:1)(cid:29)(cid:30)(cid:28)(cid:28)(cid:31)(cid:29)(cid:27)(cid:32)(cid:33)(cid:31)(cid:1)(cid:2)(cid:3,Unknown,5611.0
Unknown,Unknown,31,Unknown,Unknown,Unknown,Unknown,cid:16)(cid:17)(cid:16)(cid:27)(cid:28)(cid:1)(cid:29)(cid:30)(cid:28)(cid:28)(cid:31)(cid:29)(cid:27)(cid:32)(cid:33)(cid:31)(cid:1)(cid:2)(cid:3,Unknown,5642.0
Unknown,Unknown,33,Unknown,Unknown,Unknown,Unknown,cid:16)(cid:17)(cid:16)(cid:27)(cid:28)(cid:1)(cid:29)(cid:30)(cid:28)(cid:28)(cid:31)(cid:29)(cid:27)(cid:32)(cid:33)(cid:31)(cid:1)(cid:2)(cid:3,Unknown,5675.0
Unknown,Unknown,31,Unknown,Unknown,Unknown,Unknown,cid:16)(cid:17)(cid:16)(cid:27)(cid:28)(cid:1)(cid:29)(cid:30)(cid:28)(cid:28)(cid:31)(cid:29)(cid:27)(cid:32)(cid:33)(cid:31)(cid:1)(cid:2)(cid:3,Unknown,5706.0
Unknown,Unknown,19,Unknown,Unknown,Unknown,Unknown,cid:16)(cid:17)(cid:16)(cid:27)(cid:28)(cid:1)(cid:29)(cid:30)(cid:28)(cid:28)(cid:31)(cid:29)(cid:27)(cid:32)(cid:33)(cid:31)(cid:1)(cid:2)(cid:3,Unknown,5725.0
Unknown,Unknown,1,Unknown,Unknown,Unknown,Unknown,cid:16)(cid:17)(cid:16)(cid:27)(cid:28)(cid:1)(cid:29)(cid:30)(cid:28)(cid:28)(cid:31)(cid:29)(cid:27)(cid:32)(cid:33)(cid:31)(cid:1)(cid:2)(cid:3,Unknown,5726.0
Unknown,Unknown,2,Unknown,Unknown,Unknown,Unknown,cid:16)(cid:17)(cid:16)(cid:27)(cid:28)(cid:1)(cid:29)(cid:30)(cid:28)(cid:28)(cid:31)(cid:29)(cid:27)(cid:32)(cid:33)(cid:31)(cid:1)(cid:2)(cid:3,Unknown,5728.0
Unknown,Unknown,3,Unknown,Unknown,Unknown,Unknown,cid:16)(cid:17)(cid:16)(cid:27)(cid:28)(cid:1)(cid:29)(cid:30)(cid:28)(cid:28)(cid:31)(cid:29)(cid:27)(cid:32)(cid:33)(cid:31)(cid:1)(cid:2)(cid:3,Unknown,5731.0
Unknown,Unknown,10,Unknown,Unknown,Unknown,Unknown,cid:16)(cid:17)(cid:16)(cid:27)(cid:28)(cid:1)(cid:29)(cid:30)(cid:28)(cid:28)(cid:31)(cid:29)(cid:27)(cid:32)(cid:33)(cid:31)(cid:1)(cid:2)(cid:3,Unknown,5741.0
Unknown,Unknown,11,Unknown,Unknown,Unknown,Unknown,cid:16)(cid:17)(cid:16)(cid:27)(cid:28)(cid:1)(cid:29)(cid:30)(cid:28)(cid:28)(cid:31)(cid:29)(cid:27)(cid:32)(cid:33)(cid:31)(cid:1)(cid:2)(cid:3,Unknown,5752.0
Unknown,Unknown,20,Unknown,Unknown,Unknown,Unknown,cid:16)(cid:17)(cid:16)(cid:27)(cid:28)(cid:1)(cid:29)(cid:30)(cid:28)(cid:28)(cid:31)(cid:29)(cid:27)(cid:32)(cid:33)(cid:31)(cid:1)(cid:2)(cid:3,Unknown,5772.0
Unknown,Unknown,10,Unknown,Unknown,Unknown,Unknown,cid:16)(cid:17)(cid:16)(cid:27)(cid:28)(cid:1)(cid:29)(cid:30)(cid:28)(cid:28)(cid:31)(cid:29)(cid:27)(cid:32)(cid:33)(cid:31)(cid:1)(cid:2)(cid:3,Unknown,5782.0
Unknown,Unknown,11,Unknown,Unknown,Unknown,Unknown,cid:16)(cid:17)(cid:16)(cid:27)(cid:28)(cid:1)(cid:29)(cid:30)(cid:28)(cid:28)(cid:31)(cid:29)(cid:27)(cid:32)(cid:33)(cid:31)(cid:1)(cid:2)(cid:3,Unknown,5793.0
Unknown,Unknown,24,Unknown,Unknown,Unknown,Unknown,cid:16)(cid:17)(cid:16)(cid:27)(cid:28)(cid:1)(cid:29)(cid:30)(cid:28)(cid:28)(cid:31)(cid:29)(cid:27)(cid:32)(cid:33)(cid:31)(cid:1)(cid:2)(cid:3,Unknown,5817.0
Unknown,Unknown,1,Unknown,Unknown,Unknown,Unknown,cid:16)(cid:17)(cid:16)(cid:27)(cid:28)(cid:1)(cid:29)(cid:30)(cid:28)(cid:28)(cid:31)(cid:29)(cid:27)(cid:32)(cid:33)(cid:31)(cid:1)(cid:2)(cid:3,Unknown,5818.0
Unknown,Unknown,6,Unknown,Unknown,Unknown,Unknown,cid:16)(cid:17)(cid:16)(cid:27)(cid:28)(cid:1)(cid:29)(cid:30)(cid:28)(cid:28)(cid:31)(cid:29)(cid:27)(cid:32)(cid:33)(cid:31)(cid:1)(cid:2)(cid:3,Unknown,5824.0
Unknown,Unknown,25,Unknown,Unknown,Unknown,Unknown,cid:16)(cid:17)(cid:16)(cid:27)(cid:28)(cid:1)(cid:29)(cid:30)(cid:28)(cid:28)(cid:31)(cid:29)(cid:27)(cid:32)(cid:33)(cid:31)(cid:1)(cid:2)(cid:3,Unknown,5849.0
Unknown,Unknown,7,Unknown,Unknown,Unknown,Unknown,cid:16)(cid:17)(cid:16)(cid:27)(cid:28)(cid:1)(cid:29)(cid:30)(cid:28)(cid:28)(cid:31)(cid:29)(cid:27)(cid:32)(cid:33)(cid:31)(cid:1)(cid:2)(cid:3,Unknown,5856.0
Unknown,Unknown,10,Unknown,Unknown,Unknown,Unknown,cid:16)(cid:17)(cid:16)(cid:27)(cid:28)(cid:1)(cid:29)(cid:30)(cid:28)(cid:28)(cid:31)(cid:29)(cid:27)(cid:32)(cid:33)(cid:31)(cid:1)(cid:2)(cid:3,Unknown,5866.0
Unknown,Unknown,1,Unknown,Unknown,Unknown,Unknown,cid:16)(cid:17)(cid:16)(cid:27)(cid:28)(cid:1)(cid:29)(cid:30)(cid:28)(cid:28)(cid:31)(cid:29)(cid:27)(cid:32)(cid:33)(cid:31)(cid:1)(cid:2)(cid:3,Unknown,5867.0
Unknown,Unknown,26,Unknown,Unknown,Unknown,Unknown,cid:16)(cid:17)(cid:16)(cid:27)(cid:28)(cid:1)(cid:29)(cid:30)(cid:28)(cid:28)(cid:31)(cid:29)(cid:27)(cid:32)(cid:33)(cid:31)(cid:1)(cid:2)(cid:3,Unknown,5893.0
Unknown,Unknown,45,Unknown,Unknown,Unknown,Unknown,cid:16)(cid:17)(cid:16)(cid:27)(cid:28)(cid:1)(cid:29)(cid:30)(cid:28)(cid:28)(cid:31)(cid:29)(cid:27)(cid:32)(cid:33)(cid:31)(cid:1)(cid:2)(cid:3,Unknown,5938.0
Unknown,Unknown,10,Unknown,Unknown,Unknown,Unknown,cid:16)(cid:17)(cid:16)(cid:27)(cid:28)(cid:1)(cid:29)(cid:30)(cid:28)(cid:28)(cid:31)(cid:29)(cid:27)(cid:32)(cid:33)(cid:31)(cid:1)(cid:2)(cid:3,Unknown,5948.0
Unknown,Unknown,19,Unknown,Unknown,Unknown,Unknown,cid:16)(cid:17)(cid:16)(cid:27)(cid:28)(cid:1)(cid:29)(cid:30)(cid:28)(cid:28)(cid:31)(cid:29)(cid:27)(cid:32)(cid:33)(cid:31)(cid:1)(cid:2)(cid:3,Unknown,5967.0
Unknown,Unknown,16,Unknown,Unknown,Unknown,Unknown,cid:16)(cid:17)(cid:16)(cid:27)(cid:28)(cid:1)(cid:29)(cid:30)(cid:28)(cid:28)(cid:31)(cid:29)(cid:27)(cid:32)(cid:33)(cid:31)(cid:1)(cid:2)(cid:3,Unknown,5983.0
Unknown,Unknown,7,Unknown,Unknown,Unknown,Unknown,cid:16)(cid:17)(cid:16)(cid:27)(cid:28)(cid:1)(cid:29)(cid:30)(cid:28)(cid:28)(cid:31)(cid:29)(cid:27)(cid:32)(cid:33)(cid:31)(cid:1)(cid:2)(cid:3,Unknown,5990.0
Unknown,Unknown,3,Unknown,Unknown,Unknown,Unknown,cid:16)(cid:17)(cid:16)(cid:27)(cid:28)(cid:1)(cid:29)(cid:30)(cid:28)(cid:28)(cid:31)(cid:29)(cid:27)(cid:32)(cid:33)(cid:31)(cid:1)(cid:2)(cid:3,Unknown,5993.0
Unknown,Unknown,8,Unknown,Unknown,Unknown,Unknown,cid:16)(cid:17)(cid:16)(cid:27)(cid:28)(cid:1)(cid:29)(cid:30)(cid:28)(cid:28)(cid:31)(cid:29)(cid:27)(cid:32)(cid:33)(cid:31)(cid:1)(cid:2)(cid:3,Unknown,6001.0
Unknown,Unknown,28,Unknown,Unknown,Unknown,Unknown,cid:16)(cid:17)(cid:16)(cid:27)(cid:28)(cid:1)(cid:29)(cid:30)(cid:28)(cid:28)(cid:31)(cid:29)(cid:27)(cid:32)(cid:33)(cid:31)(cid:1)(cid:2)(cid:3,Unknown,6029.0
Unknown,Unknown,10,Unknown,Unknown,Unknown,Unknown,cid:16)(cid:17)(cid:16)(cid:27)(cid:28)(cid:1)(cid:29)(cid:30)(cid:28)(cid:28)(cid:31)(cid:29)(cid:27)(cid:32)(cid:33)(cid:31)(cid:1)(cid:2)(cid:3,Unknown,6039.0
Unknown,Unknown,3,Unknown,Unknown,Unknown,Unknown,cid:16)(cid:17)(cid:16)(cid:27)(cid:28)(cid:1)(cid:29)(cid:30)(cid:28)(cid:28)(cid:31)(cid:29)(cid:27)(cid:32)(cid:33)(cid:31)(cid:1)(cid:2)(cid:3,Unknown,6042.0
Unknown,Unknown,6,Unknown,Unknown,Unknown,Unknown,cid:16)(cid:17)(cid:16)(cid:27)(cid:28)(cid:1)(cid:29)(cid:30)(cid:28)(cid:28)(cid:31)(cid:29)(cid:27)(cid:32)(cid:33)(cid:31)(cid:1)(cid:2)(cid:3,Unknown,6048.0
Unknown,Unknown,8,Unknown,Unknown,Unknown,Unknown,cid:16)(cid:17)(cid:16)(cid:27)(cid:28)(cid:1)(cid:29)(cid:30)(cid:28)(cid:28)(cid:31)(cid:29)(cid:27)(cid:32)(cid:33)(cid:31)(cid:1)(cid:2)(cid:3,Unknown,6056.0
Unknown,Unknown,46,Unknown,Unknown,Unknown,Unknown,cid:16)(cid:17)(cid:16)(cid:27)(cid:28)(cid:1)(cid:29)(cid:30)(cid:28)(cid:28)(cid:31)(cid:29)(cid:27)(cid:32)(cid:33)(cid:31)(cid:1)(cid:2)(cid:3,Unknown,6102.0
Unknown,Unknown,46,Unknown,Unknown,Unknown,Unknown,cid:16)(cid:17)(cid:16)(cid:27)(cid:28)(cid:1)(cid:29)(cid:30)(cid:28)(cid:28)(cid:31)(cid:29)(cid:27)(cid:32)(cid:33)(cid:31)(cid:1)(cid:2)(cid:3,Unknown,6148.0
Unknown,Unknown,47,Unknown,Unknown,Unknown,Unknown,cid:16)(cid:17)(cid:16)(cid:27)(cid:28)(cid:1)(cid:29)(cid:30)(cid:28)(cid:28)(cid:31)(cid:29)(cid:27)(cid:32)(cid:33)(cid:31)(cid:1)(cid:2)(cid:3,Unknown,6195.0
Unknown,Unknown,32,Unknown,Unknown,Unknown,Unknown,cid:16)(cid:17)(cid:16)(cid:27)(cid:28)(cid:1)(cid:29)(cid:30)(cid:28)(cid:28)(cid:31)(cid:29)(cid:27)(cid:32)(cid:33)(cid:31)(cid:1)(cid:2)(cid:3,Unknown,6227.0
Unknown,Unknown,48,Unknown,Unknown,Unknown,Unknown,cid:16)(cid:17)(cid:16)(cid:27)(cid:28)(cid:1)(cid:29)(cid:30)(cid:28)(cid:28)(cid:31)(cid:29)(cid:27)(cid:32)(cid:33)(cid:31)(cid:1)(cid:2)(cid:3,Unknown,6275.0
Unknown,Unknown,49,Unknown,Unknown,Unknown,Unknown,cid:16)(cid:17)(cid:16)(cid:27)(cid:28)(cid:1)(cid:29)(cid:30)(cid:28)(cid:28)(cid:31)(cid:29)(cid:27)(cid:32)(cid:33)(cid:31)(cid:1)(cid:2)(cid:3,Unknown,6324.0
Unknown,Unknown,10,Unknown,Unknown,Unknown,Unknown,cid:10)(cid:13)(cid:20)(cid:10)(cid:11,cid:41)(cid:27)(cid:28)(cid:2)(cid:17)(cid:15,10.0
Unknown,Unknown,13,Unknown,Unknown,Unknown,Unknown,cid:10)(cid:13)(cid:20)(cid:10)(cid:11,cid:39)(cid:1)(cid:11)(cid:4)(cid:10)(cid:25)(cid:10)(cid:10)(cid:1)(cid:26,23.0
Unknown,Unknown,20,Unknown,Unknown,Unknown,Unknown,cid:10)(cid:13)(cid:20)(cid:10)(cid:11,cid:24)(cid:1)(cid:11)(cid:25)(cid:9)(cid:10)(cid:1)(cid:26,43.0
Unknown,Unknown,10,Unknown,Unknown,Unknown,Unknown,cid:10)(cid:13)(cid:20)(cid:10)(cid:11,cid:18)(cid:30)(cid:43)(cid:43)(cid:27)(cid:1)(cid:42)(cid:17)(cid:16)(cid:1)(cid:40)(cid:3)(cid:30)(cid:28)(cid:28)(cid:1)(cid:28)(cid:27)(cid:1)(cid:2)(cid:31)(cid:3)(cid:16)(cid:31)(cid:1)(cid:40)(cid:27)(cid:32)(cid:35)(cid:1)(cid:2)(cid:3,53.0
Unknown,Unknown,11,Unknown,Unknown,Unknown,Unknown,cid:10)(cid:13)(cid:20)(cid:10)(cid:11,cid:28)(cid:27)(cid:1)(cid:36)(cid:32)(cid:35)(cid:3)(cid:31)(cid:3)(cid:30)(cid:31)(cid:1)(cid:35)(cid:17)(cid:32)(cid:28)(cid:17)(cid:34)(cid:34)(cid:30)(cid:31)(cid:3)(cid:36)(cid:1)(cid:2)(cid:3,64.0
Unknown,Unknown,33,Unknown,Unknown,Unknown,Unknown,cid:10)(cid:13)(cid:20)(cid:10)(cid:11,cid:24)(cid:1)(cid:12)(cid:7)(cid:4)(cid:25)(cid:12)(cid:11)(cid:1)(cid:26,97.0
Unknown,Unknown,27,Unknown,Unknown,Unknown,Unknown,cid:10)(cid:13)(cid:20)(cid:10)(cid:11,cid:24)(cid:1)(cid:13)(cid:4)(cid:25)(cid:13)(cid:8)(cid:1)(cid:26,124.0
Unknown,Unknown,37,Unknown,Unknown,Unknown,Unknown,cid:10)(cid:13)(cid:20)(cid:10)(cid:11,Unknown,161.0
Unknown,Unknown,38,Unknown,Unknown,Unknown,Unknown,cid:10)(cid:13)(cid:20)(cid:10)(cid:11,Unknown,199.0
Unknown,Unknown,39,Unknown,Unknown,Unknown,Unknown,cid:10)(cid:13)(cid:20)(cid:10)(cid:11,Unknown,238.0
Unknown,Unknown,1,Unknown,Unknown,Unknown,Unknown,cid:10)(cid:13)(cid:20)(cid:10)(cid:11,Unknown,239.0
Unknown,Unknown,11,Unknown,Unknown,Unknown,Unknown,cid:10)(cid:13)(cid:20)(cid:10)(cid:11,Unknown,250.0
Unknown,Unknown,7,Unknown,Unknown,Unknown,Unknown,cid:10)(cid:13)(cid:20)(cid:10)(cid:11,Unknown,257.0
Unknown,Unknown,10,Unknown,Unknown,Unknown,Unknown,cid:10)(cid:13)(cid:20)(cid:10)(cid:11,Unknown,267.0
Unknown,Unknown,25,Unknown,Unknown,Unknown,Unknown,cid:10)(cid:13)(cid:20)(cid:10)(cid:11,Unknown,292.0
Unknown,Unknown,10,Unknown,Unknown,Unknown,Unknown,cid:10)(cid:13)(cid:20)(cid:10)(cid:11,Unknown,302.0
Unknown,Unknown,10,Unknown,Unknown,Unknown,Unknown,cid:10)(cid:13)(cid:20)(cid:10)(cid:11,Unknown,312.0
Unknown,Unknown,1,Unknown,Unknown,Unknown,Unknown,cid:10)(cid:13)(cid:20)(cid:10)(cid:11,Unknown,313.0
Unknown,Unknown,26,Unknown,Unknown,Unknown,Unknown,cid:10)(cid:13)(cid:20)(cid:10)(cid:11,Unknown,339.0
Unknown,Unknown,10,Unknown,Unknown,Unknown,Unknown,cid:10)(cid:13)(cid:20)(cid:10)(cid:11,Unknown,349.0
Unknown,Unknown,13,Unknown,Unknown,Unknown,Unknown,cid:10)(cid:13)(cid:20)(cid:10)(cid:11,Unknown,362.0
Unknown,Unknown,20,Unknown,Unknown,Unknown,Unknown,cid:10)(cid:13)(cid:20)(cid:10)(cid:11,Unknown,382.0
Unknown,Unknown,10,Unknown,Unknown,Unknown,Unknown,cid:10)(cid:13)(cid:20)(cid:10)(cid:11,Unknown,392.0
Unknown,Unknown,11,Unknown,Unknown,Unknown,Unknown,cid:10)(cid:13)(cid:20)(cid:10)(cid:11,Unknown,403.0
Unknown,Unknown,34,Unknown,Unknown,Unknown,Unknown,cid:10)(cid:13)(cid:20)(cid:10)(cid:11,Unknown,437.0
Unknown,Unknown,27,Unknown,Unknown,Unknown,Unknown,cid:10)(cid:13)(cid:20)(cid:10)(cid:11,Unknown,464.0
Unknown,Unknown,40,Unknown,Unknown,Unknown,Unknown,cid:10)(cid:13)(cid:20)(cid:10)(cid:11,Unknown,504.0
Unknown,Unknown,1,Unknown,Unknown,Unknown,Unknown,cid:10)(cid:13)(cid:20)(cid:10)(cid:11,Unknown,505.0
Unknown,Unknown,37,Unknown,Unknown,Unknown,Unknown,cid:10)(cid:13)(cid:20)(cid:10)(cid:11,Unknown,542.0
Unknown,Unknown,27,Unknown,Unknown,Unknown,Unknown,cid:10)(cid:13)(cid:20)(cid:10)(cid:11,Unknown,569.0
Unknown,Unknown,16,Unknown,Unknown,Unknown,Unknown,cid:10)(cid:13)(cid:20)(cid:10)(cid:11,Unknown,585.0
Unknown,Unknown,39,Unknown,Unknown,Unknown,Unknown,cid:10)(cid:13)(cid:20)(cid:10)(cid:11,Unknown,624.0
Unknown,Unknown,1,Unknown,Unknown,Unknown,Unknown,cid:10)(cid:13)(cid:20)(cid:10)(cid:11,Unknown,625.0
Unknown,Unknown,11,Unknown,Unknown,Unknown,Unknown,cid:10)(cid:13)(cid:20)(cid:10)(cid:11,Unknown,636.0
Unknown,Unknown,12,Unknown,Unknown,Unknown,Unknown,cid:10)(cid:13)(cid:20)(cid:10)(cid:11,Unknown,648.0
Unknown,Unknown,8,Unknown,Unknown,Unknown,Unknown,cid:10)(cid:13)(cid:20)(cid:10)(cid:11,Unknown,656.0
Unknown,Unknown,25,Unknown,Unknown,Unknown,Unknown,cid:10)(cid:13)(cid:20)(cid:10)(cid:11,Unknown,681.0
Unknown,Unknown,10,Unknown,Unknown,Unknown,Unknown,cid:10)(cid:13)(cid:20)(cid:10)(cid:11,Unknown,691.0
Unknown,Unknown,10,Unknown,Unknown,Unknown,Unknown,cid:10)(cid:13)(cid:20)(cid:10)(cid:11,Unknown,701.0
Unknown,Unknown,1,Unknown,Unknown,Unknown,Unknown,cid:10)(cid:13)(cid:20)(cid:10)(cid:11,Unknown,702.0
Unknown,Unknown,26,Unknown,Unknown,Unknown,Unknown,cid:10)(cid:13)(cid:20)(cid:10)(cid:11,Unknown,728.0
Unknown,Unknown,10,Unknown,Unknown,Unknown,Unknown,cid:10)(cid:13)(cid:20)(cid:10)(cid:11,Unknown,738.0
Unknown,Unknown,13,Unknown,Unknown,Unknown,Unknown,cid:10)(cid:13)(cid:20)(cid:10)(cid:11,Unknown,751.0
Unknown,Unknown,20,Unknown,Unknown,Unknown,Unknown,cid:10)(cid:13)(cid:20)(cid:10)(cid:11,Unknown,771.0
Unknown,Unknown,10,Unknown,Unknown,Unknown,Unknown,cid:10)(cid:13)(cid:20)(cid:10)(cid:11,Unknown,781.0
Unknown,Unknown,11,Unknown,Unknown,Unknown,Unknown,cid:10)(cid:13)(cid:20)(cid:10)(cid:11,Unknown,792.0
Unknown,Unknown,40,Unknown,Unknown,Unknown,Unknown,cid:10)(cid:13)(cid:20)(cid:10)(cid:11,Unknown,832.0
Unknown,Unknown,27,Unknown,Unknown,Unknown,Unknown,cid:10)(cid:13)(cid:20)(cid:10)(cid:11,Unknown,859.0
Unknown,Unknown,32,Unknown,Unknown,Unknown,Unknown,cid:10)(cid:13)(cid:20)(cid:10)(cid:11,Unknown,891.0
Unknown,Unknown,33,Unknown,Unknown,Unknown,Unknown,cid:10)(cid:13)(cid:20)(cid:10)(cid:11,Unknown,924.0
Unknown,Unknown,38,Unknown,Unknown,Unknown,Unknown,cid:10)(cid:13)(cid:20)(cid:10)(cid:11,Unknown,962.0
Unknown,Unknown,39,Unknown,Unknown,Unknown,Unknown,cid:10)(cid:13)(cid:20)(cid:10)(cid:11,Unknown,1001.0
Unknown,Unknown,1,Unknown,Unknown,Unknown,Unknown,cid:10)(cid:13)(cid:20)(cid:10)(cid:11,Unknown,1002.0
Unknown,Unknown,6,Unknown,Unknown,Unknown,Unknown,cid:10)(cid:13)(cid:20)(cid:10)(cid:11,Unknown,1008.0
Unknown,Unknown,8,Unknown,Unknown,Unknown,Unknown,cid:10)(cid:13)(cid:20)(cid:10)(cid:11,Unknown,1016.0
Unknown,Unknown,10,Unknown,Unknown,Unknown,Unknown,cid:10)(cid:13)(cid:20)(cid:10)(cid:11,Unknown,1026.0
Unknown,Unknown,25,Unknown,Unknown,Unknown,Unknown,cid:10)(cid:13)(cid:20)(cid:10)(cid:11,Unknown,1051.0
Unknown,Unknown,10,Unknown,Unknown,Unknown,Unknown,cid:10)(cid:13)(cid:20)(cid:10)(cid:11,Unknown,1061.0
Unknown,Unknown,10,Unknown,Unknown,Unknown,Unknown,cid:10)(cid:13)(cid:20)(cid:10)(cid:11,Unknown,1071.0
Unknown,Unknown,1,Unknown,Unknown,Unknown,Unknown,cid:10)(cid:13)(cid:20)(cid:10)(cid:11,Unknown,1072.0
Unknown,Unknown,26,Unknown,Unknown,Unknown,Unknown,cid:10)(cid:13)(cid:20)(cid:10)(cid:11,Unknown,1098.0
Unknown,Unknown,10,Unknown,Unknown,Unknown,Unknown,cid:10)(cid:13)(cid:20)(cid:10)(cid:11,Unknown,1108.0
Unknown,Unknown,13,Unknown,Unknown,Unknown,Unknown,cid:10)(cid:13)(cid:20)(cid:10)(cid:11,Unknown,1121.0
Unknown,Unknown,20,Unknown,Unknown,Unknown,Unknown,cid:10)(cid:13)(cid:20)(cid:10)(cid:11,Unknown,1141.0
Unknown,Unknown,10,Unknown,Unknown,Unknown,Unknown,cid:10)(cid:13)(cid:20)(cid:10)(cid:11,Unknown,1151.0
Unknown,Unknown,11,Unknown,Unknown,Unknown,Unknown,cid:10)(cid:13)(cid:20)(cid:10)(cid:11,Unknown,1162.0
Unknown,Unknown,36,Unknown,Unknown,Unknown,Unknown,cid:10)(cid:13)(cid:20)(cid:10)(cid:11,Unknown,1198.0
Unknown,Unknown,27,Unknown,Unknown,Unknown,Unknown,cid:10)(cid:13)(cid:20)(cid:10)(cid:11,Unknown,1225.0
Unknown,Unknown,28,Unknown,Unknown,Unknown,Unknown,cid:10)(cid:13)(cid:20)(cid:10)(cid:11,Unknown,1253.0
Unknown,Unknown,29,Unknown,Unknown,Unknown,Unknown,cid:10)(cid:13)(cid:20)(cid:10)(cid:11,Unknown,1282.0
Unknown,Unknown,30,Unknown,Unknown,Unknown,Unknown,cid:10)(cid:13)(cid:20)(cid:10)(cid:11,Unknown,1312.0
Unknown,Unknown,39,Unknown,Unknown,Unknown,Unknown,cid:10)(cid:13)(cid:20)(cid:10)(cid:11,Unknown,1351.0
Unknown,Unknown,1,Unknown,Unknown,Unknown,Unknown,cid:10)(cid:13)(cid:20)(cid:10)(cid:11,Unknown,1352.0
Unknown,Unknown,11,Unknown,Unknown,Unknown,Unknown,cid:10)(cid:13)(cid:20)(cid:10)(cid:11,Unknown,1363.0
Unknown,Unknown,12,Unknown,Unknown,Unknown,Unknown,cid:10)(cid:13)(cid:20)(cid:10)(cid:11,Unknown,1375.0
Unknown,Unknown,10,Unknown,Unknown,Unknown,Unknown,cid:10)(cid:13)(cid:20)(cid:10)(cid:11,Unknown,1385.0
Unknown,Unknown,25,Unknown,Unknown,Unknown,Unknown,cid:10)(cid:13)(cid:20)(cid:10)(cid:11,Unknown,1410.0
Unknown,Unknown,10,Unknown,Unknown,Unknown,Unknown,cid:10)(cid:13)(cid:20)(cid:10)(cid:11,Unknown,1420.0
Unknown,Unknown,10,Unknown,Unknown,Unknown,Unknown,cid:10)(cid:13)(cid:20)(cid:10)(cid:11,Unknown,1430.0
Unknown,Unknown,1,Unknown,Unknown,Unknown,Unknown,cid:10)(cid:13)(cid:20)(cid:10)(cid:11,Unknown,1431.0
Unknown,Unknown,26,Unknown,Unknown,Unknown,Unknown,cid:10)(cid:13)(cid:20)(cid:10)(cid:11,Unknown,1457.0
Unknown,Unknown,10,Unknown,Unknown,Unknown,Unknown,cid:10)(cid:13)(cid:20)(cid:10)(cid:11,Unknown,1467.0
Unknown,Unknown,13,Unknown,Unknown,Unknown,Unknown,cid:10)(cid:13)(cid:20)(cid:10)(cid:11,Unknown,1480.0
Unknown,Unknown,20,Unknown,Unknown,Unknown,Unknown,cid:10)(cid:13)(cid:20)(cid:10)(cid:11,Unknown,1500.0
Unknown,Unknown,10,Unknown,Unknown,Unknown,Unknown,cid:10)(cid:13)(cid:20)(cid:10)(cid:11,Unknown,1510.0
Unknown,Unknown,11,Unknown,Unknown,Unknown,Unknown,cid:10)(cid:13)(cid:20)(cid:10)(cid:11,Unknown,1521.0
Unknown,Unknown,41,Unknown,Unknown,Unknown,Unknown,cid:10)(cid:13)(cid:20)(cid:10)(cid:11,Unknown,1562.0
Unknown,Unknown,27,Unknown,Unknown,Unknown,Unknown,cid:10)(cid:13)(cid:20)(cid:10)(cid:11,Unknown,1589.0
Unknown,Unknown,28,Unknown,Unknown,Unknown,Unknown,cid:10)(cid:13)(cid:20)(cid:10)(cid:11,Unknown,1617.0
Unknown,Unknown,2,Unknown,Unknown,Unknown,Unknown,cid:10)(cid:13)(cid:20)(cid:10)(cid:11,Unknown,1619.0
Unknown,Unknown,17,Unknown,Unknown,Unknown,Unknown,cid:10)(cid:13)(cid:20)(cid:10)(cid:11,Unknown,1636.0
Unknown,Unknown,15,Unknown,Unknown,Unknown,Unknown,cid:10)(cid:13)(cid:20)(cid:10)(cid:11,Unknown,1651.0
Unknown,Unknown,39,Unknown,Unknown,Unknown,Unknown,cid:10)(cid:13)(cid:20)(cid:10)(cid:11,Unknown,1690.0
Unknown,Unknown,1,Unknown,Unknown,Unknown,Unknown,cid:10)(cid:13)(cid:20)(cid:10)(cid:11,Unknown,1691.0
Unknown,Unknown,11,Unknown,Unknown,Unknown,Unknown,cid:10)(cid:13)(cid:20)(cid:10)(cid:11,Unknown,1702.0
Unknown,Unknown,4,Unknown,Unknown,Unknown,Unknown,cid:10)(cid:13)(cid:20)(cid:10)(cid:11,Unknown,1706.0
Unknown,Unknown,10,Unknown,Unknown,Unknown,Unknown,cid:10)(cid:13)(cid:20)(cid:10)(cid:11,Unknown,1716.0
Unknown,Unknown,25,Unknown,Unknown,Unknown,Unknown,cid:10)(cid:13)(cid:20)(cid:10)(cid:11,Unknown,1741.0
Unknown,Unknown,10,Unknown,Unknown,Unknown,Unknown,cid:10)(cid:13)(cid:20)(cid:10)(cid:11,Unknown,1751.0
Unknown,Unknown,10,Unknown,Unknown,Unknown,Unknown,cid:10)(cid:13)(cid:20)(cid:10)(cid:11,Unknown,1761.0
Unknown,Unknown,1,Unknown,Unknown,Unknown,Unknown,cid:10)(cid:13)(cid:20)(cid:10)(cid:11,Unknown,1762.0
Unknown,Unknown,26,Unknown,Unknown,Unknown,Unknown,cid:10)(cid:13)(cid:20)(cid:10)(cid:11,Unknown,1788.0
Unknown,Unknown,10,Unknown,Unknown,Unknown,Unknown,cid:10)(cid:13)(cid:20)(cid:10)(cid:11,Unknown,1798.0
Unknown,Unknown,13,Unknown,Unknown,Unknown,Unknown,cid:10)(cid:13)(cid:20)(cid:10)(cid:11,Unknown,1811.0
Unknown,Unknown,20,Unknown,Unknown,Unknown,Unknown,cid:10)(cid:13)(cid:20)(cid:10)(cid:11,Unknown,1831.0
Unknown,Unknown,10,Unknown,Unknown,Unknown,Unknown,cid:10)(cid:13)(cid:20)(cid:10)(cid:11,Unknown,1841.0
Unknown,Unknown,11,Unknown,Unknown,Unknown,Unknown,cid:10)(cid:13)(cid:20)(cid:10)(cid:11,Unknown,1852.0
Unknown,Unknown,14,Unknown,Unknown,Unknown,Unknown,cid:10)(cid:13)(cid:20)(cid:10)(cid:11,Unknown,1866.0
Unknown,Unknown,21,Unknown,Unknown,Unknown,Unknown,cid:10)(cid:13)(cid:20)(cid:10)(cid:11,Unknown,1887.0
Unknown,Unknown,22,Unknown,Unknown,Unknown,Unknown,cid:10)(cid:13)(cid:20)(cid:10)(cid:11,Unknown,1909.0
Unknown,Unknown,23,Unknown,Unknown,Unknown,Unknown,cid:10)(cid:13)(cid:20)(cid:10)(cid:11,Unknown,1932.0
Unknown,Unknown,21,Unknown,Unknown,Unknown,Unknown,cid:10)(cid:13)(cid:20)(cid:10)(cid:11,Unknown,1953.0
Unknown,Unknown,24,Unknown,Unknown,Unknown,Unknown,cid:10)(cid:13)(cid:20)(cid:10)(cid:11,Unknown,1977.0
Unknown,Unknown,1,Unknown,Unknown,Unknown,Unknown,cid:10)(cid:13)(cid:20)(cid:10)(cid:11,Unknown,1978.0
Unknown,Unknown,11,Unknown,Unknown,Unknown,Unknown,cid:10)(cid:13)(cid:20)(cid:10)(cid:11,Unknown,1989.0
Unknown,Unknown,25,Unknown,Unknown,Unknown,Unknown,cid:10)(cid:13)(cid:20)(cid:10)(cid:11,Unknown,2014.0
Unknown,Unknown,12,Unknown,Unknown,Unknown,Unknown,cid:10)(cid:13)(cid:20)(cid:10)(cid:11,Unknown,2026.0
Unknown,Unknown,10,Unknown,Unknown,Unknown,Unknown,cid:10)(cid:13)(cid:20)(cid:10)(cid:11,Unknown,2036.0
Unknown,Unknown,1,Unknown,Unknown,Unknown,Unknown,cid:10)(cid:13)(cid:20)(cid:10)(cid:11,Unknown,2037.0
Unknown,Unknown,26,Unknown,Unknown,Unknown,Unknown,cid:10)(cid:13)(cid:20)(cid:10)(cid:11,Unknown,2063.0
Unknown,Unknown,10,Unknown,Unknown,Unknown,Unknown,cid:10)(cid:13)(cid:20)(cid:10)(cid:11,Unknown,2073.0
Unknown,Unknown,13,Unknown,Unknown,Unknown,Unknown,cid:10)(cid:13)(cid:20)(cid:10)(cid:11,Unknown,2086.0
Unknown,Unknown,20,Unknown,Unknown,Unknown,Unknown,cid:10)(cid:13)(cid:20)(cid:10)(cid:11,Unknown,2106.0
Unknown,Unknown,10,Unknown,Unknown,Unknown,Unknown,cid:10)(cid:13)(cid:20)(cid:10)(cid:11,Unknown,2116.0
Unknown,Unknown,11,Unknown,Unknown,Unknown,Unknown,cid:10)(cid:13)(cid:20)(cid:10)(cid:11,Unknown,2127.0
Unknown,Unknown,14,Unknown,Unknown,Unknown,Unknown,cid:10)(cid:13)(cid:20)(cid:10)(cid:11,Unknown,2141.0
Unknown,Unknown,21,Unknown,Unknown,Unknown,Unknown,cid:10)(cid:13)(cid:20)(cid:10)(cid:11,Unknown,2162.0
Unknown,Unknown,22,Unknown,Unknown,Unknown,Unknown,cid:10)(cid:13)(cid:20)(cid:10)(cid:11,Unknown,2184.0
Unknown,Unknown,23,Unknown,Unknown,Unknown,Unknown,cid:10)(cid:13)(cid:20)(cid:10)(cid:11,Unknown,2207.0
Unknown,Unknown,21,Unknown,Unknown,Unknown,Unknown,cid:10)(cid:13)(cid:20)(cid:10)(cid:11,Unknown,2228.0
Unknown,Unknown,24,Unknown,Unknown,Unknown,Unknown,cid:10)(cid:13)(cid:20)(cid:10)(cid:11,Unknown,2252.0
Unknown,Unknown,1,Unknown,Unknown,Unknown,Unknown,cid:10)(cid:13)(cid:20)(cid:10)(cid:11,Unknown,2253.0
Unknown,Unknown,11,Unknown,Unknown,Unknown,Unknown,cid:10)(cid:13)(cid:20)(cid:10)(cid:11,Unknown,2264.0
Unknown,Unknown,25,Unknown,Unknown,Unknown,Unknown,cid:10)(cid:13)(cid:20)(cid:10)(cid:11,Unknown,2289.0
Unknown,Unknown,12,Unknown,Unknown,Unknown,Unknown,cid:10)(cid:13)(cid:20)(cid:10)(cid:11,Unknown,2301.0
Unknown,Unknown,10,Unknown,Unknown,Unknown,Unknown,cid:10)(cid:13)(cid:20)(cid:10)(cid:11,Unknown,2311.0
Unknown,Unknown,1,Unknown,Unknown,Unknown,Unknown,cid:10)(cid:13)(cid:20)(cid:10)(cid:11,Unknown,2312.0
Unknown,Unknown,26,Unknown,Unknown,Unknown,Unknown,cid:10)(cid:13)(cid:20)(cid:10)(cid:11,Unknown,2338.0
Unknown,Unknown,10,Unknown,Unknown,Unknown,Unknown,cid:10)(cid:13)(cid:20)(cid:10)(cid:11,Unknown,2348.0
Unknown,Unknown,13,Unknown,Unknown,Unknown,Unknown,cid:10)(cid:13)(cid:20)(cid:10)(cid:11,Unknown,2361.0
Unknown,Unknown,20,Unknown,Unknown,Unknown,Unknown,cid:10)(cid:13)(cid:20)(cid:10)(cid:11,Unknown,2381.0
Unknown,Unknown,10,Unknown,Unknown,Unknown,Unknown,cid:10)(cid:13)(cid:20)(cid:10)(cid:11,Unknown,2391.0
Unknown,Unknown,11,Unknown,Unknown,Unknown,Unknown,cid:10)(cid:13)(cid:20)(cid:10)(cid:11,Unknown,2402.0
Unknown,Unknown,14,Unknown,Unknown,Unknown,Unknown,cid:10)(cid:13)(cid:20)(cid:10)(cid:11,Unknown,2416.0
Unknown,Unknown,21,Unknown,Unknown,Unknown,Unknown,cid:10)(cid:13)(cid:20)(cid:10)(cid:11,Unknown,2437.0
Unknown,Unknown,22,Unknown,Unknown,Unknown,Unknown,cid:10)(cid:13)(cid:20)(cid:10)(cid:11,Unknown,2459.0
Unknown,Unknown,23,Unknown,Unknown,Unknown,Unknown,cid:10)(cid:13)(cid:20)(cid:10)(cid:11,Unknown,2482.0
Unknown,Unknown,21,Unknown,Unknown,Unknown,Unknown,cid:10)(cid:13)(cid:20)(cid:10)(cid:11,Unknown,2503.0
Unknown,Unknown,24,Unknown,Unknown,Unknown,Unknown,cid:10)(cid:13)(cid:20)(cid:10)(cid:11,Unknown,2527.0
Unknown,Unknown,1,Unknown,Unknown,Unknown,Unknown,cid:10)(cid:13)(cid:20)(cid:10)(cid:11,Unknown,2528.0
Unknown,Unknown,11,Unknown,Unknown,Unknown,Unknown,cid:10)(cid:13)(cid:20)(cid:10)(cid:11,Unknown,2539.0
Unknown,Unknown,25,Unknown,Unknown,Unknown,Unknown,cid:10)(cid:13)(cid:20)(cid:10)(cid:11,Unknown,2564.0
Unknown,Unknown,12,Unknown,Unknown,Unknown,Unknown,cid:10)(cid:13)(cid:20)(cid:10)(cid:11,Unknown,2576.0
Unknown,Unknown,10,Unknown,Unknown,Unknown,Unknown,cid:10)(cid:13)(cid:20)(cid:10)(cid:11,Unknown,2586.0
Unknown,Unknown,1,Unknown,Unknown,Unknown,Unknown,cid:10)(cid:13)(cid:20)(cid:10)(cid:11,Unknown,2587.0
Unknown,Unknown,26,Unknown,Unknown,Unknown,Unknown,cid:10)(cid:13)(cid:20)(cid:10)(cid:11,Unknown,2613.0
Unknown,Unknown,10,Unknown,Unknown,Unknown,Unknown,cid:10)(cid:13)(cid:20)(cid:10)(cid:11,Unknown,2623.0
Unknown,Unknown,13,Unknown,Unknown,Unknown,Unknown,cid:10)(cid:13)(cid:20)(cid:10)(cid:11,Unknown,2636.0
Unknown,Unknown,20,Unknown,Unknown,Unknown,Unknown,cid:10)(cid:13)(cid:20)(cid:10)(cid:11,Unknown,2656.0
Unknown,Unknown,10,Unknown,Unknown,Unknown,Unknown,cid:10)(cid:13)(cid:20)(cid:10)(cid:11,Unknown,2666.0
Unknown,Unknown,11,Unknown,Unknown,Unknown,Unknown,cid:10)(cid:13)(cid:20)(cid:10)(cid:11,Unknown,2677.0
Unknown,Unknown,14,Unknown,Unknown,Unknown,Unknown,cid:10)(cid:13)(cid:20)(cid:10)(cid:11,Unknown,2691.0
Unknown,Unknown,21,Unknown,Unknown,Unknown,Unknown,cid:10)(cid:13)(cid:20)(cid:10)(cid:11,Unknown,2712.0
Unknown,Unknown,22,Unknown,Unknown,Unknown,Unknown,cid:10)(cid:13)(cid:20)(cid:10)(cid:11,Unknown,2734.0
Unknown,Unknown,23,Unknown,Unknown,Unknown,Unknown,cid:10)(cid:13)(cid:20)(cid:10)(cid:11,Unknown,2757.0
Unknown,Unknown,21,Unknown,Unknown,Unknown,Unknown,cid:10)(cid:13)(cid:20)(cid:10)(cid:11,Unknown,2778.0
Unknown,Unknown,24,Unknown,Unknown,Unknown,Unknown,cid:10)(cid:13)(cid:20)(cid:10)(cid:11,Unknown,2802.0
Unknown,Unknown,1,Unknown,Unknown,Unknown,Unknown,cid:10)(cid:13)(cid:20)(cid:10)(cid:11,Unknown,2803.0
Unknown,Unknown,11,Unknown,Unknown,Unknown,Unknown,cid:10)(cid:13)(cid:20)(cid:10)(cid:11,Unknown,2814.0
Unknown,Unknown,25,Unknown,Unknown,Unknown,Unknown,cid:10)(cid:13)(cid:20)(cid:10)(cid:11,Unknown,2839.0
Unknown,Unknown,12,Unknown,Unknown,Unknown,Unknown,cid:10)(cid:13)(cid:20)(cid:10)(cid:11,Unknown,2851.0
Unknown,Unknown,10,Unknown,Unknown,Unknown,Unknown,cid:10)(cid:13)(cid:20)(cid:10)(cid:11,Unknown,2861.0
Unknown,Unknown,1,Unknown,Unknown,Unknown,Unknown,cid:10)(cid:13)(cid:20)(cid:10)(cid:11,Unknown,2862.0
Unknown,Unknown,26,Unknown,Unknown,Unknown,Unknown,cid:10)(cid:13)(cid:20)(cid:10)(cid:11,Unknown,2888.0
Unknown,Unknown,10,Unknown,Unknown,Unknown,Unknown,cid:10)(cid:13)(cid:20)(cid:10)(cid:11,Unknown,2898.0
Unknown,Unknown,13,Unknown,Unknown,Unknown,Unknown,cid:10)(cid:13)(cid:20)(cid:10)(cid:11,Unknown,2911.0
Unknown,Unknown,20,Unknown,Unknown,Unknown,Unknown,cid:10)(cid:13)(cid:20)(cid:10)(cid:11,Unknown,2931.0
Unknown,Unknown,10,Unknown,Unknown,Unknown,Unknown,cid:10)(cid:13)(cid:20)(cid:10)(cid:11,Unknown,2941.0
Unknown,Unknown,11,Unknown,Unknown,Unknown,Unknown,cid:10)(cid:13)(cid:20)(cid:10)(cid:11,Unknown,2952.0
Unknown,Unknown,14,Unknown,Unknown,Unknown,Unknown,cid:10)(cid:13)(cid:20)(cid:10)(cid:11,Unknown,2966.0
Unknown,Unknown,21,Unknown,Unknown,Unknown,Unknown,cid:10)(cid:13)(cid:20)(cid:10)(cid:11,Unknown,2987.0
Unknown,Unknown,22,Unknown,Unknown,Unknown,Unknown,cid:10)(cid:13)(cid:20)(cid:10)(cid:11,Unknown,3009.0
Unknown,Unknown,23,Unknown,Unknown,Unknown,Unknown,cid:10)(cid:13)(cid:20)(cid:10)(cid:11,Unknown,3032.0
Unknown,Unknown,21,Unknown,Unknown,Unknown,Unknown,cid:10)(cid:13)(cid:20)(cid:10)(cid:11,Unknown,3053.0
Unknown,Unknown,24,Unknown,Unknown,Unknown,Unknown,cid:10)(cid:13)(cid:20)(cid:10)(cid:11,Unknown,3077.0
Unknown,Unknown,1,Unknown,Unknown,Unknown,Unknown,cid:10)(cid:13)(cid:20)(cid:10)(cid:11,Unknown,3078.0
Unknown,Unknown,11,Unknown,Unknown,Unknown,Unknown,cid:10)(cid:13)(cid:20)(cid:10)(cid:11,Unknown,3089.0
Unknown,Unknown,25,Unknown,Unknown,Unknown,Unknown,cid:10)(cid:13)(cid:20)(cid:10)(cid:11,Unknown,3114.0
Unknown,Unknown,12,Unknown,Unknown,Unknown,Unknown,cid:10)(cid:13)(cid:20)(cid:10)(cid:11,Unknown,3126.0
Unknown,Unknown,10,Unknown,Unknown,Unknown,Unknown,cid:10)(cid:13)(cid:20)(cid:10)(cid:11,Unknown,3136.0
Unknown,Unknown,1,Unknown,Unknown,Unknown,Unknown,cid:10)(cid:13)(cid:20)(cid:10)(cid:11,Unknown,3137.0
Unknown,Unknown,26,Unknown,Unknown,Unknown,Unknown,cid:10)(cid:13)(cid:20)(cid:10)(cid:11,Unknown,3163.0
Unknown,Unknown,35,Unknown,Unknown,Unknown,Unknown,cid:10)(cid:13)(cid:20)(cid:10)(cid:11,Unknown,3198.0
Unknown,Unknown,42,Unknown,Unknown,Unknown,Unknown,cid:10)(cid:13)(cid:20)(cid:10)(cid:11,Unknown,3240.0
Unknown,Unknown,28,Unknown,Unknown,Unknown,Unknown,cid:10)(cid:13)(cid:20)(cid:10)(cid:11,Unknown,3268.0
Unknown,Unknown,1,Unknown,Unknown,Unknown,Unknown,cid:10)(cid:13)(cid:20)(cid:10)(cid:11,Unknown,3269.0
Unknown,Unknown,28,Unknown,Unknown,Unknown,Unknown,cid:10)(cid:13)(cid:20)(cid:10)(cid:11,Unknown,3297.0
Unknown,Unknown,27,Unknown,Unknown,Unknown,Unknown,cid:10)(cid:13)(cid:20)(cid:10)(cid:11,Unknown,3324.0
Unknown,Unknown,29,Unknown,Unknown,Unknown,Unknown,cid:10)(cid:13)(cid:20)(cid:10)(cid:11,Unknown,3353.0
Unknown,Unknown,27,Unknown,Unknown,Unknown,Unknown,cid:10)(cid:13)(cid:20)(cid:10)(cid:11,Unknown,3380.0
Unknown,Unknown,40,Unknown,Unknown,Unknown,Unknown,cid:10)(cid:13)(cid:20)(cid:10)(cid:11,Unknown,3420.0
Unknown,Unknown,31,Unknown,Unknown,Unknown,Unknown,cid:10)(cid:13)(cid:20)(cid:10)(cid:11,Unknown,3451.0
Unknown,Unknown,36,Unknown,Unknown,Unknown,Unknown,cid:10)(cid:13)(cid:20)(cid:10)(cid:11,Unknown,3487.0
Unknown,Unknown,1,Unknown,Unknown,Unknown,Unknown,cid:10)(cid:13)(cid:20)(cid:10)(cid:11,Unknown,3488.0
Unknown,Unknown,37,Unknown,Unknown,Unknown,Unknown,cid:10)(cid:13)(cid:20)(cid:10)(cid:11,Unknown,3525.0
Unknown,Unknown,17,Unknown,Unknown,Unknown,Unknown,cid:10)(cid:13)(cid:20)(cid:10)(cid:11,Unknown,3542.0
Unknown,Unknown,30,Unknown,Unknown,Unknown,Unknown,cid:10)(cid:13)(cid:20)(cid:10)(cid:11,Unknown,3572.0
Unknown,Unknown,36,Unknown,Unknown,Unknown,Unknown,cid:10)(cid:13)(cid:20)(cid:10)(cid:11,Unknown,3608.0
Unknown,Unknown,36,Unknown,Unknown,Unknown,Unknown,cid:10)(cid:13)(cid:20)(cid:10)(cid:11,Unknown,3644.0
Unknown,Unknown,38,Unknown,Unknown,Unknown,Unknown,cid:10)(cid:13)(cid:20)(cid:10)(cid:11,Unknown,3682.0
Unknown,Unknown,1,Unknown,Unknown,Unknown,Unknown,cid:10)(cid:13)(cid:20)(cid:10)(cid:11,Unknown,3683.0
Unknown,Unknown,28,Unknown,Unknown,Unknown,Unknown,cid:10)(cid:13)(cid:20)(cid:10)(cid:11,Unknown,3711.0
Unknown,Unknown,31,Unknown,Unknown,Unknown,Unknown,cid:10)(cid:13)(cid:20)(cid:10)(cid:11,Unknown,3742.0
Unknown,Unknown,1,Unknown,Unknown,Unknown,Unknown,cid:10)(cid:13)(cid:20)(cid:10)(cid:11,Unknown,3743.0
Unknown,Unknown,35,Unknown,Unknown,Unknown,Unknown,cid:10)(cid:13)(cid:20)(cid:10)(cid:11,Unknown,3778.0
Unknown,Unknown,42,Unknown,Unknown,Unknown,Unknown,cid:10)(cid:13)(cid:20)(cid:10)(cid:11,Unknown,3820.0
Unknown,Unknown,27,Unknown,Unknown,Unknown,Unknown,cid:10)(cid:13)(cid:20)(cid:10)(cid:11,Unknown,3847.0
Unknown,Unknown,1,Unknown,Unknown,Unknown,Unknown,cid:10)(cid:13)(cid:20)(cid:10)(cid:11,Unknown,3848.0
Unknown,Unknown,2,Unknown,Unknown,Unknown,Unknown,cid:10)(cid:13)(cid:20)(cid:10)(cid:11,Unknown,3850.0
Unknown,Unknown,3,Unknown,Unknown,Unknown,Unknown,cid:10)(cid:13)(cid:20)(cid:10)(cid:11,Unknown,3853.0
Unknown,Unknown,10,Unknown,Unknown,Unknown,Unknown,cid:10)(cid:13)(cid:20)(cid:10)(cid:11,Unknown,3863.0
Unknown,Unknown,13,Unknown,Unknown,Unknown,Unknown,cid:10)(cid:13)(cid:20)(cid:10)(cid:11,Unknown,3876.0
Unknown,Unknown,20,Unknown,Unknown,Unknown,Unknown,cid:10)(cid:13)(cid:20)(cid:10)(cid:11,Unknown,3896.0
Unknown,Unknown,10,Unknown,Unknown,Unknown,Unknown,cid:10)(cid:13)(cid:20)(cid:10)(cid:11,Unknown,3906.0
Unknown,Unknown,11,Unknown,Unknown,Unknown,Unknown,cid:10)(cid:13)(cid:20)(cid:10)(cid:11,Unknown,3917.0
Unknown,Unknown,24,Unknown,Unknown,Unknown,Unknown,cid:10)(cid:13)(cid:20)(cid:10)(cid:11,Unknown,3941.0
Unknown,Unknown,1,Unknown,Unknown,Unknown,Unknown,cid:10)(cid:13)(cid:20)(cid:10)(cid:11,Unknown,3942.0
Unknown,Unknown,11,Unknown,Unknown,Unknown,Unknown,cid:10)(cid:13)(cid:20)(cid:10)(cid:11,Unknown,3953.0
Unknown,Unknown,10,Unknown,Unknown,Unknown,Unknown,cid:10)(cid:13)(cid:20)(cid:10)(cid:11,Unknown,3963.0
Unknown,Unknown,25,Unknown,Unknown,Unknown,Unknown,cid:10)(cid:13)(cid:20)(cid:10)(cid:11,Unknown,3988.0
Unknown,Unknown,10,Unknown,Unknown,Unknown,Unknown,cid:10)(cid:13)(cid:20)(cid:10)(cid:11,Unknown,3998.0
Unknown,Unknown,10,Unknown,Unknown,Unknown,Unknown,cid:10)(cid:13)(cid:20)(cid:10)(cid:11,Unknown,4008.0
Unknown,Unknown,1,Unknown,Unknown,Unknown,Unknown,cid:10)(cid:13)(cid:20)(cid:10)(cid:11,Unknown,4009.0
Unknown,Unknown,26,Unknown,Unknown,Unknown,Unknown,cid:10)(cid:13)(cid:20)(cid:10)(cid:11,Unknown,4035.0
Unknown,Unknown,45,Unknown,Unknown,Unknown,Unknown,cid:10)(cid:13)(cid:20)(cid:10)(cid:11,Unknown,4080.0
Unknown,Unknown,10,Unknown,Unknown,Unknown,Unknown,cid:10)(cid:13)(cid:20)(cid:10)(cid:11,Unknown,4090.0
Unknown,Unknown,19,Unknown,Unknown,Unknown,Unknown,cid:10)(cid:13)(cid:20)(cid:10)(cid:11,Unknown,4109.0
Unknown,Unknown,16,Unknown,Unknown,Unknown,Unknown,cid:10)(cid:13)(cid:20)(cid:10)(cid:11,Unknown,4125.0
Unknown,Unknown,7,Unknown,Unknown,Unknown,Unknown,cid:10)(cid:13)(cid:20)(cid:10)(cid:11,Unknown,4132.0
Unknown,Unknown,3,Unknown,Unknown,Unknown,Unknown,cid:10)(cid:13)(cid:20)(cid:10)(cid:11,Unknown,4135.0
Unknown,Unknown,8,Unknown,Unknown,Unknown,Unknown,cid:10)(cid:13)(cid:20)(cid:10)(cid:11,Unknown,4143.0
Unknown,Unknown,28,Unknown,Unknown,Unknown,Unknown,cid:10)(cid:13)(cid:20)(cid:10)(cid:11,Unknown,4171.0
Unknown,Unknown,10,Unknown,Unknown,Unknown,Unknown,cid:10)(cid:13)(cid:20)(cid:10)(cid:11,Unknown,4181.0
Unknown,Unknown,3,Unknown,Unknown,Unknown,Unknown,cid:10)(cid:13)(cid:20)(cid:10)(cid:11,Unknown,4184.0
Unknown,Unknown,6,Unknown,Unknown,Unknown,Unknown,cid:10)(cid:13)(cid:20)(cid:10)(cid:11,Unknown,4190.0
Unknown,Unknown,8,Unknown,Unknown,Unknown,Unknown,cid:10)(cid:13)(cid:20)(cid:10)(cid:11,Unknown,4198.0
Unknown,Unknown,46,Unknown,Unknown,Unknown,Unknown,cid:10)(cid:13)(cid:20)(cid:10)(cid:11,Unknown,4244.0
Unknown,Unknown,46,Unknown,Unknown,Unknown,Unknown,cid:10)(cid:13)(cid:20)(cid:10)(cid:11,Unknown,4290.0
Unknown,Unknown,47,Unknown,Unknown,Unknown,Unknown,cid:10)(cid:13)(cid:20)(cid:10)(cid:11,Unknown,4337.0
Unknown,Unknown,32,Unknown,Unknown,Unknown,Unknown,cid:10)(cid:13)(cid:20)(cid:10)(cid:11,Unknown,4369.0
Unknown,Unknown,48,Unknown,Unknown,Unknown,Unknown,cid:10)(cid:13)(cid:20)(cid:10)(cid:11,Unknown,4417.0
Unknown,Unknown,49,Unknown,Unknown,Unknown,Unknown,cid:10)(cid:13)(cid:20)(cid:10)(cid:11,Unknown,4466.0
Unknown,Unknown,27,Unknown,Unknown,Unknown,Unknown,cid:10)(cid:13)(cid:20)(cid:10)(cid:11,Unknown,4493.0
Unknown,Unknown,18,Unknown,Unknown,Unknown,Unknown,cid:10)(cid:13)(cid:20)(cid:10)(cid:11,Unknown,4511.0
Unknown,Unknown,3,Unknown,Unknown,Unknown,Unknown,cid:10)(cid:13)(cid:20)(cid:10)(cid:11,Unknown,4514.0
Unknown,Unknown,3,Unknown,Unknown,Unknown,Unknown,cid:10)(cid:13)(cid:20)(cid:10)(cid:11,Unknown,4517.0
Unknown,Unknown,1,Unknown,Unknown,Unknown,Unknown,cid:10)(cid:13)(cid:20)(cid:10)(cid:11,Unknown,4518.0
Unknown,Unknown,36,Unknown,Unknown,Unknown,Unknown,cid:10)(cid:13)(cid:20)(cid:10)(cid:11,Unknown,4554.0
Unknown,Unknown,16,Unknown,Unknown,Unknown,Unknown,cid:10)(cid:13)(cid:20)(cid:10)(cid:11,Unknown,4570.0
Unknown,Unknown,1,Unknown,Unknown,Unknown,Unknown,cid:10)(cid:13)(cid:20)(cid:10)(cid:11,Unknown,4571.0
Unknown,Unknown,27,Unknown,Unknown,Unknown,Unknown,cid:10)(cid:13)(cid:20)(cid:10)(cid:11,Unknown,4598.0
Unknown,Unknown,18,Unknown,Unknown,Unknown,Unknown,cid:10)(cid:13)(cid:20)(cid:10)(cid:11,Unknown,4616.0
Unknown,Unknown,17,Unknown,Unknown,Unknown,Unknown,cid:10)(cid:13)(cid:20)(cid:10)(cid:11,Unknown,4633.0
Unknown,Unknown,28,Unknown,Unknown,Unknown,Unknown,cid:10)(cid:13)(cid:20)(cid:10)(cid:11,Unknown,4661.0
Unknown,Unknown,28,Unknown,Unknown,Unknown,Unknown,cid:10)(cid:13)(cid:20)(cid:10)(cid:11,Unknown,4689.0
Unknown,Unknown,30,Unknown,Unknown,Unknown,Unknown,cid:10)(cid:13)(cid:20)(cid:10)(cid:11,Unknown,4719.0
Unknown,Unknown,15,Unknown,Unknown,Unknown,Unknown,cid:10)(cid:13)(cid:20)(cid:10)(cid:11,Unknown,4734.0
Unknown,Unknown,27,Unknown,Unknown,Unknown,Unknown,cid:10)(cid:13)(cid:20)(cid:10)(cid:11,Unknown,4761.0
Unknown,Unknown,30,Unknown,Unknown,Unknown,Unknown,cid:10)(cid:13)(cid:20)(cid:10)(cid:11,Unknown,4791.0
Unknown,Unknown,3,Unknown,Unknown,Unknown,Unknown,cid:10)(cid:13)(cid:20)(cid:10)(cid:11,Unknown,4794.0
Unknown,Unknown,1,Unknown,Unknown,Unknown,Unknown,cid:10)(cid:13)(cid:20)(cid:10)(cid:11,Unknown,4795.0
Unknown,Unknown,2,Unknown,Unknown,Unknown,Unknown,cid:10)(cid:13)(cid:20)(cid:10)(cid:11,Unknown,4797.0
Unknown,Unknown,3,Unknown,Unknown,Unknown,Unknown,cid:10)(cid:13)(cid:20)(cid:10)(cid:11,Unknown,4800.0
Unknown,Unknown,10,Unknown,Unknown,Unknown,Unknown,cid:10)(cid:13)(cid:20)(cid:10)(cid:11,Unknown,4810.0
Unknown,Unknown,13,Unknown,Unknown,Unknown,Unknown,cid:10)(cid:13)(cid:20)(cid:10)(cid:11,Unknown,4823.0
Unknown,Unknown,20,Unknown,Unknown,Unknown,Unknown,cid:10)(cid:13)(cid:20)(cid:10)(cid:11,Unknown,4843.0
Unknown,Unknown,10,Unknown,Unknown,Unknown,Unknown,cid:10)(cid:13)(cid:20)(cid:10)(cid:11,Unknown,4853.0
Unknown,Unknown,11,Unknown,Unknown,Unknown,Unknown,cid:10)(cid:13)(cid:20)(cid:10)(cid:11,Unknown,4864.0
Unknown,Unknown,24,Unknown,Unknown,Unknown,Unknown,cid:10)(cid:13)(cid:20)(cid:10)(cid:11,Unknown,4888.0
Unknown,Unknown,1,Unknown,Unknown,Unknown,Unknown,cid:10)(cid:13)(cid:20)(cid:10)(cid:11,Unknown,4889.0
Unknown,Unknown,11,Unknown,Unknown,Unknown,Unknown,cid:10)(cid:13)(cid:20)(cid:10)(cid:11,Unknown,4900.0
Unknown,Unknown,25,Unknown,Unknown,Unknown,Unknown,cid:10)(cid:13)(cid:20)(cid:10)(cid:11,Unknown,4925.0
Unknown,Unknown,9,Unknown,Unknown,Unknown,Unknown,cid:10)(cid:13)(cid:20)(cid:10)(cid:11,Unknown,4934.0
Unknown,Unknown,10,Unknown,Unknown,Unknown,Unknown,cid:10)(cid:13)(cid:20)(cid:10)(cid:11,Unknown,4944.0
Unknown,Unknown,1,Unknown,Unknown,Unknown,Unknown,cid:10)(cid:13)(cid:20)(cid:10)(cid:11,Unknown,4945.0
Unknown,Unknown,26,Unknown,Unknown,Unknown,Unknown,cid:10)(cid:13)(cid:20)(cid:10)(cid:11,Unknown,4971.0
Unknown,Unknown,45,Unknown,Unknown,Unknown,Unknown,cid:10)(cid:13)(cid:20)(cid:10)(cid:11,Unknown,5016.0
Unknown,Unknown,10,Unknown,Unknown,Unknown,Unknown,cid:10)(cid:13)(cid:20)(cid:10)(cid:11,Unknown,5026.0
Unknown,Unknown,19,Unknown,Unknown,Unknown,Unknown,cid:10)(cid:13)(cid:20)(cid:10)(cid:11,Unknown,5045.0
Unknown,Unknown,16,Unknown,Unknown,Unknown,Unknown,cid:10)(cid:13)(cid:20)(cid:10)(cid:11,Unknown,5061.0
Unknown,Unknown,7,Unknown,Unknown,Unknown,Unknown,cid:10)(cid:13)(cid:20)(cid:10)(cid:11,Unknown,5068.0
Unknown,Unknown,3,Unknown,Unknown,Unknown,Unknown,cid:10)(cid:13)(cid:20)(cid:10)(cid:11,Unknown,5071.0
Unknown,Unknown,8,Unknown,Unknown,Unknown,Unknown,cid:10)(cid:13)(cid:20)(cid:10)(cid:11,Unknown,5079.0
Unknown,Unknown,28,Unknown,Unknown,Unknown,Unknown,cid:10)(cid:13)(cid:20)(cid:10)(cid:11,Unknown,5107.0
Unknown,Unknown,10,Unknown,Unknown,Unknown,Unknown,cid:10)(cid:13)(cid:20)(cid:10)(cid:11,Unknown,5117.0
Unknown,Unknown,3,Unknown,Unknown,Unknown,Unknown,cid:10)(cid:13)(cid:20)(cid:10)(cid:11,Unknown,5120.0
Unknown,Unknown,6,Unknown,Unknown,Unknown,Unknown,cid:10)(cid:13)(cid:20)(cid:10)(cid:11,Unknown,5126.0
Unknown,Unknown,8,Unknown,Unknown,Unknown,Unknown,cid:10)(cid:13)(cid:20)(cid:10)(cid:11,Unknown,5134.0
Unknown,Unknown,46,Unknown,Unknown,Unknown,Unknown,cid:10)(cid:13)(cid:20)(cid:10)(cid:11,Unknown,5180.0
Unknown,Unknown,46,Unknown,Unknown,Unknown,Unknown,cid:10)(cid:13)(cid:20)(cid:10)(cid:11,Unknown,5226.0
Unknown,Unknown,47,Unknown,Unknown,Unknown,Unknown,cid:10)(cid:13)(cid:20)(cid:10)(cid:11,Unknown,5273.0
Unknown,Unknown,32,Unknown,Unknown,Unknown,Unknown,cid:10)(cid:13)(cid:20)(cid:10)(cid:11,Unknown,5305.0
Unknown,Unknown,48,Unknown,Unknown,Unknown,Unknown,cid:10)(cid:13)(cid:20)(cid:10)(cid:11,Unknown,5353.0
Unknown,Unknown,49,Unknown,Unknown,Unknown,Unknown,cid:10)(cid:13)(cid:20)(cid:10)(cid:11,Unknown,5402.0
Unknown,Unknown,18,Unknown,Unknown,Unknown,Unknown,cid:10)(cid:13)(cid:20)(cid:10)(cid:11,Unknown,5420.0
Unknown,Unknown,30,Unknown,Unknown,Unknown,Unknown,cid:10)(cid:13)(cid:20)(cid:10)(cid:11,Unknown,5450.0
Unknown,Unknown,43,Unknown,Unknown,Unknown,Unknown,cid:10)(cid:13)(cid:20)(cid:10)(cid:11,Unknown,5493.0
Unknown,Unknown,43,Unknown,Unknown,Unknown,Unknown,cid:10)(cid:13)(cid:20)(cid:10)(cid:11,Unknown,5536.0
Unknown,Unknown,27,Unknown,Unknown,Unknown,Unknown,cid:10)(cid:13)(cid:20)(cid:10)(cid:11,Unknown,5563.0
Unknown,Unknown,1,Unknown,Unknown,Unknown,Unknown,cid:10)(cid:13)(cid:20)(cid:10)(cid:11,Unknown,5564.0
Unknown,Unknown,42,Unknown,Unknown,Unknown,Unknown,cid:10)(cid:13)(cid:20)(cid:10)(cid:11,Unknown,5606.0
Unknown,Unknown,17,Unknown,Unknown,Unknown,Unknown,cid:10)(cid:13)(cid:20)(cid:10)(cid:11,Unknown,5623.0
Unknown,Unknown,16,Unknown,Unknown,Unknown,Unknown,cid:10)(cid:13)(cid:20)(cid:10)(cid:11,Unknown,5639.0
Unknown,Unknown,1,Unknown,Unknown,Unknown,Unknown,cid:10)(cid:13)(cid:20)(cid:10)(cid:11,Unknown,5640.0
Unknown,Unknown,40,Unknown,Unknown,Unknown,Unknown,cid:10)(cid:13)(cid:20)(cid:10)(cid:11,Unknown,5680.0
Unknown,Unknown,3,Unknown,Unknown,Unknown,Unknown,cid:10)(cid:13)(cid:20)(cid:10)(cid:11,Unknown,5683.0
Unknown,Unknown,30,Unknown,Unknown,Unknown,Unknown,cid:10)(cid:13)(cid:20)(cid:10)(cid:11,Unknown,5713.0
Unknown,Unknown,28,Unknown,Unknown,Unknown,Unknown,cid:10)(cid:13)(cid:20)(cid:10)(cid:11,Unknown,5741.0
Unknown,Unknown,28,Unknown,Unknown,Unknown,Unknown,cid:10)(cid:13)(cid:20)(cid:10)(cid:11,Unknown,5769.0
Unknown,Unknown,1,Unknown,Unknown,Unknown,Unknown,cid:10)(cid:13)(cid:20)(cid:10)(cid:11,Unknown,5770.0
Unknown,Unknown,28,Unknown,Unknown,Unknown,Unknown,cid:10)(cid:13)(cid:20)(cid:10)(cid:11,Unknown,5798.0
Unknown,Unknown,27,Unknown,Unknown,Unknown,Unknown,cid:10)(cid:13)(cid:20)(cid:10)(cid:11,Unknown,5825.0
Unknown,Unknown,1,Unknown,Unknown,Unknown,Unknown,cid:10)(cid:13)(cid:20)(cid:10)(cid:11,Unknown,5826.0
Unknown,Unknown,2,Unknown,Unknown,Unknown,Unknown,cid:10)(cid:13)(cid:20)(cid:10)(cid:11,Unknown,5828.0
Unknown,Unknown,31,Unknown,Unknown,Unknown,Unknown,cid:10)(cid:13)(cid:20)(cid:10)(cid:11,Unknown,5859.0
Unknown,Unknown,3,Unknown,Unknown,Unknown,Unknown,cid:10)(cid:13)(cid:20)(cid:10)(cid:11,Unknown,5862.0
Unknown,Unknown,16,Unknown,Unknown,Unknown,Unknown,cid:10)(cid:13)(cid:20)(cid:10)(cid:11,Unknown,5878.0
Unknown,Unknown,31,Unknown,Unknown,Unknown,Unknown,cid:10)(cid:13)(cid:20)(cid:10)(cid:11,Unknown,5909.0
Unknown,Unknown,1,Unknown,Unknown,Unknown,Unknown,cid:10)(cid:13)(cid:20)(cid:10)(cid:11,Unknown,5910.0
Unknown,Unknown,40,Unknown,Unknown,Unknown,Unknown,cid:10)(cid:13)(cid:20)(cid:10)(cid:11,Unknown,5950.0
Unknown,Unknown,27,Unknown,Unknown,Unknown,Unknown,cid:10)(cid:13)(cid:20)(cid:10)(cid:11,Unknown,5977.0
Unknown,Unknown,32,Unknown,Unknown,Unknown,Unknown,cid:10)(cid:13)(cid:20)(cid:10)(cid:11,Unknown,6009.0
Unknown,Unknown,35,Unknown,Unknown,Unknown,Unknown,cid:10)(cid:13)(cid:20)(cid:10)(cid:11,Unknown,6044.0
Unknown,Unknown,1,Unknown,Unknown,Unknown,Unknown,cid:10)(cid:13)(cid:20)(cid:10)(cid:11,Unknown,6045.0
Unknown,Unknown,2,Unknown,Unknown,Unknown,Unknown,cid:10)(cid:13)(cid:20)(cid:10)(cid:11,Unknown,6047.0
Unknown,Unknown,3,Unknown,Unknown,Unknown,Unknown,cid:10)(cid:13)(cid:20)(cid:10)(cid:11,Unknown,6050.0
Unknown,Unknown,10,Unknown,Unknown,Unknown,Unknown,cid:10)(cid:13)(cid:20)(cid:10)(cid:11,Unknown,6060.0
Unknown,Unknown,8,Unknown,Unknown,Unknown,Unknown,cid:10)(cid:13)(cid:20)(cid:10)(cid:11,Unknown,6068.0
Unknown,Unknown,20,Unknown,Unknown,Unknown,Unknown,cid:10)(cid:13)(cid:20)(cid:10)(cid:11,Unknown,6088.0
Unknown,Unknown,10,Unknown,Unknown,Unknown,Unknown,cid:10)(cid:13)(cid:20)(cid:10)(cid:11,Unknown,6098.0
Unknown,Unknown,11,Unknown,Unknown,Unknown,Unknown,cid:10)(cid:13)(cid:20)(cid:10)(cid:11,Unknown,6109.0
Unknown,Unknown,24,Unknown,Unknown,Unknown,Unknown,cid:10)(cid:13)(cid:20)(cid:10)(cid:11,Unknown,6133.0
Unknown,Unknown,1,Unknown,Unknown,Unknown,Unknown,cid:10)(cid:13)(cid:20)(cid:10)(cid:11,Unknown,6134.0
Unknown,Unknown,11,Unknown,Unknown,Unknown,Unknown,cid:10)(cid:13)(cid:20)(cid:10)(cid:11,Unknown,6145.0
Unknown,Unknown,6,Unknown,Unknown,Unknown,Unknown,cid:10)(cid:13)(cid:20)(cid:10)(cid:11,Unknown,6151.0
Unknown,Unknown,25,Unknown,Unknown,Unknown,Unknown,cid:10)(cid:13)(cid:20)(cid:10)(cid:11,Unknown,6176.0
Unknown,Unknown,10,Unknown,Unknown,Unknown,Unknown,cid:10)(cid:13)(cid:20)(cid:10)(cid:11,Unknown,6186.0
Unknown,Unknown,10,Unknown,Unknown,Unknown,Unknown,cid:10)(cid:13)(cid:20)(cid:10)(cid:11,Unknown,6196.0
Unknown,Unknown,1,Unknown,Unknown,Unknown,Unknown,cid:10)(cid:13)(cid:20)(cid:10)(cid:11,Unknown,6197.0
Unknown,Unknown,26,Unknown,Unknown,Unknown,Unknown,cid:10)(cid:13)(cid:20)(cid:10)(cid:11,Unknown,6223.0
Unknown,Unknown,45,Unknown,Unknown,Unknown,Unknown,cid:10)(cid:13)(cid:20)(cid:10)(cid:11,Unknown,6268.0
Unknown,Unknown,10,Unknown,Unknown,Unknown,Unknown,cid:10)(cid:13)(cid:20)(cid:10)(cid:11,Unknown,6278.0
Unknown,Unknown,19,Unknown,Unknown,Unknown,Unknown,cid:10)(cid:13)(cid:20)(cid:10)(cid:11,Unknown,6297.0
Unknown,Unknown,16,Unknown,Unknown,Unknown,Unknown,cid:10)(cid:13)(cid:20)(cid:10)(cid:11,Unknown,6313.0
Unknown,Unknown,7,Unknown,Unknown,Unknown,Unknown,cid:10)(cid:13)(cid:20)(cid:10)(cid:11,Unknown,6320.0
Unknown,Unknown,3,Unknown,Unknown,Unknown,Unknown,cid:10)(cid:13)(cid:20)(cid:10)(cid:11,Unknown,6323.0
Unknown,Unknown,8,Unknown,Unknown,Unknown,Unknown,cid:10)(cid:13)(cid:20)(cid:10)(cid:11,Unknown,6331.0
Unknown,Unknown,28,Unknown,Unknown,Unknown,Unknown,cid:10)(cid:13)(cid:20)(cid:10)(cid:11,Unknown,6359.0
Unknown,Unknown,10,Unknown,Unknown,Unknown,Unknown,cid:10)(cid:13)(cid:20)(cid:10)(cid:11,Unknown,6369.0
Unknown,Unknown,3,Unknown,Unknown,Unknown,Unknown,cid:10)(cid:13)(cid:20)(cid:10)(cid:11,Unknown,6372.0
Unknown,Unknown,6,Unknown,Unknown,Unknown,Unknown,cid:10)(cid:13)(cid:20)(cid:10)(cid:11,Unknown,6378.0
Unknown,Unknown,8,Unknown,Unknown,Unknown,Unknown,cid:10)(cid:13)(cid:20)(cid:10)(cid:11,Unknown,6386.0
Unknown,Unknown,46,Unknown,Unknown,Unknown,Unknown,cid:10)(cid:13)(cid:20)(cid:10)(cid:11,Unknown,6432.0
Unknown,Unknown,46,Unknown,Unknown,Unknown,Unknown,cid:10)(cid:13)(cid:20)(cid:10)(cid:11,Unknown,6478.0
Unknown,Unknown,47,Unknown,Unknown,Unknown,Unknown,cid:10)(cid:13)(cid:20)(cid:10)(cid:11,Unknown,6525.0
Unknown,Unknown,32,Unknown,Unknown,Unknown,Unknown,cid:10)(cid:13)(cid:20)(cid:10)(cid:11,Unknown,6557.0
Unknown,Unknown,48,Unknown,Unknown,Unknown,Unknown,cid:10)(cid:13)(cid:20)(cid:10)(cid:11,Unknown,6605.0
Unknown,Unknown,49,Unknown,Unknown,Unknown,Unknown,cid:10)(cid:13)(cid:20)(cid:10)(cid:11,Unknown,6654.0
Unknown,Unknown,28,Unknown,Unknown,Unknown,Unknown,cid:10)(cid:13)(cid:20)(cid:10)(cid:11,Unknown,6682.0
Unknown,Unknown,27,Unknown,Unknown,Unknown,Unknown,cid:10)(cid:13)(cid:20)(cid:10)(cid:11,Unknown,6709.0
Unknown,Unknown,1,Unknown,Unknown,Unknown,Unknown,cid:10)(cid:13)(cid:20)(cid:10)(cid:11,Unknown,6710.0
Unknown,Unknown,36,Unknown,Unknown,Unknown,Unknown,cid:10)(cid:13)(cid:20)(cid:10)(cid:11,Unknown,6746.0
Unknown,Unknown,32,Unknown,Unknown,Unknown,Unknown,cid:10)(cid:13)(cid:20)(cid:10)(cid:11,Unknown,6778.0
Unknown,Unknown,35,Unknown,Unknown,Unknown,Unknown,cid:10)(cid:13)(cid:20)(cid:10)(cid:11,Unknown,6813.0
Unknown,Unknown,3,Unknown,Unknown,Unknown,Unknown,cid:10)(cid:13)(cid:20)(cid:10)(cid:11,Unknown,6816.0
Unknown,Unknown,31,Unknown,Unknown,Unknown,Unknown,cid:10)(cid:13)(cid:20)(cid:10)(cid:11,Unknown,6847.0
Unknown,Unknown,3,Unknown,Unknown,Unknown,Unknown,cid:10)(cid:13)(cid:20)(cid:10)(cid:11,Unknown,6850.0
Unknown,Unknown,30,Unknown,Unknown,Unknown,Unknown,cid:10)(cid:13)(cid:20)(cid:10)(cid:11,Unknown,6880.0
Unknown,Unknown,31,Unknown,Unknown,Unknown,Unknown,cid:10)(cid:13)(cid:20)(cid:10)(cid:11,Unknown,6911.0
Unknown,Unknown,1,Unknown,Unknown,Unknown,Unknown,cid:10)(cid:13)(cid:20)(cid:10)(cid:11,Unknown,6912.0
Unknown,Unknown,35,Unknown,Unknown,Unknown,Unknown,cid:10)(cid:13)(cid:20)(cid:10)(cid:11,Unknown,6947.0
Unknown,Unknown,17,Unknown,Unknown,Unknown,Unknown,cid:10)(cid:13)(cid:20)(cid:10)(cid:11,Unknown,6964.0
Unknown,Unknown,32,Unknown,Unknown,Unknown,Unknown,cid:10)(cid:13)(cid:20)(cid:10)(cid:11,Unknown,6996.0
Unknown,Unknown,28,Unknown,Unknown,Unknown,Unknown,cid:10)(cid:13)(cid:20)(cid:10)(cid:11,Unknown,7024.0
Unknown,Unknown,17,Unknown,Unknown,Unknown,Unknown,cid:10)(cid:13)(cid:20)(cid:10)(cid:11,Unknown,7041.0
Unknown,Unknown,34,Unknown,Unknown,Unknown,Unknown,cid:10)(cid:13)(cid:20)(cid:10)(cid:11,Unknown,7075.0
Unknown,Unknown,34,Unknown,Unknown,Unknown,Unknown,cid:10)(cid:13)(cid:20)(cid:10)(cid:11,Unknown,7109.0
Unknown,Unknown,30,Unknown,Unknown,Unknown,Unknown,cid:10)(cid:13)(cid:20)(cid:10)(cid:11,Unknown,7139.0
Unknown,Unknown,31,Unknown,Unknown,Unknown,Unknown,cid:10)(cid:13)(cid:20)(cid:10)(cid:11,Unknown,7170.0
Unknown,Unknown,3,Unknown,Unknown,Unknown,Unknown,cid:10)(cid:13)(cid:20)(cid:10)(cid:11,Unknown,7173.0
Unknown,Unknown,36,Unknown,Unknown,Unknown,Unknown,cid:10)(cid:13)(cid:20)(cid:10)(cid:11,Unknown,7209.0
Unknown,Unknown,1,Unknown,Unknown,Unknown,Unknown,cid:10)(cid:13)(cid:20)(cid:10)(cid:11,Unknown,7210.0
Unknown,Unknown,2,Unknown,Unknown,Unknown,Unknown,cid:10)(cid:13)(cid:20)(cid:10)(cid:11,Unknown,7212.0
Unknown,Unknown,3,Unknown,Unknown,Unknown,Unknown,cid:10)(cid:13)(cid:20)(cid:10)(cid:11,Unknown,7215.0
Unknown,Unknown,10,Unknown,Unknown,Unknown,Unknown,cid:10)(cid:13)(cid:20)(cid:10)(cid:11,Unknown,7225.0
Unknown,Unknown,8,Unknown,Unknown,Unknown,Unknown,cid:10)(cid:13)(cid:20)(cid:10)(cid:11,Unknown,7233.0
Unknown,Unknown,20,Unknown,Unknown,Unknown,Unknown,cid:10)(cid:13)(cid:20)(cid:10)(cid:11,Unknown,7253.0
Unknown,Unknown,10,Unknown,Unknown,Unknown,Unknown,cid:10)(cid:13)(cid:20)(cid:10)(cid:11,Unknown,7263.0
Unknown,Unknown,11,Unknown,Unknown,Unknown,Unknown,cid:10)(cid:13)(cid:20)(cid:10)(cid:11,Unknown,7274.0
Unknown,Unknown,24,Unknown,Unknown,Unknown,Unknown,cid:10)(cid:13)(cid:20)(cid:10)(cid:11,Unknown,7298.0
Unknown,Unknown,1,Unknown,Unknown,Unknown,Unknown,cid:10)(cid:13)(cid:20)(cid:10)(cid:11,Unknown,7299.0
Unknown,Unknown,8,Unknown,Unknown,Unknown,Unknown,cid:10)(cid:13)(cid:20)(cid:10)(cid:11,Unknown,7307.0
Unknown,Unknown,5,Unknown,Unknown,Unknown,Unknown,cid:10)(cid:13)(cid:20)(cid:10)(cid:11,Unknown,7312.0
Unknown,Unknown,25,Unknown,Unknown,Unknown,Unknown,cid:10)(cid:13)(cid:20)(cid:10)(cid:11,Unknown,7337.0
Unknown,Unknown,11,Unknown,Unknown,Unknown,Unknown,cid:10)(cid:13)(cid:20)(cid:10)(cid:11,Unknown,7348.0
Unknown,Unknown,10,Unknown,Unknown,Unknown,Unknown,cid:10)(cid:13)(cid:20)(cid:10)(cid:11,Unknown,7358.0
Unknown,Unknown,1,Unknown,Unknown,Unknown,Unknown,cid:10)(cid:13)(cid:20)(cid:10)(cid:11,Unknown,7359.0
Unknown,Unknown,26,Unknown,Unknown,Unknown,Unknown,cid:10)(cid:13)(cid:20)(cid:10)(cid:11,Unknown,7385.0
Unknown,Unknown,45,Unknown,Unknown,Unknown,Unknown,cid:10)(cid:13)(cid:20)(cid:10)(cid:11,Unknown,7430.0
Unknown,Unknown,10,Unknown,Unknown,Unknown,Unknown,cid:10)(cid:13)(cid:20)(cid:10)(cid:11,Unknown,7440.0
Unknown,Unknown,19,Unknown,Unknown,Unknown,Unknown,cid:10)(cid:13)(cid:20)(cid:10)(cid:11,Unknown,7459.0
Unknown,Unknown,16,Unknown,Unknown,Unknown,Unknown,cid:10)(cid:13)(cid:20)(cid:10)(cid:11,Unknown,7475.0
Unknown,Unknown,7,Unknown,Unknown,Unknown,Unknown,cid:10)(cid:13)(cid:20)(cid:10)(cid:11,Unknown,7482.0
Unknown,Unknown,3,Unknown,Unknown,Unknown,Unknown,cid:10)(cid:13)(cid:20)(cid:10)(cid:11,Unknown,7485.0
Unknown,Unknown,8,Unknown,Unknown,Unknown,Unknown,cid:10)(cid:13)(cid:20)(cid:10)(cid:11,Unknown,7493.0
Unknown,Unknown,28,Unknown,Unknown,Unknown,Unknown,cid:10)(cid:13)(cid:20)(cid:10)(cid:11,Unknown,7521.0
Unknown,Unknown,10,Unknown,Unknown,Unknown,Unknown,cid:10)(cid:13)(cid:20)(cid:10)(cid:11,Unknown,7531.0
Unknown,Unknown,3,Unknown,Unknown,Unknown,Unknown,cid:10)(cid:13)(cid:20)(cid:10)(cid:11,Unknown,7534.0
Unknown,Unknown,6,Unknown,Unknown,Unknown,Unknown,cid:10)(cid:13)(cid:20)(cid:10)(cid:11,Unknown,7540.0
Unknown,Unknown,8,Unknown,Unknown,Unknown,Unknown,cid:10)(cid:13)(cid:20)(cid:10)(cid:11,Unknown,7548.0
Unknown,Unknown,46,Unknown,Unknown,Unknown,Unknown,cid:10)(cid:13)(cid:20)(cid:10)(cid:11,Unknown,7594.0
Unknown,Unknown,46,Unknown,Unknown,Unknown,Unknown,cid:10)(cid:13)(cid:20)(cid:10)(cid:11,Unknown,7640.0
Unknown,Unknown,47,Unknown,Unknown,Unknown,Unknown,cid:10)(cid:13)(cid:20)(cid:10)(cid:11,Unknown,7687.0
Unknown,Unknown,32,Unknown,Unknown,Unknown,Unknown,cid:10)(cid:13)(cid:20)(cid:10)(cid:11,Unknown,7719.0
Unknown,Unknown,48,Unknown,Unknown,Unknown,Unknown,cid:10)(cid:13)(cid:20)(cid:10)(cid:11,Unknown,7767.0
Unknown,Unknown,49,Unknown,Unknown,Unknown,Unknown,cid:10)(cid:13)(cid:20)(cid:10)(cid:11,Unknown,7816.0
Unknown,Unknown,36,Unknown,Unknown,Unknown,Unknown,cid:10)(cid:13)(cid:20)(cid:10)(cid:11,Unknown,7852.0
Unknown,Unknown,18,Unknown,Unknown,Unknown,Unknown,cid:10)(cid:13)(cid:20)(cid:10)(cid:11,Unknown,7870.0
Unknown,Unknown,31,Unknown,Unknown,Unknown,Unknown,cid:10)(cid:13)(cid:20)(cid:10)(cid:11,Unknown,7901.0
Unknown,Unknown,31,Unknown,Unknown,Unknown,Unknown,cid:10)(cid:13)(cid:20)(cid:10)(cid:11,Unknown,7932.0
Unknown,Unknown,33,Unknown,Unknown,Unknown,Unknown,cid:10)(cid:13)(cid:20)(cid:10)(cid:11,Unknown,7965.0
Unknown,Unknown,38,Unknown,Unknown,Unknown,Unknown,cid:10)(cid:13)(cid:20)(cid:10)(cid:11,Unknown,8003.0
Unknown,Unknown,10,Unknown,Unknown,Unknown,Unknown,cid:10)(cid:13)(cid:20)(cid:10)(cid:11,Unknown,8013.0
Unknown,Unknown,10,Unknown,Unknown,Unknown,Unknown,cid:10)(cid:13)(cid:20)(cid:10)(cid:11,Unknown,8023.0
Unknown,Unknown,10,Unknown,Unknown,Unknown,Unknown,cid:10)(cid:13)(cid:20)(cid:10)(cid:11,Unknown,8033.0
Unknown,Unknown,10,Unknown,Unknown,Unknown,Unknown,cid:10)(cid:13)(cid:20)(cid:10)(cid:11,Unknown,8043.0
Unknown,Unknown,10,Unknown,Unknown,Unknown,Unknown,cid:10)(cid:13)(cid:20)(cid:10)(cid:11,Unknown,8053.0
Unknown,Unknown,10,Unknown,Unknown,Unknown,Unknown,cid:10)(cid:13)(cid:20)(cid:10)(cid:11,Unknown,8063.0
Unknown,Unknown,11,Unknown,Unknown,Unknown,Unknown,cid:10)(cid:13)(cid:20)(cid:10)(cid:11,Unknown,8074.0
Unknown,Unknown,8,Unknown,Unknown,Unknown,Unknown,cid:10)(cid:13)(cid:20)(cid:10)(cid:11,Unknown,8082.0
Unknown,Unknown,5,Unknown,Unknown,Unknown,Unknown,cid:10)(cid:13)(cid:20)(cid:10)(cid:11,Unknown,8087.0
Unknown,Unknown,1,Unknown,Unknown,Unknown,Unknown,cid:10)(cid:13)(cid:20)(cid:10)(cid:11,Unknown,8088.0
Unknown,Unknown,35,Unknown,Unknown,Unknown,Unknown,cid:10)(cid:13)(cid:20)(cid:10)(cid:11,Unknown,8123.0
Unknown,Unknown,17,Unknown,Unknown,Unknown,Unknown,cid:10)(cid:13)(cid:20)(cid:10)(cid:11,Unknown,8140.0
Unknown,Unknown,32,Unknown,Unknown,Unknown,Unknown,cid:10)(cid:13)(cid:20)(cid:10)(cid:11,Unknown,8172.0
Unknown,Unknown,28,Unknown,Unknown,Unknown,Unknown,cid:10)(cid:13)(cid:20)(cid:10)(cid:11,Unknown,8200.0
Unknown,Unknown,17,Unknown,Unknown,Unknown,Unknown,cid:10)(cid:13)(cid:20)(cid:10)(cid:11,Unknown,8217.0
Unknown,Unknown,34,Unknown,Unknown,Unknown,Unknown,cid:10)(cid:13)(cid:20)(cid:10)(cid:11,Unknown,8251.0
Unknown,Unknown,34,Unknown,Unknown,Unknown,Unknown,cid:10)(cid:13)(cid:20)(cid:10)(cid:11,Unknown,8285.0
Unknown,Unknown,30,Unknown,Unknown,Unknown,Unknown,cid:10)(cid:13)(cid:20)(cid:10)(cid:11,Unknown,8315.0
Unknown,Unknown,31,Unknown,Unknown,Unknown,Unknown,cid:10)(cid:13)(cid:20)(cid:10)(cid:11,Unknown,8346.0
Unknown,Unknown,3,Unknown,Unknown,Unknown,Unknown,cid:10)(cid:13)(cid:20)(cid:10)(cid:11,Unknown,8349.0
Unknown,Unknown,36,Unknown,Unknown,Unknown,Unknown,cid:10)(cid:13)(cid:20)(cid:10)(cid:11,Unknown,8385.0
Unknown,Unknown,1,Unknown,Unknown,Unknown,Unknown,cid:10)(cid:13)(cid:20)(cid:10)(cid:11,Unknown,8386.0
Unknown,Unknown,2,Unknown,Unknown,Unknown,Unknown,cid:10)(cid:13)(cid:20)(cid:10)(cid:11,Unknown,8388.0
Unknown,Unknown,3,Unknown,Unknown,Unknown,Unknown,cid:10)(cid:13)(cid:20)(cid:10)(cid:11,Unknown,8391.0
Unknown,Unknown,10,Unknown,Unknown,Unknown,Unknown,cid:10)(cid:13)(cid:20)(cid:10)(cid:11,Unknown,8401.0
Unknown,Unknown,5,Unknown,Unknown,Unknown,Unknown,cid:10)(cid:13)(cid:20)(cid:10)(cid:11,Unknown,8406.0
Unknown,Unknown,20,Unknown,Unknown,Unknown,Unknown,cid:10)(cid:13)(cid:20)(cid:10)(cid:11,Unknown,8426.0
Unknown,Unknown,10,Unknown,Unknown,Unknown,Unknown,cid:10)(cid:13)(cid:20)(cid:10)(cid:11,Unknown,8436.0
Unknown,Unknown,11,Unknown,Unknown,Unknown,Unknown,cid:10)(cid:13)(cid:20)(cid:10)(cid:11,Unknown,8447.0
Unknown,Unknown,24,Unknown,Unknown,Unknown,Unknown,cid:10)(cid:13)(cid:20)(cid:10)(cid:11,Unknown,8471.0
Unknown,Unknown,1,Unknown,Unknown,Unknown,Unknown,cid:10)(cid:13)(cid:20)(cid:10)(cid:11,Unknown,8472.0
Unknown,Unknown,12,Unknown,Unknown,Unknown,Unknown,cid:10)(cid:13)(cid:20)(cid:10)(cid:11,Unknown,8484.0
Unknown,Unknown,7,Unknown,Unknown,Unknown,Unknown,cid:10)(cid:13)(cid:20)(cid:10)(cid:11,Unknown,8491.0
Unknown,Unknown,4,Unknown,Unknown,Unknown,Unknown,cid:10)(cid:13)(cid:20)(cid:10)(cid:11,Unknown,8495.0
Unknown,Unknown,25,Unknown,Unknown,Unknown,Unknown,cid:10)(cid:13)(cid:20)(cid:10)(cid:11,Unknown,8520.0
Unknown,Unknown,12,Unknown,Unknown,Unknown,Unknown,cid:10)(cid:13)(cid:20)(cid:10)(cid:11,Unknown,8532.0
Unknown,Unknown,11,Unknown,Unknown,Unknown,Unknown,cid:10)(cid:13)(cid:20)(cid:10)(cid:11,Unknown,8543.0
Unknown,Unknown,1,Unknown,Unknown,Unknown,Unknown,cid:10)(cid:13)(cid:20)(cid:10)(cid:11,Unknown,8544.0
Unknown,Unknown,26,Unknown,Unknown,Unknown,Unknown,cid:10)(cid:13)(cid:20)(cid:10)(cid:11,Unknown,8570.0
Unknown,Unknown,45,Unknown,Unknown,Unknown,Unknown,cid:10)(cid:13)(cid:20)(cid:10)(cid:11,Unknown,8615.0
Unknown,Unknown,10,Unknown,Unknown,Unknown,Unknown,cid:10)(cid:13)(cid:20)(cid:10)(cid:11,Unknown,8625.0
Unknown,Unknown,19,Unknown,Unknown,Unknown,Unknown,cid:10)(cid:13)(cid:20)(cid:10)(cid:11,Unknown,8644.0
Unknown,Unknown,16,Unknown,Unknown,Unknown,Unknown,cid:10)(cid:13)(cid:20)(cid:10)(cid:11,Unknown,8660.0
Unknown,Unknown,7,Unknown,Unknown,Unknown,Unknown,cid:10)(cid:13)(cid:20)(cid:10)(cid:11,Unknown,8667.0
Unknown,Unknown,3,Unknown,Unknown,Unknown,Unknown,cid:10)(cid:13)(cid:20)(cid:10)(cid:11,Unknown,8670.0
Unknown,Unknown,8,Unknown,Unknown,Unknown,Unknown,cid:10)(cid:13)(cid:20)(cid:10)(cid:11,Unknown,8678.0
Unknown,Unknown,28,Unknown,Unknown,Unknown,Unknown,cid:10)(cid:13)(cid:20)(cid:10)(cid:11,Unknown,8706.0
Unknown,Unknown,10,Unknown,Unknown,Unknown,Unknown,cid:10)(cid:13)(cid:20)(cid:10)(cid:11,Unknown,8716.0
Unknown,Unknown,3,Unknown,Unknown,Unknown,Unknown,cid:10)(cid:13)(cid:20)(cid:10)(cid:11,Unknown,8719.0
Unknown,Unknown,6,Unknown,Unknown,Unknown,Unknown,cid:10)(cid:13)(cid:20)(cid:10)(cid:11,Unknown,8725.0
Unknown,Unknown,8,Unknown,Unknown,Unknown,Unknown,cid:10)(cid:13)(cid:20)(cid:10)(cid:11,Unknown,8733.0
Unknown,Unknown,46,Unknown,Unknown,Unknown,Unknown,cid:10)(cid:13)(cid:20)(cid:10)(cid:11,Unknown,8779.0
Unknown,Unknown,46,Unknown,Unknown,Unknown,Unknown,cid:10)(cid:13)(cid:20)(cid:10)(cid:11,Unknown,8825.0
Unknown,Unknown,47,Unknown,Unknown,Unknown,Unknown,cid:10)(cid:13)(cid:20)(cid:10)(cid:11,Unknown,8872.0
Unknown,Unknown,32,Unknown,Unknown,Unknown,Unknown,cid:10)(cid:13)(cid:20)(cid:10)(cid:11,Unknown,8904.0
Unknown,Unknown,48,Unknown,Unknown,Unknown,Unknown,cid:10)(cid:13)(cid:20)(cid:10)(cid:11,Unknown,8952.0
Unknown,Unknown,49,Unknown,Unknown,Unknown,Unknown,cid:10)(cid:13)(cid:20)(cid:10)(cid:11,Unknown,9001.0
Unknown,Unknown,33,Unknown,Unknown,Unknown,Unknown,cid:10)(cid:13)(cid:20)(cid:10)(cid:11,Unknown,9034.0
Unknown,Unknown,31,Unknown,Unknown,Unknown,Unknown,cid:10)(cid:13)(cid:20)(cid:10)(cid:11,Unknown,9065.0
Unknown,Unknown,28,Unknown,Unknown,Unknown,Unknown,cid:10)(cid:13)(cid:20)(cid:10)(cid:11,Unknown,9093.0
Unknown,Unknown,30,Unknown,Unknown,Unknown,Unknown,cid:10)(cid:13)(cid:20)(cid:10)(cid:11,Unknown,9123.0
Unknown,Unknown,35,Unknown,Unknown,Unknown,Unknown,cid:10)(cid:13)(cid:20)(cid:10)(cid:11,Unknown,9158.0
Unknown,Unknown,31,Unknown,Unknown,Unknown,Unknown,cid:10)(cid:13)(cid:20)(cid:10)(cid:11,Unknown,9189.0
Unknown,Unknown,36,Unknown,Unknown,Unknown,Unknown,cid:10)(cid:13)(cid:20)(cid:10)(cid:11,Unknown,9225.0
Unknown,Unknown,1,Unknown,Unknown,Unknown,Unknown,cid:10)(cid:13)(cid:20)(cid:10)(cid:11,Unknown,9226.0
Unknown,Unknown,4,Unknown,Unknown,Unknown,Unknown,cid:10)(cid:13)(cid:20)(cid:10)(cid:11,Unknown,9230.0
Unknown,Unknown,4,Unknown,Unknown,Unknown,Unknown,cid:10)(cid:13)(cid:20)(cid:10)(cid:11,Unknown,9234.0
Unknown,Unknown,1,Unknown,Unknown,Unknown,Unknown,cid:10)(cid:13)(cid:20)(cid:10)(cid:11,Unknown,9235.0
Unknown,Unknown,35,Unknown,Unknown,Unknown,Unknown,cid:10)(cid:13)(cid:20)(cid:10)(cid:11,Unknown,9270.0
Unknown,Unknown,17,Unknown,Unknown,Unknown,Unknown,cid:10)(cid:13)(cid:20)(cid:10)(cid:11,Unknown,9287.0
Unknown,Unknown,32,Unknown,Unknown,Unknown,Unknown,cid:10)(cid:13)(cid:20)(cid:10)(cid:11,Unknown,9319.0
Unknown,Unknown,28,Unknown,Unknown,Unknown,Unknown,cid:10)(cid:13)(cid:20)(cid:10)(cid:11,Unknown,9347.0
Unknown,Unknown,17,Unknown,Unknown,Unknown,Unknown,cid:10)(cid:13)(cid:20)(cid:10)(cid:11,Unknown,9364.0
Unknown,Unknown,34,Unknown,Unknown,Unknown,Unknown,cid:10)(cid:13)(cid:20)(cid:10)(cid:11,Unknown,9398.0
Unknown,Unknown,34,Unknown,Unknown,Unknown,Unknown,cid:10)(cid:13)(cid:20)(cid:10)(cid:11,Unknown,9432.0
Unknown,Unknown,30,Unknown,Unknown,Unknown,Unknown,cid:10)(cid:13)(cid:20)(cid:10)(cid:11,Unknown,9462.0
Unknown,Unknown,31,Unknown,Unknown,Unknown,Unknown,cid:10)(cid:13)(cid:20)(cid:10)(cid:11,Unknown,9493.0
Unknown,Unknown,3,Unknown,Unknown,Unknown,Unknown,cid:10)(cid:13)(cid:20)(cid:10)(cid:11,Unknown,9496.0
Unknown,Unknown,36,Unknown,Unknown,Unknown,Unknown,cid:10)(cid:13)(cid:20)(cid:10)(cid:11,Unknown,9532.0
Unknown,Unknown,1,Unknown,Unknown,Unknown,Unknown,cid:10)(cid:13)(cid:20)(cid:10)(cid:11,Unknown,9533.0
Unknown,Unknown,2,Unknown,Unknown,Unknown,Unknown,cid:10)(cid:13)(cid:20)(cid:10)(cid:11,Unknown,9535.0
Unknown,Unknown,3,Unknown,Unknown,Unknown,Unknown,cid:10)(cid:13)(cid:20)(cid:10)(cid:11,Unknown,9538.0
Unknown,Unknown,10,Unknown,Unknown,Unknown,Unknown,cid:10)(cid:13)(cid:20)(cid:10)(cid:11,Unknown,9548.0
Unknown,Unknown,5,Unknown,Unknown,Unknown,Unknown,cid:10)(cid:13)(cid:20)(cid:10)(cid:11,Unknown,9553.0
Unknown,Unknown,20,Unknown,Unknown,Unknown,Unknown,cid:10)(cid:13)(cid:20)(cid:10)(cid:11,Unknown,9573.0
Unknown,Unknown,10,Unknown,Unknown,Unknown,Unknown,cid:10)(cid:13)(cid:20)(cid:10)(cid:11,Unknown,9583.0
Unknown,Unknown,11,Unknown,Unknown,Unknown,Unknown,cid:10)(cid:13)(cid:20)(cid:10)(cid:11,Unknown,9594.0
Unknown,Unknown,24,Unknown,Unknown,Unknown,Unknown,cid:10)(cid:13)(cid:20)(cid:10)(cid:11,Unknown,9618.0
Unknown,Unknown,1,Unknown,Unknown,Unknown,Unknown,cid:10)(cid:13)(cid:20)(cid:10)(cid:11,Unknown,9619.0
Unknown,Unknown,11,Unknown,Unknown,Unknown,Unknown,cid:10)(cid:13)(cid:20)(cid:10)(cid:11,Unknown,9630.0
Unknown,Unknown,8,Unknown,Unknown,Unknown,Unknown,cid:10)(cid:13)(cid:20)(cid:10)(cid:11,Unknown,9638.0
Unknown,Unknown,25,Unknown,Unknown,Unknown,Unknown,cid:10)(cid:13)(cid:20)(cid:10)(cid:11,Unknown,9663.0
Unknown,Unknown,10,Unknown,Unknown,Unknown,Unknown,cid:10)(cid:13)(cid:20)(cid:10)(cid:11,Unknown,9673.0
Unknown,Unknown,10,Unknown,Unknown,Unknown,Unknown,cid:10)(cid:13)(cid:20)(cid:10)(cid:11,Unknown,9683.0
Unknown,Unknown,1,Unknown,Unknown,Unknown,Unknown,cid:10)(cid:13)(cid:20)(cid:10)(cid:11,Unknown,9684.0
Unknown,Unknown,26,Unknown,Unknown,Unknown,Unknown,cid:10)(cid:13)(cid:20)(cid:10)(cid:11,Unknown,9710.0
Unknown,Unknown,45,Unknown,Unknown,Unknown,Unknown,cid:10)(cid:13)(cid:20)(cid:10)(cid:11,Unknown,9755.0
Unknown,Unknown,10,Unknown,Unknown,Unknown,Unknown,cid:10)(cid:13)(cid:20)(cid:10)(cid:11,Unknown,9765.0
Unknown,Unknown,19,Unknown,Unknown,Unknown,Unknown,cid:10)(cid:13)(cid:20)(cid:10)(cid:11,Unknown,9784.0
Unknown,Unknown,16,Unknown,Unknown,Unknown,Unknown,cid:10)(cid:13)(cid:20)(cid:10)(cid:11,Unknown,9800.0
Unknown,Unknown,7,Unknown,Unknown,Unknown,Unknown,cid:10)(cid:13)(cid:20)(cid:10)(cid:11,Unknown,9807.0
Unknown,Unknown,3,Unknown,Unknown,Unknown,Unknown,cid:10)(cid:13)(cid:20)(cid:10)(cid:11,Unknown,9810.0
Unknown,Unknown,8,Unknown,Unknown,Unknown,Unknown,cid:10)(cid:13)(cid:20)(cid:10)(cid:11,Unknown,9818.0
Unknown,Unknown,28,Unknown,Unknown,Unknown,Unknown,cid:10)(cid:13)(cid:20)(cid:10)(cid:11,Unknown,9846.0
Unknown,Unknown,10,Unknown,Unknown,Unknown,Unknown,cid:10)(cid:13)(cid:20)(cid:10)(cid:11,Unknown,9856.0
Unknown,Unknown,3,Unknown,Unknown,Unknown,Unknown,cid:10)(cid:13)(cid:20)(cid:10)(cid:11,Unknown,9859.0
Unknown,Unknown,6,Unknown,Unknown,Unknown,Unknown,cid:10)(cid:13)(cid:20)(cid:10)(cid:11,Unknown,9865.0
Unknown,Unknown,8,Unknown,Unknown,Unknown,Unknown,cid:10)(cid:13)(cid:20)(cid:10)(cid:11,Unknown,9873.0
Unknown,Unknown,46,Unknown,Unknown,Unknown,Unknown,cid:10)(cid:13)(cid:20)(cid:10)(cid:11,Unknown,9919.0
Unknown,Unknown,46,Unknown,Unknown,Unknown,Unknown,cid:10)(cid:13)(cid:20)(cid:10)(cid:11,Unknown,9965.0
Unknown,Unknown,47,Unknown,Unknown,Unknown,Unknown,cid:10)(cid:13)(cid:20)(cid:10)(cid:11,Unknown,10012.0
Unknown,Unknown,32,Unknown,Unknown,Unknown,Unknown,cid:10)(cid:13)(cid:20)(cid:10)(cid:11,Unknown,10044.0
Unknown,Unknown,48,Unknown,Unknown,Unknown,Unknown,cid:10)(cid:13)(cid:20)(cid:10)(cid:11,Unknown,10092.0
Unknown,Unknown,49,Unknown,Unknown,Unknown,Unknown,cid:10)(cid:13)(cid:20)(cid:10)(cid:11,Unknown,10141.0
Unknown,Unknown,34,Unknown,Unknown,Unknown,Unknown,cid:10)(cid:13)(cid:20)(cid:10)(cid:11,Unknown,10175.0
Unknown,Unknown,3,Unknown,Unknown,Unknown,Unknown,cid:10)(cid:13)(cid:20)(cid:10)(cid:11,Unknown,10178.0
Unknown,Unknown,1,Unknown,Unknown,Unknown,Unknown,cid:10)(cid:13)(cid:20)(cid:10)(cid:11,Unknown,10179.0
Unknown,Unknown,37,Unknown,Unknown,Unknown,Unknown,cid:10)(cid:13)(cid:20)(cid:10)(cid:11,Unknown,10216.0
Unknown,Unknown,3,Unknown,Unknown,Unknown,Unknown,cid:10)(cid:13)(cid:20)(cid:10)(cid:11,Unknown,10219.0
Unknown,Unknown,30,Unknown,Unknown,Unknown,Unknown,cid:10)(cid:13)(cid:20)(cid:10)(cid:11,Unknown,10249.0
Unknown,Unknown,35,Unknown,Unknown,Unknown,Unknown,cid:10)(cid:13)(cid:20)(cid:10)(cid:11,Unknown,10284.0
Unknown,Unknown,17,Unknown,Unknown,Unknown,Unknown,cid:10)(cid:13)(cid:20)(cid:10)(cid:11,Unknown,10301.0
Unknown,Unknown,28,Unknown,Unknown,Unknown,Unknown,cid:10)(cid:13)(cid:20)(cid:10)(cid:11,Unknown,10329.0
Unknown,Unknown,27,Unknown,Unknown,Unknown,Unknown,cid:10)(cid:13)(cid:20)(cid:10)(cid:11,Unknown,10356.0
Unknown,Unknown,40,Unknown,Unknown,Unknown,Unknown,cid:10)(cid:13)(cid:20)(cid:10)(cid:11,Unknown,10396.0
Unknown,Unknown,31,Unknown,Unknown,Unknown,Unknown,cid:10)(cid:13)(cid:20)(cid:10)(cid:11,Unknown,10427.0
Unknown,Unknown,1,Unknown,Unknown,Unknown,Unknown,cid:10)(cid:13)(cid:20)(cid:10)(cid:11,Unknown,10428.0
Unknown,Unknown,36,Unknown,Unknown,Unknown,Unknown,cid:10)(cid:13)(cid:20)(cid:10)(cid:11,Unknown,10464.0
Unknown,Unknown,31,Unknown,Unknown,Unknown,Unknown,cid:10)(cid:13)(cid:20)(cid:10)(cid:11,Unknown,10495.0
Unknown,Unknown,18,Unknown,Unknown,Unknown,Unknown,cid:10)(cid:13)(cid:20)(cid:10)(cid:11,Unknown,10513.0
Unknown,Unknown,16,Unknown,Unknown,Unknown,Unknown,cid:10)(cid:13)(cid:20)(cid:10)(cid:11,Unknown,10529.0
Unknown,Unknown,1,Unknown,Unknown,Unknown,Unknown,cid:10)(cid:13)(cid:20)(cid:10)(cid:11,Unknown,10530.0
Unknown,Unknown,36,Unknown,Unknown,Unknown,Unknown,cid:10)(cid:13)(cid:20)(cid:10)(cid:11,Unknown,10566.0
Unknown,Unknown,17,Unknown,Unknown,Unknown,Unknown,cid:10)(cid:13)(cid:20)(cid:10)(cid:11,Unknown,10583.0
Unknown,Unknown,3,Unknown,Unknown,Unknown,Unknown,cid:10)(cid:13)(cid:20)(cid:10)(cid:11,Unknown,10586.0
Unknown,Unknown,16,Unknown,Unknown,Unknown,Unknown,cid:10)(cid:13)(cid:20)(cid:10)(cid:11,Unknown,10602.0
Unknown,Unknown,36,Unknown,Unknown,Unknown,Unknown,cid:10)(cid:13)(cid:20)(cid:10)(cid:11,Unknown,10638.0
Unknown,Unknown,1,Unknown,Unknown,Unknown,Unknown,cid:10)(cid:13)(cid:20)(cid:10)(cid:11,Unknown,10639.0
Unknown,Unknown,2,Unknown,Unknown,Unknown,Unknown,cid:10)(cid:13)(cid:20)(cid:10)(cid:11,Unknown,10641.0
Unknown,Unknown,3,Unknown,Unknown,Unknown,Unknown,cid:10)(cid:13)(cid:20)(cid:10)(cid:11,Unknown,10644.0
Unknown,Unknown,10,Unknown,Unknown,Unknown,Unknown,cid:10)(cid:13)(cid:20)(cid:10)(cid:11,Unknown,10654.0
Unknown,Unknown,5,Unknown,Unknown,Unknown,Unknown,cid:10)(cid:13)(cid:20)(cid:10)(cid:11,Unknown,10659.0
Unknown,Unknown,20,Unknown,Unknown,Unknown,Unknown,cid:10)(cid:13)(cid:20)(cid:10)(cid:11,Unknown,10679.0
Unknown,Unknown,10,Unknown,Unknown,Unknown,Unknown,cid:10)(cid:13)(cid:20)(cid:10)(cid:11,Unknown,10689.0
Unknown,Unknown,11,Unknown,Unknown,Unknown,Unknown,cid:10)(cid:13)(cid:20)(cid:10)(cid:11,Unknown,10700.0
Unknown,Unknown,24,Unknown,Unknown,Unknown,Unknown,cid:10)(cid:13)(cid:20)(cid:10)(cid:11,Unknown,10724.0
Unknown,Unknown,1,Unknown,Unknown,Unknown,Unknown,cid:10)(cid:13)(cid:20)(cid:10)(cid:11,Unknown,10725.0
Unknown,Unknown,13,Unknown,Unknown,Unknown,Unknown,cid:10)(cid:13)(cid:20)(cid:10)(cid:11,Unknown,10738.0
Unknown,Unknown,4,Unknown,Unknown,Unknown,Unknown,cid:10)(cid:13)(cid:20)(cid:10)(cid:11,Unknown,10742.0
Unknown,Unknown,25,Unknown,Unknown,Unknown,Unknown,cid:10)(cid:13)(cid:20)(cid:10)(cid:11,Unknown,10767.0
Unknown,Unknown,13,Unknown,Unknown,Unknown,Unknown,cid:10)(cid:13)(cid:20)(cid:10)(cid:11,Unknown,10780.0
Unknown,Unknown,8,Unknown,Unknown,Unknown,Unknown,cid:10)(cid:13)(cid:20)(cid:10)(cid:11,Unknown,10788.0
Unknown,Unknown,1,Unknown,Unknown,Unknown,Unknown,cid:10)(cid:13)(cid:20)(cid:10)(cid:11,Unknown,10789.0
Unknown,Unknown,26,Unknown,Unknown,Unknown,Unknown,cid:10)(cid:13)(cid:20)(cid:10)(cid:11,Unknown,10815.0
Unknown,Unknown,45,Unknown,Unknown,Unknown,Unknown,cid:10)(cid:13)(cid:20)(cid:10)(cid:11,Unknown,10860.0
Unknown,Unknown,10,Unknown,Unknown,Unknown,Unknown,cid:10)(cid:13)(cid:20)(cid:10)(cid:11,Unknown,10870.0
Unknown,Unknown,19,Unknown,Unknown,Unknown,Unknown,cid:10)(cid:13)(cid:20)(cid:10)(cid:11,Unknown,10889.0
Unknown,Unknown,16,Unknown,Unknown,Unknown,Unknown,cid:10)(cid:13)(cid:20)(cid:10)(cid:11,Unknown,10905.0
Unknown,Unknown,7,Unknown,Unknown,Unknown,Unknown,cid:10)(cid:13)(cid:20)(cid:10)(cid:11,Unknown,10912.0
Unknown,Unknown,3,Unknown,Unknown,Unknown,Unknown,cid:10)(cid:13)(cid:20)(cid:10)(cid:11,Unknown,10915.0
Unknown,Unknown,8,Unknown,Unknown,Unknown,Unknown,cid:10)(cid:13)(cid:20)(cid:10)(cid:11,Unknown,10923.0
Unknown,Unknown,28,Unknown,Unknown,Unknown,Unknown,cid:10)(cid:13)(cid:20)(cid:10)(cid:11,Unknown,10951.0
Unknown,Unknown,10,Unknown,Unknown,Unknown,Unknown,cid:10)(cid:13)(cid:20)(cid:10)(cid:11,Unknown,10961.0
Unknown,Unknown,3,Unknown,Unknown,Unknown,Unknown,cid:10)(cid:13)(cid:20)(cid:10)(cid:11,Unknown,10964.0
Unknown,Unknown,6,Unknown,Unknown,Unknown,Unknown,cid:10)(cid:13)(cid:20)(cid:10)(cid:11,Unknown,10970.0
Unknown,Unknown,8,Unknown,Unknown,Unknown,Unknown,cid:10)(cid:13)(cid:20)(cid:10)(cid:11,Unknown,10978.0
Unknown,Unknown,46,Unknown,Unknown,Unknown,Unknown,cid:10)(cid:13)(cid:20)(cid:10)(cid:11,Unknown,11024.0
Unknown,Unknown,46,Unknown,Unknown,Unknown,Unknown,cid:10)(cid:13)(cid:20)(cid:10)(cid:11,Unknown,11070.0
Unknown,Unknown,47,Unknown,Unknown,Unknown,Unknown,cid:10)(cid:13)(cid:20)(cid:10)(cid:11,Unknown,11117.0
Unknown,Unknown,32,Unknown,Unknown,Unknown,Unknown,cid:10)(cid:13)(cid:20)(cid:10)(cid:11,Unknown,11149.0
Unknown,Unknown,48,Unknown,Unknown,Unknown,Unknown,cid:10)(cid:13)(cid:20)(cid:10)(cid:11,Unknown,11197.0
Unknown,Unknown,49,Unknown,Unknown,Unknown,Unknown,cid:10)(cid:13)(cid:20)(cid:10)(cid:11,Unknown,11246.0
Unknown,Unknown,16,Unknown,Unknown,Unknown,Unknown,cid:10)(cid:13)(cid:20)(cid:10)(cid:11,Unknown,11262.0
Unknown,Unknown,17,Unknown,Unknown,Unknown,Unknown,cid:10)(cid:13)(cid:20)(cid:10)(cid:11,Unknown,11279.0
Unknown,Unknown,16,Unknown,Unknown,Unknown,Unknown,cid:10)(cid:13)(cid:20)(cid:10)(cid:11,Unknown,11295.0
Unknown,Unknown,27,Unknown,Unknown,Unknown,Unknown,cid:10)(cid:13)(cid:20)(cid:10)(cid:11,Unknown,11322.0
Unknown,Unknown,28,Unknown,Unknown,Unknown,Unknown,cid:10)(cid:13)(cid:20)(cid:10)(cid:11,Unknown,11350.0
Unknown,Unknown,1,Unknown,Unknown,Unknown,Unknown,cid:10)(cid:13)(cid:20)(cid:10)(cid:11,Unknown,11351.0
Unknown,Unknown,35,Unknown,Unknown,Unknown,Unknown,cid:10)(cid:13)(cid:20)(cid:10)(cid:11,Unknown,11386.0
Unknown,Unknown,17,Unknown,Unknown,Unknown,Unknown,cid:10)(cid:13)(cid:20)(cid:10)(cid:11,Unknown,11403.0
Unknown,Unknown,32,Unknown,Unknown,Unknown,Unknown,cid:10)(cid:13)(cid:20)(cid:10)(cid:11,Unknown,11435.0
Unknown,Unknown,28,Unknown,Unknown,Unknown,Unknown,cid:10)(cid:13)(cid:20)(cid:10)(cid:11,Unknown,11463.0
Unknown,Unknown,17,Unknown,Unknown,Unknown,Unknown,cid:10)(cid:13)(cid:20)(cid:10)(cid:11,Unknown,11480.0
Unknown,Unknown,34,Unknown,Unknown,Unknown,Unknown,cid:10)(cid:13)(cid:20)(cid:10)(cid:11,Unknown,11514.0
Unknown,Unknown,34,Unknown,Unknown,Unknown,Unknown,cid:10)(cid:13)(cid:20)(cid:10)(cid:11,Unknown,11548.0
Unknown,Unknown,30,Unknown,Unknown,Unknown,Unknown,cid:10)(cid:13)(cid:20)(cid:10)(cid:11,Unknown,11578.0
Unknown,Unknown,31,Unknown,Unknown,Unknown,Unknown,cid:10)(cid:13)(cid:20)(cid:10)(cid:11,Unknown,11609.0
Unknown,Unknown,3,Unknown,Unknown,Unknown,Unknown,cid:10)(cid:13)(cid:20)(cid:10)(cid:11,Unknown,11612.0
Unknown,Unknown,36,Unknown,Unknown,Unknown,Unknown,cid:10)(cid:13)(cid:20)(cid:10)(cid:11,Unknown,11648.0
Unknown,Unknown,1,Unknown,Unknown,Unknown,Unknown,cid:10)(cid:13)(cid:20)(cid:10)(cid:11,Unknown,11649.0
Unknown,Unknown,2,Unknown,Unknown,Unknown,Unknown,cid:10)(cid:13)(cid:20)(cid:10)(cid:11,Unknown,11651.0
Unknown,Unknown,3,Unknown,Unknown,Unknown,Unknown,cid:10)(cid:13)(cid:20)(cid:10)(cid:11,Unknown,11654.0
Unknown,Unknown,10,Unknown,Unknown,Unknown,Unknown,cid:10)(cid:13)(cid:20)(cid:10)(cid:11,Unknown,11664.0
Unknown,Unknown,5,Unknown,Unknown,Unknown,Unknown,cid:10)(cid:13)(cid:20)(cid:10)(cid:11,Unknown,11669.0
Unknown,Unknown,20,Unknown,Unknown,Unknown,Unknown,cid:10)(cid:13)(cid:20)(cid:10)(cid:11,Unknown,11689.0
Unknown,Unknown,10,Unknown,Unknown,Unknown,Unknown,cid:10)(cid:13)(cid:20)(cid:10)(cid:11,Unknown,11699.0
Unknown,Unknown,11,Unknown,Unknown,Unknown,Unknown,cid:10)(cid:13)(cid:20)(cid:10)(cid:11,Unknown,11710.0
Unknown,Unknown,24,Unknown,Unknown,Unknown,Unknown,cid:10)(cid:13)(cid:20)(cid:10)(cid:11,Unknown,11734.0
Unknown,Unknown,1,Unknown,Unknown,Unknown,Unknown,cid:10)(cid:13)(cid:20)(cid:10)(cid:11,Unknown,11735.0
Unknown,Unknown,8,Unknown,Unknown,Unknown,Unknown,cid:10)(cid:13)(cid:20)(cid:10)(cid:11,Unknown,11743.0
Unknown,Unknown,10,Unknown,Unknown,Unknown,Unknown,cid:10)(cid:13)(cid:20)(cid:10)(cid:11,Unknown,11753.0
Unknown,Unknown,25,Unknown,Unknown,Unknown,Unknown,cid:10)(cid:13)(cid:20)(cid:10)(cid:11,Unknown,11778.0
Unknown,Unknown,10,Unknown,Unknown,Unknown,Unknown,cid:10)(cid:13)(cid:20)(cid:10)(cid:11,Unknown,11788.0
Unknown,Unknown,10,Unknown,Unknown,Unknown,Unknown,cid:10)(cid:13)(cid:20)(cid:10)(cid:11,Unknown,11798.0
Unknown,Unknown,1,Unknown,Unknown,Unknown,Unknown,cid:10)(cid:13)(cid:20)(cid:10)(cid:11,Unknown,11799.0
Unknown,Unknown,26,Unknown,Unknown,Unknown,Unknown,cid:10)(cid:13)(cid:20)(cid:10)(cid:11,Unknown,11825.0
Unknown,Unknown,45,Unknown,Unknown,Unknown,Unknown,cid:10)(cid:13)(cid:20)(cid:10)(cid:11,Unknown,11870.0
Unknown,Unknown,10,Unknown,Unknown,Unknown,Unknown,cid:10)(cid:13)(cid:20)(cid:10)(cid:11,Unknown,11880.0
Unknown,Unknown,19,Unknown,Unknown,Unknown,Unknown,cid:10)(cid:13)(cid:20)(cid:10)(cid:11,Unknown,11899.0
Unknown,Unknown,16,Unknown,Unknown,Unknown,Unknown,cid:10)(cid:13)(cid:20)(cid:10)(cid:11,Unknown,11915.0
Unknown,Unknown,7,Unknown,Unknown,Unknown,Unknown,cid:10)(cid:13)(cid:20)(cid:10)(cid:11,Unknown,11922.0
Unknown,Unknown,3,Unknown,Unknown,Unknown,Unknown,cid:10)(cid:13)(cid:20)(cid:10)(cid:11,Unknown,11925.0
Unknown,Unknown,8,Unknown,Unknown,Unknown,Unknown,cid:10)(cid:13)(cid:20)(cid:10)(cid:11,Unknown,11933.0
Unknown,Unknown,28,Unknown,Unknown,Unknown,Unknown,cid:10)(cid:13)(cid:20)(cid:10)(cid:11,Unknown,11961.0
Unknown,Unknown,10,Unknown,Unknown,Unknown,Unknown,cid:10)(cid:13)(cid:20)(cid:10)(cid:11,Unknown,11971.0
Unknown,Unknown,3,Unknown,Unknown,Unknown,Unknown,cid:10)(cid:13)(cid:20)(cid:10)(cid:11,Unknown,11974.0
Unknown,Unknown,6,Unknown,Unknown,Unknown,Unknown,cid:10)(cid:13)(cid:20)(cid:10)(cid:11,Unknown,11980.0
Unknown,Unknown,8,Unknown,Unknown,Unknown,Unknown,cid:10)(cid:13)(cid:20)(cid:10)(cid:11,Unknown,11988.0
Unknown,Unknown,46,Unknown,Unknown,Unknown,Unknown,cid:10)(cid:13)(cid:20)(cid:10)(cid:11,Unknown,12034.0
Unknown,Unknown,46,Unknown,Unknown,Unknown,Unknown,cid:10)(cid:13)(cid:20)(cid:10)(cid:11,Unknown,12080.0
Unknown,Unknown,47,Unknown,Unknown,Unknown,Unknown,cid:10)(cid:13)(cid:20)(cid:10)(cid:11,Unknown,12127.0
Unknown,Unknown,32,Unknown,Unknown,Unknown,Unknown,cid:10)(cid:13)(cid:20)(cid:10)(cid:11,Unknown,12159.0
Unknown,Unknown,48,Unknown,Unknown,Unknown,Unknown,cid:10)(cid:13)(cid:20)(cid:10)(cid:11,Unknown,12207.0
Unknown,Unknown,49,Unknown,Unknown,Unknown,Unknown,cid:10)(cid:13)(cid:20)(cid:10)(cid:11,Unknown,12256.0
Unknown,Unknown,28,Unknown,Unknown,Unknown,Unknown,cid:10)(cid:13)(cid:20)(cid:10)(cid:11,Unknown,12284.0
Unknown,Unknown,27,Unknown,Unknown,Unknown,Unknown,cid:10)(cid:13)(cid:20)(cid:10)(cid:11,Unknown,12311.0
Unknown,Unknown,1,Unknown,Unknown,Unknown,Unknown,cid:10)(cid:13)(cid:20)(cid:10)(cid:11,Unknown,12312.0
Unknown,Unknown,35,Unknown,Unknown,Unknown,Unknown,cid:10)(cid:13)(cid:20)(cid:10)(cid:11,Unknown,12347.0
Unknown,Unknown,30,Unknown,Unknown,Unknown,Unknown,cid:10)(cid:13)(cid:20)(cid:10)(cid:11,Unknown,12377.0
Unknown,Unknown,29,Unknown,Unknown,Unknown,Unknown,cid:10)(cid:13)(cid:20)(cid:10)(cid:11,Unknown,12406.0
Unknown,Unknown,31,Unknown,Unknown,Unknown,Unknown,cid:10)(cid:13)(cid:20)(cid:10)(cid:11,Unknown,12437.0
Unknown,Unknown,16,Unknown,Unknown,Unknown,Unknown,cid:10)(cid:13)(cid:20)(cid:10)(cid:11,Unknown,12453.0
Unknown,Unknown,16,Unknown,Unknown,Unknown,Unknown,cid:10)(cid:13)(cid:20)(cid:10)(cid:11,Unknown,12469.0
Unknown,Unknown,31,Unknown,Unknown,Unknown,Unknown,cid:10)(cid:13)(cid:20)(cid:10)(cid:11,Unknown,12500.0
Unknown,Unknown,1,Unknown,Unknown,Unknown,Unknown,cid:10)(cid:13)(cid:20)(cid:10)(cid:11,Unknown,12501.0
Unknown,Unknown,33,Unknown,Unknown,Unknown,Unknown,cid:10)(cid:13)(cid:20)(cid:10)(cid:11,Unknown,12534.0
Unknown,Unknown,31,Unknown,Unknown,Unknown,Unknown,cid:10)(cid:13)(cid:20)(cid:10)(cid:11,Unknown,12565.0
Unknown,Unknown,1,Unknown,Unknown,Unknown,Unknown,cid:10)(cid:13)(cid:20)(cid:10)(cid:11,Unknown,12566.0
Unknown,Unknown,28,Unknown,Unknown,Unknown,Unknown,cid:10)(cid:13)(cid:20)(cid:10)(cid:11,Unknown,12594.0
Unknown,Unknown,27,Unknown,Unknown,Unknown,Unknown,cid:10)(cid:13)(cid:20)(cid:10)(cid:11,Unknown,12621.0
Unknown,Unknown,1,Unknown,Unknown,Unknown,Unknown,cid:10)(cid:13)(cid:20)(cid:10)(cid:11,Unknown,12622.0
Unknown,Unknown,35,Unknown,Unknown,Unknown,Unknown,cid:10)(cid:13)(cid:20)(cid:10)(cid:11,Unknown,12657.0
Unknown,Unknown,3,Unknown,Unknown,Unknown,Unknown,cid:10)(cid:13)(cid:20)(cid:10)(cid:11,Unknown,12660.0
Unknown,Unknown,1,Unknown,Unknown,Unknown,Unknown,cid:10)(cid:13)(cid:20)(cid:10)(cid:11,Unknown,12661.0
Unknown,Unknown,44,Unknown,Unknown,Unknown,Unknown,cid:10)(cid:13)(cid:20)(cid:10)(cid:11,Unknown,12705.0
Unknown,Unknown,17,Unknown,Unknown,Unknown,Unknown,cid:10)(cid:13)(cid:20)(cid:10)(cid:11,Unknown,12722.0
Unknown,Unknown,32,Unknown,Unknown,Unknown,Unknown,cid:10)(cid:13)(cid:20)(cid:10)(cid:11,Unknown,12754.0
Unknown,Unknown,27,Unknown,Unknown,Unknown,Unknown,cid:10)(cid:13)(cid:20)(cid:10)(cid:11,Unknown,12781.0
Unknown,Unknown,3,Unknown,Unknown,Unknown,Unknown,cid:10)(cid:13)(cid:20)(cid:10)(cid:11,Unknown,12784.0
Unknown,Unknown,3,Unknown,Unknown,Unknown,Unknown,cid:10)(cid:13)(cid:20)(cid:10)(cid:11,Unknown,12787.0
Unknown,Unknown,31,Unknown,Unknown,Unknown,Unknown,cid:10)(cid:13)(cid:20)(cid:10)(cid:11,Unknown,12818.0
Unknown,Unknown,1,Unknown,Unknown,Unknown,Unknown,cid:10)(cid:13)(cid:20)(cid:10)(cid:11,Unknown,12819.0
Unknown,Unknown,2,Unknown,Unknown,Unknown,Unknown,cid:10)(cid:13)(cid:20)(cid:10)(cid:11,Unknown,12821.0
Unknown,Unknown,3,Unknown,Unknown,Unknown,Unknown,cid:10)(cid:13)(cid:20)(cid:10)(cid:11,Unknown,12824.0
Unknown,Unknown,10,Unknown,Unknown,Unknown,Unknown,cid:10)(cid:13)(cid:20)(cid:10)(cid:11,Unknown,12834.0
Unknown,Unknown,4,Unknown,Unknown,Unknown,Unknown,cid:10)(cid:13)(cid:20)(cid:10)(cid:11,Unknown,12838.0
Unknown,Unknown,20,Unknown,Unknown,Unknown,Unknown,cid:10)(cid:13)(cid:20)(cid:10)(cid:11,Unknown,12858.0
Unknown,Unknown,10,Unknown,Unknown,Unknown,Unknown,cid:10)(cid:13)(cid:20)(cid:10)(cid:11,Unknown,12868.0
Unknown,Unknown,11,Unknown,Unknown,Unknown,Unknown,cid:10)(cid:13)(cid:20)(cid:10)(cid:11,Unknown,12879.0
Unknown,Unknown,24,Unknown,Unknown,Unknown,Unknown,cid:10)(cid:13)(cid:20)(cid:10)(cid:11,Unknown,12903.0
Unknown,Unknown,1,Unknown,Unknown,Unknown,Unknown,cid:10)(cid:13)(cid:20)(cid:10)(cid:11,Unknown,12904.0
Unknown,Unknown,6,Unknown,Unknown,Unknown,Unknown,cid:10)(cid:13)(cid:20)(cid:10)(cid:11,Unknown,12910.0
Unknown,Unknown,8,Unknown,Unknown,Unknown,Unknown,cid:10)(cid:13)(cid:20)(cid:10)(cid:11,Unknown,12918.0
Unknown,Unknown,13,Unknown,Unknown,Unknown,Unknown,cid:10)(cid:13)(cid:20)(cid:10)(cid:11,Unknown,12931.0
Unknown,Unknown,25,Unknown,Unknown,Unknown,Unknown,cid:10)(cid:13)(cid:20)(cid:10)(cid:11,Unknown,12956.0
Unknown,Unknown,11,Unknown,Unknown,Unknown,Unknown,cid:10)(cid:13)(cid:20)(cid:10)(cid:11,Unknown,12967.0
Unknown,Unknown,10,Unknown,Unknown,Unknown,Unknown,cid:10)(cid:13)(cid:20)(cid:10)(cid:11,Unknown,12977.0
Unknown,Unknown,1,Unknown,Unknown,Unknown,Unknown,cid:10)(cid:13)(cid:20)(cid:10)(cid:11,Unknown,12978.0
Unknown,Unknown,26,Unknown,Unknown,Unknown,Unknown,cid:10)(cid:13)(cid:20)(cid:10)(cid:11,Unknown,13004.0
Unknown,Unknown,45,Unknown,Unknown,Unknown,Unknown,cid:10)(cid:13)(cid:20)(cid:10)(cid:11,Unknown,13049.0
Unknown,Unknown,10,Unknown,Unknown,Unknown,Unknown,cid:10)(cid:13)(cid:20)(cid:10)(cid:11,Unknown,13059.0
Unknown,Unknown,19,Unknown,Unknown,Unknown,Unknown,cid:10)(cid:13)(cid:20)(cid:10)(cid:11,Unknown,13078.0
Unknown,Unknown,16,Unknown,Unknown,Unknown,Unknown,cid:10)(cid:13)(cid:20)(cid:10)(cid:11,Unknown,13094.0
Unknown,Unknown,7,Unknown,Unknown,Unknown,Unknown,cid:10)(cid:13)(cid:20)(cid:10)(cid:11,Unknown,13101.0
Unknown,Unknown,3,Unknown,Unknown,Unknown,Unknown,cid:10)(cid:13)(cid:20)(cid:10)(cid:11,Unknown,13104.0
Unknown,Unknown,8,Unknown,Unknown,Unknown,Unknown,cid:10)(cid:13)(cid:20)(cid:10)(cid:11,Unknown,13112.0
Unknown,Unknown,28,Unknown,Unknown,Unknown,Unknown,cid:10)(cid:13)(cid:20)(cid:10)(cid:11,Unknown,13140.0
Unknown,Unknown,10,Unknown,Unknown,Unknown,Unknown,cid:10)(cid:13)(cid:20)(cid:10)(cid:11,Unknown,13150.0
Unknown,Unknown,3,Unknown,Unknown,Unknown,Unknown,cid:10)(cid:13)(cid:20)(cid:10)(cid:11,Unknown,13153.0
Unknown,Unknown,6,Unknown,Unknown,Unknown,Unknown,cid:10)(cid:13)(cid:20)(cid:10)(cid:11,Unknown,13159.0
Unknown,Unknown,8,Unknown,Unknown,Unknown,Unknown,cid:10)(cid:13)(cid:20)(cid:10)(cid:11,Unknown,13167.0
Unknown,Unknown,46,Unknown,Unknown,Unknown,Unknown,cid:10)(cid:13)(cid:20)(cid:10)(cid:11,Unknown,13213.0
Unknown,Unknown,46,Unknown,Unknown,Unknown,Unknown,cid:10)(cid:13)(cid:20)(cid:10)(cid:11,Unknown,13259.0
Unknown,Unknown,47,Unknown,Unknown,Unknown,Unknown,cid:10)(cid:13)(cid:20)(cid:10)(cid:11,Unknown,13306.0
Unknown,Unknown,32,Unknown,Unknown,Unknown,Unknown,cid:10)(cid:13)(cid:20)(cid:10)(cid:11,Unknown,13338.0
Unknown,Unknown,48,Unknown,Unknown,Unknown,Unknown,cid:10)(cid:13)(cid:20)(cid:10)(cid:11,Unknown,13386.0
Unknown,Unknown,49,Unknown,Unknown,Unknown,Unknown,cid:10)(cid:13)(cid:20)(cid:10)(cid:11,Unknown,13435.0
Unknown,Unknown,16,Unknown,Unknown,Unknown,Unknown,cid:10)(cid:9)(cid:20)(cid:10)(cid:11,cid:24)(cid:1)(cid:7)(cid:12)(cid:25)(cid:7)(cid:8)(cid:1)(cid:26,16.0
Unknown,Unknown,17,Unknown,Unknown,Unknown,Unknown,cid:10)(cid:9)(cid:20)(cid:10)(cid:11,cid:28)(cid:27)(cid:1)(cid:36)(cid:32)(cid:35)(cid:3)(cid:31)(cid:3)(cid:30)(cid:31)(cid:1)(cid:35)(cid:17)(cid:32)(cid:28)(cid:17)(cid:34)(cid:34)(cid:30)(cid:31)(cid:3)(cid:36)(cid:1)(cid:2)(cid:3,33.0
Unknown,Unknown,16,Unknown,Unknown,Unknown,Unknown,cid:10)(cid:9)(cid:20)(cid:10)(cid:11,Unknown,49.0
Unknown,Unknown,27,Unknown,Unknown,Unknown,Unknown,cid:10)(cid:9)(cid:20)(cid:10)(cid:11,Unknown,76.0
Unknown,Unknown,28,Unknown,Unknown,Unknown,Unknown,cid:10)(cid:9)(cid:20)(cid:10)(cid:11,Unknown,104.0
Unknown,Unknown,1,Unknown,Unknown,Unknown,Unknown,cid:10)(cid:9)(cid:20)(cid:10)(cid:11,Unknown,105.0
Unknown,Unknown,35,Unknown,Unknown,Unknown,Unknown,cid:10)(cid:9)(cid:20)(cid:10)(cid:11,Unknown,140.0
Unknown,Unknown,17,Unknown,Unknown,Unknown,Unknown,cid:10)(cid:9)(cid:20)(cid:10)(cid:11,Unknown,157.0
Unknown,Unknown,32,Unknown,Unknown,Unknown,Unknown,cid:10)(cid:9)(cid:20)(cid:10)(cid:11,Unknown,189.0
Unknown,Unknown,28,Unknown,Unknown,Unknown,Unknown,cid:10)(cid:9)(cid:20)(cid:10)(cid:11,Unknown,217.0
Unknown,Unknown,17,Unknown,Unknown,Unknown,Unknown,cid:10)(cid:9)(cid:20)(cid:10)(cid:11,Unknown,234.0
Unknown,Unknown,34,Unknown,Unknown,Unknown,Unknown,cid:10)(cid:9)(cid:20)(cid:10)(cid:11,Unknown,268.0
Unknown,Unknown,34,Unknown,Unknown,Unknown,Unknown,cid:10)(cid:9)(cid:20)(cid:10)(cid:11,Unknown,302.0
Unknown,Unknown,30,Unknown,Unknown,Unknown,Unknown,cid:10)(cid:9)(cid:20)(cid:10)(cid:11,Unknown,332.0
Unknown,Unknown,31,Unknown,Unknown,Unknown,Unknown,cid:10)(cid:9)(cid:20)(cid:10)(cid:11,Unknown,363.0
Unknown,Unknown,3,Unknown,Unknown,Unknown,Unknown,cid:10)(cid:9)(cid:20)(cid:10)(cid:11,Unknown,366.0
Unknown,Unknown,36,Unknown,Unknown,Unknown,Unknown,cid:10)(cid:9)(cid:20)(cid:10)(cid:11,Unknown,402.0
Unknown,Unknown,1,Unknown,Unknown,Unknown,Unknown,cid:10)(cid:9)(cid:20)(cid:10)(cid:11,Unknown,403.0
Unknown,Unknown,2,Unknown,Unknown,Unknown,Unknown,cid:10)(cid:9)(cid:20)(cid:10)(cid:11,Unknown,405.0
Unknown,Unknown,3,Unknown,Unknown,Unknown,Unknown,cid:10)(cid:9)(cid:20)(cid:10)(cid:11,Unknown,408.0
Unknown,Unknown,10,Unknown,Unknown,Unknown,Unknown,cid:10)(cid:9)(cid:20)(cid:10)(cid:11,Unknown,418.0
Unknown,Unknown,9,Unknown,Unknown,Unknown,Unknown,cid:10)(cid:9)(cid:20)(cid:10)(cid:11,Unknown,427.0
Unknown,Unknown,20,Unknown,Unknown,Unknown,Unknown,cid:10)(cid:9)(cid:20)(cid:10)(cid:11,Unknown,447.0
Unknown,Unknown,10,Unknown,Unknown,Unknown,Unknown,cid:10)(cid:9)(cid:20)(cid:10)(cid:11,Unknown,457.0
Unknown,Unknown,11,Unknown,Unknown,Unknown,Unknown,cid:10)(cid:9)(cid:20)(cid:10)(cid:11,Unknown,468.0
Unknown,Unknown,24,Unknown,Unknown,Unknown,Unknown,cid:10)(cid:9)(cid:20)(cid:10)(cid:11,Unknown,492.0
Unknown,Unknown,1,Unknown,Unknown,Unknown,Unknown,cid:10)(cid:9)(cid:20)(cid:10)(cid:11,Unknown,493.0
Unknown,Unknown,5,Unknown,Unknown,Unknown,Unknown,cid:10)(cid:9)(cid:20)(cid:10)(cid:11,Unknown,498.0
Unknown,Unknown,13,Unknown,Unknown,Unknown,Unknown,cid:10)(cid:9)(cid:20)(cid:10)(cid:11,Unknown,511.0
Unknown,Unknown,25,Unknown,Unknown,Unknown,Unknown,cid:10)(cid:9)(cid:20)(cid:10)(cid:11,Unknown,536.0
Unknown,Unknown,10,Unknown,Unknown,Unknown,Unknown,cid:10)(cid:9)(cid:20)(cid:10)(cid:11,Unknown,546.0
Unknown,Unknown,11,Unknown,Unknown,Unknown,Unknown,cid:10)(cid:9)(cid:20)(cid:10)(cid:11,Unknown,557.0
Unknown,Unknown,1,Unknown,Unknown,Unknown,Unknown,cid:10)(cid:9)(cid:20)(cid:10)(cid:11,Unknown,558.0
Unknown,Unknown,26,Unknown,Unknown,Unknown,Unknown,cid:10)(cid:9)(cid:20)(cid:10)(cid:11,Unknown,584.0
Unknown,Unknown,45,Unknown,Unknown,Unknown,Unknown,cid:10)(cid:9)(cid:20)(cid:10)(cid:11,Unknown,629.0
Unknown,Unknown,10,Unknown,Unknown,Unknown,Unknown,cid:10)(cid:9)(cid:20)(cid:10)(cid:11,Unknown,639.0
Unknown,Unknown,19,Unknown,Unknown,Unknown,Unknown,cid:10)(cid:9)(cid:20)(cid:10)(cid:11,Unknown,658.0
Unknown,Unknown,16,Unknown,Unknown,Unknown,Unknown,cid:10)(cid:9)(cid:20)(cid:10)(cid:11,Unknown,674.0
Unknown,Unknown,7,Unknown,Unknown,Unknown,Unknown,cid:10)(cid:9)(cid:20)(cid:10)(cid:11,Unknown,681.0
Unknown,Unknown,3,Unknown,Unknown,Unknown,Unknown,cid:10)(cid:9)(cid:20)(cid:10)(cid:11,Unknown,684.0
Unknown,Unknown,8,Unknown,Unknown,Unknown,Unknown,cid:10)(cid:9)(cid:20)(cid:10)(cid:11,Unknown,692.0
Unknown,Unknown,28,Unknown,Unknown,Unknown,Unknown,cid:10)(cid:9)(cid:20)(cid:10)(cid:11,Unknown,720.0
Unknown,Unknown,10,Unknown,Unknown,Unknown,Unknown,cid:10)(cid:9)(cid:20)(cid:10)(cid:11,Unknown,730.0
Unknown,Unknown,3,Unknown,Unknown,Unknown,Unknown,cid:10)(cid:9)(cid:20)(cid:10)(cid:11,Unknown,733.0
Unknown,Unknown,6,Unknown,Unknown,Unknown,Unknown,cid:10)(cid:9)(cid:20)(cid:10)(cid:11,Unknown,739.0
Unknown,Unknown,8,Unknown,Unknown,Unknown,Unknown,cid:10)(cid:9)(cid:20)(cid:10)(cid:11,Unknown,747.0
Unknown,Unknown,46,Unknown,Unknown,Unknown,Unknown,cid:10)(cid:9)(cid:20)(cid:10)(cid:11,Unknown,793.0
Unknown,Unknown,46,Unknown,Unknown,Unknown,Unknown,cid:10)(cid:9)(cid:20)(cid:10)(cid:11,Unknown,839.0
Unknown,Unknown,47,Unknown,Unknown,Unknown,Unknown,cid:10)(cid:9)(cid:20)(cid:10)(cid:11,Unknown,886.0
Unknown,Unknown,32,Unknown,Unknown,Unknown,Unknown,cid:10)(cid:9)(cid:20)(cid:10)(cid:11,Unknown,918.0
Unknown,Unknown,48,Unknown,Unknown,Unknown,Unknown,cid:10)(cid:9)(cid:20)(cid:10)(cid:11,Unknown,966.0
Unknown,Unknown,49,Unknown,Unknown,Unknown,Unknown,cid:10)(cid:9)(cid:20)(cid:10)(cid:11,Unknown,1015.0
Unknown,Unknown,16,Unknown,Unknown,Unknown,Unknown,cid:10)(cid:9)(cid:20)(cid:10)(cid:11,Unknown,1031.0
Unknown,Unknown,17,Unknown,Unknown,Unknown,Unknown,cid:10)(cid:9)(cid:20)(cid:10)(cid:11,Unknown,1048.0
Unknown,Unknown,16,Unknown,Unknown,Unknown,Unknown,cid:10)(cid:9)(cid:20)(cid:10)(cid:11,Unknown,1064.0
Unknown,Unknown,27,Unknown,Unknown,Unknown,Unknown,cid:10)(cid:9)(cid:20)(cid:10)(cid:11,Unknown,1091.0
Unknown,Unknown,28,Unknown,Unknown,Unknown,Unknown,cid:10)(cid:9)(cid:20)(cid:10)(cid:11,Unknown,1119.0
Unknown,Unknown,1,Unknown,Unknown,Unknown,Unknown,cid:10)(cid:9)(cid:20)(cid:10)(cid:11,Unknown,1120.0
Unknown,Unknown,35,Unknown,Unknown,Unknown,Unknown,cid:10)(cid:9)(cid:20)(cid:10)(cid:11,Unknown,1155.0
Unknown,Unknown,17,Unknown,Unknown,Unknown,Unknown,cid:10)(cid:9)(cid:20)(cid:10)(cid:11,Unknown,1172.0
Unknown,Unknown,32,Unknown,Unknown,Unknown,Unknown,cid:10)(cid:9)(cid:20)(cid:10)(cid:11,Unknown,1204.0
Unknown,Unknown,28,Unknown,Unknown,Unknown,Unknown,cid:10)(cid:9)(cid:20)(cid:10)(cid:11,Unknown,1232.0
Unknown,Unknown,17,Unknown,Unknown,Unknown,Unknown,cid:10)(cid:9)(cid:20)(cid:10)(cid:11,Unknown,1249.0
Unknown,Unknown,34,Unknown,Unknown,Unknown,Unknown,cid:10)(cid:9)(cid:20)(cid:10)(cid:11,Unknown,1283.0
Unknown,Unknown,34,Unknown,Unknown,Unknown,Unknown,cid:10)(cid:9)(cid:20)(cid:10)(cid:11,Unknown,1317.0
Unknown,Unknown,30,Unknown,Unknown,Unknown,Unknown,cid:10)(cid:9)(cid:20)(cid:10)(cid:11,Unknown,1347.0
Unknown,Unknown,31,Unknown,Unknown,Unknown,Unknown,cid:10)(cid:9)(cid:20)(cid:10)(cid:11,Unknown,1378.0
Unknown,Unknown,3,Unknown,Unknown,Unknown,Unknown,cid:10)(cid:9)(cid:20)(cid:10)(cid:11,Unknown,1381.0
Unknown,Unknown,36,Unknown,Unknown,Unknown,Unknown,cid:10)(cid:9)(cid:20)(cid:10)(cid:11,Unknown,1417.0
Unknown,Unknown,1,Unknown,Unknown,Unknown,Unknown,cid:10)(cid:9)(cid:20)(cid:10)(cid:11,Unknown,1418.0
Unknown,Unknown,2,Unknown,Unknown,Unknown,Unknown,cid:10)(cid:9)(cid:20)(cid:10)(cid:11,Unknown,1420.0
Unknown,Unknown,3,Unknown,Unknown,Unknown,Unknown,cid:10)(cid:9)(cid:20)(cid:10)(cid:11,Unknown,1423.0
Unknown,Unknown,6,Unknown,Unknown,Unknown,Unknown,cid:10)(cid:9)(cid:20)(cid:10)(cid:11,Unknown,1429.0
Unknown,Unknown,10,Unknown,Unknown,Unknown,Unknown,cid:10)(cid:9)(cid:20)(cid:10)(cid:11,Unknown,1439.0
Unknown,Unknown,20,Unknown,Unknown,Unknown,Unknown,cid:10)(cid:9)(cid:20)(cid:10)(cid:11,Unknown,1459.0
Unknown,Unknown,10,Unknown,Unknown,Unknown,Unknown,cid:10)(cid:9)(cid:20)(cid:10)(cid:11,Unknown,1469.0
Unknown,Unknown,11,Unknown,Unknown,Unknown,Unknown,cid:10)(cid:9)(cid:20)(cid:10)(cid:11,Unknown,1480.0
Unknown,Unknown,45,Unknown,Unknown,Unknown,Unknown,cid:10)(cid:9)(cid:20)(cid:10)(cid:11,Unknown,1525.0
Unknown,Unknown,10,Unknown,Unknown,Unknown,Unknown,cid:10)(cid:9)(cid:20)(cid:10)(cid:11,Unknown,1535.0
Unknown,Unknown,19,Unknown,Unknown,Unknown,Unknown,cid:10)(cid:9)(cid:20)(cid:10)(cid:11,Unknown,1554.0
Unknown,Unknown,16,Unknown,Unknown,Unknown,Unknown,cid:10)(cid:9)(cid:20)(cid:10)(cid:11,Unknown,1570.0
Unknown,Unknown,7,Unknown,Unknown,Unknown,Unknown,cid:10)(cid:9)(cid:20)(cid:10)(cid:11,Unknown,1577.0
Unknown,Unknown,3,Unknown,Unknown,Unknown,Unknown,cid:10)(cid:9)(cid:20)(cid:10)(cid:11,Unknown,1580.0
Unknown,Unknown,8,Unknown,Unknown,Unknown,Unknown,cid:10)(cid:9)(cid:20)(cid:10)(cid:11,Unknown,1588.0
Unknown,Unknown,28,Unknown,Unknown,Unknown,Unknown,cid:10)(cid:9)(cid:20)(cid:10)(cid:11,Unknown,1616.0
Unknown,Unknown,10,Unknown,Unknown,Unknown,Unknown,cid:10)(cid:9)(cid:20)(cid:10)(cid:11,Unknown,1626.0
Unknown,Unknown,3,Unknown,Unknown,Unknown,Unknown,cid:10)(cid:9)(cid:20)(cid:10)(cid:11,Unknown,1629.0
Unknown,Unknown,6,Unknown,Unknown,Unknown,Unknown,cid:10)(cid:9)(cid:20)(cid:10)(cid:11,Unknown,1635.0
Unknown,Unknown,8,Unknown,Unknown,Unknown,Unknown,cid:10)(cid:9)(cid:20)(cid:10)(cid:11,Unknown,1643.0
Unknown,Unknown,46,Unknown,Unknown,Unknown,Unknown,cid:10)(cid:9)(cid:20)(cid:10)(cid:11,Unknown,1689.0
Unknown,Unknown,46,Unknown,Unknown,Unknown,Unknown,cid:10)(cid:9)(cid:20)(cid:10)(cid:11,Unknown,1735.0
Unknown,Unknown,47,Unknown,Unknown,Unknown,Unknown,cid:10)(cid:9)(cid:20)(cid:10)(cid:11,Unknown,1782.0
Unknown,Unknown,32,Unknown,Unknown,Unknown,Unknown,cid:10)(cid:9)(cid:20)(cid:10)(cid:11,Unknown,1814.0
Unknown,Unknown,48,Unknown,Unknown,Unknown,Unknown,cid:10)(cid:9)(cid:20)(cid:10)(cid:11,Unknown,1862.0
Unknown,Unknown,49,Unknown,Unknown,Unknown,Unknown,cid:10)(cid:9)(cid:20)(cid:10)(cid:11,Unknown,1911.0
Unknown,Unknown,24,Unknown,Unknown,Unknown,Unknown,cid:10)(cid:9)(cid:20)(cid:10)(cid:11,Unknown,1935.0
Unknown,Unknown,1,Unknown,Unknown,Unknown,Unknown,cid:10)(cid:9)(cid:20)(cid:10)(cid:11,Unknown,1936.0
Unknown,Unknown,8,Unknown,Unknown,Unknown,Unknown,cid:10)(cid:9)(cid:20)(cid:10)(cid:11,Unknown,1944.0
Unknown,Unknown,10,Unknown,Unknown,Unknown,Unknown,cid:10)(cid:9)(cid:20)(cid:10)(cid:11,Unknown,1954.0
Unknown,Unknown,25,Unknown,Unknown,Unknown,Unknown,cid:10)(cid:9)(cid:20)(cid:10)(cid:11,Unknown,1979.0
Unknown,Unknown,10,Unknown,Unknown,Unknown,Unknown,cid:10)(cid:9)(cid:20)(cid:10)(cid:11,Unknown,1989.0
Unknown,Unknown,6,Unknown,Unknown,Unknown,Unknown,cid:10)(cid:9)(cid:20)(cid:10)(cid:11,Unknown,1995.0
Unknown,Unknown,1,Unknown,Unknown,Unknown,Unknown,cid:10)(cid:9)(cid:20)(cid:10)(cid:11,Unknown,1996.0
Unknown,Unknown,26,Unknown,Unknown,Unknown,Unknown,cid:10)(cid:9)(cid:20)(cid:10)(cid:11,Unknown,2022.0
Unknown,Unknown,16,Unknown,Unknown,Unknown,Unknown,cid:10)(cid:9)(cid:20)(cid:10)(cid:11,Unknown,2038.0
Unknown,Unknown,17,Unknown,Unknown,Unknown,Unknown,cid:10)(cid:9)(cid:20)(cid:10)(cid:11,Unknown,2055.0
Unknown,Unknown,16,Unknown,Unknown,Unknown,Unknown,cid:10)(cid:9)(cid:20)(cid:10)(cid:11,Unknown,2071.0
Unknown,Unknown,27,Unknown,Unknown,Unknown,Unknown,cid:10)(cid:9)(cid:20)(cid:10)(cid:11,Unknown,2098.0
Unknown,Unknown,28,Unknown,Unknown,Unknown,Unknown,cid:10)(cid:9)(cid:20)(cid:10)(cid:11,Unknown,2126.0
Unknown,Unknown,1,Unknown,Unknown,Unknown,Unknown,cid:10)(cid:9)(cid:20)(cid:10)(cid:11,Unknown,2127.0
Unknown,Unknown,35,Unknown,Unknown,Unknown,Unknown,cid:10)(cid:9)(cid:20)(cid:10)(cid:11,Unknown,2162.0
Unknown,Unknown,17,Unknown,Unknown,Unknown,Unknown,cid:10)(cid:9)(cid:20)(cid:10)(cid:11,Unknown,2179.0
Unknown,Unknown,32,Unknown,Unknown,Unknown,Unknown,cid:10)(cid:9)(cid:20)(cid:10)(cid:11,Unknown,2211.0
Unknown,Unknown,28,Unknown,Unknown,Unknown,Unknown,cid:10)(cid:9)(cid:20)(cid:10)(cid:11,Unknown,2239.0
Unknown,Unknown,17,Unknown,Unknown,Unknown,Unknown,cid:10)(cid:9)(cid:20)(cid:10)(cid:11,Unknown,2256.0
Unknown,Unknown,34,Unknown,Unknown,Unknown,Unknown,cid:10)(cid:9)(cid:20)(cid:10)(cid:11,Unknown,2290.0
Unknown,Unknown,34,Unknown,Unknown,Unknown,Unknown,cid:10)(cid:9)(cid:20)(cid:10)(cid:11,Unknown,2324.0
Unknown,Unknown,30,Unknown,Unknown,Unknown,Unknown,cid:10)(cid:9)(cid:20)(cid:10)(cid:11,Unknown,2354.0
Unknown,Unknown,31,Unknown,Unknown,Unknown,Unknown,cid:10)(cid:9)(cid:20)(cid:10)(cid:11,Unknown,2385.0
Unknown,Unknown,3,Unknown,Unknown,Unknown,Unknown,cid:10)(cid:9)(cid:20)(cid:10)(cid:11,Unknown,2388.0
Unknown,Unknown,36,Unknown,Unknown,Unknown,Unknown,cid:10)(cid:9)(cid:20)(cid:10)(cid:11,Unknown,2424.0
Unknown,Unknown,1,Unknown,Unknown,Unknown,Unknown,cid:10)(cid:9)(cid:20)(cid:10)(cid:11,Unknown,2425.0
Unknown,Unknown,2,Unknown,Unknown,Unknown,Unknown,cid:10)(cid:9)(cid:20)(cid:10)(cid:11,Unknown,2427.0
Unknown,Unknown,3,Unknown,Unknown,Unknown,Unknown,cid:10)(cid:9)(cid:20)(cid:10)(cid:11,Unknown,2430.0
Unknown,Unknown,6,Unknown,Unknown,Unknown,Unknown,cid:10)(cid:9)(cid:20)(cid:10)(cid:11,Unknown,2436.0
Unknown,Unknown,10,Unknown,Unknown,Unknown,Unknown,cid:10)(cid:9)(cid:20)(cid:10)(cid:11,Unknown,2446.0
Unknown,Unknown,20,Unknown,Unknown,Unknown,Unknown,cid:10)(cid:9)(cid:20)(cid:10)(cid:11,Unknown,2466.0
Unknown,Unknown,10,Unknown,Unknown,Unknown,Unknown,cid:10)(cid:9)(cid:20)(cid:10)(cid:11,Unknown,2476.0
Unknown,Unknown,11,Unknown,Unknown,Unknown,Unknown,cid:10)(cid:9)(cid:20)(cid:10)(cid:11,Unknown,2487.0
Unknown,Unknown,24,Unknown,Unknown,Unknown,Unknown,cid:10)(cid:9)(cid:20)(cid:10)(cid:11,Unknown,2511.0
Unknown,Unknown,1,Unknown,Unknown,Unknown,Unknown,cid:10)(cid:9)(cid:20)(cid:10)(cid:11,Unknown,2512.0
Unknown,Unknown,7,Unknown,Unknown,Unknown,Unknown,cid:10)(cid:9)(cid:20)(cid:10)(cid:11,Unknown,2519.0
Unknown,Unknown,12,Unknown,Unknown,Unknown,Unknown,cid:10)(cid:9)(cid:20)(cid:10)(cid:11,Unknown,2531.0
Unknown,Unknown,25,Unknown,Unknown,Unknown,Unknown,cid:10)(cid:9)(cid:20)(cid:10)(cid:11,Unknown,2556.0
Unknown,Unknown,7,Unknown,Unknown,Unknown,Unknown,cid:10)(cid:9)(cid:20)(cid:10)(cid:11,Unknown,2563.0
Unknown,Unknown,8,Unknown,Unknown,Unknown,Unknown,cid:10)(cid:9)(cid:20)(cid:10)(cid:11,Unknown,2571.0
Unknown,Unknown,1,Unknown,Unknown,Unknown,Unknown,cid:10)(cid:9)(cid:20)(cid:10)(cid:11,Unknown,2572.0
Unknown,Unknown,26,Unknown,Unknown,Unknown,Unknown,cid:10)(cid:9)(cid:20)(cid:10)(cid:11,Unknown,2598.0
Unknown,Unknown,45,Unknown,Unknown,Unknown,Unknown,cid:10)(cid:9)(cid:20)(cid:10)(cid:11,Unknown,2643.0
Unknown,Unknown,10,Unknown,Unknown,Unknown,Unknown,cid:10)(cid:9)(cid:20)(cid:10)(cid:11,Unknown,2653.0
Unknown,Unknown,19,Unknown,Unknown,Unknown,Unknown,cid:10)(cid:9)(cid:20)(cid:10)(cid:11,Unknown,2672.0
Unknown,Unknown,16,Unknown,Unknown,Unknown,Unknown,cid:10)(cid:9)(cid:20)(cid:10)(cid:11,Unknown,2688.0
Unknown,Unknown,7,Unknown,Unknown,Unknown,Unknown,cid:10)(cid:9)(cid:20)(cid:10)(cid:11,Unknown,2695.0
Unknown,Unknown,3,Unknown,Unknown,Unknown,Unknown,cid:10)(cid:9)(cid:20)(cid:10)(cid:11,Unknown,2698.0
Unknown,Unknown,8,Unknown,Unknown,Unknown,Unknown,cid:10)(cid:9)(cid:20)(cid:10)(cid:11,Unknown,2706.0
Unknown,Unknown,28,Unknown,Unknown,Unknown,Unknown,cid:10)(cid:9)(cid:20)(cid:10)(cid:11,Unknown,2734.0
Unknown,Unknown,10,Unknown,Unknown,Unknown,Unknown,cid:10)(cid:9)(cid:20)(cid:10)(cid:11,Unknown,2744.0
Unknown,Unknown,3,Unknown,Unknown,Unknown,Unknown,cid:10)(cid:9)(cid:20)(cid:10)(cid:11,Unknown,2747.0
Unknown,Unknown,6,Unknown,Unknown,Unknown,Unknown,cid:10)(cid:9)(cid:20)(cid:10)(cid:11,Unknown,2753.0
Unknown,Unknown,8,Unknown,Unknown,Unknown,Unknown,cid:10)(cid:9)(cid:20)(cid:10)(cid:11,Unknown,2761.0
Unknown,Unknown,46,Unknown,Unknown,Unknown,Unknown,cid:10)(cid:9)(cid:20)(cid:10)(cid:11,Unknown,2807.0
Unknown,Unknown,46,Unknown,Unknown,Unknown,Unknown,cid:10)(cid:9)(cid:20)(cid:10)(cid:11,Unknown,2853.0
Unknown,Unknown,47,Unknown,Unknown,Unknown,Unknown,cid:10)(cid:9)(cid:20)(cid:10)(cid:11,Unknown,2900.0
Unknown,Unknown,32,Unknown,Unknown,Unknown,Unknown,cid:10)(cid:9)(cid:20)(cid:10)(cid:11,Unknown,2932.0
Unknown,Unknown,48,Unknown,Unknown,Unknown,Unknown,cid:10)(cid:9)(cid:20)(cid:10)(cid:11,Unknown,2980.0
Unknown,Unknown,49,Unknown,Unknown,Unknown,Unknown,cid:10)(cid:9)(cid:20)(cid:10)(cid:11,Unknown,3029.0
Unknown,Unknown,18,Unknown,Unknown,Unknown,Unknown,cid:10)(cid:9)(cid:20)(cid:10)(cid:11,Unknown,3047.0
Unknown,Unknown,31,Unknown,Unknown,Unknown,Unknown,cid:10)(cid:9)(cid:20)(cid:10)(cid:11,Unknown,3078.0
Unknown,Unknown,43,Unknown,Unknown,Unknown,Unknown,cid:10)(cid:9)(cid:20)(cid:10)(cid:11,Unknown,3121.0
Unknown,Unknown,43,Unknown,Unknown,Unknown,Unknown,cid:10)(cid:9)(cid:20)(cid:10)(cid:11,Unknown,3164.0
Unknown,Unknown,31,Unknown,Unknown,Unknown,Unknown,cid:10)(cid:9)(cid:20)(cid:10)(cid:11,Unknown,3195.0
Unknown,Unknown,16,Unknown,Unknown,Unknown,Unknown,cid:10)(cid:9)(cid:20)(cid:10)(cid:11,Unknown,3211.0
Unknown,Unknown,16,Unknown,Unknown,Unknown,Unknown,cid:10)(cid:9)(cid:20)(cid:10)(cid:11,Unknown,3227.0
Unknown,Unknown,27,Unknown,Unknown,Unknown,Unknown,cid:10)(cid:9)(cid:20)(cid:10)(cid:11,Unknown,3254.0
Unknown,Unknown,1,Unknown,Unknown,Unknown,Unknown,cid:10)(cid:9)(cid:20)(cid:10)(cid:11,Unknown,3255.0
Unknown,Unknown,33,Unknown,Unknown,Unknown,Unknown,cid:10)(cid:9)(cid:20)(cid:10)(cid:11,Unknown,3288.0
Unknown,Unknown,31,Unknown,Unknown,Unknown,Unknown,cid:10)(cid:9)(cid:20)(cid:10)(cid:11,Unknown,3319.0
Unknown,Unknown,34,Unknown,Unknown,Unknown,Unknown,cid:10)(cid:9)(cid:20)(cid:10)(cid:11,Unknown,3353.0
Unknown,Unknown,31,Unknown,Unknown,Unknown,Unknown,cid:10)(cid:9)(cid:20)(cid:10)(cid:11,Unknown,3384.0
Unknown,Unknown,34,Unknown,Unknown,Unknown,Unknown,cid:10)(cid:9)(cid:20)(cid:10)(cid:11,Unknown,3418.0
Unknown,Unknown,31,Unknown,Unknown,Unknown,Unknown,cid:10)(cid:9)(cid:20)(cid:10)(cid:11,Unknown,3449.0
Unknown,Unknown,1,Unknown,Unknown,Unknown,Unknown,cid:10)(cid:9)(cid:20)(cid:10)(cid:11,Unknown,3450.0
Unknown,Unknown,28,Unknown,Unknown,Unknown,Unknown,cid:10)(cid:9)(cid:20)(cid:10)(cid:11,Unknown,3478.0
Unknown,Unknown,27,Unknown,Unknown,Unknown,Unknown,cid:10)(cid:9)(cid:20)(cid:10)(cid:11,Unknown,3505.0
Unknown,Unknown,1,Unknown,Unknown,Unknown,Unknown,cid:10)(cid:9)(cid:20)(cid:10)(cid:11,Unknown,3506.0
Unknown,Unknown,2,Unknown,Unknown,Unknown,Unknown,cid:10)(cid:9)(cid:20)(cid:10)(cid:11,Unknown,3508.0
Unknown,Unknown,31,Unknown,Unknown,Unknown,Unknown,cid:10)(cid:9)(cid:20)(cid:10)(cid:11,Unknown,3539.0
Unknown,Unknown,3,Unknown,Unknown,Unknown,Unknown,cid:10)(cid:9)(cid:20)(cid:10)(cid:11,Unknown,3542.0
Unknown,Unknown,16,Unknown,Unknown,Unknown,Unknown,cid:10)(cid:9)(cid:20)(cid:10)(cid:11,Unknown,3558.0
Unknown,Unknown,31,Unknown,Unknown,Unknown,Unknown,cid:10)(cid:9)(cid:20)(cid:10)(cid:11,Unknown,3589.0
Unknown,Unknown,1,Unknown,Unknown,Unknown,Unknown,cid:10)(cid:9)(cid:20)(cid:10)(cid:11,Unknown,3590.0
Unknown,Unknown,36,Unknown,Unknown,Unknown,Unknown,cid:10)(cid:9)(cid:20)(cid:10)(cid:11,Unknown,3626.0
Unknown,Unknown,17,Unknown,Unknown,Unknown,Unknown,cid:10)(cid:9)(cid:20)(cid:10)(cid:11,Unknown,3643.0
Unknown,Unknown,32,Unknown,Unknown,Unknown,Unknown,cid:10)(cid:9)(cid:20)(cid:10)(cid:11,Unknown,3675.0
Unknown,Unknown,36,Unknown,Unknown,Unknown,Unknown,cid:10)(cid:9)(cid:20)(cid:10)(cid:11,Unknown,3711.0
Unknown,Unknown,1,Unknown,Unknown,Unknown,Unknown,cid:10)(cid:9)(cid:20)(cid:10)(cid:11,Unknown,3712.0
Unknown,Unknown,2,Unknown,Unknown,Unknown,Unknown,cid:10)(cid:9)(cid:20)(cid:10)(cid:11,Unknown,3714.0
Unknown,Unknown,3,Unknown,Unknown,Unknown,Unknown,cid:10)(cid:9)(cid:20)(cid:10)(cid:11,Unknown,3717.0
Unknown,Unknown,6,Unknown,Unknown,Unknown,Unknown,cid:10)(cid:9)(cid:20)(cid:10)(cid:11,Unknown,3723.0
Unknown,Unknown,10,Unknown,Unknown,Unknown,Unknown,cid:10)(cid:9)(cid:20)(cid:10)(cid:11,Unknown,3733.0
Unknown,Unknown,20,Unknown,Unknown,Unknown,Unknown,cid:10)(cid:9)(cid:20)(cid:10)(cid:11,Unknown,3753.0
Unknown,Unknown,10,Unknown,Unknown,Unknown,Unknown,cid:10)(cid:9)(cid:20)(cid:10)(cid:11,Unknown,3763.0
Unknown,Unknown,11,Unknown,Unknown,Unknown,Unknown,cid:10)(cid:9)(cid:20)(cid:10)(cid:11,Unknown,3774.0
Unknown,Unknown,24,Unknown,Unknown,Unknown,Unknown,cid:10)(cid:9)(cid:20)(cid:10)(cid:11,Unknown,3798.0
Unknown,Unknown,1,Unknown,Unknown,Unknown,Unknown,cid:10)(cid:9)(cid:20)(cid:10)(cid:11,Unknown,3799.0
Unknown,Unknown,6,Unknown,Unknown,Unknown,Unknown,cid:10)(cid:9)(cid:20)(cid:10)(cid:11,Unknown,3805.0
Unknown,Unknown,8,Unknown,Unknown,Unknown,Unknown,cid:10)(cid:9)(cid:20)(cid:10)(cid:11,Unknown,3813.0
Unknown,Unknown,25,Unknown,Unknown,Unknown,Unknown,cid:10)(cid:9)(cid:20)(cid:10)(cid:11,Unknown,3838.0
Unknown,Unknown,11,Unknown,Unknown,Unknown,Unknown,cid:10)(cid:9)(cid:20)(cid:10)(cid:11,Unknown,3849.0
Unknown,Unknown,5,Unknown,Unknown,Unknown,Unknown,cid:10)(cid:9)(cid:20)(cid:10)(cid:11,Unknown,3854.0
Unknown,Unknown,1,Unknown,Unknown,Unknown,Unknown,cid:10)(cid:9)(cid:20)(cid:10)(cid:11,Unknown,3855.0
Unknown,Unknown,26,Unknown,Unknown,Unknown,Unknown,cid:10)(cid:9)(cid:20)(cid:10)(cid:11,Unknown,3881.0
Unknown,Unknown,45,Unknown,Unknown,Unknown,Unknown,cid:10)(cid:9)(cid:20)(cid:10)(cid:11,Unknown,3926.0
Unknown,Unknown,10,Unknown,Unknown,Unknown,Unknown,cid:10)(cid:9)(cid:20)(cid:10)(cid:11,Unknown,3936.0
Unknown,Unknown,19,Unknown,Unknown,Unknown,Unknown,cid:10)(cid:9)(cid:20)(cid:10)(cid:11,Unknown,3955.0
Unknown,Unknown,16,Unknown,Unknown,Unknown,Unknown,cid:10)(cid:9)(cid:20)(cid:10)(cid:11,Unknown,3971.0
Unknown,Unknown,7,Unknown,Unknown,Unknown,Unknown,cid:10)(cid:9)(cid:20)(cid:10)(cid:11,Unknown,3978.0
Unknown,Unknown,3,Unknown,Unknown,Unknown,Unknown,cid:10)(cid:9)(cid:20)(cid:10)(cid:11,Unknown,3981.0
Unknown,Unknown,8,Unknown,Unknown,Unknown,Unknown,cid:10)(cid:9)(cid:20)(cid:10)(cid:11,Unknown,3989.0
Unknown,Unknown,28,Unknown,Unknown,Unknown,Unknown,cid:10)(cid:9)(cid:20)(cid:10)(cid:11,Unknown,4017.0
Unknown,Unknown,10,Unknown,Unknown,Unknown,Unknown,cid:10)(cid:9)(cid:20)(cid:10)(cid:11,Unknown,4027.0
Unknown,Unknown,3,Unknown,Unknown,Unknown,Unknown,cid:10)(cid:9)(cid:20)(cid:10)(cid:11,Unknown,4030.0
Unknown,Unknown,6,Unknown,Unknown,Unknown,Unknown,cid:10)(cid:9)(cid:20)(cid:10)(cid:11,Unknown,4036.0
Unknown,Unknown,8,Unknown,Unknown,Unknown,Unknown,cid:10)(cid:9)(cid:20)(cid:10)(cid:11,Unknown,4044.0
Unknown,Unknown,46,Unknown,Unknown,Unknown,Unknown,cid:10)(cid:9)(cid:20)(cid:10)(cid:11,Unknown,4090.0
Unknown,Unknown,46,Unknown,Unknown,Unknown,Unknown,cid:10)(cid:9)(cid:20)(cid:10)(cid:11,Unknown,4136.0
Unknown,Unknown,47,Unknown,Unknown,Unknown,Unknown,cid:10)(cid:9)(cid:20)(cid:10)(cid:11,Unknown,4183.0
Unknown,Unknown,32,Unknown,Unknown,Unknown,Unknown,cid:10)(cid:9)(cid:20)(cid:10)(cid:11,Unknown,4215.0
Unknown,Unknown,48,Unknown,Unknown,Unknown,Unknown,cid:10)(cid:9)(cid:20)(cid:10)(cid:11,Unknown,4263.0
Unknown,Unknown,49,Unknown,Unknown,Unknown,Unknown,cid:10)(cid:9)(cid:20)(cid:10)(cid:11,Unknown,4312.0
Unknown,Unknown,16,Unknown,Unknown,Unknown,Unknown,cid:10)(cid:9)(cid:20)(cid:10)(cid:11,Unknown,4328.0
Unknown,Unknown,17,Unknown,Unknown,Unknown,Unknown,cid:10)(cid:9)(cid:20)(cid:10)(cid:11,Unknown,4345.0
Unknown,Unknown,16,Unknown,Unknown,Unknown,Unknown,cid:10)(cid:9)(cid:20)(cid:10)(cid:11,Unknown,4361.0
Unknown,Unknown,27,Unknown,Unknown,Unknown,Unknown,cid:10)(cid:9)(cid:20)(cid:10)(cid:11,Unknown,4388.0
Unknown,Unknown,28,Unknown,Unknown,Unknown,Unknown,cid:10)(cid:9)(cid:20)(cid:10)(cid:11,Unknown,4416.0
Unknown,Unknown,1,Unknown,Unknown,Unknown,Unknown,cid:10)(cid:9)(cid:20)(cid:10)(cid:11,Unknown,4417.0
Unknown,Unknown,28,Unknown,Unknown,Unknown,Unknown,cid:10)(cid:9)(cid:20)(cid:10)(cid:11,Unknown,4445.0
Unknown,Unknown,27,Unknown,Unknown,Unknown,Unknown,cid:10)(cid:9)(cid:20)(cid:10)(cid:11,Unknown,4472.0
Unknown,Unknown,1,Unknown,Unknown,Unknown,Unknown,cid:10)(cid:9)(cid:20)(cid:10)(cid:11,Unknown,4473.0
Unknown,Unknown,3,Unknown,Unknown,Unknown,Unknown,cid:10)(cid:9)(cid:20)(cid:10)(cid:11,Unknown,4476.0
Unknown,Unknown,17,Unknown,Unknown,Unknown,Unknown,cid:10)(cid:9)(cid:20)(cid:10)(cid:11,Unknown,4493.0
Unknown,Unknown,35,Unknown,Unknown,Unknown,Unknown,cid:10)(cid:9)(cid:20)(cid:10)(cid:11,Unknown,4528.0
Unknown,Unknown,42,Unknown,Unknown,Unknown,Unknown,cid:10)(cid:9)(cid:20)(cid:10)(cid:11,Unknown,4570.0
Unknown,Unknown,31,Unknown,Unknown,Unknown,Unknown,cid:10)(cid:9)(cid:20)(cid:10)(cid:11,Unknown,4601.0
Unknown,Unknown,16,Unknown,Unknown,Unknown,Unknown,cid:10)(cid:9)(cid:20)(cid:10)(cid:11,Unknown,4617.0
Unknown,Unknown,16,Unknown,Unknown,Unknown,Unknown,cid:10)(cid:9)(cid:20)(cid:10)(cid:11,Unknown,4633.0
Unknown,Unknown,31,Unknown,Unknown,Unknown,Unknown,cid:10)(cid:9)(cid:20)(cid:10)(cid:11,Unknown,4664.0
Unknown,Unknown,1,Unknown,Unknown,Unknown,Unknown,cid:10)(cid:9)(cid:20)(cid:10)(cid:11,Unknown,4665.0
Unknown,Unknown,2,Unknown,Unknown,Unknown,Unknown,cid:10)(cid:9)(cid:20)(cid:10)(cid:11,Unknown,4667.0
Unknown,Unknown,3,Unknown,Unknown,Unknown,Unknown,cid:10)(cid:9)(cid:20)(cid:10)(cid:11,Unknown,4670.0
Unknown,Unknown,6,Unknown,Unknown,Unknown,Unknown,cid:10)(cid:9)(cid:20)(cid:10)(cid:11,Unknown,4676.0
Unknown,Unknown,6,Unknown,Unknown,Unknown,Unknown,cid:10)(cid:9)(cid:20)(cid:10)(cid:11,Unknown,4682.0
Unknown,Unknown,20,Unknown,Unknown,Unknown,Unknown,cid:10)(cid:9)(cid:20)(cid:10)(cid:11,Unknown,4702.0
Unknown,Unknown,10,Unknown,Unknown,Unknown,Unknown,cid:10)(cid:9)(cid:20)(cid:10)(cid:11,Unknown,4712.0
Unknown,Unknown,11,Unknown,Unknown,Unknown,Unknown,cid:10)(cid:9)(cid:20)(cid:10)(cid:11,Unknown,4723.0
Unknown,Unknown,24,Unknown,Unknown,Unknown,Unknown,cid:10)(cid:9)(cid:20)(cid:10)(cid:11,Unknown,4747.0
Unknown,Unknown,1,Unknown,Unknown,Unknown,Unknown,cid:10)(cid:9)(cid:20)(cid:10)(cid:11,Unknown,4748.0
Unknown,Unknown,7,Unknown,Unknown,Unknown,Unknown,cid:10)(cid:9)(cid:20)(cid:10)(cid:11,Unknown,4755.0
Unknown,Unknown,10,Unknown,Unknown,Unknown,Unknown,cid:10)(cid:9)(cid:20)(cid:10)(cid:11,Unknown,4765.0
Unknown,Unknown,25,Unknown,Unknown,Unknown,Unknown,cid:10)(cid:9)(cid:20)(cid:10)(cid:11,Unknown,4790.0
Unknown,Unknown,13,Unknown,Unknown,Unknown,Unknown,cid:10)(cid:9)(cid:20)(cid:10)(cid:11,Unknown,4803.0
Unknown,Unknown,5,Unknown,Unknown,Unknown,Unknown,cid:10)(cid:9)(cid:20)(cid:10)(cid:11,Unknown,4808.0
Unknown,Unknown,1,Unknown,Unknown,Unknown,Unknown,cid:10)(cid:9)(cid:20)(cid:10)(cid:11,Unknown,4809.0
Unknown,Unknown,26,Unknown,Unknown,Unknown,Unknown,cid:10)(cid:9)(cid:20)(cid:10)(cid:11,Unknown,4835.0
Unknown,Unknown,45,Unknown,Unknown,Unknown,Unknown,cid:10)(cid:9)(cid:20)(cid:10)(cid:11,Unknown,4880.0
Unknown,Unknown,10,Unknown,Unknown,Unknown,Unknown,cid:10)(cid:9)(cid:20)(cid:10)(cid:11,Unknown,4890.0
Unknown,Unknown,19,Unknown,Unknown,Unknown,Unknown,cid:10)(cid:9)(cid:20)(cid:10)(cid:11,Unknown,4909.0
Unknown,Unknown,16,Unknown,Unknown,Unknown,Unknown,cid:10)(cid:9)(cid:20)(cid:10)(cid:11,Unknown,4925.0
Unknown,Unknown,7,Unknown,Unknown,Unknown,Unknown,cid:10)(cid:9)(cid:20)(cid:10)(cid:11,Unknown,4932.0
Unknown,Unknown,3,Unknown,Unknown,Unknown,Unknown,cid:10)(cid:9)(cid:20)(cid:10)(cid:11,Unknown,4935.0
Unknown,Unknown,8,Unknown,Unknown,Unknown,Unknown,cid:10)(cid:9)(cid:20)(cid:10)(cid:11,Unknown,4943.0
Unknown,Unknown,28,Unknown,Unknown,Unknown,Unknown,cid:10)(cid:9)(cid:20)(cid:10)(cid:11,Unknown,4971.0
Unknown,Unknown,10,Unknown,Unknown,Unknown,Unknown,cid:10)(cid:9)(cid:20)(cid:10)(cid:11,Unknown,4981.0
Unknown,Unknown,3,Unknown,Unknown,Unknown,Unknown,cid:10)(cid:9)(cid:20)(cid:10)(cid:11,Unknown,4984.0
Unknown,Unknown,6,Unknown,Unknown,Unknown,Unknown,cid:10)(cid:9)(cid:20)(cid:10)(cid:11,Unknown,4990.0
Unknown,Unknown,8,Unknown,Unknown,Unknown,Unknown,cid:10)(cid:9)(cid:20)(cid:10)(cid:11,Unknown,4998.0
Unknown,Unknown,46,Unknown,Unknown,Unknown,Unknown,cid:10)(cid:9)(cid:20)(cid:10)(cid:11,Unknown,5044.0
Unknown,Unknown,46,Unknown,Unknown,Unknown,Unknown,cid:10)(cid:9)(cid:20)(cid:10)(cid:11,Unknown,5090.0
Unknown,Unknown,47,Unknown,Unknown,Unknown,Unknown,cid:10)(cid:9)(cid:20)(cid:10)(cid:11,Unknown,5137.0
Unknown,Unknown,32,Unknown,Unknown,Unknown,Unknown,cid:10)(cid:9)(cid:20)(cid:10)(cid:11,Unknown,5169.0
Unknown,Unknown,48,Unknown,Unknown,Unknown,Unknown,cid:10)(cid:9)(cid:20)(cid:10)(cid:11,Unknown,5217.0
Unknown,Unknown,49,Unknown,Unknown,Unknown,Unknown,cid:10)(cid:9)(cid:20)(cid:10)(cid:11,Unknown,5266.0
Unknown,Unknown,28,Unknown,Unknown,Unknown,Unknown,cid:10)(cid:9)(cid:20)(cid:10)(cid:11,Unknown,5294.0
Unknown,Unknown,27,Unknown,Unknown,Unknown,Unknown,cid:10)(cid:9)(cid:20)(cid:10)(cid:11,Unknown,5321.0
Unknown,Unknown,1,Unknown,Unknown,Unknown,Unknown,cid:10)(cid:9)(cid:20)(cid:10)(cid:11,Unknown,5322.0
Unknown,Unknown,36,Unknown,Unknown,Unknown,Unknown,cid:10)(cid:9)(cid:20)(cid:10)(cid:11,Unknown,5358.0
Unknown,Unknown,32,Unknown,Unknown,Unknown,Unknown,cid:10)(cid:9)(cid:20)(cid:10)(cid:11,Unknown,5390.0
Unknown,Unknown,35,Unknown,Unknown,Unknown,Unknown,cid:10)(cid:9)(cid:20)(cid:10)(cid:11,Unknown,5425.0
Unknown,Unknown,3,Unknown,Unknown,Unknown,Unknown,cid:10)(cid:9)(cid:20)(cid:10)(cid:11,Unknown,5428.0
Unknown,Unknown,31,Unknown,Unknown,Unknown,Unknown,cid:10)(cid:9)(cid:20)(cid:10)(cid:11,Unknown,5459.0
Unknown,Unknown,3,Unknown,Unknown,Unknown,Unknown,cid:10)(cid:9)(cid:20)(cid:10)(cid:11,Unknown,5462.0
Unknown,Unknown,30,Unknown,Unknown,Unknown,Unknown,cid:10)(cid:9)(cid:20)(cid:10)(cid:11,Unknown,5492.0
Unknown,Unknown,31,Unknown,Unknown,Unknown,Unknown,cid:10)(cid:9)(cid:20)(cid:10)(cid:11,Unknown,5523.0
Unknown,Unknown,1,Unknown,Unknown,Unknown,Unknown,cid:10)(cid:9)(cid:20)(cid:10)(cid:11,Unknown,5524.0
Unknown,Unknown,35,Unknown,Unknown,Unknown,Unknown,cid:10)(cid:9)(cid:20)(cid:10)(cid:11,Unknown,5559.0
Unknown,Unknown,17,Unknown,Unknown,Unknown,Unknown,cid:10)(cid:9)(cid:20)(cid:10)(cid:11,Unknown,5576.0
Unknown,Unknown,32,Unknown,Unknown,Unknown,Unknown,cid:10)(cid:9)(cid:20)(cid:10)(cid:11,Unknown,5608.0
Unknown,Unknown,28,Unknown,Unknown,Unknown,Unknown,cid:10)(cid:9)(cid:20)(cid:10)(cid:11,Unknown,5636.0
Unknown,Unknown,17,Unknown,Unknown,Unknown,Unknown,cid:10)(cid:9)(cid:20)(cid:10)(cid:11,Unknown,5653.0
Unknown,Unknown,34,Unknown,Unknown,Unknown,Unknown,cid:10)(cid:9)(cid:20)(cid:10)(cid:11,Unknown,5687.0
Unknown,Unknown,34,Unknown,Unknown,Unknown,Unknown,cid:10)(cid:9)(cid:20)(cid:10)(cid:11,Unknown,5721.0
Unknown,Unknown,30,Unknown,Unknown,Unknown,Unknown,cid:10)(cid:9)(cid:20)(cid:10)(cid:11,Unknown,5751.0
Unknown,Unknown,31,Unknown,Unknown,Unknown,Unknown,cid:10)(cid:9)(cid:20)(cid:10)(cid:11,Unknown,5782.0
Unknown,Unknown,3,Unknown,Unknown,Unknown,Unknown,cid:10)(cid:9)(cid:20)(cid:10)(cid:11,Unknown,5785.0
Unknown,Unknown,36,Unknown,Unknown,Unknown,Unknown,cid:10)(cid:9)(cid:20)(cid:10)(cid:11,Unknown,5821.0
Unknown,Unknown,1,Unknown,Unknown,Unknown,Unknown,cid:10)(cid:9)(cid:20)(cid:10)(cid:11,Unknown,5822.0
Unknown,Unknown,2,Unknown,Unknown,Unknown,Unknown,cid:10)(cid:9)(cid:20)(cid:10)(cid:11,Unknown,5824.0
Unknown,Unknown,3,Unknown,Unknown,Unknown,Unknown,cid:10)(cid:9)(cid:20)(cid:10)(cid:11,Unknown,5827.0
Unknown,Unknown,6,Unknown,Unknown,Unknown,Unknown,cid:10)(cid:9)(cid:20)(cid:10)(cid:11,Unknown,5833.0
Unknown,Unknown,11,Unknown,Unknown,Unknown,Unknown,cid:10)(cid:9)(cid:20)(cid:10)(cid:11,Unknown,5844.0
Unknown,Unknown,20,Unknown,Unknown,Unknown,Unknown,cid:10)(cid:9)(cid:20)(cid:10)(cid:11,Unknown,5864.0
Unknown,Unknown,10,Unknown,Unknown,Unknown,Unknown,cid:10)(cid:9)(cid:20)(cid:10)(cid:11,Unknown,5874.0
Unknown,Unknown,11,Unknown,Unknown,Unknown,Unknown,cid:10)(cid:9)(cid:20)(cid:10)(cid:11,Unknown,5885.0
Unknown,Unknown,24,Unknown,Unknown,Unknown,Unknown,cid:10)(cid:9)(cid:20)(cid:10)(cid:11,Unknown,5909.0
Unknown,Unknown,1,Unknown,Unknown,Unknown,Unknown,cid:10)(cid:9)(cid:20)(cid:10)(cid:11,Unknown,5910.0
Unknown,Unknown,8,Unknown,Unknown,Unknown,Unknown,cid:10)(cid:9)(cid:20)(cid:10)(cid:11,Unknown,5918.0
Unknown,Unknown,6,Unknown,Unknown,Unknown,Unknown,cid:10)(cid:9)(cid:20)(cid:10)(cid:11,Unknown,5924.0
Unknown,Unknown,25,Unknown,Unknown,Unknown,Unknown,cid:10)(cid:9)(cid:20)(cid:10)(cid:11,Unknown,5949.0
Unknown,Unknown,10,Unknown,Unknown,Unknown,Unknown,cid:10)(cid:9)(cid:20)(cid:10)(cid:11,Unknown,5959.0
Unknown,Unknown,10,Unknown,Unknown,Unknown,Unknown,cid:10)(cid:9)(cid:20)(cid:10)(cid:11,Unknown,5969.0
Unknown,Unknown,1,Unknown,Unknown,Unknown,Unknown,cid:10)(cid:9)(cid:20)(cid:10)(cid:11,Unknown,5970.0
Unknown,Unknown,26,Unknown,Unknown,Unknown,Unknown,cid:10)(cid:9)(cid:20)(cid:10)(cid:11,Unknown,5996.0
Unknown,Unknown,45,Unknown,Unknown,Unknown,Unknown,cid:10)(cid:9)(cid:20)(cid:10)(cid:11,Unknown,6041.0
Unknown,Unknown,10,Unknown,Unknown,Unknown,Unknown,cid:10)(cid:9)(cid:20)(cid:10)(cid:11,Unknown,6051.0
Unknown,Unknown,19,Unknown,Unknown,Unknown,Unknown,cid:10)(cid:9)(cid:20)(cid:10)(cid:11,Unknown,6070.0
Unknown,Unknown,16,Unknown,Unknown,Unknown,Unknown,cid:10)(cid:9)(cid:20)(cid:10)(cid:11,Unknown,6086.0
Unknown,Unknown,7,Unknown,Unknown,Unknown,Unknown,cid:10)(cid:9)(cid:20)(cid:10)(cid:11,Unknown,6093.0
Unknown,Unknown,3,Unknown,Unknown,Unknown,Unknown,cid:10)(cid:9)(cid:20)(cid:10)(cid:11,Unknown,6096.0
Unknown,Unknown,8,Unknown,Unknown,Unknown,Unknown,cid:10)(cid:9)(cid:20)(cid:10)(cid:11,Unknown,6104.0
Unknown,Unknown,28,Unknown,Unknown,Unknown,Unknown,cid:10)(cid:9)(cid:20)(cid:10)(cid:11,Unknown,6132.0
Unknown,Unknown,10,Unknown,Unknown,Unknown,Unknown,cid:10)(cid:9)(cid:20)(cid:10)(cid:11,Unknown,6142.0
Unknown,Unknown,3,Unknown,Unknown,Unknown,Unknown,cid:10)(cid:9)(cid:20)(cid:10)(cid:11,Unknown,6145.0
Unknown,Unknown,6,Unknown,Unknown,Unknown,Unknown,cid:10)(cid:9)(cid:20)(cid:10)(cid:11,Unknown,6151.0
Unknown,Unknown,8,Unknown,Unknown,Unknown,Unknown,cid:10)(cid:9)(cid:20)(cid:10)(cid:11,Unknown,6159.0
Unknown,Unknown,46,Unknown,Unknown,Unknown,Unknown,cid:10)(cid:9)(cid:20)(cid:10)(cid:11,Unknown,6205.0
Unknown,Unknown,46,Unknown,Unknown,Unknown,Unknown,cid:10)(cid:9)(cid:20)(cid:10)(cid:11,Unknown,6251.0
Unknown,Unknown,47,Unknown,Unknown,Unknown,Unknown,cid:10)(cid:9)(cid:20)(cid:10)(cid:11,Unknown,6298.0
Unknown,Unknown,32,Unknown,Unknown,Unknown,Unknown,cid:10)(cid:9)(cid:20)(cid:10)(cid:11,Unknown,6330.0
Unknown,Unknown,48,Unknown,Unknown,Unknown,Unknown,cid:10)(cid:9)(cid:20)(cid:10)(cid:11,Unknown,6378.0
Unknown,Unknown,49,Unknown,Unknown,Unknown,Unknown,cid:10)(cid:9)(cid:20)(cid:10)(cid:11,Unknown,6427.0
Unknown,Unknown,36,Unknown,Unknown,Unknown,Unknown,cid:10)(cid:9)(cid:20)(cid:10)(cid:11,Unknown,6463.0
Unknown,Unknown,27,Unknown,Unknown,Unknown,Unknown,cid:10)(cid:9)(cid:20)(cid:10)(cid:11,Unknown,6490.0
Unknown,Unknown,15,Unknown,Unknown,Unknown,Unknown,cid:10)(cid:9)(cid:20)(cid:10)(cid:11,Unknown,6505.0
Unknown,Unknown,31,Unknown,Unknown,Unknown,Unknown,cid:10)(cid:9)(cid:20)(cid:10)(cid:11,Unknown,6536.0
Unknown,Unknown,2,Unknown,Unknown,Unknown,Unknown,cid:10)(cid:9)(cid:20)(cid:10)(cid:11,Unknown,6538.0
Unknown,Unknown,1,Unknown,Unknown,Unknown,Unknown,cid:10)(cid:9)(cid:20)(cid:10)(cid:11,Unknown,6539.0
Unknown,Unknown,36,Unknown,Unknown,Unknown,Unknown,cid:10)(cid:9)(cid:20)(cid:10)(cid:11,Unknown,6575.0
Unknown,Unknown,31,Unknown,Unknown,Unknown,Unknown,cid:10)(cid:9)(cid:20)(cid:10)(cid:11,Unknown,6606.0
Unknown,Unknown,15,Unknown,Unknown,Unknown,Unknown,cid:10)(cid:9)(cid:20)(cid:10)(cid:11,Unknown,6621.0
Unknown,Unknown,28,Unknown,Unknown,Unknown,Unknown,cid:10)(cid:9)(cid:20)(cid:10)(cid:11,Unknown,6649.0
Unknown,Unknown,30,Unknown,Unknown,Unknown,Unknown,cid:10)(cid:9)(cid:20)(cid:10)(cid:11,Unknown,6679.0
Unknown,Unknown,36,Unknown,Unknown,Unknown,Unknown,cid:10)(cid:9)(cid:20)(cid:10)(cid:11,Unknown,6715.0
Unknown,Unknown,1,Unknown,Unknown,Unknown,Unknown,cid:10)(cid:9)(cid:20)(cid:10)(cid:11,Unknown,6716.0
Unknown,Unknown,35,Unknown,Unknown,Unknown,Unknown,cid:10)(cid:9)(cid:20)(cid:10)(cid:11,Unknown,6751.0
Unknown,Unknown,31,Unknown,Unknown,Unknown,Unknown,cid:10)(cid:9)(cid:20)(cid:10)(cid:11,Unknown,6782.0
Unknown,Unknown,33,Unknown,Unknown,Unknown,Unknown,cid:10)(cid:9)(cid:20)(cid:10)(cid:11,Unknown,6815.0
Unknown,Unknown,31,Unknown,Unknown,Unknown,Unknown,cid:10)(cid:9)(cid:20)(cid:10)(cid:11,Unknown,6846.0
Unknown,Unknown,19,Unknown,Unknown,Unknown,Unknown,cid:10)(cid:9)(cid:20)(cid:10)(cid:11,Unknown,6865.0
Unknown,Unknown,1,Unknown,Unknown,Unknown,Unknown,cid:10)(cid:9)(cid:20)(cid:10)(cid:11,Unknown,6866.0
Unknown,Unknown,2,Unknown,Unknown,Unknown,Unknown,cid:10)(cid:9)(cid:20)(cid:10)(cid:11,Unknown,6868.0
Unknown,Unknown,3,Unknown,Unknown,Unknown,Unknown,cid:10)(cid:9)(cid:20)(cid:10)(cid:11,Unknown,6871.0
Unknown,Unknown,6,Unknown,Unknown,Unknown,Unknown,cid:10)(cid:9)(cid:20)(cid:10)(cid:11,Unknown,6877.0
Unknown,Unknown,11,Unknown,Unknown,Unknown,Unknown,cid:10)(cid:9)(cid:20)(cid:10)(cid:11,Unknown,6888.0
Unknown,Unknown,20,Unknown,Unknown,Unknown,Unknown,cid:10)(cid:9)(cid:20)(cid:10)(cid:11,Unknown,6908.0
Unknown,Unknown,10,Unknown,Unknown,Unknown,Unknown,cid:10)(cid:9)(cid:20)(cid:10)(cid:11,Unknown,6918.0
Unknown,Unknown,11,Unknown,Unknown,Unknown,Unknown,cid:10)(cid:9)(cid:20)(cid:10)(cid:11,Unknown,6929.0
Unknown,Unknown,24,Unknown,Unknown,Unknown,Unknown,cid:10)(cid:9)(cid:20)(cid:10)(cid:11,Unknown,6953.0
Unknown,Unknown,1,Unknown,Unknown,Unknown,Unknown,cid:10)(cid:9)(cid:20)(cid:10)(cid:11,Unknown,6954.0
Unknown,Unknown,6,Unknown,Unknown,Unknown,Unknown,cid:10)(cid:9)(cid:20)(cid:10)(cid:11,Unknown,6960.0
Unknown,Unknown,25,Unknown,Unknown,Unknown,Unknown,cid:10)(cid:9)(cid:20)(cid:10)(cid:11,Unknown,6985.0
Unknown,Unknown,7,Unknown,Unknown,Unknown,Unknown,cid:10)(cid:9)(cid:20)(cid:10)(cid:11,Unknown,6992.0
Unknown,Unknown,10,Unknown,Unknown,Unknown,Unknown,cid:10)(cid:9)(cid:20)(cid:10)(cid:11,Unknown,7002.0
Unknown,Unknown,1,Unknown,Unknown,Unknown,Unknown,cid:10)(cid:9)(cid:20)(cid:10)(cid:11,Unknown,7003.0
Unknown,Unknown,26,Unknown,Unknown,Unknown,Unknown,cid:10)(cid:9)(cid:20)(cid:10)(cid:11,Unknown,7029.0
Unknown,Unknown,45,Unknown,Unknown,Unknown,Unknown,cid:10)(cid:9)(cid:20)(cid:10)(cid:11,Unknown,7074.0
Unknown,Unknown,10,Unknown,Unknown,Unknown,Unknown,cid:10)(cid:9)(cid:20)(cid:10)(cid:11,Unknown,7084.0
Unknown,Unknown,19,Unknown,Unknown,Unknown,Unknown,cid:10)(cid:9)(cid:20)(cid:10)(cid:11,Unknown,7103.0
Unknown,Unknown,16,Unknown,Unknown,Unknown,Unknown,cid:10)(cid:9)(cid:20)(cid:10)(cid:11,Unknown,7119.0
Unknown,Unknown,7,Unknown,Unknown,Unknown,Unknown,cid:10)(cid:9)(cid:20)(cid:10)(cid:11,Unknown,7126.0
Unknown,Unknown,3,Unknown,Unknown,Unknown,Unknown,cid:10)(cid:9)(cid:20)(cid:10)(cid:11,Unknown,7129.0
Unknown,Unknown,8,Unknown,Unknown,Unknown,Unknown,cid:10)(cid:9)(cid:20)(cid:10)(cid:11,Unknown,7137.0
Unknown,Unknown,28,Unknown,Unknown,Unknown,Unknown,cid:10)(cid:9)(cid:20)(cid:10)(cid:11,Unknown,7165.0
Unknown,Unknown,10,Unknown,Unknown,Unknown,Unknown,cid:10)(cid:9)(cid:20)(cid:10)(cid:11,Unknown,7175.0
Unknown,Unknown,3,Unknown,Unknown,Unknown,Unknown,cid:10)(cid:9)(cid:20)(cid:10)(cid:11,Unknown,7178.0
Unknown,Unknown,6,Unknown,Unknown,Unknown,Unknown,cid:10)(cid:9)(cid:20)(cid:10)(cid:11,Unknown,7184.0
Unknown,Unknown,8,Unknown,Unknown,Unknown,Unknown,cid:10)(cid:9)(cid:20)(cid:10)(cid:11,Unknown,7192.0
Unknown,Unknown,46,Unknown,Unknown,Unknown,Unknown,cid:10)(cid:9)(cid:20)(cid:10)(cid:11,Unknown,7238.0
Unknown,Unknown,46,Unknown,Unknown,Unknown,Unknown,cid:10)(cid:9)(cid:20)(cid:10)(cid:11,Unknown,7284.0
Unknown,Unknown,47,Unknown,Unknown,Unknown,Unknown,cid:10)(cid:9)(cid:20)(cid:10)(cid:11,Unknown,7331.0
Unknown,Unknown,32,Unknown,Unknown,Unknown,Unknown,cid:10)(cid:9)(cid:20)(cid:10)(cid:11,Unknown,7363.0
Unknown,Unknown,48,Unknown,Unknown,Unknown,Unknown,cid:10)(cid:9)(cid:20)(cid:10)(cid:11,Unknown,7411.0
Unknown,Unknown,49,Unknown,Unknown,Unknown,Unknown,cid:10)(cid:9)(cid:20)(cid:10)(cid:11,Unknown,7460.0
Unknown,Unknown,35,Unknown,Unknown,Unknown,Unknown,cid:10)(cid:9)(cid:20)(cid:10)(cid:11,Unknown,7495.0
Unknown,Unknown,27,Unknown,Unknown,Unknown,Unknown,cid:10)(cid:9)(cid:20)(cid:10)(cid:11,Unknown,7522.0
Unknown,Unknown,3,Unknown,Unknown,Unknown,Unknown,cid:10)(cid:9)(cid:20)(cid:10)(cid:11,Unknown,7525.0
Unknown,Unknown,3,Unknown,Unknown,Unknown,Unknown,cid:10)(cid:9)(cid:20)(cid:10)(cid:11,Unknown,7528.0
Unknown,Unknown,31,Unknown,Unknown,Unknown,Unknown,cid:10)(cid:9)(cid:20)(cid:10)(cid:11,Unknown,7559.0
Unknown,Unknown,2,Unknown,Unknown,Unknown,Unknown,cid:10)(cid:9)(cid:20)(cid:10)(cid:11,Unknown,7561.0
Unknown,Unknown,17,Unknown,Unknown,Unknown,Unknown,cid:10)(cid:9)(cid:20)(cid:10)(cid:11,Unknown,7578.0
Unknown,Unknown,32,Unknown,Unknown,Unknown,Unknown,cid:10)(cid:9)(cid:20)(cid:10)(cid:11,Unknown,7610.0
Unknown,Unknown,3,Unknown,Unknown,Unknown,Unknown,cid:10)(cid:9)(cid:20)(cid:10)(cid:11,Unknown,7613.0
Unknown,Unknown,1,Unknown,Unknown,Unknown,Unknown,cid:10)(cid:9)(cid:20)(cid:10)(cid:11,Unknown,7614.0
Unknown,Unknown,34,Unknown,Unknown,Unknown,Unknown,cid:10)(cid:9)(cid:20)(cid:10)(cid:11,Unknown,7648.0
Unknown,Unknown,27,Unknown,Unknown,Unknown,Unknown,cid:10)(cid:9)(cid:20)(cid:10)(cid:11,Unknown,7675.0
Unknown,Unknown,3,Unknown,Unknown,Unknown,Unknown,cid:10)(cid:9)(cid:20)(cid:10)(cid:11,Unknown,7678.0
Unknown,Unknown,41,Unknown,Unknown,Unknown,Unknown,cid:10)(cid:9)(cid:20)(cid:10)(cid:11,Unknown,7719.0
Unknown,Unknown,31,Unknown,Unknown,Unknown,Unknown,cid:10)(cid:9)(cid:20)(cid:10)(cid:11,Unknown,7750.0
Unknown,Unknown,1,Unknown,Unknown,Unknown,Unknown,cid:10)(cid:9)(cid:20)(cid:10)(cid:11,Unknown,7751.0
Unknown,Unknown,3,Unknown,Unknown,Unknown,Unknown,cid:10)(cid:9)(cid:20)(cid:10)(cid:11,Unknown,7754.0
Unknown,Unknown,31,Unknown,Unknown,Unknown,Unknown,cid:10)(cid:9)(cid:20)(cid:10)(cid:11,Unknown,7785.0
Unknown,Unknown,37,Unknown,Unknown,Unknown,Unknown,cid:10)(cid:9)(cid:20)(cid:10)(cid:11,Unknown,7822.0
Unknown,Unknown,27,Unknown,Unknown,Unknown,Unknown,cid:10)(cid:9)(cid:20)(cid:10)(cid:11,Unknown,7849.0
Unknown,Unknown,30,Unknown,Unknown,Unknown,Unknown,cid:10)(cid:9)(cid:20)(cid:10)(cid:11,Unknown,7879.0
Unknown,Unknown,36,Unknown,Unknown,Unknown,Unknown,cid:10)(cid:9)(cid:20)(cid:10)(cid:11,Unknown,7915.0
Unknown,Unknown,1,Unknown,Unknown,Unknown,Unknown,cid:10)(cid:9)(cid:20)(cid:10)(cid:11,Unknown,7916.0
Unknown,Unknown,2,Unknown,Unknown,Unknown,Unknown,cid:10)(cid:9)(cid:20)(cid:10)(cid:11,Unknown,7918.0
Unknown,Unknown,3,Unknown,Unknown,Unknown,Unknown,cid:10)(cid:9)(cid:20)(cid:10)(cid:11,Unknown,7921.0
Unknown,Unknown,6,Unknown,Unknown,Unknown,Unknown,cid:10)(cid:9)(cid:20)(cid:10)(cid:11,Unknown,7927.0
Unknown,Unknown,8,Unknown,Unknown,Unknown,Unknown,cid:10)(cid:9)(cid:20)(cid:10)(cid:11,Unknown,7935.0
Unknown,Unknown,20,Unknown,Unknown,Unknown,Unknown,cid:10)(cid:9)(cid:20)(cid:10)(cid:11,Unknown,7955.0
Unknown,Unknown,10,Unknown,Unknown,Unknown,Unknown,cid:10)(cid:9)(cid:20)(cid:10)(cid:11,Unknown,7965.0
Unknown,Unknown,11,Unknown,Unknown,Unknown,Unknown,cid:10)(cid:9)(cid:20)(cid:10)(cid:11,Unknown,7976.0
Unknown,Unknown,24,Unknown,Unknown,Unknown,Unknown,cid:10)(cid:9)(cid:20)(cid:10)(cid:11,Unknown,8000.0
Unknown,Unknown,1,Unknown,Unknown,Unknown,Unknown,cid:10)(cid:9)(cid:20)(cid:10)(cid:11,Unknown,8001.0
Unknown,Unknown,11,Unknown,Unknown,Unknown,Unknown,cid:10)(cid:9)(cid:20)(cid:10)(cid:11,Unknown,8012.0
Unknown,Unknown,10,Unknown,Unknown,Unknown,Unknown,cid:10)(cid:9)(cid:20)(cid:10)(cid:11,Unknown,8022.0
Unknown,Unknown,25,Unknown,Unknown,Unknown,Unknown,cid:10)(cid:9)(cid:20)(cid:10)(cid:11,Unknown,8047.0
Unknown,Unknown,10,Unknown,Unknown,Unknown,Unknown,cid:10)(cid:9)(cid:20)(cid:10)(cid:11,Unknown,8057.0
Unknown,Unknown,6,Unknown,Unknown,Unknown,Unknown,cid:10)(cid:9)(cid:20)(cid:10)(cid:11,Unknown,8063.0
Unknown,Unknown,1,Unknown,Unknown,Unknown,Unknown,cid:10)(cid:9)(cid:20)(cid:10)(cid:11,Unknown,8064.0
Unknown,Unknown,26,Unknown,Unknown,Unknown,Unknown,cid:10)(cid:9)(cid:20)(cid:10)(cid:11,Unknown,8090.0
Unknown,Unknown,45,Unknown,Unknown,Unknown,Unknown,cid:10)(cid:9)(cid:20)(cid:10)(cid:11,Unknown,8135.0
Unknown,Unknown,10,Unknown,Unknown,Unknown,Unknown,cid:10)(cid:9)(cid:20)(cid:10)(cid:11,Unknown,8145.0
Unknown,Unknown,19,Unknown,Unknown,Unknown,Unknown,cid:10)(cid:9)(cid:20)(cid:10)(cid:11,Unknown,8164.0
Unknown,Unknown,16,Unknown,Unknown,Unknown,Unknown,cid:10)(cid:9)(cid:20)(cid:10)(cid:11,Unknown,8180.0
Unknown,Unknown,7,Unknown,Unknown,Unknown,Unknown,cid:10)(cid:9)(cid:20)(cid:10)(cid:11,Unknown,8187.0
Unknown,Unknown,3,Unknown,Unknown,Unknown,Unknown,cid:10)(cid:9)(cid:20)(cid:10)(cid:11,Unknown,8190.0
Unknown,Unknown,8,Unknown,Unknown,Unknown,Unknown,cid:10)(cid:9)(cid:20)(cid:10)(cid:11,Unknown,8198.0
Unknown,Unknown,28,Unknown,Unknown,Unknown,Unknown,cid:10)(cid:9)(cid:20)(cid:10)(cid:11,Unknown,8226.0
Unknown,Unknown,10,Unknown,Unknown,Unknown,Unknown,cid:10)(cid:9)(cid:20)(cid:10)(cid:11,Unknown,8236.0
Unknown,Unknown,3,Unknown,Unknown,Unknown,Unknown,cid:10)(cid:9)(cid:20)(cid:10)(cid:11,Unknown,8239.0
Unknown,Unknown,6,Unknown,Unknown,Unknown,Unknown,cid:10)(cid:9)(cid:20)(cid:10)(cid:11,Unknown,8245.0
Unknown,Unknown,8,Unknown,Unknown,Unknown,Unknown,cid:10)(cid:9)(cid:20)(cid:10)(cid:11,Unknown,8253.0
Unknown,Unknown,46,Unknown,Unknown,Unknown,Unknown,cid:10)(cid:9)(cid:20)(cid:10)(cid:11,Unknown,8299.0
Unknown,Unknown,46,Unknown,Unknown,Unknown,Unknown,cid:10)(cid:9)(cid:20)(cid:10)(cid:11,Unknown,8345.0
Unknown,Unknown,47,Unknown,Unknown,Unknown,Unknown,cid:10)(cid:9)(cid:20)(cid:10)(cid:11,Unknown,8392.0
Unknown,Unknown,32,Unknown,Unknown,Unknown,Unknown,cid:10)(cid:9)(cid:20)(cid:10)(cid:11,Unknown,8424.0
Unknown,Unknown,48,Unknown,Unknown,Unknown,Unknown,cid:10)(cid:9)(cid:20)(cid:10)(cid:11,Unknown,8472.0
Unknown,Unknown,49,Unknown,Unknown,Unknown,Unknown,cid:10)(cid:9)(cid:20)(cid:10)(cid:11,Unknown,8521.0
Unknown,Unknown,3,Unknown,Unknown,Unknown,Unknown,cid:10)(cid:9)(cid:20)(cid:10)(cid:11,Unknown,8524.0
Unknown,Unknown,31,Unknown,Unknown,Unknown,Unknown,cid:10)(cid:9)(cid:20)(cid:10)(cid:11,Unknown,8555.0
Unknown,Unknown,28,Unknown,Unknown,Unknown,Unknown,cid:10)(cid:9)(cid:20)(cid:10)(cid:11,Unknown,8583.0
Unknown,Unknown,45,Unknown,Unknown,Unknown,Unknown,cid:10)(cid:9)(cid:20)(cid:10)(cid:11,Unknown,8628.0
Unknown,Unknown,35,Unknown,Unknown,Unknown,Unknown,cid:10)(cid:9)(cid:20)(cid:10)(cid:11,Unknown,8663.0
Unknown,Unknown,17,Unknown,Unknown,Unknown,Unknown,cid:10)(cid:9)(cid:20)(cid:10)(cid:11,Unknown,8680.0
Unknown,Unknown,32,Unknown,Unknown,Unknown,Unknown,cid:10)(cid:9)(cid:20)(cid:10)(cid:11,Unknown,8712.0
Unknown,Unknown,28,Unknown,Unknown,Unknown,Unknown,cid:10)(cid:9)(cid:20)(cid:10)(cid:11,Unknown,8740.0
Unknown,Unknown,17,Unknown,Unknown,Unknown,Unknown,cid:10)(cid:9)(cid:20)(cid:10)(cid:11,Unknown,8757.0
Unknown,Unknown,34,Unknown,Unknown,Unknown,Unknown,cid:10)(cid:9)(cid:20)(cid:10)(cid:11,Unknown,8791.0
Unknown,Unknown,34,Unknown,Unknown,Unknown,Unknown,cid:10)(cid:9)(cid:20)(cid:10)(cid:11,Unknown,8825.0
Unknown,Unknown,30,Unknown,Unknown,Unknown,Unknown,cid:10)(cid:9)(cid:20)(cid:10)(cid:11,Unknown,8855.0
Unknown,Unknown,31,Unknown,Unknown,Unknown,Unknown,cid:10)(cid:9)(cid:20)(cid:10)(cid:11,Unknown,8886.0
Unknown,Unknown,3,Unknown,Unknown,Unknown,Unknown,cid:10)(cid:9)(cid:20)(cid:10)(cid:11,Unknown,8889.0
Unknown,Unknown,36,Unknown,Unknown,Unknown,Unknown,cid:10)(cid:9)(cid:20)(cid:10)(cid:11,Unknown,8925.0
Unknown,Unknown,1,Unknown,Unknown,Unknown,Unknown,cid:10)(cid:9)(cid:20)(cid:10)(cid:11,Unknown,8926.0
Unknown,Unknown,35,Unknown,Unknown,Unknown,Unknown,cid:10)(cid:9)(cid:20)(cid:10)(cid:11,Unknown,8961.0
Unknown,Unknown,17,Unknown,Unknown,Unknown,Unknown,cid:10)(cid:9)(cid:20)(cid:10)(cid:11,Unknown,8978.0
Unknown,Unknown,32,Unknown,Unknown,Unknown,Unknown,cid:10)(cid:9)(cid:20)(cid:10)(cid:11,Unknown,9010.0
Unknown,Unknown,28,Unknown,Unknown,Unknown,Unknown,cid:10)(cid:9)(cid:20)(cid:10)(cid:11,Unknown,9038.0
Unknown,Unknown,17,Unknown,Unknown,Unknown,Unknown,cid:10)(cid:9)(cid:20)(cid:10)(cid:11,Unknown,9055.0
Unknown,Unknown,34,Unknown,Unknown,Unknown,Unknown,cid:10)(cid:9)(cid:20)(cid:10)(cid:11,Unknown,9089.0
Unknown,Unknown,34,Unknown,Unknown,Unknown,Unknown,cid:10)(cid:9)(cid:20)(cid:10)(cid:11,Unknown,9123.0
Unknown,Unknown,30,Unknown,Unknown,Unknown,Unknown,cid:10)(cid:9)(cid:20)(cid:10)(cid:11,Unknown,9153.0
Unknown,Unknown,31,Unknown,Unknown,Unknown,Unknown,cid:10)(cid:9)(cid:20)(cid:10)(cid:11,Unknown,9184.0
Unknown,Unknown,3,Unknown,Unknown,Unknown,Unknown,cid:10)(cid:9)(cid:20)(cid:10)(cid:11,Unknown,9187.0
Unknown,Unknown,36,Unknown,Unknown,Unknown,Unknown,cid:10)(cid:9)(cid:20)(cid:10)(cid:11,Unknown,9223.0
Unknown,Unknown,1,Unknown,Unknown,Unknown,Unknown,cid:10)(cid:9)(cid:20)(cid:10)(cid:11,Unknown,9224.0
Unknown,Unknown,2,Unknown,Unknown,Unknown,Unknown,cid:10)(cid:9)(cid:20)(cid:10)(cid:11,Unknown,9226.0
Unknown,Unknown,3,Unknown,Unknown,Unknown,Unknown,cid:10)(cid:9)(cid:20)(cid:10)(cid:11,Unknown,9229.0
Unknown,Unknown,6,Unknown,Unknown,Unknown,Unknown,cid:10)(cid:9)(cid:20)(cid:10)(cid:11,Unknown,9235.0
Unknown,Unknown,5,Unknown,Unknown,Unknown,Unknown,cid:10)(cid:9)(cid:20)(cid:10)(cid:11,Unknown,9240.0
Unknown,Unknown,20,Unknown,Unknown,Unknown,Unknown,cid:10)(cid:9)(cid:20)(cid:10)(cid:11,Unknown,9260.0
Unknown,Unknown,10,Unknown,Unknown,Unknown,Unknown,cid:10)(cid:9)(cid:20)(cid:10)(cid:11,Unknown,9270.0
Unknown,Unknown,11,Unknown,Unknown,Unknown,Unknown,cid:10)(cid:9)(cid:20)(cid:10)(cid:11,Unknown,9281.0
Unknown,Unknown,24,Unknown,Unknown,Unknown,Unknown,cid:10)(cid:9)(cid:20)(cid:10)(cid:11,Unknown,9305.0
Unknown,Unknown,1,Unknown,Unknown,Unknown,Unknown,cid:10)(cid:9)(cid:20)(cid:10)(cid:11,Unknown,9306.0
Unknown,Unknown,12,Unknown,Unknown,Unknown,Unknown,cid:10)(cid:9)(cid:20)(cid:10)(cid:11,Unknown,9318.0
Unknown,Unknown,10,Unknown,Unknown,Unknown,Unknown,cid:10)(cid:9)(cid:20)(cid:10)(cid:11,Unknown,9328.0
Unknown,Unknown,25,Unknown,Unknown,Unknown,Unknown,cid:10)(cid:9)(cid:20)(cid:10)(cid:11,Unknown,9353.0
Unknown,Unknown,10,Unknown,Unknown,Unknown,Unknown,cid:10)(cid:9)(cid:20)(cid:10)(cid:11,Unknown,9363.0
Unknown,Unknown,6,Unknown,Unknown,Unknown,Unknown,cid:10)(cid:9)(cid:20)(cid:10)(cid:11,Unknown,9369.0
Unknown,Unknown,1,Unknown,Unknown,Unknown,Unknown,cid:10)(cid:9)(cid:20)(cid:10)(cid:11,Unknown,9370.0
Unknown,Unknown,26,Unknown,Unknown,Unknown,Unknown,cid:10)(cid:9)(cid:20)(cid:10)(cid:11,Unknown,9396.0
Unknown,Unknown,45,Unknown,Unknown,Unknown,Unknown,cid:10)(cid:9)(cid:20)(cid:10)(cid:11,Unknown,9441.0
Unknown,Unknown,10,Unknown,Unknown,Unknown,Unknown,cid:10)(cid:9)(cid:20)(cid:10)(cid:11,Unknown,9451.0
Unknown,Unknown,19,Unknown,Unknown,Unknown,Unknown,cid:10)(cid:9)(cid:20)(cid:10)(cid:11,Unknown,9470.0
Unknown,Unknown,16,Unknown,Unknown,Unknown,Unknown,cid:10)(cid:9)(cid:20)(cid:10)(cid:11,Unknown,9486.0
Unknown,Unknown,7,Unknown,Unknown,Unknown,Unknown,cid:10)(cid:9)(cid:20)(cid:10)(cid:11,Unknown,9493.0
Unknown,Unknown,3,Unknown,Unknown,Unknown,Unknown,cid:10)(cid:9)(cid:20)(cid:10)(cid:11,Unknown,9496.0
Unknown,Unknown,8,Unknown,Unknown,Unknown,Unknown,cid:10)(cid:9)(cid:20)(cid:10)(cid:11,Unknown,9504.0
Unknown,Unknown,28,Unknown,Unknown,Unknown,Unknown,cid:10)(cid:9)(cid:20)(cid:10)(cid:11,Unknown,9532.0
Unknown,Unknown,10,Unknown,Unknown,Unknown,Unknown,cid:10)(cid:9)(cid:20)(cid:10)(cid:11,Unknown,9542.0
Unknown,Unknown,3,Unknown,Unknown,Unknown,Unknown,cid:10)(cid:9)(cid:20)(cid:10)(cid:11,Unknown,9545.0
Unknown,Unknown,6,Unknown,Unknown,Unknown,Unknown,cid:10)(cid:9)(cid:20)(cid:10)(cid:11,Unknown,9551.0
Unknown,Unknown,8,Unknown,Unknown,Unknown,Unknown,cid:10)(cid:9)(cid:20)(cid:10)(cid:11,Unknown,9559.0
Unknown,Unknown,46,Unknown,Unknown,Unknown,Unknown,cid:10)(cid:9)(cid:20)(cid:10)(cid:11,Unknown,9605.0
Unknown,Unknown,46,Unknown,Unknown,Unknown,Unknown,cid:10)(cid:9)(cid:20)(cid:10)(cid:11,Unknown,9651.0
Unknown,Unknown,47,Unknown,Unknown,Unknown,Unknown,cid:10)(cid:9)(cid:20)(cid:10)(cid:11,Unknown,9698.0
Unknown,Unknown,32,Unknown,Unknown,Unknown,Unknown,cid:10)(cid:9)(cid:20)(cid:10)(cid:11,Unknown,9730.0
Unknown,Unknown,48,Unknown,Unknown,Unknown,Unknown,cid:10)(cid:9)(cid:20)(cid:10)(cid:11,Unknown,9778.0
Unknown,Unknown,49,Unknown,Unknown,Unknown,Unknown,cid:10)(cid:9)(cid:20)(cid:10)(cid:11,Unknown,9827.0
Unknown,Unknown,18,Unknown,Unknown,Unknown,Unknown,cid:10)(cid:9)(cid:20)(cid:10)(cid:11,Unknown,9845.0
Unknown,Unknown,31,Unknown,Unknown,Unknown,Unknown,cid:10)(cid:9)(cid:20)(cid:10)(cid:11,Unknown,9876.0
Unknown,Unknown,43,Unknown,Unknown,Unknown,Unknown,cid:10)(cid:9)(cid:20)(cid:10)(cid:11,Unknown,9919.0
Unknown,Unknown,43,Unknown,Unknown,Unknown,Unknown,cid:10)(cid:9)(cid:20)(cid:10)(cid:11,Unknown,9962.0
Unknown,Unknown,31,Unknown,Unknown,Unknown,Unknown,cid:10)(cid:9)(cid:20)(cid:10)(cid:11,Unknown,9993.0
Unknown,Unknown,16,Unknown,Unknown,Unknown,Unknown,cid:10)(cid:9)(cid:20)(cid:10)(cid:11,Unknown,10009.0
Unknown,Unknown,16,Unknown,Unknown,Unknown,Unknown,cid:10)(cid:9)(cid:20)(cid:10)(cid:11,Unknown,10025.0
Unknown,Unknown,27,Unknown,Unknown,Unknown,Unknown,cid:10)(cid:9)(cid:20)(cid:10)(cid:11,Unknown,10052.0
Unknown,Unknown,1,Unknown,Unknown,Unknown,Unknown,cid:10)(cid:9)(cid:20)(cid:10)(cid:11,Unknown,10053.0
Unknown,Unknown,33,Unknown,Unknown,Unknown,Unknown,cid:10)(cid:9)(cid:20)(cid:10)(cid:11,Unknown,10086.0
Unknown,Unknown,31,Unknown,Unknown,Unknown,Unknown,cid:10)(cid:9)(cid:20)(cid:10)(cid:11,Unknown,10117.0
Unknown,Unknown,34,Unknown,Unknown,Unknown,Unknown,cid:10)(cid:9)(cid:20)(cid:10)(cid:11,Unknown,10151.0
Unknown,Unknown,31,Unknown,Unknown,Unknown,Unknown,cid:10)(cid:9)(cid:20)(cid:10)(cid:11,Unknown,10182.0
Unknown,Unknown,34,Unknown,Unknown,Unknown,Unknown,cid:10)(cid:9)(cid:20)(cid:10)(cid:11,Unknown,10216.0
Unknown,Unknown,31,Unknown,Unknown,Unknown,Unknown,cid:10)(cid:9)(cid:20)(cid:10)(cid:11,Unknown,10247.0
Unknown,Unknown,1,Unknown,Unknown,Unknown,Unknown,cid:10)(cid:9)(cid:20)(cid:10)(cid:11,Unknown,10248.0
Unknown,Unknown,28,Unknown,Unknown,Unknown,Unknown,cid:10)(cid:9)(cid:20)(cid:10)(cid:11,Unknown,10276.0
Unknown,Unknown,27,Unknown,Unknown,Unknown,Unknown,cid:10)(cid:9)(cid:20)(cid:10)(cid:11,Unknown,10303.0
Unknown,Unknown,1,Unknown,Unknown,Unknown,Unknown,cid:10)(cid:9)(cid:20)(cid:10)(cid:11,Unknown,10304.0
Unknown,Unknown,2,Unknown,Unknown,Unknown,Unknown,cid:10)(cid:9)(cid:20)(cid:10)(cid:11,Unknown,10306.0
Unknown,Unknown,31,Unknown,Unknown,Unknown,Unknown,cid:10)(cid:9)(cid:20)(cid:10)(cid:11,Unknown,10337.0
Unknown,Unknown,3,Unknown,Unknown,Unknown,Unknown,cid:10)(cid:9)(cid:20)(cid:10)(cid:11,Unknown,10340.0
Unknown,Unknown,16,Unknown,Unknown,Unknown,Unknown,cid:10)(cid:9)(cid:20)(cid:10)(cid:11,Unknown,10356.0
Unknown,Unknown,31,Unknown,Unknown,Unknown,Unknown,cid:10)(cid:9)(cid:20)(cid:10)(cid:11,Unknown,10387.0
Unknown,Unknown,1,Unknown,Unknown,Unknown,Unknown,cid:10)(cid:9)(cid:20)(cid:10)(cid:11,Unknown,10388.0
Unknown,Unknown,36,Unknown,Unknown,Unknown,Unknown,cid:10)(cid:9)(cid:20)(cid:10)(cid:11,Unknown,10424.0
Unknown,Unknown,17,Unknown,Unknown,Unknown,Unknown,cid:10)(cid:9)(cid:20)(cid:10)(cid:11,Unknown,10441.0
Unknown,Unknown,32,Unknown,Unknown,Unknown,Unknown,cid:10)(cid:9)(cid:20)(cid:10)(cid:11,Unknown,10473.0
Unknown,Unknown,36,Unknown,Unknown,Unknown,Unknown,cid:10)(cid:9)(cid:20)(cid:10)(cid:11,Unknown,10509.0
Unknown,Unknown,1,Unknown,Unknown,Unknown,Unknown,cid:10)(cid:9)(cid:20)(cid:10)(cid:11,Unknown,10510.0
Unknown,Unknown,2,Unknown,Unknown,Unknown,Unknown,cid:10)(cid:9)(cid:20)(cid:10)(cid:11,Unknown,10512.0
Unknown,Unknown,3,Unknown,Unknown,Unknown,Unknown,cid:10)(cid:9)(cid:20)(cid:10)(cid:11,Unknown,10515.0
Unknown,Unknown,6,Unknown,Unknown,Unknown,Unknown,cid:10)(cid:9)(cid:20)(cid:10)(cid:11,Unknown,10521.0
Unknown,Unknown,7,Unknown,Unknown,Unknown,Unknown,cid:10)(cid:9)(cid:20)(cid:10)(cid:11,Unknown,10528.0
Unknown,Unknown,20,Unknown,Unknown,Unknown,Unknown,cid:10)(cid:9)(cid:20)(cid:10)(cid:11,Unknown,10548.0
Unknown,Unknown,10,Unknown,Unknown,Unknown,Unknown,cid:10)(cid:9)(cid:20)(cid:10)(cid:11,Unknown,10558.0
Unknown,Unknown,11,Unknown,Unknown,Unknown,Unknown,cid:10)(cid:9)(cid:20)(cid:10)(cid:11,Unknown,10569.0
Unknown,Unknown,24,Unknown,Unknown,Unknown,Unknown,cid:10)(cid:9)(cid:20)(cid:10)(cid:11,Unknown,10593.0
Unknown,Unknown,1,Unknown,Unknown,Unknown,Unknown,cid:10)(cid:9)(cid:20)(cid:10)(cid:11,Unknown,10594.0
Unknown,Unknown,8,Unknown,Unknown,Unknown,Unknown,cid:10)(cid:9)(cid:20)(cid:10)(cid:11,Unknown,10602.0
Unknown,Unknown,10,Unknown,Unknown,Unknown,Unknown,cid:10)(cid:9)(cid:20)(cid:10)(cid:11,Unknown,10612.0
Unknown,Unknown,25,Unknown,Unknown,Unknown,Unknown,cid:10)(cid:9)(cid:20)(cid:10)(cid:11,Unknown,10637.0
Unknown,Unknown,10,Unknown,Unknown,Unknown,Unknown,cid:10)(cid:9)(cid:20)(cid:10)(cid:11,Unknown,10647.0
Unknown,Unknown,10,Unknown,Unknown,Unknown,Unknown,cid:10)(cid:9)(cid:20)(cid:10)(cid:11,Unknown,10657.0
Unknown,Unknown,1,Unknown,Unknown,Unknown,Unknown,cid:10)(cid:9)(cid:20)(cid:10)(cid:11,Unknown,10658.0
Unknown,Unknown,26,Unknown,Unknown,Unknown,Unknown,cid:10)(cid:9)(cid:20)(cid:10)(cid:11,Unknown,10684.0
Unknown,Unknown,45,Unknown,Unknown,Unknown,Unknown,cid:10)(cid:9)(cid:20)(cid:10)(cid:11,Unknown,10729.0
Unknown,Unknown,10,Unknown,Unknown,Unknown,Unknown,cid:10)(cid:9)(cid:20)(cid:10)(cid:11,Unknown,10739.0
Unknown,Unknown,19,Unknown,Unknown,Unknown,Unknown,cid:10)(cid:9)(cid:20)(cid:10)(cid:11,Unknown,10758.0
Unknown,Unknown,16,Unknown,Unknown,Unknown,Unknown,cid:10)(cid:9)(cid:20)(cid:10)(cid:11,Unknown,10774.0
Unknown,Unknown,7,Unknown,Unknown,Unknown,Unknown,cid:10)(cid:9)(cid:20)(cid:10)(cid:11,Unknown,10781.0
Unknown,Unknown,3,Unknown,Unknown,Unknown,Unknown,cid:10)(cid:9)(cid:20)(cid:10)(cid:11,Unknown,10784.0
Unknown,Unknown,8,Unknown,Unknown,Unknown,Unknown,cid:10)(cid:9)(cid:20)(cid:10)(cid:11,Unknown,10792.0
Unknown,Unknown,28,Unknown,Unknown,Unknown,Unknown,cid:10)(cid:9)(cid:20)(cid:10)(cid:11,Unknown,10820.0
Unknown,Unknown,10,Unknown,Unknown,Unknown,Unknown,cid:10)(cid:9)(cid:20)(cid:10)(cid:11,Unknown,10830.0
Unknown,Unknown,3,Unknown,Unknown,Unknown,Unknown,cid:10)(cid:9)(cid:20)(cid:10)(cid:11,Unknown,10833.0
Unknown,Unknown,6,Unknown,Unknown,Unknown,Unknown,cid:10)(cid:9)(cid:20)(cid:10)(cid:11,Unknown,10839.0
Unknown,Unknown,8,Unknown,Unknown,Unknown,Unknown,cid:10)(cid:9)(cid:20)(cid:10)(cid:11,Unknown,10847.0
Unknown,Unknown,46,Unknown,Unknown,Unknown,Unknown,cid:10)(cid:9)(cid:20)(cid:10)(cid:11,Unknown,10893.0
Unknown,Unknown,46,Unknown,Unknown,Unknown,Unknown,cid:10)(cid:9)(cid:20)(cid:10)(cid:11,Unknown,10939.0
Unknown,Unknown,47,Unknown,Unknown,Unknown,Unknown,cid:10)(cid:9)(cid:20)(cid:10)(cid:11,Unknown,10986.0
Unknown,Unknown,32,Unknown,Unknown,Unknown,Unknown,cid:10)(cid:9)(cid:20)(cid:10)(cid:11,Unknown,11018.0
Unknown,Unknown,48,Unknown,Unknown,Unknown,Unknown,cid:10)(cid:9)(cid:20)(cid:10)(cid:11,Unknown,11066.0
Unknown,Unknown,49,Unknown,Unknown,Unknown,Unknown,cid:10)(cid:9)(cid:20)(cid:10)(cid:11,Unknown,11115.0
Unknown,2,Unknown,2,Unknown,Card,Unknown,Banque Inconnue,qonto,-2.0
Unknown,205,Unknown,205,Unknown,Card,Unknown,Banque Inconnue,EGB 2 RUE WINSTON CHURCHILL,-207.0
Unknown,1,Unknown,1,Unknown,Card,Unknown,Banque Inconnue,Coulommiers France,-208.0
Unknown,28,Unknown,28,Unknown,Card,Unknown,Banque Inconnue,IBAN,-236.0
Unknown,1,Unknown,1,Unknown,Card,Unknown,Banque Inconnue,QNTOFRPIXXX,-237.0
Unknown,"415,07",Unknown,"415,07",Unknown,Card,Unknown,Banque Inconnue,Qonto,-41744.0
Unknown,"1 195,00",Unknown,"1 195,00",Unknown,Card,Unknown,Banque Inconnue,Apple Pay,-161244.0
Unknown,"1 608,09",Unknown,"1 608,09",Unknown,Card,Unknown,Banque Inconnue,SYNTHÈSE DE VOTRE COMPTE,-322053.0
Unknown,28,Unknown,28,Unknown,Card,Unknown,Banque Inconnue,Solde,-322081.0
Unknown,"1,98",Unknown,"1,98",Unknown,Card,Unknown,Banque Inconnue,Solde,-322279.0
Unknown,01,Unknown,01,Unknown,Card,Unknown,Banque Inconnue,Qonto,-322280.0
Unknown,02,Unknown,02,Unknown,Card,Unknown,Banque Inconnue,VILLEVAUDE FR,-322282.0
Unknown,"18,00",Unknown,"18,00",Unknown,Card,Unknown,Banque Inconnue,SANEF AUTOROUTE,-324082.0
Unknown,01,Unknown,01,Unknown,Card,Unknown,Banque Inconnue,Qonto,-324083.0
Unknown,02 51,Unknown,02 51,Unknown,Card,Unknown,Banque Inconnue,Unknown,-324334.0
Unknown,70,Unknown,70,Unknown,Card,Unknown,Banque Inconnue,Unknown,-324404.0
Unknown,01,Unknown,01,Unknown,Card,Unknown,Banque Inconnue,Unknown,-324405.0
Unknown,02 82,Unknown,02 82,Unknown,Card,Unknown,Banque Inconnue,Unknown,-324687.0
Unknown,97,Unknown,97,Unknown,Card,Unknown,Banque Inconnue,Unknown,-324784.0
Unknown,02,Unknown,02,Unknown,Card,Unknown,Banque Inconnue,Unknown,-324786.0
Unknown,02 30,Unknown,02 30,Unknown,Card,Unknown,Banque Inconnue,Unknown,-325016.0
Unknown,03,Unknown,03,Unknown,Card,Unknown,Banque Inconnue,Unknown,-325019.0
Unknown,02,Unknown,02,Unknown,Card,Unknown,Banque Inconnue,Unknown,-325021.0
Unknown,02 72,Unknown,02 72,Unknown,Card,Unknown,Banque Inconnue,Unknown,-325293.0
Unknown,00,Unknown,00,Unknown,Card,Unknown,Banque Inconnue,Unknown,-325293.0
Unknown,02,Unknown,02,Unknown,Card,Unknown,Banque Inconnue,Unknown,-325295.0
Unknown,02,Unknown,02,Unknown,Card,Unknown,Banque Inconnue,Unknown,-325297.0
Unknown,"1,90",Unknown,"1,90",Unknown,Card,Unknown,Banque Inconnue,Unknown,-325487.0
Unknown,06,Unknown,06,Unknown,Card,Unknown,Banque Inconnue,Unknown,-325493.0
Unknown,60,Unknown,60,Unknown,Card,Unknown,Banque Inconnue,Unknown,-325553.0
Unknown,80,Unknown,80,Unknown,Card,Unknown,Banque Inconnue,Unknown,-325633.0
Unknown,1,Unknown,1,Unknown,Card,Unknown,Banque Inconnue,Unknown,-325634.0
Unknown,3,Unknown,3,Unknown,Card,Unknown,Banque Inconnue,Unknown,-325637.0
01/03/2022,97,Unknown,97,Unknown,Unknown,Unknown,"Crédit 2.952,73",SOCIETE GENERALE RELEVÉ DE COMPTE,-97.0
31/03/2022,01,Unknown,01,Unknown,Unknown,Unknown,"Crédit 2.952,73",Page 2/2 Date Valeur,-98.0
30/03/2022,03,Unknown,03,Unknown,Unknown,Unknown,"Crédit 2.952,73",FNAC STE GENNEVI,-101.0
30/03/2022,31,Unknown,31,Unknown,Unknown,Unknown,"Crédit 2.952,73",CARTE,-132.0
30/03/2022,03,Unknown,03,Unknown,Unknown,Unknown,"Crédit 2.952,73",SG,-135.0
30/03/2022,3,Unknown,3,Unknown,Unknown,Unknown,"Crédit 2.952,73",MORSANG,-138.0
30/03/2022,2,Unknown,2,Unknown,Unknown,Unknown,"Crédit 2.952,73",TOTAUX DES MOUVEMENTS,-140.0
30/03/2022,2,Unknown,2,Unknown,Unknown,Unknown,"Crédit 2.952,73",SOLDE AU,-142.0
31/03/2022,30,Unknown,30,Unknown,Unknown,Unknown,"Crédit 2.952,73",Opération,-172.0
31/03/2022,03,Unknown,03,Unknown,Unknown,Unknown,"Crédit 2.952,73",Résolution,-175.0
31/03/2022,30,Unknown,30,Unknown,Unknown,Unknown,"Crédit 2.952,73",PROGRAMME DE FIDÉLITÉ JAZZ DOUBLE,-205.0
31/03/2022,03,Unknown,03,Unknown,Unknown,Unknown,"Crédit 2.952,73",CB Visa Gold Business,-208.0
01/09/2021,29,Unknown,29,Unknown,Unknown,Unknown,"Crédit 2.952,73",Jazz Pro,-237.0
Unknown,03,Unknown,03,Unknown,Unknown,Unknown,"Crédit 2.952,73",CB Visa Gold Business,-240.0
Unknown,30,Unknown,30,Unknown,Unknown,Unknown,"Crédit 2.952,73",Jazz Pro,-270.0
Unknown,03,Unknown,03,Unknown,Unknown,Unknown,"Crédit 2.952,73","RCS Pais Siege Social 29,bd Haussmann",-273.0
Unknown,30,Unknown,30,Unknown,Unknown,Unknown,"Crédit 2.952,73",Paris,-303.0
Unknown,03,Unknown,03,Unknown,Unknown,Unknown,"Crédit 2.952,73",Unknown,-306.0
Unknown,29,Unknown,29,Unknown,Unknown,Unknown,"Crédit 2.952,73",Unknown,-335.0
Unknown,03,Unknown,03,Unknown,Unknown,Unknown,"Crédit 2.952,73",Unknown,-338.0
Unknown,30,Unknown,30,Unknown,Unknown,Unknown,"Crédit 2.952,73",Unknown,-368.0
Unknown,03,Unknown,03,Unknown,Unknown,Unknown,"Crédit 2.952,73",Unknown,-371.0
Unknown,30,Unknown,30,Unknown,Unknown,Unknown,"Crédit 2.952,73",Unknown,-401.0
Unknown,03,Unknown,03,Unknown,Unknown,Unknown,"Crédit 2.952,73",Unknown,-404.0
Unknown,29,Unknown,29,Unknown,Unknown,Unknown,"Crédit 2.952,73",Unknown,-433.0
Unknown,03,Unknown,03,Unknown,Unknown,Unknown,"Crédit 2.952,73",Unknown,-436.0
Unknown,31,Unknown,31,Unknown,Unknown,Unknown,"Crédit 2.952,73",Unknown,-467.0
Unknown,03,Unknown,03,Unknown,Unknown,Unknown,"Crédit 2.952,73",Unknown,-470.0
Unknown,31,Unknown,31,Unknown,Unknown,Unknown,"Crédit 2.952,73",Unknown,-501.0
Unknown,03,Unknown,03,Unknown,Unknown,Unknown,"Crédit 2.952,73",Unknown,-504.0
Unknown,30,Unknown,30,Unknown,Unknown,Unknown,"Crédit 2.952,73",Unknown,-534.0
Unknown,03,Unknown,03,Unknown,Unknown,Unknown,"Crédit 2.952,73",Unknown,-537.0
Unknown,"29,99",Unknown,"29,99",Unknown,Unknown,Unknown,"Crédit 2.952,73",Unknown,-3536.0
Unknown,"29,99",Unknown,"29,99",Unknown,Unknown,Unknown,"Crédit 2.952,73",Unknown,-6535.0
Unknown,"327,99",Unknown,"327,99",Unknown,Unknown,Unknown,"Crédit 2.952,73",Unknown,-39334.0
Unknown,"310,00",Unknown,"310,00",Unknown,Unknown,Unknown,"Crédit 2.952,73",Unknown,-70334.0
Unknown,"2.952,73",Unknown,"2.952,73",Unknown,Unknown,Unknown,"Crédit 2.952,73",Unknown,-70336.95273
Unknown,"10,28",Unknown,"10,28",Unknown,Unknown,Unknown,"Crédit 2.952,73",Unknown,-71364.95273
Unknown,31,Unknown,31,Unknown,Unknown,Unknown,"Crédit 2.952,73",Unknown,-71395.95273
Unknown,03,Unknown,03,Unknown,Unknown,Unknown,"Crédit 2.952,73",Unknown,-71398.95273
Unknown,"1.714,96",Unknown,"1.714,96",Unknown,Unknown,Unknown,"Crédit 2.952,73",Unknown,-71400.66769
Unknown,31,Unknown,31,Unknown,Unknown,Unknown,"Crédit 2.952,73",Unknown,-71431.66769
Unknown,03,Unknown,03,Unknown,Unknown,Unknown,"Crédit 2.952,73",Unknown,-71434.66769
Unknown,"4 832,19",Unknown,"4 832,19",Unknown,Unknown,Unknown,"Crédit 2.952,73",Unknown,-554653.66769
Unknown,01,Unknown,01,Unknown,Unknown,Unknown,"Crédit 2.952,73",Unknown,-554654.66769
Unknown,09,Unknown,09,Unknown,Unknown,Unknown,"Crédit 2.952,73",Unknown,-554663.66769
Unknown,15,Unknown,15,Unknown,Unknown,Unknown,"Crédit 2.952,73",Unknown,-554678.66769
Unknown,12,Unknown,12,Unknown,Unknown,Unknown,"Crédit 2.952,73",Unknown,-554690.66769
Unknown,35,Unknown,35,Unknown,Unknown,Unknown,"Crédit 2.952,73",Unknown,-554725.66769
Unknown,15 000,Unknown,15 000,Unknown,Unknown,Unknown,"Crédit 2.952,73",Unknown,-569725.66769
Unknown,12,Unknown,12,Unknown,Unknown,Unknown,"Crédit 2.952,73",Unknown,-569737.66769
Unknown,35,Unknown,35,Unknown,Unknown,Unknown,"Crédit 2.952,73",Unknown,-569772.66769
Unknown,7 500,Unknown,7 500,Unknown,Unknown,Unknown,"Crédit 2.952,73",Unknown,-577272.66769
Unknown,12,Unknown,12,Unknown,Unknown,Unknown,"Crédit 2.952,73",Unknown,-577284.66769
Unknown,25,Unknown,25,Unknown,Unknown,Unknown,"Crédit 2.952,73",Unknown,-577309.66769
Unknown,1 552 120 222,Unknown,1 552 120 222,Unknown,Unknown,Unknown,"Crédit 2.952,73",Unknown,-1552697531.66769
Unknown,29,Unknown,29,Unknown,Unknown,Unknown,"Crédit 2.952,73",Unknown,-1552697560.66769
Unknown,"046 405 540,00",Unknown,"046 405 540,00",Unknown,Unknown,Unknown,"Crédit 2.952,73",Unknown,-6193251560.66769
Unknown,002,Unknown,002,Unknown,Unknown,Unknown,"Crédit 2.952,73",Unknown,-6193251562.66769
Unknown,002,Unknown,002,Unknown,Unknown,Unknown,"Crédit 2.952,73",Unknown,-6193251564.66769
14/01/2019,1,Unknown,1,Unknown,POS,Unknown,MR,BANQUE POSTALE Releve,-1.0
11/01/2019,14,Unknown,14,Unknown,POS,Unknown,MR,GRAND TURC,-15.0
Unknown,01,Unknown,01,Unknown,POS,Unknown,MR,CARTE X1580 09/01/19 A 17h45,-16.0
Unknown,11 034 07,Unknown,11 034 07,Unknown,POS,Unknown,MR,CARTE X1580 10/01/19 A 10H39,-1103423.0
Unknown,028,Unknown,028,Unknown,POS,Unknown,MR,ReTRAIT,-1103451.0
Unknown,09,Unknown,09,Unknown,POS,Unknown,MR,CARTE X1580 10/01/19,-1103460.0
Unknown,01,Unknown,01,Unknown,POS,Unknown,MR,Planifiez vos dépenses,-1103461.0
Unknown,08.01,Unknown,08.01,Unknown,POS,Unknown,MR,Renseignez,-1103469.01
Unknown,19,Unknown,19,Unknown,POS,Unknown,MR,Conseiller,-1103488.01
Unknown,580 10,Unknown,580 10,Unknown,POS,Unknown,MR,Coût de connerion,-1161498.01
Unknown,01,Unknown,01,Unknown,POS,Unknown,MR,Prix dun appel local,-1161499.01
Unknown,09,Unknown,09,Unknown,POS,Unknown,MR,Service,-1161508.01
Unknown,01,Unknown,01,Unknown,POS,Unknown,MR,prix dun appel Frais,-1161509.01
Unknown,19,Unknown,19,Unknown,POS,Unknown,MR,Qu remboursés,-1161528.01
Unknown,10,Unknown,10,Unknown,POS,Unknown,MR,Unknown,-1161538.01
Unknown,01,Unknown,01,Unknown,POS,Unknown,MR,Unknown,-1161539.01
Unknown,09.01,Unknown,09.01,Unknown,POS,Unknown,MR,Unknown,-1161548.02
Unknown,19,Unknown,19,Unknown,POS,Unknown,MR,Unknown,-1161567.02
Unknown,580 11,Unknown,580 11,Unknown,POS,Unknown,MR,Unknown,-1219578.02
Unknown,01,Unknown,01,Unknown,POS,Unknown,MR,Unknown,-1219579.02
Unknown,10,Unknown,10,Unknown,POS,Unknown,MR,Unknown,-1219589.02
Unknown,01,Unknown,01,Unknown,POS,Unknown,MR,Unknown,-1219590.02
Unknown,19,Unknown,19,Unknown,POS,Unknown,MR,Unknown,-1219609.02
Unknown,11,Unknown,11,Unknown,POS,Unknown,MR,Unknown,-1219620.02
Unknown,01,Unknown,01,Unknown,POS,Unknown,MR,Unknown,-1219621.02
Unknown,10,Unknown,10,Unknown,POS,Unknown,MR,Unknown,-1219631.02
Unknown,01,Unknown,01,Unknown,POS,Unknown,MR,Unknown,-1219632.02
Unknown,19,Unknown,19,Unknown,POS,Unknown,MR,Unknown,-1219651.02
Unknown,0,Unknown,0,Unknown,POS,Unknown,MR,Unknown,-1219651.02
Unknown,"35,00",Unknown,"35,00",Unknown,POS,Unknown,MR,Unknown,-1223151.02
Unknown,"10,00",Unknown,"10,00",Unknown,POS,Unknown,MR,Unknown,-1224151.02
Unknown,"4,57",Unknown,"4,57",Unknown,POS,Unknown,MR,Unknown,-1224608.02
Unknown,"200,00",Unknown,"200,00",Unknown,POS,Unknown,MR,Unknown,-1244608.02
Unknown,"250,00",Unknown,"250,00",Unknown,POS,Unknown,MR,Unknown,-1269608.02
Unknown,"2 922,44",Unknown,"2 922,44",Unknown,POS,Unknown,MR,Unknown,-1561852.02
Unknown,"2 204,09",Unknown,"2 204,09",Unknown,POS,Unknown,MR,Unknown,-1782261.02
Unknown,11,Unknown,11,Unknown,POS,Unknown,MR,Unknown,-1782272.02
Unknown,01,Unknown,01,Unknown,POS,Unknown,MR,Unknown,-1782273.02
Unknown,"765,00",Unknown,"765,00",Unknown,POS,Unknown,MR,Unknown,-1858773.02
Unknown,1,Unknown,1,Unknown,POS,Unknown,MR,Unknown,-1858774.02
Unknown,2,Unknown,2,Unknown,POS,Unknown,MR,Unknown,-1858776.02
Unknown,3,Unknown,3,Unknown,POS,Unknown,MR,Unknown,-1858779.02
Unknown,4,Unknown,4,Unknown,POS,Unknown,MR,Unknown,-1858783.02
Unknown,"0,15",Unknown,"0,15",Unknown,POS,Unknown,MR,Unknown,-1858798.02
Unknown,2,Unknown,2,Unknown,POS,Unknown,MR,Unknown,-1858800.02
Unknown,2,Unknown,2,Unknown,POS,Unknown,MR,Unknown,-1858802.02
01/02/2022,97,Unknown,97,Unknown,Unknown,Unknown,Appli Pro,SOCIETE GENERALE RELEVÉ DE COMPTE,-97.0
28/02/2022,01,Unknown,01,Unknown,Unknown,Unknown,Appli Pro,Page 1/2 VOS CONTACTS Votre Banque,-98.0
31/01/2022,02,Unknown,02,Unknown,Unknown,Unknown,Appli Pro,Distance,-100.0
01/02/2022,28,Unknown,28,Unknown,Unknown,Unknown,Appli Pro,"0,3o€/min prix",-128.0
01/02/2022,02,Unknown,02,Unknown,Unknown,Unknown,Appli Pro,STE GENEV,-130.0
04/02/2022,2,Unknown,2,Unknown,Unknown,Unknown,Appli Pro,PerI,-132.0
04/02/2022,1,Unknown,1,Unknown,Unknown,Unknown,Appli Pro,ABCI,-133.0
04/02/2022,2,Unknown,2,Unknown,Unknown,Unknown,Appli Pro,STE GENEVIEVE DES BOIS,-135.0
04/02/2022,0,Unknown,0,Unknown,Unknown,Unknown,Appli Pro,dylan barbanchon@socgen com,-135.0
07/02/2022,01 60,Unknown,01 60,Unknown,Unknown,Unknown,Appli Pro,P5I RELEVÉ DES OPÉRATIONS Date Valeur,-295.0
07/02/2022,16 05,Unknown,16 05,Unknown,Unknown,Unknown,Appli Pro,CARTE,-1900.0
07/02/2022,48,Unknown,48,Unknown,Unknown,Unknown,Appli Pro,CARTE,-1948.0
07/02/2022,01 69,Unknown,01 69,Unknown,Unknown,Unknown,Appli Pro,GEANT CG328,-2117.0
07/02/2022,51 30,Unknown,51 30,Unknown,Unknown,Unknown,Appli Pro,CARTE,-7247.0
07/02/2022,83,Unknown,83,Unknown,Unknown,Unknown,Appli Pro,CBAM,-7330.0
10/02/2022,75,Unknown,75,Unknown,Unknown,Unknown,Appli Pro,BUREAUVALL,-7405.0
10/02/2022,15,Unknown,15,Unknown,Unknown,Unknown,Appli Pro,CARTE X8155,-7420.0
14/02/2022,01 60,Unknown,01 60,Unknown,Unknown,Unknown,Appli Pro,CARTE X8155,-7580.0
14/02/2022,16 87,Unknown,16 87,Unknown,Unknown,Unknown,Appli Pro,FNAC STE GENNEVI,-9267.0
15/02/2022,75,Unknown,75,Unknown,Unknown,Unknown,Appli Pro,CARTE X8155,-9342.0
15/02/2022,31,Unknown,31,Unknown,Unknown,Unknown,Appli Pro,CBAM,-9373.0
17/02/2022,01,Unknown,01,Unknown,Unknown,Unknown,Appli Pro,BUREAUVALL,-9374.0
16/02/2022,01,Unknown,01,Unknown,Unknown,Unknown,Appli Pro,CARTE,-9375.0
17/02/2022,02,Unknown,02,Unknown,Unknown,Unknown,Appli Pro,SG,-9377.0
16/02/2022,01,Unknown,01,Unknown,Unknown,Unknown,Appli Pro,CARTE,-9378.0
18/02/2022,02,Unknown,02,Unknown,Unknown,Unknown,Appli Pro,CARTE,-9380.0
18/02/2022,31,Unknown,31,Unknown,Unknown,Unknown,Appli Pro,RETRAIT,-9411.0
21/02/2022,01,Unknown,01,Unknown,Unknown,Unknown,Appli Pro,CIC SAINTE,-9412.0
21/02/2022,04,Unknown,04,Unknown,Unknown,Unknown,Appli Pro,NT,-9416.0
21/02/2022,02,Unknown,02,Unknown,Unknown,Unknown,Appli Pro,EUR TVA,-9418.0
21/02/2022,04,Unknown,04,Unknown,Unknown,Unknown,Appli Pro,EUR,-9422.0
21/02/2022,02,Unknown,02,Unknown,Unknown,Unknown,Appli Pro,NT,-9424.0
21/02/2022,03,Unknown,03,Unknown,Unknown,Unknown,Appli Pro,EUR,-9427.0
24/02/2022,02,Unknown,02,Unknown,Unknown,Unknown,Appli Pro,CARTE,-9429.0
24/02/2022,04,Unknown,04,Unknown,Unknown,Unknown,Appli Pro,CARTE X8155,-9433.0
25/02/2022,02,Unknown,02,Unknown,Unknown,Unknown,Appli Pro,SG,-9435.0
25/02/2022,04,Unknown,04,Unknown,Unknown,Unknown,Appli Pro,MORSANG SUR ORGE,-9439.0
01/03/2020,02,Unknown,02,Unknown,Unknown,Unknown,Appli Pro,CARTE X8155,-9441.0
Unknown,03,Unknown,03,Unknown,Unknown,Unknown,Appli Pro,CLEAN,-9444.0
Unknown,02,Unknown,02,Unknown,Unknown,Unknown,Appli Pro,CARTE X8155,-9446.0
Unknown,07,Unknown,07,Unknown,Unknown,Unknown,Appli Pro,NORAUTO,-9453.0
Unknown,02,Unknown,02,Unknown,Unknown,Unknown,Appli Pro,CARTE,-9455.0
Unknown,07,Unknown,07,Unknown,Unknown,Unknown,Appli Pro,CBAM,-9462.0
Unknown,02,Unknown,02,Unknown,Unknown,Unknown,Appli Pro,BUREAUVALL,-9464.0
Unknown,04,Unknown,04,Unknown,Unknown,Unknown,Appli Pro,CARTE,-9468.0
Unknown,02,Unknown,02,Unknown,Unknown,Unknown,Appli Pro,SG,-9470.0
Unknown,07,Unknown,07,Unknown,Unknown,Unknown,Appli Pro,MORSANG SUR ORGE 00915459 Débit Crédit,-9477.0
Unknown,02,Unknown,02,Unknown,Unknown,Unknown,Appli Pro,Paris,-9479.0
Unknown,07,Unknown,07,Unknown,Unknown,Unknown,Appli Pro,com 3 Le Mediateur,-9486.0
Unknown,02,Unknown,02,Unknown,Unknown,Unknown,Appli Pro,Charte de la Mediation Société Générale,-9488.0
Unknown,04,Unknown,04,Unknown,Unknown,Unknown,Appli Pro,Le Médlateur,-9492.0
Unknown,02,Unknown,02,Unknown,Unknown,Unknown,Appli Pro,Valmy,-9494.0
Unknown,07,Unknown,07,Unknown,Unknown,Unknown,Appli Pro,Paris,-9501.0
Unknown,02,Unknown,02,Unknown,Unknown,Unknown,Appli Pro,Mediateur www mediateur societegenerale fr,-9503.0
Unknown,07,Unknown,07,Unknown,Unknown,Unknown,Appli Pro,Médiateur,-9510.0
Unknown,02,Unknown,02,Unknown,Unknown,Unknown,Appli Pro,Sociole Genérale,-9512.0
Unknown,04,Unknown,04,Unknown,Unknown,Unknown,Appli Pro,RCS Pais,-9516.0
Unknown,02,Unknown,02,Unknown,Unknown,Unknown,Appli Pro,Eur Siège,-9518.0
Unknown,10,Unknown,10,Unknown,Unknown,Unknown,Appli Pro,Paris,-9528.0
Unknown,02,Unknown,02,Unknown,Unknown,Unknown,Appli Pro,VeRT,-9530.0
Unknown,10,Unknown,10,Unknown,Unknown,Unknown,Appli Pro,Unknown,-9540.0
Unknown,02,Unknown,02,Unknown,Unknown,Unknown,Appli Pro,Unknown,-9542.0
Unknown,09,Unknown,09,Unknown,Unknown,Unknown,Appli Pro,Unknown,-9551.0
Unknown,02,Unknown,02,Unknown,Unknown,Unknown,Appli Pro,Unknown,-9553.0
Unknown,14,Unknown,14,Unknown,Unknown,Unknown,Appli Pro,Unknown,-9567.0
Unknown,02,Unknown,02,Unknown,Unknown,Unknown,Appli Pro,Unknown,-9569.0
Unknown,14,Unknown,14,Unknown,Unknown,Unknown,Appli Pro,Unknown,-9583.0
Unknown,02,Unknown,02,Unknown,Unknown,Unknown,Appli Pro,Unknown,-9585.0
Unknown,12,Unknown,12,Unknown,Unknown,Unknown,Appli Pro,Unknown,-9597.0
Unknown,02,Unknown,02,Unknown,Unknown,Unknown,Appli Pro,Unknown,-9599.0
Unknown,15,Unknown,15,Unknown,Unknown,Unknown,Appli Pro,Unknown,-9614.0
Unknown,02,Unknown,02,Unknown,Unknown,Unknown,Appli Pro,Unknown,-9616.0
Unknown,15,Unknown,15,Unknown,Unknown,Unknown,Appli Pro,Unknown,-9631.0
Unknown,02,Unknown,02,Unknown,Unknown,Unknown,Appli Pro,Unknown,-9633.0
Unknown,12,Unknown,12,Unknown,Unknown,Unknown,Appli Pro,Unknown,-9645.0
Unknown,02,Unknown,02,Unknown,Unknown,Unknown,Appli Pro,Unknown,-9647.0
Unknown,17,Unknown,17,Unknown,Unknown,Unknown,Appli Pro,Unknown,-9664.0
Unknown,02,Unknown,02,Unknown,Unknown,Unknown,Appli Pro,Unknown,-9666.0
Unknown,16,Unknown,16,Unknown,Unknown,Unknown,Appli Pro,Unknown,-9682.0
Unknown,02,Unknown,02,Unknown,Unknown,Unknown,Appli Pro,Unknown,-9684.0
Unknown,25,Unknown,25,Unknown,Unknown,Unknown,Appli Pro,Unknown,-9709.0
Unknown,"7,13",Unknown,"7,13",Unknown,Unknown,Unknown,Appli Pro,Unknown,-10422.0
Unknown,"2,62",Unknown,"2,62",Unknown,Unknown,Unknown,Appli Pro,Unknown,-10684.0
Unknown,"20,00",Unknown,"20,00",Unknown,Unknown,Unknown,Appli Pro,Unknown,-12684.0
Unknown,"0,53",Unknown,"0,53",Unknown,Unknown,Unknown,Appli Pro,Unknown,-12737.0
Unknown,17,Unknown,17,Unknown,Unknown,Unknown,Appli Pro,Unknown,-12754.0
Unknown,02,Unknown,02,Unknown,Unknown,Unknown,Appli Pro,Unknown,-12756.0
Unknown,16,Unknown,16,Unknown,Unknown,Unknown,Appli Pro,Unknown,-12772.0
Unknown,02,Unknown,02,Unknown,Unknown,Unknown,Appli Pro,Unknown,-12774.0
Unknown,"28,57",Unknown,"28,57",Unknown,Unknown,Unknown,Appli Pro,Unknown,-15631.0
Unknown,"10,43",Unknown,"10,43",Unknown,Unknown,Unknown,Appli Pro,Unknown,-16674.0
Unknown,"20,00",Unknown,"20,00",Unknown,Unknown,Unknown,Appli Pro,Unknown,-18674.0
Unknown,"2,09",Unknown,"2,09",Unknown,Unknown,Unknown,Appli Pro,Unknown,-18883.0
Unknown,18,Unknown,18,Unknown,Unknown,Unknown,Appli Pro,Unknown,-18901.0
Unknown,02,Unknown,02,Unknown,Unknown,Unknown,Appli Pro,Unknown,-18903.0
Unknown,18,Unknown,18,Unknown,Unknown,Unknown,Appli Pro,Unknown,-18921.0
Unknown,02,Unknown,02,Unknown,Unknown,Unknown,Appli Pro,Unknown,-18923.0
Unknown,17,Unknown,17,Unknown,Unknown,Unknown,Appli Pro,Unknown,-18940.0
Unknown,02,Unknown,02,Unknown,Unknown,Unknown,Appli Pro,Unknown,-18942.0
Unknown,21,Unknown,21,Unknown,Unknown,Unknown,Appli Pro,Unknown,-18963.0
Unknown,02,Unknown,02,Unknown,Unknown,Unknown,Appli Pro,Unknown,-18965.0
Unknown,21,Unknown,21,Unknown,Unknown,Unknown,Appli Pro,Unknown,-18986.0
Unknown,02,Unknown,02,Unknown,Unknown,Unknown,Appli Pro,Unknown,-18988.0
Unknown,18,Unknown,18,Unknown,Unknown,Unknown,Appli Pro,Unknown,-19006.0
Unknown,02,Unknown,02,Unknown,Unknown,Unknown,Appli Pro,Unknown,-19008.0
Unknown,21,Unknown,21,Unknown,Unknown,Unknown,Appli Pro,Unknown,-19029.0
Unknown,02,Unknown,02,Unknown,Unknown,Unknown,Appli Pro,Unknown,-19031.0
Unknown,21,Unknown,21,Unknown,Unknown,Unknown,Appli Pro,Unknown,-19052.0
Unknown,02,Unknown,02,Unknown,Unknown,Unknown,Appli Pro,Unknown,-19054.0
Unknown,18,Unknown,18,Unknown,Unknown,Unknown,Appli Pro,Unknown,-19072.0
Unknown,02,Unknown,02,Unknown,Unknown,Unknown,Appli Pro,Unknown,-19074.0
Unknown,21,Unknown,21,Unknown,Unknown,Unknown,Appli Pro,Unknown,-19095.0
Unknown,02,Unknown,02,Unknown,Unknown,Unknown,Appli Pro,Unknown,-19097.0
Unknown,21,Unknown,21,Unknown,Unknown,Unknown,Appli Pro,Unknown,-19118.0
Unknown,02,Unknown,02,Unknown,Unknown,Unknown,Appli Pro,Unknown,-19120.0
Unknown,18,Unknown,18,Unknown,Unknown,Unknown,Appli Pro,Unknown,-19138.0
Unknown,02,Unknown,02,Unknown,Unknown,Unknown,Appli Pro,Unknown,-19140.0
Unknown,206 24,Unknown,206 24,Unknown,Unknown,Unknown,Appli Pro,Unknown,-39764.0
Unknown,02,Unknown,02,Unknown,Unknown,Unknown,Appli Pro,Unknown,-39766.0
Unknown,24,Unknown,24,Unknown,Unknown,Unknown,Appli Pro,Unknown,-39790.0
Unknown,02,Unknown,02,Unknown,Unknown,Unknown,Appli Pro,Unknown,-39792.0
Unknown,23,Unknown,23,Unknown,Unknown,Unknown,Appli Pro,Unknown,-39815.0
Unknown,02,Unknown,02,Unknown,Unknown,Unknown,Appli Pro,Unknown,-39817.0
Unknown,25,Unknown,25,Unknown,Unknown,Unknown,Appli Pro,Unknown,-39842.0
Unknown,02,Unknown,02,Unknown,Unknown,Unknown,Appli Pro,Unknown,-39844.0
Unknown,25,Unknown,25,Unknown,Unknown,Unknown,Appli Pro,Unknown,-39869.0
Unknown,02,Unknown,02,Unknown,Unknown,Unknown,Appli Pro,Unknown,-39871.0
Unknown,24,Unknown,24,Unknown,Unknown,Unknown,Appli Pro,Unknown,-39895.0
Unknown,02,Unknown,02,Unknown,Unknown,Unknown,Appli Pro,Unknown,-39897.0
Unknown,"6.784,10",Unknown,"6.784,10",Unknown,Unknown,Unknown,Appli Pro,Unknown,-39903.7841
Unknown,"524,83",Unknown,"524,83",Unknown,Unknown,Unknown,Appli Pro,Unknown,-92386.7841
Unknown,"38,82",Unknown,"38,82",Unknown,Unknown,Unknown,Appli Pro,Unknown,-96268.7841
Unknown,"96,49",Unknown,"96,49",Unknown,Unknown,Unknown,Appli Pro,Unknown,-105917.7841
Unknown,"8,00",Unknown,"8,00",Unknown,Unknown,Unknown,Appli Pro,Unknown,-106717.7841
Unknown,"12,99",Unknown,"12,99",Unknown,Unknown,Unknown,Appli Pro,Unknown,-108016.7841
Unknown,"94,94",Unknown,"94,94",Unknown,Unknown,Unknown,Appli Pro,Unknown,-117510.7841
Unknown,"310,00",Unknown,"310,00",Unknown,Unknown,Unknown,Appli Pro,Unknown,-148510.7841
Unknown,"127,54",Unknown,"127,54",Unknown,Unknown,Unknown,Appli Pro,Unknown,-161264.7841
Unknown,"190,00",Unknown,"190,00",Unknown,Unknown,Unknown,Appli Pro,Unknown,-180264.7841
Unknown,"10,28",Unknown,"10,28",Unknown,Unknown,Unknown,Appli Pro,Unknown,-181292.7841
Unknown,"41,09",Unknown,"41,09",Unknown,Unknown,Unknown,Appli Pro,Unknown,-185401.7841
Unknown,"18,99",Unknown,"18,99",Unknown,Unknown,Unknown,Appli Pro,Unknown,-187300.7841
Unknown,"150,00",Unknown,"150,00",Unknown,Unknown,Unknown,Appli Pro,Unknown,-202300.7841
Unknown,"20,00",Unknown,"20,00",Unknown,Unknown,Unknown,Appli Pro,Unknown,-204300.7841
Unknown,"159,95",Unknown,"159,95",Unknown,Unknown,Unknown,Appli Pro,Unknown,-220295.7841
Unknown,"205,33",Unknown,"205,33",Unknown,Unknown,Unknown,Appli Pro,Unknown,-240828.7841
Unknown,"120,00",Unknown,"120,00",Unknown,Unknown,Unknown,Appli Pro,Unknown,-252828.7841
Unknown,2,Unknown,2,Unknown,Unknown,Unknown,Appli Pro,Unknown,-252830.7841
Unknown,33,Unknown,33,Unknown,Unknown,Unknown,Appli Pro,Unknown,-252863.7841
Unknown,76 77,Unknown,76 77,Unknown,Unknown,Unknown,Appli Pro,Unknown,-260540.7841
Unknown,01,Unknown,01,Unknown,Unknown,Unknown,Appli Pro,Unknown,-260541.7841
Unknown,03,Unknown,03,Unknown,Unknown,Unknown,Appli Pro,Unknown,-260544.7841
Unknown,1,Unknown,1,Unknown,Unknown,Unknown,Appli Pro,Unknown,-260545.7841
Unknown,2,Unknown,2,Unknown,Unknown,Unknown,Appli Pro,Unknown,-260547.7841
Unknown,18,Unknown,18,Unknown,Unknown,Unknown,Appli Pro,Unknown,-260565.7841
Unknown,3,Unknown,3,Unknown,Unknown,Unknown,Appli Pro,Unknown,-260568.7841
Unknown,17,Unknown,17,Unknown,Unknown,Unknown,Appli Pro,Unknown,-260585.7841
Unknown,7,Unknown,7,Unknown,Unknown,Unknown,Appli Pro,Unknown,-260592.7841
Unknown,90,Unknown,90,Unknown,Unknown,Unknown,Appli Pro,Unknown,-260682.7841
Unknown,552 120 222,Unknown,552 120 222,Unknown,Unknown,Unknown,Appli Pro,Unknown,-552380904.7841
Unknown,"1 046 405 540,00",Unknown,"1 046 405 540,00",Unknown,Unknown,Unknown,Appli Pro,Unknown,-105192934904.7841
Unknown,29,Unknown,29,Unknown,Unknown,Unknown,Appli Pro,Unknown,-105192934933.7841
Unknown,1,Unknown,1,Unknown,Unknown,Unknown,Appli Pro,Unknown,-105192934934.7841
Unknown,001,Unknown,001,Unknown,Unknown,Unknown,Appli Pro,Unknown,-105192934935.7841
Unknown,002,Unknown,002,Unknown,Unknown,Unknown,Appli Pro,Unknown,-105192934937.7841
15/04/2019,4,Unknown,4,Unknown,Virement,Unknown,MR,BANQUE POSTALE Releve,-4.0
Unknown,15,Unknown,15,Unknown,Virement,Unknown,MR,MKT FR 25.03.19 CaRte,-19.0
Unknown,04,Unknown,04,Unknown,Virement,Unknown,MR,CARTE,-23.0
Unknown,11 034 07,Unknown,11 034 07,Unknown,Virement,Unknown,MR,RetRnit Dablabanquepostale,-1103430.0
Unknown,028,Unknown,028,Unknown,Virement,Unknown,MR,CartenumeRo,-1103458.0
Unknown,26,Unknown,26,Unknown,Virement,Unknown,MR,AchaT,-1103484.0
Unknown,03,Unknown,03,Unknown,Virement,Unknown,MR,Frere,-1103487.0
Unknown,25.03,Unknown,25.03,Unknown,Virement,Unknown,MR,ROUEN 26.03.19 CaRtenumeRo,-1103512.03
Unknown,19,Unknown,19,Unknown,Virement,Unknown,MR,AchaT,-1103531.03
Unknown,580 27,Unknown,580 27,Unknown,Virement,Unknown,MR,PALAI 26.03.19 CarienumeRo,-1161558.03
Unknown,03,Unknown,03,Unknown,Virement,Unknown,MR,ViREMENT,-1161561.03
Unknown,26,Unknown,26,Unknown,Virement,Unknown,MR,CARTE,-1161587.03
Unknown,03,Unknown,03,Unknown,Virement,Unknown,MR,ROUEN SI SEVERIROUEN,-1161590.03
Unknown,19,Unknown,19,Unknown,Virement,Unknown,MR,CARTE,-1161609.03
Unknown,27,Unknown,27,Unknown,Virement,Unknown,MR,RetRnit Dablabanquepostale,-1161636.03
Unknown,03,Unknown,03,Unknown,Virement,Unknown,MR,ACHAT,-1161639.03
Unknown,26,Unknown,26,Unknown,Virement,Unknown,MR,CARTE,-1161665.03
Unknown,03,Unknown,03,Unknown,Virement,Unknown,MR,BANQUE POSTALE,-1161668.03
Unknown,19,Unknown,19,Unknown,Virement,Unknown,MR,OMIO 27.03.19 EUR 18.50 CARIE NO,-1161687.03
Unknown,27,Unknown,27,Unknown,Virement,Unknown,MR,CB E LECLERC 28.03.19 EUR33.93,-1161714.03
Unknown,03,Unknown,03,Unknown,Virement,Unknown,MR,CaRtenuMERo,-1161717.03
Unknown,26.03,Unknown,26.03,Unknown,Virement,Unknown,MR,MKT FR,-1161743.06
Unknown,19,Unknown,19,Unknown,Virement,Unknown,MR,CB Sapn,-1161762.06
Unknown,580 27,Unknown,580 27,Unknown,Virement,Unknown,MR,VOIRE,-1219789.06
Unknown,03,Unknown,03,Unknown,Virement,Unknown,MR,VIREMENT DE SASU AB DRIVER,-1219792.06
Unknown,26.03,Unknown,26.03,Unknown,Virement,Unknown,MR,CARTE X1580,-1219818.09
Unknown,19,Unknown,19,Unknown,Virement,Unknown,MR,GeNNEVILUERS,-1219837.09
Unknown,580 27,Unknown,580 27,Unknown,Virement,Unknown,MR,CaRtenumERo,-1277864.09
Unknown,03,Unknown,03,Unknown,Virement,Unknown,MR,CARTE,-1277867.09
Unknown,26.03,Unknown,26.03,Unknown,Virement,Unknown,MR,Unknown,-1277893.12
Unknown,19,Unknown,19,Unknown,Virement,Unknown,MR,Unknown,-1277912.12
Unknown,580 27,Unknown,580 27,Unknown,Virement,Unknown,MR,Unknown,-1335939.12
Unknown,03,Unknown,03,Unknown,Virement,Unknown,MR,Unknown,-1335942.12
Unknown,26.03,Unknown,26.03,Unknown,Virement,Unknown,MR,Unknown,-1335968.15
Unknown,19,Unknown,19,Unknown,Virement,Unknown,MR,Unknown,-1335987.15
Unknown,580 27,Unknown,580 27,Unknown,Virement,Unknown,MR,Unknown,-1394014.15
Unknown,03,Unknown,03,Unknown,Virement,Unknown,MR,Unknown,-1394017.15
Unknown,26.03,Unknown,26.03,Unknown,Virement,Unknown,MR,Unknown,-1394043.1800000002
Unknown,19,Unknown,19,Unknown,Virement,Unknown,MR,Unknown,-1394062.1800000002
Unknown,580 28,Unknown,580 28,Unknown,Virement,Unknown,MR,Unknown,-1452090.1800000002
Unknown,03,Unknown,03,Unknown,Virement,Unknown,MR,Unknown,-1452093.1800000002
Unknown,28,Unknown,28,Unknown,Virement,Unknown,MR,Unknown,-1452121.1800000002
Unknown,03,Unknown,03,Unknown,Virement,Unknown,MR,Unknown,-1452124.1800000002
Unknown,27,Unknown,27,Unknown,Virement,Unknown,MR,Unknown,-1452151.1800000002
Unknown,03,Unknown,03,Unknown,Virement,Unknown,MR,Unknown,-1452154.1800000002
Unknown,19,Unknown,19,Unknown,Virement,Unknown,MR,Unknown,-1452173.1800000002
Unknown,28,Unknown,28,Unknown,Virement,Unknown,MR,Unknown,-1452201.1800000002
Unknown,03,Unknown,03,Unknown,Virement,Unknown,MR,Unknown,-1452204.1800000002
Unknown,27,Unknown,27,Unknown,Virement,Unknown,MR,Unknown,-1452231.1800000002
Unknown,03,Unknown,03,Unknown,Virement,Unknown,MR,Unknown,-1452234.1800000002
Unknown,19,Unknown,19,Unknown,Virement,Unknown,MR,Unknown,-1452253.1800000002
Unknown,28,Unknown,28,Unknown,Virement,Unknown,MR,Unknown,-1452281.1800000002
Unknown,03,Unknown,03,Unknown,Virement,Unknown,MR,Unknown,-1452284.1800000002
Unknown,27.03,Unknown,27.03,Unknown,Virement,Unknown,MR,Unknown,-1452311.2100000002
Unknown,19,Unknown,19,Unknown,Virement,Unknown,MR,Unknown,-1452330.2100000002
Unknown,580 28,Unknown,580 28,Unknown,Virement,Unknown,MR,Unknown,-1510358.2100000002
Unknown,03,Unknown,03,Unknown,Virement,Unknown,MR,Unknown,-1510361.2100000002
Unknown,27.03,Unknown,27.03,Unknown,Virement,Unknown,MR,Unknown,-1510388.2400000002
Unknown,19,Unknown,19,Unknown,Virement,Unknown,MR,Unknown,-1510407.2400000002
Unknown,580 28,Unknown,580 28,Unknown,Virement,Unknown,MR,Unknown,-1568435.2400000002
Unknown,03,Unknown,03,Unknown,Virement,Unknown,MR,Unknown,-1568438.2400000002
Unknown,27.03,Unknown,27.03,Unknown,Virement,Unknown,MR,Unknown,-1568465.2700000005
Unknown,19,Unknown,19,Unknown,Virement,Unknown,MR,Unknown,-1568484.2700000005
Unknown,580 28,Unknown,580 28,Unknown,Virement,Unknown,MR,Unknown,-1626512.2700000005
Unknown,03,Unknown,03,Unknown,Virement,Unknown,MR,Unknown,-1626515.2700000005
Unknown,26.03,Unknown,26.03,Unknown,Virement,Unknown,MR,Unknown,-1626541.3000000005
Unknown,19,Unknown,19,Unknown,Virement,Unknown,MR,Unknown,-1626560.3000000005
Unknown,19.50,Unknown,19.50,Unknown,Virement,Unknown,MR,Unknown,-1626579.8000000005
Unknown,580 29,Unknown,580 29,Unknown,Virement,Unknown,MR,Unknown,-1684608.8000000005
Unknown,03,Unknown,03,Unknown,Virement,Unknown,MR,Unknown,-1684611.8000000005
Unknown,28,Unknown,28,Unknown,Virement,Unknown,MR,Unknown,-1684639.8000000005
Unknown,03,Unknown,03,Unknown,Virement,Unknown,MR,Unknown,-1684642.8000000005
Unknown,19,Unknown,19,Unknown,Virement,Unknown,MR,Unknown,-1684661.8000000005
Unknown,29,Unknown,29,Unknown,Virement,Unknown,MR,Unknown,-1684690.8000000005
Unknown,03,Unknown,03,Unknown,Virement,Unknown,MR,Unknown,-1684693.8000000005
Unknown,29,Unknown,29,Unknown,Virement,Unknown,MR,Unknown,-1684722.8000000005
Unknown,03,Unknown,03,Unknown,Virement,Unknown,MR,Unknown,-1684725.8000000005
Unknown,19,Unknown,19,Unknown,Virement,Unknown,MR,Unknown,-1684744.8000000005
Unknown,29,Unknown,29,Unknown,Virement,Unknown,MR,Unknown,-1684773.8000000005
Unknown,03,Unknown,03,Unknown,Virement,Unknown,MR,Unknown,-1684776.8000000005
Unknown,27.03,Unknown,27.03,Unknown,Virement,Unknown,MR,Unknown,-1684803.8300000003
Unknown,19,Unknown,19,Unknown,Virement,Unknown,MR,Unknown,-1684822.8300000003
Unknown,18.50,Unknown,18.50,Unknown,Virement,Unknown,MR,Unknown,-1684841.3300000003
Unknown,580 29,Unknown,580 29,Unknown,Virement,Unknown,MR,Unknown,-1742870.3300000003
Unknown,03,Unknown,03,Unknown,Virement,Unknown,MR,Unknown,-1742873.3300000003
Unknown,28.03,Unknown,28.03,Unknown,Virement,Unknown,MR,Unknown,-1742901.3600000003
Unknown,19,Unknown,19,Unknown,Virement,Unknown,MR,Unknown,-1742920.3600000003
Unknown,93,Unknown,93,Unknown,Virement,Unknown,MR,Unknown,-1743013.3600000003
Unknown,580 29,Unknown,580 29,Unknown,Virement,Unknown,MR,Unknown,-1801042.3600000003
Unknown,03,Unknown,03,Unknown,Virement,Unknown,MR,Unknown,-1801045.3600000003
Unknown,28.03,Unknown,28.03,Unknown,Virement,Unknown,MR,Unknown,-1801073.3900000004
Unknown,19,Unknown,19,Unknown,Virement,Unknown,MR,Unknown,-1801092.3900000004
Unknown,580 01,Unknown,580 01,Unknown,Virement,Unknown,MR,Unknown,-1859093.3900000004
Unknown,04,Unknown,04,Unknown,Virement,Unknown,MR,Unknown,-1859097.3900000004
Unknown,29.03,Unknown,29.03,Unknown,Virement,Unknown,MR,Unknown,-1859126.4200000004
Unknown,19,Unknown,19,Unknown,Virement,Unknown,MR,Unknown,-1859145.4200000004
Unknown,580 01,Unknown,580 01,Unknown,Virement,Unknown,MR,Unknown,-1917146.4200000004
Unknown,04,Unknown,04,Unknown,Virement,Unknown,MR,Unknown,-1917150.4200000004
Unknown,31.03,Unknown,31.03,Unknown,Virement,Unknown,MR,Unknown,-1917181.4500000004
Unknown,19,Unknown,19,Unknown,Virement,Unknown,MR,Unknown,-1917200.4500000004
Unknown,580 02,Unknown,580 02,Unknown,Virement,Unknown,MR,Unknown,-1975202.4500000004
Unknown,04,Unknown,04,Unknown,Virement,Unknown,MR,Unknown,-1975206.4500000004
Unknown,31.03,Unknown,31.03,Unknown,Virement,Unknown,MR,Unknown,-1975237.4800000004
Unknown,19,Unknown,19,Unknown,Virement,Unknown,MR,Unknown,-1975256.4800000004
Unknown,580 02,Unknown,580 02,Unknown,Virement,Unknown,MR,Unknown,-2033258.4800000004
Unknown,04,Unknown,04,Unknown,Virement,Unknown,MR,Unknown,-2033262.4800000004
Unknown,03,Unknown,03,Unknown,Virement,Unknown,MR,Unknown,-2033265.4800000004
Unknown,04,Unknown,04,Unknown,Virement,Unknown,MR,Unknown,-2033269.4800000004
Unknown,03,Unknown,03,Unknown,Virement,Unknown,MR,Unknown,-2033272.4800000004
Unknown,04,Unknown,04,Unknown,Virement,Unknown,MR,Unknown,-2033276.4800000004
Unknown,02,Unknown,02,Unknown,Virement,Unknown,MR,Unknown,-2033278.4800000004
Unknown,04,Unknown,04,Unknown,Virement,Unknown,MR,Unknown,-2033282.4800000004
Unknown,19,Unknown,19,Unknown,Virement,Unknown,MR,Unknown,-2033301.4800000004
Unknown,03,Unknown,03,Unknown,Virement,Unknown,MR,Unknown,-2033304.4800000004
Unknown,04,Unknown,04,Unknown,Virement,Unknown,MR,Unknown,-2033308.4800000004
Unknown,02.04,Unknown,02.04,Unknown,Virement,Unknown,MR,Unknown,-2033310.5200000005
Unknown,19,Unknown,19,Unknown,Virement,Unknown,MR,Unknown,-2033329.5200000005
Unknown,580 03,Unknown,580 03,Unknown,Virement,Unknown,MR,Unknown,-2091332.5200000005
Unknown,04,Unknown,04,Unknown,Virement,Unknown,MR,Unknown,-2091336.5200000005
Unknown,02.04,Unknown,02.04,Unknown,Virement,Unknown,MR,Unknown,-2091338.5600000003
Unknown,19,Unknown,19,Unknown,Virement,Unknown,MR,Unknown,-2091357.5600000003
Unknown,580 04,Unknown,580 04,Unknown,Virement,Unknown,MR,Unknown,-2149361.5600000005
Unknown,04,Unknown,04,Unknown,Virement,Unknown,MR,Unknown,-2149365.5600000005
Unknown,02,Unknown,02,Unknown,Virement,Unknown,MR,Unknown,-2149367.5600000005
Unknown,04,Unknown,04,Unknown,Virement,Unknown,MR,Unknown,-2149371.5600000005
Unknown,19,Unknown,19,Unknown,Virement,Unknown,MR,Unknown,-2149390.5600000005
Unknown,0,Unknown,0,Unknown,Virement,Unknown,MR,Unknown,-2149390.5600000005
Unknown,"41,16",Unknown,"41,16",Unknown,Virement,Unknown,MR,Unknown,-2153506.5600000005
Unknown,"20,00",Unknown,"20,00",Unknown,Virement,Unknown,MR,Unknown,-2155506.5600000005
Unknown,"100,00",Unknown,"100,00",Unknown,Virement,Unknown,MR,Unknown,-2165506.5600000005
Unknown,"1,90",Unknown,"1,90",Unknown,Virement,Unknown,MR,Unknown,-2165696.5600000005
Unknown,"2,50",Unknown,"2,50",Unknown,Virement,Unknown,MR,Unknown,-2165946.5600000005
Unknown,"14,00",Unknown,"14,00",Unknown,Virement,Unknown,MR,Unknown,-2167346.5600000005
Unknown,"21,80",Unknown,"21,80",Unknown,Virement,Unknown,MR,Unknown,-2169526.5600000005
Unknown,"46,50",Unknown,"46,50",Unknown,Virement,Unknown,MR,Unknown,-2174176.5600000005
Unknown,"943,85",Unknown,"943,85",Unknown,Virement,Unknown,MR,Unknown,-2268561.5600000005
Unknown,"40,00",Unknown,"40,00",Unknown,Virement,Unknown,MR,Unknown,-2272561.5600000005
Unknown,"80,00",Unknown,"80,00",Unknown,Virement,Unknown,MR,Unknown,-2280561.5600000005
Unknown,"1,70",Unknown,"1,70",Unknown,Virement,Unknown,MR,Unknown,-2280731.5600000005
Unknown,"1,90",Unknown,"1,90",Unknown,Virement,Unknown,MR,Unknown,-2280921.5600000005
Unknown,"14,50",Unknown,"14,50",Unknown,Virement,Unknown,MR,Unknown,-2282371.5600000005
Unknown,"19,50",Unknown,"19,50",Unknown,Virement,Unknown,MR,Unknown,-2284321.5600000005
Unknown,"20,00",Unknown,"20,00",Unknown,Virement,Unknown,MR,Unknown,-2286321.5600000005
Unknown,"150,00",Unknown,"150,00",Unknown,Virement,Unknown,MR,Unknown,-2301321.5600000005
Unknown,"18,50",Unknown,"18,50",Unknown,Virement,Unknown,MR,Unknown,-2303171.5600000005
Unknown,"33,93",Unknown,"33,93",Unknown,Virement,Unknown,MR,Unknown,-2306564.5600000005
Unknown,"56,00",Unknown,"56,00",Unknown,Virement,Unknown,MR,Unknown,-2312164.5600000005
Unknown,"45,98",Unknown,"45,98",Unknown,Virement,Unknown,MR,Unknown,-2316762.5600000005
Unknown,"57,00",Unknown,"57,00",Unknown,Virement,Unknown,MR,Unknown,-2322462.5600000005
Unknown,"8,70",Unknown,"8,70",Unknown,Virement,Unknown,MR,Unknown,-2323332.5600000005
Unknown,"17,85",Unknown,"17,85",Unknown,Virement,Unknown,MR,Unknown,-2325117.5600000005
Unknown,"516,38",Unknown,"516,38",Unknown,Virement,Unknown,MR,Unknown,-2376755.5600000005
Unknown,"100,00",Unknown,"100,00",Unknown,Virement,Unknown,MR,Unknown,-2386755.5600000005
Unknown,"10,90",Unknown,"10,90",Unknown,Virement,Unknown,MR,Unknown,-2387845.5600000005
Unknown,"38,79",Unknown,"38,79",Unknown,Virement,Unknown,MR,Unknown,-2391724.5600000005
Unknown,"20,00",Unknown,"20,00",Unknown,Virement,Unknown,MR,Unknown,-2393724.5600000005
Unknown,3,Unknown,3,Unknown,Virement,Unknown,MR,Unknown,-2393727.5600000005
Unknown,4,Unknown,4,Unknown,Virement,Unknown,MR,Unknown,-2393731.5600000005
01/02/2022,97,Unknown,97,Unknown,Unknown,Unknown,Crédit,SOCIETE GENERALE RELEVÉ DE COMPTE,-97.0
28/02/2022,01,Unknown,01,Unknown,Unknown,Unknown,Crédit,O,-98.0
28/02/2022,02,Unknown,02,Unknown,Unknown,Unknown,Crédit,Page 2/2 Date Valeur,-100.0
28/02/2022,28,Unknown,28,Unknown,Unknown,Unknown,Crédit,CARTE,-128.0
28/02/2022,02,Unknown,02,Unknown,Unknown,Unknown,Crédit,TOTAUX DES MOUVEMENTS,-130.0
28/02/2022,2,Unknown,2,Unknown,Unknown,Unknown,Crédit,SOLDE AU,-132.0
01/09/2021,2,Unknown,2,Unknown,Unknown,Unknown,Crédit,Opération exonéree de commisslon,-134.0
Unknown,2,Unknown,2,Unknown,Unknown,Unknown,Crédit,Résolution,-136.0
Unknown,28,Unknown,28,Unknown,Unknown,Unknown,Crédit,PROGRAMME DE FIDÉLITÉ,-164.0
Unknown,02,Unknown,02,Unknown,Unknown,Unknown,Crédit,CB Visa Gold Business,-166.0
Unknown,28,Unknown,28,Unknown,Unknown,Unknown,Crédit,Jazz Pro,-194.0
Unknown,02,Unknown,02,Unknown,Unknown,Unknown,Crédit,CB Visa Gold Business,-196.0
Unknown,25,Unknown,25,Unknown,Unknown,Unknown,Crédit,Jazz Pro,-221.0
Unknown,02,Unknown,02,Unknown,Unknown,Unknown,Crédit,RCS,-223.0
Unknown,"18,00",Unknown,"18,00",Unknown,Unknown,Unknown,Crédit,Paris,-2023.0
Unknown,"2.136,97",Unknown,"2.136,97",Unknown,Unknown,Unknown,Crédit,Unknown,-2025.13697
Unknown,"10,28",Unknown,"10,28",Unknown,Unknown,Unknown,Crédit,Unknown,-3053.13697
Unknown,28,Unknown,28,Unknown,Unknown,Unknown,Crédit,Unknown,-3081.13697
Unknown,02,Unknown,02,Unknown,Unknown,Unknown,Crédit,Unknown,-3083.13697
Unknown,"4.657,41",Unknown,"4.657,41",Unknown,Unknown,Unknown,Crédit,Unknown,-3087.79438
Unknown,28,Unknown,28,Unknown,Unknown,Unknown,Crédit,Unknown,-3115.79438
Unknown,02,Unknown,02,Unknown,Unknown,Unknown,Crédit,Unknown,-3117.79438
Unknown,"2 710,55",Unknown,"2 710,55",Unknown,Unknown,Unknown,Crédit,Unknown,-274172.79438
Unknown,01,Unknown,01,Unknown,Unknown,Unknown,Crédit,Unknown,-274173.79438
Unknown,09,Unknown,09,Unknown,Unknown,Unknown,Crédit,Unknown,-274182.79438
Unknown,15 000,Unknown,15 000,Unknown,Unknown,Unknown,Crédit,Unknown,-289182.79438
Unknown,12,Unknown,12,Unknown,Unknown,Unknown,Crédit,Unknown,-289194.79438
Unknown,35,Unknown,35,Unknown,Unknown,Unknown,Crédit,Unknown,-289229.79438
Unknown,15 000,Unknown,15 000,Unknown,Unknown,Unknown,Crédit,Unknown,-304229.79438
Unknown,12,Unknown,12,Unknown,Unknown,Unknown,Crédit,Unknown,-304241.79438
Unknown,35,Unknown,35,Unknown,Unknown,Unknown,Crédit,Unknown,-304276.79438
Unknown,7 500,Unknown,7 500,Unknown,Unknown,Unknown,Crédit,Unknown,-311776.79438
Unknown,12,Unknown,12,Unknown,Unknown,Unknown,Crédit,Unknown,-311788.79438
Unknown,25,Unknown,25,Unknown,Unknown,Unknown,Crédit,Unknown,-311813.79438
Unknown,1 552 120 222,Unknown,1 552 120 222,Unknown,Unknown,Unknown,Crédit,Unknown,-1552432035.79438
Unknown,"1 046 405 540,00",Unknown,"1 046 405 540,00",Unknown,Unknown,Unknown,Crédit,Unknown,-106192986035.79436
Unknown,002,Unknown,002,Unknown,Unknown,Unknown,Crédit,Unknown,-106192986037.79436
Unknown,002,Unknown,002,Unknown,Unknown,Unknown,Crédit,Unknown,-106192986039.79436
01/01/2022,97,Unknown,97,Unknown,POS,Unknown,Appli Pro,SOCIETE GENERALE RELEVÉ DE COMPTE,-97.0
31/01/2022,01,Unknown,01,Unknown,POS,Unknown,Appli Pro,Page 1/2 VOS CONTACTS Votre Banque,-98.0
31/12/2021,01,Unknown,01,Unknown,POS,Unknown,Appli Pro,Distance,-99.0
05/01/2022,31,Unknown,31,Unknown,POS,Unknown,Appli Pro,internet,-130.0
05/01/2022,01,Unknown,01,Unknown,POS,Unknown,Appli Pro,professlonnels .socletegenerale,-131.0
06/01/2022,1,Unknown,1,Unknown,POS,Unknown,Appli Pro,"0,3o€/min prix",-132.0
05/01/2022,1,Unknown,1,Unknown,POS,Unknown,Appli Pro,STE GENEV,-133.0
10/01/2022,2,Unknown,2,Unknown,POS,Unknown,Appli Pro,STE GENEVIEVE DES BOIS,-135.0
10/01/2022,0,Unknown,0,Unknown,POS,Unknown,Appli Pro,dylan barbanchon@socgen com,-135.0
18/01/2022,01 60,Unknown,01 60,Unknown,POS,Unknown,Appli Pro,P5I RELEVÉ DES OPÉRATIONS Date Valeur,-295.0
17/01/2022,16 05,Unknown,16 05,Unknown,POS,Unknown,Appli Pro,CARTE X8155,-1900.0
18/01/2022,48,Unknown,48,Unknown,POS,Unknown,Appli Pro,SC-TAMIL NADU,-1948.0
17/01/2022,01 69,Unknown,01 69,Unknown,POS,Unknown,Appli Pro,QUIETIS PRO,-2117.0
31/01/2022,51 30,Unknown,51 30,Unknown,POS,Unknown,Appli Pro,NT,-7247.0
31/01/2022,83,Unknown,83,Unknown,POS,Unknown,Appli Pro,EUR,-7330.0
31/01/2022,75,Unknown,75,Unknown,POS,Unknown,Appli Pro,CARTE X8155 RETRAIT,-7405.0
31/01/2022,15,Unknown,15,Unknown,POS,Unknown,Appli Pro,BANQUE POSTALE,-7420.0
31/01/2022,01 60,Unknown,01 60,Unknown,POS,Unknown,Appli Pro,NT,-7580.0
01/03/2020,16 87,Unknown,16 87,Unknown,POS,Unknown,Appli Pro,EUR TVA,-9267.0
Unknown,75,Unknown,75,Unknown,POS,Unknown,Appli Pro,EUR,-9342.0
Unknown,31,Unknown,31,Unknown,POS,Unknown,Appli Pro,NT,-9373.0
Unknown,12,Unknown,12,Unknown,POS,Unknown,Appli Pro,EUR 31/01/2022 | 31/01/2022,-9385.0
Unknown,05,Unknown,05,Unknown,POS,Unknown,Appli Pro,RETRAIT,-9390.0
Unknown,01,Unknown,01,Unknown,POS,Unknown,Appli Pro,BANQUE POSTALE,-9391.0
Unknown,05,Unknown,05,Unknown,POS,Unknown,Appli Pro,TOTAUX DES MOUVEMENTS,-9396.0
Unknown,01,Unknown,01,Unknown,POS,Unknown,Appli Pro,SOLDE AU 31/01/2022,-9397.0
Unknown,04,Unknown,04,Unknown,POS,Unknown,Appli Pro,Opération,-9401.0
Unknown,01,Unknown,01,Unknown,POS,Unknown,Appli Pro,Résolution,-9402.0
Unknown,06,Unknown,06,Unknown,POS,Unknown,Appli Pro,Paris,-9408.0
Unknown,01,Unknown,01,Unknown,POS,Unknown,Appli Pro,clientele@socgen com 3 Le Mediateur,-9409.0
Unknown,05,Unknown,05,Unknown,POS,Unknown,Appli Pro,Charte de la Mediation,-9414.0
Unknown,01,Unknown,01,Unknown,POS,Unknown,Appli Pro,Le Méediateur,-9415.0
Unknown,25,Unknown,25,Unknown,POS,Unknown,Appli Pro,Valmy,-9440.0
Unknown,01,Unknown,01,Unknown,POS,Unknown,Appli Pro,Paris,-9441.0
Unknown,01,Unknown,01,Unknown,POS,Unknown,Appli Pro,Ir,-9442.0
Unknown,22,Unknown,22,Unknown,POS,Unknown,Appli Pro,Médiateur,-9464.0
Unknown,31,Unknown,31,Unknown,POS,Unknown,Appli Pro,Sociele Genéral,-9495.0
Unknown,12,Unknown,12,Unknown,POS,Unknown,Appli Pro,RCS Pais SA,-9507.0
Unknown,22,Unknown,22,Unknown,POS,Unknown,Appli Pro,Eur g8,-9529.0
Unknown,"46,50",Unknown,"46,50",Unknown,POS,Unknown,Appli Pro,Paris,-14179.0
Unknown,10,Unknown,10,Unknown,POS,Unknown,Appli Pro,Unknown,-14189.0
Unknown,01,Unknown,01,Unknown,POS,Unknown,Appli Pro,Unknown,-14190.0
Unknown,10,Unknown,10,Unknown,POS,Unknown,Appli Pro,Unknown,-14200.0
Unknown,01,Unknown,01,Unknown,POS,Unknown,Appli Pro,Unknown,-14201.0
Unknown,07,Unknown,07,Unknown,POS,Unknown,Appli Pro,Unknown,-14208.0
Unknown,01,Unknown,01,Unknown,POS,Unknown,Appli Pro,Unknown,-14209.0
Unknown,18,Unknown,18,Unknown,POS,Unknown,Appli Pro,Unknown,-14227.0
Unknown,01,Unknown,01,Unknown,POS,Unknown,Appli Pro,Unknown,-14228.0
Unknown,17,Unknown,17,Unknown,POS,Unknown,Appli Pro,Unknown,-14245.0
Unknown,01,Unknown,01,Unknown,POS,Unknown,Appli Pro,Unknown,-14246.0
Unknown,25,Unknown,25,Unknown,POS,Unknown,Appli Pro,Unknown,-14271.0
Unknown,"7,13",Unknown,"7,13",Unknown,POS,Unknown,Appli Pro,Unknown,-14984.0
Unknown,"2,62",Unknown,"2,62",Unknown,POS,Unknown,Appli Pro,Unknown,-15246.0
Unknown,"20,00",Unknown,"20,00",Unknown,POS,Unknown,Appli Pro,Unknown,-17246.0
Unknown,"0,53",Unknown,"0,53",Unknown,POS,Unknown,Appli Pro,Unknown,-17299.0
Unknown,18,Unknown,18,Unknown,POS,Unknown,Appli Pro,Unknown,-17317.0
Unknown,01,Unknown,01,Unknown,POS,Unknown,Appli Pro,Unknown,-17318.0
Unknown,17,Unknown,17,Unknown,POS,Unknown,Appli Pro,Unknown,-17335.0
Unknown,01,Unknown,01,Unknown,POS,Unknown,Appli Pro,Unknown,-17336.0
Unknown,"28,57",Unknown,"28,57",Unknown,POS,Unknown,Appli Pro,Unknown,-20193.0
Unknown,"10,43",Unknown,"10,43",Unknown,POS,Unknown,Appli Pro,Unknown,-21236.0
Unknown,"20,009",Unknown,"20,009",Unknown,POS,Unknown,Appli Pro,Unknown,-41245.0
Unknown,"2,09",Unknown,"2,09",Unknown,POS,Unknown,Appli Pro,Unknown,-41454.0
Unknown,31,Unknown,31,Unknown,POS,Unknown,Appli Pro,Unknown,-41485.0
Unknown,01,Unknown,01,Unknown,POS,Unknown,Appli Pro,Unknown,-41486.0
Unknown,31,Unknown,31,Unknown,POS,Unknown,Appli Pro,Unknown,-41517.0
Unknown,01,Unknown,01,Unknown,POS,Unknown,Appli Pro,Unknown,-41518.0
Unknown,29,Unknown,29,Unknown,POS,Unknown,Appli Pro,Unknown,-41547.0
Unknown,01,Unknown,01,Unknown,POS,Unknown,Appli Pro,Unknown,-41548.0
Unknown,31,Unknown,31,Unknown,POS,Unknown,Appli Pro,Unknown,-41579.0
Unknown,01,Unknown,01,Unknown,POS,Unknown,Appli Pro,Unknown,-41580.0
Unknown,31,Unknown,31,Unknown,POS,Unknown,Appli Pro,Unknown,-41611.0
Unknown,01,Unknown,01,Unknown,POS,Unknown,Appli Pro,Unknown,-41612.0
Unknown,29,Unknown,29,Unknown,POS,Unknown,Appli Pro,Unknown,-41641.0
Unknown,01,Unknown,01,Unknown,POS,Unknown,Appli Pro,Unknown,-41642.0
Unknown,"7.538,36",Unknown,"7.538,36",Unknown,POS,Unknown,Appli Pro,Unknown,-41649.53836
Unknown,"14,00",Unknown,"14,00",Unknown,POS,Unknown,Appli Pro,Unknown,-43049.53836
Unknown,"46,50",Unknown,"46,50",Unknown,POS,Unknown,Appli Pro,Unknown,-47699.53836
Unknown,"300,00",Unknown,"300,00",Unknown,POS,Unknown,Appli Pro,Unknown,-77699.53836
Unknown,"10,28",Unknown,"10,28",Unknown,POS,Unknown,Appli Pro,Unknown,-78727.53836
Unknown,"41,09",Unknown,"41,09",Unknown,POS,Unknown,Appli Pro,Unknown,-82836.53836
Unknown,"162,95",Unknown,"162,95",Unknown,POS,Unknown,Appli Pro,Unknown,-99131.53836
Unknown,"200,00",Unknown,"200,00",Unknown,POS,Unknown,Appli Pro,Unknown,-119131.53836
Unknown,"764,54",Unknown,"764,54",Unknown,POS,Unknown,Appli Pro,Unknown,-195585.53836
Unknown,"10,28",Unknown,"10,28",Unknown,POS,Unknown,Appli Pro,Unknown,-196613.53836
Unknown,31,Unknown,31,Unknown,POS,Unknown,Appli Pro,Unknown,-196644.53836
Unknown,01,Unknown,01,Unknown,POS,Unknown,Appli Pro,Unknown,-196645.53836
Unknown,"6.784,10",Unknown,"6.784,10",Unknown,POS,Unknown,Appli Pro,Unknown,-196652.32246
Unknown,33,Unknown,33,Unknown,POS,Unknown,Appli Pro,Unknown,-196685.32246
Unknown,76 77,Unknown,76 77,Unknown,POS,Unknown,Appli Pro,Unknown,-204362.32246
Unknown,01,Unknown,01,Unknown,POS,Unknown,Appli Pro,Unknown,-204363.32246
Unknown,03,Unknown,03,Unknown,POS,Unknown,Appli Pro,Unknown,-204366.32246
Unknown,2,Unknown,2,Unknown,POS,Unknown,Appli Pro,Unknown,-204368.32246
Unknown,18,Unknown,18,Unknown,POS,Unknown,Appli Pro,Unknown,-204386.32246
Unknown,3,Unknown,3,Unknown,POS,Unknown,Appli Pro,Unknown,-204389.32246
Unknown,17,Unknown,17,Unknown,POS,Unknown,Appli Pro,Unknown,-204406.32246
Unknown,7,Unknown,7,Unknown,POS,Unknown,Appli Pro,Unknown,-204413.32246
Unknown,90,Unknown,90,Unknown,POS,Unknown,Appli Pro,Unknown,-204503.32246
Unknown,552 120 222,Unknown,552 120 222,Unknown,POS,Unknown,Appli Pro,Unknown,-552324725.32246
Unknown,"066 714 367,50",Unknown,"066 714 367,50",Unknown,POS,Unknown,Appli Pro,Unknown,-7223761475.32246
Unknown,29,Unknown,29,Unknown,POS,Unknown,Appli Pro,Unknown,-7223761504.32246
Unknown,1,Unknown,1,Unknown,POS,Unknown,Appli Pro,Unknown,-7223761505.32246
Unknown,001,Unknown,001,Unknown,POS,Unknown,Appli Pro,Unknown,-7223761506.32246
Unknown,002,Unknown,002,Unknown,POS,Unknown,Appli Pro,Unknown,-7223761508.32246
01/05/2020,92,Unknown,92,Unknown,Unknown,Unknown,NAIS BEAUTE 15,SOCIETE GENERALE RELEVÉ DE COMPTE,-92.0
30/05/2020,01,Unknown,01,Unknown,Unknown,Unknown,NAIS BEAUTE 15,Page 1/4 VOS CONTACTS Votre Banque,-93.0
30/04/2020,05,Unknown,05,Unknown,Unknown,Unknown,NAIS BEAUTE 15,VILLENEUVE ST-GEORGES,-98.0
05/05/2020,30,Unknown,30,Unknown,Unknown,Unknown,NAIS BEAUTE 15,NE VAUT,-128.0
05/05/2020,05,Unknown,05,Unknown,Unknown,Unknown,NAIS BEAUTE 15,FACTURE P61,-133.0
15-03-2018,5,Unknown,5,Unknown,Unknown,Unknown,NAIS BEAUTE 15,opération SOLDE,-138.0
06/05/2020,1,Unknown,1,Unknown,Unknown,Unknown,NAIS BEAUTE 15,PRELEVEMENT EUROPEEN,-139.0
30/04/2020,4,Unknown,4,Unknown,Unknown,Unknown,NAIS BEAUTE 15,SOFTAVERA ID,-143.0
07/05/2020,0,Unknown,0,Unknown,Unknown,Unknown,NAIS BEAUTE 15,FR58ZZZ673989,-143.0
07/05/2020,15,Unknown,15,Unknown,Unknown,Unknown,NAIS BEAUTE 15,SDD,-158.0
07/05/2020,01 45,Unknown,01 45,Unknown,Unknown,Unknown,NAIS BEAUTE 15,FINT,-303.0
07/05/2020,10 10,Unknown,10 10,Unknown,Unknown,Unknown,NAIS BEAUTE 15,TAUX CONVENTIONNEL A,-1313.0
07/05/2020,10,Unknown,10,Unknown,Unknown,Unknown,NAIS BEAUTE 15,DATE DARRETE,-1323.0
07/05/2020,01 43,Unknown,01 43,Unknown,Unknown,Unknown,NAIS BEAUTE 15,CARTE,-1466.0
11/05/2020,89 87,Unknown,89 87,Unknown,Unknown,Unknown,NAIS BEAUTE 15,SG,-10453.0
11/05/2020,62,Unknown,62,Unknown,Unknown,Unknown,NAIS BEAUTE 15,LEBLANC MESNIL,-10515.0
12/05/2020,30,Unknown,30,Unknown,Unknown,Unknown,NAIS BEAUTE 15,CARTE XS999,-10545.0
12/05/2020,04,Unknown,04,Unknown,Unknown,Unknown,NAIS BEAUTE 15,SG,-10549.0
01/10/2015,05,Unknown,05,Unknown,Unknown,Unknown,NAIS BEAUTE 15,LE BLANC,-10554.0
Unknown,05,Unknown,05,Unknown,Unknown,Unknown,NAIS BEAUTE 15,MESNIL,-10559.0
Unknown,05,Unknown,05,Unknown,Unknown,Unknown,NAIS BEAUTE 15,PRELEVEMENT EUROPEEN 3618340896,-10564.0
Unknown,05,Unknown,05,Unknown,Unknown,Unknown,NAIS BEAUTE 15,Free Telecom ID,-10569.0
Unknown,15,Unknown,15,Unknown,Unknown,Unknown,NAIS BEAUTE 15,REF FHO 943138236,-10584.0
Unknown,03,Unknown,03,Unknown,Unknown,Unknown,NAIS BEAUTE 15,PRELEVEMENT,-10587.0
Unknown,06,Unknown,06,Unknown,Unknown,Unknown,NAIS BEAUTE 15,"Crédit 2,47",-10593.0
Unknown,05,Unknown,05,Unknown,Unknown,Unknown,NAIS BEAUTE 15,CT3883641801,-10598.0
Unknown,30,Unknown,30,Unknown,Unknown,Unknown,NAIS BEAUTE 15,"OOE COM 3,19E 322,81 suito",-10628.0
Unknown,04,Unknown,04,Unknown,Unknown,Unknown,NAIS BEAUTE 15,Insatisfaction Ou,-10632.0
Unknown,30,Unknown,30,Unknown,Unknown,Unknown,NAIS BEAUTE 15,YOUs pouvoz,-10662.0
Unknown,04,Unknown,04,Unknown,Unknown,Unknown,NAIS BEAUTE 15,Lagonce,-10666.0
Unknown,20,Unknown,20,Unknown,Unknown,Unknown,NAIS BEAUTE 15,Pans cedex 18 Tel 0142143169,-10686.0
Unknown,"2,21",Unknown,"2,21",Unknown,Unknown,Unknown,NAIS BEAUTE 15,Mediatour,-10907.0
Unknown,"0,26",Unknown,"0,26",Unknown,Unknown,Unknown,NAIS BEAUTE 15,Charte de la Mediation Societe Generale,-10933.0
Unknown,9,Unknown,9,Unknown,Unknown,Unknown,NAIS BEAUTE 15,Le Mediateur aupres de Societe Generale,-10942.0
Unknown,0,Unknown,0,Unknown,Unknown,Unknown,NAIS BEAUTE 15,Valmy 92987,-10942.0
Unknown,10,Unknown,10,Unknown,Unknown,Unknown,NAIS BEAUTE 15,Internet du Mediateur WW mediateur societegenerale,-10952.0
Unknown,0,Unknown,0,Unknown,Unknown,Unknown,NAIS BEAUTE 15,Mediateur,-10952.0
Unknown,07,Unknown,07,Unknown,Unknown,Unknown,NAIS BEAUTE 15,Sogete Geneale,-10959.0
Unknown,05,Unknown,05,Unknown,Unknown,Unknown,NAIS BEAUTE 15,Pans S ^gucaotaloe,-10964.0
Unknown,07,Unknown,07,Unknown,Unknown,Unknown,NAIS BEAUTE 15,S0e4 Scoe Soo,-10971.0
Unknown,05,Unknown,05,Unknown,Unknown,Unknown,NAIS BEAUTE 15,Unknown,-10976.0
Unknown,06,Unknown,06,Unknown,Unknown,Unknown,NAIS BEAUTE 15,Unknown,-10982.0
Unknown,05,Unknown,05,Unknown,Unknown,Unknown,NAIS BEAUTE 15,Unknown,-10987.0
Unknown,07,Unknown,07,Unknown,Unknown,Unknown,NAIS BEAUTE 15,Unknown,-10994.0
Unknown,05,Unknown,05,Unknown,Unknown,Unknown,NAIS BEAUTE 15,Unknown,-10999.0
Unknown,07,Unknown,07,Unknown,Unknown,Unknown,NAIS BEAUTE 15,Unknown,-11006.0
Unknown,05,Unknown,05,Unknown,Unknown,Unknown,NAIS BEAUTE 15,Unknown,-11011.0
Unknown,06,Unknown,06,Unknown,Unknown,Unknown,NAIS BEAUTE 15,Unknown,-11017.0
Unknown,05,Unknown,05,Unknown,Unknown,Unknown,NAIS BEAUTE 15,Unknown,-11022.0
Unknown,07,Unknown,07,Unknown,Unknown,Unknown,NAIS BEAUTE 15,Unknown,-11029.0
Unknown,05,Unknown,05,Unknown,Unknown,Unknown,NAIS BEAUTE 15,Unknown,-11034.0
Unknown,07,Unknown,07,Unknown,Unknown,Unknown,NAIS BEAUTE 15,Unknown,-11041.0
Unknown,05,Unknown,05,Unknown,Unknown,Unknown,NAIS BEAUTE 15,Unknown,-11046.0
Unknown,11,Unknown,11,Unknown,Unknown,Unknown,NAIS BEAUTE 15,Unknown,-11057.0
Unknown,05,Unknown,05,Unknown,Unknown,Unknown,NAIS BEAUTE 15,Unknown,-11062.0
Unknown,11,Unknown,11,Unknown,Unknown,Unknown,NAIS BEAUTE 15,Unknown,-11073.0
Unknown,05,Unknown,05,Unknown,Unknown,Unknown,NAIS BEAUTE 15,Unknown,-11078.0
Unknown,"436,52",Unknown,"436,52",Unknown,Unknown,Unknown,NAIS BEAUTE 15,Unknown,-54730.0
Unknown,"23,88",Unknown,"23,88",Unknown,Unknown,Unknown,NAIS BEAUTE 15,Unknown,-57118.0
Unknown,"2,47",Unknown,"2,47",Unknown,Unknown,Unknown,NAIS BEAUTE 15,Unknown,-57365.0
Unknown,"10,00",Unknown,"10,00",Unknown,Unknown,Unknown,NAIS BEAUTE 15,Unknown,-58365.0
Unknown,"50,00",Unknown,"50,00",Unknown,Unknown,Unknown,NAIS BEAUTE 15,Unknown,-63365.0
Unknown,"39,99",Unknown,"39,99",Unknown,Unknown,Unknown,NAIS BEAUTE 15,Unknown,-67364.0
Unknown,"138,00",Unknown,"138,00",Unknown,Unknown,Unknown,NAIS BEAUTE 15,Unknown,-81164.0
Unknown,12,Unknown,12,Unknown,Unknown,Unknown,NAIS BEAUTE 15,Unknown,-81176.0
Unknown,05,Unknown,05,Unknown,Unknown,Unknown,NAIS BEAUTE 15,Unknown,-81181.0
Unknown,12,Unknown,12,Unknown,Unknown,Unknown,NAIS BEAUTE 15,Unknown,-81193.0
Unknown,05,Unknown,05,Unknown,Unknown,Unknown,NAIS BEAUTE 15,Unknown,-81198.0
Unknown,12,Unknown,12,Unknown,Unknown,Unknown,NAIS BEAUTE 15,Unknown,-81210.0
Unknown,05,Unknown,05,Unknown,Unknown,Unknown,NAIS BEAUTE 15,Unknown,-81215.0
Unknown,326,Unknown,326,Unknown,Unknown,Unknown,NAIS BEAUTE 15,Unknown,-81541.0
Unknown,3,Unknown,3,Unknown,Unknown,Unknown,NAIS BEAUTE 15,Unknown,-81544.0
Unknown,"322,81",Unknown,"322,81",Unknown,Unknown,Unknown,NAIS BEAUTE 15,Unknown,-113825.0
Unknown,2,Unknown,2,Unknown,Unknown,Unknown,NAIS BEAUTE 15,Unknown,-113827.0
Unknown,33,Unknown,33,Unknown,Unknown,Unknown,NAIS BEAUTE 15,Unknown,-113860.0
Unknown,76 77,Unknown,76 77,Unknown,Unknown,Unknown,NAIS BEAUTE 15,Unknown,-121537.0
Unknown,01,Unknown,01,Unknown,Unknown,Unknown,NAIS BEAUTE 15,Unknown,-121538.0
Unknown,10,Unknown,10,Unknown,Unknown,Unknown,NAIS BEAUTE 15,Unknown,-121548.0
Unknown,18,Unknown,18,Unknown,Unknown,Unknown,NAIS BEAUTE 15,Unknown,-121566.0
Unknown,17,Unknown,17,Unknown,Unknown,Unknown,NAIS BEAUTE 15,Unknown,-121583.0
Unknown,90,Unknown,90,Unknown,Unknown,Unknown,NAIS BEAUTE 15,Unknown,-121673.0
Unknown,552 120 222,Unknown,552 120 222,Unknown,Unknown,Unknown,NAIS BEAUTE 15,Unknown,-552241895.0
Unknown,066,Unknown,066,Unknown,Unknown,Unknown,NAIS BEAUTE 15,Unknown,-552241961.0
Unknown,29,Unknown,29,Unknown,Unknown,Unknown,NAIS BEAUTE 15,Unknown,-552241990.0
Unknown,1,Unknown,1,Unknown,Unknown,Unknown,NAIS BEAUTE 15,Unknown,-552241991.0
30/11/2021,Unknown,10,Unknown,Unknown,Debit,Unknown,ReLEVE N' 10 AU 30/11/2021,BANQUE POPULAIRE #X BOURGOGNE,10.0
30/11/2021,Unknown,30,Unknown,Unknown,Debit,Unknown,ReLEVE N' 10 AU 30/11/2021,BiMATOO,40.0
01/11/2021,Unknown,11,Unknown,Unknown,Debit,Unknown,ReLEVE N' 10 AU 30/11/2021,PROMOGROS1021 VOTRE COMPTE,51.0
08/11/2021,Unknown,0,Unknown,Unknown,Debit,Unknown,ReLEVE N' 10 AU 30/11/2021,DaTE DETAIL DES VIREMENTS,51.0
08/11/2021,Unknown,11,Unknown,Unknown,Debit,Unknown,ReLEVE N' 10 AU 30/11/2021,PiCKUP,62.0
15/11/2021,Unknown,264 00,Unknown,Unknown,Debit,Unknown,ReLEVE N' 10 AU 30/11/2021,Activ Pickup Sept2o2,26462.0
18/11/2021,Unknown,10,Unknown,Unknown,Debit,Unknown,ReLEVE N' 10 AU 30/11/2021,Stichting Custooian Uber PaYMEnTS,26472.0
22/11/2021,Unknown,30,Unknown,Unknown,Debit,Unknown,ReLEVE N' 10 AU 30/11/2021,Poe,26502.0
29/11/2021,Unknown,11,Unknown,Unknown,Debit,Unknown,ReLEVE N' 10 AU 30/11/2021,Custodian Uber PaYmenTs LEBF93053E260238,26513.0
Unknown,Unknown,01,Unknown,Unknown,Debit,Unknown,ReLEVE N' 10 AU 30/11/2021,SvCS 006,26514.0
Unknown,Unknown,11,Unknown,Unknown,Debit,Unknown,ReLEVE N' 10 AU 30/11/2021,ASEDOOviRAZ8Q,26525.0
Unknown,Unknown,008,Unknown,Unknown,Debit,Unknown,ReLEVE N' 10 AU 30/11/2021,Zeolzetoibouosv,26533.0
Unknown,Unknown,08,Unknown,Unknown,Debit,Unknown,ReLEVE N' 10 AU 30/11/2021,Custodian Uber PaYMEnTS,26541.0
Unknown,Unknown,11,Unknown,Unknown,Debit,Unknown,ReLEVE N' 10 AU 30/11/2021,SVCS Do8,26552.0
Unknown,Unknown,523 70,Unknown,Unknown,Debit,Unknown,ReLEVE N' 10 AU 30/11/2021,StiChTING Custodian Uber PAYMENTS,78922.0
Unknown,Unknown,108 66,Unknown,Unknown,Debit,Unknown,ReLEVE N' 10 AU 30/11/2021,Poe,89788.0
Unknown,Unknown,08,Unknown,Unknown,Debit,Unknown,ReLEVE N' 10 AU 30/11/2021,Kukwov7svjgFPe,89796.0
Unknown,Unknown,11,Unknown,Unknown,Debit,Unknown,ReLEVE N' 10 AU 30/11/2021,Darls tertes enquou Rcgodezvous,89807.0
Unknown,Unknown,008,Unknown,Unknown,Debit,Unknown,ReLEVE N' 10 AU 30/11/2021,tormulare aintormaton communcue,89815.0
Unknown,Unknown,15,Unknown,Unknown,Debit,Unknown,ReLEVE N' 10 AU 30/11/2021,Oemande,89830.0
Unknown,Unknown,11,Unknown,Unknown,Debit,Unknown,ReLEVE N' 10 AU 30/11/2021,voverconseder Concemnant,89841.0
Unknown,Unknown,006,Unknown,Unknown,Debit,Unknown,ReLEVE N' 10 AU 30/11/2021,Asle Livrel de Developpement Durable,89847.0
Unknown,Unknown,594 16,Unknown,Unknown,Debit,Unknown,ReLEVE N' 10 AU 30/11/2021,Solidaire,149263.0
Unknown,Unknown,600 26,Unknown,Unknown,Debit,Unknown,ReLEVE N' 10 AU 30/11/2021,Qarantis partetl A,209289.0
Unknown,Unknown,2,Unknown,Unknown,Debit,Unknown,ReLEVE N' 10 AU 30/11/2021,Banquc,209291.0
Unknown,Unknown,18,Unknown,Unknown,Debit,Unknown,ReLEVE N' 10 AU 30/11/2021,Bourgogne,209309.0
Unknown,Unknown,11,Unknown,Unknown,Debit,Unknown,ReLEVE N' 10 AU 30/11/2021,Franche-Comte,209320.0
Unknown,Unknown,10,Unknown,Unknown,Debit,Unknown,ReLEVE N' 10 AU 30/11/2021,PagE,209330.0
Unknown,Unknown,84 22,Unknown,Unknown,Debit,Unknown,ReLEVE N' 10 AU 30/11/2021,DoUagoc,217752.0
Unknown,Unknown,11,Unknown,Unknown,Debit,Unknown,ReLEVE N' 10 AU 30/11/2021,Dion CoorVaeozVAi,217763.0
Unknown,Unknown,29,Unknown,Unknown,Debit,Unknown,ReLEVE N' 10 AU 30/11/2021,Sioe Soce Ba0,217792.0
Unknown,Unknown,11,Unknown,Unknown,Debit,Unknown,ReLEVE N' 10 AU 30/11/2021,CcP Dion,217803.0
Unknown,Unknown,008,Unknown,Unknown,Debit,Unknown,ReLEVE N' 10 AU 30/11/2021,Unknown,217811.0
Unknown,Unknown,84 00,Unknown,Unknown,Debit,Unknown,ReLEVE N' 10 AU 30/11/2021,Unknown,226211.0
Unknown,Unknown,356 41,Unknown,Unknown,Debit,Unknown,ReLEVE N' 10 AU 30/11/2021,Unknown,261852.0
Unknown,Unknown,"223,06",Unknown,Unknown,Debit,Unknown,ReLEVE N' 10 AU 30/11/2021,Unknown,284158.0
Unknown,Unknown,7,Unknown,Unknown,Debit,Unknown,ReLEVE N' 10 AU 30/11/2021,Unknown,284165.0
Unknown,Unknown,80,Unknown,Unknown,Debit,Unknown,ReLEVE N' 10 AU 30/11/2021,Unknown,284245.0
Unknown,Unknown,82 210,Unknown,Unknown,Debit,Unknown,ReLEVE N' 10 AU 30/11/2021,Unknown,366455.0
Unknown,Unknown,601,Unknown,Unknown,Debit,Unknown,ReLEVE N' 10 AU 30/11/2021,Unknown,367056.0
Unknown,Unknown,029 504,Unknown,Unknown,Debit,Unknown,ReLEVE N' 10 AU 30/11/2021,Unknown,396560.0
Unknown,Unknown,16,Unknown,Unknown,Debit,Unknown,ReLEVE N' 10 AU 30/11/2021,Unknown,396576.0
31/12/2021,Unknown,06,Unknown,Unknown,Debit,Unknown,Revise C8,VOTRE COMPTE COURANT N' 02421381795 Oaie CovpTA,6.0
Unknown,Unknown,12,Unknown,Unknown,Debit,Unknown,Revise C8,Remise C8,18.0
Unknown,Unknown,228,Unknown,Unknown,Debit,Unknown,Revise C8,BRUT 228,246.0
Unknown,Unknown,0,Unknown,Unknown,Debit,Unknown,Revise C8,Revise C8 5072120015,246.0
Unknown,Unknown,06,Unknown,Unknown,Debit,Unknown,Revise C8,Cou 0 Q6 N8000s,252.0
Unknown,Unknown,12,Unknown,Unknown,Debit,Unknown,Revise C8,BRUT 20,264.0
Unknown,Unknown,23,Unknown,Unknown,Debit,Unknown,Revise C8,Cou,287.0
Unknown,Unknown,0,Unknown,Unknown,Debit,Unknown,Revise C8,N80026 16337,287.0
Unknown,Unknown,06,Unknown,Unknown,Debit,Unknown,Revise C8,C8 5072121012,293.0
Unknown,Unknown,12,Unknown,Unknown,Debit,Unknown,Revise C8,Remise C8 5072120015,305.0
Unknown,Unknown,20 206,Unknown,Unknown,Debit,Unknown,Revise C8,Remise C8 5072121012,20511.0
Unknown,Unknown,06,Unknown,Unknown,Debit,Unknown,Revise C8,N80o33,20517.0
Unknown,Unknown,12,Unknown,Unknown,Debit,Unknown,Revise C8,Evi STICHTING CUSTODIAN,20529.0
Unknown,Unknown,200 026,Unknown,Unknown,Debit,Unknown,Revise C8,VetRo,220555.0
Unknown,Unknown,06,Unknown,Unknown,Debit,Unknown,Revise C8,PvSI,220561.0
Unknown,Unknown,12,Unknown,Unknown,Debit,Unknown,Revise C8,CoNSEIL Seavcedecenare,220573.0
Unknown,Unknown,0,Unknown,Unknown,Debit,Unknown,Revise C8,Revise C8 5072120015,220573.0
Unknown,Unknown,06,Unknown,Unknown,Debit,Unknown,Revise C8,C8 5072120015,220579.0
Unknown,Unknown,12,Unknown,Unknown,Debit,Unknown,Revise C8,C8 5072121012,220591.0
Unknown,Unknown,06,Unknown,Unknown,Debit,Unknown,Revise C8,Eurovirem SepA,220597.0
Unknown,Unknown,12,Unknown,Unknown,Debit,Unknown,Revise C8,C8 5072120015,220609.0
Unknown,Unknown,06,Unknown,Unknown,Debit,Unknown,Revise C8,Revise C8,220615.0
Unknown,Unknown,12,Unknown,Unknown,Debit,Unknown,Revise C8,Cov 0,220627.0
Unknown,Unknown,287,Unknown,Unknown,Debit,Unknown,Revise C8,Kannanaran,220914.0
Unknown,Unknown,06,Unknown,Unknown,Debit,Unknown,Revise C8,C8 5072121012,220920.0
Unknown,Unknown,12,Unknown,Unknown,Debit,Unknown,Revise C8,Revise C8 5072120015 BRUr,220932.0
Unknown,Unknown,205 06,Unknown,Unknown,Debit,Unknown,Revise C8,Cov 0 J96,241438.0
Unknown,Unknown,12,Unknown,Unknown,Debit,Unknown,Revise C8,N 11 AU 31/12/2021,241450.0
Unknown,Unknown,06,Unknown,Unknown,Debit,Unknown,Revise C8,CRedit,241456.0
Unknown,Unknown,12,Unknown,Unknown,Debit,Unknown,Revise C8,Daie Oaie,241468.0
Unknown,Unknown,07,Unknown,Unknown,Debit,Unknown,Revise C8,OAOOTWS,241475.0
Unknown,Unknown,12,Unknown,Unknown,Debit,Unknown,Revise C8,FMZ6CoF,241487.0
Unknown,Unknown,29,Unknown,Unknown,Debit,Unknown,Revise C8,FMYZ2i5,241516.0
Unknown,Unknown,0,Unknown,Unknown,Debit,Unknown,Revise C8,FoMPHUL,241516.0
Unknown,Unknown,07,Unknown,Unknown,Debit,Unknown,Revise C8,Franche-Comte,241523.0
Unknown,Unknown,12,Unknown,Unknown,Debit,Unknown,Revise C8,PAGE 2 Bout POPUARE BoUAGoCAE ach CovIE,241535.0
Unknown,Unknown,07,Unknown,Unknown,Debit,Unknown,Revise C8,Dion CoosW,241542.0
Unknown,Unknown,12,Unknown,Unknown,Debit,Unknown,Revise C8,Coa,241554.0
Unknown,Unknown,2 08,Unknown,Unknown,Debit,Unknown,Revise C8,Dio'0,241762.0
Unknown,Unknown,12,Unknown,Unknown,Debit,Unknown,Revise C8,Ccbofapoony,241774.0
Unknown,Unknown,08,Unknown,Unknown,Debit,Unknown,Revise C8,Covrng Acavence,241782.0
Unknown,Unknown,12,Unknown,Unknown,Debit,Unknown,Revise C8,Unknown,241794.0
Unknown,Unknown,06,Unknown,Unknown,Debit,Unknown,Revise C8,Unknown,241800.0
Unknown,Unknown,08,Unknown,Unknown,Debit,Unknown,Revise C8,Unknown,241808.0
Unknown,Unknown,12,Unknown,Unknown,Debit,Unknown,Revise C8,Unknown,241820.0
Unknown,Unknown,07,Unknown,Unknown,Debit,Unknown,Revise C8,Unknown,241827.0
Unknown,Unknown,08,Unknown,Unknown,Debit,Unknown,Revise C8,Unknown,241835.0
Unknown,Unknown,12,Unknown,Unknown,Debit,Unknown,Revise C8,Unknown,241847.0
Unknown,Unknown,6,Unknown,Unknown,Debit,Unknown,Revise C8,Unknown,241853.0
Unknown,Unknown,0 026,Unknown,Unknown,Debit,Unknown,Revise C8,Unknown,241879.0
Unknown,Unknown,08,Unknown,Unknown,Debit,Unknown,Revise C8,Unknown,241887.0
Unknown,Unknown,12,Unknown,Unknown,Debit,Unknown,Revise C8,Unknown,241899.0
Unknown,Unknown,106 706,Unknown,Unknown,Debit,Unknown,Revise C8,Unknown,348605.0
Unknown,Unknown,0,Unknown,Unknown,Debit,Unknown,Revise C8,Unknown,348605.0
Unknown,Unknown,08,Unknown,Unknown,Debit,Unknown,Revise C8,Unknown,348613.0
Unknown,Unknown,12,Unknown,Unknown,Debit,Unknown,Revise C8,Unknown,348625.0
Unknown,Unknown,09,Unknown,Unknown,Debit,Unknown,Revise C8,Unknown,348634.0
Unknown,Unknown,12,Unknown,Unknown,Debit,Unknown,Revise C8,Unknown,348646.0
Unknown,Unknown,0 166,Unknown,Unknown,Debit,Unknown,Revise C8,Unknown,348812.0
Unknown,Unknown,09,Unknown,Unknown,Debit,Unknown,Revise C8,Unknown,348821.0
Unknown,Unknown,12,Unknown,Unknown,Debit,Unknown,Revise C8,Unknown,348833.0
Unknown,Unknown,262 266,Unknown,Unknown,Debit,Unknown,Revise C8,Unknown,611099.0
Unknown,Unknown,10,Unknown,Unknown,Debit,Unknown,Revise C8,Unknown,611109.0
Unknown,Unknown,12,Unknown,Unknown,Debit,Unknown,Revise C8,Unknown,611121.0
Unknown,Unknown,121 376,Unknown,Unknown,Debit,Unknown,Revise C8,Unknown,732497.0
Unknown,Unknown,0,Unknown,Unknown,Debit,Unknown,Revise C8,Unknown,732497.0
Unknown,Unknown,11,Unknown,Unknown,Debit,Unknown,Revise C8,Unknown,732508.0
Unknown,Unknown,31,Unknown,Unknown,Debit,Unknown,Revise C8,Unknown,732539.0
Unknown,Unknown,12,Unknown,Unknown,Debit,Unknown,Revise C8,Unknown,732551.0
Unknown,Unknown,"228,67",Unknown,Unknown,Debit,Unknown,Revise C8,Unknown,755418.0
Unknown,Unknown,0,Unknown,Unknown,Debit,Unknown,Revise C8,Unknown,755418.0
Unknown,Unknown,06,Unknown,Unknown,Debit,Unknown,Revise C8,Unknown,755424.0
Unknown,Unknown,12 06,Unknown,Unknown,Debit,Unknown,Revise C8,Unknown,756630.0
Unknown,Unknown,12,Unknown,Unknown,Debit,Unknown,Revise C8,Unknown,756642.0
Unknown,Unknown,0,Unknown,Unknown,Debit,Unknown,Revise C8,Unknown,756642.0
Unknown,Unknown,06,Unknown,Unknown,Debit,Unknown,Revise C8,Unknown,756648.0
Unknown,Unknown,12 06,Unknown,Unknown,Debit,Unknown,Revise C8,Unknown,757854.0
Unknown,Unknown,12 23,Unknown,Unknown,Debit,Unknown,Revise C8,Unknown,759077.0
Unknown,Unknown,10,Unknown,Unknown,Debit,Unknown,Revise C8,Unknown,759087.0
Unknown,Unknown,06,Unknown,Unknown,Debit,Unknown,Revise C8,Unknown,759093.0
Unknown,Unknown,12 06,Unknown,Unknown,Debit,Unknown,Revise C8,Unknown,760299.0
Unknown,Unknown,12 20,Unknown,Unknown,Debit,Unknown,Revise C8,Unknown,761519.0
Unknown,Unknown,14,Unknown,Unknown,Debit,Unknown,Revise C8,Unknown,761533.0
Unknown,Unknown,06,Unknown,Unknown,Debit,Unknown,Revise C8,Unknown,761539.0
Unknown,Unknown,12 06,Unknown,Unknown,Debit,Unknown,Revise C8,Unknown,762745.0
Unknown,Unknown,12 206.92,Unknown,Unknown,Debit,Unknown,Revise C8,Unknown,774951.92
Unknown,Unknown,06,Unknown,Unknown,Debit,Unknown,Revise C8,Unknown,774957.92
Unknown,Unknown,12 06,Unknown,Unknown,Debit,Unknown,Revise C8,Unknown,776163.92
Unknown,Unknown,12,Unknown,Unknown,Debit,Unknown,Revise C8,Unknown,776175.92
Unknown,Unknown,5,Unknown,Unknown,Debit,Unknown,Revise C8,Unknown,776180.92
Unknown,Unknown,90,Unknown,Unknown,Debit,Unknown,Revise C8,Unknown,776270.92
Unknown,Unknown,06,Unknown,Unknown,Debit,Unknown,Revise C8,Unknown,776276.92
Unknown,Unknown,12 06,Unknown,Unknown,Debit,Unknown,Revise C8,Unknown,777482.92
Unknown,Unknown,"12 110,92",Unknown,Unknown,Debit,Unknown,Revise C8,Unknown,1988574.92
Unknown,Unknown,06,Unknown,Unknown,Debit,Unknown,Revise C8,Unknown,1988580.92
Unknown,Unknown,12 06,Unknown,Unknown,Debit,Unknown,Revise C8,Unknown,1989786.92
Unknown,Unknown,"12 883,62",Unknown,Unknown,Debit,Unknown,Revise C8,Unknown,3278148.92
Unknown,Unknown,06,Unknown,Unknown,Debit,Unknown,Revise C8,Unknown,3278154.92
Unknown,Unknown,12 06,Unknown,Unknown,Debit,Unknown,Revise C8,Unknown,3279360.92
Unknown,Unknown,12 287 11,Unknown,Unknown,Debit,Unknown,Revise C8,Unknown,4508071.92
Unknown,Unknown,06,Unknown,Unknown,Debit,Unknown,Revise C8,Unknown,4508077.92
Unknown,Unknown,12 06,Unknown,Unknown,Debit,Unknown,Revise C8,Unknown,4509283.92
Unknown,Unknown,"12 401,85",Unknown,Unknown,Debit,Unknown,Revise C8,Unknown,5749468.92
Unknown,Unknown,06,Unknown,Unknown,Debit,Unknown,Revise C8,Unknown,5749474.92
Unknown,Unknown,12,Unknown,Unknown,Debit,Unknown,Revise C8,Unknown,5749486.92
Unknown,Unknown,06,Unknown,Unknown,Debit,Unknown,Revise C8,Unknown,5749492.92
Unknown,Unknown,12 06,Unknown,Unknown,Debit,Unknown,Revise C8,Unknown,5750698.92
Unknown,Unknown,12 06,Unknown,Unknown,Debit,Unknown,Revise C8,Unknown,5751904.92
Unknown,Unknown,"12 840,15",Unknown,Unknown,Debit,Unknown,Revise C8,Unknown,7035919.92
Unknown,Unknown,264,Unknown,Unknown,Debit,Unknown,Revise C8,Unknown,7036183.92
Unknown,Unknown,06,Unknown,Unknown,Debit,Unknown,Revise C8,Unknown,7036189.92
Unknown,Unknown,12 06,Unknown,Unknown,Debit,Unknown,Revise C8,Unknown,7037395.92
Unknown,Unknown,12 39,Unknown,Unknown,Debit,Unknown,Revise C8,Unknown,7038634.92
Unknown,Unknown,23,Unknown,Unknown,Debit,Unknown,Revise C8,Unknown,7038657.92
Unknown,Unknown,07,Unknown,Unknown,Debit,Unknown,Revise C8,Unknown,7038664.92
Unknown,Unknown,12 07,Unknown,Unknown,Debit,Unknown,Revise C8,Unknown,7039871.92
Unknown,Unknown,12 14,Unknown,Unknown,Debit,Unknown,Revise C8,Unknown,7041085.92
Unknown,Unknown,75,Unknown,Unknown,Debit,Unknown,Revise C8,Unknown,7041160.92
Unknown,Unknown,07,Unknown,Unknown,Debit,Unknown,Revise C8,Unknown,7041167.92
Unknown,Unknown,12 07,Unknown,Unknown,Debit,Unknown,Revise C8,Unknown,7042374.92
Unknown,Unknown,12 134 34,Unknown,Unknown,Debit,Unknown,Revise C8,Unknown,8255808.92
Unknown,Unknown,08,Unknown,Unknown,Debit,Unknown,Revise C8,Unknown,8255816.92
Unknown,Unknown,12,Unknown,Unknown,Debit,Unknown,Revise C8,Unknown,8255828.92
Unknown,Unknown,07,Unknown,Unknown,Debit,Unknown,Revise C8,Unknown,8255835.92
Unknown,Unknown,12 08,Unknown,Unknown,Debit,Unknown,Revise C8,Unknown,8257043.92
Unknown,Unknown,"12 123,66",Unknown,Unknown,Debit,Unknown,Revise C8,Unknown,9469409.92
Unknown,Unknown,07,Unknown,Unknown,Debit,Unknown,Revise C8,Unknown,9469416.92
Unknown,Unknown,"12 114,67",Unknown,Unknown,Debit,Unknown,Revise C8,Unknown,10680883.92
Unknown,Unknown,07,Unknown,Unknown,Debit,Unknown,Revise C8,Unknown,10680890.92
Unknown,Unknown,12 07,Unknown,Unknown,Debit,Unknown,Revise C8,Unknown,10682097.92
Unknown,Unknown,12 21,Unknown,Unknown,Debit,Unknown,Revise C8,Unknown,10683318.92
Unknown,Unknown,54,Unknown,Unknown,Debit,Unknown,Revise C8,Unknown,10683372.92
Unknown,Unknown,08,Unknown,Unknown,Debit,Unknown,Revise C8,Unknown,10683380.92
Unknown,Unknown,12 08,Unknown,Unknown,Debit,Unknown,Revise C8,Unknown,10684588.92
Unknown,Unknown,12,Unknown,Unknown,Debit,Unknown,Revise C8,Unknown,10684600.92
Unknown,Unknown,"6,88",Unknown,Unknown,Debit,Unknown,Revise C8,Unknown,10685288.92
Unknown,Unknown,08,Unknown,Unknown,Debit,Unknown,Revise C8,Unknown,10685296.92
Unknown,Unknown,12 08,Unknown,Unknown,Debit,Unknown,Revise C8,Unknown,10686504.92
Unknown,Unknown,12 196.70,Unknown,Unknown,Debit,Unknown,Revise C8,Unknown,10698701.62
Unknown,Unknown,08,Unknown,Unknown,Debit,Unknown,Revise C8,Unknown,10698709.62
Unknown,Unknown,12 08,Unknown,Unknown,Debit,Unknown,Revise C8,Unknown,10699917.62
Unknown,Unknown,12,Unknown,Unknown,Debit,Unknown,Revise C8,Unknown,10699929.62
Unknown,Unknown,08,Unknown,Unknown,Debit,Unknown,Revise C8,Unknown,10699937.62
Unknown,Unknown,12 08,Unknown,Unknown,Debit,Unknown,Revise C8,Unknown,10701145.62
Unknown,Unknown,12 50,Unknown,Unknown,Debit,Unknown,Revise C8,Unknown,10702395.62
Unknown,Unknown,75,Unknown,Unknown,Debit,Unknown,Revise C8,Unknown,10702470.62
Unknown,Unknown,09,Unknown,Unknown,Debit,Unknown,Revise C8,Unknown,10702479.62
Unknown,Unknown,12 09,Unknown,Unknown,Debit,Unknown,Revise C8,Unknown,10703688.62
Unknown,Unknown,12 262 46,Unknown,Unknown,Debit,Unknown,Revise C8,Unknown,11929934.62
Unknown,Unknown,09,Unknown,Unknown,Debit,Unknown,Revise C8,Unknown,11929943.62
Unknown,Unknown,12 09,Unknown,Unknown,Debit,Unknown,Revise C8,Unknown,11931152.62
Unknown,Unknown,12 120,Unknown,Unknown,Debit,Unknown,Revise C8,Unknown,11943272.62
Unknown,Unknown,98,Unknown,Unknown,Debit,Unknown,Revise C8,Unknown,11943370.62
Unknown,Unknown,2,Unknown,Unknown,Debit,Unknown,Revise C8,Unknown,11943372.62
Unknown,Unknown,09 204,Unknown,Unknown,Debit,Unknown,Revise C8,Unknown,11952576.62
Unknown,Unknown,16 800,Unknown,Unknown,Debit,Unknown,Revise C8,Unknown,11969376.62
Unknown,Unknown,68 708,Unknown,Unknown,Debit,Unknown,Revise C8,Unknown,12038084.62
Unknown,Unknown,0,Unknown,Unknown,Debit,Unknown,Revise C8,Unknown,12038084.62
Unknown,Unknown,0 023,Unknown,Unknown,Debit,Unknown,Revise C8,Unknown,12038107.62
Unknown,Unknown,070 116,Unknown,Unknown,Debit,Unknown,Revise C8,Unknown,12108223.62
31/12/2021,Unknown,10,Unknown,Unknown,Debit,Unknown,VNAJ16303,BANQUE POPULAIRE BOURGOGNE FRANCHE,10.0
Unknown,Unknown,12,Unknown,Unknown,Debit,Unknown,VNAJ16303,Prlv SEPAAVIVA,22.0
Unknown,Unknown,10,Unknown,Unknown,Debit,Unknown,VNAJ16303,Remise,32.0
Unknown,Unknown,12,Unknown,Unknown,Debit,Unknown,VNAJ16303,C8 5072120015,44.0
Unknown,Unknown,11,Unknown,Unknown,Debit,Unknown,VNAJ16303,Cou 0,55.0
Unknown,Unknown,12,Unknown,Unknown,Debit,Unknown,VNAJ16303,Revise C8,67.0
Unknown,Unknown,17,Unknown,Unknown,Debit,Unknown,VNAJ16303,C8 5072120015,84.0
Unknown,Unknown,0,Unknown,Unknown,Debit,Unknown,VNAJ16303,Revise C8 5072121012 BRUr,84.0
Unknown,Unknown,11,Unknown,Unknown,Debit,Unknown,VNAJ16303,N800jo,95.0
Unknown,Unknown,12,Unknown,Unknown,Debit,Unknown,VNAJ16303,Remise C8 5072120015,107.0
Unknown,Unknown,13,Unknown,Unknown,Debit,Unknown,VNAJ16303,Boe Cou,120.0
Unknown,Unknown,12,Unknown,Unknown,Debit,Unknown,VNAJ16303,Revise C8,132.0
Unknown,Unknown,13,Unknown,Unknown,Debit,Unknown,VNAJ16303,N80oso,145.0
Unknown,Unknown,12,Unknown,Unknown,Debit,Unknown,VNAJ16303,Revise C8 5072120015 BRUr,157.0
Unknown,Unknown,315,Unknown,Unknown,Debit,Unknown,VNAJ16303,Cou 0 226 N8ooo2/197602,472.0
Unknown,Unknown,13,Unknown,Unknown,Debit,Unknown,VNAJ16303,Remise,485.0
Unknown,Unknown,12,Unknown,Unknown,Debit,Unknown,VNAJ16303,C8 5072120015,497.0
Unknown,Unknown,48,Unknown,Unknown,Debit,Unknown,VNAJ16303,N80oo,545.0
Unknown,Unknown,0 166,Unknown,Unknown,Debit,Unknown,VNAJ16303,Revise C8,711.0
Unknown,Unknown,13,Unknown,Unknown,Debit,Unknown,VNAJ16303,Revise C8 5072121012 BRUr,724.0
Unknown,Unknown,12,Unknown,Unknown,Debit,Unknown,VNAJ16303,Coy,736.0
Unknown,Unknown,338,Unknown,Unknown,Debit,Unknown,VNAJ16303,EviStiCHTING CUSTOOIAN,1074.0
Unknown,Unknown,13,Unknown,Unknown,Debit,Unknown,VNAJ16303,C8 270,1087.0
Unknown,Unknown,12,Unknown,Unknown,Debit,Unknown,VNAJ16303,Veiro OIVIRLAIO77,1099.0
Unknown,Unknown,68 506,Unknown,Unknown,Debit,Unknown,VNAJ16303,Cou 0,69605.0
Unknown,Unknown,0 226,Unknown,Unknown,Debit,Unknown,VNAJ16303,Depot AGEnCE,69831.0
Unknown,Unknown,13,Unknown,Unknown,Debit,Unknown,VNAJ16303,SouS Reservede Covpiage,69844.0
Unknown,Unknown,12,Unknown,Unknown,Debit,Unknown,VNAJ16303,Revise C8,69856.0
Unknown,Unknown,0 256,Unknown,Unknown,Debit,Unknown,VNAJ16303,BRUt,70112.0
Unknown,Unknown,13,Unknown,Unknown,Debit,Unknown,VNAJ16303,Cov 0oe,70125.0
Unknown,Unknown,12,Unknown,Unknown,Debit,Unknown,VNAJ16303,Mrne Qjnoisyle,70137.0
Unknown,Unknown,0 006,Unknown,Unknown,Debit,Unknown,VNAJ16303,RelVenoy,70143.0
Unknown,Unknown,13,Unknown,Unknown,Debit,Unknown,VNAJ16303,C8;4704,70156.0
Unknown,Unknown,12,Unknown,Unknown,Debit,Unknown,VNAJ16303,MARnE Qonoisyle,70168.0
Unknown,Unknown,102 456,Unknown,Unknown,Debit,Unknown,VNAJ16303,SARouxeluberomubervlliers,172624.0
Unknown,Unknown,006,Unknown,Unknown,Debit,Unknown,VNAJ16303,SARouxeL,172630.0
Unknown,Unknown,13,Unknown,Unknown,Debit,Unknown,VNAJ16303,"EvUnited PaRCEL ServiC U8956656020211101,2021-1130,112",172643.0
Unknown,Unknown,12,Unknown,Unknown,Debit,Unknown,VNAJ16303,C8 5072120015,172655.0
Unknown,Unknown,008,Unknown,Unknown,Debit,Unknown,VNAJ16303,COu,172663.0
Unknown,Unknown,212 13,Unknown,Unknown,Debit,Unknown,VNAJ16303,N8ooos171847,193876.0
Unknown,Unknown,12,Unknown,Unknown,Debit,Unknown,VNAJ16303,Valeur OAZZPSD,193888.0
Unknown,Unknown,270,Unknown,Unknown,Debit,Unknown,VNAJ16303,FYJOF?C,194158.0
Unknown,Unknown,13,Unknown,Unknown,Debit,Unknown,VNAJ16303,GO6YZCA,194171.0
Unknown,Unknown,12,Unknown,Unknown,Debit,Unknown,VNAJ16303,GO6YZCB,194183.0
Unknown,Unknown,14,Unknown,Unknown,Debit,Unknown,VNAJ16303,GO6YZCC,194197.0
Unknown,Unknown,12,Unknown,Unknown,Debit,Unknown,VNAJ16303,GO6YZCD,194209.0
Unknown,Unknown,0,Unknown,Unknown,Debit,Unknown,VNAJ16303,GO6YzCE,194209.0
Unknown,Unknown,14,Unknown,Unknown,Debit,Unknown,VNAJ16303,GO7GWYK,194223.0
Unknown,Unknown,12,Unknown,Unknown,Debit,Unknown,VNAJ16303,A,194235.0
Unknown,Unknown,14,Unknown,Unknown,Debit,Unknown,VNAJ16303,Banque Populaire,194249.0
Unknown,Unknown,12,Unknown,Unknown,Debit,Unknown,VNAJ16303,Franche-Comte,194261.0
Unknown,Unknown,14,Unknown,Unknown,Debit,Unknown,VNAJ16303,CoooNn Qiex IAnecor,194275.0
Unknown,Unknown,12,Unknown,Unknown,Debit,Unknown,VNAJ16303,Irenoli,194287.0
Unknown,Unknown,470,Unknown,Unknown,Debit,Unknown,VNAJ16303,Ccoal,194757.0
Unknown,Unknown,14,Unknown,Unknown,Debit,Unknown,VNAJ16303,Dpon,194771.0
Unknown,Unknown,12,Unknown,Unknown,Debit,Unknown,VNAJ16303,CCborRpcony,194783.0
Unknown,Unknown,14,Unknown,Unknown,Debit,Unknown,VNAJ16303,Unknown,194797.0
Unknown,Unknown,12,Unknown,Unknown,Debit,Unknown,VNAJ16303,Unknown,194809.0
Unknown,Unknown,14,Unknown,Unknown,Debit,Unknown,VNAJ16303,Unknown,194823.0
Unknown,Unknown,12,Unknown,Unknown,Debit,Unknown,VNAJ16303,Unknown,194835.0
Unknown,Unknown,14,Unknown,Unknown,Debit,Unknown,VNAJ16303,Unknown,194849.0
Unknown,Unknown,12,Unknown,Unknown,Debit,Unknown,VNAJ16303,Unknown,194861.0
Unknown,Unknown,470,Unknown,Unknown,Debit,Unknown,VNAJ16303,Unknown,195331.0
Unknown,Unknown,15,Unknown,Unknown,Debit,Unknown,VNAJ16303,Unknown,195346.0
Unknown,Unknown,12,Unknown,Unknown,Debit,Unknown,VNAJ16303,Unknown,195358.0
Unknown,Unknown,112,Unknown,Unknown,Debit,Unknown,VNAJ16303,Unknown,195470.0
Unknown,Unknown,15,Unknown,Unknown,Debit,Unknown,VNAJ16303,Unknown,195485.0
Unknown,Unknown,12,Unknown,Unknown,Debit,Unknown,VNAJ16303,Unknown,195497.0
Unknown,Unknown,20 866,Unknown,Unknown,Debit,Unknown,VNAJ16303,Unknown,216363.0
Unknown,Unknown,11,Unknown,Unknown,Debit,Unknown,VNAJ16303,Unknown,216374.0
Unknown,Unknown,31,Unknown,Unknown,Debit,Unknown,VNAJ16303,Unknown,216405.0
Unknown,Unknown,12,Unknown,Unknown,Debit,Unknown,VNAJ16303,Unknown,216417.0
Unknown,Unknown,67 09,Unknown,Unknown,Debit,Unknown,VNAJ16303,Unknown,223126.0
Unknown,Unknown,10,Unknown,Unknown,Debit,Unknown,VNAJ16303,Unknown,223136.0
Unknown,Unknown,12 10,Unknown,Unknown,Debit,Unknown,VNAJ16303,Unknown,224346.0
Unknown,Unknown,12,Unknown,Unknown,Debit,Unknown,VNAJ16303,Unknown,224358.0
Unknown,Unknown,10,Unknown,Unknown,Debit,Unknown,VNAJ16303,Unknown,224368.0
Unknown,Unknown,12 10,Unknown,Unknown,Debit,Unknown,VNAJ16303,Unknown,225578.0
Unknown,Unknown,"12 234,39",Unknown,Unknown,Debit,Unknown,VNAJ16303,Unknown,1449017.0
Unknown,Unknown,10,Unknown,Unknown,Debit,Unknown,VNAJ16303,Unknown,1449027.0
Unknown,Unknown,12 10,Unknown,Unknown,Debit,Unknown,VNAJ16303,Unknown,1450237.0
Unknown,Unknown,12 17,Unknown,Unknown,Debit,Unknown,VNAJ16303,Unknown,1451454.0
Unknown,Unknown,37,Unknown,Unknown,Debit,Unknown,VNAJ16303,Unknown,1451491.0
Unknown,Unknown,10,Unknown,Unknown,Debit,Unknown,VNAJ16303,Unknown,1451501.0
Unknown,Unknown,12 10,Unknown,Unknown,Debit,Unknown,VNAJ16303,Unknown,1452711.0
Unknown,Unknown,12 14,Unknown,Unknown,Debit,Unknown,VNAJ16303,Unknown,1453925.0
Unknown,Unknown,85,Unknown,Unknown,Debit,Unknown,VNAJ16303,Unknown,1454010.0
Unknown,Unknown,13,Unknown,Unknown,Debit,Unknown,VNAJ16303,Unknown,1454023.0
Unknown,Unknown,12 13,Unknown,Unknown,Debit,Unknown,VNAJ16303,Unknown,1455236.0
Unknown,Unknown,12 35,Unknown,Unknown,Debit,Unknown,VNAJ16303,Unknown,1456471.0
Unknown,Unknown,08,Unknown,Unknown,Debit,Unknown,VNAJ16303,Unknown,1456479.0
Unknown,Unknown,13,Unknown,Unknown,Debit,Unknown,VNAJ16303,Unknown,1456492.0
Unknown,Unknown,12 13,Unknown,Unknown,Debit,Unknown,VNAJ16303,Unknown,1457705.0
Unknown,Unknown,"12 315,19",Unknown,Unknown,Debit,Unknown,VNAJ16303,Unknown,2689224.0
Unknown,Unknown,13,Unknown,Unknown,Debit,Unknown,VNAJ16303,Unknown,2689237.0
Unknown,Unknown,12 13,Unknown,Unknown,Debit,Unknown,VNAJ16303,Unknown,2690450.0
Unknown,Unknown,12 48,Unknown,Unknown,Debit,Unknown,VNAJ16303,Unknown,2691698.0
Unknown,Unknown,64,Unknown,Unknown,Debit,Unknown,VNAJ16303,Unknown,2691762.0
Unknown,Unknown,0,Unknown,Unknown,Debit,Unknown,VNAJ16303,Unknown,2691762.0
Unknown,Unknown,13,Unknown,Unknown,Debit,Unknown,VNAJ16303,Unknown,2691775.0
Unknown,Unknown,12 13,Unknown,Unknown,Debit,Unknown,VNAJ16303,Unknown,2692988.0
Unknown,Unknown,"12 338,50",Unknown,Unknown,Debit,Unknown,VNAJ16303,Unknown,3926838.0
Unknown,Unknown,13,Unknown,Unknown,Debit,Unknown,VNAJ16303,Unknown,3926851.0
Unknown,Unknown,12 13,Unknown,Unknown,Debit,Unknown,VNAJ16303,Unknown,3928064.0
Unknown,Unknown,12 68,Unknown,Unknown,Debit,Unknown,VNAJ16303,Unknown,3929332.0
Unknown,Unknown,28,Unknown,Unknown,Debit,Unknown,VNAJ16303,Unknown,3929360.0
Unknown,Unknown,13,Unknown,Unknown,Debit,Unknown,VNAJ16303,Unknown,3929373.0
Unknown,Unknown,12 13,Unknown,Unknown,Debit,Unknown,VNAJ16303,Unknown,3930586.0
Unknown,Unknown,12 76,Unknown,Unknown,Debit,Unknown,VNAJ16303,Unknown,3931862.0
Unknown,Unknown,84,Unknown,Unknown,Debit,Unknown,VNAJ16303,Unknown,3931946.0
Unknown,Unknown,13,Unknown,Unknown,Debit,Unknown,VNAJ16303,Unknown,3931959.0
Unknown,Unknown,12 13,Unknown,Unknown,Debit,Unknown,VNAJ16303,Unknown,3933172.0
Unknown,Unknown,12,Unknown,Unknown,Debit,Unknown,VNAJ16303,Unknown,3933184.0
Unknown,Unknown,1 50,Unknown,Unknown,Debit,Unknown,VNAJ16303,Unknown,3933334.0
Unknown,Unknown,13,Unknown,Unknown,Debit,Unknown,VNAJ16303,Unknown,3933347.0
Unknown,Unknown,12 13,Unknown,Unknown,Debit,Unknown,VNAJ16303,Unknown,3934560.0
Unknown,Unknown,"12 192,45",Unknown,Unknown,Debit,Unknown,VNAJ16303,Unknown,5153805.0
Unknown,Unknown,13,Unknown,Unknown,Debit,Unknown,VNAJ16303,Unknown,5153818.0
Unknown,Unknown,12 13,Unknown,Unknown,Debit,Unknown,VNAJ16303,Unknown,5155031.0
Unknown,Unknown,"12 558,59",Unknown,Unknown,Debit,Unknown,VNAJ16303,Unknown,6410890.0
Unknown,Unknown,13,Unknown,Unknown,Debit,Unknown,VNAJ16303,Unknown,6410903.0
Unknown,Unknown,12,Unknown,Unknown,Debit,Unknown,VNAJ16303,Unknown,6410915.0
Unknown,Unknown,13,Unknown,Unknown,Debit,Unknown,VNAJ16303,Unknown,6410928.0
Unknown,Unknown,12,Unknown,Unknown,Debit,Unknown,VNAJ16303,Unknown,6410940.0
Unknown,Unknown,13,Unknown,Unknown,Debit,Unknown,VNAJ16303,Unknown,6410953.0
Unknown,Unknown,12 13,Unknown,Unknown,Debit,Unknown,VNAJ16303,Unknown,6412166.0
Unknown,Unknown,12 13,Unknown,Unknown,Debit,Unknown,VNAJ16303,Unknown,6413379.0
Unknown,Unknown,12 13,Unknown,Unknown,Debit,Unknown,VNAJ16303,Unknown,6414592.0
Unknown,Unknown,12 99,Unknown,Unknown,Debit,Unknown,VNAJ16303,Unknown,6415891.0
Unknown,Unknown,"66 204,43",Unknown,Unknown,Debit,Unknown,VNAJ16303,Unknown,13036334.0
Unknown,Unknown,24 27,Unknown,Unknown,Debit,Unknown,VNAJ16303,Unknown,13038761.0
Unknown,Unknown,14,Unknown,Unknown,Debit,Unknown,VNAJ16303,Unknown,13038775.0
Unknown,Unknown,12 14,Unknown,Unknown,Debit,Unknown,VNAJ16303,Unknown,13039989.0
Unknown,Unknown,12 600 00,Unknown,Unknown,Debit,Unknown,VNAJ16303,Unknown,14299989.0
Unknown,Unknown,14,Unknown,Unknown,Debit,Unknown,VNAJ16303,Unknown,14300003.0
Unknown,Unknown,12 14,Unknown,Unknown,Debit,Unknown,VNAJ16303,Unknown,14301217.0
Unknown,Unknown,"12 141,02",Unknown,Unknown,Debit,Unknown,VNAJ16303,Unknown,15515319.0
Unknown,Unknown,14,Unknown,Unknown,Debit,Unknown,VNAJ16303,Unknown,15515333.0
Unknown,Unknown,12,Unknown,Unknown,Debit,Unknown,VNAJ16303,Unknown,15515345.0
Unknown,Unknown,14,Unknown,Unknown,Debit,Unknown,VNAJ16303,Unknown,15515359.0
Unknown,Unknown,12,Unknown,Unknown,Debit,Unknown,VNAJ16303,Unknown,15515371.0
Unknown,Unknown,14,Unknown,Unknown,Debit,Unknown,VNAJ16303,Unknown,15515385.0
Unknown,Unknown,12,Unknown,Unknown,Debit,Unknown,VNAJ16303,Unknown,15515397.0
Unknown,Unknown,14,Unknown,Unknown,Debit,Unknown,VNAJ16303,Unknown,15515411.0
Unknown,Unknown,12,Unknown,Unknown,Debit,Unknown,VNAJ16303,Unknown,15515423.0
Unknown,Unknown,14,Unknown,Unknown,Debit,Unknown,VNAJ16303,Unknown,15515437.0
Unknown,Unknown,12,Unknown,Unknown,Debit,Unknown,VNAJ16303,Unknown,15515449.0
Unknown,Unknown,15,Unknown,Unknown,Debit,Unknown,VNAJ16303,Unknown,15515464.0
Unknown,Unknown,12 14,Unknown,Unknown,Debit,Unknown,VNAJ16303,Unknown,15516678.0
Unknown,Unknown,12 14,Unknown,Unknown,Debit,Unknown,VNAJ16303,Unknown,15517892.0
Unknown,Unknown,12 14,Unknown,Unknown,Debit,Unknown,VNAJ16303,Unknown,15519106.0
Unknown,Unknown,12 14,Unknown,Unknown,Debit,Unknown,VNAJ16303,Unknown,15520320.0
Unknown,Unknown,12 14,Unknown,Unknown,Debit,Unknown,VNAJ16303,Unknown,15521534.0
Unknown,Unknown,12 15,Unknown,Unknown,Debit,Unknown,VNAJ16303,Unknown,15522749.0
Unknown,Unknown,12 12,Unknown,Unknown,Debit,Unknown,VNAJ16303,Unknown,15523961.0
Unknown,Unknown,29 15,Unknown,Unknown,Debit,Unknown,VNAJ16303,Unknown,15526876.0
Unknown,Unknown,02 22,Unknown,Unknown,Debit,Unknown,VNAJ16303,Unknown,15527098.0
Unknown,Unknown,"00 167,70",Unknown,Unknown,Debit,Unknown,VNAJ16303,Unknown,15543868.0
Unknown,Unknown,"763,86",Unknown,Unknown,Debit,Unknown,VNAJ16303,Unknown,15620254.0
Unknown,Unknown,"112,80",Unknown,Unknown,Debit,Unknown,VNAJ16303,Unknown,15631534.0
Unknown,Unknown,14,Unknown,Unknown,Debit,Unknown,VNAJ16303,Unknown,15631548.0
Unknown,Unknown,12 14,Unknown,Unknown,Debit,Unknown,VNAJ16303,Unknown,15632762.0
Unknown,Unknown,12 28,Unknown,Unknown,Debit,Unknown,VNAJ16303,Unknown,15633990.0
Unknown,Unknown,79,Unknown,Unknown,Debit,Unknown,VNAJ16303,Unknown,15634069.0
Unknown,Unknown,3,Unknown,Unknown,Debit,Unknown,VNAJ16303,Unknown,15634072.0
Unknown,Unknown,0,Unknown,Unknown,Debit,Unknown,VNAJ16303,Unknown,15634072.0
Unknown,Unknown,80,Unknown,Unknown,Debit,Unknown,VNAJ16303,Unknown,15634152.0
Unknown,Unknown,0 023,Unknown,Unknown,Debit,Unknown,VNAJ16303,Unknown,15634175.0
Unknown,Unknown,816,Unknown,Unknown,Debit,Unknown,VNAJ16303,Unknown,15634991.0
03/01/2021,Unknown,40,Unknown,Unknown,Debit,Unknown,EPI SERVICE PRIMEUR,Titulaire(s,40.0
03/01/2021,Unknown,1,Unknown,Unknown,Debit,Unknown,EPI SERVICE PRIMEUR,Page 516 Crédit Mutuel,41.0
03/01/2021,Unknown,516,Unknown,Unknown,Debit,Unknown,EPI SERVICE PRIMEUR,Date Date de,557.0
04/01/2021,Unknown,04,Unknown,Unknown,Debit,Unknown,EPI SERVICE PRIMEUR,COMCARTES,561.0
04/01/2021,Unknown,01 04,Unknown,Unknown,Debit,Unknown,EPI SERVICE PRIMEUR,COMCARTES,665.0
04/01/2021,Unknown,01 04,Unknown,Unknown,Debit,Unknown,EPI SERVICE PRIMEUR,COM,769.0
05/01/2021,Unknown,01 04,Unknown,Unknown,Debit,Unknown,EPI SERVICE PRIMEUR,REMISE,873.0
04/01/2021,Unknown,01 04,Unknown,Unknown,Debit,Unknown,EPI SERVICE PRIMEUR,TPV N 0386405,977.0
04/01/2021,Unknown,01 03,Unknown,Unknown,Debit,Unknown,EPI SERVICE PRIMEUR,COMCARTES,1080.0
05/12/2020,Unknown,01,Unknown,Unknown,Debit,Unknown,EPI SERVICE PRIMEUR,COMCARTES,1081.0
05/01/2021,Unknown,64,Unknown,Unknown,Debit,Unknown,EPI SERVICE PRIMEUR,TPV N 0386405,1145.0
05/01/2021,Unknown,03,Unknown,Unknown,Debit,Unknown,EPI SERVICE PRIMEUR,TPV N,1148.0
05/01/2021,Unknown,01,Unknown,Unknown,Debit,Unknown,EPI SERVICE PRIMEUR,CARTE,1149.0
05/01/2021,Unknown,64,Unknown,Unknown,Debit,Unknown,EPI SERVICE PRIMEUR,SUPER U 35 RENNES,1213.0
05/01/2021,Unknown,03,Unknown,Unknown,Debit,Unknown,EPI SERVICE PRIMEUR,COMCARTES,1216.0
06/01/2021,Unknown,01,Unknown,Unknown,Debit,Unknown,EPI SERVICE PRIMEUR,COM,1217.0
06/01/2021,Unknown,01,Unknown,Unknown,Debit,Unknown,EPI SERVICE PRIMEUR,COM,1218.0
06/01/2021,Unknown,04,Unknown,Unknown,Debit,Unknown,EPI SERVICE PRIMEUR,COM,1222.0
06/01/2021,Unknown,01,Unknown,Unknown,Debit,Unknown,EPI SERVICE PRIMEUR,AUTOROUTES DU SUD DE LA FRANCE GLACP246730044741270,1223.0
06/01/2021,Unknown,04,Unknown,Unknown,Debit,Unknown,EPI SERVICE PRIMEUR,FR94ZZZOO7048,1227.0
06/01/2021,Unknown,01,Unknown,Unknown,Debit,Unknown,EPI SERVICE PRIMEUR,TPV N 0386405,1228.0
06/01/2021,Unknown,04,Unknown,Unknown,Debit,Unknown,EPI SERVICE PRIMEUR,TPV N 0386405,1232.0
06/01/2021,Unknown,01,Unknown,Unknown,Debit,Unknown,EPI SERVICE PRIMEUR,TPV N 0386405,1233.0
06/01/2021,Unknown,05,Unknown,Unknown,Debit,Unknown,EPI SERVICE PRIMEUR,TPV N,1238.0
06/01/2021,Unknown,01,Unknown,Unknown,Debit,Unknown,EPI SERVICE PRIMEUR,CARTE,1239.0
06/01/2021,Unknown,04,Unknown,Unknown,Debit,Unknown,EPI SERVICE PRIMEUR,CARTE,1243.0
07/01/2021,Unknown,01,Unknown,Unknown,Debit,Unknown,EPI SERVICE PRIMEUR,COMCARTES,1244.0
06/01/2021,Unknown,04,Unknown,Unknown,Debit,Unknown,EPI SERVICE PRIMEUR,COM,1248.0
06/01/2021,Unknown,01,Unknown,Unknown,Debit,Unknown,EPI SERVICE PRIMEUR,COM,1249.0
07/01/2021,Unknown,05,Unknown,Unknown,Debit,Unknown,EPI SERVICE PRIMEUR,COM,1254.0
07/01/2021,Unknown,12,Unknown,Unknown,Debit,Unknown,EPI SERVICE PRIMEUR,Suite AU VeRso,1266.0
07/01/2021,Unknown,05,Unknown,Unknown,Debit,Unknown,EPI SERVICE PRIMEUR,Unknown,1271.0
07/01/2021,Unknown,01,Unknown,Unknown,Debit,Unknown,EPI SERVICE PRIMEUR,Unknown,1272.0
07/01/2021,Unknown,01,Unknown,Unknown,Debit,Unknown,EPI SERVICE PRIMEUR,Unknown,1273.0
07/01/2021,Unknown,01,Unknown,Unknown,Debit,Unknown,EPI SERVICE PRIMEUR,Unknown,1274.0
Unknown,Unknown,05,Unknown,Unknown,Debit,Unknown,EPI SERVICE PRIMEUR,Unknown,1279.0
Unknown,Unknown,01,Unknown,Unknown,Debit,Unknown,EPI SERVICE PRIMEUR,Unknown,1280.0
Unknown,Unknown,64,Unknown,Unknown,Debit,Unknown,EPI SERVICE PRIMEUR,Unknown,1344.0
Unknown,Unknown,05,Unknown,Unknown,Debit,Unknown,EPI SERVICE PRIMEUR,Unknown,1349.0
Unknown,Unknown,01,Unknown,Unknown,Debit,Unknown,EPI SERVICE PRIMEUR,Unknown,1350.0
Unknown,Unknown,64,Unknown,Unknown,Debit,Unknown,EPI SERVICE PRIMEUR,Unknown,1414.0
Unknown,Unknown,05,Unknown,Unknown,Debit,Unknown,EPI SERVICE PRIMEUR,Unknown,1419.0
Unknown,Unknown,01,Unknown,Unknown,Debit,Unknown,EPI SERVICE PRIMEUR,Unknown,1420.0
Unknown,Unknown,05,Unknown,Unknown,Debit,Unknown,EPI SERVICE PRIMEUR,Unknown,1425.0
Unknown,Unknown,01,Unknown,Unknown,Debit,Unknown,EPI SERVICE PRIMEUR,Unknown,1426.0
Unknown,Unknown,06,Unknown,Unknown,Debit,Unknown,EPI SERVICE PRIMEUR,Unknown,1432.0
Unknown,Unknown,01,Unknown,Unknown,Debit,Unknown,EPI SERVICE PRIMEUR,Unknown,1433.0
Unknown,Unknown,06,Unknown,Unknown,Debit,Unknown,EPI SERVICE PRIMEUR,Unknown,1439.0
Unknown,Unknown,01,Unknown,Unknown,Debit,Unknown,EPI SERVICE PRIMEUR,Unknown,1440.0
Unknown,Unknown,06,Unknown,Unknown,Debit,Unknown,EPI SERVICE PRIMEUR,Unknown,1446.0
Unknown,Unknown,01,Unknown,Unknown,Debit,Unknown,EPI SERVICE PRIMEUR,Unknown,1447.0
Unknown,Unknown,05,Unknown,Unknown,Debit,Unknown,EPI SERVICE PRIMEUR,Unknown,1452.0
Unknown,Unknown,01,Unknown,Unknown,Debit,Unknown,EPI SERVICE PRIMEUR,Unknown,1453.0
Unknown,Unknown,35,Unknown,Unknown,Debit,Unknown,EPI SERVICE PRIMEUR,Unknown,1488.0
Unknown,Unknown,06,Unknown,Unknown,Debit,Unknown,EPI SERVICE PRIMEUR,Unknown,1494.0
Unknown,Unknown,01,Unknown,Unknown,Debit,Unknown,EPI SERVICE PRIMEUR,Unknown,1495.0
Unknown,Unknown,06,Unknown,Unknown,Debit,Unknown,EPI SERVICE PRIMEUR,Unknown,1501.0
Unknown,Unknown,01,Unknown,Unknown,Debit,Unknown,EPI SERVICE PRIMEUR,Unknown,1502.0
Unknown,Unknown,64,Unknown,Unknown,Debit,Unknown,EPI SERVICE PRIMEUR,Unknown,1566.0
Unknown,Unknown,06,Unknown,Unknown,Debit,Unknown,EPI SERVICE PRIMEUR,Unknown,1572.0
Unknown,Unknown,01,Unknown,Unknown,Debit,Unknown,EPI SERVICE PRIMEUR,Unknown,1573.0
Unknown,Unknown,01,Unknown,Unknown,Debit,Unknown,EPI SERVICE PRIMEUR,Unknown,1574.0
Unknown,Unknown,06,Unknown,Unknown,Debit,Unknown,EPI SERVICE PRIMEUR,Unknown,1580.0
Unknown,Unknown,01,Unknown,Unknown,Debit,Unknown,EPI SERVICE PRIMEUR,Unknown,1581.0
Unknown,Unknown,64,Unknown,Unknown,Debit,Unknown,EPI SERVICE PRIMEUR,Unknown,1645.0
Unknown,Unknown,06,Unknown,Unknown,Debit,Unknown,EPI SERVICE PRIMEUR,Unknown,1651.0
Unknown,Unknown,01,Unknown,Unknown,Debit,Unknown,EPI SERVICE PRIMEUR,Unknown,1652.0
Unknown,Unknown,01,Unknown,Unknown,Debit,Unknown,EPI SERVICE PRIMEUR,Unknown,1653.0
Unknown,Unknown,06,Unknown,Unknown,Debit,Unknown,EPI SERVICE PRIMEUR,Unknown,1659.0
Unknown,Unknown,01,Unknown,Unknown,Debit,Unknown,EPI SERVICE PRIMEUR,Unknown,1660.0
Unknown,Unknown,06,Unknown,Unknown,Debit,Unknown,EPI SERVICE PRIMEUR,Unknown,1666.0
Unknown,Unknown,01,Unknown,Unknown,Debit,Unknown,EPI SERVICE PRIMEUR,Unknown,1667.0
Unknown,Unknown,06,Unknown,Unknown,Debit,Unknown,EPI SERVICE PRIMEUR,Unknown,1673.0
Unknown,Unknown,01,Unknown,Unknown,Debit,Unknown,EPI SERVICE PRIMEUR,Unknown,1674.0
Unknown,Unknown,07,Unknown,Unknown,Debit,Unknown,EPI SERVICE PRIMEUR,Unknown,1681.0
Unknown,Unknown,01,Unknown,Unknown,Debit,Unknown,EPI SERVICE PRIMEUR,Unknown,1682.0
Unknown,Unknown,06,Unknown,Unknown,Debit,Unknown,EPI SERVICE PRIMEUR,Unknown,1688.0
Unknown,Unknown,01,Unknown,Unknown,Debit,Unknown,EPI SERVICE PRIMEUR,Unknown,1689.0
Unknown,Unknown,06,Unknown,Unknown,Debit,Unknown,EPI SERVICE PRIMEUR,Unknown,1695.0
Unknown,Unknown,01,Unknown,Unknown,Debit,Unknown,EPI SERVICE PRIMEUR,Unknown,1696.0
Unknown,Unknown,07,Unknown,Unknown,Debit,Unknown,EPI SERVICE PRIMEUR,Unknown,1703.0
Unknown,Unknown,01,Unknown,Unknown,Debit,Unknown,EPI SERVICE PRIMEUR,Unknown,1704.0
Unknown,Unknown,06,Unknown,Unknown,Debit,Unknown,EPI SERVICE PRIMEUR,Unknown,1710.0
Unknown,Unknown,01,Unknown,Unknown,Debit,Unknown,EPI SERVICE PRIMEUR,Unknown,1711.0
Unknown,Unknown,35,Unknown,Unknown,Debit,Unknown,EPI SERVICE PRIMEUR,Unknown,1746.0
Unknown,Unknown,07,Unknown,Unknown,Debit,Unknown,EPI SERVICE PRIMEUR,Unknown,1753.0
Unknown,Unknown,01,Unknown,Unknown,Debit,Unknown,EPI SERVICE PRIMEUR,Unknown,1754.0
Unknown,Unknown,06,Unknown,Unknown,Debit,Unknown,EPI SERVICE PRIMEUR,Unknown,1760.0
Unknown,Unknown,01,Unknown,Unknown,Debit,Unknown,EPI SERVICE PRIMEUR,Unknown,1761.0
Unknown,Unknown,75,Unknown,Unknown,Debit,Unknown,EPI SERVICE PRIMEUR,Unknown,1836.0
Unknown,Unknown,07,Unknown,Unknown,Debit,Unknown,EPI SERVICE PRIMEUR,Unknown,1843.0
Unknown,Unknown,01,Unknown,Unknown,Debit,Unknown,EPI SERVICE PRIMEUR,Unknown,1844.0
Unknown,Unknown,01,Unknown,Unknown,Debit,Unknown,EPI SERVICE PRIMEUR,Unknown,1845.0
Unknown,Unknown,07,Unknown,Unknown,Debit,Unknown,EPI SERVICE PRIMEUR,Unknown,1852.0
Unknown,Unknown,01,Unknown,Unknown,Debit,Unknown,EPI SERVICE PRIMEUR,Unknown,1853.0
Unknown,Unknown,64,Unknown,Unknown,Debit,Unknown,EPI SERVICE PRIMEUR,Unknown,1917.0
Unknown,Unknown,07,Unknown,Unknown,Debit,Unknown,EPI SERVICE PRIMEUR,Unknown,1924.0
Unknown,Unknown,01,Unknown,Unknown,Debit,Unknown,EPI SERVICE PRIMEUR,Unknown,1925.0
Unknown,Unknown,01,Unknown,Unknown,Debit,Unknown,EPI SERVICE PRIMEUR,Unknown,1926.0
Unknown,Unknown,07,Unknown,Unknown,Debit,Unknown,EPI SERVICE PRIMEUR,Unknown,1933.0
Unknown,Unknown,01,Unknown,Unknown,Debit,Unknown,EPI SERVICE PRIMEUR,Unknown,1934.0
Unknown,Unknown,64,Unknown,Unknown,Debit,Unknown,EPI SERVICE PRIMEUR,Unknown,1998.0
Unknown,Unknown,001,Unknown,Unknown,Debit,Unknown,EPI SERVICE PRIMEUR,Unknown,1999.0
Unknown,Unknown,"0,60",Unknown,Unknown,Debit,Unknown,EPI SERVICE PRIMEUR,Unknown,2059.0
Unknown,Unknown,0,Unknown,Unknown,Debit,Unknown,EPI SERVICE PRIMEUR,Unknown,2059.0
Unknown,Unknown,34 48,Unknown,Unknown,Debit,Unknown,EPI SERVICE PRIMEUR,Unknown,5507.0
Unknown,Unknown,"12 995,00",Unknown,Unknown,Debit,Unknown,EPI SERVICE PRIMEUR,Unknown,1305007.0
Unknown,Unknown,04,Unknown,Unknown,Debit,Unknown,EPI SERVICE PRIMEUR,Unknown,1305011.0
Unknown,Unknown,01 92,Unknown,Unknown,Debit,Unknown,EPI SERVICE PRIMEUR,Unknown,1305203.0
Unknown,Unknown,98 05,Unknown,Unknown,Debit,Unknown,EPI SERVICE PRIMEUR,Unknown,1315008.0
Unknown,Unknown,01 05,Unknown,Unknown,Debit,Unknown,EPI SERVICE PRIMEUR,Unknown,1315113.0
Unknown,Unknown,01 05,Unknown,Unknown,Debit,Unknown,EPI SERVICE PRIMEUR,Unknown,1315218.0
Unknown,Unknown,01 05,Unknown,Unknown,Debit,Unknown,EPI SERVICE PRIMEUR,Unknown,1315323.0
Unknown,Unknown,01 05,Unknown,Unknown,Debit,Unknown,EPI SERVICE PRIMEUR,Unknown,1315428.0
Unknown,Unknown,01 05,Unknown,Unknown,Debit,Unknown,EPI SERVICE PRIMEUR,Unknown,1315533.0
Unknown,Unknown,01 05,Unknown,Unknown,Debit,Unknown,EPI SERVICE PRIMEUR,Unknown,1315638.0
Unknown,Unknown,01 05,Unknown,Unknown,Debit,Unknown,EPI SERVICE PRIMEUR,Unknown,1315743.0
Unknown,Unknown,01,Unknown,Unknown,Debit,Unknown,EPI SERVICE PRIMEUR,Unknown,1315744.0
Unknown,Unknown,"5 380,00",Unknown,Unknown,Debit,Unknown,EPI SERVICE PRIMEUR,Unknown,1853744.0
Unknown,Unknown,"25,00",Unknown,Unknown,Debit,Unknown,EPI SERVICE PRIMEUR,Unknown,1856244.0
Unknown,Unknown,"72,40",Unknown,Unknown,Debit,Unknown,EPI SERVICE PRIMEUR,Unknown,1863484.0
Unknown,Unknown,"4 200,00",Unknown,Unknown,Debit,Unknown,EPI SERVICE PRIMEUR,Unknown,2283484.0
Unknown,Unknown,"29,50",Unknown,Unknown,Debit,Unknown,EPI SERVICE PRIMEUR,Unknown,2286434.0
Unknown,Unknown,0 31,Unknown,Unknown,Debit,Unknown,EPI SERVICE PRIMEUR,Unknown,2286465.0
Unknown,Unknown,"0,05",Unknown,Unknown,Debit,Unknown,EPI SERVICE PRIMEUR,Unknown,2286470.0
Unknown,Unknown,"329,51",Unknown,Unknown,Debit,Unknown,EPI SERVICE PRIMEUR,Unknown,2319421.0
Unknown,Unknown,05,Unknown,Unknown,Debit,Unknown,EPI SERVICE PRIMEUR,Unknown,2319426.0
Unknown,Unknown,"01 115,95",Unknown,Unknown,Debit,Unknown,EPI SERVICE PRIMEUR,Unknown,2431021.0
Unknown,Unknown,06,Unknown,Unknown,Debit,Unknown,EPI SERVICE PRIMEUR,Unknown,2431027.0
Unknown,Unknown,01 06,Unknown,Unknown,Debit,Unknown,EPI SERVICE PRIMEUR,Unknown,2431133.0
Unknown,Unknown,01 06,Unknown,Unknown,Debit,Unknown,EPI SERVICE PRIMEUR,Unknown,2431239.0
Unknown,Unknown,01 06,Unknown,Unknown,Debit,Unknown,EPI SERVICE PRIMEUR,Unknown,2431345.0
Unknown,Unknown,01 06,Unknown,Unknown,Debit,Unknown,EPI SERVICE PRIMEUR,Unknown,2431451.0
Unknown,Unknown,01 06,Unknown,Unknown,Debit,Unknown,EPI SERVICE PRIMEUR,Unknown,2431557.0
Unknown,Unknown,01 06,Unknown,Unknown,Debit,Unknown,EPI SERVICE PRIMEUR,Unknown,2431663.0
Unknown,Unknown,01 06,Unknown,Unknown,Debit,Unknown,EPI SERVICE PRIMEUR,Unknown,2431769.0
Unknown,Unknown,01 06,Unknown,Unknown,Debit,Unknown,EPI SERVICE PRIMEUR,Unknown,2431875.0
Unknown,Unknown,"01 230,00",Unknown,Unknown,Debit,Unknown,EPI SERVICE PRIMEUR,Unknown,2554875.0
Unknown,Unknown,"11,70",Unknown,Unknown,Debit,Unknown,EPI SERVICE PRIMEUR,Unknown,2556045.0
Unknown,Unknown,"219,24",Unknown,Unknown,Debit,Unknown,EPI SERVICE PRIMEUR,Unknown,2577969.0
Unknown,Unknown,"1,25",Unknown,Unknown,Debit,Unknown,EPI SERVICE PRIMEUR,Unknown,2578094.0
Unknown,Unknown,"0,02",Unknown,Unknown,Debit,Unknown,EPI SERVICE PRIMEUR,Unknown,2578096.0
Unknown,Unknown,"0,03",Unknown,Unknown,Debit,Unknown,EPI SERVICE PRIMEUR,Unknown,2578099.0
Unknown,Unknown,"0,57",Unknown,Unknown,Debit,Unknown,EPI SERVICE PRIMEUR,Unknown,2578156.0
Unknown,Unknown,0 47,Unknown,Unknown,Debit,Unknown,EPI SERVICE PRIMEUR,Unknown,2578203.0
Unknown,Unknown,1 00,Unknown,Unknown,Debit,Unknown,EPI SERVICE PRIMEUR,Unknown,2578303.0
Unknown,Unknown,07,Unknown,Unknown,Debit,Unknown,EPI SERVICE PRIMEUR,Unknown,2578310.0
Unknown,Unknown,01 07,Unknown,Unknown,Debit,Unknown,EPI SERVICE PRIMEUR,Unknown,2578417.0
Unknown,Unknown,01 07,Unknown,Unknown,Debit,Unknown,EPI SERVICE PRIMEUR,Unknown,2578524.0
Unknown,Unknown,01 07,Unknown,Unknown,Debit,Unknown,EPI SERVICE PRIMEUR,Unknown,2578631.0
Unknown,Unknown,01 07,Unknown,Unknown,Debit,Unknown,EPI SERVICE PRIMEUR,Unknown,2578738.0
Unknown,Unknown,01 07,Unknown,Unknown,Debit,Unknown,EPI SERVICE PRIMEUR,Unknown,2578845.0
Unknown,Unknown,01 07,Unknown,Unknown,Debit,Unknown,EPI SERVICE PRIMEUR,Unknown,2578952.0
Unknown,Unknown,01 07,Unknown,Unknown,Debit,Unknown,EPI SERVICE PRIMEUR,Unknown,2579059.0
Unknown,Unknown,01 07,Unknown,Unknown,Debit,Unknown,EPI SERVICE PRIMEUR,Unknown,2579166.0
Unknown,Unknown,01 07,Unknown,Unknown,Debit,Unknown,EPI SERVICE PRIMEUR,Unknown,2579273.0
Unknown,Unknown,01 07,Unknown,Unknown,Debit,Unknown,EPI SERVICE PRIMEUR,Unknown,2579380.0
Unknown,Unknown,01 21,Unknown,Unknown,Debit,Unknown,EPI SERVICE PRIMEUR,Unknown,2579501.0
Unknown,Unknown,"00 216,90",Unknown,Unknown,Debit,Unknown,EPI SERVICE PRIMEUR,Unknown,2601191.0
Unknown,Unknown,"17,30",Unknown,Unknown,Debit,Unknown,EPI SERVICE PRIMEUR,Unknown,2602921.0
Unknown,Unknown,"58,00",Unknown,Unknown,Debit,Unknown,EPI SERVICE PRIMEUR,Unknown,2608721.0
Unknown,Unknown,"8,00",Unknown,Unknown,Debit,Unknown,EPI SERVICE PRIMEUR,Unknown,2609521.0
Unknown,Unknown,1,Unknown,Unknown,Debit,Unknown,EPI SERVICE PRIMEUR,Unknown,2609522.0
Unknown,Unknown,0,Unknown,Unknown,Debit,Unknown,EPI SERVICE PRIMEUR,Unknown,2609522.0
Unknown,Unknown,1,Unknown,Unknown,Debit,Unknown,EPI SERVICE PRIMEUR,Unknown,2609523.0
Unknown,Unknown,"5 152,03",Unknown,Unknown,Debit,Unknown,EPI SERVICE PRIMEUR,Unknown,3124726.0
Unknown,Unknown,"35,00",Unknown,Unknown,Debit,Unknown,EPI SERVICE PRIMEUR,Unknown,3128226.0
Unknown,Unknown,"0,05",Unknown,Unknown,Debit,Unknown,EPI SERVICE PRIMEUR,Unknown,3128231.0
Unknown,Unknown,"0,91",Unknown,Unknown,Debit,Unknown,EPI SERVICE PRIMEUR,Unknown,3128322.0
Unknown,Unknown,"0,07",Unknown,Unknown,Debit,Unknown,EPI SERVICE PRIMEUR,Unknown,3128329.0
Unknown,Unknown,0 10,Unknown,Unknown,Debit,Unknown,EPI SERVICE PRIMEUR,Unknown,3128339.0
07/01/2021,Unknown,40,Unknown,Unknown,Unknown,Unknown,EPI SERVICE PRIMEUR,Titulaire(s,40.0
07/01/2021,Unknown,1,Unknown,Unknown,Unknown,Unknown,EPI SERVICE PRIMEUR,Page 616 Date Date,41.0
Unknown,Unknown,616,Unknown,Unknown,Unknown,Unknown,EPI SERVICE PRIMEUR,Operation Delont Cred,657.0
Unknown,Unknown,07,Unknown,Unknown,Unknown,Unknown,EPI SERVICE PRIMEUR,COM,664.0
Unknown,Unknown,01 07,Unknown,Unknown,Unknown,Unknown,EPI SERVICE PRIMEUR,COM,771.0
Unknown,Unknown,01 07,Unknown,Unknown,Unknown,Unknown,EPI SERVICE PRIMEUR,TOTAL DES OPÉRATIONS DU RELEVÉ,878.0
Unknown,Unknown,01,Unknown,Unknown,Unknown,Unknown,EPI SERVICE PRIMEUR,SOLDE,879.0
Unknown,Unknown,01,Unknown,Unknown,Unknown,Unknown,EPI SERVICE PRIMEUR,CRÉDITEUR AU 07 JANVIER,880.0
Unknown,Unknown,07,Unknown,Unknown,Unknown,Unknown,EPI SERVICE PRIMEUR,davas depots,887.0
Unknown,Unknown,01,Unknown,Unknown,Unknown,Unknown,EPI SERVICE PRIMEUR,FGDR,888.0
Unknown,Unknown,64,Unknown,Unknown,Unknown,Unknown,EPI SERVICE PRIMEUR,Credi Muuel,952.0
Unknown,Unknown,0 14,Unknown,Unknown,Unknown,Unknown,EPI SERVICE PRIMEUR,creda capial vanable,966.0
Unknown,Unknown,009,Unknown,Unknown,Unknown,Unknown,EPI SERVICE PRIMEUR,M ORIAS 07,975.0
Unknown,Unknown,19 233 86,Unknown,Unknown,Unknown,Unknown,EPI SERVICE PRIMEUR,Siege,1924361.0
Unknown,Unknown,"33 023,04",Unknown,Unknown,Unknown,Unknown,EPI SERVICE PRIMEUR,Releco Kerhuon Sren,5226665.0
Unknown,Unknown,07,Unknown,Unknown,Unknown,Unknown,EPI SERVICE PRIMEUR,RCS,5226672.0
Unknown,Unknown,"27 435,09",Unknown,Unknown,Unknown,Unknown,EPI SERVICE PRIMEUR,Elabussemnents Oe credi e apphcation,7970181.0
Unknown,Unknown,1,Unknown,Unknown,Unknown,Unknown,EPI SERVICE PRIMEUR,Qu Code monetare,7970182.0
Unknown,Unknown,4,Unknown,Unknown,Unknown,Unknown,EPI SERVICE PRIMEUR,hnancier,7970186.0
Unknown,Unknown,8,Unknown,Unknown,Unknown,Unknown,EPI SERVICE PRIMEUR,Reolementation Bancare,7970194.0
Unknown,Unknown,5,Unknown,Unknown,Unknown,Unknown,EPI SERVICE PRIMEUR,Millet,7970199.0
Unknown,Unknown,07 025 585,Unknown,Unknown,Unknown,Unknown,EPI SERVICE PRIMEUR,VOs depois,14995784.0
Unknown,Unknown,775 877 010,Unknown,Unknown,Unknown,Unknown,EPI SERVICE PRIMEUR,Uvque,790872794.0
Unknown,Unknown,312,Unknown,Unknown,Unknown,Unknown,EPI SERVICE PRIMEUR,Conservczle conhoenticuemen,790873106.0
Unknown,Unknown,90 05,Unknown,Unknown,Unknown,Unknown,EPI SERVICE PRIMEUR,Inlalion Oc Ouee,790882111.0
Unknown,Unknown,0,Unknown,Unknown,Unknown,Unknown,EPI SERVICE PRIMEUR,La bonne erecution dun contratetle tratement dune feclamation,790882111.0
Unknown,Unknown,0 800 00,Unknown,Unknown,Unknown,Unknown,EPI SERVICE PRIMEUR,Groupe Crede Muuel Nkea,790962111.0
Unknown,Unknown,30 92,Unknown,Unknown,Unknown,Unknown,EPI SERVICE PRIMEUR,Carse de CrediMuuel,790965203.0
Unknown,Unknown,Unknown,Unknown,Unknown,Unknown,Unknown,EPI SERVICE PRIMEUR,premernnerocueuin 0e lciconone,790965203.0
Unknown,Unknown,Unknown,Unknown,Unknown,Unknown,Unknown,EPI SERVICE PRIMEUR,Suae),790965203.0
Unknown,Unknown,Unknown,Unknown,Unknown,Unknown,Unknown,EPI SERVICE PRIMEUR,Brest,790965203.0
Unknown,Unknown,Unknown,Unknown,Unknown,Unknown,Unknown,EPI SERVICE PRIMEUR,Eman sugoeshionoemb,790965203.0
24/06/2021,40,Unknown,40,Unknown,Virement,Unknown,EPI SERVICE PRIMEUR,Titulaire(s,-40.0
24/06/2021,7,Unknown,7,Unknown,Virement,Unknown,EPI SERVICE PRIMEUR,Date Date de Valeur,-47.0
24/06/2021,6,Unknown,6,Unknown,Virement,Unknown,EPI SERVICE PRIMEUR,COM,-53.0
24/06/2021,10,Unknown,10,Unknown,Virement,Unknown,EPI SERVICE PRIMEUR,CARTES,-63.0
24/06/2021,24,Unknown,24,Unknown,Virement,Unknown,EPI SERVICE PRIMEUR,COM,-87.0
24/06/2021,06 24,Unknown,06 24,Unknown,Virement,Unknown,EPI SERVICE PRIMEUR,CARTES,-711.0
24/06/2021,06 24,Unknown,06 24,Unknown,Virement,Unknown,EPI SERVICE PRIMEUR,COM,-1335.0
24/06/2021,06 24,Unknown,06 24,Unknown,Virement,Unknown,EPI SERVICE PRIMEUR,CARTES 0386405,-1959.0
25/06/2021,06 24,Unknown,06 24,Unknown,Virement,Unknown,EPI SERVICE PRIMEUR,CHQ,-2583.0
24/06/2021,06 24,Unknown,06 24,Unknown,Virement,Unknown,EPI SERVICE PRIMEUR,REMISE,-3207.0
24/06/2021,06,Unknown,06,Unknown,Virement,Unknown,EPI SERVICE PRIMEUR,TPV,-3213.0
25/06/2021,01,Unknown,01,Unknown,Virement,Unknown,EPI SERVICE PRIMEUR,REMISE,-3214.0
25/06/2021,24,Unknown,24,Unknown,Virement,Unknown,EPI SERVICE PRIMEUR,TPV,-3238.0
25/06/2021,06,Unknown,06,Unknown,Virement,Unknown,EPI SERVICE PRIMEUR,REMISE,-3244.0
25/06/2021,64,Unknown,64,Unknown,Virement,Unknown,EPI SERVICE PRIMEUR,TPV,-3308.0
25/06/2021,24,Unknown,24,Unknown,Virement,Unknown,EPI SERVICE PRIMEUR,REMISE,-3332.0
25/06/2021,06,Unknown,06,Unknown,Virement,Unknown,EPI SERVICE PRIMEUR,TPV,-3338.0
25/06/2021,64,Unknown,64,Unknown,Virement,Unknown,EPI SERVICE PRIMEUR,REMISE,-3402.0
25/06/2021,24,Unknown,24,Unknown,Virement,Unknown,EPI SERVICE PRIMEUR,CARTE,-3426.0
25/06/2021,06,Unknown,06,Unknown,Virement,Unknown,EPI SERVICE PRIMEUR,FVIREMENT,-3432.0
25/06/2021,24,Unknown,24,Unknown,Virement,Unknown,EPI SERVICE PRIMEUR,CAS DUN VIREMENT,-3456.0
25/06/2021,06,Unknown,06,Unknown,Virement,Unknown,EPI SERVICE PRIMEUR,OCCASIONNEL,-3462.0
25/06/2021,24,Unknown,24,Unknown,Virement,Unknown,EPI SERVICE PRIMEUR,COM,-3486.0
28/06/2021,06,Unknown,06,Unknown,Virement,Unknown,EPI SERVICE PRIMEUR,CARTES,-3492.0
25/06/2021,24,Unknown,24,Unknown,Virement,Unknown,EPI SERVICE PRIMEUR,COM,-3516.0
25/06/2021,06,Unknown,06,Unknown,Virement,Unknown,EPI SERVICE PRIMEUR,CARTES,-3522.0
26/06/2021,24,Unknown,24,Unknown,Virement,Unknown,EPI SERVICE PRIMEUR,COM,-3546.0
26/06/2021,06,Unknown,06,Unknown,Virement,Unknown,EPI SERVICE PRIMEUR,CARTES 0386405,-3552.0
26/06/2021,25,Unknown,25,Unknown,Virement,Unknown,EPI SERVICE PRIMEUR,COM,-3577.0
26/06/2021,06,Unknown,06,Unknown,Virement,Unknown,EPI SERVICE PRIMEUR,CARTES,-3583.0
26/06/2021,24,Unknown,24,Unknown,Virement,Unknown,EPI SERVICE PRIMEUR,COM,-3607.0
26/06/2021,06,Unknown,06,Unknown,Virement,Unknown,EPI SERVICE PRIMEUR,CARTES,-3613.0
26/06/2021,24,Unknown,24,Unknown,Virement,Unknown,EPI SERVICE PRIMEUR,COM,-3637.0
28/06/2021,06,Unknown,06,Unknown,Virement,Unknown,EPI SERVICE PRIMEUR,CARTES,-3643.0
28/06/2021,25,Unknown,25,Unknown,Virement,Unknown,EPI SERVICE PRIMEUR,FR66ZZZ425331 B35M000000550,-3668.0
28/06/2021,06,Unknown,06,Unknown,Virement,Unknown,EPI SERVICE PRIMEUR,MO1,-3674.0
28/06/2021,25,Unknown,25,Unknown,Virement,Unknown,EPI SERVICE PRIMEUR,REMISE,-3699.0
28/06/2021,06,Unknown,06,Unknown,Virement,Unknown,EPI SERVICE PRIMEUR,REMISE,-3705.0
28/06/2021,24,Unknown,24,Unknown,Virement,Unknown,EPI SERVICE PRIMEUR,TPV,-3729.0
28/06/2021,06,Unknown,06,Unknown,Virement,Unknown,EPI SERVICE PRIMEUR,REMISE,-3735.0
28/06/2021,25,Unknown,25,Unknown,Virement,Unknown,EPI SERVICE PRIMEUR,REMISE,-3760.0
28/06/2021,06,Unknown,06,Unknown,Virement,Unknown,EPI SERVICE PRIMEUR,CARTE,-3766.0
28/06/2021,25,Unknown,25,Unknown,Virement,Unknown,EPI SERVICE PRIMEUR,METRO,-3791.0
28/06/2021,06,Unknown,06,Unknown,Virement,Unknown,EPI SERVICE PRIMEUR,COM,-3797.0
28/06/2021,64,Unknown,64,Unknown,Virement,Unknown,EPI SERVICE PRIMEUR,CARTES,-3861.0
28/06/2021,25,Unknown,25,Unknown,Virement,Unknown,EPI SERVICE PRIMEUR,COM,-3886.0
28/06/2021,06,Unknown,06,Unknown,Virement,Unknown,EPI SERVICE PRIMEUR,CARTES 0386405,-3892.0
28/06/2021,01,Unknown,01,Unknown,Virement,Unknown,EPI SERVICE PRIMEUR,COM,-3893.0
28/06/2021,25,Unknown,25,Unknown,Virement,Unknown,EPI SERVICE PRIMEUR,CARTES,-3918.0
Unknown,06,Unknown,06,Unknown,Virement,Unknown,EPI SERVICE PRIMEUR,COM,-3924.0
Unknown,64,Unknown,64,Unknown,Virement,Unknown,EPI SERVICE PRIMEUR,CARTES,-3988.0
Unknown,25,Unknown,25,Unknown,Virement,Unknown,EPI SERVICE PRIMEUR,COM,-4013.0
Unknown,06,Unknown,06,Unknown,Virement,Unknown,EPI SERVICE PRIMEUR,CARTES,-4019.0
Unknown,01,Unknown,01,Unknown,Virement,Unknown,EPI SERVICE PRIMEUR,COM,-4020.0
Unknown,25,Unknown,25,Unknown,Virement,Unknown,EPI SERVICE PRIMEUR,CARTES 0386405,-4045.0
Unknown,06,Unknown,06,Unknown,Virement,Unknown,EPI SERVICE PRIMEUR,TPV,-4051.0
Unknown,64,Unknown,64,Unknown,Virement,Unknown,EPI SERVICE PRIMEUR,TPV,-4115.0
Unknown,25,Unknown,25,Unknown,Virement,Unknown,EPI SERVICE PRIMEUR,TPV,-4140.0
Unknown,06,Unknown,06,Unknown,Virement,Unknown,EPI SERVICE PRIMEUR,TPV,-4146.0
Unknown,01,Unknown,01,Unknown,Virement,Unknown,EPI SERVICE PRIMEUR,TPV,-4147.0
Unknown,25,Unknown,25,Unknown,Virement,Unknown,EPI SERVICE PRIMEUR,CARTES,-4172.0
Unknown,06,Unknown,06,Unknown,Virement,Unknown,EPI SERVICE PRIMEUR,COM,-4178.0
Unknown,35,Unknown,35,Unknown,Virement,Unknown,EPI SERVICE PRIMEUR,CARTES,-4213.0
Unknown,82 25,Unknown,82 25,Unknown,Virement,Unknown,EPI SERVICE PRIMEUR,COM,-12438.0
Unknown,06,Unknown,06,Unknown,Virement,Unknown,EPI SERVICE PRIMEUR,CARTES 0386405 64 2706 28/06/2021 COM,-12444.0
Unknown,25,Unknown,25,Unknown,Virement,Unknown,EPI SERVICE PRIMEUR,CARTES 0386405,-12469.0
Unknown,06,Unknown,06,Unknown,Virement,Unknown,EPI SERVICE PRIMEUR,COM,-12475.0
Unknown,28,Unknown,28,Unknown,Virement,Unknown,EPI SERVICE PRIMEUR,CARTES,-12503.0
Unknown,06,Unknown,06,Unknown,Virement,Unknown,EPI SERVICE PRIMEUR,COM,-12509.0
Unknown,25,Unknown,25,Unknown,Virement,Unknown,EPI SERVICE PRIMEUR,CARTES,-12534.0
Unknown,06,Unknown,06,Unknown,Virement,Unknown,EPI SERVICE PRIMEUR,Unknown,-12540.0
Unknown,25,Unknown,25,Unknown,Virement,Unknown,EPI SERVICE PRIMEUR,Unknown,-12565.0
Unknown,06,Unknown,06,Unknown,Virement,Unknown,EPI SERVICE PRIMEUR,Unknown,-12571.0
Unknown,26,Unknown,26,Unknown,Virement,Unknown,EPI SERVICE PRIMEUR,Unknown,-12597.0
Unknown,06,Unknown,06,Unknown,Virement,Unknown,EPI SERVICE PRIMEUR,Unknown,-12603.0
Unknown,25,Unknown,25,Unknown,Virement,Unknown,EPI SERVICE PRIMEUR,Unknown,-12628.0
Unknown,06,Unknown,06,Unknown,Virement,Unknown,EPI SERVICE PRIMEUR,Unknown,-12634.0
Unknown,26,Unknown,26,Unknown,Virement,Unknown,EPI SERVICE PRIMEUR,Unknown,-12660.0
Unknown,06,Unknown,06,Unknown,Virement,Unknown,EPI SERVICE PRIMEUR,Unknown,-12666.0
Unknown,64,Unknown,64,Unknown,Virement,Unknown,EPI SERVICE PRIMEUR,Unknown,-12730.0
Unknown,26,Unknown,26,Unknown,Virement,Unknown,EPI SERVICE PRIMEUR,Unknown,-12756.0
Unknown,06,Unknown,06,Unknown,Virement,Unknown,EPI SERVICE PRIMEUR,Unknown,-12762.0
Unknown,64,Unknown,64,Unknown,Virement,Unknown,EPI SERVICE PRIMEUR,Unknown,-12826.0
Unknown,26,Unknown,26,Unknown,Virement,Unknown,EPI SERVICE PRIMEUR,Unknown,-12852.0
Unknown,06,Unknown,06,Unknown,Virement,Unknown,EPI SERVICE PRIMEUR,Unknown,-12858.0
Unknown,01,Unknown,01,Unknown,Virement,Unknown,EPI SERVICE PRIMEUR,Unknown,-12859.0
Unknown,26,Unknown,26,Unknown,Virement,Unknown,EPI SERVICE PRIMEUR,Unknown,-12885.0
Unknown,06,Unknown,06,Unknown,Virement,Unknown,EPI SERVICE PRIMEUR,Unknown,-12891.0
Unknown,64,Unknown,64,Unknown,Virement,Unknown,EPI SERVICE PRIMEUR,Unknown,-12955.0
Unknown,26,Unknown,26,Unknown,Virement,Unknown,EPI SERVICE PRIMEUR,Unknown,-12981.0
Unknown,06,Unknown,06,Unknown,Virement,Unknown,EPI SERVICE PRIMEUR,Unknown,-12987.0
Unknown,01,Unknown,01,Unknown,Virement,Unknown,EPI SERVICE PRIMEUR,Unknown,-12988.0
Unknown,26,Unknown,26,Unknown,Virement,Unknown,EPI SERVICE PRIMEUR,Unknown,-13014.0
Unknown,06,Unknown,06,Unknown,Virement,Unknown,EPI SERVICE PRIMEUR,Unknown,-13020.0
Unknown,64,Unknown,64,Unknown,Virement,Unknown,EPI SERVICE PRIMEUR,Unknown,-13084.0
Unknown,28,Unknown,28,Unknown,Virement,Unknown,EPI SERVICE PRIMEUR,Unknown,-13112.0
Unknown,06,Unknown,06,Unknown,Virement,Unknown,EPI SERVICE PRIMEUR,Unknown,-13118.0
Unknown,28,Unknown,28,Unknown,Virement,Unknown,EPI SERVICE PRIMEUR,Unknown,-13146.0
Unknown,06,Unknown,06,Unknown,Virement,Unknown,EPI SERVICE PRIMEUR,Unknown,-13152.0
Unknown,28,Unknown,28,Unknown,Virement,Unknown,EPI SERVICE PRIMEUR,Unknown,-13180.0
Unknown,06,Unknown,06,Unknown,Virement,Unknown,EPI SERVICE PRIMEUR,Unknown,-13186.0
Unknown,28,Unknown,28,Unknown,Virement,Unknown,EPI SERVICE PRIMEUR,Unknown,-13214.0
Unknown,06,Unknown,06,Unknown,Virement,Unknown,EPI SERVICE PRIMEUR,Unknown,-13220.0
Unknown,28,Unknown,28,Unknown,Virement,Unknown,EPI SERVICE PRIMEUR,Unknown,-13248.0
Unknown,06,Unknown,06,Unknown,Virement,Unknown,EPI SERVICE PRIMEUR,Unknown,-13254.0
Unknown,28,Unknown,28,Unknown,Virement,Unknown,EPI SERVICE PRIMEUR,Unknown,-13282.0
Unknown,06,Unknown,06,Unknown,Virement,Unknown,EPI SERVICE PRIMEUR,Unknown,-13288.0
Unknown,28,Unknown,28,Unknown,Virement,Unknown,EPI SERVICE PRIMEUR,Unknown,-13316.0
Unknown,06,Unknown,06,Unknown,Virement,Unknown,EPI SERVICE PRIMEUR,Unknown,-13322.0
Unknown,28,Unknown,28,Unknown,Virement,Unknown,EPI SERVICE PRIMEUR,Unknown,-13350.0
Unknown,06,Unknown,06,Unknown,Virement,Unknown,EPI SERVICE PRIMEUR,Unknown,-13356.0
Unknown,28,Unknown,28,Unknown,Virement,Unknown,EPI SERVICE PRIMEUR,Unknown,-13384.0
Unknown,06,Unknown,06,Unknown,Virement,Unknown,EPI SERVICE PRIMEUR,Unknown,-13390.0
Unknown,26,Unknown,26,Unknown,Virement,Unknown,EPI SERVICE PRIMEUR,Unknown,-13416.0
Unknown,06,Unknown,06,Unknown,Virement,Unknown,EPI SERVICE PRIMEUR,Unknown,-13422.0
Unknown,28,Unknown,28,Unknown,Virement,Unknown,EPI SERVICE PRIMEUR,Unknown,-13450.0
Unknown,06,Unknown,06,Unknown,Virement,Unknown,EPI SERVICE PRIMEUR,Unknown,-13456.0
Unknown,26,Unknown,26,Unknown,Virement,Unknown,EPI SERVICE PRIMEUR,Unknown,-13482.0
Unknown,06,Unknown,06,Unknown,Virement,Unknown,EPI SERVICE PRIMEUR,Unknown,-13488.0
Unknown,28,Unknown,28,Unknown,Virement,Unknown,EPI SERVICE PRIMEUR,Unknown,-13516.0
Unknown,06,Unknown,06,Unknown,Virement,Unknown,EPI SERVICE PRIMEUR,Unknown,-13522.0
Unknown,64,Unknown,64,Unknown,Virement,Unknown,EPI SERVICE PRIMEUR,Unknown,-13586.0
Unknown,28,Unknown,28,Unknown,Virement,Unknown,EPI SERVICE PRIMEUR,Unknown,-13614.0
Unknown,06,Unknown,06,Unknown,Virement,Unknown,EPI SERVICE PRIMEUR,Unknown,-13620.0
Unknown,01,Unknown,01,Unknown,Virement,Unknown,EPI SERVICE PRIMEUR,Unknown,-13621.0
Unknown,28,Unknown,28,Unknown,Virement,Unknown,EPI SERVICE PRIMEUR,Unknown,-13649.0
Unknown,06,Unknown,06,Unknown,Virement,Unknown,EPI SERVICE PRIMEUR,Unknown,-13655.0
Unknown,64,Unknown,64,Unknown,Virement,Unknown,EPI SERVICE PRIMEUR,Unknown,-13719.0
Unknown,28,Unknown,28,Unknown,Virement,Unknown,EPI SERVICE PRIMEUR,Unknown,-13747.0
Unknown,06,Unknown,06,Unknown,Virement,Unknown,EPI SERVICE PRIMEUR,Unknown,-13753.0
Unknown,01,Unknown,01,Unknown,Virement,Unknown,EPI SERVICE PRIMEUR,Unknown,-13754.0
Unknown,28,Unknown,28,Unknown,Virement,Unknown,EPI SERVICE PRIMEUR,Unknown,-13782.0
Unknown,06,Unknown,06,Unknown,Virement,Unknown,EPI SERVICE PRIMEUR,Unknown,-13788.0
Unknown,64,Unknown,64,Unknown,Virement,Unknown,EPI SERVICE PRIMEUR,Unknown,-13852.0
Unknown,28,Unknown,28,Unknown,Virement,Unknown,EPI SERVICE PRIMEUR,Unknown,-13880.0
Unknown,06,Unknown,06,Unknown,Virement,Unknown,EPI SERVICE PRIMEUR,Unknown,-13886.0
Unknown,01,Unknown,01,Unknown,Virement,Unknown,EPI SERVICE PRIMEUR,Unknown,-13887.0
Unknown,"0,46",Unknown,"0,46",Unknown,Virement,Unknown,EPI SERVICE PRIMEUR,Unknown,-13933.0
Unknown,"0,57",Unknown,"0,57",Unknown,Virement,Unknown,EPI SERVICE PRIMEUR,Unknown,-13990.0
Unknown,"0,03",Unknown,"0,03",Unknown,Virement,Unknown,EPI SERVICE PRIMEUR,Unknown,-13993.0
Unknown,"328,00",Unknown,"328,00",Unknown,Virement,Unknown,EPI SERVICE PRIMEUR,Unknown,-46793.0
Unknown,"323,09",Unknown,"323,09",Unknown,Virement,Unknown,EPI SERVICE PRIMEUR,Unknown,-79102.0
Unknown,24,Unknown,24,Unknown,Virement,Unknown,EPI SERVICE PRIMEUR,Unknown,-79126.0
Unknown,06 25,Unknown,06 25,Unknown,Virement,Unknown,EPI SERVICE PRIMEUR,Unknown,-79751.0
Unknown,06 25,Unknown,06 25,Unknown,Virement,Unknown,EPI SERVICE PRIMEUR,Unknown,-80376.0
Unknown,06 25,Unknown,06 25,Unknown,Virement,Unknown,EPI SERVICE PRIMEUR,Unknown,-81001.0
Unknown,06 25,Unknown,06 25,Unknown,Virement,Unknown,EPI SERVICE PRIMEUR,Unknown,-81626.0
Unknown,06 25,Unknown,06 25,Unknown,Virement,Unknown,EPI SERVICE PRIMEUR,Unknown,-82251.0
Unknown,06 25,Unknown,06 25,Unknown,Virement,Unknown,EPI SERVICE PRIMEUR,Unknown,-82876.0
Unknown,06 25,Unknown,06 25,Unknown,Virement,Unknown,EPI SERVICE PRIMEUR,Unknown,-83501.0
Unknown,06 25,Unknown,06 25,Unknown,Virement,Unknown,EPI SERVICE PRIMEUR,Unknown,-84126.0
Unknown,"06 596,87",Unknown,"06 596,87",Unknown,Virement,Unknown,EPI SERVICE PRIMEUR,Unknown,-743813.0
Unknown,"67,80",Unknown,"67,80",Unknown,Virement,Unknown,EPI SERVICE PRIMEUR,Unknown,-750593.0
Unknown,"384,35",Unknown,"384,35",Unknown,Virement,Unknown,EPI SERVICE PRIMEUR,Unknown,-789028.0
Unknown,"431,25",Unknown,"431,25",Unknown,Virement,Unknown,EPI SERVICE PRIMEUR,Unknown,-832153.0
Unknown,"45,50",Unknown,"45,50",Unknown,Virement,Unknown,EPI SERVICE PRIMEUR,Unknown,-836703.0
Unknown,"112,90",Unknown,"112,90",Unknown,Virement,Unknown,EPI SERVICE PRIMEUR,Unknown,-847993.0
Unknown,"15,00",Unknown,"15,00",Unknown,Virement,Unknown,EPI SERVICE PRIMEUR,Unknown,-849493.0
Unknown,"150,00",Unknown,"150,00",Unknown,Virement,Unknown,EPI SERVICE PRIMEUR,Unknown,-864493.0
Unknown,"3,85",Unknown,"3,85",Unknown,Virement,Unknown,EPI SERVICE PRIMEUR,Unknown,-864878.0
Unknown,25,Unknown,25,Unknown,Virement,Unknown,EPI SERVICE PRIMEUR,Unknown,-864903.0
Unknown,06 25,Unknown,06 25,Unknown,Virement,Unknown,EPI SERVICE PRIMEUR,Unknown,-865528.0
Unknown,06 25,Unknown,06 25,Unknown,Virement,Unknown,EPI SERVICE PRIMEUR,Unknown,-866153.0
Unknown,06 25,Unknown,06 25,Unknown,Virement,Unknown,EPI SERVICE PRIMEUR,Unknown,-866778.0
Unknown,06 25,Unknown,06 25,Unknown,Virement,Unknown,EPI SERVICE PRIMEUR,Unknown,-867403.0
Unknown,06 25,Unknown,06 25,Unknown,Virement,Unknown,EPI SERVICE PRIMEUR,Unknown,-868028.0
Unknown,06 25,Unknown,06 25,Unknown,Virement,Unknown,EPI SERVICE PRIMEUR,Unknown,-868653.0
Unknown,06,Unknown,06,Unknown,Virement,Unknown,EPI SERVICE PRIMEUR,Unknown,-868659.0
Unknown,"0,64",Unknown,"0,64",Unknown,Virement,Unknown,EPI SERVICE PRIMEUR,Unknown,-868723.0
Unknown,"0,08",Unknown,"0,08",Unknown,Virement,Unknown,EPI SERVICE PRIMEUR,Unknown,-868731.0
Unknown,"1,92",Unknown,"1,92",Unknown,Virement,Unknown,EPI SERVICE PRIMEUR,Unknown,-868923.0
Unknown,"1,53",Unknown,"1,53",Unknown,Virement,Unknown,EPI SERVICE PRIMEUR,Unknown,-869076.0
Unknown,"0,29",Unknown,"0,29",Unknown,Virement,Unknown,EPI SERVICE PRIMEUR,Unknown,-869105.0
Unknown,"0,31",Unknown,"0,31",Unknown,Virement,Unknown,EPI SERVICE PRIMEUR,Unknown,-869136.0
Unknown,"300,00",Unknown,"300,00",Unknown,Virement,Unknown,EPI SERVICE PRIMEUR,Unknown,-899136.0
Unknown,26,Unknown,26,Unknown,Virement,Unknown,EPI SERVICE PRIMEUR,Unknown,-899162.0
Unknown,06 26,Unknown,06 26,Unknown,Virement,Unknown,EPI SERVICE PRIMEUR,Unknown,-899788.0
Unknown,06 26,Unknown,06 26,Unknown,Virement,Unknown,EPI SERVICE PRIMEUR,Unknown,-900414.0
Unknown,06 26,Unknown,06 26,Unknown,Virement,Unknown,EPI SERVICE PRIMEUR,Unknown,-901040.0
Unknown,06 26,Unknown,06 26,Unknown,Virement,Unknown,EPI SERVICE PRIMEUR,Unknown,-901666.0
Unknown,06 26,Unknown,06 26,Unknown,Virement,Unknown,EPI SERVICE PRIMEUR,Unknown,-902292.0
Unknown,06 26,Unknown,06 26,Unknown,Virement,Unknown,EPI SERVICE PRIMEUR,Unknown,-902918.0
Unknown,06 26,Unknown,06 26,Unknown,Virement,Unknown,EPI SERVICE PRIMEUR,Unknown,-903544.0
Unknown,06 26,Unknown,06 26,Unknown,Virement,Unknown,EPI SERVICE PRIMEUR,Unknown,-904170.0
Unknown,06 26,Unknown,06 26,Unknown,Virement,Unknown,EPI SERVICE PRIMEUR,Unknown,-904796.0
Unknown,06 26,Unknown,06 26,Unknown,Virement,Unknown,EPI SERVICE PRIMEUR,Unknown,-905422.0
Unknown,06 26,Unknown,06 26,Unknown,Virement,Unknown,EPI SERVICE PRIMEUR,Unknown,-906048.0
Unknown,06 28,Unknown,06 28,Unknown,Virement,Unknown,EPI SERVICE PRIMEUR,Unknown,-906676.0
Unknown,06 28,Unknown,06 28,Unknown,Virement,Unknown,EPI SERVICE PRIMEUR,Unknown,-907304.0
Unknown,06 28,Unknown,06 28,Unknown,Virement,Unknown,EPI SERVICE PRIMEUR,Unknown,-907932.0
Unknown,06 28,Unknown,06 28,Unknown,Virement,Unknown,EPI SERVICE PRIMEUR,Unknown,-908560.0
Unknown,06 28,Unknown,06 28,Unknown,Virement,Unknown,EPI SERVICE PRIMEUR,Unknown,-909188.0
Unknown,06 28,Unknown,06 28,Unknown,Virement,Unknown,EPI SERVICE PRIMEUR,Unknown,-909816.0
Unknown,06 28,Unknown,06 28,Unknown,Virement,Unknown,EPI SERVICE PRIMEUR,Unknown,-910444.0
Unknown,06 28,Unknown,06 28,Unknown,Virement,Unknown,EPI SERVICE PRIMEUR,Unknown,-911072.0
Unknown,06 28,Unknown,06 28,Unknown,Virement,Unknown,EPI SERVICE PRIMEUR,Unknown,-911700.0
Unknown,06 28,Unknown,06 28,Unknown,Virement,Unknown,EPI SERVICE PRIMEUR,Unknown,-912328.0
Unknown,06 28,Unknown,06 28,Unknown,Virement,Unknown,EPI SERVICE PRIMEUR,Unknown,-912956.0
Unknown,06 28,Unknown,06 28,Unknown,Virement,Unknown,EPI SERVICE PRIMEUR,Unknown,-913584.0
Unknown,06 28,Unknown,06 28,Unknown,Virement,Unknown,EPI SERVICE PRIMEUR,Unknown,-914212.0
Unknown,06 28,Unknown,06 28,Unknown,Virement,Unknown,EPI SERVICE PRIMEUR,Unknown,-914840.0
Unknown,06 28,Unknown,06 28,Unknown,Virement,Unknown,EPI SERVICE PRIMEUR,Unknown,-915468.0
Unknown,06 28,Unknown,06 28,Unknown,Virement,Unknown,EPI SERVICE PRIMEUR,Unknown,-916096.0
Unknown,06 20,Unknown,06 20,Unknown,Virement,Unknown,EPI SERVICE PRIMEUR,Unknown,-916716.0
Unknown,"50 323,60",Unknown,"50 323,60",Unknown,Virement,Unknown,EPI SERVICE PRIMEUR,Unknown,-5949076.0
Unknown,"207,10",Unknown,"207,10",Unknown,Virement,Unknown,EPI SERVICE PRIMEUR,Unknown,-5969786.0
Unknown,"48,80",Unknown,"48,80",Unknown,Virement,Unknown,EPI SERVICE PRIMEUR,Unknown,-5974666.0
Unknown,"17,20",Unknown,"17,20",Unknown,Virement,Unknown,EPI SERVICE PRIMEUR,Unknown,-5976386.0
Unknown,"400,70",Unknown,"400,70",Unknown,Virement,Unknown,EPI SERVICE PRIMEUR,Unknown,-6016456.0
Unknown,"0,08",Unknown,"0,08",Unknown,Virement,Unknown,EPI SERVICE PRIMEUR,Unknown,-6016464.0
Unknown,"1,61",Unknown,"1,61",Unknown,Virement,Unknown,EPI SERVICE PRIMEUR,Unknown,-6016625.0
Unknown,"0,93",Unknown,"0,93",Unknown,Virement,Unknown,EPI SERVICE PRIMEUR,Unknown,-6016718.0
Unknown,"0,27",Unknown,"0,27",Unknown,Virement,Unknown,EPI SERVICE PRIMEUR,Unknown,-6016745.0
Unknown,"0,01",Unknown,"0,01",Unknown,Virement,Unknown,EPI SERVICE PRIMEUR,Unknown,-6016746.0
Unknown,"0,07",Unknown,"0,07",Unknown,Virement,Unknown,EPI SERVICE PRIMEUR,Unknown,-6016753.0
Unknown,"91,50",Unknown,"91,50",Unknown,Virement,Unknown,EPI SERVICE PRIMEUR,Unknown,-6025903.0
Unknown,"786,60",Unknown,"786,60",Unknown,Virement,Unknown,EPI SERVICE PRIMEUR,Unknown,-6104563.0
Unknown,"299,00",Unknown,"299,00",Unknown,Virement,Unknown,EPI SERVICE PRIMEUR,Unknown,-6134463.0
Unknown,"68,00",Unknown,"68,00",Unknown,Virement,Unknown,EPI SERVICE PRIMEUR,Unknown,-6141263.0
Unknown,"252,30",Unknown,"252,30",Unknown,Virement,Unknown,EPI SERVICE PRIMEUR,Unknown,-6166493.0
Unknown,"168,10",Unknown,"168,10",Unknown,Virement,Unknown,EPI SERVICE PRIMEUR,Unknown,-6183303.0
Unknown,"844,11",Unknown,"844,11",Unknown,Virement,Unknown,EPI SERVICE PRIMEUR,Unknown,-6267714.0
Unknown,"35,19",Unknown,"35,19",Unknown,Virement,Unknown,EPI SERVICE PRIMEUR,Unknown,-6271233.0
Unknown,1,Unknown,1,Unknown,Virement,Unknown,EPI SERVICE PRIMEUR,Unknown,-6271234.0
Unknown,"84,35",Unknown,"84,35",Unknown,Virement,Unknown,EPI SERVICE PRIMEUR,Unknown,-6279669.0
Unknown,"101,90",Unknown,"101,90",Unknown,Virement,Unknown,EPI SERVICE PRIMEUR,Unknown,-6289859.0
Unknown,"0,72",Unknown,"0,72",Unknown,Virement,Unknown,EPI SERVICE PRIMEUR,Unknown,-6289931.0
Unknown,"0,09",Unknown,"0,09",Unknown,Virement,Unknown,EPI SERVICE PRIMEUR,Unknown,-6289940.0
Unknown,"4,24",Unknown,"4,24",Unknown,Virement,Unknown,EPI SERVICE PRIMEUR,Unknown,-6290364.0
Unknown,"1,21",Unknown,"1,21",Unknown,Virement,Unknown,EPI SERVICE PRIMEUR,Unknown,-6290485.0
Unknown,"1,04",Unknown,"1,04",Unknown,Virement,Unknown,EPI SERVICE PRIMEUR,Unknown,-6290589.0
Unknown,"0,28",Unknown,"0,28",Unknown,Virement,Unknown,EPI SERVICE PRIMEUR,Unknown,-6290617.0
Unknown,Unknown,1,Unknown,Unknown,Unknown,Unknown,Banque Inconnue,cid:22)(cid:23)(cid:24,1.0
Unknown,Unknown,2,Unknown,Unknown,Unknown,Unknown,Banque Inconnue,cid:43)(cid:2)(cid:37)(cid:17)(cid:2)(cid:18)(cid:18)(cid:18)(cid:19)(cid:18)(cid:18)(cid:2)(cid:44,3.0
Unknown,Unknown,3,Unknown,Unknown,Unknown,Unknown,Banque Inconnue,cid:25)(cid:24)(cid:26)(cid:27)(cid:28)(cid:2)(cid:28)(cid:3)(cid:16)(cid:32)(cid:2)(cid:17)(cid:32)(cid:33)(cid:34)(cid:2)(cid:35)(cid:18)(cid:18)(cid:18)(cid:2)(cid:18)(cid:17)(cid:33)(cid:35)(cid:2)(cid:17)(cid:1)(cid:36)(cid:37)(cid:2)(cid:33)(cid:35)(cid:33)(cid:1)(cid:2)(cid:1)(cid:18)(cid:34,6.0
Unknown,Unknown,2,Unknown,Unknown,Unknown,Unknown,Banque Inconnue,cid:24)(cid:25)(cid:29)(cid:28)(cid:2)(cid:38)(cid:8)(cid:10)(cid:11)(cid:28)(cid:3)(cid:39)(cid:17)(cid:40)(cid:40)(cid:40,8.0
Unknown,Unknown,4,Unknown,Unknown,Unknown,Unknown,Banque Inconnue,Unknown,12.0
Unknown,Unknown,5,Unknown,Unknown,Unknown,Unknown,Banque Inconnue,Unknown,17.0
Unknown,Unknown,6,Unknown,Unknown,Unknown,Unknown,Banque Inconnue,Unknown,23.0
Unknown,Unknown,7,Unknown,Unknown,Unknown,Unknown,Banque Inconnue,Unknown,30.0
Unknown,Unknown,8,Unknown,Unknown,Unknown,Unknown,Banque Inconnue,Unknown,38.0
Unknown,Unknown,9,Unknown,Unknown,Unknown,Unknown,Banque Inconnue,Unknown,47.0
Unknown,Unknown,10,Unknown,Unknown,Unknown,Unknown,Banque Inconnue,Unknown,57.0
Unknown,Unknown,11,Unknown,Unknown,Unknown,Unknown,Banque Inconnue,Unknown,68.0
Unknown,Unknown,9,Unknown,Unknown,Unknown,Unknown,Banque Inconnue,Unknown,77.0
Unknown,Unknown,12,Unknown,Unknown,Unknown,Unknown,Banque Inconnue,Unknown,89.0
Unknown,Unknown,13,Unknown,Unknown,Unknown,Unknown,Banque Inconnue,Unknown,102.0
Unknown,Unknown,2,Unknown,Unknown,Unknown,Unknown,Banque Inconnue,Unknown,104.0
Unknown,Unknown,6,Unknown,Unknown,Unknown,Unknown,Banque Inconnue,Unknown,110.0
Unknown,Unknown,14,Unknown,Unknown,Unknown,Unknown,Banque Inconnue,Unknown,124.0
Unknown,Unknown,15,Unknown,Unknown,Unknown,Unknown,Banque Inconnue,Unknown,139.0
Unknown,Unknown,7,Unknown,Unknown,Unknown,Unknown,Banque Inconnue,Unknown,146.0
Unknown,Unknown,16,Unknown,Unknown,Unknown,Unknown,Banque Inconnue,Unknown,162.0
Unknown,Unknown,17,Unknown,Unknown,Unknown,Unknown,Banque Inconnue,Unknown,179.0
Unknown,Unknown,18,Unknown,Unknown,Unknown,Unknown,Banque Inconnue,Unknown,197.0
Unknown,Unknown,16,Unknown,Unknown,Unknown,Unknown,Banque Inconnue,Unknown,213.0
Unknown,Unknown,19,Unknown,Unknown,Unknown,Unknown,Banque Inconnue,Unknown,232.0
Unknown,Unknown,18,Unknown,Unknown,Unknown,Unknown,Banque Inconnue,Unknown,250.0
Unknown,Unknown,20,Unknown,Unknown,Unknown,Unknown,Banque Inconnue,Unknown,270.0
Unknown,Unknown,16,Unknown,Unknown,Unknown,Unknown,Banque Inconnue,Unknown,286.0
Unknown,Unknown,20,Unknown,Unknown,Unknown,Unknown,Banque Inconnue,Unknown,306.0
Unknown,Unknown,17,Unknown,Unknown,Unknown,Unknown,Banque Inconnue,Unknown,323.0
Unknown,Unknown,7,Unknown,Unknown,Unknown,Unknown,Banque Inconnue,Unknown,330.0
Unknown,Unknown,9,Unknown,Unknown,Unknown,Unknown,Banque Inconnue,Unknown,339.0
Unknown,Unknown,15,Unknown,Unknown,Unknown,Unknown,Banque Inconnue,Unknown,354.0
Unknown,Unknown,7,Unknown,Unknown,Unknown,Unknown,Banque Inconnue,Unknown,361.0
Unknown,Unknown,21,Unknown,Unknown,Unknown,Unknown,Banque Inconnue,Unknown,382.0
Unknown,Unknown,17,Unknown,Unknown,Unknown,Unknown,Banque Inconnue,Unknown,399.0
Unknown,Unknown,18,Unknown,Unknown,Unknown,Unknown,Banque Inconnue,Unknown,417.0
Unknown,Unknown,16,Unknown,Unknown,Unknown,Unknown,Banque Inconnue,Unknown,433.0
Unknown,Unknown,19,Unknown,Unknown,Unknown,Unknown,Banque Inconnue,Unknown,452.0
Unknown,Unknown,18,Unknown,Unknown,Unknown,Unknown,Banque Inconnue,Unknown,470.0
Unknown,Unknown,20,Unknown,Unknown,Unknown,Unknown,Banque Inconnue,Unknown,490.0
Unknown,Unknown,16,Unknown,Unknown,Unknown,Unknown,Banque Inconnue,Unknown,506.0
Unknown,Unknown,20,Unknown,Unknown,Unknown,Unknown,Banque Inconnue,Unknown,526.0
Unknown,Unknown,17,Unknown,Unknown,Unknown,Unknown,Banque Inconnue,Unknown,543.0
Unknown,Unknown,22,Unknown,Unknown,Unknown,Unknown,Banque Inconnue,Unknown,565.0
Unknown,Unknown,23,Unknown,Unknown,Unknown,Unknown,Banque Inconnue,Unknown,588.0
Unknown,Unknown,24,Unknown,Unknown,Unknown,Unknown,Banque Inconnue,Unknown,612.0
Unknown,Unknown,30,Unknown,Unknown,Unknown,Unknown,Banque Inconnue,Unknown,642.0
Unknown,Unknown,31,Unknown,Unknown,Unknown,Unknown,Banque Inconnue,Unknown,673.0
Unknown,Unknown,3,Unknown,Unknown,Unknown,Unknown,Banque Inconnue,Unknown,676.0
Unknown,Unknown,32,Unknown,Unknown,Unknown,Unknown,Banque Inconnue,Unknown,708.0
Unknown,Unknown,2,Unknown,Unknown,Unknown,Unknown,Banque Inconnue,Unknown,710.0
Unknown,Unknown,7,Unknown,Unknown,Unknown,Unknown,Banque Inconnue,Unknown,717.0
Unknown,Unknown,9,Unknown,Unknown,Unknown,Unknown,Banque Inconnue,Unknown,726.0
Unknown,Unknown,15,Unknown,Unknown,Unknown,Unknown,Banque Inconnue,Unknown,741.0
Unknown,Unknown,7,Unknown,Unknown,Unknown,Unknown,Banque Inconnue,Unknown,748.0
Unknown,Unknown,16,Unknown,Unknown,Unknown,Unknown,Banque Inconnue,Unknown,764.0
Unknown,Unknown,17,Unknown,Unknown,Unknown,Unknown,Banque Inconnue,Unknown,781.0
Unknown,Unknown,18,Unknown,Unknown,Unknown,Unknown,Banque Inconnue,Unknown,799.0
Unknown,Unknown,16,Unknown,Unknown,Unknown,Unknown,Banque Inconnue,Unknown,815.0
Unknown,Unknown,19,Unknown,Unknown,Unknown,Unknown,Banque Inconnue,Unknown,834.0
Unknown,Unknown,33,Unknown,Unknown,Unknown,Unknown,Banque Inconnue,Unknown,867.0
Unknown,Unknown,7,Unknown,Unknown,Unknown,Unknown,Banque Inconnue,Unknown,874.0
Unknown,Unknown,17,Unknown,Unknown,Unknown,Unknown,Banque Inconnue,Unknown,891.0
Unknown,Unknown,16,Unknown,Unknown,Unknown,Unknown,Banque Inconnue,Unknown,907.0
Unknown,Unknown,21,Unknown,Unknown,Unknown,Unknown,Banque Inconnue,Unknown,928.0
Unknown,Unknown,34,Unknown,Unknown,Unknown,Unknown,Banque Inconnue,Unknown,962.0
Unknown,Unknown,35,Unknown,Unknown,Unknown,Unknown,Banque Inconnue,Unknown,997.0
Unknown,Unknown,20,Unknown,Unknown,Unknown,Unknown,Banque Inconnue,Unknown,1017.0
Unknown,Unknown,7,Unknown,Unknown,Unknown,Unknown,Banque Inconnue,Unknown,1024.0
Unknown,Unknown,36,Unknown,Unknown,Unknown,Unknown,Banque Inconnue,Unknown,1060.0
Unknown,Unknown,1,Unknown,Unknown,Unknown,Unknown,Banque Inconnue,Unknown,1061.0
Unknown,Unknown,2,Unknown,Unknown,Unknown,Unknown,Banque Inconnue,Unknown,1063.0
Unknown,Unknown,3,Unknown,Unknown,Unknown,Unknown,Banque Inconnue,Unknown,1066.0
Unknown,Unknown,4,Unknown,Unknown,Unknown,Unknown,Banque Inconnue,Unknown,1070.0
Unknown,Unknown,5,Unknown,Unknown,Unknown,Unknown,Banque Inconnue,Unknown,1075.0
Unknown,Unknown,2,Unknown,Unknown,Unknown,Unknown,Banque Inconnue,Unknown,1077.0
Unknown,Unknown,6,Unknown,Unknown,Unknown,Unknown,Banque Inconnue,Unknown,1083.0
Unknown,Unknown,7,Unknown,Unknown,Unknown,Unknown,Banque Inconnue,Unknown,1090.0
Unknown,Unknown,8,Unknown,Unknown,Unknown,Unknown,Banque Inconnue,Unknown,1098.0
Unknown,Unknown,9,Unknown,Unknown,Unknown,Unknown,Banque Inconnue,Unknown,1107.0
Unknown,Unknown,10,Unknown,Unknown,Unknown,Unknown,Banque Inconnue,Unknown,1117.0
Unknown,Unknown,11,Unknown,Unknown,Unknown,Unknown,Banque Inconnue,Unknown,1128.0
Unknown,Unknown,8,Unknown,Unknown,Unknown,Unknown,Banque Inconnue,Unknown,1136.0
Unknown,Unknown,2,Unknown,Unknown,Unknown,Unknown,Banque Inconnue,Unknown,1138.0
Unknown,Unknown,12,Unknown,Unknown,Unknown,Unknown,Banque Inconnue,Unknown,1150.0
Unknown,Unknown,13,Unknown,Unknown,Unknown,Unknown,Banque Inconnue,Unknown,1163.0
Unknown,Unknown,4,Unknown,Unknown,Unknown,Unknown,Banque Inconnue,Unknown,1167.0
Unknown,Unknown,3,Unknown,Unknown,Unknown,Unknown,Banque Inconnue,Unknown,1170.0
Unknown,Unknown,12,Unknown,Unknown,Unknown,Unknown,Banque Inconnue,Unknown,1182.0
Unknown,Unknown,13,Unknown,Unknown,Unknown,Unknown,Banque Inconnue,Unknown,1195.0
Unknown,Unknown,7,Unknown,Unknown,Unknown,Unknown,Banque Inconnue,Unknown,1202.0
Unknown,Unknown,14,Unknown,Unknown,Unknown,Unknown,Banque Inconnue,Unknown,1216.0
Unknown,Unknown,14,Unknown,Unknown,Unknown,Unknown,Banque Inconnue,Unknown,1230.0
Unknown,Unknown,2,Unknown,Unknown,Unknown,Unknown,Banque Inconnue,Unknown,1232.0
Unknown,Unknown,15,Unknown,Unknown,Unknown,Unknown,Banque Inconnue,Unknown,1247.0
Unknown,Unknown,2,Unknown,Unknown,Unknown,Unknown,Banque Inconnue,Unknown,1249.0
Unknown,Unknown,5,Unknown,Unknown,Unknown,Unknown,Banque Inconnue,Unknown,1254.0
Unknown,Unknown,30,Unknown,Unknown,Unknown,Unknown,Banque Inconnue,Unknown,1284.0
Unknown,Unknown,41,Unknown,Unknown,Unknown,Unknown,Banque Inconnue,Unknown,1325.0
Unknown,Unknown,26,Unknown,Unknown,Unknown,Unknown,Banque Inconnue,Unknown,1351.0
Unknown,Unknown,42,Unknown,Unknown,Unknown,Unknown,Banque Inconnue,Unknown,1393.0
Unknown,Unknown,25,Unknown,Unknown,Unknown,Unknown,Banque Inconnue,Unknown,1418.0
Unknown,Unknown,27,Unknown,Unknown,Unknown,Unknown,Banque Inconnue,Unknown,1445.0
Unknown,Unknown,43,Unknown,Unknown,Unknown,Unknown,Banque Inconnue,Unknown,1488.0
Unknown,Unknown,2,Unknown,Unknown,Unknown,Unknown,Banque Inconnue,Unknown,1490.0
Unknown,Unknown,37,Unknown,Unknown,Unknown,Unknown,Banque Inconnue,Unknown,1527.0
Unknown,Unknown,17,Unknown,Unknown,Unknown,Unknown,Banque Inconnue,Unknown,1544.0
Unknown,Unknown,2,Unknown,Unknown,Unknown,Unknown,Banque Inconnue,Unknown,1546.0
Unknown,Unknown,18,Unknown,Unknown,Unknown,Unknown,Banque Inconnue,Unknown,1564.0
Unknown,Unknown,18,Unknown,Unknown,Unknown,Unknown,Banque Inconnue,Unknown,1582.0
Unknown,Unknown,18,Unknown,Unknown,Unknown,Unknown,Banque Inconnue,Unknown,1600.0
Unknown,Unknown,19,Unknown,Unknown,Unknown,Unknown,Banque Inconnue,Unknown,1619.0
Unknown,Unknown,18,Unknown,Unknown,Unknown,Unknown,Banque Inconnue,Unknown,1637.0
Unknown,Unknown,18,Unknown,Unknown,Unknown,Unknown,Banque Inconnue,Unknown,1655.0
Unknown,Unknown,2,Unknown,Unknown,Unknown,Unknown,Banque Inconnue,Unknown,1657.0
Unknown,Unknown,44,Unknown,Unknown,Unknown,Unknown,Banque Inconnue,Unknown,1701.0
Unknown,Unknown,16,Unknown,Unknown,Unknown,Unknown,Banque Inconnue,Unknown,1717.0
Unknown,Unknown,16,Unknown,Unknown,Unknown,Unknown,Banque Inconnue,Unknown,1733.0
Unknown,Unknown,17,Unknown,Unknown,Unknown,Unknown,Banque Inconnue,Unknown,1750.0
Unknown,Unknown,1,Unknown,Unknown,Unknown,Unknown,Banque Inconnue,Unknown,1751.0
Unknown,Unknown,18,Unknown,Unknown,Unknown,Unknown,Banque Inconnue,Unknown,1769.0
Unknown,Unknown,19,Unknown,Unknown,Unknown,Unknown,Banque Inconnue,Unknown,1788.0
Unknown,Unknown,2,Unknown,Unknown,Unknown,Unknown,Banque Inconnue,Unknown,1790.0
Unknown,Unknown,12,Unknown,Unknown,Unknown,Unknown,Banque Inconnue,Unknown,1802.0
Unknown,Unknown,20,Unknown,Unknown,Unknown,Unknown,Banque Inconnue,Unknown,1822.0
Unknown,Unknown,21,Unknown,Unknown,Unknown,Unknown,Banque Inconnue,Unknown,1843.0
Unknown,Unknown,22,Unknown,Unknown,Unknown,Unknown,Banque Inconnue,Unknown,1865.0
Unknown,Unknown,20,Unknown,Unknown,Unknown,Unknown,Banque Inconnue,Unknown,1885.0
Unknown,Unknown,23,Unknown,Unknown,Unknown,Unknown,Banque Inconnue,Unknown,1908.0
Unknown,Unknown,23,Unknown,Unknown,Unknown,Unknown,Banque Inconnue,Unknown,1931.0
Unknown,Unknown,24,Unknown,Unknown,Unknown,Unknown,Banque Inconnue,Unknown,1955.0
Unknown,Unknown,25,Unknown,Unknown,Unknown,Unknown,Banque Inconnue,Unknown,1980.0
Unknown,Unknown,26,Unknown,Unknown,Unknown,Unknown,Banque Inconnue,Unknown,2006.0
Unknown,Unknown,27,Unknown,Unknown,Unknown,Unknown,Banque Inconnue,Unknown,2033.0
Unknown,Unknown,19,Unknown,Unknown,Unknown,Unknown,Banque Inconnue,Unknown,2052.0
Unknown,Unknown,2,Unknown,Unknown,Unknown,Unknown,Banque Inconnue,Unknown,2054.0
Unknown,Unknown,28,Unknown,Unknown,Unknown,Unknown,Banque Inconnue,Unknown,2082.0
Unknown,Unknown,26,Unknown,Unknown,Unknown,Unknown,Banque Inconnue,Unknown,2108.0
Unknown,Unknown,29,Unknown,Unknown,Unknown,Unknown,Banque Inconnue,Unknown,2137.0
Unknown,Unknown,30,Unknown,Unknown,Unknown,Unknown,Banque Inconnue,Unknown,2167.0
Unknown,Unknown,31,Unknown,Unknown,Unknown,Unknown,Banque Inconnue,Unknown,2198.0
Unknown,Unknown,25,Unknown,Unknown,Unknown,Unknown,Banque Inconnue,Unknown,2223.0
Unknown,Unknown,9,Unknown,Unknown,Unknown,Unknown,Banque Inconnue,Unknown,2232.0
Unknown,Unknown,20,Unknown,Unknown,Unknown,Unknown,Banque Inconnue,Unknown,2252.0
Unknown,Unknown,26,Unknown,Unknown,Unknown,Unknown,Banque Inconnue,Unknown,2278.0
Unknown,Unknown,41,Unknown,Unknown,Unknown,Unknown,Banque Inconnue,Unknown,2319.0
Unknown,Unknown,24,Unknown,Unknown,Unknown,Unknown,Banque Inconnue,Unknown,2343.0
Unknown,Unknown,25,Unknown,Unknown,Unknown,Unknown,Banque Inconnue,Unknown,2368.0
Unknown,Unknown,27,Unknown,Unknown,Unknown,Unknown,Banque Inconnue,Unknown,2395.0
Unknown,Unknown,15,Unknown,Unknown,Unknown,Unknown,Banque Inconnue,Unknown,2410.0
Unknown,Unknown,2,Unknown,Unknown,Unknown,Unknown,Banque Inconnue,Unknown,2412.0
Unknown,Unknown,37,Unknown,Unknown,Unknown,Unknown,Banque Inconnue,Unknown,2449.0
Unknown,Unknown,18,Unknown,Unknown,Unknown,Unknown,Banque Inconnue,Unknown,2467.0
Unknown,Unknown,2,Unknown,Unknown,Unknown,Unknown,Banque Inconnue,Unknown,2469.0
Unknown,Unknown,18,Unknown,Unknown,Unknown,Unknown,Banque Inconnue,Unknown,2487.0
Unknown,Unknown,36,Unknown,Unknown,Unknown,Unknown,Banque Inconnue,Unknown,2523.0
Unknown,Unknown,35,Unknown,Unknown,Unknown,Unknown,Banque Inconnue,Unknown,2558.0
Unknown,Unknown,19,Unknown,Unknown,Unknown,Unknown,Banque Inconnue,Unknown,2577.0
Unknown,Unknown,37,Unknown,Unknown,Unknown,Unknown,Banque Inconnue,Unknown,2614.0
Unknown,Unknown,16,Unknown,Unknown,Unknown,Unknown,Banque Inconnue,Unknown,2630.0
Unknown,Unknown,2,Unknown,Unknown,Unknown,Unknown,Banque Inconnue,Unknown,2632.0
Unknown,Unknown,44,Unknown,Unknown,Unknown,Unknown,Banque Inconnue,Unknown,2676.0
Unknown,Unknown,25,Unknown,Unknown,Unknown,Unknown,Banque Inconnue,Unknown,2701.0
Unknown,Unknown,24,Unknown,Unknown,Unknown,Unknown,Banque Inconnue,Unknown,2725.0
Unknown,Unknown,26,Unknown,Unknown,Unknown,Unknown,Banque Inconnue,Unknown,2751.0
Unknown,Unknown,27,Unknown,Unknown,Unknown,Unknown,Banque Inconnue,Unknown,2778.0
Unknown,Unknown,28,Unknown,Unknown,Unknown,Unknown,Banque Inconnue,Unknown,2806.0
Unknown,Unknown,2,Unknown,Unknown,Unknown,Unknown,Banque Inconnue,Unknown,2808.0
Unknown,Unknown,28,Unknown,Unknown,Unknown,Unknown,Banque Inconnue,Unknown,2836.0
Unknown,Unknown,3,Unknown,Unknown,Unknown,Unknown,Banque Inconnue,Unknown,2839.0
Unknown,Unknown,16,Unknown,Unknown,Unknown,Unknown,Banque Inconnue,Unknown,2855.0
Unknown,Unknown,32,Unknown,Unknown,Unknown,Unknown,Banque Inconnue,Unknown,2887.0
Unknown,Unknown,2,Unknown,Unknown,Unknown,Unknown,Banque Inconnue,Unknown,2889.0
Unknown,Unknown,17,Unknown,Unknown,Unknown,Unknown,Banque Inconnue,Unknown,2906.0
Unknown,Unknown,32,Unknown,Unknown,Unknown,Unknown,Banque Inconnue,Unknown,2938.0
Unknown,Unknown,33,Unknown,Unknown,Unknown,Unknown,Banque Inconnue,Unknown,2971.0
Unknown,Unknown,34,Unknown,Unknown,Unknown,Unknown,Banque Inconnue,Unknown,3005.0
Unknown,Unknown,2,Unknown,Unknown,Unknown,Unknown,Banque Inconnue,Unknown,3007.0
Unknown,Unknown,35,Unknown,Unknown,Unknown,Unknown,Banque Inconnue,Unknown,3042.0
Unknown,Unknown,18,Unknown,Unknown,Unknown,Unknown,Banque Inconnue,Unknown,3060.0
Unknown,Unknown,18,Unknown,Unknown,Unknown,Unknown,Banque Inconnue,Unknown,3078.0
Unknown,Unknown,18,Unknown,Unknown,Unknown,Unknown,Banque Inconnue,Unknown,3096.0
Unknown,Unknown,2,Unknown,Unknown,Unknown,Unknown,Banque Inconnue,Unknown,3098.0
Unknown,Unknown,18,Unknown,Unknown,Unknown,Unknown,Banque Inconnue,Unknown,3116.0
Unknown,Unknown,17,Unknown,Unknown,Unknown,Unknown,Banque Inconnue,Unknown,3133.0
Unknown,Unknown,33,Unknown,Unknown,Unknown,Unknown,Banque Inconnue,Unknown,3166.0
Unknown,Unknown,35,Unknown,Unknown,Unknown,Unknown,Banque Inconnue,Unknown,3201.0
Unknown,Unknown,2,Unknown,Unknown,Unknown,Unknown,Banque Inconnue,Unknown,3203.0
Unknown,Unknown,17,Unknown,Unknown,Unknown,Unknown,Banque Inconnue,Unknown,3220.0
Unknown,Unknown,1,Unknown,Unknown,Unknown,Unknown,Banque Inconnue,Unknown,3221.0
Unknown,Unknown,36,Unknown,Unknown,Unknown,Unknown,Banque Inconnue,Unknown,3257.0
Unknown,Unknown,37,Unknown,Unknown,Unknown,Unknown,Banque Inconnue,Unknown,3294.0
Unknown,Unknown,2,Unknown,Unknown,Unknown,Unknown,Banque Inconnue,Unknown,3296.0
Unknown,Unknown,33,Unknown,Unknown,Unknown,Unknown,Banque Inconnue,Unknown,3329.0
Unknown,Unknown,35,Unknown,Unknown,Unknown,Unknown,Banque Inconnue,Unknown,3364.0
Unknown,Unknown,33,Unknown,Unknown,Unknown,Unknown,Banque Inconnue,Unknown,3397.0
Unknown,Unknown,1,Unknown,Unknown,Unknown,Unknown,Banque Inconnue,Unknown,3398.0
Unknown,Unknown,2,Unknown,Unknown,Unknown,Unknown,Banque Inconnue,Unknown,3400.0
Unknown,Unknown,1,Unknown,Unknown,Unknown,Unknown,Banque Inconnue,Unknown,3401.0
Unknown,Unknown,18,Unknown,Unknown,Unknown,Unknown,Banque Inconnue,Unknown,3419.0
Unknown,Unknown,34,Unknown,Unknown,Unknown,Unknown,Banque Inconnue,Unknown,3453.0
Unknown,Unknown,24,Unknown,Unknown,Unknown,Unknown,Banque Inconnue,Unknown,3477.0
Unknown,Unknown,25,Unknown,Unknown,Unknown,Unknown,Banque Inconnue,Unknown,3502.0
Unknown,Unknown,29,Unknown,Unknown,Unknown,Unknown,Banque Inconnue,Unknown,3531.0
Unknown,Unknown,28,Unknown,Unknown,Unknown,Unknown,Banque Inconnue,Unknown,3559.0
Unknown,Unknown,2,Unknown,Unknown,Unknown,Unknown,Banque Inconnue,Unknown,3561.0
Unknown,Unknown,38,Unknown,Unknown,Unknown,Unknown,Banque Inconnue,Unknown,3599.0
Unknown,Unknown,8,Unknown,Unknown,Unknown,Unknown,Banque Inconnue,Unknown,3607.0
Unknown,Unknown,10,Unknown,Unknown,Unknown,Unknown,Banque Inconnue,Unknown,3617.0
Unknown,Unknown,11,Unknown,Unknown,Unknown,Unknown,Banque Inconnue,Unknown,3628.0
Unknown,Unknown,28,Unknown,Unknown,Unknown,Unknown,Banque Inconnue,Unknown,3656.0
Unknown,Unknown,3,Unknown,Unknown,Unknown,Unknown,Banque Inconnue,Unknown,3659.0
Unknown,Unknown,39,Unknown,Unknown,Unknown,Unknown,Banque Inconnue,Unknown,3698.0
Unknown,Unknown,17,Unknown,Unknown,Unknown,Unknown,Banque Inconnue,Unknown,3715.0
Unknown,Unknown,40,Unknown,Unknown,Unknown,Unknown,Banque Inconnue,Unknown,3755.0
Unknown,Unknown,40,Unknown,Unknown,Unknown,Unknown,Banque Inconnue,Unknown,3795.0
Unknown,Unknown,40,Unknown,Unknown,Unknown,Unknown,Banque Inconnue,Unknown,3835.0
Unknown,Unknown,30,Unknown,Unknown,Unknown,Unknown,Banque Inconnue,Unknown,3865.0
Unknown,Unknown,31,Unknown,Unknown,Unknown,Unknown,Banque Inconnue,Unknown,3896.0
Unknown,Unknown,3,Unknown,Unknown,Unknown,Unknown,Banque Inconnue,Unknown,3899.0
Unknown,Unknown,32,Unknown,Unknown,Unknown,Unknown,Banque Inconnue,Unknown,3931.0
Unknown,Unknown,2,Unknown,Unknown,Unknown,Unknown,Banque Inconnue,Unknown,3933.0
Unknown,Unknown,7,Unknown,Unknown,Unknown,Unknown,Banque Inconnue,Unknown,3940.0
Unknown,Unknown,9,Unknown,Unknown,Unknown,Unknown,Banque Inconnue,Unknown,3949.0
Unknown,Unknown,15,Unknown,Unknown,Unknown,Unknown,Banque Inconnue,Unknown,3964.0
Unknown,Unknown,7,Unknown,Unknown,Unknown,Unknown,Banque Inconnue,Unknown,3971.0
Unknown,Unknown,21,Unknown,Unknown,Unknown,Unknown,Banque Inconnue,Unknown,3992.0
Unknown,Unknown,17,Unknown,Unknown,Unknown,Unknown,Banque Inconnue,Unknown,4009.0
Unknown,Unknown,18,Unknown,Unknown,Unknown,Unknown,Banque Inconnue,Unknown,4027.0
Unknown,Unknown,16,Unknown,Unknown,Unknown,Unknown,Banque Inconnue,Unknown,4043.0
Unknown,Unknown,19,Unknown,Unknown,Unknown,Unknown,Banque Inconnue,Unknown,4062.0
Unknown,Unknown,33,Unknown,Unknown,Unknown,Unknown,Banque Inconnue,Unknown,4095.0
Unknown,Unknown,7,Unknown,Unknown,Unknown,Unknown,Banque Inconnue,Unknown,4102.0
Unknown,Unknown,17,Unknown,Unknown,Unknown,Unknown,Banque Inconnue,Unknown,4119.0
Unknown,Unknown,7,Unknown,Unknown,Unknown,Unknown,Banque Inconnue,Unknown,4126.0
Unknown,Unknown,16,Unknown,Unknown,Unknown,Unknown,Banque Inconnue,Unknown,4142.0
Unknown,Unknown,37,Unknown,Unknown,Unknown,Unknown,Banque Inconnue,Unknown,4179.0
Unknown,Unknown,37,Unknown,Unknown,Unknown,Unknown,Banque Inconnue,Unknown,4216.0
Unknown,Unknown,34,Unknown,Unknown,Unknown,Unknown,Banque Inconnue,Unknown,4250.0
Unknown,Unknown,37,Unknown,Unknown,Unknown,Unknown,Banque Inconnue,Unknown,4287.0
Unknown,Unknown,37,Unknown,Unknown,Unknown,Unknown,Banque Inconnue,Unknown,4324.0
Unknown,Unknown,7,Unknown,Unknown,Unknown,Unknown,Banque Inconnue,Unknown,4331.0
Unknown,Unknown,36,Unknown,Unknown,Unknown,Unknown,Banque Inconnue,Unknown,4367.0
Unknown,Unknown,14,Unknown,Unknown,Unknown,Unknown,cid:50)(cid:46)(cid:12)(cid:2)(cid:7)(cid:8)(cid:10)(cid:5)(cid:3)(cid:48)(cid:46)(cid:3)(cid:12)(cid:13)(cid:5)(cid:2)(cid:14)(cid:46)(cid:2)(cid:28)(cid:5)(cid:3)(cid:10)(cid:5)(cid:2)(cid:64)(cid:46)(cid:4)(cid:12)(cid:2)(cid:28)(cid:3,cid:12)(cid:20)(cid:30)(cid:41)(cid:26)(cid:29)(cid:41)(cid:2)(cid:46)(cid:10)(cid:1)(cid:37)(cid:37)(cid:1)(cid:34)(cid:16)(cid:2)(cid:15)(cid:2)(cid:18)(cid:32)(cid:18)(cid:16)(cid:1)(cid:18)(cid:1)(cid:17)(cid:18)(cid:18)(cid:16)(cid:35)(cid:33)(cid:18)(cid:34,14.0
Unknown,Unknown,9,Unknown,Unknown,Unknown,Unknown,cid:50)(cid:46)(cid:12)(cid:2)(cid:7)(cid:8)(cid:10)(cid:5)(cid:3)(cid:48)(cid:46)(cid:3)(cid:12)(cid:13)(cid:5)(cid:2)(cid:14)(cid:46)(cid:2)(cid:28)(cid:5)(cid:3)(cid:10)(cid:5)(cid:2)(cid:64)(cid:46)(cid:4)(cid:12)(cid:2)(cid:28)(cid:3,cid:18)(cid:35)(cid:45)(cid:18)(cid:16,23.0
Unknown,Unknown,38,Unknown,Unknown,Unknown,Unknown,cid:50)(cid:46)(cid:12)(cid:2)(cid:7)(cid:8)(cid:10)(cid:5)(cid:3)(cid:48)(cid:46)(cid:3)(cid:12)(cid:13)(cid:5)(cid:2)(cid:14)(cid:46)(cid:2)(cid:28)(cid:5)(cid:3)(cid:10)(cid:5)(cid:2)(cid:64)(cid:46)(cid:4)(cid:12)(cid:2)(cid:28)(cid:3,cid:9)(cid:41)(cid:29)(cid:41)(cid:24)(cid:20)(cid:30)(cid:2)(cid:46)(cid:62)(cid:24)(cid:29)(cid:2)(cid:66)(cid:46)(cid:4)(cid:50)(cid:11)(cid:49)(cid:2)(cid:5)(cid:8)(cid:2)(cid:47)(cid:3)(cid:7)(cid:2)(cid:28)(cid:3,61.0
Unknown,Unknown,2,Unknown,Unknown,Unknown,Unknown,cid:50)(cid:46)(cid:12)(cid:2)(cid:7)(cid:8)(cid:10)(cid:5)(cid:3)(cid:48)(cid:46)(cid:3)(cid:12)(cid:13)(cid:5)(cid:2)(cid:14)(cid:46)(cid:2)(cid:28)(cid:5)(cid:3)(cid:10)(cid:5)(cid:2)(cid:64)(cid:46)(cid:4)(cid:12)(cid:2)(cid:28)(cid:3,cid:15)(cid:2)(cid:37)(cid:18)(cid:19)(cid:37)(cid:33)(cid:2)(cid:44,63.0
Unknown,Unknown,7,Unknown,Unknown,Unknown,Unknown,cid:50)(cid:46)(cid:12)(cid:2)(cid:7)(cid:8)(cid:10)(cid:5)(cid:3)(cid:48)(cid:46)(cid:3)(cid:12)(cid:13)(cid:5)(cid:2)(cid:14)(cid:46)(cid:2)(cid:28)(cid:5)(cid:3)(cid:10)(cid:5)(cid:2)(cid:64)(cid:46)(cid:4)(cid:12)(cid:2)(cid:28)(cid:3,cid:18)(cid:35)(cid:45)(cid:18)(cid:16,70.0
Unknown,Unknown,32,Unknown,Unknown,Unknown,Unknown,cid:50)(cid:46)(cid:12)(cid:2)(cid:7)(cid:8)(cid:10)(cid:5)(cid:3)(cid:48)(cid:46)(cid:3)(cid:12)(cid:13)(cid:5)(cid:2)(cid:14)(cid:46)(cid:2)(cid:28)(cid:5)(cid:3)(cid:10)(cid:5)(cid:2)(cid:64)(cid:46)(cid:4)(cid:12)(cid:2)(cid:28)(cid:3,cid:14)(cid:5)(cid:12)(cid:14)(cid:5)(cid:3)(cid:12)(cid:2)(cid:12)(cid:11)(cid:4)(cid:14)(cid:11)(cid:48)(cid:48)(cid:7)(cid:5)(cid:3)(cid:2)(cid:28)(cid:3,102.0
Unknown,Unknown,2,Unknown,Unknown,Unknown,Unknown,cid:50)(cid:46)(cid:12)(cid:2)(cid:7)(cid:8)(cid:10)(cid:5)(cid:3)(cid:48)(cid:46)(cid:3)(cid:12)(cid:13)(cid:5)(cid:2)(cid:14)(cid:46)(cid:2)(cid:28)(cid:5)(cid:3)(cid:10)(cid:5)(cid:2)(cid:64)(cid:46)(cid:4)(cid:12)(cid:2)(cid:28)(cid:3,Unknown,104.0
Unknown,Unknown,7,Unknown,Unknown,Unknown,Unknown,cid:50)(cid:46)(cid:12)(cid:2)(cid:7)(cid:8)(cid:10)(cid:5)(cid:3)(cid:48)(cid:46)(cid:3)(cid:12)(cid:13)(cid:5)(cid:2)(cid:14)(cid:46)(cid:2)(cid:28)(cid:5)(cid:3)(cid:10)(cid:5)(cid:2)(cid:64)(cid:46)(cid:4)(cid:12)(cid:2)(cid:28)(cid:3,Unknown,111.0
Unknown,Unknown,4,Unknown,Unknown,Unknown,Unknown,cid:50)(cid:46)(cid:12)(cid:2)(cid:7)(cid:8)(cid:10)(cid:5)(cid:3)(cid:48)(cid:46)(cid:3)(cid:12)(cid:13)(cid:5)(cid:2)(cid:14)(cid:46)(cid:2)(cid:28)(cid:5)(cid:3)(cid:10)(cid:5)(cid:2)(cid:64)(cid:46)(cid:4)(cid:12)(cid:2)(cid:28)(cid:3,Unknown,115.0
Unknown,Unknown,9,Unknown,Unknown,Unknown,Unknown,cid:50)(cid:46)(cid:12)(cid:2)(cid:7)(cid:8)(cid:10)(cid:5)(cid:3)(cid:48)(cid:46)(cid:3)(cid:12)(cid:13)(cid:5)(cid:2)(cid:14)(cid:46)(cid:2)(cid:28)(cid:5)(cid:3)(cid:10)(cid:5)(cid:2)(cid:64)(cid:46)(cid:4)(cid:12)(cid:2)(cid:28)(cid:3,Unknown,124.0
Unknown,Unknown,3,Unknown,Unknown,Unknown,Unknown,cid:50)(cid:46)(cid:12)(cid:2)(cid:7)(cid:8)(cid:10)(cid:5)(cid:3)(cid:48)(cid:46)(cid:3)(cid:12)(cid:13)(cid:5)(cid:2)(cid:14)(cid:46)(cid:2)(cid:28)(cid:5)(cid:3)(cid:10)(cid:5)(cid:2)(cid:64)(cid:46)(cid:4)(cid:12)(cid:2)(cid:28)(cid:3,Unknown,127.0
Unknown,Unknown,2,Unknown,Unknown,Unknown,Unknown,cid:50)(cid:46)(cid:12)(cid:2)(cid:7)(cid:8)(cid:10)(cid:5)(cid:3)(cid:48)(cid:46)(cid:3)(cid:12)(cid:13)(cid:5)(cid:2)(cid:14)(cid:46)(cid:2)(cid:28)(cid:5)(cid:3)(cid:10)(cid:5)(cid:2)(cid:64)(cid:46)(cid:4)(cid:12)(cid:2)(cid:28)(cid:3,Unknown,129.0
Unknown,Unknown,15,Unknown,Unknown,Unknown,Unknown,cid:50)(cid:46)(cid:12)(cid:2)(cid:7)(cid:8)(cid:10)(cid:5)(cid:3)(cid:48)(cid:46)(cid:3)(cid:12)(cid:13)(cid:5)(cid:2)(cid:14)(cid:46)(cid:2)(cid:28)(cid:5)(cid:3)(cid:10)(cid:5)(cid:2)(cid:64)(cid:46)(cid:4)(cid:12)(cid:2)(cid:28)(cid:3,Unknown,144.0
Unknown,Unknown,13,Unknown,Unknown,Unknown,Unknown,cid:50)(cid:46)(cid:12)(cid:2)(cid:7)(cid:8)(cid:10)(cid:5)(cid:3)(cid:48)(cid:46)(cid:3)(cid:12)(cid:13)(cid:5)(cid:2)(cid:14)(cid:46)(cid:2)(cid:28)(cid:5)(cid:3)(cid:10)(cid:5)(cid:2)(cid:64)(cid:46)(cid:4)(cid:12)(cid:2)(cid:28)(cid:3,Unknown,157.0
Unknown,Unknown,39,Unknown,Unknown,Unknown,Unknown,cid:50)(cid:46)(cid:12)(cid:2)(cid:7)(cid:8)(cid:10)(cid:5)(cid:3)(cid:48)(cid:46)(cid:3)(cid:12)(cid:13)(cid:5)(cid:2)(cid:14)(cid:46)(cid:2)(cid:28)(cid:5)(cid:3)(cid:10)(cid:5)(cid:2)(cid:64)(cid:46)(cid:4)(cid:12)(cid:2)(cid:28)(cid:3,Unknown,196.0
Unknown,Unknown,13,Unknown,Unknown,Unknown,Unknown,cid:50)(cid:46)(cid:12)(cid:2)(cid:7)(cid:8)(cid:10)(cid:5)(cid:3)(cid:48)(cid:46)(cid:3)(cid:12)(cid:13)(cid:5)(cid:2)(cid:14)(cid:46)(cid:2)(cid:28)(cid:5)(cid:3)(cid:10)(cid:5)(cid:2)(cid:64)(cid:46)(cid:4)(cid:12)(cid:2)(cid:28)(cid:3,Unknown,209.0
Unknown,Unknown,9,Unknown,Unknown,Unknown,Unknown,cid:50)(cid:46)(cid:12)(cid:2)(cid:7)(cid:8)(cid:10)(cid:5)(cid:3)(cid:48)(cid:46)(cid:3)(cid:12)(cid:13)(cid:5)(cid:2)(cid:14)(cid:46)(cid:2)(cid:28)(cid:5)(cid:3)(cid:10)(cid:5)(cid:2)(cid:64)(cid:46)(cid:4)(cid:12)(cid:2)(cid:28)(cid:3,Unknown,218.0
Unknown,Unknown,10,Unknown,Unknown,Unknown,Unknown,cid:50)(cid:46)(cid:12)(cid:2)(cid:7)(cid:8)(cid:10)(cid:5)(cid:3)(cid:48)(cid:46)(cid:3)(cid:12)(cid:13)(cid:5)(cid:2)(cid:14)(cid:46)(cid:2)(cid:28)(cid:5)(cid:3)(cid:10)(cid:5)(cid:2)(cid:64)(cid:46)(cid:4)(cid:12)(cid:2)(cid:28)(cid:3,Unknown,228.0
Unknown,Unknown,6,Unknown,Unknown,Unknown,Unknown,cid:50)(cid:46)(cid:12)(cid:2)(cid:7)(cid:8)(cid:10)(cid:5)(cid:3)(cid:48)(cid:46)(cid:3)(cid:12)(cid:13)(cid:5)(cid:2)(cid:14)(cid:46)(cid:2)(cid:28)(cid:5)(cid:3)(cid:10)(cid:5)(cid:2)(cid:64)(cid:46)(cid:4)(cid:12)(cid:2)(cid:28)(cid:3,Unknown,234.0
Unknown,Unknown,9,Unknown,Unknown,Unknown,Unknown,cid:50)(cid:46)(cid:12)(cid:2)(cid:7)(cid:8)(cid:10)(cid:5)(cid:3)(cid:48)(cid:46)(cid:3)(cid:12)(cid:13)(cid:5)(cid:2)(cid:14)(cid:46)(cid:2)(cid:28)(cid:5)(cid:3)(cid:10)(cid:5)(cid:2)(cid:64)(cid:46)(cid:4)(cid:12)(cid:2)(cid:28)(cid:3,Unknown,243.0
Unknown,Unknown,11,Unknown,Unknown,Unknown,Unknown,cid:50)(cid:46)(cid:12)(cid:2)(cid:7)(cid:8)(cid:10)(cid:5)(cid:3)(cid:48)(cid:46)(cid:3)(cid:12)(cid:13)(cid:5)(cid:2)(cid:14)(cid:46)(cid:2)(cid:28)(cid:5)(cid:3)(cid:10)(cid:5)(cid:2)(cid:64)(cid:46)(cid:4)(cid:12)(cid:2)(cid:28)(cid:3,Unknown,254.0
Unknown,Unknown,38,Unknown,Unknown,Unknown,Unknown,cid:50)(cid:46)(cid:12)(cid:2)(cid:7)(cid:8)(cid:10)(cid:5)(cid:3)(cid:48)(cid:46)(cid:3)(cid:12)(cid:13)(cid:5)(cid:2)(cid:14)(cid:46)(cid:2)(cid:28)(cid:5)(cid:3)(cid:10)(cid:5)(cid:2)(cid:64)(cid:46)(cid:4)(cid:12)(cid:2)(cid:28)(cid:3,Unknown,292.0
Unknown,Unknown,12,Unknown,Unknown,Unknown,Unknown,cid:50)(cid:46)(cid:12)(cid:2)(cid:7)(cid:8)(cid:10)(cid:5)(cid:3)(cid:48)(cid:46)(cid:3)(cid:12)(cid:13)(cid:5)(cid:2)(cid:14)(cid:46)(cid:2)(cid:28)(cid:5)(cid:3)(cid:10)(cid:5)(cid:2)(cid:64)(cid:46)(cid:4)(cid:12)(cid:2)(cid:28)(cid:3,Unknown,304.0
Unknown,Unknown,31,Unknown,Unknown,Unknown,Unknown,cid:50)(cid:46)(cid:12)(cid:2)(cid:7)(cid:8)(cid:10)(cid:5)(cid:3)(cid:48)(cid:46)(cid:3)(cid:12)(cid:13)(cid:5)(cid:2)(cid:14)(cid:46)(cid:2)(cid:28)(cid:5)(cid:3)(cid:10)(cid:5)(cid:2)(cid:64)(cid:46)(cid:4)(cid:12)(cid:2)(cid:28)(cid:3,Unknown,335.0
Unknown,Unknown,10,Unknown,Unknown,Unknown,Unknown,cid:50)(cid:46)(cid:12)(cid:2)(cid:7)(cid:8)(cid:10)(cid:5)(cid:3)(cid:48)(cid:46)(cid:3)(cid:12)(cid:13)(cid:5)(cid:2)(cid:14)(cid:46)(cid:2)(cid:28)(cid:5)(cid:3)(cid:10)(cid:5)(cid:2)(cid:64)(cid:46)(cid:4)(cid:12)(cid:2)(cid:28)(cid:3,Unknown,345.0
Unknown,Unknown,6,Unknown,Unknown,Unknown,Unknown,cid:50)(cid:46)(cid:12)(cid:2)(cid:7)(cid:8)(cid:10)(cid:5)(cid:3)(cid:48)(cid:46)(cid:3)(cid:12)(cid:13)(cid:5)(cid:2)(cid:14)(cid:46)(cid:2)(cid:28)(cid:5)(cid:3)(cid:10)(cid:5)(cid:2)(cid:64)(cid:46)(cid:4)(cid:12)(cid:2)(cid:28)(cid:3,Unknown,351.0
Unknown,Unknown,14,Unknown,Unknown,Unknown,Unknown,cid:50)(cid:46)(cid:12)(cid:2)(cid:7)(cid:8)(cid:10)(cid:5)(cid:3)(cid:48)(cid:46)(cid:3)(cid:12)(cid:13)(cid:5)(cid:2)(cid:14)(cid:46)(cid:2)(cid:28)(cid:5)(cid:3)(cid:10)(cid:5)(cid:2)(cid:64)(cid:46)(cid:4)(cid:12)(cid:2)(cid:28)(cid:3,Unknown,365.0
Unknown,Unknown,5,Unknown,Unknown,Unknown,Unknown,cid:50)(cid:46)(cid:12)(cid:2)(cid:7)(cid:8)(cid:10)(cid:5)(cid:3)(cid:48)(cid:46)(cid:3)(cid:12)(cid:13)(cid:5)(cid:2)(cid:14)(cid:46)(cid:2)(cid:28)(cid:5)(cid:3)(cid:10)(cid:5)(cid:2)(cid:64)(cid:46)(cid:4)(cid:12)(cid:2)(cid:28)(cid:3,Unknown,370.0
Unknown,Unknown,8,Unknown,Unknown,Unknown,Unknown,cid:50)(cid:46)(cid:12)(cid:2)(cid:7)(cid:8)(cid:10)(cid:5)(cid:3)(cid:48)(cid:46)(cid:3)(cid:12)(cid:13)(cid:5)(cid:2)(cid:14)(cid:46)(cid:2)(cid:28)(cid:5)(cid:3)(cid:10)(cid:5)(cid:2)(cid:64)(cid:46)(cid:4)(cid:12)(cid:2)(cid:28)(cid:3,Unknown,378.0
Unknown,Unknown,12,Unknown,Unknown,Unknown,Unknown,cid:50)(cid:46)(cid:12)(cid:2)(cid:7)(cid:8)(cid:10)(cid:5)(cid:3)(cid:48)(cid:46)(cid:3)(cid:12)(cid:13)(cid:5)(cid:2)(cid:14)(cid:46)(cid:2)(cid:28)(cid:5)(cid:3)(cid:10)(cid:5)(cid:2)(cid:64)(cid:46)(cid:4)(cid:12)(cid:2)(cid:28)(cid:3,Unknown,390.0
Unknown,Unknown,38,Unknown,Unknown,Unknown,Unknown,cid:50)(cid:46)(cid:12)(cid:2)(cid:7)(cid:8)(cid:10)(cid:5)(cid:3)(cid:48)(cid:46)(cid:3)(cid:12)(cid:13)(cid:5)(cid:2)(cid:14)(cid:46)(cid:2)(cid:28)(cid:5)(cid:3)(cid:10)(cid:5)(cid:2)(cid:64)(cid:46)(cid:4)(cid:12)(cid:2)(cid:28)(cid:3,Unknown,428.0
Unknown,Unknown,29,Unknown,Unknown,Unknown,Unknown,cid:50)(cid:46)(cid:12)(cid:2)(cid:7)(cid:8)(cid:10)(cid:5)(cid:3)(cid:48)(cid:46)(cid:3)(cid:12)(cid:13)(cid:5)(cid:2)(cid:14)(cid:46)(cid:2)(cid:28)(cid:5)(cid:3)(cid:10)(cid:5)(cid:2)(cid:64)(cid:46)(cid:4)(cid:12)(cid:2)(cid:28)(cid:3,Unknown,457.0
Unknown,Unknown,13,Unknown,Unknown,Unknown,Unknown,cid:50)(cid:46)(cid:12)(cid:2)(cid:7)(cid:8)(cid:10)(cid:5)(cid:3)(cid:48)(cid:46)(cid:3)(cid:12)(cid:13)(cid:5)(cid:2)(cid:14)(cid:46)(cid:2)(cid:28)(cid:5)(cid:3)(cid:10)(cid:5)(cid:2)(cid:64)(cid:46)(cid:4)(cid:12)(cid:2)(cid:28)(cid:3,Unknown,470.0
Unknown,Unknown,5,Unknown,Unknown,Unknown,Unknown,cid:50)(cid:46)(cid:12)(cid:2)(cid:7)(cid:8)(cid:10)(cid:5)(cid:3)(cid:48)(cid:46)(cid:3)(cid:12)(cid:13)(cid:5)(cid:2)(cid:14)(cid:46)(cid:2)(cid:28)(cid:5)(cid:3)(cid:10)(cid:5)(cid:2)(cid:64)(cid:46)(cid:4)(cid:12)(cid:2)(cid:28)(cid:3,Unknown,475.0
Unknown,Unknown,32,Unknown,Unknown,Unknown,Unknown,cid:50)(cid:46)(cid:12)(cid:2)(cid:7)(cid:8)(cid:10)(cid:5)(cid:3)(cid:48)(cid:46)(cid:3)(cid:12)(cid:13)(cid:5)(cid:2)(cid:14)(cid:46)(cid:2)(cid:28)(cid:5)(cid:3)(cid:10)(cid:5)(cid:2)(cid:64)(cid:46)(cid:4)(cid:12)(cid:2)(cid:28)(cid:3,Unknown,507.0
Unknown,Unknown,12,Unknown,Unknown,Unknown,Unknown,cid:50)(cid:46)(cid:12)(cid:2)(cid:7)(cid:8)(cid:10)(cid:5)(cid:3)(cid:48)(cid:46)(cid:3)(cid:12)(cid:13)(cid:5)(cid:2)(cid:14)(cid:46)(cid:2)(cid:28)(cid:5)(cid:3)(cid:10)(cid:5)(cid:2)(cid:64)(cid:46)(cid:4)(cid:12)(cid:2)(cid:28)(cid:3,Unknown,519.0
Unknown,Unknown,38,Unknown,Unknown,Unknown,Unknown,cid:50)(cid:46)(cid:12)(cid:2)(cid:7)(cid:8)(cid:10)(cid:5)(cid:3)(cid:48)(cid:46)(cid:3)(cid:12)(cid:13)(cid:5)(cid:2)(cid:14)(cid:46)(cid:2)(cid:28)(cid:5)(cid:3)(cid:10)(cid:5)(cid:2)(cid:64)(cid:46)(cid:4)(cid:12)(cid:2)(cid:28)(cid:3,Unknown,557.0
Unknown,Unknown,18,Unknown,Unknown,Unknown,Unknown,cid:50)(cid:46)(cid:12)(cid:2)(cid:7)(cid:8)(cid:10)(cid:5)(cid:3)(cid:48)(cid:46)(cid:3)(cid:12)(cid:13)(cid:5)(cid:2)(cid:14)(cid:46)(cid:2)(cid:28)(cid:5)(cid:3)(cid:10)(cid:5)(cid:2)(cid:64)(cid:46)(cid:4)(cid:12)(cid:2)(cid:28)(cid:3,Unknown,575.0
Unknown,Unknown,1,Unknown,Unknown,Unknown,Unknown,cid:50)(cid:46)(cid:12)(cid:2)(cid:7)(cid:8)(cid:10)(cid:5)(cid:3)(cid:48)(cid:46)(cid:3)(cid:12)(cid:13)(cid:5)(cid:2)(cid:14)(cid:46)(cid:2)(cid:28)(cid:5)(cid:3)(cid:10)(cid:5)(cid:2)(cid:64)(cid:46)(cid:4)(cid:12)(cid:2)(cid:28)(cid:3,Unknown,576.0
Unknown,Unknown,45,Unknown,Unknown,Unknown,Unknown,cid:50)(cid:46)(cid:12)(cid:2)(cid:7)(cid:8)(cid:10)(cid:5)(cid:3)(cid:48)(cid:46)(cid:3)(cid:12)(cid:13)(cid:5)(cid:2)(cid:14)(cid:46)(cid:2)(cid:28)(cid:5)(cid:3)(cid:10)(cid:5)(cid:2)(cid:64)(cid:46)(cid:4)(cid:12)(cid:2)(cid:28)(cid:3,Unknown,621.0
Unknown,Unknown,18,Unknown,Unknown,Unknown,Unknown,cid:50)(cid:46)(cid:12)(cid:2)(cid:7)(cid:8)(cid:10)(cid:5)(cid:3)(cid:48)(cid:46)(cid:3)(cid:12)(cid:13)(cid:5)(cid:2)(cid:14)(cid:46)(cid:2)(cid:28)(cid:5)(cid:3)(cid:10)(cid:5)(cid:2)(cid:64)(cid:46)(cid:4)(cid:12)(cid:2)(cid:28)(cid:3,Unknown,639.0
Unknown,Unknown,16,Unknown,Unknown,Unknown,Unknown,cid:50)(cid:46)(cid:12)(cid:2)(cid:7)(cid:8)(cid:10)(cid:5)(cid:3)(cid:48)(cid:46)(cid:3)(cid:12)(cid:13)(cid:5)(cid:2)(cid:14)(cid:46)(cid:2)(cid:28)(cid:5)(cid:3)(cid:10)(cid:5)(cid:2)(cid:64)(cid:46)(cid:4)(cid:12)(cid:2)(cid:28)(cid:3,Unknown,655.0
Unknown,Unknown,5,Unknown,Unknown,Unknown,Unknown,cid:50)(cid:46)(cid:12)(cid:2)(cid:7)(cid:8)(cid:10)(cid:5)(cid:3)(cid:48)(cid:46)(cid:3)(cid:12)(cid:13)(cid:5)(cid:2)(cid:14)(cid:46)(cid:2)(cid:28)(cid:5)(cid:3)(cid:10)(cid:5)(cid:2)(cid:64)(cid:46)(cid:4)(cid:12)(cid:2)(cid:28)(cid:3,Unknown,660.0
Unknown,Unknown,10,Unknown,Unknown,Unknown,Unknown,cid:50)(cid:46)(cid:12)(cid:2)(cid:7)(cid:8)(cid:10)(cid:5)(cid:3)(cid:48)(cid:46)(cid:3)(cid:12)(cid:13)(cid:5)(cid:2)(cid:14)(cid:46)(cid:2)(cid:28)(cid:5)(cid:3)(cid:10)(cid:5)(cid:2)(cid:64)(cid:46)(cid:4)(cid:12)(cid:2)(cid:28)(cid:3,Unknown,670.0
Unknown,Unknown,46,Unknown,Unknown,Unknown,Unknown,cid:50)(cid:46)(cid:12)(cid:2)(cid:7)(cid:8)(cid:10)(cid:5)(cid:3)(cid:48)(cid:46)(cid:3)(cid:12)(cid:13)(cid:5)(cid:2)(cid:14)(cid:46)(cid:2)(cid:28)(cid:5)(cid:3)(cid:10)(cid:5)(cid:2)(cid:64)(cid:46)(cid:4)(cid:12)(cid:2)(cid:28)(cid:3,Unknown,716.0
Unknown,Unknown,47,Unknown,Unknown,Unknown,Unknown,cid:50)(cid:46)(cid:12)(cid:2)(cid:7)(cid:8)(cid:10)(cid:5)(cid:3)(cid:48)(cid:46)(cid:3)(cid:12)(cid:13)(cid:5)(cid:2)(cid:14)(cid:46)(cid:2)(cid:28)(cid:5)(cid:3)(cid:10)(cid:5)(cid:2)(cid:64)(cid:46)(cid:4)(cid:12)(cid:2)(cid:28)(cid:3,Unknown,763.0
Unknown,Unknown,14,Unknown,Unknown,Unknown,Unknown,cid:50)(cid:46)(cid:12)(cid:2)(cid:7)(cid:8)(cid:10)(cid:5)(cid:3)(cid:48)(cid:46)(cid:3)(cid:12)(cid:13)(cid:5)(cid:2)(cid:14)(cid:46)(cid:2)(cid:28)(cid:5)(cid:3)(cid:10)(cid:5)(cid:2)(cid:64)(cid:46)(cid:4)(cid:12)(cid:2)(cid:28)(cid:3,Unknown,777.0
Unknown,Unknown,7,Unknown,Unknown,Unknown,Unknown,cid:50)(cid:46)(cid:12)(cid:2)(cid:7)(cid:8)(cid:10)(cid:5)(cid:3)(cid:48)(cid:46)(cid:3)(cid:12)(cid:13)(cid:5)(cid:2)(cid:14)(cid:46)(cid:2)(cid:28)(cid:5)(cid:3)(cid:10)(cid:5)(cid:2)(cid:64)(cid:46)(cid:4)(cid:12)(cid:2)(cid:28)(cid:3,Unknown,784.0
Unknown,Unknown,9,Unknown,Unknown,Unknown,Unknown,cid:50)(cid:46)(cid:12)(cid:2)(cid:7)(cid:8)(cid:10)(cid:5)(cid:3)(cid:48)(cid:46)(cid:3)(cid:12)(cid:13)(cid:5)(cid:2)(cid:14)(cid:46)(cid:2)(cid:28)(cid:5)(cid:3)(cid:10)(cid:5)(cid:2)(cid:64)(cid:46)(cid:4)(cid:12)(cid:2)(cid:28)(cid:3,Unknown,793.0
Unknown,Unknown,9,Unknown,Unknown,Unknown,Unknown,cid:50)(cid:46)(cid:12)(cid:2)(cid:7)(cid:8)(cid:10)(cid:5)(cid:3)(cid:48)(cid:46)(cid:3)(cid:12)(cid:13)(cid:5)(cid:2)(cid:14)(cid:46)(cid:2)(cid:28)(cid:5)(cid:3)(cid:10)(cid:5)(cid:2)(cid:64)(cid:46)(cid:4)(cid:12)(cid:2)(cid:28)(cid:3,Unknown,802.0
Unknown,Unknown,5,Unknown,Unknown,Unknown,Unknown,cid:50)(cid:46)(cid:12)(cid:2)(cid:7)(cid:8)(cid:10)(cid:5)(cid:3)(cid:48)(cid:46)(cid:3)(cid:12)(cid:13)(cid:5)(cid:2)(cid:14)(cid:46)(cid:2)(cid:28)(cid:5)(cid:3)(cid:10)(cid:5)(cid:2)(cid:64)(cid:46)(cid:4)(cid:12)(cid:2)(cid:28)(cid:3,Unknown,807.0
Unknown,Unknown,48,Unknown,Unknown,Unknown,Unknown,cid:50)(cid:46)(cid:12)(cid:2)(cid:7)(cid:8)(cid:10)(cid:5)(cid:3)(cid:48)(cid:46)(cid:3)(cid:12)(cid:13)(cid:5)(cid:2)(cid:14)(cid:46)(cid:2)(cid:28)(cid:5)(cid:3)(cid:10)(cid:5)(cid:2)(cid:64)(cid:46)(cid:4)(cid:12)(cid:2)(cid:28)(cid:3,Unknown,855.0
Unknown,Unknown,5,Unknown,Unknown,Unknown,Unknown,cid:50)(cid:46)(cid:12)(cid:2)(cid:7)(cid:8)(cid:10)(cid:5)(cid:3)(cid:48)(cid:46)(cid:3)(cid:12)(cid:13)(cid:5)(cid:2)(cid:14)(cid:46)(cid:2)(cid:28)(cid:5)(cid:3)(cid:10)(cid:5)(cid:2)(cid:64)(cid:46)(cid:4)(cid:12)(cid:2)(cid:28)(cid:3,Unknown,860.0
Unknown,Unknown,8,Unknown,Unknown,Unknown,Unknown,cid:50)(cid:46)(cid:12)(cid:2)(cid:7)(cid:8)(cid:10)(cid:5)(cid:3)(cid:48)(cid:46)(cid:3)(cid:12)(cid:13)(cid:5)(cid:2)(cid:14)(cid:46)(cid:2)(cid:28)(cid:5)(cid:3)(cid:10)(cid:5)(cid:2)(cid:64)(cid:46)(cid:4)(cid:12)(cid:2)(cid:28)(cid:3,Unknown,868.0
Unknown,Unknown,10,Unknown,Unknown,Unknown,Unknown,cid:50)(cid:46)(cid:12)(cid:2)(cid:7)(cid:8)(cid:10)(cid:5)(cid:3)(cid:48)(cid:46)(cid:3)(cid:12)(cid:13)(cid:5)(cid:2)(cid:14)(cid:46)(cid:2)(cid:28)(cid:5)(cid:3)(cid:10)(cid:5)(cid:2)(cid:64)(cid:46)(cid:4)(cid:12)(cid:2)(cid:28)(cid:3,Unknown,878.0
Unknown,Unknown,2,Unknown,Unknown,Unknown,Unknown,cid:50)(cid:46)(cid:12)(cid:2)(cid:7)(cid:8)(cid:10)(cid:5)(cid:3)(cid:48)(cid:46)(cid:3)(cid:12)(cid:13)(cid:5)(cid:2)(cid:14)(cid:46)(cid:2)(cid:28)(cid:5)(cid:3)(cid:10)(cid:5)(cid:2)(cid:64)(cid:46)(cid:4)(cid:12)(cid:2)(cid:28)(cid:3,Unknown,880.0
Unknown,Unknown,10,Unknown,Unknown,Unknown,Unknown,cid:50)(cid:46)(cid:12)(cid:2)(cid:7)(cid:8)(cid:10)(cid:5)(cid:3)(cid:48)(cid:46)(cid:3)(cid:12)(cid:13)(cid:5)(cid:2)(cid:14)(cid:46)(cid:2)(cid:28)(cid:5)(cid:3)(cid:10)(cid:5)(cid:2)(cid:64)(cid:46)(cid:4)(cid:12)(cid:2)(cid:28)(cid:3,Unknown,890.0
Unknown,Unknown,11,Unknown,Unknown,Unknown,Unknown,cid:50)(cid:46)(cid:12)(cid:2)(cid:7)(cid:8)(cid:10)(cid:5)(cid:3)(cid:48)(cid:46)(cid:3)(cid:12)(cid:13)(cid:5)(cid:2)(cid:14)(cid:46)(cid:2)(cid:28)(cid:5)(cid:3)(cid:10)(cid:5)(cid:2)(cid:64)(cid:46)(cid:4)(cid:12)(cid:2)(cid:28)(cid:3,Unknown,901.0
Unknown,Unknown,8,Unknown,Unknown,Unknown,Unknown,cid:50)(cid:46)(cid:12)(cid:2)(cid:7)(cid:8)(cid:10)(cid:5)(cid:3)(cid:48)(cid:46)(cid:3)(cid:12)(cid:13)(cid:5)(cid:2)(cid:14)(cid:46)(cid:2)(cid:28)(cid:5)(cid:3)(cid:10)(cid:5)(cid:2)(cid:64)(cid:46)(cid:4)(cid:12)(cid:2)(cid:28)(cid:3,Unknown,909.0
Unknown,Unknown,49,Unknown,Unknown,Unknown,Unknown,cid:50)(cid:46)(cid:12)(cid:2)(cid:7)(cid:8)(cid:10)(cid:5)(cid:3)(cid:48)(cid:46)(cid:3)(cid:12)(cid:13)(cid:5)(cid:2)(cid:14)(cid:46)(cid:2)(cid:28)(cid:5)(cid:3)(cid:10)(cid:5)(cid:2)(cid:64)(cid:46)(cid:4)(cid:12)(cid:2)(cid:28)(cid:3,Unknown,958.0
Unknown,Unknown,2,Unknown,Unknown,Unknown,Unknown,cid:50)(cid:46)(cid:12)(cid:2)(cid:7)(cid:8)(cid:10)(cid:5)(cid:3)(cid:48)(cid:46)(cid:3)(cid:12)(cid:13)(cid:5)(cid:2)(cid:14)(cid:46)(cid:2)(cid:28)(cid:5)(cid:3)(cid:10)(cid:5)(cid:2)(cid:64)(cid:46)(cid:4)(cid:12)(cid:2)(cid:28)(cid:3,Unknown,960.0
Unknown,Unknown,13,Unknown,Unknown,Unknown,Unknown,cid:50)(cid:46)(cid:12)(cid:2)(cid:7)(cid:8)(cid:10)(cid:5)(cid:3)(cid:48)(cid:46)(cid:3)(cid:12)(cid:13)(cid:5)(cid:2)(cid:14)(cid:46)(cid:2)(cid:28)(cid:5)(cid:3)(cid:10)(cid:5)(cid:2)(cid:64)(cid:46)(cid:4)(cid:12)(cid:2)(cid:28)(cid:3,Unknown,973.0
Unknown,Unknown,5,Unknown,Unknown,Unknown,Unknown,cid:50)(cid:46)(cid:12)(cid:2)(cid:7)(cid:8)(cid:10)(cid:5)(cid:3)(cid:48)(cid:46)(cid:3)(cid:12)(cid:13)(cid:5)(cid:2)(cid:14)(cid:46)(cid:2)(cid:28)(cid:5)(cid:3)(cid:10)(cid:5)(cid:2)(cid:64)(cid:46)(cid:4)(cid:12)(cid:2)(cid:28)(cid:3,Unknown,978.0
Unknown,Unknown,8,Unknown,Unknown,Unknown,Unknown,cid:50)(cid:46)(cid:12)(cid:2)(cid:7)(cid:8)(cid:10)(cid:5)(cid:3)(cid:48)(cid:46)(cid:3)(cid:12)(cid:13)(cid:5)(cid:2)(cid:14)(cid:46)(cid:2)(cid:28)(cid:5)(cid:3)(cid:10)(cid:5)(cid:2)(cid:64)(cid:46)(cid:4)(cid:12)(cid:2)(cid:28)(cid:3,Unknown,986.0
Unknown,Unknown,3,Unknown,Unknown,Unknown,Unknown,cid:50)(cid:46)(cid:12)(cid:2)(cid:7)(cid:8)(cid:10)(cid:5)(cid:3)(cid:48)(cid:46)(cid:3)(cid:12)(cid:13)(cid:5)(cid:2)(cid:14)(cid:46)(cid:2)(cid:28)(cid:5)(cid:3)(cid:10)(cid:5)(cid:2)(cid:64)(cid:46)(cid:4)(cid:12)(cid:2)(cid:28)(cid:3,Unknown,989.0
Unknown,Unknown,49,Unknown,Unknown,Unknown,Unknown,cid:50)(cid:46)(cid:12)(cid:2)(cid:7)(cid:8)(cid:10)(cid:5)(cid:3)(cid:48)(cid:46)(cid:3)(cid:12)(cid:13)(cid:5)(cid:2)(cid:14)(cid:46)(cid:2)(cid:28)(cid:5)(cid:3)(cid:10)(cid:5)(cid:2)(cid:64)(cid:46)(cid:4)(cid:12)(cid:2)(cid:28)(cid:3,Unknown,1038.0
Unknown,Unknown,43,Unknown,Unknown,Unknown,Unknown,cid:50)(cid:46)(cid:12)(cid:2)(cid:7)(cid:8)(cid:10)(cid:5)(cid:3)(cid:48)(cid:46)(cid:3)(cid:12)(cid:13)(cid:5)(cid:2)(cid:14)(cid:46)(cid:2)(cid:28)(cid:5)(cid:3)(cid:10)(cid:5)(cid:2)(cid:64)(cid:46)(cid:4)(cid:12)(cid:2)(cid:28)(cid:3,Unknown,1081.0
Unknown,Unknown,2,Unknown,Unknown,Unknown,Unknown,cid:50)(cid:46)(cid:12)(cid:2)(cid:7)(cid:8)(cid:10)(cid:5)(cid:3)(cid:48)(cid:46)(cid:3)(cid:12)(cid:13)(cid:5)(cid:2)(cid:14)(cid:46)(cid:2)(cid:28)(cid:5)(cid:3)(cid:10)(cid:5)(cid:2)(cid:64)(cid:46)(cid:4)(cid:12)(cid:2)(cid:28)(cid:3,Unknown,1083.0
Unknown,Unknown,37,Unknown,Unknown,Unknown,Unknown,cid:50)(cid:46)(cid:12)(cid:2)(cid:7)(cid:8)(cid:10)(cid:5)(cid:3)(cid:48)(cid:46)(cid:3)(cid:12)(cid:13)(cid:5)(cid:2)(cid:14)(cid:46)(cid:2)(cid:28)(cid:5)(cid:3)(cid:10)(cid:5)(cid:2)(cid:64)(cid:46)(cid:4)(cid:12)(cid:2)(cid:28)(cid:3,Unknown,1120.0
Unknown,Unknown,18,Unknown,Unknown,Unknown,Unknown,cid:50)(cid:46)(cid:12)(cid:2)(cid:7)(cid:8)(cid:10)(cid:5)(cid:3)(cid:48)(cid:46)(cid:3)(cid:12)(cid:13)(cid:5)(cid:2)(cid:14)(cid:46)(cid:2)(cid:28)(cid:5)(cid:3)(cid:10)(cid:5)(cid:2)(cid:64)(cid:46)(cid:4)(cid:12)(cid:2)(cid:28)(cid:3,Unknown,1138.0
Unknown,Unknown,2,Unknown,Unknown,Unknown,Unknown,cid:50)(cid:46)(cid:12)(cid:2)(cid:7)(cid:8)(cid:10)(cid:5)(cid:3)(cid:48)(cid:46)(cid:3)(cid:12)(cid:13)(cid:5)(cid:2)(cid:14)(cid:46)(cid:2)(cid:28)(cid:5)(cid:3)(cid:10)(cid:5)(cid:2)(cid:64)(cid:46)(cid:4)(cid:12)(cid:2)(cid:28)(cid:3,Unknown,1140.0
Unknown,Unknown,18,Unknown,Unknown,Unknown,Unknown,cid:50)(cid:46)(cid:12)(cid:2)(cid:7)(cid:8)(cid:10)(cid:5)(cid:3)(cid:48)(cid:46)(cid:3)(cid:12)(cid:13)(cid:5)(cid:2)(cid:14)(cid:46)(cid:2)(cid:28)(cid:5)(cid:3)(cid:10)(cid:5)(cid:2)(cid:64)(cid:46)(cid:4)(cid:12)(cid:2)(cid:28)(cid:3,Unknown,1158.0
Unknown,Unknown,18,Unknown,Unknown,Unknown,Unknown,cid:50)(cid:46)(cid:12)(cid:2)(cid:7)(cid:8)(cid:10)(cid:5)(cid:3)(cid:48)(cid:46)(cid:3)(cid:12)(cid:13)(cid:5)(cid:2)(cid:14)(cid:46)(cid:2)(cid:28)(cid:5)(cid:3)(cid:10)(cid:5)(cid:2)(cid:64)(cid:46)(cid:4)(cid:12)(cid:2)(cid:28)(cid:3,Unknown,1176.0
Unknown,Unknown,18,Unknown,Unknown,Unknown,Unknown,cid:50)(cid:46)(cid:12)(cid:2)(cid:7)(cid:8)(cid:10)(cid:5)(cid:3)(cid:48)(cid:46)(cid:3)(cid:12)(cid:13)(cid:5)(cid:2)(cid:14)(cid:46)(cid:2)(cid:28)(cid:5)(cid:3)(cid:10)(cid:5)(cid:2)(cid:64)(cid:46)(cid:4)(cid:12)(cid:2)(cid:28)(cid:3,Unknown,1194.0
Unknown,Unknown,19,Unknown,Unknown,Unknown,Unknown,cid:50)(cid:46)(cid:12)(cid:2)(cid:7)(cid:8)(cid:10)(cid:5)(cid:3)(cid:48)(cid:46)(cid:3)(cid:12)(cid:13)(cid:5)(cid:2)(cid:14)(cid:46)(cid:2)(cid:28)(cid:5)(cid:3)(cid:10)(cid:5)(cid:2)(cid:64)(cid:46)(cid:4)(cid:12)(cid:2)(cid:28)(cid:3,Unknown,1213.0
Unknown,Unknown,18,Unknown,Unknown,Unknown,Unknown,cid:50)(cid:46)(cid:12)(cid:2)(cid:7)(cid:8)(cid:10)(cid:5)(cid:3)(cid:48)(cid:46)(cid:3)(cid:12)(cid:13)(cid:5)(cid:2)(cid:14)(cid:46)(cid:2)(cid:28)(cid:5)(cid:3)(cid:10)(cid:5)(cid:2)(cid:64)(cid:46)(cid:4)(cid:12)(cid:2)(cid:28)(cid:3,Unknown,1231.0
Unknown,Unknown,18,Unknown,Unknown,Unknown,Unknown,cid:50)(cid:46)(cid:12)(cid:2)(cid:7)(cid:8)(cid:10)(cid:5)(cid:3)(cid:48)(cid:46)(cid:3)(cid:12)(cid:13)(cid:5)(cid:2)(cid:14)(cid:46)(cid:2)(cid:28)(cid:5)(cid:3)(cid:10)(cid:5)(cid:2)(cid:64)(cid:46)(cid:4)(cid:12)(cid:2)(cid:28)(cid:3,Unknown,1249.0
Unknown,Unknown,2,Unknown,Unknown,Unknown,Unknown,cid:50)(cid:46)(cid:12)(cid:2)(cid:7)(cid:8)(cid:10)(cid:5)(cid:3)(cid:48)(cid:46)(cid:3)(cid:12)(cid:13)(cid:5)(cid:2)(cid:14)(cid:46)(cid:2)(cid:28)(cid:5)(cid:3)(cid:10)(cid:5)(cid:2)(cid:64)(cid:46)(cid:4)(cid:12)(cid:2)(cid:28)(cid:3,Unknown,1251.0
Unknown,Unknown,44,Unknown,Unknown,Unknown,Unknown,cid:50)(cid:46)(cid:12)(cid:2)(cid:7)(cid:8)(cid:10)(cid:5)(cid:3)(cid:48)(cid:46)(cid:3)(cid:12)(cid:13)(cid:5)(cid:2)(cid:14)(cid:46)(cid:2)(cid:28)(cid:5)(cid:3)(cid:10)(cid:5)(cid:2)(cid:64)(cid:46)(cid:4)(cid:12)(cid:2)(cid:28)(cid:3,Unknown,1295.0
Unknown,Unknown,50,Unknown,Unknown,Unknown,Unknown,cid:50)(cid:46)(cid:12)(cid:2)(cid:7)(cid:8)(cid:10)(cid:5)(cid:3)(cid:48)(cid:46)(cid:3)(cid:12)(cid:13)(cid:5)(cid:2)(cid:14)(cid:46)(cid:2)(cid:28)(cid:5)(cid:3)(cid:10)(cid:5)(cid:2)(cid:64)(cid:46)(cid:4)(cid:12)(cid:2)(cid:28)(cid:3,Unknown,1345.0
Unknown,Unknown,42,Unknown,Unknown,Unknown,Unknown,cid:50)(cid:46)(cid:12)(cid:2)(cid:7)(cid:8)(cid:10)(cid:5)(cid:3)(cid:48)(cid:46)(cid:3)(cid:12)(cid:13)(cid:5)(cid:2)(cid:14)(cid:46)(cid:2)(cid:28)(cid:5)(cid:3)(cid:10)(cid:5)(cid:2)(cid:64)(cid:46)(cid:4)(cid:12)(cid:2)(cid:28)(cid:3,Unknown,1387.0
Unknown,Unknown,51,Unknown,Unknown,Unknown,Unknown,cid:50)(cid:46)(cid:12)(cid:2)(cid:7)(cid:8)(cid:10)(cid:5)(cid:3)(cid:48)(cid:46)(cid:3)(cid:12)(cid:13)(cid:5)(cid:2)(cid:14)(cid:46)(cid:2)(cid:28)(cid:5)(cid:3)(cid:10)(cid:5)(cid:2)(cid:64)(cid:46)(cid:4)(cid:12)(cid:2)(cid:28)(cid:3,Unknown,1438.0
Unknown,Unknown,52,Unknown,Unknown,Unknown,Unknown,cid:50)(cid:46)(cid:12)(cid:2)(cid:7)(cid:8)(cid:10)(cid:5)(cid:3)(cid:48)(cid:46)(cid:3)(cid:12)(cid:13)(cid:5)(cid:2)(cid:14)(cid:46)(cid:2)(cid:28)(cid:5)(cid:3)(cid:10)(cid:5)(cid:2)(cid:64)(cid:46)(cid:4)(cid:12)(cid:2)(cid:28)(cid:3,Unknown,1490.0
Unknown,Unknown,41,Unknown,Unknown,Unknown,Unknown,cid:50)(cid:46)(cid:12)(cid:2)(cid:7)(cid:8)(cid:10)(cid:5)(cid:3)(cid:48)(cid:46)(cid:3)(cid:12)(cid:13)(cid:5)(cid:2)(cid:14)(cid:46)(cid:2)(cid:28)(cid:5)(cid:3)(cid:10)(cid:5)(cid:2)(cid:64)(cid:46)(cid:4)(cid:12)(cid:2)(cid:28)(cid:3,Unknown,1531.0
Unknown,Unknown,2,Unknown,Unknown,Unknown,Unknown,cid:50)(cid:46)(cid:12)(cid:2)(cid:7)(cid:8)(cid:10)(cid:5)(cid:3)(cid:48)(cid:46)(cid:3)(cid:12)(cid:13)(cid:5)(cid:2)(cid:14)(cid:46)(cid:2)(cid:28)(cid:5)(cid:3)(cid:10)(cid:5)(cid:2)(cid:64)(cid:46)(cid:4)(cid:12)(cid:2)(cid:28)(cid:3,Unknown,1533.0
Unknown,Unknown,53,Unknown,Unknown,Unknown,Unknown,cid:50)(cid:46)(cid:12)(cid:2)(cid:7)(cid:8)(cid:10)(cid:5)(cid:3)(cid:48)(cid:46)(cid:3)(cid:12)(cid:13)(cid:5)(cid:2)(cid:14)(cid:46)(cid:2)(cid:28)(cid:5)(cid:3)(cid:10)(cid:5)(cid:2)(cid:64)(cid:46)(cid:4)(cid:12)(cid:2)(cid:28)(cid:3,Unknown,1586.0
Unknown,Unknown,25,Unknown,Unknown,Unknown,Unknown,cid:50)(cid:46)(cid:12)(cid:2)(cid:7)(cid:8)(cid:10)(cid:5)(cid:3)(cid:48)(cid:46)(cid:3)(cid:12)(cid:13)(cid:5)(cid:2)(cid:14)(cid:46)(cid:2)(cid:28)(cid:5)(cid:3)(cid:10)(cid:5)(cid:2)(cid:64)(cid:46)(cid:4)(cid:12)(cid:2)(cid:28)(cid:3,Unknown,1611.0
Unknown,Unknown,2,Unknown,Unknown,Unknown,Unknown,cid:50)(cid:46)(cid:12)(cid:2)(cid:7)(cid:8)(cid:10)(cid:5)(cid:3)(cid:48)(cid:46)(cid:3)(cid:12)(cid:13)(cid:5)(cid:2)(cid:14)(cid:46)(cid:2)(cid:28)(cid:5)(cid:3)(cid:10)(cid:5)(cid:2)(cid:64)(cid:46)(cid:4)(cid:12)(cid:2)(cid:28)(cid:3,Unknown,1613.0
Unknown,Unknown,31,Unknown,Unknown,Unknown,Unknown,cid:50)(cid:46)(cid:12)(cid:2)(cid:7)(cid:8)(cid:10)(cid:5)(cid:3)(cid:48)(cid:46)(cid:3)(cid:12)(cid:13)(cid:5)(cid:2)(cid:14)(cid:46)(cid:2)(cid:28)(cid:5)(cid:3)(cid:10)(cid:5)(cid:2)(cid:64)(cid:46)(cid:4)(cid:12)(cid:2)(cid:28)(cid:3,Unknown,1644.0
Unknown,Unknown,54,Unknown,Unknown,Unknown,Unknown,cid:50)(cid:46)(cid:12)(cid:2)(cid:7)(cid:8)(cid:10)(cid:5)(cid:3)(cid:48)(cid:46)(cid:3)(cid:12)(cid:13)(cid:5)(cid:2)(cid:14)(cid:46)(cid:2)(cid:28)(cid:5)(cid:3)(cid:10)(cid:5)(cid:2)(cid:64)(cid:46)(cid:4)(cid:12)(cid:2)(cid:28)(cid:3,Unknown,1698.0
Unknown,Unknown,55,Unknown,Unknown,Unknown,Unknown,cid:50)(cid:46)(cid:12)(cid:2)(cid:7)(cid:8)(cid:10)(cid:5)(cid:3)(cid:48)(cid:46)(cid:3)(cid:12)(cid:13)(cid:5)(cid:2)(cid:14)(cid:46)(cid:2)(cid:28)(cid:5)(cid:3)(cid:10)(cid:5)(cid:2)(cid:64)(cid:46)(cid:4)(cid:12)(cid:2)(cid:28)(cid:3,Unknown,1753.0
Unknown,Unknown,56,Unknown,Unknown,Unknown,Unknown,cid:50)(cid:46)(cid:12)(cid:2)(cid:7)(cid:8)(cid:10)(cid:5)(cid:3)(cid:48)(cid:46)(cid:3)(cid:12)(cid:13)(cid:5)(cid:2)(cid:14)(cid:46)(cid:2)(cid:28)(cid:5)(cid:3)(cid:10)(cid:5)(cid:2)(cid:64)(cid:46)(cid:4)(cid:12)(cid:2)(cid:28)(cid:3,Unknown,1809.0
Unknown,Unknown,21,Unknown,Unknown,Unknown,Unknown,cid:50)(cid:46)(cid:12)(cid:2)(cid:7)(cid:8)(cid:10)(cid:5)(cid:3)(cid:48)(cid:46)(cid:3)(cid:12)(cid:13)(cid:5)(cid:2)(cid:14)(cid:46)(cid:2)(cid:28)(cid:5)(cid:3)(cid:10)(cid:5)(cid:2)(cid:64)(cid:46)(cid:4)(cid:12)(cid:2)(cid:28)(cid:3,Unknown,1830.0
Unknown,Unknown,25,Unknown,Unknown,Unknown,Unknown,cid:50)(cid:46)(cid:12)(cid:2)(cid:7)(cid:8)(cid:10)(cid:5)(cid:3)(cid:48)(cid:46)(cid:3)(cid:12)(cid:13)(cid:5)(cid:2)(cid:14)(cid:46)(cid:2)(cid:28)(cid:5)(cid:3)(cid:10)(cid:5)(cid:2)(cid:64)(cid:46)(cid:4)(cid:12)(cid:2)(cid:28)(cid:3,Unknown,1855.0
Unknown,Unknown,18,Unknown,Unknown,Unknown,Unknown,cid:50)(cid:46)(cid:12)(cid:2)(cid:7)(cid:8)(cid:10)(cid:5)(cid:3)(cid:48)(cid:46)(cid:3)(cid:12)(cid:13)(cid:5)(cid:2)(cid:14)(cid:46)(cid:2)(cid:28)(cid:5)(cid:3)(cid:10)(cid:5)(cid:2)(cid:64)(cid:46)(cid:4)(cid:12)(cid:2)(cid:28)(cid:3,Unknown,1873.0
Unknown,Unknown,1,Unknown,Unknown,Unknown,Unknown,cid:50)(cid:46)(cid:12)(cid:2)(cid:7)(cid:8)(cid:10)(cid:5)(cid:3)(cid:48)(cid:46)(cid:3)(cid:12)(cid:13)(cid:5)(cid:2)(cid:14)(cid:46)(cid:2)(cid:28)(cid:5)(cid:3)(cid:10)(cid:5)(cid:2)(cid:64)(cid:46)(cid:4)(cid:12)(cid:2)(cid:28)(cid:3,Unknown,1874.0
Unknown,Unknown,45,Unknown,Unknown,Unknown,Unknown,cid:50)(cid:46)(cid:12)(cid:2)(cid:7)(cid:8)(cid:10)(cid:5)(cid:3)(cid:48)(cid:46)(cid:3)(cid:12)(cid:13)(cid:5)(cid:2)(cid:14)(cid:46)(cid:2)(cid:28)(cid:5)(cid:3)(cid:10)(cid:5)(cid:2)(cid:64)(cid:46)(cid:4)(cid:12)(cid:2)(cid:28)(cid:3,Unknown,1919.0
Unknown,Unknown,18,Unknown,Unknown,Unknown,Unknown,cid:50)(cid:46)(cid:12)(cid:2)(cid:7)(cid:8)(cid:10)(cid:5)(cid:3)(cid:48)(cid:46)(cid:3)(cid:12)(cid:13)(cid:5)(cid:2)(cid:14)(cid:46)(cid:2)(cid:28)(cid:5)(cid:3)(cid:10)(cid:5)(cid:2)(cid:64)(cid:46)(cid:4)(cid:12)(cid:2)(cid:28)(cid:3,Unknown,1937.0
Unknown,Unknown,16,Unknown,Unknown,Unknown,Unknown,cid:50)(cid:46)(cid:12)(cid:2)(cid:7)(cid:8)(cid:10)(cid:5)(cid:3)(cid:48)(cid:46)(cid:3)(cid:12)(cid:13)(cid:5)(cid:2)(cid:14)(cid:46)(cid:2)(cid:28)(cid:5)(cid:3)(cid:10)(cid:5)(cid:2)(cid:64)(cid:46)(cid:4)(cid:12)(cid:2)(cid:28)(cid:3,Unknown,1953.0
Unknown,Unknown,38,Unknown,Unknown,Unknown,Unknown,cid:50)(cid:46)(cid:12)(cid:2)(cid:7)(cid:8)(cid:10)(cid:5)(cid:3)(cid:48)(cid:46)(cid:3)(cid:12)(cid:13)(cid:5)(cid:2)(cid:14)(cid:46)(cid:2)(cid:28)(cid:5)(cid:3)(cid:10)(cid:5)(cid:2)(cid:64)(cid:46)(cid:4)(cid:12)(cid:2)(cid:28)(cid:3,Unknown,1991.0
Unknown,Unknown,20,Unknown,Unknown,Unknown,Unknown,cid:50)(cid:46)(cid:12)(cid:2)(cid:7)(cid:8)(cid:10)(cid:5)(cid:3)(cid:48)(cid:46)(cid:3)(cid:12)(cid:13)(cid:5)(cid:2)(cid:14)(cid:46)(cid:2)(cid:28)(cid:5)(cid:3)(cid:10)(cid:5)(cid:2)(cid:64)(cid:46)(cid:4)(cid:12)(cid:2)(cid:28)(cid:3,Unknown,2011.0
Unknown,Unknown,30,Unknown,Unknown,Unknown,Unknown,cid:50)(cid:46)(cid:12)(cid:2)(cid:7)(cid:8)(cid:10)(cid:5)(cid:3)(cid:48)(cid:46)(cid:3)(cid:12)(cid:13)(cid:5)(cid:2)(cid:14)(cid:46)(cid:2)(cid:28)(cid:5)(cid:3)(cid:10)(cid:5)(cid:2)(cid:64)(cid:46)(cid:4)(cid:12)(cid:2)(cid:28)(cid:3,Unknown,2041.0
Unknown,Unknown,41,Unknown,Unknown,Unknown,Unknown,cid:50)(cid:46)(cid:12)(cid:2)(cid:7)(cid:8)(cid:10)(cid:5)(cid:3)(cid:48)(cid:46)(cid:3)(cid:12)(cid:13)(cid:5)(cid:2)(cid:14)(cid:46)(cid:2)(cid:28)(cid:5)(cid:3)(cid:10)(cid:5)(cid:2)(cid:64)(cid:46)(cid:4)(cid:12)(cid:2)(cid:28)(cid:3,Unknown,2082.0
Unknown,Unknown,20,Unknown,Unknown,Unknown,Unknown,cid:50)(cid:46)(cid:12)(cid:2)(cid:7)(cid:8)(cid:10)(cid:5)(cid:3)(cid:48)(cid:46)(cid:3)(cid:12)(cid:13)(cid:5)(cid:2)(cid:14)(cid:46)(cid:2)(cid:28)(cid:5)(cid:3)(cid:10)(cid:5)(cid:2)(cid:64)(cid:46)(cid:4)(cid:12)(cid:2)(cid:28)(cid:3,Unknown,2102.0
Unknown,Unknown,15,Unknown,Unknown,Unknown,Unknown,cid:50)(cid:46)(cid:12)(cid:2)(cid:7)(cid:8)(cid:10)(cid:5)(cid:3)(cid:48)(cid:46)(cid:3)(cid:12)(cid:13)(cid:5)(cid:2)(cid:14)(cid:46)(cid:2)(cid:28)(cid:5)(cid:3)(cid:10)(cid:5)(cid:2)(cid:64)(cid:46)(cid:4)(cid:12)(cid:2)(cid:28)(cid:3,Unknown,2117.0
Unknown,Unknown,2,Unknown,Unknown,Unknown,Unknown,cid:50)(cid:46)(cid:12)(cid:2)(cid:7)(cid:8)(cid:10)(cid:5)(cid:3)(cid:48)(cid:46)(cid:3)(cid:12)(cid:13)(cid:5)(cid:2)(cid:14)(cid:46)(cid:2)(cid:28)(cid:5)(cid:3)(cid:10)(cid:5)(cid:2)(cid:64)(cid:46)(cid:4)(cid:12)(cid:2)(cid:28)(cid:3,Unknown,2119.0
Unknown,Unknown,36,Unknown,Unknown,Unknown,Unknown,cid:50)(cid:46)(cid:12)(cid:2)(cid:7)(cid:8)(cid:10)(cid:5)(cid:3)(cid:48)(cid:46)(cid:3)(cid:12)(cid:13)(cid:5)(cid:2)(cid:14)(cid:46)(cid:2)(cid:28)(cid:5)(cid:3)(cid:10)(cid:5)(cid:2)(cid:64)(cid:46)(cid:4)(cid:12)(cid:2)(cid:28)(cid:3,Unknown,2155.0
Unknown,Unknown,1,Unknown,Unknown,Unknown,Unknown,cid:50)(cid:46)(cid:12)(cid:2)(cid:7)(cid:8)(cid:10)(cid:5)(cid:3)(cid:48)(cid:46)(cid:3)(cid:12)(cid:13)(cid:5)(cid:2)(cid:14)(cid:46)(cid:2)(cid:28)(cid:5)(cid:3)(cid:10)(cid:5)(cid:2)(cid:64)(cid:46)(cid:4)(cid:12)(cid:2)(cid:28)(cid:3,Unknown,2156.0
Unknown,Unknown,19,Unknown,Unknown,Unknown,Unknown,cid:50)(cid:46)(cid:12)(cid:2)(cid:7)(cid:8)(cid:10)(cid:5)(cid:3)(cid:48)(cid:46)(cid:3)(cid:12)(cid:13)(cid:5)(cid:2)(cid:14)(cid:46)(cid:2)(cid:28)(cid:5)(cid:3)(cid:10)(cid:5)(cid:2)(cid:64)(cid:46)(cid:4)(cid:12)(cid:2)(cid:28)(cid:3,Unknown,2175.0
Unknown,Unknown,18,Unknown,Unknown,Unknown,Unknown,cid:50)(cid:46)(cid:12)(cid:2)(cid:7)(cid:8)(cid:10)(cid:5)(cid:3)(cid:48)(cid:46)(cid:3)(cid:12)(cid:13)(cid:5)(cid:2)(cid:14)(cid:46)(cid:2)(cid:28)(cid:5)(cid:3)(cid:10)(cid:5)(cid:2)(cid:64)(cid:46)(cid:4)(cid:12)(cid:2)(cid:28)(cid:3,Unknown,2193.0
Unknown,Unknown,18,Unknown,Unknown,Unknown,Unknown,cid:50)(cid:46)(cid:12)(cid:2)(cid:7)(cid:8)(cid:10)(cid:5)(cid:3)(cid:48)(cid:46)(cid:3)(cid:12)(cid:13)(cid:5)(cid:2)(cid:14)(cid:46)(cid:2)(cid:28)(cid:5)(cid:3)(cid:10)(cid:5)(cid:2)(cid:64)(cid:46)(cid:4)(cid:12)(cid:2)(cid:28)(cid:3,Unknown,2211.0
Unknown,Unknown,2,Unknown,Unknown,Unknown,Unknown,cid:50)(cid:46)(cid:12)(cid:2)(cid:7)(cid:8)(cid:10)(cid:5)(cid:3)(cid:48)(cid:46)(cid:3)(cid:12)(cid:13)(cid:5)(cid:2)(cid:14)(cid:46)(cid:2)(cid:28)(cid:5)(cid:3)(cid:10)(cid:5)(cid:2)(cid:64)(cid:46)(cid:4)(cid:12)(cid:2)(cid:28)(cid:3,Unknown,2213.0
Unknown,Unknown,44,Unknown,Unknown,Unknown,Unknown,cid:50)(cid:46)(cid:12)(cid:2)(cid:7)(cid:8)(cid:10)(cid:5)(cid:3)(cid:48)(cid:46)(cid:3)(cid:12)(cid:13)(cid:5)(cid:2)(cid:14)(cid:46)(cid:2)(cid:28)(cid:5)(cid:3)(cid:10)(cid:5)(cid:2)(cid:64)(cid:46)(cid:4)(cid:12)(cid:2)(cid:28)(cid:3,Unknown,2257.0
Unknown,Unknown,46,Unknown,Unknown,Unknown,Unknown,cid:50)(cid:46)(cid:12)(cid:2)(cid:7)(cid:8)(cid:10)(cid:5)(cid:3)(cid:48)(cid:46)(cid:3)(cid:12)(cid:13)(cid:5)(cid:2)(cid:14)(cid:46)(cid:2)(cid:28)(cid:5)(cid:3)(cid:10)(cid:5)(cid:2)(cid:64)(cid:46)(cid:4)(cid:12)(cid:2)(cid:28)(cid:3,Unknown,2303.0
Unknown,Unknown,57,Unknown,Unknown,Unknown,Unknown,cid:50)(cid:46)(cid:12)(cid:2)(cid:7)(cid:8)(cid:10)(cid:5)(cid:3)(cid:48)(cid:46)(cid:3)(cid:12)(cid:13)(cid:5)(cid:2)(cid:14)(cid:46)(cid:2)(cid:28)(cid:5)(cid:3)(cid:10)(cid:5)(cid:2)(cid:64)(cid:46)(cid:4)(cid:12)(cid:2)(cid:28)(cid:3,Unknown,2360.0
Unknown,Unknown,20,Unknown,Unknown,Unknown,Unknown,cid:50)(cid:46)(cid:12)(cid:2)(cid:7)(cid:8)(cid:10)(cid:5)(cid:3)(cid:48)(cid:46)(cid:3)(cid:12)(cid:13)(cid:5)(cid:2)(cid:14)(cid:46)(cid:2)(cid:28)(cid:5)(cid:3)(cid:10)(cid:5)(cid:2)(cid:64)(cid:46)(cid:4)(cid:12)(cid:2)(cid:28)(cid:3,Unknown,2380.0
Unknown,Unknown,30,Unknown,Unknown,Unknown,Unknown,cid:50)(cid:46)(cid:12)(cid:2)(cid:7)(cid:8)(cid:10)(cid:5)(cid:3)(cid:48)(cid:46)(cid:3)(cid:12)(cid:13)(cid:5)(cid:2)(cid:14)(cid:46)(cid:2)(cid:28)(cid:5)(cid:3)(cid:10)(cid:5)(cid:2)(cid:64)(cid:46)(cid:4)(cid:12)(cid:2)(cid:28)(cid:3,Unknown,2410.0
Unknown,Unknown,30,Unknown,Unknown,Unknown,Unknown,cid:50)(cid:46)(cid:12)(cid:2)(cid:7)(cid:8)(cid:10)(cid:5)(cid:3)(cid:48)(cid:46)(cid:3)(cid:12)(cid:13)(cid:5)(cid:2)(cid:14)(cid:46)(cid:2)(cid:28)(cid:5)(cid:3)(cid:10)(cid:5)(cid:2)(cid:64)(cid:46)(cid:4)(cid:12)(cid:2)(cid:28)(cid:3,Unknown,2440.0
Unknown,Unknown,25,Unknown,Unknown,Unknown,Unknown,cid:50)(cid:46)(cid:12)(cid:2)(cid:7)(cid:8)(cid:10)(cid:5)(cid:3)(cid:48)(cid:46)(cid:3)(cid:12)(cid:13)(cid:5)(cid:2)(cid:14)(cid:46)(cid:2)(cid:28)(cid:5)(cid:3)(cid:10)(cid:5)(cid:2)(cid:64)(cid:46)(cid:4)(cid:12)(cid:2)(cid:28)(cid:3,Unknown,2465.0
Unknown,Unknown,23,Unknown,Unknown,Unknown,Unknown,cid:50)(cid:46)(cid:12)(cid:2)(cid:7)(cid:8)(cid:10)(cid:5)(cid:3)(cid:48)(cid:46)(cid:3)(cid:12)(cid:13)(cid:5)(cid:2)(cid:14)(cid:46)(cid:2)(cid:28)(cid:5)(cid:3)(cid:10)(cid:5)(cid:2)(cid:64)(cid:46)(cid:4)(cid:12)(cid:2)(cid:28)(cid:3,Unknown,2488.0
Unknown,Unknown,25,Unknown,Unknown,Unknown,Unknown,cid:50)(cid:46)(cid:12)(cid:2)(cid:7)(cid:8)(cid:10)(cid:5)(cid:3)(cid:48)(cid:46)(cid:3)(cid:12)(cid:13)(cid:5)(cid:2)(cid:14)(cid:46)(cid:2)(cid:28)(cid:5)(cid:3)(cid:10)(cid:5)(cid:2)(cid:64)(cid:46)(cid:4)(cid:12)(cid:2)(cid:28)(cid:3,Unknown,2513.0
Unknown,Unknown,30,Unknown,Unknown,Unknown,Unknown,cid:50)(cid:46)(cid:12)(cid:2)(cid:7)(cid:8)(cid:10)(cid:5)(cid:3)(cid:48)(cid:46)(cid:3)(cid:12)(cid:13)(cid:5)(cid:2)(cid:14)(cid:46)(cid:2)(cid:28)(cid:5)(cid:3)(cid:10)(cid:5)(cid:2)(cid:64)(cid:46)(cid:4)(cid:12)(cid:2)(cid:28)(cid:3,Unknown,2543.0
Unknown,Unknown,41,Unknown,Unknown,Unknown,Unknown,cid:50)(cid:46)(cid:12)(cid:2)(cid:7)(cid:8)(cid:10)(cid:5)(cid:3)(cid:48)(cid:46)(cid:3)(cid:12)(cid:13)(cid:5)(cid:2)(cid:14)(cid:46)(cid:2)(cid:28)(cid:5)(cid:3)(cid:10)(cid:5)(cid:2)(cid:64)(cid:46)(cid:4)(cid:12)(cid:2)(cid:28)(cid:3,Unknown,2584.0
Unknown,Unknown,2,Unknown,Unknown,Unknown,Unknown,cid:50)(cid:46)(cid:12)(cid:2)(cid:7)(cid:8)(cid:10)(cid:5)(cid:3)(cid:48)(cid:46)(cid:3)(cid:12)(cid:13)(cid:5)(cid:2)(cid:14)(cid:46)(cid:2)(cid:28)(cid:5)(cid:3)(cid:10)(cid:5)(cid:2)(cid:64)(cid:46)(cid:4)(cid:12)(cid:2)(cid:28)(cid:3,Unknown,2586.0
Unknown,Unknown,45,Unknown,Unknown,Unknown,Unknown,cid:50)(cid:46)(cid:12)(cid:2)(cid:7)(cid:8)(cid:10)(cid:5)(cid:3)(cid:48)(cid:46)(cid:3)(cid:12)(cid:13)(cid:5)(cid:2)(cid:14)(cid:46)(cid:2)(cid:28)(cid:5)(cid:3)(cid:10)(cid:5)(cid:2)(cid:64)(cid:46)(cid:4)(cid:12)(cid:2)(cid:28)(cid:3,Unknown,2631.0
Unknown,Unknown,2,Unknown,Unknown,Unknown,Unknown,cid:50)(cid:46)(cid:12)(cid:2)(cid:7)(cid:8)(cid:10)(cid:5)(cid:3)(cid:48)(cid:46)(cid:3)(cid:12)(cid:13)(cid:5)(cid:2)(cid:14)(cid:46)(cid:2)(cid:28)(cid:5)(cid:3)(cid:10)(cid:5)(cid:2)(cid:64)(cid:46)(cid:4)(cid:12)(cid:2)(cid:28)(cid:3,Unknown,2633.0
Unknown,Unknown,28,Unknown,Unknown,Unknown,Unknown,cid:50)(cid:46)(cid:12)(cid:2)(cid:7)(cid:8)(cid:10)(cid:5)(cid:3)(cid:48)(cid:46)(cid:3)(cid:12)(cid:13)(cid:5)(cid:2)(cid:14)(cid:46)(cid:2)(cid:28)(cid:5)(cid:3)(cid:10)(cid:5)(cid:2)(cid:64)(cid:46)(cid:4)(cid:12)(cid:2)(cid:28)(cid:3,Unknown,2661.0
Unknown,Unknown,26,Unknown,Unknown,Unknown,Unknown,cid:50)(cid:46)(cid:12)(cid:2)(cid:7)(cid:8)(cid:10)(cid:5)(cid:3)(cid:48)(cid:46)(cid:3)(cid:12)(cid:13)(cid:5)(cid:2)(cid:14)(cid:46)(cid:2)(cid:28)(cid:5)(cid:3)(cid:10)(cid:5)(cid:2)(cid:64)(cid:46)(cid:4)(cid:12)(cid:2)(cid:28)(cid:3,Unknown,2687.0
Unknown,Unknown,29,Unknown,Unknown,Unknown,Unknown,cid:50)(cid:46)(cid:12)(cid:2)(cid:7)(cid:8)(cid:10)(cid:5)(cid:3)(cid:48)(cid:46)(cid:3)(cid:12)(cid:13)(cid:5)(cid:2)(cid:14)(cid:46)(cid:2)(cid:28)(cid:5)(cid:3)(cid:10)(cid:5)(cid:2)(cid:64)(cid:46)(cid:4)(cid:12)(cid:2)(cid:28)(cid:3,Unknown,2716.0
Unknown,Unknown,24,Unknown,Unknown,Unknown,Unknown,cid:50)(cid:46)(cid:12)(cid:2)(cid:7)(cid:8)(cid:10)(cid:5)(cid:3)(cid:48)(cid:46)(cid:3)(cid:12)(cid:13)(cid:5)(cid:2)(cid:14)(cid:46)(cid:2)(cid:28)(cid:5)(cid:3)(cid:10)(cid:5)(cid:2)(cid:64)(cid:46)(cid:4)(cid:12)(cid:2)(cid:28)(cid:3,Unknown,2740.0
Unknown,Unknown,27,Unknown,Unknown,Unknown,Unknown,cid:50)(cid:46)(cid:12)(cid:2)(cid:7)(cid:8)(cid:10)(cid:5)(cid:3)(cid:48)(cid:46)(cid:3)(cid:12)(cid:13)(cid:5)(cid:2)(cid:14)(cid:46)(cid:2)(cid:28)(cid:5)(cid:3)(cid:10)(cid:5)(cid:2)(cid:64)(cid:46)(cid:4)(cid:12)(cid:2)(cid:28)(cid:3,Unknown,2767.0
Unknown,Unknown,2,Unknown,Unknown,Unknown,Unknown,cid:50)(cid:46)(cid:12)(cid:2)(cid:7)(cid:8)(cid:10)(cid:5)(cid:3)(cid:48)(cid:46)(cid:3)(cid:12)(cid:13)(cid:5)(cid:2)(cid:14)(cid:46)(cid:2)(cid:28)(cid:5)(cid:3)(cid:10)(cid:5)(cid:2)(cid:64)(cid:46)(cid:4)(cid:12)(cid:2)(cid:28)(cid:3,Unknown,2769.0
Unknown,Unknown,29,Unknown,Unknown,Unknown,Unknown,cid:50)(cid:46)(cid:12)(cid:2)(cid:7)(cid:8)(cid:10)(cid:5)(cid:3)(cid:48)(cid:46)(cid:3)(cid:12)(cid:13)(cid:5)(cid:2)(cid:14)(cid:46)(cid:2)(cid:28)(cid:5)(cid:3)(cid:10)(cid:5)(cid:2)(cid:64)(cid:46)(cid:4)(cid:12)(cid:2)(cid:28)(cid:3,Unknown,2798.0
Unknown,Unknown,53,Unknown,Unknown,Unknown,Unknown,cid:50)(cid:46)(cid:12)(cid:2)(cid:7)(cid:8)(cid:10)(cid:5)(cid:3)(cid:48)(cid:46)(cid:3)(cid:12)(cid:13)(cid:5)(cid:2)(cid:14)(cid:46)(cid:2)(cid:28)(cid:5)(cid:3)(cid:10)(cid:5)(cid:2)(cid:64)(cid:46)(cid:4)(cid:12)(cid:2)(cid:28)(cid:3,Unknown,2851.0
Unknown,Unknown,53,Unknown,Unknown,Unknown,Unknown,cid:50)(cid:46)(cid:12)(cid:2)(cid:7)(cid:8)(cid:10)(cid:5)(cid:3)(cid:48)(cid:46)(cid:3)(cid:12)(cid:13)(cid:5)(cid:2)(cid:14)(cid:46)(cid:2)(cid:28)(cid:5)(cid:3)(cid:10)(cid:5)(cid:2)(cid:64)(cid:46)(cid:4)(cid:12)(cid:2)(cid:28)(cid:3,Unknown,2904.0
Unknown,Unknown,24,Unknown,Unknown,Unknown,Unknown,cid:50)(cid:46)(cid:12)(cid:2)(cid:7)(cid:8)(cid:10)(cid:5)(cid:3)(cid:48)(cid:46)(cid:3)(cid:12)(cid:13)(cid:5)(cid:2)(cid:14)(cid:46)(cid:2)(cid:28)(cid:5)(cid:3)(cid:10)(cid:5)(cid:2)(cid:64)(cid:46)(cid:4)(cid:12)(cid:2)(cid:28)(cid:3,Unknown,2928.0
Unknown,Unknown,41,Unknown,Unknown,Unknown,Unknown,cid:50)(cid:46)(cid:12)(cid:2)(cid:7)(cid:8)(cid:10)(cid:5)(cid:3)(cid:48)(cid:46)(cid:3)(cid:12)(cid:13)(cid:5)(cid:2)(cid:14)(cid:46)(cid:2)(cid:28)(cid:5)(cid:3)(cid:10)(cid:5)(cid:2)(cid:64)(cid:46)(cid:4)(cid:12)(cid:2)(cid:28)(cid:3,Unknown,2969.0
Unknown,Unknown,24,Unknown,Unknown,Unknown,Unknown,cid:50)(cid:46)(cid:12)(cid:2)(cid:7)(cid:8)(cid:10)(cid:5)(cid:3)(cid:48)(cid:46)(cid:3)(cid:12)(cid:13)(cid:5)(cid:2)(cid:14)(cid:46)(cid:2)(cid:28)(cid:5)(cid:3)(cid:10)(cid:5)(cid:2)(cid:64)(cid:46)(cid:4)(cid:12)(cid:2)(cid:28)(cid:3,Unknown,2993.0
Unknown,Unknown,20,Unknown,Unknown,Unknown,Unknown,cid:50)(cid:46)(cid:12)(cid:2)(cid:7)(cid:8)(cid:10)(cid:5)(cid:3)(cid:48)(cid:46)(cid:3)(cid:12)(cid:13)(cid:5)(cid:2)(cid:14)(cid:46)(cid:2)(cid:28)(cid:5)(cid:3)(cid:10)(cid:5)(cid:2)(cid:64)(cid:46)(cid:4)(cid:12)(cid:2)(cid:28)(cid:3,Unknown,3013.0
Unknown,Unknown,30,Unknown,Unknown,Unknown,Unknown,cid:50)(cid:46)(cid:12)(cid:2)(cid:7)(cid:8)(cid:10)(cid:5)(cid:3)(cid:48)(cid:46)(cid:3)(cid:12)(cid:13)(cid:5)(cid:2)(cid:14)(cid:46)(cid:2)(cid:28)(cid:5)(cid:3)(cid:10)(cid:5)(cid:2)(cid:64)(cid:46)(cid:4)(cid:12)(cid:2)(cid:28)(cid:3,Unknown,3043.0
Unknown,Unknown,30,Unknown,Unknown,Unknown,Unknown,cid:50)(cid:46)(cid:12)(cid:2)(cid:7)(cid:8)(cid:10)(cid:5)(cid:3)(cid:48)(cid:46)(cid:3)(cid:12)(cid:13)(cid:5)(cid:2)(cid:14)(cid:46)(cid:2)(cid:28)(cid:5)(cid:3)(cid:10)(cid:5)(cid:2)(cid:64)(cid:46)(cid:4)(cid:12)(cid:2)(cid:28)(cid:3,Unknown,3073.0
Unknown,Unknown,25,Unknown,Unknown,Unknown,Unknown,cid:50)(cid:46)(cid:12)(cid:2)(cid:7)(cid:8)(cid:10)(cid:5)(cid:3)(cid:48)(cid:46)(cid:3)(cid:12)(cid:13)(cid:5)(cid:2)(cid:14)(cid:46)(cid:2)(cid:28)(cid:5)(cid:3)(cid:10)(cid:5)(cid:2)(cid:64)(cid:46)(cid:4)(cid:12)(cid:2)(cid:28)(cid:3,Unknown,3098.0
Unknown,Unknown,22,Unknown,Unknown,Unknown,Unknown,cid:50)(cid:46)(cid:12)(cid:2)(cid:7)(cid:8)(cid:10)(cid:5)(cid:3)(cid:48)(cid:46)(cid:3)(cid:12)(cid:13)(cid:5)(cid:2)(cid:14)(cid:46)(cid:2)(cid:28)(cid:5)(cid:3)(cid:10)(cid:5)(cid:2)(cid:64)(cid:46)(cid:4)(cid:12)(cid:2)(cid:28)(cid:3,Unknown,3120.0
Unknown,Unknown,27,Unknown,Unknown,Unknown,Unknown,cid:50)(cid:46)(cid:12)(cid:2)(cid:7)(cid:8)(cid:10)(cid:5)(cid:3)(cid:48)(cid:46)(cid:3)(cid:12)(cid:13)(cid:5)(cid:2)(cid:14)(cid:46)(cid:2)(cid:28)(cid:5)(cid:3)(cid:10)(cid:5)(cid:2)(cid:64)(cid:46)(cid:4)(cid:12)(cid:2)(cid:28)(cid:3,Unknown,3147.0
Unknown,Unknown,18,Unknown,Unknown,Unknown,Unknown,cid:50)(cid:46)(cid:12)(cid:2)(cid:7)(cid:8)(cid:10)(cid:5)(cid:3)(cid:48)(cid:46)(cid:3)(cid:12)(cid:13)(cid:5)(cid:2)(cid:14)(cid:46)(cid:2)(cid:28)(cid:5)(cid:3)(cid:10)(cid:5)(cid:2)(cid:64)(cid:46)(cid:4)(cid:12)(cid:2)(cid:28)(cid:3,Unknown,3165.0
Unknown,Unknown,1,Unknown,Unknown,Unknown,Unknown,cid:50)(cid:46)(cid:12)(cid:2)(cid:7)(cid:8)(cid:10)(cid:5)(cid:3)(cid:48)(cid:46)(cid:3)(cid:12)(cid:13)(cid:5)(cid:2)(cid:14)(cid:46)(cid:2)(cid:28)(cid:5)(cid:3)(cid:10)(cid:5)(cid:2)(cid:64)(cid:46)(cid:4)(cid:12)(cid:2)(cid:28)(cid:3,Unknown,3166.0
Unknown,Unknown,45,Unknown,Unknown,Unknown,Unknown,cid:50)(cid:46)(cid:12)(cid:2)(cid:7)(cid:8)(cid:10)(cid:5)(cid:3)(cid:48)(cid:46)(cid:3)(cid:12)(cid:13)(cid:5)(cid:2)(cid:14)(cid:46)(cid:2)(cid:28)(cid:5)(cid:3)(cid:10)(cid:5)(cid:2)(cid:64)(cid:46)(cid:4)(cid:12)(cid:2)(cid:28)(cid:3,Unknown,3211.0
Unknown,Unknown,18,Unknown,Unknown,Unknown,Unknown,cid:50)(cid:46)(cid:12)(cid:2)(cid:7)(cid:8)(cid:10)(cid:5)(cid:3)(cid:48)(cid:46)(cid:3)(cid:12)(cid:13)(cid:5)(cid:2)(cid:14)(cid:46)(cid:2)(cid:28)(cid:5)(cid:3)(cid:10)(cid:5)(cid:2)(cid:64)(cid:46)(cid:4)(cid:12)(cid:2)(cid:28)(cid:3,Unknown,3229.0
Unknown,Unknown,16,Unknown,Unknown,Unknown,Unknown,cid:50)(cid:46)(cid:12)(cid:2)(cid:7)(cid:8)(cid:10)(cid:5)(cid:3)(cid:48)(cid:46)(cid:3)(cid:12)(cid:13)(cid:5)(cid:2)(cid:14)(cid:46)(cid:2)(cid:28)(cid:5)(cid:3)(cid:10)(cid:5)(cid:2)(cid:64)(cid:46)(cid:4)(cid:12)(cid:2)(cid:28)(cid:3,Unknown,3245.0
Unknown,Unknown,38,Unknown,Unknown,Unknown,Unknown,cid:50)(cid:46)(cid:12)(cid:2)(cid:7)(cid:8)(cid:10)(cid:5)(cid:3)(cid:48)(cid:46)(cid:3)(cid:12)(cid:13)(cid:5)(cid:2)(cid:14)(cid:46)(cid:2)(cid:28)(cid:5)(cid:3)(cid:10)(cid:5)(cid:2)(cid:64)(cid:46)(cid:4)(cid:12)(cid:2)(cid:28)(cid:3,Unknown,3283.0
Unknown,Unknown,20,Unknown,Unknown,Unknown,Unknown,cid:50)(cid:46)(cid:12)(cid:2)(cid:7)(cid:8)(cid:10)(cid:5)(cid:3)(cid:48)(cid:46)(cid:3)(cid:12)(cid:13)(cid:5)(cid:2)(cid:14)(cid:46)(cid:2)(cid:28)(cid:5)(cid:3)(cid:10)(cid:5)(cid:2)(cid:64)(cid:46)(cid:4)(cid:12)(cid:2)(cid:28)(cid:3,Unknown,3303.0
Unknown,Unknown,30,Unknown,Unknown,Unknown,Unknown,cid:50)(cid:46)(cid:12)(cid:2)(cid:7)(cid:8)(cid:10)(cid:5)(cid:3)(cid:48)(cid:46)(cid:3)(cid:12)(cid:13)(cid:5)(cid:2)(cid:14)(cid:46)(cid:2)(cid:28)(cid:5)(cid:3)(cid:10)(cid:5)(cid:2)(cid:64)(cid:46)(cid:4)(cid:12)(cid:2)(cid:28)(cid:3,Unknown,3333.0
Unknown,Unknown,41,Unknown,Unknown,Unknown,Unknown,cid:50)(cid:46)(cid:12)(cid:2)(cid:7)(cid:8)(cid:10)(cid:5)(cid:3)(cid:48)(cid:46)(cid:3)(cid:12)(cid:13)(cid:5)(cid:2)(cid:14)(cid:46)(cid:2)(cid:28)(cid:5)(cid:3)(cid:10)(cid:5)(cid:2)(cid:64)(cid:46)(cid:4)(cid:12)(cid:2)(cid:28)(cid:3,Unknown,3374.0
Unknown,Unknown,20,Unknown,Unknown,Unknown,Unknown,cid:50)(cid:46)(cid:12)(cid:2)(cid:7)(cid:8)(cid:10)(cid:5)(cid:3)(cid:48)(cid:46)(cid:3)(cid:12)(cid:13)(cid:5)(cid:2)(cid:14)(cid:46)(cid:2)(cid:28)(cid:5)(cid:3)(cid:10)(cid:5)(cid:2)(cid:64)(cid:46)(cid:4)(cid:12)(cid:2)(cid:28)(cid:3,Unknown,3394.0
Unknown,Unknown,15,Unknown,Unknown,Unknown,Unknown,cid:50)(cid:46)(cid:12)(cid:2)(cid:7)(cid:8)(cid:10)(cid:5)(cid:3)(cid:48)(cid:46)(cid:3)(cid:12)(cid:13)(cid:5)(cid:2)(cid:14)(cid:46)(cid:2)(cid:28)(cid:5)(cid:3)(cid:10)(cid:5)(cid:2)(cid:64)(cid:46)(cid:4)(cid:12)(cid:2)(cid:28)(cid:3,Unknown,3409.0
Unknown,Unknown,2,Unknown,Unknown,Unknown,Unknown,cid:50)(cid:46)(cid:12)(cid:2)(cid:7)(cid:8)(cid:10)(cid:5)(cid:3)(cid:48)(cid:46)(cid:3)(cid:12)(cid:13)(cid:5)(cid:2)(cid:14)(cid:46)(cid:2)(cid:28)(cid:5)(cid:3)(cid:10)(cid:5)(cid:2)(cid:64)(cid:46)(cid:4)(cid:12)(cid:2)(cid:28)(cid:3,Unknown,3411.0
Unknown,Unknown,1,Unknown,Unknown,Unknown,Unknown,cid:50)(cid:46)(cid:12)(cid:2)(cid:7)(cid:8)(cid:10)(cid:5)(cid:3)(cid:48)(cid:46)(cid:3)(cid:12)(cid:13)(cid:5)(cid:2)(cid:14)(cid:46)(cid:2)(cid:28)(cid:5)(cid:3)(cid:10)(cid:5)(cid:2)(cid:64)(cid:46)(cid:4)(cid:12)(cid:2)(cid:28)(cid:3,Unknown,3412.0
Unknown,Unknown,19,Unknown,Unknown,Unknown,Unknown,cid:50)(cid:46)(cid:12)(cid:2)(cid:7)(cid:8)(cid:10)(cid:5)(cid:3)(cid:48)(cid:46)(cid:3)(cid:12)(cid:13)(cid:5)(cid:2)(cid:14)(cid:46)(cid:2)(cid:28)(cid:5)(cid:3)(cid:10)(cid:5)(cid:2)(cid:64)(cid:46)(cid:4)(cid:12)(cid:2)(cid:28)(cid:3,Unknown,3431.0
Unknown,Unknown,36,Unknown,Unknown,Unknown,Unknown,cid:50)(cid:46)(cid:12)(cid:2)(cid:7)(cid:8)(cid:10)(cid:5)(cid:3)(cid:48)(cid:46)(cid:3)(cid:12)(cid:13)(cid:5)(cid:2)(cid:14)(cid:46)(cid:2)(cid:28)(cid:5)(cid:3)(cid:10)(cid:5)(cid:2)(cid:64)(cid:46)(cid:4)(cid:12)(cid:2)(cid:28)(cid:3,Unknown,3467.0
Unknown,Unknown,18,Unknown,Unknown,Unknown,Unknown,cid:50)(cid:46)(cid:12)(cid:2)(cid:7)(cid:8)(cid:10)(cid:5)(cid:3)(cid:48)(cid:46)(cid:3)(cid:12)(cid:13)(cid:5)(cid:2)(cid:14)(cid:46)(cid:2)(cid:28)(cid:5)(cid:3)(cid:10)(cid:5)(cid:2)(cid:64)(cid:46)(cid:4)(cid:12)(cid:2)(cid:28)(cid:3,Unknown,3485.0
Unknown,Unknown,2,Unknown,Unknown,Unknown,Unknown,cid:50)(cid:46)(cid:12)(cid:2)(cid:7)(cid:8)(cid:10)(cid:5)(cid:3)(cid:48)(cid:46)(cid:3)(cid:12)(cid:13)(cid:5)(cid:2)(cid:14)(cid:46)(cid:2)(cid:28)(cid:5)(cid:3)(cid:10)(cid:5)(cid:2)(cid:64)(cid:46)(cid:4)(cid:12)(cid:2)(cid:28)(cid:3,Unknown,3487.0
Unknown,Unknown,44,Unknown,Unknown,Unknown,Unknown,cid:50)(cid:46)(cid:12)(cid:2)(cid:7)(cid:8)(cid:10)(cid:5)(cid:3)(cid:48)(cid:46)(cid:3)(cid:12)(cid:13)(cid:5)(cid:2)(cid:14)(cid:46)(cid:2)(cid:28)(cid:5)(cid:3)(cid:10)(cid:5)(cid:2)(cid:64)(cid:46)(cid:4)(cid:12)(cid:2)(cid:28)(cid:3,Unknown,3531.0
Unknown,Unknown,46,Unknown,Unknown,Unknown,Unknown,cid:50)(cid:46)(cid:12)(cid:2)(cid:7)(cid:8)(cid:10)(cid:5)(cid:3)(cid:48)(cid:46)(cid:3)(cid:12)(cid:13)(cid:5)(cid:2)(cid:14)(cid:46)(cid:2)(cid:28)(cid:5)(cid:3)(cid:10)(cid:5)(cid:2)(cid:64)(cid:46)(cid:4)(cid:12)(cid:2)(cid:28)(cid:3,Unknown,3577.0
Unknown,Unknown,57,Unknown,Unknown,Unknown,Unknown,cid:50)(cid:46)(cid:12)(cid:2)(cid:7)(cid:8)(cid:10)(cid:5)(cid:3)(cid:48)(cid:46)(cid:3)(cid:12)(cid:13)(cid:5)(cid:2)(cid:14)(cid:46)(cid:2)(cid:28)(cid:5)(cid:3)(cid:10)(cid:5)(cid:2)(cid:64)(cid:46)(cid:4)(cid:12)(cid:2)(cid:28)(cid:3,Unknown,3634.0
Unknown,Unknown,20,Unknown,Unknown,Unknown,Unknown,cid:50)(cid:46)(cid:12)(cid:2)(cid:7)(cid:8)(cid:10)(cid:5)(cid:3)(cid:48)(cid:46)(cid:3)(cid:12)(cid:13)(cid:5)(cid:2)(cid:14)(cid:46)(cid:2)(cid:28)(cid:5)(cid:3)(cid:10)(cid:5)(cid:2)(cid:64)(cid:46)(cid:4)(cid:12)(cid:2)(cid:28)(cid:3,Unknown,3654.0
Unknown,Unknown,30,Unknown,Unknown,Unknown,Unknown,cid:50)(cid:46)(cid:12)(cid:2)(cid:7)(cid:8)(cid:10)(cid:5)(cid:3)(cid:48)(cid:46)(cid:3)(cid:12)(cid:13)(cid:5)(cid:2)(cid:14)(cid:46)(cid:2)(cid:28)(cid:5)(cid:3)(cid:10)(cid:5)(cid:2)(cid:64)(cid:46)(cid:4)(cid:12)(cid:2)(cid:28)(cid:3,Unknown,3684.0
Unknown,Unknown,30,Unknown,Unknown,Unknown,Unknown,cid:50)(cid:46)(cid:12)(cid:2)(cid:7)(cid:8)(cid:10)(cid:5)(cid:3)(cid:48)(cid:46)(cid:3)(cid:12)(cid:13)(cid:5)(cid:2)(cid:14)(cid:46)(cid:2)(cid:28)(cid:5)(cid:3)(cid:10)(cid:5)(cid:2)(cid:64)(cid:46)(cid:4)(cid:12)(cid:2)(cid:28)(cid:3,Unknown,3714.0
Unknown,Unknown,25,Unknown,Unknown,Unknown,Unknown,cid:50)(cid:46)(cid:12)(cid:2)(cid:7)(cid:8)(cid:10)(cid:5)(cid:3)(cid:48)(cid:46)(cid:3)(cid:12)(cid:13)(cid:5)(cid:2)(cid:14)(cid:46)(cid:2)(cid:28)(cid:5)(cid:3)(cid:10)(cid:5)(cid:2)(cid:64)(cid:46)(cid:4)(cid:12)(cid:2)(cid:28)(cid:3,Unknown,3739.0
Unknown,Unknown,23,Unknown,Unknown,Unknown,Unknown,cid:50)(cid:46)(cid:12)(cid:2)(cid:7)(cid:8)(cid:10)(cid:5)(cid:3)(cid:48)(cid:46)(cid:3)(cid:12)(cid:13)(cid:5)(cid:2)(cid:14)(cid:46)(cid:2)(cid:28)(cid:5)(cid:3)(cid:10)(cid:5)(cid:2)(cid:64)(cid:46)(cid:4)(cid:12)(cid:2)(cid:28)(cid:3,Unknown,3762.0
Unknown,Unknown,25,Unknown,Unknown,Unknown,Unknown,cid:50)(cid:46)(cid:12)(cid:2)(cid:7)(cid:8)(cid:10)(cid:5)(cid:3)(cid:48)(cid:46)(cid:3)(cid:12)(cid:13)(cid:5)(cid:2)(cid:14)(cid:46)(cid:2)(cid:28)(cid:5)(cid:3)(cid:10)(cid:5)(cid:2)(cid:64)(cid:46)(cid:4)(cid:12)(cid:2)(cid:28)(cid:3,Unknown,3787.0
Unknown,Unknown,30,Unknown,Unknown,Unknown,Unknown,cid:50)(cid:46)(cid:12)(cid:2)(cid:7)(cid:8)(cid:10)(cid:5)(cid:3)(cid:48)(cid:46)(cid:3)(cid:12)(cid:13)(cid:5)(cid:2)(cid:14)(cid:46)(cid:2)(cid:28)(cid:5)(cid:3)(cid:10)(cid:5)(cid:2)(cid:64)(cid:46)(cid:4)(cid:12)(cid:2)(cid:28)(cid:3,Unknown,3817.0
Unknown,Unknown,41,Unknown,Unknown,Unknown,Unknown,cid:50)(cid:46)(cid:12)(cid:2)(cid:7)(cid:8)(cid:10)(cid:5)(cid:3)(cid:48)(cid:46)(cid:3)(cid:12)(cid:13)(cid:5)(cid:2)(cid:14)(cid:46)(cid:2)(cid:28)(cid:5)(cid:3)(cid:10)(cid:5)(cid:2)(cid:64)(cid:46)(cid:4)(cid:12)(cid:2)(cid:28)(cid:3,Unknown,3858.0
Unknown,Unknown,2,Unknown,Unknown,Unknown,Unknown,cid:50)(cid:46)(cid:12)(cid:2)(cid:7)(cid:8)(cid:10)(cid:5)(cid:3)(cid:48)(cid:46)(cid:3)(cid:12)(cid:13)(cid:5)(cid:2)(cid:14)(cid:46)(cid:2)(cid:28)(cid:5)(cid:3)(cid:10)(cid:5)(cid:2)(cid:64)(cid:46)(cid:4)(cid:12)(cid:2)(cid:28)(cid:3,Unknown,3860.0
Unknown,Unknown,45,Unknown,Unknown,Unknown,Unknown,cid:50)(cid:46)(cid:12)(cid:2)(cid:7)(cid:8)(cid:10)(cid:5)(cid:3)(cid:48)(cid:46)(cid:3)(cid:12)(cid:13)(cid:5)(cid:2)(cid:14)(cid:46)(cid:2)(cid:28)(cid:5)(cid:3)(cid:10)(cid:5)(cid:2)(cid:64)(cid:46)(cid:4)(cid:12)(cid:2)(cid:28)(cid:3,Unknown,3905.0
Unknown,Unknown,2,Unknown,Unknown,Unknown,Unknown,cid:50)(cid:46)(cid:12)(cid:2)(cid:7)(cid:8)(cid:10)(cid:5)(cid:3)(cid:48)(cid:46)(cid:3)(cid:12)(cid:13)(cid:5)(cid:2)(cid:14)(cid:46)(cid:2)(cid:28)(cid:5)(cid:3)(cid:10)(cid:5)(cid:2)(cid:64)(cid:46)(cid:4)(cid:12)(cid:2)(cid:28)(cid:3,Unknown,3907.0
Unknown,Unknown,28,Unknown,Unknown,Unknown,Unknown,cid:50)(cid:46)(cid:12)(cid:2)(cid:7)(cid:8)(cid:10)(cid:5)(cid:3)(cid:48)(cid:46)(cid:3)(cid:12)(cid:13)(cid:5)(cid:2)(cid:14)(cid:46)(cid:2)(cid:28)(cid:5)(cid:3)(cid:10)(cid:5)(cid:2)(cid:64)(cid:46)(cid:4)(cid:12)(cid:2)(cid:28)(cid:3,Unknown,3935.0
Unknown,Unknown,26,Unknown,Unknown,Unknown,Unknown,cid:50)(cid:46)(cid:12)(cid:2)(cid:7)(cid:8)(cid:10)(cid:5)(cid:3)(cid:48)(cid:46)(cid:3)(cid:12)(cid:13)(cid:5)(cid:2)(cid:14)(cid:46)(cid:2)(cid:28)(cid:5)(cid:3)(cid:10)(cid:5)(cid:2)(cid:64)(cid:46)(cid:4)(cid:12)(cid:2)(cid:28)(cid:3,Unknown,3961.0
Unknown,Unknown,29,Unknown,Unknown,Unknown,Unknown,cid:50)(cid:46)(cid:12)(cid:2)(cid:7)(cid:8)(cid:10)(cid:5)(cid:3)(cid:48)(cid:46)(cid:3)(cid:12)(cid:13)(cid:5)(cid:2)(cid:14)(cid:46)(cid:2)(cid:28)(cid:5)(cid:3)(cid:10)(cid:5)(cid:2)(cid:64)(cid:46)(cid:4)(cid:12)(cid:2)(cid:28)(cid:3,Unknown,3990.0
Unknown,Unknown,24,Unknown,Unknown,Unknown,Unknown,cid:50)(cid:46)(cid:12)(cid:2)(cid:7)(cid:8)(cid:10)(cid:5)(cid:3)(cid:48)(cid:46)(cid:3)(cid:12)(cid:13)(cid:5)(cid:2)(cid:14)(cid:46)(cid:2)(cid:28)(cid:5)(cid:3)(cid:10)(cid:5)(cid:2)(cid:64)(cid:46)(cid:4)(cid:12)(cid:2)(cid:28)(cid:3,Unknown,4014.0
Unknown,Unknown,27,Unknown,Unknown,Unknown,Unknown,cid:50)(cid:46)(cid:12)(cid:2)(cid:7)(cid:8)(cid:10)(cid:5)(cid:3)(cid:48)(cid:46)(cid:3)(cid:12)(cid:13)(cid:5)(cid:2)(cid:14)(cid:46)(cid:2)(cid:28)(cid:5)(cid:3)(cid:10)(cid:5)(cid:2)(cid:64)(cid:46)(cid:4)(cid:12)(cid:2)(cid:28)(cid:3,Unknown,4041.0
Unknown,Unknown,2,Unknown,Unknown,Unknown,Unknown,cid:50)(cid:46)(cid:12)(cid:2)(cid:7)(cid:8)(cid:10)(cid:5)(cid:3)(cid:48)(cid:46)(cid:3)(cid:12)(cid:13)(cid:5)(cid:2)(cid:14)(cid:46)(cid:2)(cid:28)(cid:5)(cid:3)(cid:10)(cid:5)(cid:2)(cid:64)(cid:46)(cid:4)(cid:12)(cid:2)(cid:28)(cid:3,Unknown,4043.0
Unknown,Unknown,29,Unknown,Unknown,Unknown,Unknown,cid:50)(cid:46)(cid:12)(cid:2)(cid:7)(cid:8)(cid:10)(cid:5)(cid:3)(cid:48)(cid:46)(cid:3)(cid:12)(cid:13)(cid:5)(cid:2)(cid:14)(cid:46)(cid:2)(cid:28)(cid:5)(cid:3)(cid:10)(cid:5)(cid:2)(cid:64)(cid:46)(cid:4)(cid:12)(cid:2)(cid:28)(cid:3,Unknown,4072.0
Unknown,Unknown,53,Unknown,Unknown,Unknown,Unknown,cid:50)(cid:46)(cid:12)(cid:2)(cid:7)(cid:8)(cid:10)(cid:5)(cid:3)(cid:48)(cid:46)(cid:3)(cid:12)(cid:13)(cid:5)(cid:2)(cid:14)(cid:46)(cid:2)(cid:28)(cid:5)(cid:3)(cid:10)(cid:5)(cid:2)(cid:64)(cid:46)(cid:4)(cid:12)(cid:2)(cid:28)(cid:3,Unknown,4125.0
Unknown,Unknown,53,Unknown,Unknown,Unknown,Unknown,cid:50)(cid:46)(cid:12)(cid:2)(cid:7)(cid:8)(cid:10)(cid:5)(cid:3)(cid:48)(cid:46)(cid:3)(cid:12)(cid:13)(cid:5)(cid:2)(cid:14)(cid:46)(cid:2)(cid:28)(cid:5)(cid:3)(cid:10)(cid:5)(cid:2)(cid:64)(cid:46)(cid:4)(cid:12)(cid:2)(cid:28)(cid:3,Unknown,4178.0
Unknown,Unknown,24,Unknown,Unknown,Unknown,Unknown,cid:50)(cid:46)(cid:12)(cid:2)(cid:7)(cid:8)(cid:10)(cid:5)(cid:3)(cid:48)(cid:46)(cid:3)(cid:12)(cid:13)(cid:5)(cid:2)(cid:14)(cid:46)(cid:2)(cid:28)(cid:5)(cid:3)(cid:10)(cid:5)(cid:2)(cid:64)(cid:46)(cid:4)(cid:12)(cid:2)(cid:28)(cid:3,Unknown,4202.0
Unknown,Unknown,41,Unknown,Unknown,Unknown,Unknown,cid:50)(cid:46)(cid:12)(cid:2)(cid:7)(cid:8)(cid:10)(cid:5)(cid:3)(cid:48)(cid:46)(cid:3)(cid:12)(cid:13)(cid:5)(cid:2)(cid:14)(cid:46)(cid:2)(cid:28)(cid:5)(cid:3)(cid:10)(cid:5)(cid:2)(cid:64)(cid:46)(cid:4)(cid:12)(cid:2)(cid:28)(cid:3,Unknown,4243.0
Unknown,Unknown,24,Unknown,Unknown,Unknown,Unknown,cid:50)(cid:46)(cid:12)(cid:2)(cid:7)(cid:8)(cid:10)(cid:5)(cid:3)(cid:48)(cid:46)(cid:3)(cid:12)(cid:13)(cid:5)(cid:2)(cid:14)(cid:46)(cid:2)(cid:28)(cid:5)(cid:3)(cid:10)(cid:5)(cid:2)(cid:64)(cid:46)(cid:4)(cid:12)(cid:2)(cid:28)(cid:3,Unknown,4267.0
Unknown,Unknown,20,Unknown,Unknown,Unknown,Unknown,cid:50)(cid:46)(cid:12)(cid:2)(cid:7)(cid:8)(cid:10)(cid:5)(cid:3)(cid:48)(cid:46)(cid:3)(cid:12)(cid:13)(cid:5)(cid:2)(cid:14)(cid:46)(cid:2)(cid:28)(cid:5)(cid:3)(cid:10)(cid:5)(cid:2)(cid:64)(cid:46)(cid:4)(cid:12)(cid:2)(cid:28)(cid:3,Unknown,4287.0
Unknown,Unknown,30,Unknown,Unknown,Unknown,Unknown,cid:50)(cid:46)(cid:12)(cid:2)(cid:7)(cid:8)(cid:10)(cid:5)(cid:3)(cid:48)(cid:46)(cid:3)(cid:12)(cid:13)(cid:5)(cid:2)(cid:14)(cid:46)(cid:2)(cid:28)(cid:5)(cid:3)(cid:10)(cid:5)(cid:2)(cid:64)(cid:46)(cid:4)(cid:12)(cid:2)(cid:28)(cid:3,Unknown,4317.0
Unknown,Unknown,30,Unknown,Unknown,Unknown,Unknown,cid:50)(cid:46)(cid:12)(cid:2)(cid:7)(cid:8)(cid:10)(cid:5)(cid:3)(cid:48)(cid:46)(cid:3)(cid:12)(cid:13)(cid:5)(cid:2)(cid:14)(cid:46)(cid:2)(cid:28)(cid:5)(cid:3)(cid:10)(cid:5)(cid:2)(cid:64)(cid:46)(cid:4)(cid:12)(cid:2)(cid:28)(cid:3,Unknown,4347.0
Unknown,Unknown,25,Unknown,Unknown,Unknown,Unknown,cid:50)(cid:46)(cid:12)(cid:2)(cid:7)(cid:8)(cid:10)(cid:5)(cid:3)(cid:48)(cid:46)(cid:3)(cid:12)(cid:13)(cid:5)(cid:2)(cid:14)(cid:46)(cid:2)(cid:28)(cid:5)(cid:3)(cid:10)(cid:5)(cid:2)(cid:64)(cid:46)(cid:4)(cid:12)(cid:2)(cid:28)(cid:3,Unknown,4372.0
Unknown,Unknown,22,Unknown,Unknown,Unknown,Unknown,cid:50)(cid:46)(cid:12)(cid:2)(cid:7)(cid:8)(cid:10)(cid:5)(cid:3)(cid:48)(cid:46)(cid:3)(cid:12)(cid:13)(cid:5)(cid:2)(cid:14)(cid:46)(cid:2)(cid:28)(cid:5)(cid:3)(cid:10)(cid:5)(cid:2)(cid:64)(cid:46)(cid:4)(cid:12)(cid:2)(cid:28)(cid:3,Unknown,4394.0
Unknown,Unknown,27,Unknown,Unknown,Unknown,Unknown,cid:50)(cid:46)(cid:12)(cid:2)(cid:7)(cid:8)(cid:10)(cid:5)(cid:3)(cid:48)(cid:46)(cid:3)(cid:12)(cid:13)(cid:5)(cid:2)(cid:14)(cid:46)(cid:2)(cid:28)(cid:5)(cid:3)(cid:10)(cid:5)(cid:2)(cid:64)(cid:46)(cid:4)(cid:12)(cid:2)(cid:28)(cid:3,Unknown,4421.0
Unknown,Unknown,18,Unknown,Unknown,Unknown,Unknown,cid:50)(cid:46)(cid:12)(cid:2)(cid:7)(cid:8)(cid:10)(cid:5)(cid:3)(cid:48)(cid:46)(cid:3)(cid:12)(cid:13)(cid:5)(cid:2)(cid:14)(cid:46)(cid:2)(cid:28)(cid:5)(cid:3)(cid:10)(cid:5)(cid:2)(cid:64)(cid:46)(cid:4)(cid:12)(cid:2)(cid:28)(cid:3,Unknown,4439.0
Unknown,Unknown,34,Unknown,Unknown,Unknown,Unknown,cid:50)(cid:46)(cid:12)(cid:2)(cid:7)(cid:8)(cid:10)(cid:5)(cid:3)(cid:48)(cid:46)(cid:3)(cid:12)(cid:13)(cid:5)(cid:2)(cid:14)(cid:46)(cid:2)(cid:28)(cid:5)(cid:3)(cid:10)(cid:5)(cid:2)(cid:64)(cid:46)(cid:4)(cid:12)(cid:2)(cid:28)(cid:3,Unknown,4473.0
Unknown,Unknown,45,Unknown,Unknown,Unknown,Unknown,cid:50)(cid:46)(cid:12)(cid:2)(cid:7)(cid:8)(cid:10)(cid:5)(cid:3)(cid:48)(cid:46)(cid:3)(cid:12)(cid:13)(cid:5)(cid:2)(cid:14)(cid:46)(cid:2)(cid:28)(cid:5)(cid:3)(cid:10)(cid:5)(cid:2)(cid:64)(cid:46)(cid:4)(cid:12)(cid:2)(cid:28)(cid:3,Unknown,4518.0
Unknown,Unknown,18,Unknown,Unknown,Unknown,Unknown,cid:50)(cid:46)(cid:12)(cid:2)(cid:7)(cid:8)(cid:10)(cid:5)(cid:3)(cid:48)(cid:46)(cid:3)(cid:12)(cid:13)(cid:5)(cid:2)(cid:14)(cid:46)(cid:2)(cid:28)(cid:5)(cid:3)(cid:10)(cid:5)(cid:2)(cid:64)(cid:46)(cid:4)(cid:12)(cid:2)(cid:28)(cid:3,Unknown,4536.0
Unknown,Unknown,16,Unknown,Unknown,Unknown,Unknown,cid:50)(cid:46)(cid:12)(cid:2)(cid:7)(cid:8)(cid:10)(cid:5)(cid:3)(cid:48)(cid:46)(cid:3)(cid:12)(cid:13)(cid:5)(cid:2)(cid:14)(cid:46)(cid:2)(cid:28)(cid:5)(cid:3)(cid:10)(cid:5)(cid:2)(cid:64)(cid:46)(cid:4)(cid:12)(cid:2)(cid:28)(cid:3,Unknown,4552.0
Unknown,Unknown,23,Unknown,Unknown,Unknown,Unknown,cid:50)(cid:46)(cid:12)(cid:2)(cid:7)(cid:8)(cid:10)(cid:5)(cid:3)(cid:48)(cid:46)(cid:3)(cid:12)(cid:13)(cid:5)(cid:2)(cid:14)(cid:46)(cid:2)(cid:28)(cid:5)(cid:3)(cid:10)(cid:5)(cid:2)(cid:64)(cid:46)(cid:4)(cid:12)(cid:2)(cid:28)(cid:3,Unknown,4575.0
Unknown,Unknown,29,Unknown,Unknown,Unknown,Unknown,cid:50)(cid:46)(cid:12)(cid:2)(cid:7)(cid:8)(cid:10)(cid:5)(cid:3)(cid:48)(cid:46)(cid:3)(cid:12)(cid:13)(cid:5)(cid:2)(cid:14)(cid:46)(cid:2)(cid:28)(cid:5)(cid:3)(cid:10)(cid:5)(cid:2)(cid:64)(cid:46)(cid:4)(cid:12)(cid:2)(cid:28)(cid:3,Unknown,4604.0
Unknown,Unknown,22,Unknown,Unknown,Unknown,Unknown,cid:50)(cid:46)(cid:12)(cid:2)(cid:7)(cid:8)(cid:10)(cid:5)(cid:3)(cid:48)(cid:46)(cid:3)(cid:12)(cid:13)(cid:5)(cid:2)(cid:14)(cid:46)(cid:2)(cid:28)(cid:5)(cid:3)(cid:10)(cid:5)(cid:2)(cid:64)(cid:46)(cid:4)(cid:12)(cid:2)(cid:28)(cid:3,Unknown,4626.0
Unknown,Unknown,25,Unknown,Unknown,Unknown,Unknown,cid:50)(cid:46)(cid:12)(cid:2)(cid:7)(cid:8)(cid:10)(cid:5)(cid:3)(cid:48)(cid:46)(cid:3)(cid:12)(cid:13)(cid:5)(cid:2)(cid:14)(cid:46)(cid:2)(cid:28)(cid:5)(cid:3)(cid:10)(cid:5)(cid:2)(cid:64)(cid:46)(cid:4)(cid:12)(cid:2)(cid:28)(cid:3,Unknown,4651.0
Unknown,Unknown,41,Unknown,Unknown,Unknown,Unknown,cid:50)(cid:46)(cid:12)(cid:2)(cid:7)(cid:8)(cid:10)(cid:5)(cid:3)(cid:48)(cid:46)(cid:3)(cid:12)(cid:13)(cid:5)(cid:2)(cid:14)(cid:46)(cid:2)(cid:28)(cid:5)(cid:3)(cid:10)(cid:5)(cid:2)(cid:64)(cid:46)(cid:4)(cid:12)(cid:2)(cid:28)(cid:3,Unknown,4692.0
Unknown,Unknown,29,Unknown,Unknown,Unknown,Unknown,cid:50)(cid:46)(cid:12)(cid:2)(cid:7)(cid:8)(cid:10)(cid:5)(cid:3)(cid:48)(cid:46)(cid:3)(cid:12)(cid:13)(cid:5)(cid:2)(cid:14)(cid:46)(cid:2)(cid:28)(cid:5)(cid:3)(cid:10)(cid:5)(cid:2)(cid:64)(cid:46)(cid:4)(cid:12)(cid:2)(cid:28)(cid:3,Unknown,4721.0
Unknown,Unknown,2,Unknown,Unknown,Unknown,Unknown,cid:50)(cid:46)(cid:12)(cid:2)(cid:7)(cid:8)(cid:10)(cid:5)(cid:3)(cid:48)(cid:46)(cid:3)(cid:12)(cid:13)(cid:5)(cid:2)(cid:14)(cid:46)(cid:2)(cid:28)(cid:5)(cid:3)(cid:10)(cid:5)(cid:2)(cid:64)(cid:46)(cid:4)(cid:12)(cid:2)(cid:28)(cid:3,Unknown,4723.0
Unknown,Unknown,29,Unknown,Unknown,Unknown,Unknown,cid:50)(cid:46)(cid:12)(cid:2)(cid:7)(cid:8)(cid:10)(cid:5)(cid:3)(cid:48)(cid:46)(cid:3)(cid:12)(cid:13)(cid:5)(cid:2)(cid:14)(cid:46)(cid:2)(cid:28)(cid:5)(cid:3)(cid:10)(cid:5)(cid:2)(cid:64)(cid:46)(cid:4)(cid:12)(cid:2)(cid:28)(cid:3,Unknown,4752.0
Unknown,Unknown,26,Unknown,Unknown,Unknown,Unknown,cid:50)(cid:46)(cid:12)(cid:2)(cid:7)(cid:8)(cid:10)(cid:5)(cid:3)(cid:48)(cid:46)(cid:3)(cid:12)(cid:13)(cid:5)(cid:2)(cid:14)(cid:46)(cid:2)(cid:28)(cid:5)(cid:3)(cid:10)(cid:5)(cid:2)(cid:64)(cid:46)(cid:4)(cid:12)(cid:2)(cid:28)(cid:3,Unknown,4778.0
Unknown,Unknown,27,Unknown,Unknown,Unknown,Unknown,cid:50)(cid:46)(cid:12)(cid:2)(cid:7)(cid:8)(cid:10)(cid:5)(cid:3)(cid:48)(cid:46)(cid:3)(cid:12)(cid:13)(cid:5)(cid:2)(cid:14)(cid:46)(cid:2)(cid:28)(cid:5)(cid:3)(cid:10)(cid:5)(cid:2)(cid:64)(cid:46)(cid:4)(cid:12)(cid:2)(cid:28)(cid:3,Unknown,4805.0
Unknown,Unknown,24,Unknown,Unknown,Unknown,Unknown,cid:50)(cid:46)(cid:12)(cid:2)(cid:7)(cid:8)(cid:10)(cid:5)(cid:3)(cid:48)(cid:46)(cid:3)(cid:12)(cid:13)(cid:5)(cid:2)(cid:14)(cid:46)(cid:2)(cid:28)(cid:5)(cid:3)(cid:10)(cid:5)(cid:2)(cid:64)(cid:46)(cid:4)(cid:12)(cid:2)(cid:28)(cid:3,Unknown,4829.0
Unknown,Unknown,23,Unknown,Unknown,Unknown,Unknown,cid:50)(cid:46)(cid:12)(cid:2)(cid:7)(cid:8)(cid:10)(cid:5)(cid:3)(cid:48)(cid:46)(cid:3)(cid:12)(cid:13)(cid:5)(cid:2)(cid:14)(cid:46)(cid:2)(cid:28)(cid:5)(cid:3)(cid:10)(cid:5)(cid:2)(cid:64)(cid:46)(cid:4)(cid:12)(cid:2)(cid:28)(cid:3,Unknown,4852.0
Unknown,Unknown,15,Unknown,Unknown,Unknown,Unknown,cid:50)(cid:46)(cid:12)(cid:2)(cid:7)(cid:8)(cid:10)(cid:5)(cid:3)(cid:48)(cid:46)(cid:3)(cid:12)(cid:13)(cid:5)(cid:2)(cid:14)(cid:46)(cid:2)(cid:28)(cid:5)(cid:3)(cid:10)(cid:5)(cid:2)(cid:64)(cid:46)(cid:4)(cid:12)(cid:2)(cid:28)(cid:3,Unknown,4867.0
Unknown,Unknown,2,Unknown,Unknown,Unknown,Unknown,cid:50)(cid:46)(cid:12)(cid:2)(cid:7)(cid:8)(cid:10)(cid:5)(cid:3)(cid:48)(cid:46)(cid:3)(cid:12)(cid:13)(cid:5)(cid:2)(cid:14)(cid:46)(cid:2)(cid:28)(cid:5)(cid:3)(cid:10)(cid:5)(cid:2)(cid:64)(cid:46)(cid:4)(cid:12)(cid:2)(cid:28)(cid:3,Unknown,4869.0
Unknown,Unknown,1,Unknown,Unknown,Unknown,Unknown,cid:50)(cid:46)(cid:12)(cid:2)(cid:7)(cid:8)(cid:10)(cid:5)(cid:3)(cid:48)(cid:46)(cid:3)(cid:12)(cid:13)(cid:5)(cid:2)(cid:14)(cid:46)(cid:2)(cid:28)(cid:5)(cid:3)(cid:10)(cid:5)(cid:2)(cid:64)(cid:46)(cid:4)(cid:12)(cid:2)(cid:28)(cid:3,Unknown,4870.0
Unknown,Unknown,18,Unknown,Unknown,Unknown,Unknown,cid:50)(cid:46)(cid:12)(cid:2)(cid:7)(cid:8)(cid:10)(cid:5)(cid:3)(cid:48)(cid:46)(cid:3)(cid:12)(cid:13)(cid:5)(cid:2)(cid:14)(cid:46)(cid:2)(cid:28)(cid:5)(cid:3)(cid:10)(cid:5)(cid:2)(cid:64)(cid:46)(cid:4)(cid:12)(cid:2)(cid:28)(cid:3,Unknown,4888.0
Unknown,Unknown,2,Unknown,Unknown,Unknown,Unknown,cid:50)(cid:46)(cid:12)(cid:2)(cid:7)(cid:8)(cid:10)(cid:5)(cid:3)(cid:48)(cid:46)(cid:3)(cid:12)(cid:13)(cid:5)(cid:2)(cid:14)(cid:46)(cid:2)(cid:28)(cid:5)(cid:3)(cid:10)(cid:5)(cid:2)(cid:64)(cid:46)(cid:4)(cid:12)(cid:2)(cid:28)(cid:3,Unknown,4890.0
Unknown,Unknown,18,Unknown,Unknown,Unknown,Unknown,cid:50)(cid:46)(cid:12)(cid:2)(cid:7)(cid:8)(cid:10)(cid:5)(cid:3)(cid:48)(cid:46)(cid:3)(cid:12)(cid:13)(cid:5)(cid:2)(cid:14)(cid:46)(cid:2)(cid:28)(cid:5)(cid:3)(cid:10)(cid:5)(cid:2)(cid:64)(cid:46)(cid:4)(cid:12)(cid:2)(cid:28)(cid:3,Unknown,4908.0
Unknown,Unknown,18,Unknown,Unknown,Unknown,Unknown,cid:50)(cid:46)(cid:12)(cid:2)(cid:7)(cid:8)(cid:10)(cid:5)(cid:3)(cid:48)(cid:46)(cid:3)(cid:12)(cid:13)(cid:5)(cid:2)(cid:14)(cid:46)(cid:2)(cid:28)(cid:5)(cid:3)(cid:10)(cid:5)(cid:2)(cid:64)(cid:46)(cid:4)(cid:12)(cid:2)(cid:28)(cid:3,Unknown,4926.0
Unknown,Unknown,18,Unknown,Unknown,Unknown,Unknown,cid:50)(cid:46)(cid:12)(cid:2)(cid:7)(cid:8)(cid:10)(cid:5)(cid:3)(cid:48)(cid:46)(cid:3)(cid:12)(cid:13)(cid:5)(cid:2)(cid:14)(cid:46)(cid:2)(cid:28)(cid:5)(cid:3)(cid:10)(cid:5)(cid:2)(cid:64)(cid:46)(cid:4)(cid:12)(cid:2)(cid:28)(cid:3,Unknown,4944.0
Unknown,Unknown,19,Unknown,Unknown,Unknown,Unknown,cid:50)(cid:46)(cid:12)(cid:2)(cid:7)(cid:8)(cid:10)(cid:5)(cid:3)(cid:48)(cid:46)(cid:3)(cid:12)(cid:13)(cid:5)(cid:2)(cid:14)(cid:46)(cid:2)(cid:28)(cid:5)(cid:3)(cid:10)(cid:5)(cid:2)(cid:64)(cid:46)(cid:4)(cid:12)(cid:2)(cid:28)(cid:3,Unknown,4963.0
Unknown,Unknown,18,Unknown,Unknown,Unknown,Unknown,cid:50)(cid:46)(cid:12)(cid:2)(cid:7)(cid:8)(cid:10)(cid:5)(cid:3)(cid:48)(cid:46)(cid:3)(cid:12)(cid:13)(cid:5)(cid:2)(cid:14)(cid:46)(cid:2)(cid:28)(cid:5)(cid:3)(cid:10)(cid:5)(cid:2)(cid:64)(cid:46)(cid:4)(cid:12)(cid:2)(cid:28)(cid:3,Unknown,4981.0
Unknown,Unknown,18,Unknown,Unknown,Unknown,Unknown,cid:50)(cid:46)(cid:12)(cid:2)(cid:7)(cid:8)(cid:10)(cid:5)(cid:3)(cid:48)(cid:46)(cid:3)(cid:12)(cid:13)(cid:5)(cid:2)(cid:14)(cid:46)(cid:2)(cid:28)(cid:5)(cid:3)(cid:10)(cid:5)(cid:2)(cid:64)(cid:46)(cid:4)(cid:12)(cid:2)(cid:28)(cid:3,Unknown,4999.0
Unknown,Unknown,2,Unknown,Unknown,Unknown,Unknown,cid:50)(cid:46)(cid:12)(cid:2)(cid:7)(cid:8)(cid:10)(cid:5)(cid:3)(cid:48)(cid:46)(cid:3)(cid:12)(cid:13)(cid:5)(cid:2)(cid:14)(cid:46)(cid:2)(cid:28)(cid:5)(cid:3)(cid:10)(cid:5)(cid:2)(cid:64)(cid:46)(cid:4)(cid:12)(cid:2)(cid:28)(cid:3,Unknown,5001.0
Unknown,Unknown,44,Unknown,Unknown,Unknown,Unknown,cid:50)(cid:46)(cid:12)(cid:2)(cid:7)(cid:8)(cid:10)(cid:5)(cid:3)(cid:48)(cid:46)(cid:3)(cid:12)(cid:13)(cid:5)(cid:2)(cid:14)(cid:46)(cid:2)(cid:28)(cid:5)(cid:3)(cid:10)(cid:5)(cid:2)(cid:64)(cid:46)(cid:4)(cid:12)(cid:2)(cid:28)(cid:3,Unknown,5045.0
Unknown,Unknown,51,Unknown,Unknown,Unknown,Unknown,cid:50)(cid:46)(cid:12)(cid:2)(cid:7)(cid:8)(cid:10)(cid:5)(cid:3)(cid:48)(cid:46)(cid:3)(cid:12)(cid:13)(cid:5)(cid:2)(cid:14)(cid:46)(cid:2)(cid:28)(cid:5)(cid:3)(cid:10)(cid:5)(cid:2)(cid:64)(cid:46)(cid:4)(cid:12)(cid:2)(cid:28)(cid:3,Unknown,5096.0
Unknown,Unknown,29,Unknown,Unknown,Unknown,Unknown,cid:50)(cid:46)(cid:12)(cid:2)(cid:7)(cid:8)(cid:10)(cid:5)(cid:3)(cid:48)(cid:46)(cid:3)(cid:12)(cid:13)(cid:5)(cid:2)(cid:14)(cid:46)(cid:2)(cid:28)(cid:5)(cid:3)(cid:10)(cid:5)(cid:2)(cid:64)(cid:46)(cid:4)(cid:12)(cid:2)(cid:28)(cid:3,Unknown,5125.0
Unknown,Unknown,24,Unknown,Unknown,Unknown,Unknown,cid:50)(cid:46)(cid:12)(cid:2)(cid:7)(cid:8)(cid:10)(cid:5)(cid:3)(cid:48)(cid:46)(cid:3)(cid:12)(cid:13)(cid:5)(cid:2)(cid:14)(cid:46)(cid:2)(cid:28)(cid:5)(cid:3)(cid:10)(cid:5)(cid:2)(cid:64)(cid:46)(cid:4)(cid:12)(cid:2)(cid:28)(cid:3,Unknown,5149.0
Unknown,Unknown,25,Unknown,Unknown,Unknown,Unknown,cid:50)(cid:46)(cid:12)(cid:2)(cid:7)(cid:8)(cid:10)(cid:5)(cid:3)(cid:48)(cid:46)(cid:3)(cid:12)(cid:13)(cid:5)(cid:2)(cid:14)(cid:46)(cid:2)(cid:28)(cid:5)(cid:3)(cid:10)(cid:5)(cid:2)(cid:64)(cid:46)(cid:4)(cid:12)(cid:2)(cid:28)(cid:3,Unknown,5174.0
Unknown,Unknown,23,Unknown,Unknown,Unknown,Unknown,cid:50)(cid:46)(cid:12)(cid:2)(cid:7)(cid:8)(cid:10)(cid:5)(cid:3)(cid:48)(cid:46)(cid:3)(cid:12)(cid:13)(cid:5)(cid:2)(cid:14)(cid:46)(cid:2)(cid:28)(cid:5)(cid:3)(cid:10)(cid:5)(cid:2)(cid:64)(cid:46)(cid:4)(cid:12)(cid:2)(cid:28)(cid:3,Unknown,5197.0
Unknown,Unknown,25,Unknown,Unknown,Unknown,Unknown,cid:50)(cid:46)(cid:12)(cid:2)(cid:7)(cid:8)(cid:10)(cid:5)(cid:3)(cid:48)(cid:46)(cid:3)(cid:12)(cid:13)(cid:5)(cid:2)(cid:14)(cid:46)(cid:2)(cid:28)(cid:5)(cid:3)(cid:10)(cid:5)(cid:2)(cid:64)(cid:46)(cid:4)(cid:12)(cid:2)(cid:28)(cid:3,Unknown,5222.0
Unknown,Unknown,30,Unknown,Unknown,Unknown,Unknown,cid:50)(cid:46)(cid:12)(cid:2)(cid:7)(cid:8)(cid:10)(cid:5)(cid:3)(cid:48)(cid:46)(cid:3)(cid:12)(cid:13)(cid:5)(cid:2)(cid:14)(cid:46)(cid:2)(cid:28)(cid:5)(cid:3)(cid:10)(cid:5)(cid:2)(cid:64)(cid:46)(cid:4)(cid:12)(cid:2)(cid:28)(cid:3,Unknown,5252.0
Unknown,Unknown,41,Unknown,Unknown,Unknown,Unknown,cid:50)(cid:46)(cid:12)(cid:2)(cid:7)(cid:8)(cid:10)(cid:5)(cid:3)(cid:48)(cid:46)(cid:3)(cid:12)(cid:13)(cid:5)(cid:2)(cid:14)(cid:46)(cid:2)(cid:28)(cid:5)(cid:3)(cid:10)(cid:5)(cid:2)(cid:64)(cid:46)(cid:4)(cid:12)(cid:2)(cid:28)(cid:3,Unknown,5293.0
Unknown,Unknown,18,Unknown,Unknown,Unknown,Unknown,cid:50)(cid:46)(cid:12)(cid:2)(cid:7)(cid:8)(cid:10)(cid:5)(cid:3)(cid:48)(cid:46)(cid:3)(cid:12)(cid:13)(cid:5)(cid:2)(cid:14)(cid:46)(cid:2)(cid:28)(cid:5)(cid:3)(cid:10)(cid:5)(cid:2)(cid:64)(cid:46)(cid:4)(cid:12)(cid:2)(cid:28)(cid:3,Unknown,5311.0
Unknown,Unknown,34,Unknown,Unknown,Unknown,Unknown,cid:50)(cid:46)(cid:12)(cid:2)(cid:7)(cid:8)(cid:10)(cid:5)(cid:3)(cid:48)(cid:46)(cid:3)(cid:12)(cid:13)(cid:5)(cid:2)(cid:14)(cid:46)(cid:2)(cid:28)(cid:5)(cid:3)(cid:10)(cid:5)(cid:2)(cid:64)(cid:46)(cid:4)(cid:12)(cid:2)(cid:28)(cid:3,Unknown,5345.0
Unknown,Unknown,45,Unknown,Unknown,Unknown,Unknown,cid:50)(cid:46)(cid:12)(cid:2)(cid:7)(cid:8)(cid:10)(cid:5)(cid:3)(cid:48)(cid:46)(cid:3)(cid:12)(cid:13)(cid:5)(cid:2)(cid:14)(cid:46)(cid:2)(cid:28)(cid:5)(cid:3)(cid:10)(cid:5)(cid:2)(cid:64)(cid:46)(cid:4)(cid:12)(cid:2)(cid:28)(cid:3,Unknown,5390.0
Unknown,Unknown,18,Unknown,Unknown,Unknown,Unknown,cid:50)(cid:46)(cid:12)(cid:2)(cid:7)(cid:8)(cid:10)(cid:5)(cid:3)(cid:48)(cid:46)(cid:3)(cid:12)(cid:13)(cid:5)(cid:2)(cid:14)(cid:46)(cid:2)(cid:28)(cid:5)(cid:3)(cid:10)(cid:5)(cid:2)(cid:64)(cid:46)(cid:4)(cid:12)(cid:2)(cid:28)(cid:3,Unknown,5408.0
Unknown,Unknown,16,Unknown,Unknown,Unknown,Unknown,cid:50)(cid:46)(cid:12)(cid:2)(cid:7)(cid:8)(cid:10)(cid:5)(cid:3)(cid:48)(cid:46)(cid:3)(cid:12)(cid:13)(cid:5)(cid:2)(cid:14)(cid:46)(cid:2)(cid:28)(cid:5)(cid:3)(cid:10)(cid:5)(cid:2)(cid:64)(cid:46)(cid:4)(cid:12)(cid:2)(cid:28)(cid:3,Unknown,5424.0
Unknown,Unknown,57,Unknown,Unknown,Unknown,Unknown,cid:50)(cid:46)(cid:12)(cid:2)(cid:7)(cid:8)(cid:10)(cid:5)(cid:3)(cid:48)(cid:46)(cid:3)(cid:12)(cid:13)(cid:5)(cid:2)(cid:14)(cid:46)(cid:2)(cid:28)(cid:5)(cid:3)(cid:10)(cid:5)(cid:2)(cid:64)(cid:46)(cid:4)(cid:12)(cid:2)(cid:28)(cid:3,Unknown,5481.0
Unknown,Unknown,24,Unknown,Unknown,Unknown,Unknown,cid:50)(cid:46)(cid:12)(cid:2)(cid:7)(cid:8)(cid:10)(cid:5)(cid:3)(cid:48)(cid:46)(cid:3)(cid:12)(cid:13)(cid:5)(cid:2)(cid:14)(cid:46)(cid:2)(cid:28)(cid:5)(cid:3)(cid:10)(cid:5)(cid:2)(cid:64)(cid:46)(cid:4)(cid:12)(cid:2)(cid:28)(cid:3,Unknown,5505.0
Unknown,Unknown,30,Unknown,Unknown,Unknown,Unknown,cid:50)(cid:46)(cid:12)(cid:2)(cid:7)(cid:8)(cid:10)(cid:5)(cid:3)(cid:48)(cid:46)(cid:3)(cid:12)(cid:13)(cid:5)(cid:2)(cid:14)(cid:46)(cid:2)(cid:28)(cid:5)(cid:3)(cid:10)(cid:5)(cid:2)(cid:64)(cid:46)(cid:4)(cid:12)(cid:2)(cid:28)(cid:3,Unknown,5535.0
Unknown,Unknown,24,Unknown,Unknown,Unknown,Unknown,cid:50)(cid:46)(cid:12)(cid:2)(cid:7)(cid:8)(cid:10)(cid:5)(cid:3)(cid:48)(cid:46)(cid:3)(cid:12)(cid:13)(cid:5)(cid:2)(cid:14)(cid:46)(cid:2)(cid:28)(cid:5)(cid:3)(cid:10)(cid:5)(cid:2)(cid:64)(cid:46)(cid:4)(cid:12)(cid:2)(cid:28)(cid:3,Unknown,5559.0
Unknown,Unknown,15,Unknown,Unknown,Unknown,Unknown,cid:50)(cid:46)(cid:12)(cid:2)(cid:7)(cid:8)(cid:10)(cid:5)(cid:3)(cid:48)(cid:46)(cid:3)(cid:12)(cid:13)(cid:5)(cid:2)(cid:14)(cid:46)(cid:2)(cid:28)(cid:5)(cid:3)(cid:10)(cid:5)(cid:2)(cid:64)(cid:46)(cid:4)(cid:12)(cid:2)(cid:28)(cid:3,Unknown,5574.0
Unknown,Unknown,2,Unknown,Unknown,Unknown,Unknown,cid:50)(cid:46)(cid:12)(cid:2)(cid:7)(cid:8)(cid:10)(cid:5)(cid:3)(cid:48)(cid:46)(cid:3)(cid:12)(cid:13)(cid:5)(cid:2)(cid:14)(cid:46)(cid:2)(cid:28)(cid:5)(cid:3)(cid:10)(cid:5)(cid:2)(cid:64)(cid:46)(cid:4)(cid:12)(cid:2)(cid:28)(cid:3,Unknown,5576.0
Unknown,Unknown,36,Unknown,Unknown,Unknown,Unknown,cid:50)(cid:46)(cid:12)(cid:2)(cid:7)(cid:8)(cid:10)(cid:5)(cid:3)(cid:48)(cid:46)(cid:3)(cid:12)(cid:13)(cid:5)(cid:2)(cid:14)(cid:46)(cid:2)(cid:28)(cid:5)(cid:3)(cid:10)(cid:5)(cid:2)(cid:64)(cid:46)(cid:4)(cid:12)(cid:2)(cid:28)(cid:3,Unknown,5612.0
Unknown,Unknown,2,Unknown,Unknown,Unknown,Unknown,cid:50)(cid:46)(cid:12)(cid:2)(cid:7)(cid:8)(cid:10)(cid:5)(cid:3)(cid:48)(cid:46)(cid:3)(cid:12)(cid:13)(cid:5)(cid:2)(cid:14)(cid:46)(cid:2)(cid:28)(cid:5)(cid:3)(cid:10)(cid:5)(cid:2)(cid:64)(cid:46)(cid:4)(cid:12)(cid:2)(cid:28)(cid:3,Unknown,5614.0
Unknown,Unknown,18,Unknown,Unknown,Unknown,Unknown,cid:50)(cid:46)(cid:12)(cid:2)(cid:7)(cid:8)(cid:10)(cid:5)(cid:3)(cid:48)(cid:46)(cid:3)(cid:12)(cid:13)(cid:5)(cid:2)(cid:14)(cid:46)(cid:2)(cid:28)(cid:5)(cid:3)(cid:10)(cid:5)(cid:2)(cid:64)(cid:46)(cid:4)(cid:12)(cid:2)(cid:28)(cid:3,Unknown,5632.0
Unknown,Unknown,18,Unknown,Unknown,Unknown,Unknown,cid:50)(cid:46)(cid:12)(cid:2)(cid:7)(cid:8)(cid:10)(cid:5)(cid:3)(cid:48)(cid:46)(cid:3)(cid:12)(cid:13)(cid:5)(cid:2)(cid:14)(cid:46)(cid:2)(cid:28)(cid:5)(cid:3)(cid:10)(cid:5)(cid:2)(cid:64)(cid:46)(cid:4)(cid:12)(cid:2)(cid:28)(cid:3,Unknown,5650.0
Unknown,Unknown,18,Unknown,Unknown,Unknown,Unknown,cid:50)(cid:46)(cid:12)(cid:2)(cid:7)(cid:8)(cid:10)(cid:5)(cid:3)(cid:48)(cid:46)(cid:3)(cid:12)(cid:13)(cid:5)(cid:2)(cid:14)(cid:46)(cid:2)(cid:28)(cid:5)(cid:3)(cid:10)(cid:5)(cid:2)(cid:64)(cid:46)(cid:4)(cid:12)(cid:2)(cid:28)(cid:3,Unknown,5668.0
Unknown,Unknown,19,Unknown,Unknown,Unknown,Unknown,cid:50)(cid:46)(cid:12)(cid:2)(cid:7)(cid:8)(cid:10)(cid:5)(cid:3)(cid:48)(cid:46)(cid:3)(cid:12)(cid:13)(cid:5)(cid:2)(cid:14)(cid:46)(cid:2)(cid:28)(cid:5)(cid:3)(cid:10)(cid:5)(cid:2)(cid:64)(cid:46)(cid:4)(cid:12)(cid:2)(cid:28)(cid:3,Unknown,5687.0
Unknown,Unknown,18,Unknown,Unknown,Unknown,Unknown,cid:50)(cid:46)(cid:12)(cid:2)(cid:7)(cid:8)(cid:10)(cid:5)(cid:3)(cid:48)(cid:46)(cid:3)(cid:12)(cid:13)(cid:5)(cid:2)(cid:14)(cid:46)(cid:2)(cid:28)(cid:5)(cid:3)(cid:10)(cid:5)(cid:2)(cid:64)(cid:46)(cid:4)(cid:12)(cid:2)(cid:28)(cid:3,Unknown,5705.0
Unknown,Unknown,18,Unknown,Unknown,Unknown,Unknown,cid:50)(cid:46)(cid:12)(cid:2)(cid:7)(cid:8)(cid:10)(cid:5)(cid:3)(cid:48)(cid:46)(cid:3)(cid:12)(cid:13)(cid:5)(cid:2)(cid:14)(cid:46)(cid:2)(cid:28)(cid:5)(cid:3)(cid:10)(cid:5)(cid:2)(cid:64)(cid:46)(cid:4)(cid:12)(cid:2)(cid:28)(cid:3,Unknown,5723.0
Unknown,Unknown,2,Unknown,Unknown,Unknown,Unknown,cid:50)(cid:46)(cid:12)(cid:2)(cid:7)(cid:8)(cid:10)(cid:5)(cid:3)(cid:48)(cid:46)(cid:3)(cid:12)(cid:13)(cid:5)(cid:2)(cid:14)(cid:46)(cid:2)(cid:28)(cid:5)(cid:3)(cid:10)(cid:5)(cid:2)(cid:64)(cid:46)(cid:4)(cid:12)(cid:2)(cid:28)(cid:3,Unknown,5725.0
Unknown,Unknown,44,Unknown,Unknown,Unknown,Unknown,cid:50)(cid:46)(cid:12)(cid:2)(cid:7)(cid:8)(cid:10)(cid:5)(cid:3)(cid:48)(cid:46)(cid:3)(cid:12)(cid:13)(cid:5)(cid:2)(cid:14)(cid:46)(cid:2)(cid:28)(cid:5)(cid:3)(cid:10)(cid:5)(cid:2)(cid:64)(cid:46)(cid:4)(cid:12)(cid:2)(cid:28)(cid:3,Unknown,5769.0
Unknown,Unknown,51,Unknown,Unknown,Unknown,Unknown,cid:50)(cid:46)(cid:12)(cid:2)(cid:7)(cid:8)(cid:10)(cid:5)(cid:3)(cid:48)(cid:46)(cid:3)(cid:12)(cid:13)(cid:5)(cid:2)(cid:14)(cid:46)(cid:2)(cid:28)(cid:5)(cid:3)(cid:10)(cid:5)(cid:2)(cid:64)(cid:46)(cid:4)(cid:12)(cid:2)(cid:28)(cid:3,Unknown,5820.0
Unknown,Unknown,29,Unknown,Unknown,Unknown,Unknown,cid:50)(cid:46)(cid:12)(cid:2)(cid:7)(cid:8)(cid:10)(cid:5)(cid:3)(cid:48)(cid:46)(cid:3)(cid:12)(cid:13)(cid:5)(cid:2)(cid:14)(cid:46)(cid:2)(cid:28)(cid:5)(cid:3)(cid:10)(cid:5)(cid:2)(cid:64)(cid:46)(cid:4)(cid:12)(cid:2)(cid:28)(cid:3,Unknown,5849.0
Unknown,Unknown,24,Unknown,Unknown,Unknown,Unknown,cid:50)(cid:46)(cid:12)(cid:2)(cid:7)(cid:8)(cid:10)(cid:5)(cid:3)(cid:48)(cid:46)(cid:3)(cid:12)(cid:13)(cid:5)(cid:2)(cid:14)(cid:46)(cid:2)(cid:28)(cid:5)(cid:3)(cid:10)(cid:5)(cid:2)(cid:64)(cid:46)(cid:4)(cid:12)(cid:2)(cid:28)(cid:3,Unknown,5873.0
Unknown,Unknown,25,Unknown,Unknown,Unknown,Unknown,cid:50)(cid:46)(cid:12)(cid:2)(cid:7)(cid:8)(cid:10)(cid:5)(cid:3)(cid:48)(cid:46)(cid:3)(cid:12)(cid:13)(cid:5)(cid:2)(cid:14)(cid:46)(cid:2)(cid:28)(cid:5)(cid:3)(cid:10)(cid:5)(cid:2)(cid:64)(cid:46)(cid:4)(cid:12)(cid:2)(cid:28)(cid:3,Unknown,5898.0
Unknown,Unknown,23,Unknown,Unknown,Unknown,Unknown,cid:50)(cid:46)(cid:12)(cid:2)(cid:7)(cid:8)(cid:10)(cid:5)(cid:3)(cid:48)(cid:46)(cid:3)(cid:12)(cid:13)(cid:5)(cid:2)(cid:14)(cid:46)(cid:2)(cid:28)(cid:5)(cid:3)(cid:10)(cid:5)(cid:2)(cid:64)(cid:46)(cid:4)(cid:12)(cid:2)(cid:28)(cid:3,Unknown,5921.0
Unknown,Unknown,25,Unknown,Unknown,Unknown,Unknown,cid:50)(cid:46)(cid:12)(cid:2)(cid:7)(cid:8)(cid:10)(cid:5)(cid:3)(cid:48)(cid:46)(cid:3)(cid:12)(cid:13)(cid:5)(cid:2)(cid:14)(cid:46)(cid:2)(cid:28)(cid:5)(cid:3)(cid:10)(cid:5)(cid:2)(cid:64)(cid:46)(cid:4)(cid:12)(cid:2)(cid:28)(cid:3,Unknown,5946.0
Unknown,Unknown,30,Unknown,Unknown,Unknown,Unknown,cid:50)(cid:46)(cid:12)(cid:2)(cid:7)(cid:8)(cid:10)(cid:5)(cid:3)(cid:48)(cid:46)(cid:3)(cid:12)(cid:13)(cid:5)(cid:2)(cid:14)(cid:46)(cid:2)(cid:28)(cid:5)(cid:3)(cid:10)(cid:5)(cid:2)(cid:64)(cid:46)(cid:4)(cid:12)(cid:2)(cid:28)(cid:3,Unknown,5976.0
Unknown,Unknown,41,Unknown,Unknown,Unknown,Unknown,cid:50)(cid:46)(cid:12)(cid:2)(cid:7)(cid:8)(cid:10)(cid:5)(cid:3)(cid:48)(cid:46)(cid:3)(cid:12)(cid:13)(cid:5)(cid:2)(cid:14)(cid:46)(cid:2)(cid:28)(cid:5)(cid:3)(cid:10)(cid:5)(cid:2)(cid:64)(cid:46)(cid:4)(cid:12)(cid:2)(cid:28)(cid:3,Unknown,6017.0
Unknown,Unknown,18,Unknown,Unknown,Unknown,Unknown,cid:50)(cid:46)(cid:12)(cid:2)(cid:7)(cid:8)(cid:10)(cid:5)(cid:3)(cid:48)(cid:46)(cid:3)(cid:12)(cid:13)(cid:5)(cid:2)(cid:14)(cid:46)(cid:2)(cid:28)(cid:5)(cid:3)(cid:10)(cid:5)(cid:2)(cid:64)(cid:46)(cid:4)(cid:12)(cid:2)(cid:28)(cid:3,Unknown,6035.0
Unknown,Unknown,34,Unknown,Unknown,Unknown,Unknown,cid:50)(cid:46)(cid:12)(cid:2)(cid:7)(cid:8)(cid:10)(cid:5)(cid:3)(cid:48)(cid:46)(cid:3)(cid:12)(cid:13)(cid:5)(cid:2)(cid:14)(cid:46)(cid:2)(cid:28)(cid:5)(cid:3)(cid:10)(cid:5)(cid:2)(cid:64)(cid:46)(cid:4)(cid:12)(cid:2)(cid:28)(cid:3,Unknown,6069.0
Unknown,Unknown,45,Unknown,Unknown,Unknown,Unknown,cid:50)(cid:46)(cid:12)(cid:2)(cid:7)(cid:8)(cid:10)(cid:5)(cid:3)(cid:48)(cid:46)(cid:3)(cid:12)(cid:13)(cid:5)(cid:2)(cid:14)(cid:46)(cid:2)(cid:28)(cid:5)(cid:3)(cid:10)(cid:5)(cid:2)(cid:64)(cid:46)(cid:4)(cid:12)(cid:2)(cid:28)(cid:3,Unknown,6114.0
Unknown,Unknown,18,Unknown,Unknown,Unknown,Unknown,cid:50)(cid:46)(cid:12)(cid:2)(cid:7)(cid:8)(cid:10)(cid:5)(cid:3)(cid:48)(cid:46)(cid:3)(cid:12)(cid:13)(cid:5)(cid:2)(cid:14)(cid:46)(cid:2)(cid:28)(cid:5)(cid:3)(cid:10)(cid:5)(cid:2)(cid:64)(cid:46)(cid:4)(cid:12)(cid:2)(cid:28)(cid:3,Unknown,6132.0
Unknown,Unknown,16,Unknown,Unknown,Unknown,Unknown,cid:50)(cid:46)(cid:12)(cid:2)(cid:7)(cid:8)(cid:10)(cid:5)(cid:3)(cid:48)(cid:46)(cid:3)(cid:12)(cid:13)(cid:5)(cid:2)(cid:14)(cid:46)(cid:2)(cid:28)(cid:5)(cid:3)(cid:10)(cid:5)(cid:2)(cid:64)(cid:46)(cid:4)(cid:12)(cid:2)(cid:28)(cid:3,Unknown,6148.0
Unknown,Unknown,10,Unknown,Unknown,Unknown,Unknown,cid:50)(cid:46)(cid:12)(cid:2)(cid:7)(cid:8)(cid:10)(cid:5)(cid:3)(cid:48)(cid:46)(cid:3)(cid:12)(cid:13)(cid:5)(cid:2)(cid:14)(cid:46)(cid:2)(cid:28)(cid:5)(cid:3)(cid:10)(cid:5)(cid:2)(cid:64)(cid:46)(cid:4)(cid:12)(cid:2)(cid:28)(cid:3,Unknown,6158.0
Unknown,Unknown,11,Unknown,Unknown,Unknown,Unknown,cid:50)(cid:46)(cid:12)(cid:2)(cid:7)(cid:8)(cid:10)(cid:5)(cid:3)(cid:48)(cid:46)(cid:3)(cid:12)(cid:13)(cid:5)(cid:2)(cid:14)(cid:46)(cid:2)(cid:28)(cid:5)(cid:3)(cid:10)(cid:5)(cid:2)(cid:64)(cid:46)(cid:4)(cid:12)(cid:2)(cid:28)(cid:3,Unknown,6169.0
Unknown,Unknown,10,Unknown,Unknown,Unknown,Unknown,cid:50)(cid:46)(cid:12)(cid:2)(cid:7)(cid:8)(cid:10)(cid:5)(cid:3)(cid:48)(cid:46)(cid:3)(cid:12)(cid:13)(cid:5)(cid:2)(cid:14)(cid:46)(cid:2)(cid:28)(cid:5)(cid:3)(cid:10)(cid:5)(cid:2)(cid:64)(cid:46)(cid:4)(cid:12)(cid:2)(cid:28)(cid:3,Unknown,6179.0
Unknown,Unknown,46,Unknown,Unknown,Unknown,Unknown,cid:50)(cid:46)(cid:12)(cid:2)(cid:7)(cid:8)(cid:10)(cid:5)(cid:3)(cid:48)(cid:46)(cid:3)(cid:12)(cid:13)(cid:5)(cid:2)(cid:14)(cid:46)(cid:2)(cid:28)(cid:5)(cid:3)(cid:10)(cid:5)(cid:2)(cid:64)(cid:46)(cid:4)(cid:12)(cid:2)(cid:28)(cid:3,Unknown,6225.0
Unknown,Unknown,14,Unknown,Unknown,Unknown,Unknown,cid:50)(cid:46)(cid:12)(cid:2)(cid:7)(cid:8)(cid:10)(cid:5)(cid:3)(cid:48)(cid:46)(cid:3)(cid:12)(cid:13)(cid:5)(cid:2)(cid:14)(cid:46)(cid:2)(cid:28)(cid:5)(cid:3)(cid:10)(cid:5)(cid:2)(cid:64)(cid:46)(cid:4)(cid:12)(cid:2)(cid:28)(cid:3,Unknown,6239.0
Unknown,Unknown,2,Unknown,Unknown,Unknown,Unknown,cid:50)(cid:46)(cid:12)(cid:2)(cid:7)(cid:8)(cid:10)(cid:5)(cid:3)(cid:48)(cid:46)(cid:3)(cid:12)(cid:13)(cid:5)(cid:2)(cid:14)(cid:46)(cid:2)(cid:28)(cid:5)(cid:3)(cid:10)(cid:5)(cid:2)(cid:64)(cid:46)(cid:4)(cid:12)(cid:2)(cid:28)(cid:3,Unknown,6241.0
Unknown,Unknown,12,Unknown,Unknown,Unknown,Unknown,cid:50)(cid:46)(cid:12)(cid:2)(cid:7)(cid:8)(cid:10)(cid:5)(cid:3)(cid:48)(cid:46)(cid:3)(cid:12)(cid:13)(cid:5)(cid:2)(cid:14)(cid:46)(cid:2)(cid:28)(cid:5)(cid:3)(cid:10)(cid:5)(cid:2)(cid:64)(cid:46)(cid:4)(cid:12)(cid:2)(cid:28)(cid:3,Unknown,6253.0
Unknown,Unknown,11,Unknown,Unknown,Unknown,Unknown,cid:50)(cid:46)(cid:12)(cid:2)(cid:7)(cid:8)(cid:10)(cid:5)(cid:3)(cid:48)(cid:46)(cid:3)(cid:12)(cid:13)(cid:5)(cid:2)(cid:14)(cid:46)(cid:2)(cid:28)(cid:5)(cid:3)(cid:10)(cid:5)(cid:2)(cid:64)(cid:46)(cid:4)(cid:12)(cid:2)(cid:28)(cid:3,Unknown,6264.0
Unknown,Unknown,4,Unknown,Unknown,Unknown,Unknown,cid:50)(cid:46)(cid:12)(cid:2)(cid:7)(cid:8)(cid:10)(cid:5)(cid:3)(cid:48)(cid:46)(cid:3)(cid:12)(cid:13)(cid:5)(cid:2)(cid:14)(cid:46)(cid:2)(cid:28)(cid:5)(cid:3)(cid:10)(cid:5)(cid:2)(cid:64)(cid:46)(cid:4)(cid:12)(cid:2)(cid:28)(cid:3,Unknown,6268.0
Unknown,Unknown,14,Unknown,Unknown,Unknown,Unknown,cid:50)(cid:46)(cid:12)(cid:2)(cid:7)(cid:8)(cid:10)(cid:5)(cid:3)(cid:48)(cid:46)(cid:3)(cid:12)(cid:13)(cid:5)(cid:2)(cid:14)(cid:46)(cid:2)(cid:28)(cid:5)(cid:3)(cid:10)(cid:5)(cid:2)(cid:64)(cid:46)(cid:4)(cid:12)(cid:2)(cid:28)(cid:3,Unknown,6282.0
Unknown,Unknown,11,Unknown,Unknown,Unknown,Unknown,cid:50)(cid:46)(cid:12)(cid:2)(cid:7)(cid:8)(cid:10)(cid:5)(cid:3)(cid:48)(cid:46)(cid:3)(cid:12)(cid:13)(cid:5)(cid:2)(cid:14)(cid:46)(cid:2)(cid:28)(cid:5)(cid:3)(cid:10)(cid:5)(cid:2)(cid:64)(cid:46)(cid:4)(cid:12)(cid:2)(cid:28)(cid:3,Unknown,6293.0
Unknown,Unknown,48,Unknown,Unknown,Unknown,Unknown,cid:50)(cid:46)(cid:12)(cid:2)(cid:7)(cid:8)(cid:10)(cid:5)(cid:3)(cid:48)(cid:46)(cid:3)(cid:12)(cid:13)(cid:5)(cid:2)(cid:14)(cid:46)(cid:2)(cid:28)(cid:5)(cid:3)(cid:10)(cid:5)(cid:2)(cid:64)(cid:46)(cid:4)(cid:12)(cid:2)(cid:28)(cid:3,Unknown,6341.0
Unknown,Unknown,48,Unknown,Unknown,Unknown,Unknown,cid:50)(cid:46)(cid:12)(cid:2)(cid:7)(cid:8)(cid:10)(cid:5)(cid:3)(cid:48)(cid:46)(cid:3)(cid:12)(cid:13)(cid:5)(cid:2)(cid:14)(cid:46)(cid:2)(cid:28)(cid:5)(cid:3)(cid:10)(cid:5)(cid:2)(cid:64)(cid:46)(cid:4)(cid:12)(cid:2)(cid:28)(cid:3,Unknown,6389.0
Unknown,Unknown,7,Unknown,Unknown,Unknown,Unknown,cid:50)(cid:46)(cid:12)(cid:2)(cid:7)(cid:8)(cid:10)(cid:5)(cid:3)(cid:48)(cid:46)(cid:3)(cid:12)(cid:13)(cid:5)(cid:2)(cid:14)(cid:46)(cid:2)(cid:28)(cid:5)(cid:3)(cid:10)(cid:5)(cid:2)(cid:64)(cid:46)(cid:4)(cid:12)(cid:2)(cid:28)(cid:3,Unknown,6396.0
Unknown,Unknown,5,Unknown,Unknown,Unknown,Unknown,cid:50)(cid:46)(cid:12)(cid:2)(cid:7)(cid:8)(cid:10)(cid:5)(cid:3)(cid:48)(cid:46)(cid:3)(cid:12)(cid:13)(cid:5)(cid:2)(cid:14)(cid:46)(cid:2)(cid:28)(cid:5)(cid:3)(cid:10)(cid:5)(cid:2)(cid:64)(cid:46)(cid:4)(cid:12)(cid:2)(cid:28)(cid:3,Unknown,6401.0
Unknown,Unknown,3,Unknown,Unknown,Unknown,Unknown,cid:50)(cid:46)(cid:12)(cid:2)(cid:7)(cid:8)(cid:10)(cid:5)(cid:3)(cid:48)(cid:46)(cid:3)(cid:12)(cid:13)(cid:5)(cid:2)(cid:14)(cid:46)(cid:2)(cid:28)(cid:5)(cid:3)(cid:10)(cid:5)(cid:2)(cid:64)(cid:46)(cid:4)(cid:12)(cid:2)(cid:28)(cid:3,Unknown,6404.0
Unknown,Unknown,9,Unknown,Unknown,Unknown,Unknown,cid:50)(cid:46)(cid:12)(cid:2)(cid:7)(cid:8)(cid:10)(cid:5)(cid:3)(cid:48)(cid:46)(cid:3)(cid:12)(cid:13)(cid:5)(cid:2)(cid:14)(cid:46)(cid:2)(cid:28)(cid:5)(cid:3)(cid:10)(cid:5)(cid:2)(cid:64)(cid:46)(cid:4)(cid:12)(cid:2)(cid:28)(cid:3,Unknown,6413.0
Unknown,Unknown,2,Unknown,Unknown,Unknown,Unknown,cid:50)(cid:46)(cid:12)(cid:2)(cid:7)(cid:8)(cid:10)(cid:5)(cid:3)(cid:48)(cid:46)(cid:3)(cid:12)(cid:13)(cid:5)(cid:2)(cid:14)(cid:46)(cid:2)(cid:28)(cid:5)(cid:3)(cid:10)(cid:5)(cid:2)(cid:64)(cid:46)(cid:4)(cid:12)(cid:2)(cid:28)(cid:3,Unknown,6415.0
Unknown,Unknown,28,Unknown,Unknown,Unknown,Unknown,cid:50)(cid:46)(cid:12)(cid:2)(cid:7)(cid:8)(cid:10)(cid:5)(cid:3)(cid:48)(cid:46)(cid:3)(cid:12)(cid:13)(cid:5)(cid:2)(cid:14)(cid:46)(cid:2)(cid:28)(cid:5)(cid:3)(cid:10)(cid:5)(cid:2)(cid:64)(cid:46)(cid:4)(cid:12)(cid:2)(cid:28)(cid:3,Unknown,6443.0
Unknown,Unknown,3,Unknown,Unknown,Unknown,Unknown,cid:50)(cid:46)(cid:12)(cid:2)(cid:7)(cid:8)(cid:10)(cid:5)(cid:3)(cid:48)(cid:46)(cid:3)(cid:12)(cid:13)(cid:5)(cid:2)(cid:14)(cid:46)(cid:2)(cid:28)(cid:5)(cid:3)(cid:10)(cid:5)(cid:2)(cid:64)(cid:46)(cid:4)(cid:12)(cid:2)(cid:28)(cid:3,Unknown,6446.0
Unknown,Unknown,15,Unknown,Unknown,Unknown,Unknown,cid:50)(cid:46)(cid:12)(cid:2)(cid:7)(cid:8)(cid:10)(cid:5)(cid:3)(cid:48)(cid:46)(cid:3)(cid:12)(cid:13)(cid:5)(cid:2)(cid:14)(cid:46)(cid:2)(cid:28)(cid:5)(cid:3)(cid:10)(cid:5)(cid:2)(cid:64)(cid:46)(cid:4)(cid:12)(cid:2)(cid:28)(cid:3,Unknown,6461.0
Unknown,Unknown,2,Unknown,Unknown,Unknown,Unknown,cid:50)(cid:46)(cid:12)(cid:2)(cid:7)(cid:8)(cid:10)(cid:5)(cid:3)(cid:48)(cid:46)(cid:3)(cid:12)(cid:13)(cid:5)(cid:2)(cid:14)(cid:46)(cid:2)(cid:28)(cid:5)(cid:3)(cid:10)(cid:5)(cid:2)(cid:64)(cid:46)(cid:4)(cid:12)(cid:2)(cid:28)(cid:3,Unknown,6463.0
Unknown,Unknown,34,Unknown,Unknown,Unknown,Unknown,cid:50)(cid:46)(cid:12)(cid:2)(cid:7)(cid:8)(cid:10)(cid:5)(cid:3)(cid:48)(cid:46)(cid:3)(cid:12)(cid:13)(cid:5)(cid:2)(cid:14)(cid:46)(cid:2)(cid:28)(cid:5)(cid:3)(cid:10)(cid:5)(cid:2)(cid:64)(cid:46)(cid:4)(cid:12)(cid:2)(cid:28)(cid:3,Unknown,6497.0
Unknown,Unknown,18,Unknown,Unknown,Unknown,Unknown,cid:50)(cid:46)(cid:12)(cid:2)(cid:7)(cid:8)(cid:10)(cid:5)(cid:3)(cid:48)(cid:46)(cid:3)(cid:12)(cid:13)(cid:5)(cid:2)(cid:14)(cid:46)(cid:2)(cid:28)(cid:5)(cid:3)(cid:10)(cid:5)(cid:2)(cid:64)(cid:46)(cid:4)(cid:12)(cid:2)(cid:28)(cid:3,Unknown,6515.0
Unknown,Unknown,19,Unknown,Unknown,Unknown,Unknown,cid:50)(cid:46)(cid:12)(cid:2)(cid:7)(cid:8)(cid:10)(cid:5)(cid:3)(cid:48)(cid:46)(cid:3)(cid:12)(cid:13)(cid:5)(cid:2)(cid:14)(cid:46)(cid:2)(cid:28)(cid:5)(cid:3)(cid:10)(cid:5)(cid:2)(cid:64)(cid:46)(cid:4)(cid:12)(cid:2)(cid:28)(cid:3,Unknown,6534.0
Unknown,Unknown,17,Unknown,Unknown,Unknown,Unknown,cid:50)(cid:46)(cid:12)(cid:2)(cid:7)(cid:8)(cid:10)(cid:5)(cid:3)(cid:48)(cid:46)(cid:3)(cid:12)(cid:13)(cid:5)(cid:2)(cid:14)(cid:46)(cid:2)(cid:28)(cid:5)(cid:3)(cid:10)(cid:5)(cid:2)(cid:64)(cid:46)(cid:4)(cid:12)(cid:2)(cid:28)(cid:3,Unknown,6551.0
Unknown,Unknown,18,Unknown,Unknown,Unknown,Unknown,cid:50)(cid:46)(cid:12)(cid:2)(cid:7)(cid:8)(cid:10)(cid:5)(cid:3)(cid:48)(cid:46)(cid:3)(cid:12)(cid:13)(cid:5)(cid:2)(cid:14)(cid:46)(cid:2)(cid:28)(cid:5)(cid:3)(cid:10)(cid:5)(cid:2)(cid:64)(cid:46)(cid:4)(cid:12)(cid:2)(cid:28)(cid:3,Unknown,6569.0
Unknown,Unknown,2,Unknown,Unknown,Unknown,Unknown,cid:50)(cid:46)(cid:12)(cid:2)(cid:7)(cid:8)(cid:10)(cid:5)(cid:3)(cid:48)(cid:46)(cid:3)(cid:12)(cid:13)(cid:5)(cid:2)(cid:14)(cid:46)(cid:2)(cid:28)(cid:5)(cid:3)(cid:10)(cid:5)(cid:2)(cid:64)(cid:46)(cid:4)(cid:12)(cid:2)(cid:28)(cid:3,Unknown,6571.0
Unknown,Unknown,44,Unknown,Unknown,Unknown,Unknown,cid:50)(cid:46)(cid:12)(cid:2)(cid:7)(cid:8)(cid:10)(cid:5)(cid:3)(cid:48)(cid:46)(cid:3)(cid:12)(cid:13)(cid:5)(cid:2)(cid:14)(cid:46)(cid:2)(cid:28)(cid:5)(cid:3)(cid:10)(cid:5)(cid:2)(cid:64)(cid:46)(cid:4)(cid:12)(cid:2)(cid:28)(cid:3,Unknown,6615.0
Unknown,Unknown,12,Unknown,Unknown,Unknown,Unknown,cid:50)(cid:46)(cid:12)(cid:2)(cid:7)(cid:8)(cid:10)(cid:5)(cid:3)(cid:48)(cid:46)(cid:3)(cid:12)(cid:13)(cid:5)(cid:2)(cid:14)(cid:46)(cid:2)(cid:28)(cid:5)(cid:3)(cid:10)(cid:5)(cid:2)(cid:64)(cid:46)(cid:4)(cid:12)(cid:2)(cid:28)(cid:3,Unknown,6627.0
Unknown,Unknown,29,Unknown,Unknown,Unknown,Unknown,cid:50)(cid:46)(cid:12)(cid:2)(cid:7)(cid:8)(cid:10)(cid:5)(cid:3)(cid:48)(cid:46)(cid:3)(cid:12)(cid:13)(cid:5)(cid:2)(cid:14)(cid:46)(cid:2)(cid:28)(cid:5)(cid:3)(cid:10)(cid:5)(cid:2)(cid:64)(cid:46)(cid:4)(cid:12)(cid:2)(cid:28)(cid:3,Unknown,6656.0
Unknown,Unknown,26,Unknown,Unknown,Unknown,Unknown,cid:50)(cid:46)(cid:12)(cid:2)(cid:7)(cid:8)(cid:10)(cid:5)(cid:3)(cid:48)(cid:46)(cid:3)(cid:12)(cid:13)(cid:5)(cid:2)(cid:14)(cid:46)(cid:2)(cid:28)(cid:5)(cid:3)(cid:10)(cid:5)(cid:2)(cid:64)(cid:46)(cid:4)(cid:12)(cid:2)(cid:28)(cid:3,Unknown,6682.0
Unknown,Unknown,41,Unknown,Unknown,Unknown,Unknown,cid:50)(cid:46)(cid:12)(cid:2)(cid:7)(cid:8)(cid:10)(cid:5)(cid:3)(cid:48)(cid:46)(cid:3)(cid:12)(cid:13)(cid:5)(cid:2)(cid:14)(cid:46)(cid:2)(cid:28)(cid:5)(cid:3)(cid:10)(cid:5)(cid:2)(cid:64)(cid:46)(cid:4)(cid:12)(cid:2)(cid:28)(cid:3,Unknown,6723.0
Unknown,Unknown,25,Unknown,Unknown,Unknown,Unknown,cid:50)(cid:46)(cid:12)(cid:2)(cid:7)(cid:8)(cid:10)(cid:5)(cid:3)(cid:48)(cid:46)(cid:3)(cid:12)(cid:13)(cid:5)(cid:2)(cid:14)(cid:46)(cid:2)(cid:28)(cid:5)(cid:3)(cid:10)(cid:5)(cid:2)(cid:64)(cid:46)(cid:4)(cid:12)(cid:2)(cid:28)(cid:3,Unknown,6748.0
Unknown,Unknown,2,Unknown,Unknown,Unknown,Unknown,cid:50)(cid:46)(cid:12)(cid:2)(cid:7)(cid:8)(cid:10)(cid:5)(cid:3)(cid:48)(cid:46)(cid:3)(cid:12)(cid:13)(cid:5)(cid:2)(cid:14)(cid:46)(cid:2)(cid:28)(cid:5)(cid:3)(cid:10)(cid:5)(cid:2)(cid:64)(cid:46)(cid:4)(cid:12)(cid:2)(cid:28)(cid:3,Unknown,6750.0
Unknown,Unknown,58,Unknown,Unknown,Unknown,Unknown,cid:50)(cid:46)(cid:12)(cid:2)(cid:7)(cid:8)(cid:10)(cid:5)(cid:3)(cid:48)(cid:46)(cid:3)(cid:12)(cid:13)(cid:5)(cid:2)(cid:14)(cid:46)(cid:2)(cid:28)(cid:5)(cid:3)(cid:10)(cid:5)(cid:2)(cid:64)(cid:46)(cid:4)(cid:12)(cid:2)(cid:28)(cid:3,Unknown,6808.0
Unknown,Unknown,58,Unknown,Unknown,Unknown,Unknown,cid:50)(cid:46)(cid:12)(cid:2)(cid:7)(cid:8)(cid:10)(cid:5)(cid:3)(cid:48)(cid:46)(cid:3)(cid:12)(cid:13)(cid:5)(cid:2)(cid:14)(cid:46)(cid:2)(cid:28)(cid:5)(cid:3)(cid:10)(cid:5)(cid:2)(cid:64)(cid:46)(cid:4)(cid:12)(cid:2)(cid:28)(cid:3,Unknown,6866.0
Unknown,Unknown,18,Unknown,Unknown,Unknown,Unknown,cid:50)(cid:46)(cid:12)(cid:2)(cid:7)(cid:8)(cid:10)(cid:5)(cid:3)(cid:48)(cid:46)(cid:3)(cid:12)(cid:13)(cid:5)(cid:2)(cid:14)(cid:46)(cid:2)(cid:28)(cid:5)(cid:3)(cid:10)(cid:5)(cid:2)(cid:64)(cid:46)(cid:4)(cid:12)(cid:2)(cid:28)(cid:3,Unknown,6884.0
Unknown,Unknown,1,Unknown,Unknown,Unknown,Unknown,cid:50)(cid:46)(cid:12)(cid:2)(cid:7)(cid:8)(cid:10)(cid:5)(cid:3)(cid:48)(cid:46)(cid:3)(cid:12)(cid:13)(cid:5)(cid:2)(cid:14)(cid:46)(cid:2)(cid:28)(cid:5)(cid:3)(cid:10)(cid:5)(cid:2)(cid:64)(cid:46)(cid:4)(cid:12)(cid:2)(cid:28)(cid:3,Unknown,6885.0
Unknown,Unknown,1,Unknown,Unknown,Unknown,Unknown,cid:50)(cid:46)(cid:12)(cid:2)(cid:7)(cid:8)(cid:10)(cid:5)(cid:3)(cid:48)(cid:46)(cid:3)(cid:12)(cid:13)(cid:5)(cid:2)(cid:14)(cid:46)(cid:2)(cid:28)(cid:5)(cid:3)(cid:10)(cid:5)(cid:2)(cid:64)(cid:46)(cid:4)(cid:12)(cid:2)(cid:28)(cid:3,Unknown,6886.0
Unknown,Unknown,37,Unknown,Unknown,Unknown,Unknown,cid:50)(cid:46)(cid:12)(cid:2)(cid:7)(cid:8)(cid:10)(cid:5)(cid:3)(cid:48)(cid:46)(cid:3)(cid:12)(cid:13)(cid:5)(cid:2)(cid:14)(cid:46)(cid:2)(cid:28)(cid:5)(cid:3)(cid:10)(cid:5)(cid:2)(cid:64)(cid:46)(cid:4)(cid:12)(cid:2)(cid:28)(cid:3,Unknown,6923.0
Unknown,Unknown,18,Unknown,Unknown,Unknown,Unknown,cid:50)(cid:46)(cid:12)(cid:2)(cid:7)(cid:8)(cid:10)(cid:5)(cid:3)(cid:48)(cid:46)(cid:3)(cid:12)(cid:13)(cid:5)(cid:2)(cid:14)(cid:46)(cid:2)(cid:28)(cid:5)(cid:3)(cid:10)(cid:5)(cid:2)(cid:64)(cid:46)(cid:4)(cid:12)(cid:2)(cid:28)(cid:3,Unknown,6941.0
Unknown,Unknown,34,Unknown,Unknown,Unknown,Unknown,cid:50)(cid:46)(cid:12)(cid:2)(cid:7)(cid:8)(cid:10)(cid:5)(cid:3)(cid:48)(cid:46)(cid:3)(cid:12)(cid:13)(cid:5)(cid:2)(cid:14)(cid:46)(cid:2)(cid:28)(cid:5)(cid:3)(cid:10)(cid:5)(cid:2)(cid:64)(cid:46)(cid:4)(cid:12)(cid:2)(cid:28)(cid:3,Unknown,6975.0
Unknown,Unknown,45,Unknown,Unknown,Unknown,Unknown,cid:50)(cid:46)(cid:12)(cid:2)(cid:7)(cid:8)(cid:10)(cid:5)(cid:3)(cid:48)(cid:46)(cid:3)(cid:12)(cid:13)(cid:5)(cid:2)(cid:14)(cid:46)(cid:2)(cid:28)(cid:5)(cid:3)(cid:10)(cid:5)(cid:2)(cid:64)(cid:46)(cid:4)(cid:12)(cid:2)(cid:28)(cid:3,Unknown,7020.0
Unknown,Unknown,18,Unknown,Unknown,Unknown,Unknown,cid:50)(cid:46)(cid:12)(cid:2)(cid:7)(cid:8)(cid:10)(cid:5)(cid:3)(cid:48)(cid:46)(cid:3)(cid:12)(cid:13)(cid:5)(cid:2)(cid:14)(cid:46)(cid:2)(cid:28)(cid:5)(cid:3)(cid:10)(cid:5)(cid:2)(cid:64)(cid:46)(cid:4)(cid:12)(cid:2)(cid:28)(cid:3,Unknown,7038.0
Unknown,Unknown,16,Unknown,Unknown,Unknown,Unknown,cid:50)(cid:46)(cid:12)(cid:2)(cid:7)(cid:8)(cid:10)(cid:5)(cid:3)(cid:48)(cid:46)(cid:3)(cid:12)(cid:13)(cid:5)(cid:2)(cid:14)(cid:46)(cid:2)(cid:28)(cid:5)(cid:3)(cid:10)(cid:5)(cid:2)(cid:64)(cid:46)(cid:4)(cid:12)(cid:2)(cid:28)(cid:3,Unknown,7054.0
Unknown,Unknown,10,Unknown,Unknown,Unknown,Unknown,cid:50)(cid:46)(cid:12)(cid:2)(cid:7)(cid:8)(cid:10)(cid:5)(cid:3)(cid:48)(cid:46)(cid:3)(cid:12)(cid:13)(cid:5)(cid:2)(cid:14)(cid:46)(cid:2)(cid:28)(cid:5)(cid:3)(cid:10)(cid:5)(cid:2)(cid:64)(cid:46)(cid:4)(cid:12)(cid:2)(cid:28)(cid:3,Unknown,7064.0
Unknown,Unknown,11,Unknown,Unknown,Unknown,Unknown,cid:50)(cid:46)(cid:12)(cid:2)(cid:7)(cid:8)(cid:10)(cid:5)(cid:3)(cid:48)(cid:46)(cid:3)(cid:12)(cid:13)(cid:5)(cid:2)(cid:14)(cid:46)(cid:2)(cid:28)(cid:5)(cid:3)(cid:10)(cid:5)(cid:2)(cid:64)(cid:46)(cid:4)(cid:12)(cid:2)(cid:28)(cid:3,Unknown,7075.0
Unknown,Unknown,10,Unknown,Unknown,Unknown,Unknown,cid:50)(cid:46)(cid:12)(cid:2)(cid:7)(cid:8)(cid:10)(cid:5)(cid:3)(cid:48)(cid:46)(cid:3)(cid:12)(cid:13)(cid:5)(cid:2)(cid:14)(cid:46)(cid:2)(cid:28)(cid:5)(cid:3)(cid:10)(cid:5)(cid:2)(cid:64)(cid:46)(cid:4)(cid:12)(cid:2)(cid:28)(cid:3,Unknown,7085.0
Unknown,Unknown,46,Unknown,Unknown,Unknown,Unknown,cid:50)(cid:46)(cid:12)(cid:2)(cid:7)(cid:8)(cid:10)(cid:5)(cid:3)(cid:48)(cid:46)(cid:3)(cid:12)(cid:13)(cid:5)(cid:2)(cid:14)(cid:46)(cid:2)(cid:28)(cid:5)(cid:3)(cid:10)(cid:5)(cid:2)(cid:64)(cid:46)(cid:4)(cid:12)(cid:2)(cid:28)(cid:3,Unknown,7131.0
Unknown,Unknown,14,Unknown,Unknown,Unknown,Unknown,cid:50)(cid:46)(cid:12)(cid:2)(cid:7)(cid:8)(cid:10)(cid:5)(cid:3)(cid:48)(cid:46)(cid:3)(cid:12)(cid:13)(cid:5)(cid:2)(cid:14)(cid:46)(cid:2)(cid:28)(cid:5)(cid:3)(cid:10)(cid:5)(cid:2)(cid:64)(cid:46)(cid:4)(cid:12)(cid:2)(cid:28)(cid:3,Unknown,7145.0
Unknown,Unknown,2,Unknown,Unknown,Unknown,Unknown,cid:50)(cid:46)(cid:12)(cid:2)(cid:7)(cid:8)(cid:10)(cid:5)(cid:3)(cid:48)(cid:46)(cid:3)(cid:12)(cid:13)(cid:5)(cid:2)(cid:14)(cid:46)(cid:2)(cid:28)(cid:5)(cid:3)(cid:10)(cid:5)(cid:2)(cid:64)(cid:46)(cid:4)(cid:12)(cid:2)(cid:28)(cid:3,Unknown,7147.0
Unknown,Unknown,12,Unknown,Unknown,Unknown,Unknown,cid:50)(cid:46)(cid:12)(cid:2)(cid:7)(cid:8)(cid:10)(cid:5)(cid:3)(cid:48)(cid:46)(cid:3)(cid:12)(cid:13)(cid:5)(cid:2)(cid:14)(cid:46)(cid:2)(cid:28)(cid:5)(cid:3)(cid:10)(cid:5)(cid:2)(cid:64)(cid:46)(cid:4)(cid:12)(cid:2)(cid:28)(cid:3,Unknown,7159.0
Unknown,Unknown,11,Unknown,Unknown,Unknown,Unknown,cid:50)(cid:46)(cid:12)(cid:2)(cid:7)(cid:8)(cid:10)(cid:5)(cid:3)(cid:48)(cid:46)(cid:3)(cid:12)(cid:13)(cid:5)(cid:2)(cid:14)(cid:46)(cid:2)(cid:28)(cid:5)(cid:3)(cid:10)(cid:5)(cid:2)(cid:64)(cid:46)(cid:4)(cid:12)(cid:2)(cid:28)(cid:3,Unknown,7170.0
Unknown,Unknown,4,Unknown,Unknown,Unknown,Unknown,cid:50)(cid:46)(cid:12)(cid:2)(cid:7)(cid:8)(cid:10)(cid:5)(cid:3)(cid:48)(cid:46)(cid:3)(cid:12)(cid:13)(cid:5)(cid:2)(cid:14)(cid:46)(cid:2)(cid:28)(cid:5)(cid:3)(cid:10)(cid:5)(cid:2)(cid:64)(cid:46)(cid:4)(cid:12)(cid:2)(cid:28)(cid:3,Unknown,7174.0
Unknown,Unknown,14,Unknown,Unknown,Unknown,Unknown,cid:50)(cid:46)(cid:12)(cid:2)(cid:7)(cid:8)(cid:10)(cid:5)(cid:3)(cid:48)(cid:46)(cid:3)(cid:12)(cid:13)(cid:5)(cid:2)(cid:14)(cid:46)(cid:2)(cid:28)(cid:5)(cid:3)(cid:10)(cid:5)(cid:2)(cid:64)(cid:46)(cid:4)(cid:12)(cid:2)(cid:28)(cid:3,Unknown,7188.0
Unknown,Unknown,11,Unknown,Unknown,Unknown,Unknown,cid:50)(cid:46)(cid:12)(cid:2)(cid:7)(cid:8)(cid:10)(cid:5)(cid:3)(cid:48)(cid:46)(cid:3)(cid:12)(cid:13)(cid:5)(cid:2)(cid:14)(cid:46)(cid:2)(cid:28)(cid:5)(cid:3)(cid:10)(cid:5)(cid:2)(cid:64)(cid:46)(cid:4)(cid:12)(cid:2)(cid:28)(cid:3,Unknown,7199.0
Unknown,Unknown,48,Unknown,Unknown,Unknown,Unknown,cid:50)(cid:46)(cid:12)(cid:2)(cid:7)(cid:8)(cid:10)(cid:5)(cid:3)(cid:48)(cid:46)(cid:3)(cid:12)(cid:13)(cid:5)(cid:2)(cid:14)(cid:46)(cid:2)(cid:28)(cid:5)(cid:3)(cid:10)(cid:5)(cid:2)(cid:64)(cid:46)(cid:4)(cid:12)(cid:2)(cid:28)(cid:3,Unknown,7247.0
Unknown,Unknown,48,Unknown,Unknown,Unknown,Unknown,cid:50)(cid:46)(cid:12)(cid:2)(cid:7)(cid:8)(cid:10)(cid:5)(cid:3)(cid:48)(cid:46)(cid:3)(cid:12)(cid:13)(cid:5)(cid:2)(cid:14)(cid:46)(cid:2)(cid:28)(cid:5)(cid:3)(cid:10)(cid:5)(cid:2)(cid:64)(cid:46)(cid:4)(cid:12)(cid:2)(cid:28)(cid:3,Unknown,7295.0
Unknown,Unknown,7,Unknown,Unknown,Unknown,Unknown,cid:50)(cid:46)(cid:12)(cid:2)(cid:7)(cid:8)(cid:10)(cid:5)(cid:3)(cid:48)(cid:46)(cid:3)(cid:12)(cid:13)(cid:5)(cid:2)(cid:14)(cid:46)(cid:2)(cid:28)(cid:5)(cid:3)(cid:10)(cid:5)(cid:2)(cid:64)(cid:46)(cid:4)(cid:12)(cid:2)(cid:28)(cid:3,Unknown,7302.0
Unknown,Unknown,5,Unknown,Unknown,Unknown,Unknown,cid:50)(cid:46)(cid:12)(cid:2)(cid:7)(cid:8)(cid:10)(cid:5)(cid:3)(cid:48)(cid:46)(cid:3)(cid:12)(cid:13)(cid:5)(cid:2)(cid:14)(cid:46)(cid:2)(cid:28)(cid:5)(cid:3)(cid:10)(cid:5)(cid:2)(cid:64)(cid:46)(cid:4)(cid:12)(cid:2)(cid:28)(cid:3,Unknown,7307.0
Unknown,Unknown,3,Unknown,Unknown,Unknown,Unknown,cid:50)(cid:46)(cid:12)(cid:2)(cid:7)(cid:8)(cid:10)(cid:5)(cid:3)(cid:48)(cid:46)(cid:3)(cid:12)(cid:13)(cid:5)(cid:2)(cid:14)(cid:46)(cid:2)(cid:28)(cid:5)(cid:3)(cid:10)(cid:5)(cid:2)(cid:64)(cid:46)(cid:4)(cid:12)(cid:2)(cid:28)(cid:3,Unknown,7310.0
Unknown,Unknown,9,Unknown,Unknown,Unknown,Unknown,cid:50)(cid:46)(cid:12)(cid:2)(cid:7)(cid:8)(cid:10)(cid:5)(cid:3)(cid:48)(cid:46)(cid:3)(cid:12)(cid:13)(cid:5)(cid:2)(cid:14)(cid:46)(cid:2)(cid:28)(cid:5)(cid:3)(cid:10)(cid:5)(cid:2)(cid:64)(cid:46)(cid:4)(cid:12)(cid:2)(cid:28)(cid:3,Unknown,7319.0
Unknown,Unknown,2,Unknown,Unknown,Unknown,Unknown,cid:50)(cid:46)(cid:12)(cid:2)(cid:7)(cid:8)(cid:10)(cid:5)(cid:3)(cid:48)(cid:46)(cid:3)(cid:12)(cid:13)(cid:5)(cid:2)(cid:14)(cid:46)(cid:2)(cid:28)(cid:5)(cid:3)(cid:10)(cid:5)(cid:2)(cid:64)(cid:46)(cid:4)(cid:12)(cid:2)(cid:28)(cid:3,Unknown,7321.0
Unknown,Unknown,28,Unknown,Unknown,Unknown,Unknown,cid:50)(cid:46)(cid:12)(cid:2)(cid:7)(cid:8)(cid:10)(cid:5)(cid:3)(cid:48)(cid:46)(cid:3)(cid:12)(cid:13)(cid:5)(cid:2)(cid:14)(cid:46)(cid:2)(cid:28)(cid:5)(cid:3)(cid:10)(cid:5)(cid:2)(cid:64)(cid:46)(cid:4)(cid:12)(cid:2)(cid:28)(cid:3,Unknown,7349.0
Unknown,Unknown,3,Unknown,Unknown,Unknown,Unknown,cid:50)(cid:46)(cid:12)(cid:2)(cid:7)(cid:8)(cid:10)(cid:5)(cid:3)(cid:48)(cid:46)(cid:3)(cid:12)(cid:13)(cid:5)(cid:2)(cid:14)(cid:46)(cid:2)(cid:28)(cid:5)(cid:3)(cid:10)(cid:5)(cid:2)(cid:64)(cid:46)(cid:4)(cid:12)(cid:2)(cid:28)(cid:3,Unknown,7352.0
Unknown,Unknown,15,Unknown,Unknown,Unknown,Unknown,cid:50)(cid:46)(cid:12)(cid:2)(cid:7)(cid:8)(cid:10)(cid:5)(cid:3)(cid:48)(cid:46)(cid:3)(cid:12)(cid:13)(cid:5)(cid:2)(cid:14)(cid:46)(cid:2)(cid:28)(cid:5)(cid:3)(cid:10)(cid:5)(cid:2)(cid:64)(cid:46)(cid:4)(cid:12)(cid:2)(cid:28)(cid:3,Unknown,7367.0
Unknown,Unknown,2,Unknown,Unknown,Unknown,Unknown,cid:50)(cid:46)(cid:12)(cid:2)(cid:7)(cid:8)(cid:10)(cid:5)(cid:3)(cid:48)(cid:46)(cid:3)(cid:12)(cid:13)(cid:5)(cid:2)(cid:14)(cid:46)(cid:2)(cid:28)(cid:5)(cid:3)(cid:10)(cid:5)(cid:2)(cid:64)(cid:46)(cid:4)(cid:12)(cid:2)(cid:28)(cid:3,Unknown,7369.0
Unknown,Unknown,34,Unknown,Unknown,Unknown,Unknown,cid:50)(cid:46)(cid:12)(cid:2)(cid:7)(cid:8)(cid:10)(cid:5)(cid:3)(cid:48)(cid:46)(cid:3)(cid:12)(cid:13)(cid:5)(cid:2)(cid:14)(cid:46)(cid:2)(cid:28)(cid:5)(cid:3)(cid:10)(cid:5)(cid:2)(cid:64)(cid:46)(cid:4)(cid:12)(cid:2)(cid:28)(cid:3,Unknown,7403.0
Unknown,Unknown,18,Unknown,Unknown,Unknown,Unknown,cid:50)(cid:46)(cid:12)(cid:2)(cid:7)(cid:8)(cid:10)(cid:5)(cid:3)(cid:48)(cid:46)(cid:3)(cid:12)(cid:13)(cid:5)(cid:2)(cid:14)(cid:46)(cid:2)(cid:28)(cid:5)(cid:3)(cid:10)(cid:5)(cid:2)(cid:64)(cid:46)(cid:4)(cid:12)(cid:2)(cid:28)(cid:3,Unknown,7421.0
Unknown,Unknown,19,Unknown,Unknown,Unknown,Unknown,cid:50)(cid:46)(cid:12)(cid:2)(cid:7)(cid:8)(cid:10)(cid:5)(cid:3)(cid:48)(cid:46)(cid:3)(cid:12)(cid:13)(cid:5)(cid:2)(cid:14)(cid:46)(cid:2)(cid:28)(cid:5)(cid:3)(cid:10)(cid:5)(cid:2)(cid:64)(cid:46)(cid:4)(cid:12)(cid:2)(cid:28)(cid:3,Unknown,7440.0
Unknown,Unknown,18,Unknown,Unknown,Unknown,Unknown,cid:50)(cid:46)(cid:12)(cid:2)(cid:7)(cid:8)(cid:10)(cid:5)(cid:3)(cid:48)(cid:46)(cid:3)(cid:12)(cid:13)(cid:5)(cid:2)(cid:14)(cid:46)(cid:2)(cid:28)(cid:5)(cid:3)(cid:10)(cid:5)(cid:2)(cid:64)(cid:46)(cid:4)(cid:12)(cid:2)(cid:28)(cid:3,Unknown,7458.0
Unknown,Unknown,17,Unknown,Unknown,Unknown,Unknown,cid:50)(cid:46)(cid:12)(cid:2)(cid:7)(cid:8)(cid:10)(cid:5)(cid:3)(cid:48)(cid:46)(cid:3)(cid:12)(cid:13)(cid:5)(cid:2)(cid:14)(cid:46)(cid:2)(cid:28)(cid:5)(cid:3)(cid:10)(cid:5)(cid:2)(cid:64)(cid:46)(cid:4)(cid:12)(cid:2)(cid:28)(cid:3,Unknown,7475.0
Unknown,Unknown,2,Unknown,Unknown,Unknown,Unknown,cid:50)(cid:46)(cid:12)(cid:2)(cid:7)(cid:8)(cid:10)(cid:5)(cid:3)(cid:48)(cid:46)(cid:3)(cid:12)(cid:13)(cid:5)(cid:2)(cid:14)(cid:46)(cid:2)(cid:28)(cid:5)(cid:3)(cid:10)(cid:5)(cid:2)(cid:64)(cid:46)(cid:4)(cid:12)(cid:2)(cid:28)(cid:3,Unknown,7477.0
Unknown,Unknown,44,Unknown,Unknown,Unknown,Unknown,cid:50)(cid:46)(cid:12)(cid:2)(cid:7)(cid:8)(cid:10)(cid:5)(cid:3)(cid:48)(cid:46)(cid:3)(cid:12)(cid:13)(cid:5)(cid:2)(cid:14)(cid:46)(cid:2)(cid:28)(cid:5)(cid:3)(cid:10)(cid:5)(cid:2)(cid:64)(cid:46)(cid:4)(cid:12)(cid:2)(cid:28)(cid:3,Unknown,7521.0
Unknown,Unknown,12,Unknown,Unknown,Unknown,Unknown,cid:50)(cid:46)(cid:12)(cid:2)(cid:7)(cid:8)(cid:10)(cid:5)(cid:3)(cid:48)(cid:46)(cid:3)(cid:12)(cid:13)(cid:5)(cid:2)(cid:14)(cid:46)(cid:2)(cid:28)(cid:5)(cid:3)(cid:10)(cid:5)(cid:2)(cid:64)(cid:46)(cid:4)(cid:12)(cid:2)(cid:28)(cid:3,Unknown,7533.0
Unknown,Unknown,29,Unknown,Unknown,Unknown,Unknown,cid:50)(cid:46)(cid:12)(cid:2)(cid:7)(cid:8)(cid:10)(cid:5)(cid:3)(cid:48)(cid:46)(cid:3)(cid:12)(cid:13)(cid:5)(cid:2)(cid:14)(cid:46)(cid:2)(cid:28)(cid:5)(cid:3)(cid:10)(cid:5)(cid:2)(cid:64)(cid:46)(cid:4)(cid:12)(cid:2)(cid:28)(cid:3,Unknown,7562.0
Unknown,Unknown,26,Unknown,Unknown,Unknown,Unknown,cid:50)(cid:46)(cid:12)(cid:2)(cid:7)(cid:8)(cid:10)(cid:5)(cid:3)(cid:48)(cid:46)(cid:3)(cid:12)(cid:13)(cid:5)(cid:2)(cid:14)(cid:46)(cid:2)(cid:28)(cid:5)(cid:3)(cid:10)(cid:5)(cid:2)(cid:64)(cid:46)(cid:4)(cid:12)(cid:2)(cid:28)(cid:3,Unknown,7588.0
Unknown,Unknown,41,Unknown,Unknown,Unknown,Unknown,cid:50)(cid:46)(cid:12)(cid:2)(cid:7)(cid:8)(cid:10)(cid:5)(cid:3)(cid:48)(cid:46)(cid:3)(cid:12)(cid:13)(cid:5)(cid:2)(cid:14)(cid:46)(cid:2)(cid:28)(cid:5)(cid:3)(cid:10)(cid:5)(cid:2)(cid:64)(cid:46)(cid:4)(cid:12)(cid:2)(cid:28)(cid:3,Unknown,7629.0
Unknown,Unknown,25,Unknown,Unknown,Unknown,Unknown,cid:50)(cid:46)(cid:12)(cid:2)(cid:7)(cid:8)(cid:10)(cid:5)(cid:3)(cid:48)(cid:46)(cid:3)(cid:12)(cid:13)(cid:5)(cid:2)(cid:14)(cid:46)(cid:2)(cid:28)(cid:5)(cid:3)(cid:10)(cid:5)(cid:2)(cid:64)(cid:46)(cid:4)(cid:12)(cid:2)(cid:28)(cid:3,Unknown,7654.0
Unknown,Unknown,2,Unknown,Unknown,Unknown,Unknown,cid:50)(cid:46)(cid:12)(cid:2)(cid:7)(cid:8)(cid:10)(cid:5)(cid:3)(cid:48)(cid:46)(cid:3)(cid:12)(cid:13)(cid:5)(cid:2)(cid:14)(cid:46)(cid:2)(cid:28)(cid:5)(cid:3)(cid:10)(cid:5)(cid:2)(cid:64)(cid:46)(cid:4)(cid:12)(cid:2)(cid:28)(cid:3,Unknown,7656.0
Unknown,Unknown,58,Unknown,Unknown,Unknown,Unknown,cid:50)(cid:46)(cid:12)(cid:2)(cid:7)(cid:8)(cid:10)(cid:5)(cid:3)(cid:48)(cid:46)(cid:3)(cid:12)(cid:13)(cid:5)(cid:2)(cid:14)(cid:46)(cid:2)(cid:28)(cid:5)(cid:3)(cid:10)(cid:5)(cid:2)(cid:64)(cid:46)(cid:4)(cid:12)(cid:2)(cid:28)(cid:3,Unknown,7714.0
Unknown,Unknown,58,Unknown,Unknown,Unknown,Unknown,cid:50)(cid:46)(cid:12)(cid:2)(cid:7)(cid:8)(cid:10)(cid:5)(cid:3)(cid:48)(cid:46)(cid:3)(cid:12)(cid:13)(cid:5)(cid:2)(cid:14)(cid:46)(cid:2)(cid:28)(cid:5)(cid:3)(cid:10)(cid:5)(cid:2)(cid:64)(cid:46)(cid:4)(cid:12)(cid:2)(cid:28)(cid:3,Unknown,7772.0
Unknown,Unknown,18,Unknown,Unknown,Unknown,Unknown,cid:50)(cid:46)(cid:12)(cid:2)(cid:7)(cid:8)(cid:10)(cid:5)(cid:3)(cid:48)(cid:46)(cid:3)(cid:12)(cid:13)(cid:5)(cid:2)(cid:14)(cid:46)(cid:2)(cid:28)(cid:5)(cid:3)(cid:10)(cid:5)(cid:2)(cid:64)(cid:46)(cid:4)(cid:12)(cid:2)(cid:28)(cid:3,Unknown,7790.0
Unknown,Unknown,1,Unknown,Unknown,Unknown,Unknown,cid:50)(cid:46)(cid:12)(cid:2)(cid:7)(cid:8)(cid:10)(cid:5)(cid:3)(cid:48)(cid:46)(cid:3)(cid:12)(cid:13)(cid:5)(cid:2)(cid:14)(cid:46)(cid:2)(cid:28)(cid:5)(cid:3)(cid:10)(cid:5)(cid:2)(cid:64)(cid:46)(cid:4)(cid:12)(cid:2)(cid:28)(cid:3,Unknown,7791.0
Unknown,Unknown,1,Unknown,Unknown,Unknown,Unknown,cid:50)(cid:46)(cid:12)(cid:2)(cid:7)(cid:8)(cid:10)(cid:5)(cid:3)(cid:48)(cid:46)(cid:3)(cid:12)(cid:13)(cid:5)(cid:2)(cid:14)(cid:46)(cid:2)(cid:28)(cid:5)(cid:3)(cid:10)(cid:5)(cid:2)(cid:64)(cid:46)(cid:4)(cid:12)(cid:2)(cid:28)(cid:3,Unknown,7792.0
Unknown,Unknown,37,Unknown,Unknown,Unknown,Unknown,cid:50)(cid:46)(cid:12)(cid:2)(cid:7)(cid:8)(cid:10)(cid:5)(cid:3)(cid:48)(cid:46)(cid:3)(cid:12)(cid:13)(cid:5)(cid:2)(cid:14)(cid:46)(cid:2)(cid:28)(cid:5)(cid:3)(cid:10)(cid:5)(cid:2)(cid:64)(cid:46)(cid:4)(cid:12)(cid:2)(cid:28)(cid:3,Unknown,7829.0
Unknown,Unknown,18,Unknown,Unknown,Unknown,Unknown,cid:50)(cid:46)(cid:12)(cid:2)(cid:7)(cid:8)(cid:10)(cid:5)(cid:3)(cid:48)(cid:46)(cid:3)(cid:12)(cid:13)(cid:5)(cid:2)(cid:14)(cid:46)(cid:2)(cid:28)(cid:5)(cid:3)(cid:10)(cid:5)(cid:2)(cid:64)(cid:46)(cid:4)(cid:12)(cid:2)(cid:28)(cid:3,Unknown,7847.0
Unknown,Unknown,32,Unknown,Unknown,Unknown,Unknown,cid:50)(cid:46)(cid:12)(cid:2)(cid:7)(cid:8)(cid:10)(cid:5)(cid:3)(cid:48)(cid:46)(cid:3)(cid:12)(cid:13)(cid:5)(cid:2)(cid:14)(cid:46)(cid:2)(cid:28)(cid:5)(cid:3)(cid:10)(cid:5)(cid:2)(cid:64)(cid:46)(cid:4)(cid:12)(cid:2)(cid:28)(cid:3,Unknown,7879.0
Unknown,Unknown,45,Unknown,Unknown,Unknown,Unknown,cid:50)(cid:46)(cid:12)(cid:2)(cid:7)(cid:8)(cid:10)(cid:5)(cid:3)(cid:48)(cid:46)(cid:3)(cid:12)(cid:13)(cid:5)(cid:2)(cid:14)(cid:46)(cid:2)(cid:28)(cid:5)(cid:3)(cid:10)(cid:5)(cid:2)(cid:64)(cid:46)(cid:4)(cid:12)(cid:2)(cid:28)(cid:3,Unknown,7924.0
Unknown,Unknown,18,Unknown,Unknown,Unknown,Unknown,cid:50)(cid:46)(cid:12)(cid:2)(cid:7)(cid:8)(cid:10)(cid:5)(cid:3)(cid:48)(cid:46)(cid:3)(cid:12)(cid:13)(cid:5)(cid:2)(cid:14)(cid:46)(cid:2)(cid:28)(cid:5)(cid:3)(cid:10)(cid:5)(cid:2)(cid:64)(cid:46)(cid:4)(cid:12)(cid:2)(cid:28)(cid:3,Unknown,7942.0
Unknown,Unknown,16,Unknown,Unknown,Unknown,Unknown,cid:50)(cid:46)(cid:12)(cid:2)(cid:7)(cid:8)(cid:10)(cid:5)(cid:3)(cid:48)(cid:46)(cid:3)(cid:12)(cid:13)(cid:5)(cid:2)(cid:14)(cid:46)(cid:2)(cid:28)(cid:5)(cid:3)(cid:10)(cid:5)(cid:2)(cid:64)(cid:46)(cid:4)(cid:12)(cid:2)(cid:28)(cid:3,Unknown,7958.0
Unknown,Unknown,27,Unknown,Unknown,Unknown,Unknown,cid:50)(cid:46)(cid:12)(cid:2)(cid:7)(cid:8)(cid:10)(cid:5)(cid:3)(cid:48)(cid:46)(cid:3)(cid:12)(cid:13)(cid:5)(cid:2)(cid:14)(cid:46)(cid:2)(cid:28)(cid:5)(cid:3)(cid:10)(cid:5)(cid:2)(cid:64)(cid:46)(cid:4)(cid:12)(cid:2)(cid:28)(cid:3,Unknown,7985.0
Unknown,Unknown,31,Unknown,Unknown,Unknown,Unknown,cid:50)(cid:46)(cid:12)(cid:2)(cid:7)(cid:8)(cid:10)(cid:5)(cid:3)(cid:48)(cid:46)(cid:3)(cid:12)(cid:13)(cid:5)(cid:2)(cid:14)(cid:46)(cid:2)(cid:28)(cid:5)(cid:3)(cid:10)(cid:5)(cid:2)(cid:64)(cid:46)(cid:4)(cid:12)(cid:2)(cid:28)(cid:3,Unknown,8016.0
Unknown,Unknown,24,Unknown,Unknown,Unknown,Unknown,cid:50)(cid:46)(cid:12)(cid:2)(cid:7)(cid:8)(cid:10)(cid:5)(cid:3)(cid:48)(cid:46)(cid:3)(cid:12)(cid:13)(cid:5)(cid:2)(cid:14)(cid:46)(cid:2)(cid:28)(cid:5)(cid:3)(cid:10)(cid:5)(cid:2)(cid:64)(cid:46)(cid:4)(cid:12)(cid:2)(cid:28)(cid:3,Unknown,8040.0
Unknown,Unknown,2,Unknown,Unknown,Unknown,Unknown,cid:50)(cid:46)(cid:12)(cid:2)(cid:7)(cid:8)(cid:10)(cid:5)(cid:3)(cid:48)(cid:46)(cid:3)(cid:12)(cid:13)(cid:5)(cid:2)(cid:14)(cid:46)(cid:2)(cid:28)(cid:5)(cid:3)(cid:10)(cid:5)(cid:2)(cid:64)(cid:46)(cid:4)(cid:12)(cid:2)(cid:28)(cid:3,Unknown,8042.0
Unknown,Unknown,31,Unknown,Unknown,Unknown,Unknown,cid:50)(cid:46)(cid:12)(cid:2)(cid:7)(cid:8)(cid:10)(cid:5)(cid:3)(cid:48)(cid:46)(cid:3)(cid:12)(cid:13)(cid:5)(cid:2)(cid:14)(cid:46)(cid:2)(cid:28)(cid:5)(cid:3)(cid:10)(cid:5)(cid:2)(cid:64)(cid:46)(cid:4)(cid:12)(cid:2)(cid:28)(cid:3,Unknown,8073.0
Unknown,Unknown,30,Unknown,Unknown,Unknown,Unknown,cid:50)(cid:46)(cid:12)(cid:2)(cid:7)(cid:8)(cid:10)(cid:5)(cid:3)(cid:48)(cid:46)(cid:3)(cid:12)(cid:13)(cid:5)(cid:2)(cid:14)(cid:46)(cid:2)(cid:28)(cid:5)(cid:3)(cid:10)(cid:5)(cid:2)(cid:64)(cid:46)(cid:4)(cid:12)(cid:2)(cid:28)(cid:3,Unknown,8103.0
Unknown,Unknown,51,Unknown,Unknown,Unknown,Unknown,cid:50)(cid:46)(cid:12)(cid:2)(cid:7)(cid:8)(cid:10)(cid:5)(cid:3)(cid:48)(cid:46)(cid:3)(cid:12)(cid:13)(cid:5)(cid:2)(cid:14)(cid:46)(cid:2)(cid:28)(cid:5)(cid:3)(cid:10)(cid:5)(cid:2)(cid:64)(cid:46)(cid:4)(cid:12)(cid:2)(cid:28)(cid:3,Unknown,8154.0
Unknown,Unknown,27,Unknown,Unknown,Unknown,Unknown,cid:50)(cid:46)(cid:12)(cid:2)(cid:7)(cid:8)(cid:10)(cid:5)(cid:3)(cid:48)(cid:46)(cid:3)(cid:12)(cid:13)(cid:5)(cid:2)(cid:14)(cid:46)(cid:2)(cid:28)(cid:5)(cid:3)(cid:10)(cid:5)(cid:2)(cid:64)(cid:46)(cid:4)(cid:12)(cid:2)(cid:28)(cid:3,Unknown,8181.0
Unknown,Unknown,15,Unknown,Unknown,Unknown,Unknown,cid:50)(cid:46)(cid:12)(cid:2)(cid:7)(cid:8)(cid:10)(cid:5)(cid:3)(cid:48)(cid:46)(cid:3)(cid:12)(cid:13)(cid:5)(cid:2)(cid:14)(cid:46)(cid:2)(cid:28)(cid:5)(cid:3)(cid:10)(cid:5)(cid:2)(cid:64)(cid:46)(cid:4)(cid:12)(cid:2)(cid:28)(cid:3,Unknown,8196.0
Unknown,Unknown,2,Unknown,Unknown,Unknown,Unknown,cid:50)(cid:46)(cid:12)(cid:2)(cid:7)(cid:8)(cid:10)(cid:5)(cid:3)(cid:48)(cid:46)(cid:3)(cid:12)(cid:13)(cid:5)(cid:2)(cid:14)(cid:46)(cid:2)(cid:28)(cid:5)(cid:3)(cid:10)(cid:5)(cid:2)(cid:64)(cid:46)(cid:4)(cid:12)(cid:2)(cid:28)(cid:3,Unknown,8198.0
Unknown,Unknown,17,Unknown,Unknown,Unknown,Unknown,cid:50)(cid:46)(cid:12)(cid:2)(cid:7)(cid:8)(cid:10)(cid:5)(cid:3)(cid:48)(cid:46)(cid:3)(cid:12)(cid:13)(cid:5)(cid:2)(cid:14)(cid:46)(cid:2)(cid:28)(cid:5)(cid:3)(cid:10)(cid:5)(cid:2)(cid:64)(cid:46)(cid:4)(cid:12)(cid:2)(cid:28)(cid:3,Unknown,8215.0
Unknown,Unknown,2,Unknown,Unknown,Unknown,Unknown,cid:50)(cid:46)(cid:12)(cid:2)(cid:7)(cid:8)(cid:10)(cid:5)(cid:3)(cid:48)(cid:46)(cid:3)(cid:12)(cid:13)(cid:5)(cid:2)(cid:14)(cid:46)(cid:2)(cid:28)(cid:5)(cid:3)(cid:10)(cid:5)(cid:2)(cid:64)(cid:46)(cid:4)(cid:12)(cid:2)(cid:28)(cid:3,Unknown,8217.0
Unknown,Unknown,32,Unknown,Unknown,Unknown,Unknown,cid:50)(cid:46)(cid:12)(cid:2)(cid:7)(cid:8)(cid:10)(cid:5)(cid:3)(cid:48)(cid:46)(cid:3)(cid:12)(cid:13)(cid:5)(cid:2)(cid:14)(cid:46)(cid:2)(cid:28)(cid:5)(cid:3)(cid:10)(cid:5)(cid:2)(cid:64)(cid:46)(cid:4)(cid:12)(cid:2)(cid:28)(cid:3,Unknown,8249.0
Unknown,Unknown,35,Unknown,Unknown,Unknown,Unknown,cid:50)(cid:46)(cid:12)(cid:2)(cid:7)(cid:8)(cid:10)(cid:5)(cid:3)(cid:48)(cid:46)(cid:3)(cid:12)(cid:13)(cid:5)(cid:2)(cid:14)(cid:46)(cid:2)(cid:28)(cid:5)(cid:3)(cid:10)(cid:5)(cid:2)(cid:64)(cid:46)(cid:4)(cid:12)(cid:2)(cid:28)(cid:3,Unknown,8284.0
Unknown,Unknown,18,Unknown,Unknown,Unknown,Unknown,cid:50)(cid:46)(cid:12)(cid:2)(cid:7)(cid:8)(cid:10)(cid:5)(cid:3)(cid:48)(cid:46)(cid:3)(cid:12)(cid:13)(cid:5)(cid:2)(cid:14)(cid:46)(cid:2)(cid:28)(cid:5)(cid:3)(cid:10)(cid:5)(cid:2)(cid:64)(cid:46)(cid:4)(cid:12)(cid:2)(cid:28)(cid:3,Unknown,8302.0
Unknown,Unknown,19,Unknown,Unknown,Unknown,Unknown,cid:50)(cid:46)(cid:12)(cid:2)(cid:7)(cid:8)(cid:10)(cid:5)(cid:3)(cid:48)(cid:46)(cid:3)(cid:12)(cid:13)(cid:5)(cid:2)(cid:14)(cid:46)(cid:2)(cid:28)(cid:5)(cid:3)(cid:10)(cid:5)(cid:2)(cid:64)(cid:46)(cid:4)(cid:12)(cid:2)(cid:28)(cid:3,Unknown,8321.0
Unknown,Unknown,18,Unknown,Unknown,Unknown,Unknown,cid:50)(cid:46)(cid:12)(cid:2)(cid:7)(cid:8)(cid:10)(cid:5)(cid:3)(cid:48)(cid:46)(cid:3)(cid:12)(cid:13)(cid:5)(cid:2)(cid:14)(cid:46)(cid:2)(cid:28)(cid:5)(cid:3)(cid:10)(cid:5)(cid:2)(cid:64)(cid:46)(cid:4)(cid:12)(cid:2)(cid:28)(cid:3,Unknown,8339.0
Unknown,Unknown,18,Unknown,Unknown,Unknown,Unknown,cid:50)(cid:46)(cid:12)(cid:2)(cid:7)(cid:8)(cid:10)(cid:5)(cid:3)(cid:48)(cid:46)(cid:3)(cid:12)(cid:13)(cid:5)(cid:2)(cid:14)(cid:46)(cid:2)(cid:28)(cid:5)(cid:3)(cid:10)(cid:5)(cid:2)(cid:64)(cid:46)(cid:4)(cid:12)(cid:2)(cid:28)(cid:3,Unknown,8357.0
Unknown,Unknown,2,Unknown,Unknown,Unknown,Unknown,cid:50)(cid:46)(cid:12)(cid:2)(cid:7)(cid:8)(cid:10)(cid:5)(cid:3)(cid:48)(cid:46)(cid:3)(cid:12)(cid:13)(cid:5)(cid:2)(cid:14)(cid:46)(cid:2)(cid:28)(cid:5)(cid:3)(cid:10)(cid:5)(cid:2)(cid:64)(cid:46)(cid:4)(cid:12)(cid:2)(cid:28)(cid:3,Unknown,8359.0
Unknown,Unknown,44,Unknown,Unknown,Unknown,Unknown,cid:50)(cid:46)(cid:12)(cid:2)(cid:7)(cid:8)(cid:10)(cid:5)(cid:3)(cid:48)(cid:46)(cid:3)(cid:12)(cid:13)(cid:5)(cid:2)(cid:14)(cid:46)(cid:2)(cid:28)(cid:5)(cid:3)(cid:10)(cid:5)(cid:2)(cid:64)(cid:46)(cid:4)(cid:12)(cid:2)(cid:28)(cid:3,Unknown,8403.0
Unknown,Unknown,51,Unknown,Unknown,Unknown,Unknown,cid:50)(cid:46)(cid:12)(cid:2)(cid:7)(cid:8)(cid:10)(cid:5)(cid:3)(cid:48)(cid:46)(cid:3)(cid:12)(cid:13)(cid:5)(cid:2)(cid:14)(cid:46)(cid:2)(cid:28)(cid:5)(cid:3)(cid:10)(cid:5)(cid:2)(cid:64)(cid:46)(cid:4)(cid:12)(cid:2)(cid:28)(cid:3,Unknown,8454.0
Unknown,Unknown,29,Unknown,Unknown,Unknown,Unknown,cid:50)(cid:46)(cid:12)(cid:2)(cid:7)(cid:8)(cid:10)(cid:5)(cid:3)(cid:48)(cid:46)(cid:3)(cid:12)(cid:13)(cid:5)(cid:2)(cid:14)(cid:46)(cid:2)(cid:28)(cid:5)(cid:3)(cid:10)(cid:5)(cid:2)(cid:64)(cid:46)(cid:4)(cid:12)(cid:2)(cid:28)(cid:3,Unknown,8483.0
Unknown,Unknown,24,Unknown,Unknown,Unknown,Unknown,cid:50)(cid:46)(cid:12)(cid:2)(cid:7)(cid:8)(cid:10)(cid:5)(cid:3)(cid:48)(cid:46)(cid:3)(cid:12)(cid:13)(cid:5)(cid:2)(cid:14)(cid:46)(cid:2)(cid:28)(cid:5)(cid:3)(cid:10)(cid:5)(cid:2)(cid:64)(cid:46)(cid:4)(cid:12)(cid:2)(cid:28)(cid:3,Unknown,8507.0
Unknown,Unknown,25,Unknown,Unknown,Unknown,Unknown,cid:50)(cid:46)(cid:12)(cid:2)(cid:7)(cid:8)(cid:10)(cid:5)(cid:3)(cid:48)(cid:46)(cid:3)(cid:12)(cid:13)(cid:5)(cid:2)(cid:14)(cid:46)(cid:2)(cid:28)(cid:5)(cid:3)(cid:10)(cid:5)(cid:2)(cid:64)(cid:46)(cid:4)(cid:12)(cid:2)(cid:28)(cid:3,Unknown,8532.0
Unknown,Unknown,23,Unknown,Unknown,Unknown,Unknown,cid:50)(cid:46)(cid:12)(cid:2)(cid:7)(cid:8)(cid:10)(cid:5)(cid:3)(cid:48)(cid:46)(cid:3)(cid:12)(cid:13)(cid:5)(cid:2)(cid:14)(cid:46)(cid:2)(cid:28)(cid:5)(cid:3)(cid:10)(cid:5)(cid:2)(cid:64)(cid:46)(cid:4)(cid:12)(cid:2)(cid:28)(cid:3,Unknown,8555.0
Unknown,Unknown,25,Unknown,Unknown,Unknown,Unknown,cid:50)(cid:46)(cid:12)(cid:2)(cid:7)(cid:8)(cid:10)(cid:5)(cid:3)(cid:48)(cid:46)(cid:3)(cid:12)(cid:13)(cid:5)(cid:2)(cid:14)(cid:46)(cid:2)(cid:28)(cid:5)(cid:3)(cid:10)(cid:5)(cid:2)(cid:64)(cid:46)(cid:4)(cid:12)(cid:2)(cid:28)(cid:3,Unknown,8580.0
Unknown,Unknown,30,Unknown,Unknown,Unknown,Unknown,cid:50)(cid:46)(cid:12)(cid:2)(cid:7)(cid:8)(cid:10)(cid:5)(cid:3)(cid:48)(cid:46)(cid:3)(cid:12)(cid:13)(cid:5)(cid:2)(cid:14)(cid:46)(cid:2)(cid:28)(cid:5)(cid:3)(cid:10)(cid:5)(cid:2)(cid:64)(cid:46)(cid:4)(cid:12)(cid:2)(cid:28)(cid:3,Unknown,8610.0
Unknown,Unknown,41,Unknown,Unknown,Unknown,Unknown,cid:50)(cid:46)(cid:12)(cid:2)(cid:7)(cid:8)(cid:10)(cid:5)(cid:3)(cid:48)(cid:46)(cid:3)(cid:12)(cid:13)(cid:5)(cid:2)(cid:14)(cid:46)(cid:2)(cid:28)(cid:5)(cid:3)(cid:10)(cid:5)(cid:2)(cid:64)(cid:46)(cid:4)(cid:12)(cid:2)(cid:28)(cid:3,Unknown,8651.0
Unknown,Unknown,2,Unknown,Unknown,Unknown,Unknown,cid:50)(cid:46)(cid:12)(cid:2)(cid:7)(cid:8)(cid:10)(cid:5)(cid:3)(cid:48)(cid:46)(cid:3)(cid:12)(cid:13)(cid:5)(cid:2)(cid:14)(cid:46)(cid:2)(cid:28)(cid:5)(cid:3)(cid:10)(cid:5)(cid:2)(cid:64)(cid:46)(cid:4)(cid:12)(cid:2)(cid:28)(cid:3,Unknown,8653.0
Unknown,Unknown,22,Unknown,Unknown,Unknown,Unknown,cid:50)(cid:46)(cid:12)(cid:2)(cid:7)(cid:8)(cid:10)(cid:5)(cid:3)(cid:48)(cid:46)(cid:3)(cid:12)(cid:13)(cid:5)(cid:2)(cid:14)(cid:46)(cid:2)(cid:28)(cid:5)(cid:3)(cid:10)(cid:5)(cid:2)(cid:64)(cid:46)(cid:4)(cid:12)(cid:2)(cid:28)(cid:3,Unknown,8675.0
Unknown,Unknown,20,Unknown,Unknown,Unknown,Unknown,cid:50)(cid:46)(cid:12)(cid:2)(cid:7)(cid:8)(cid:10)(cid:5)(cid:3)(cid:48)(cid:46)(cid:3)(cid:12)(cid:13)(cid:5)(cid:2)(cid:14)(cid:46)(cid:2)(cid:28)(cid:5)(cid:3)(cid:10)(cid:5)(cid:2)(cid:64)(cid:46)(cid:4)(cid:12)(cid:2)(cid:28)(cid:3,Unknown,8695.0
Unknown,Unknown,59,Unknown,Unknown,Unknown,Unknown,cid:50)(cid:46)(cid:12)(cid:2)(cid:7)(cid:8)(cid:10)(cid:5)(cid:3)(cid:48)(cid:46)(cid:3)(cid:12)(cid:13)(cid:5)(cid:2)(cid:14)(cid:46)(cid:2)(cid:28)(cid:5)(cid:3)(cid:10)(cid:5)(cid:2)(cid:64)(cid:46)(cid:4)(cid:12)(cid:2)(cid:28)(cid:3,Unknown,8754.0
Unknown,Unknown,25,Unknown,Unknown,Unknown,Unknown,cid:50)(cid:46)(cid:12)(cid:2)(cid:7)(cid:8)(cid:10)(cid:5)(cid:3)(cid:48)(cid:46)(cid:3)(cid:12)(cid:13)(cid:5)(cid:2)(cid:14)(cid:46)(cid:2)(cid:28)(cid:5)(cid:3)(cid:10)(cid:5)(cid:2)(cid:64)(cid:46)(cid:4)(cid:12)(cid:2)(cid:28)(cid:3,Unknown,8779.0
Unknown,Unknown,26,Unknown,Unknown,Unknown,Unknown,cid:50)(cid:46)(cid:12)(cid:2)(cid:7)(cid:8)(cid:10)(cid:5)(cid:3)(cid:48)(cid:46)(cid:3)(cid:12)(cid:13)(cid:5)(cid:2)(cid:14)(cid:46)(cid:2)(cid:28)(cid:5)(cid:3)(cid:10)(cid:5)(cid:2)(cid:64)(cid:46)(cid:4)(cid:12)(cid:2)(cid:28)(cid:3,Unknown,8805.0
Unknown,Unknown,2,Unknown,Unknown,Unknown,Unknown,cid:50)(cid:46)(cid:12)(cid:2)(cid:7)(cid:8)(cid:10)(cid:5)(cid:3)(cid:48)(cid:46)(cid:3)(cid:12)(cid:13)(cid:5)(cid:2)(cid:14)(cid:46)(cid:2)(cid:28)(cid:5)(cid:3)(cid:10)(cid:5)(cid:2)(cid:64)(cid:46)(cid:4)(cid:12)(cid:2)(cid:28)(cid:3,Unknown,8807.0
Unknown,Unknown,60,Unknown,Unknown,Unknown,Unknown,cid:50)(cid:46)(cid:12)(cid:2)(cid:7)(cid:8)(cid:10)(cid:5)(cid:3)(cid:48)(cid:46)(cid:3)(cid:12)(cid:13)(cid:5)(cid:2)(cid:14)(cid:46)(cid:2)(cid:28)(cid:5)(cid:3)(cid:10)(cid:5)(cid:2)(cid:64)(cid:46)(cid:4)(cid:12)(cid:2)(cid:28)(cid:3,Unknown,8867.0
Unknown,Unknown,21,Unknown,Unknown,Unknown,Unknown,cid:50)(cid:46)(cid:12)(cid:2)(cid:7)(cid:8)(cid:10)(cid:5)(cid:3)(cid:48)(cid:46)(cid:3)(cid:12)(cid:13)(cid:5)(cid:2)(cid:14)(cid:46)(cid:2)(cid:28)(cid:5)(cid:3)(cid:10)(cid:5)(cid:2)(cid:64)(cid:46)(cid:4)(cid:12)(cid:2)(cid:28)(cid:3,Unknown,8888.0
Unknown,Unknown,24,Unknown,Unknown,Unknown,Unknown,cid:50)(cid:46)(cid:12)(cid:2)(cid:7)(cid:8)(cid:10)(cid:5)(cid:3)(cid:48)(cid:46)(cid:3)(cid:12)(cid:13)(cid:5)(cid:2)(cid:14)(cid:46)(cid:2)(cid:28)(cid:5)(cid:3)(cid:10)(cid:5)(cid:2)(cid:64)(cid:46)(cid:4)(cid:12)(cid:2)(cid:28)(cid:3,Unknown,8912.0
Unknown,Unknown,30,Unknown,Unknown,Unknown,Unknown,cid:50)(cid:46)(cid:12)(cid:2)(cid:7)(cid:8)(cid:10)(cid:5)(cid:3)(cid:48)(cid:46)(cid:3)(cid:12)(cid:13)(cid:5)(cid:2)(cid:14)(cid:46)(cid:2)(cid:28)(cid:5)(cid:3)(cid:10)(cid:5)(cid:2)(cid:64)(cid:46)(cid:4)(cid:12)(cid:2)(cid:28)(cid:3,Unknown,8942.0
Unknown,Unknown,18,Unknown,Unknown,Unknown,Unknown,cid:50)(cid:46)(cid:12)(cid:2)(cid:7)(cid:8)(cid:10)(cid:5)(cid:3)(cid:48)(cid:46)(cid:3)(cid:12)(cid:13)(cid:5)(cid:2)(cid:14)(cid:46)(cid:2)(cid:28)(cid:5)(cid:3)(cid:10)(cid:5)(cid:2)(cid:64)(cid:46)(cid:4)(cid:12)(cid:2)(cid:28)(cid:3,Unknown,8960.0
Unknown,Unknown,32,Unknown,Unknown,Unknown,Unknown,cid:50)(cid:46)(cid:12)(cid:2)(cid:7)(cid:8)(cid:10)(cid:5)(cid:3)(cid:48)(cid:46)(cid:3)(cid:12)(cid:13)(cid:5)(cid:2)(cid:14)(cid:46)(cid:2)(cid:28)(cid:5)(cid:3)(cid:10)(cid:5)(cid:2)(cid:64)(cid:46)(cid:4)(cid:12)(cid:2)(cid:28)(cid:3,Unknown,8992.0
Unknown,Unknown,45,Unknown,Unknown,Unknown,Unknown,cid:50)(cid:46)(cid:12)(cid:2)(cid:7)(cid:8)(cid:10)(cid:5)(cid:3)(cid:48)(cid:46)(cid:3)(cid:12)(cid:13)(cid:5)(cid:2)(cid:14)(cid:46)(cid:2)(cid:28)(cid:5)(cid:3)(cid:10)(cid:5)(cid:2)(cid:64)(cid:46)(cid:4)(cid:12)(cid:2)(cid:28)(cid:3,Unknown,9037.0
Unknown,Unknown,18,Unknown,Unknown,Unknown,Unknown,cid:50)(cid:46)(cid:12)(cid:2)(cid:7)(cid:8)(cid:10)(cid:5)(cid:3)(cid:48)(cid:46)(cid:3)(cid:12)(cid:13)(cid:5)(cid:2)(cid:14)(cid:46)(cid:2)(cid:28)(cid:5)(cid:3)(cid:10)(cid:5)(cid:2)(cid:64)(cid:46)(cid:4)(cid:12)(cid:2)(cid:28)(cid:3,Unknown,9055.0
Unknown,Unknown,16,Unknown,Unknown,Unknown,Unknown,cid:50)(cid:46)(cid:12)(cid:2)(cid:7)(cid:8)(cid:10)(cid:5)(cid:3)(cid:48)(cid:46)(cid:3)(cid:12)(cid:13)(cid:5)(cid:2)(cid:14)(cid:46)(cid:2)(cid:28)(cid:5)(cid:3)(cid:10)(cid:5)(cid:2)(cid:64)(cid:46)(cid:4)(cid:12)(cid:2)(cid:28)(cid:3,Unknown,9071.0
Unknown,Unknown,61,Unknown,Unknown,Unknown,Unknown,cid:50)(cid:46)(cid:12)(cid:2)(cid:7)(cid:8)(cid:10)(cid:5)(cid:3)(cid:48)(cid:46)(cid:3)(cid:12)(cid:13)(cid:5)(cid:2)(cid:14)(cid:46)(cid:2)(cid:28)(cid:5)(cid:3)(cid:10)(cid:5)(cid:2)(cid:64)(cid:46)(cid:4)(cid:12)(cid:2)(cid:28)(cid:3,Unknown,9132.0
Unknown,Unknown,29,Unknown,Unknown,Unknown,Unknown,cid:50)(cid:46)(cid:12)(cid:2)(cid:7)(cid:8)(cid:10)(cid:5)(cid:3)(cid:48)(cid:46)(cid:3)(cid:12)(cid:13)(cid:5)(cid:2)(cid:14)(cid:46)(cid:2)(cid:28)(cid:5)(cid:3)(cid:10)(cid:5)(cid:2)(cid:64)(cid:46)(cid:4)(cid:12)(cid:2)(cid:28)(cid:3,Unknown,9161.0
Unknown,Unknown,62,Unknown,Unknown,Unknown,Unknown,cid:50)(cid:46)(cid:12)(cid:2)(cid:7)(cid:8)(cid:10)(cid:5)(cid:3)(cid:48)(cid:46)(cid:3)(cid:12)(cid:13)(cid:5)(cid:2)(cid:14)(cid:46)(cid:2)(cid:28)(cid:5)(cid:3)(cid:10)(cid:5)(cid:2)(cid:64)(cid:46)(cid:4)(cid:12)(cid:2)(cid:28)(cid:3,Unknown,9223.0
Unknown,Unknown,24,Unknown,Unknown,Unknown,Unknown,cid:50)(cid:46)(cid:12)(cid:2)(cid:7)(cid:8)(cid:10)(cid:5)(cid:3)(cid:48)(cid:46)(cid:3)(cid:12)(cid:13)(cid:5)(cid:2)(cid:14)(cid:46)(cid:2)(cid:28)(cid:5)(cid:3)(cid:10)(cid:5)(cid:2)(cid:64)(cid:46)(cid:4)(cid:12)(cid:2)(cid:28)(cid:3,Unknown,9247.0
Unknown,Unknown,25,Unknown,Unknown,Unknown,Unknown,cid:50)(cid:46)(cid:12)(cid:2)(cid:7)(cid:8)(cid:10)(cid:5)(cid:3)(cid:48)(cid:46)(cid:3)(cid:12)(cid:13)(cid:5)(cid:2)(cid:14)(cid:46)(cid:2)(cid:28)(cid:5)(cid:3)(cid:10)(cid:5)(cid:2)(cid:64)(cid:46)(cid:4)(cid:12)(cid:2)(cid:28)(cid:3,Unknown,9272.0
Unknown,Unknown,26,Unknown,Unknown,Unknown,Unknown,cid:50)(cid:46)(cid:12)(cid:2)(cid:7)(cid:8)(cid:10)(cid:5)(cid:3)(cid:48)(cid:46)(cid:3)(cid:12)(cid:13)(cid:5)(cid:2)(cid:14)(cid:46)(cid:2)(cid:28)(cid:5)(cid:3)(cid:10)(cid:5)(cid:2)(cid:64)(cid:46)(cid:4)(cid:12)(cid:2)(cid:28)(cid:3,Unknown,9298.0
Unknown,Unknown,2,Unknown,Unknown,Unknown,Unknown,cid:50)(cid:46)(cid:12)(cid:2)(cid:7)(cid:8)(cid:10)(cid:5)(cid:3)(cid:48)(cid:46)(cid:3)(cid:12)(cid:13)(cid:5)(cid:2)(cid:14)(cid:46)(cid:2)(cid:28)(cid:5)(cid:3)(cid:10)(cid:5)(cid:2)(cid:64)(cid:46)(cid:4)(cid:12)(cid:2)(cid:28)(cid:3,Unknown,9300.0
Unknown,Unknown,63,Unknown,Unknown,Unknown,Unknown,cid:50)(cid:46)(cid:12)(cid:2)(cid:7)(cid:8)(cid:10)(cid:5)(cid:3)(cid:48)(cid:46)(cid:3)(cid:12)(cid:13)(cid:5)(cid:2)(cid:14)(cid:46)(cid:2)(cid:28)(cid:5)(cid:3)(cid:10)(cid:5)(cid:2)(cid:64)(cid:46)(cid:4)(cid:12)(cid:2)(cid:28)(cid:3,Unknown,9363.0
Unknown,Unknown,24,Unknown,Unknown,Unknown,Unknown,cid:50)(cid:46)(cid:12)(cid:2)(cid:7)(cid:8)(cid:10)(cid:5)(cid:3)(cid:48)(cid:46)(cid:3)(cid:12)(cid:13)(cid:5)(cid:2)(cid:14)(cid:46)(cid:2)(cid:28)(cid:5)(cid:3)(cid:10)(cid:5)(cid:2)(cid:64)(cid:46)(cid:4)(cid:12)(cid:2)(cid:28)(cid:3,Unknown,9387.0
Unknown,Unknown,26,Unknown,Unknown,Unknown,Unknown,cid:50)(cid:46)(cid:12)(cid:2)(cid:7)(cid:8)(cid:10)(cid:5)(cid:3)(cid:48)(cid:46)(cid:3)(cid:12)(cid:13)(cid:5)(cid:2)(cid:14)(cid:46)(cid:2)(cid:28)(cid:5)(cid:3)(cid:10)(cid:5)(cid:2)(cid:64)(cid:46)(cid:4)(cid:12)(cid:2)(cid:28)(cid:3,Unknown,9413.0
Unknown,Unknown,29,Unknown,Unknown,Unknown,Unknown,cid:50)(cid:46)(cid:12)(cid:2)(cid:7)(cid:8)(cid:10)(cid:5)(cid:3)(cid:48)(cid:46)(cid:3)(cid:12)(cid:13)(cid:5)(cid:2)(cid:14)(cid:46)(cid:2)(cid:28)(cid:5)(cid:3)(cid:10)(cid:5)(cid:2)(cid:64)(cid:46)(cid:4)(cid:12)(cid:2)(cid:28)(cid:3,Unknown,9442.0
Unknown,Unknown,21,Unknown,Unknown,Unknown,Unknown,cid:50)(cid:46)(cid:12)(cid:2)(cid:7)(cid:8)(cid:10)(cid:5)(cid:3)(cid:48)(cid:46)(cid:3)(cid:12)(cid:13)(cid:5)(cid:2)(cid:14)(cid:46)(cid:2)(cid:28)(cid:5)(cid:3)(cid:10)(cid:5)(cid:2)(cid:64)(cid:46)(cid:4)(cid:12)(cid:2)(cid:28)(cid:3,Unknown,9463.0
Unknown,Unknown,53,Unknown,Unknown,Unknown,Unknown,cid:50)(cid:46)(cid:12)(cid:2)(cid:7)(cid:8)(cid:10)(cid:5)(cid:3)(cid:48)(cid:46)(cid:3)(cid:12)(cid:13)(cid:5)(cid:2)(cid:14)(cid:46)(cid:2)(cid:28)(cid:5)(cid:3)(cid:10)(cid:5)(cid:2)(cid:64)(cid:46)(cid:4)(cid:12)(cid:2)(cid:28)(cid:3,Unknown,9516.0
Unknown,Unknown,15,Unknown,Unknown,Unknown,Unknown,cid:50)(cid:46)(cid:12)(cid:2)(cid:7)(cid:8)(cid:10)(cid:5)(cid:3)(cid:48)(cid:46)(cid:3)(cid:12)(cid:13)(cid:5)(cid:2)(cid:14)(cid:46)(cid:2)(cid:28)(cid:5)(cid:3)(cid:10)(cid:5)(cid:2)(cid:64)(cid:46)(cid:4)(cid:12)(cid:2)(cid:28)(cid:3,Unknown,9531.0
Unknown,Unknown,2,Unknown,Unknown,Unknown,Unknown,cid:50)(cid:46)(cid:12)(cid:2)(cid:7)(cid:8)(cid:10)(cid:5)(cid:3)(cid:48)(cid:46)(cid:3)(cid:12)(cid:13)(cid:5)(cid:2)(cid:14)(cid:46)(cid:2)(cid:28)(cid:5)(cid:3)(cid:10)(cid:5)(cid:2)(cid:64)(cid:46)(cid:4)(cid:12)(cid:2)(cid:28)(cid:3,Unknown,9533.0
Unknown,Unknown,17,Unknown,Unknown,Unknown,Unknown,cid:50)(cid:46)(cid:12)(cid:2)(cid:7)(cid:8)(cid:10)(cid:5)(cid:3)(cid:48)(cid:46)(cid:3)(cid:12)(cid:13)(cid:5)(cid:2)(cid:14)(cid:46)(cid:2)(cid:28)(cid:5)(cid:3)(cid:10)(cid:5)(cid:2)(cid:64)(cid:46)(cid:4)(cid:12)(cid:2)(cid:28)(cid:3,Unknown,9550.0
Unknown,Unknown,2,Unknown,Unknown,Unknown,Unknown,cid:50)(cid:46)(cid:12)(cid:2)(cid:7)(cid:8)(cid:10)(cid:5)(cid:3)(cid:48)(cid:46)(cid:3)(cid:12)(cid:13)(cid:5)(cid:2)(cid:14)(cid:46)(cid:2)(cid:28)(cid:5)(cid:3)(cid:10)(cid:5)(cid:2)(cid:64)(cid:46)(cid:4)(cid:12)(cid:2)(cid:28)(cid:3,Unknown,9552.0
Unknown,Unknown,18,Unknown,Unknown,Unknown,Unknown,cid:50)(cid:46)(cid:12)(cid:2)(cid:7)(cid:8)(cid:10)(cid:5)(cid:3)(cid:48)(cid:46)(cid:3)(cid:12)(cid:13)(cid:5)(cid:2)(cid:14)(cid:46)(cid:2)(cid:28)(cid:5)(cid:3)(cid:10)(cid:5)(cid:2)(cid:64)(cid:46)(cid:4)(cid:12)(cid:2)(cid:28)(cid:3,Unknown,9570.0
Unknown,Unknown,18,Unknown,Unknown,Unknown,Unknown,cid:50)(cid:46)(cid:12)(cid:2)(cid:7)(cid:8)(cid:10)(cid:5)(cid:3)(cid:48)(cid:46)(cid:3)(cid:12)(cid:13)(cid:5)(cid:2)(cid:14)(cid:46)(cid:2)(cid:28)(cid:5)(cid:3)(cid:10)(cid:5)(cid:2)(cid:64)(cid:46)(cid:4)(cid:12)(cid:2)(cid:28)(cid:3,Unknown,9588.0
Unknown,Unknown,18,Unknown,Unknown,Unknown,Unknown,cid:50)(cid:46)(cid:12)(cid:2)(cid:7)(cid:8)(cid:10)(cid:5)(cid:3)(cid:48)(cid:46)(cid:3)(cid:12)(cid:13)(cid:5)(cid:2)(cid:14)(cid:46)(cid:2)(cid:28)(cid:5)(cid:3)(cid:10)(cid:5)(cid:2)(cid:64)(cid:46)(cid:4)(cid:12)(cid:2)(cid:28)(cid:3,Unknown,9606.0
Unknown,Unknown,19,Unknown,Unknown,Unknown,Unknown,cid:50)(cid:46)(cid:12)(cid:2)(cid:7)(cid:8)(cid:10)(cid:5)(cid:3)(cid:48)(cid:46)(cid:3)(cid:12)(cid:13)(cid:5)(cid:2)(cid:14)(cid:46)(cid:2)(cid:28)(cid:5)(cid:3)(cid:10)(cid:5)(cid:2)(cid:64)(cid:46)(cid:4)(cid:12)(cid:2)(cid:28)(cid:3,Unknown,9625.0
Unknown,Unknown,18,Unknown,Unknown,Unknown,Unknown,cid:50)(cid:46)(cid:12)(cid:2)(cid:7)(cid:8)(cid:10)(cid:5)(cid:3)(cid:48)(cid:46)(cid:3)(cid:12)(cid:13)(cid:5)(cid:2)(cid:14)(cid:46)(cid:2)(cid:28)(cid:5)(cid:3)(cid:10)(cid:5)(cid:2)(cid:64)(cid:46)(cid:4)(cid:12)(cid:2)(cid:28)(cid:3,Unknown,9643.0
Unknown,Unknown,18,Unknown,Unknown,Unknown,Unknown,cid:50)(cid:46)(cid:12)(cid:2)(cid:7)(cid:8)(cid:10)(cid:5)(cid:3)(cid:48)(cid:46)(cid:3)(cid:12)(cid:13)(cid:5)(cid:2)(cid:14)(cid:46)(cid:2)(cid:28)(cid:5)(cid:3)(cid:10)(cid:5)(cid:2)(cid:64)(cid:46)(cid:4)(cid:12)(cid:2)(cid:28)(cid:3,Unknown,9661.0
Unknown,Unknown,2,Unknown,Unknown,Unknown,Unknown,cid:50)(cid:46)(cid:12)(cid:2)(cid:7)(cid:8)(cid:10)(cid:5)(cid:3)(cid:48)(cid:46)(cid:3)(cid:12)(cid:13)(cid:5)(cid:2)(cid:14)(cid:46)(cid:2)(cid:28)(cid:5)(cid:3)(cid:10)(cid:5)(cid:2)(cid:64)(cid:46)(cid:4)(cid:12)(cid:2)(cid:28)(cid:3,Unknown,9663.0
Unknown,Unknown,44,Unknown,Unknown,Unknown,Unknown,cid:50)(cid:46)(cid:12)(cid:2)(cid:7)(cid:8)(cid:10)(cid:5)(cid:3)(cid:48)(cid:46)(cid:3)(cid:12)(cid:13)(cid:5)(cid:2)(cid:14)(cid:46)(cid:2)(cid:28)(cid:5)(cid:3)(cid:10)(cid:5)(cid:2)(cid:64)(cid:46)(cid:4)(cid:12)(cid:2)(cid:28)(cid:3,Unknown,9707.0
Unknown,Unknown,29,Unknown,Unknown,Unknown,Unknown,cid:50)(cid:46)(cid:12)(cid:2)(cid:7)(cid:8)(cid:10)(cid:5)(cid:3)(cid:48)(cid:46)(cid:3)(cid:12)(cid:13)(cid:5)(cid:2)(cid:14)(cid:46)(cid:2)(cid:28)(cid:5)(cid:3)(cid:10)(cid:5)(cid:2)(cid:64)(cid:46)(cid:4)(cid:12)(cid:2)(cid:28)(cid:3,Unknown,9736.0
Unknown,Unknown,31,Unknown,Unknown,Unknown,Unknown,cid:50)(cid:46)(cid:12)(cid:2)(cid:7)(cid:8)(cid:10)(cid:5)(cid:3)(cid:48)(cid:46)(cid:3)(cid:12)(cid:13)(cid:5)(cid:2)(cid:14)(cid:46)(cid:2)(cid:28)(cid:5)(cid:3)(cid:10)(cid:5)(cid:2)(cid:64)(cid:46)(cid:4)(cid:12)(cid:2)(cid:28)(cid:3,Unknown,9767.0
Unknown,Unknown,54,Unknown,Unknown,Unknown,Unknown,cid:50)(cid:46)(cid:12)(cid:2)(cid:7)(cid:8)(cid:10)(cid:5)(cid:3)(cid:48)(cid:46)(cid:3)(cid:12)(cid:13)(cid:5)(cid:2)(cid:14)(cid:46)(cid:2)(cid:28)(cid:5)(cid:3)(cid:10)(cid:5)(cid:2)(cid:64)(cid:46)(cid:4)(cid:12)(cid:2)(cid:28)(cid:3,Unknown,9821.0
Unknown,Unknown,29,Unknown,Unknown,Unknown,Unknown,cid:50)(cid:46)(cid:12)(cid:2)(cid:7)(cid:8)(cid:10)(cid:5)(cid:3)(cid:48)(cid:46)(cid:3)(cid:12)(cid:13)(cid:5)(cid:2)(cid:14)(cid:46)(cid:2)(cid:28)(cid:5)(cid:3)(cid:10)(cid:5)(cid:2)(cid:64)(cid:46)(cid:4)(cid:12)(cid:2)(cid:28)(cid:3,Unknown,9850.0
Unknown,Unknown,41,Unknown,Unknown,Unknown,Unknown,cid:50)(cid:46)(cid:12)(cid:2)(cid:7)(cid:8)(cid:10)(cid:5)(cid:3)(cid:48)(cid:46)(cid:3)(cid:12)(cid:13)(cid:5)(cid:2)(cid:14)(cid:46)(cid:2)(cid:28)(cid:5)(cid:3)(cid:10)(cid:5)(cid:2)(cid:64)(cid:46)(cid:4)(cid:12)(cid:2)(cid:28)(cid:3,Unknown,9891.0
Unknown,Unknown,2,Unknown,Unknown,Unknown,Unknown,cid:50)(cid:46)(cid:12)(cid:2)(cid:7)(cid:8)(cid:10)(cid:5)(cid:3)(cid:48)(cid:46)(cid:3)(cid:12)(cid:13)(cid:5)(cid:2)(cid:14)(cid:46)(cid:2)(cid:28)(cid:5)(cid:3)(cid:10)(cid:5)(cid:2)(cid:64)(cid:46)(cid:4)(cid:12)(cid:2)(cid:28)(cid:3,Unknown,9893.0
Unknown,Unknown,51,Unknown,Unknown,Unknown,Unknown,cid:50)(cid:46)(cid:12)(cid:2)(cid:7)(cid:8)(cid:10)(cid:5)(cid:3)(cid:48)(cid:46)(cid:3)(cid:12)(cid:13)(cid:5)(cid:2)(cid:14)(cid:46)(cid:2)(cid:28)(cid:5)(cid:3)(cid:10)(cid:5)(cid:2)(cid:64)(cid:46)(cid:4)(cid:12)(cid:2)(cid:28)(cid:3,Unknown,9944.0
Unknown,Unknown,25,Unknown,Unknown,Unknown,Unknown,cid:50)(cid:46)(cid:12)(cid:2)(cid:7)(cid:8)(cid:10)(cid:5)(cid:3)(cid:48)(cid:46)(cid:3)(cid:12)(cid:13)(cid:5)(cid:2)(cid:14)(cid:46)(cid:2)(cid:28)(cid:5)(cid:3)(cid:10)(cid:5)(cid:2)(cid:64)(cid:46)(cid:4)(cid:12)(cid:2)(cid:28)(cid:3,Unknown,9969.0
Unknown,Unknown,22,Unknown,Unknown,Unknown,Unknown,cid:50)(cid:46)(cid:12)(cid:2)(cid:7)(cid:8)(cid:10)(cid:5)(cid:3)(cid:48)(cid:46)(cid:3)(cid:12)(cid:13)(cid:5)(cid:2)(cid:14)(cid:46)(cid:2)(cid:28)(cid:5)(cid:3)(cid:10)(cid:5)(cid:2)(cid:64)(cid:46)(cid:4)(cid:12)(cid:2)(cid:28)(cid:3,Unknown,9991.0
Unknown,Unknown,22,Unknown,Unknown,Unknown,Unknown,cid:50)(cid:46)(cid:12)(cid:2)(cid:7)(cid:8)(cid:10)(cid:5)(cid:3)(cid:48)(cid:46)(cid:3)(cid:12)(cid:13)(cid:5)(cid:2)(cid:14)(cid:46)(cid:2)(cid:28)(cid:5)(cid:3)(cid:10)(cid:5)(cid:2)(cid:64)(cid:46)(cid:4)(cid:12)(cid:2)(cid:28)(cid:3,Unknown,10013.0
Unknown,Unknown,25,Unknown,Unknown,Unknown,Unknown,cid:50)(cid:46)(cid:12)(cid:2)(cid:7)(cid:8)(cid:10)(cid:5)(cid:3)(cid:48)(cid:46)(cid:3)(cid:12)(cid:13)(cid:5)(cid:2)(cid:14)(cid:46)(cid:2)(cid:28)(cid:5)(cid:3)(cid:10)(cid:5)(cid:2)(cid:64)(cid:46)(cid:4)(cid:12)(cid:2)(cid:28)(cid:3,Unknown,10038.0
Unknown,Unknown,18,Unknown,Unknown,Unknown,Unknown,cid:50)(cid:46)(cid:12)(cid:2)(cid:7)(cid:8)(cid:10)(cid:5)(cid:3)(cid:48)(cid:46)(cid:3)(cid:12)(cid:13)(cid:5)(cid:2)(cid:14)(cid:46)(cid:2)(cid:28)(cid:5)(cid:3)(cid:10)(cid:5)(cid:2)(cid:64)(cid:46)(cid:4)(cid:12)(cid:2)(cid:28)(cid:3,Unknown,10056.0
Unknown,Unknown,32,Unknown,Unknown,Unknown,Unknown,cid:50)(cid:46)(cid:12)(cid:2)(cid:7)(cid:8)(cid:10)(cid:5)(cid:3)(cid:48)(cid:46)(cid:3)(cid:12)(cid:13)(cid:5)(cid:2)(cid:14)(cid:46)(cid:2)(cid:28)(cid:5)(cid:3)(cid:10)(cid:5)(cid:2)(cid:64)(cid:46)(cid:4)(cid:12)(cid:2)(cid:28)(cid:3,Unknown,10088.0
Unknown,Unknown,45,Unknown,Unknown,Unknown,Unknown,cid:50)(cid:46)(cid:12)(cid:2)(cid:7)(cid:8)(cid:10)(cid:5)(cid:3)(cid:48)(cid:46)(cid:3)(cid:12)(cid:13)(cid:5)(cid:2)(cid:14)(cid:46)(cid:2)(cid:28)(cid:5)(cid:3)(cid:10)(cid:5)(cid:2)(cid:64)(cid:46)(cid:4)(cid:12)(cid:2)(cid:28)(cid:3,Unknown,10133.0
Unknown,Unknown,18,Unknown,Unknown,Unknown,Unknown,cid:50)(cid:46)(cid:12)(cid:2)(cid:7)(cid:8)(cid:10)(cid:5)(cid:3)(cid:48)(cid:46)(cid:3)(cid:12)(cid:13)(cid:5)(cid:2)(cid:14)(cid:46)(cid:2)(cid:28)(cid:5)(cid:3)(cid:10)(cid:5)(cid:2)(cid:64)(cid:46)(cid:4)(cid:12)(cid:2)(cid:28)(cid:3,Unknown,10151.0
Unknown,Unknown,16,Unknown,Unknown,Unknown,Unknown,cid:50)(cid:46)(cid:12)(cid:2)(cid:7)(cid:8)(cid:10)(cid:5)(cid:3)(cid:48)(cid:46)(cid:3)(cid:12)(cid:13)(cid:5)(cid:2)(cid:14)(cid:46)(cid:2)(cid:28)(cid:5)(cid:3)(cid:10)(cid:5)(cid:2)(cid:64)(cid:46)(cid:4)(cid:12)(cid:2)(cid:28)(cid:3,Unknown,10167.0
Unknown,Unknown,50,Unknown,Unknown,Unknown,Unknown,cid:50)(cid:46)(cid:12)(cid:2)(cid:7)(cid:8)(cid:10)(cid:5)(cid:3)(cid:48)(cid:46)(cid:3)(cid:12)(cid:13)(cid:5)(cid:2)(cid:14)(cid:46)(cid:2)(cid:28)(cid:5)(cid:3)(cid:10)(cid:5)(cid:2)(cid:64)(cid:46)(cid:4)(cid:12)(cid:2)(cid:28)(cid:3,Unknown,10217.0
Unknown,Unknown,46,Unknown,Unknown,Unknown,Unknown,cid:50)(cid:46)(cid:12)(cid:2)(cid:7)(cid:8)(cid:10)(cid:5)(cid:3)(cid:48)(cid:46)(cid:3)(cid:12)(cid:13)(cid:5)(cid:2)(cid:14)(cid:46)(cid:2)(cid:28)(cid:5)(cid:3)(cid:10)(cid:5)(cid:2)(cid:64)(cid:46)(cid:4)(cid:12)(cid:2)(cid:28)(cid:3,Unknown,10263.0
Unknown,Unknown,12,Unknown,Unknown,Unknown,Unknown,cid:50)(cid:46)(cid:12)(cid:2)(cid:7)(cid:8)(cid:10)(cid:5)(cid:3)(cid:48)(cid:46)(cid:3)(cid:12)(cid:13)(cid:5)(cid:2)(cid:14)(cid:46)(cid:2)(cid:28)(cid:5)(cid:3)(cid:10)(cid:5)(cid:2)(cid:64)(cid:46)(cid:4)(cid:12)(cid:2)(cid:28)(cid:3,Unknown,10275.0
Unknown,Unknown,2,Unknown,Unknown,Unknown,Unknown,cid:50)(cid:46)(cid:12)(cid:2)(cid:7)(cid:8)(cid:10)(cid:5)(cid:3)(cid:48)(cid:46)(cid:3)(cid:12)(cid:13)(cid:5)(cid:2)(cid:14)(cid:46)(cid:2)(cid:28)(cid:5)(cid:3)(cid:10)(cid:5)(cid:2)(cid:64)(cid:46)(cid:4)(cid:12)(cid:2)(cid:28)(cid:3,Unknown,10277.0
Unknown,Unknown,7,Unknown,Unknown,Unknown,Unknown,cid:50)(cid:46)(cid:12)(cid:2)(cid:7)(cid:8)(cid:10)(cid:5)(cid:3)(cid:48)(cid:46)(cid:3)(cid:12)(cid:13)(cid:5)(cid:2)(cid:14)(cid:46)(cid:2)(cid:28)(cid:5)(cid:3)(cid:10)(cid:5)(cid:2)(cid:64)(cid:46)(cid:4)(cid:12)(cid:2)(cid:28)(cid:3,Unknown,10284.0
Unknown,Unknown,8,Unknown,Unknown,Unknown,Unknown,cid:50)(cid:46)(cid:12)(cid:2)(cid:7)(cid:8)(cid:10)(cid:5)(cid:3)(cid:48)(cid:46)(cid:3)(cid:12)(cid:13)(cid:5)(cid:2)(cid:14)(cid:46)(cid:2)(cid:28)(cid:5)(cid:3)(cid:10)(cid:5)(cid:2)(cid:64)(cid:46)(cid:4)(cid:12)(cid:2)(cid:28)(cid:3,Unknown,10292.0
Unknown,Unknown,10,Unknown,Unknown,Unknown,Unknown,cid:50)(cid:46)(cid:12)(cid:2)(cid:7)(cid:8)(cid:10)(cid:5)(cid:3)(cid:48)(cid:46)(cid:3)(cid:12)(cid:13)(cid:5)(cid:2)(cid:14)(cid:46)(cid:2)(cid:28)(cid:5)(cid:3)(cid:10)(cid:5)(cid:2)(cid:64)(cid:46)(cid:4)(cid:12)(cid:2)(cid:28)(cid:3,Unknown,10302.0
Unknown,Unknown,5,Unknown,Unknown,Unknown,Unknown,cid:50)(cid:46)(cid:12)(cid:2)(cid:7)(cid:8)(cid:10)(cid:5)(cid:3)(cid:48)(cid:46)(cid:3)(cid:12)(cid:13)(cid:5)(cid:2)(cid:14)(cid:46)(cid:2)(cid:28)(cid:5)(cid:3)(cid:10)(cid:5)(cid:2)(cid:64)(cid:46)(cid:4)(cid:12)(cid:2)(cid:28)(cid:3,Unknown,10307.0
Unknown,Unknown,3,Unknown,Unknown,Unknown,Unknown,cid:50)(cid:46)(cid:12)(cid:2)(cid:7)(cid:8)(cid:10)(cid:5)(cid:3)(cid:48)(cid:46)(cid:3)(cid:12)(cid:13)(cid:5)(cid:2)(cid:14)(cid:46)(cid:2)(cid:28)(cid:5)(cid:3)(cid:10)(cid:5)(cid:2)(cid:64)(cid:46)(cid:4)(cid:12)(cid:2)(cid:28)(cid:3,Unknown,10310.0
Unknown,Unknown,48,Unknown,Unknown,Unknown,Unknown,cid:50)(cid:46)(cid:12)(cid:2)(cid:7)(cid:8)(cid:10)(cid:5)(cid:3)(cid:48)(cid:46)(cid:3)(cid:12)(cid:13)(cid:5)(cid:2)(cid:14)(cid:46)(cid:2)(cid:28)(cid:5)(cid:3)(cid:10)(cid:5)(cid:2)(cid:64)(cid:46)(cid:4)(cid:12)(cid:2)(cid:28)(cid:3,Unknown,10358.0
Unknown,Unknown,46,Unknown,Unknown,Unknown,Unknown,cid:50)(cid:46)(cid:12)(cid:2)(cid:7)(cid:8)(cid:10)(cid:5)(cid:3)(cid:48)(cid:46)(cid:3)(cid:12)(cid:13)(cid:5)(cid:2)(cid:14)(cid:46)(cid:2)(cid:28)(cid:5)(cid:3)(cid:10)(cid:5)(cid:2)(cid:64)(cid:46)(cid:4)(cid:12)(cid:2)(cid:28)(cid:3,Unknown,10404.0
Unknown,Unknown,3,Unknown,Unknown,Unknown,Unknown,cid:50)(cid:46)(cid:12)(cid:2)(cid:7)(cid:8)(cid:10)(cid:5)(cid:3)(cid:48)(cid:46)(cid:3)(cid:12)(cid:13)(cid:5)(cid:2)(cid:14)(cid:46)(cid:2)(cid:28)(cid:5)(cid:3)(cid:10)(cid:5)(cid:2)(cid:64)(cid:46)(cid:4)(cid:12)(cid:2)(cid:28)(cid:3,Unknown,10407.0
Unknown,Unknown,12,Unknown,Unknown,Unknown,Unknown,cid:50)(cid:46)(cid:12)(cid:2)(cid:7)(cid:8)(cid:10)(cid:5)(cid:3)(cid:48)(cid:46)(cid:3)(cid:12)(cid:13)(cid:5)(cid:2)(cid:14)(cid:46)(cid:2)(cid:28)(cid:5)(cid:3)(cid:10)(cid:5)(cid:2)(cid:64)(cid:46)(cid:4)(cid:12)(cid:2)(cid:28)(cid:3,Unknown,10419.0
Unknown,Unknown,13,Unknown,Unknown,Unknown,Unknown,cid:50)(cid:46)(cid:12)(cid:2)(cid:7)(cid:8)(cid:10)(cid:5)(cid:3)(cid:48)(cid:46)(cid:3)(cid:12)(cid:13)(cid:5)(cid:2)(cid:14)(cid:46)(cid:2)(cid:28)(cid:5)(cid:3)(cid:10)(cid:5)(cid:2)(cid:64)(cid:46)(cid:4)(cid:12)(cid:2)(cid:28)(cid:3,Unknown,10432.0
Unknown,Unknown,5,Unknown,Unknown,Unknown,Unknown,cid:50)(cid:46)(cid:12)(cid:2)(cid:7)(cid:8)(cid:10)(cid:5)(cid:3)(cid:48)(cid:46)(cid:3)(cid:12)(cid:13)(cid:5)(cid:2)(cid:14)(cid:46)(cid:2)(cid:28)(cid:5)(cid:3)(cid:10)(cid:5)(cid:2)(cid:64)(cid:46)(cid:4)(cid:12)(cid:2)(cid:28)(cid:3,Unknown,10437.0
Unknown,Unknown,2,Unknown,Unknown,Unknown,Unknown,cid:50)(cid:46)(cid:12)(cid:2)(cid:7)(cid:8)(cid:10)(cid:5)(cid:3)(cid:48)(cid:46)(cid:3)(cid:12)(cid:13)(cid:5)(cid:2)(cid:14)(cid:46)(cid:2)(cid:28)(cid:5)(cid:3)(cid:10)(cid:5)(cid:2)(cid:64)(cid:46)(cid:4)(cid:12)(cid:2)(cid:28)(cid:3,Unknown,10439.0
Unknown,Unknown,14,Unknown,Unknown,Unknown,Unknown,cid:50)(cid:46)(cid:12)(cid:2)(cid:7)(cid:8)(cid:10)(cid:5)(cid:3)(cid:48)(cid:46)(cid:3)(cid:12)(cid:13)(cid:5)(cid:2)(cid:14)(cid:46)(cid:2)(cid:28)(cid:5)(cid:3)(cid:10)(cid:5)(cid:2)(cid:64)(cid:46)(cid:4)(cid:12)(cid:2)(cid:28)(cid:3,Unknown,10453.0
Unknown,Unknown,46,Unknown,Unknown,Unknown,Unknown,cid:50)(cid:46)(cid:12)(cid:2)(cid:7)(cid:8)(cid:10)(cid:5)(cid:3)(cid:48)(cid:46)(cid:3)(cid:12)(cid:13)(cid:5)(cid:2)(cid:14)(cid:46)(cid:2)(cid:28)(cid:5)(cid:3)(cid:10)(cid:5)(cid:2)(cid:64)(cid:46)(cid:4)(cid:12)(cid:2)(cid:28)(cid:3,Unknown,10499.0
Unknown,Unknown,2,Unknown,Unknown,Unknown,Unknown,cid:50)(cid:46)(cid:12)(cid:2)(cid:7)(cid:8)(cid:10)(cid:5)(cid:3)(cid:48)(cid:46)(cid:3)(cid:12)(cid:13)(cid:5)(cid:2)(cid:14)(cid:46)(cid:2)(cid:28)(cid:5)(cid:3)(cid:10)(cid:5)(cid:2)(cid:64)(cid:46)(cid:4)(cid:12)(cid:2)(cid:28)(cid:3,Unknown,10501.0
Unknown,Unknown,28,Unknown,Unknown,Unknown,Unknown,cid:50)(cid:46)(cid:12)(cid:2)(cid:7)(cid:8)(cid:10)(cid:5)(cid:3)(cid:48)(cid:46)(cid:3)(cid:12)(cid:13)(cid:5)(cid:2)(cid:14)(cid:46)(cid:2)(cid:28)(cid:5)(cid:3)(cid:10)(cid:5)(cid:2)(cid:64)(cid:46)(cid:4)(cid:12)(cid:2)(cid:28)(cid:3,Unknown,10529.0
Unknown,Unknown,5,Unknown,Unknown,Unknown,Unknown,cid:50)(cid:46)(cid:12)(cid:2)(cid:7)(cid:8)(cid:10)(cid:5)(cid:3)(cid:48)(cid:46)(cid:3)(cid:12)(cid:13)(cid:5)(cid:2)(cid:14)(cid:46)(cid:2)(cid:28)(cid:5)(cid:3)(cid:10)(cid:5)(cid:2)(cid:64)(cid:46)(cid:4)(cid:12)(cid:2)(cid:28)(cid:3,Unknown,10534.0
Unknown,Unknown,3,Unknown,Unknown,Unknown,Unknown,cid:50)(cid:46)(cid:12)(cid:2)(cid:7)(cid:8)(cid:10)(cid:5)(cid:3)(cid:48)(cid:46)(cid:3)(cid:12)(cid:13)(cid:5)(cid:2)(cid:14)(cid:46)(cid:2)(cid:28)(cid:5)(cid:3)(cid:10)(cid:5)(cid:2)(cid:64)(cid:46)(cid:4)(cid:12)(cid:2)(cid:28)(cid:3,Unknown,10537.0
Unknown,Unknown,10,Unknown,Unknown,Unknown,Unknown,cid:50)(cid:46)(cid:12)(cid:2)(cid:7)(cid:8)(cid:10)(cid:5)(cid:3)(cid:48)(cid:46)(cid:3)(cid:12)(cid:13)(cid:5)(cid:2)(cid:14)(cid:46)(cid:2)(cid:28)(cid:5)(cid:3)(cid:10)(cid:5)(cid:2)(cid:64)(cid:46)(cid:4)(cid:12)(cid:2)(cid:28)(cid:3,Unknown,10547.0
Unknown,Unknown,5,Unknown,Unknown,Unknown,Unknown,cid:50)(cid:46)(cid:12)(cid:2)(cid:7)(cid:8)(cid:10)(cid:5)(cid:3)(cid:48)(cid:46)(cid:3)(cid:12)(cid:13)(cid:5)(cid:2)(cid:14)(cid:46)(cid:2)(cid:28)(cid:5)(cid:3)(cid:10)(cid:5)(cid:2)(cid:64)(cid:46)(cid:4)(cid:12)(cid:2)(cid:28)(cid:3,Unknown,10552.0
Unknown,Unknown,2,Unknown,Unknown,Unknown,Unknown,cid:50)(cid:46)(cid:12)(cid:2)(cid:7)(cid:8)(cid:10)(cid:5)(cid:3)(cid:48)(cid:46)(cid:3)(cid:12)(cid:13)(cid:5)(cid:2)(cid:14)(cid:46)(cid:2)(cid:28)(cid:5)(cid:3)(cid:10)(cid:5)(cid:2)(cid:64)(cid:46)(cid:4)(cid:12)(cid:2)(cid:28)(cid:3,Unknown,10554.0
Unknown,Unknown,64,Unknown,Unknown,Unknown,Unknown,cid:50)(cid:46)(cid:12)(cid:2)(cid:7)(cid:8)(cid:10)(cid:5)(cid:3)(cid:48)(cid:46)(cid:3)(cid:12)(cid:13)(cid:5)(cid:2)(cid:14)(cid:46)(cid:2)(cid:28)(cid:5)(cid:3)(cid:10)(cid:5)(cid:2)(cid:64)(cid:46)(cid:4)(cid:12)(cid:2)(cid:28)(cid:3,Unknown,10618.0
Unknown,Unknown,46,Unknown,Unknown,Unknown,Unknown,cid:50)(cid:46)(cid:12)(cid:2)(cid:7)(cid:8)(cid:10)(cid:5)(cid:3)(cid:48)(cid:46)(cid:3)(cid:12)(cid:13)(cid:5)(cid:2)(cid:14)(cid:46)(cid:2)(cid:28)(cid:5)(cid:3)(cid:10)(cid:5)(cid:2)(cid:64)(cid:46)(cid:4)(cid:12)(cid:2)(cid:28)(cid:3,Unknown,10664.0
Unknown,Unknown,4,Unknown,Unknown,Unknown,Unknown,cid:50)(cid:46)(cid:12)(cid:2)(cid:7)(cid:8)(cid:10)(cid:5)(cid:3)(cid:48)(cid:46)(cid:3)(cid:12)(cid:13)(cid:5)(cid:2)(cid:14)(cid:46)(cid:2)(cid:28)(cid:5)(cid:3)(cid:10)(cid:5)(cid:2)(cid:64)(cid:46)(cid:4)(cid:12)(cid:2)(cid:28)(cid:3,Unknown,10668.0
Unknown,Unknown,12,Unknown,Unknown,Unknown,Unknown,cid:50)(cid:46)(cid:12)(cid:2)(cid:7)(cid:8)(cid:10)(cid:5)(cid:3)(cid:48)(cid:46)(cid:3)(cid:12)(cid:13)(cid:5)(cid:2)(cid:14)(cid:46)(cid:2)(cid:28)(cid:5)(cid:3)(cid:10)(cid:5)(cid:2)(cid:64)(cid:46)(cid:4)(cid:12)(cid:2)(cid:28)(cid:3,Unknown,10680.0
Unknown,Unknown,2,Unknown,Unknown,Unknown,Unknown,cid:50)(cid:46)(cid:12)(cid:2)(cid:7)(cid:8)(cid:10)(cid:5)(cid:3)(cid:48)(cid:46)(cid:3)(cid:12)(cid:13)(cid:5)(cid:2)(cid:14)(cid:46)(cid:2)(cid:28)(cid:5)(cid:3)(cid:10)(cid:5)(cid:2)(cid:64)(cid:46)(cid:4)(cid:12)(cid:2)(cid:28)(cid:3,Unknown,10682.0
Unknown,Unknown,28,Unknown,Unknown,Unknown,Unknown,cid:50)(cid:46)(cid:12)(cid:2)(cid:7)(cid:8)(cid:10)(cid:5)(cid:3)(cid:48)(cid:46)(cid:3)(cid:12)(cid:13)(cid:5)(cid:2)(cid:14)(cid:46)(cid:2)(cid:28)(cid:5)(cid:3)(cid:10)(cid:5)(cid:2)(cid:64)(cid:46)(cid:4)(cid:12)(cid:2)(cid:28)(cid:3,Unknown,10710.0
Unknown,Unknown,3,Unknown,Unknown,Unknown,Unknown,cid:50)(cid:46)(cid:12)(cid:2)(cid:7)(cid:8)(cid:10)(cid:5)(cid:3)(cid:48)(cid:46)(cid:3)(cid:12)(cid:13)(cid:5)(cid:2)(cid:14)(cid:46)(cid:2)(cid:28)(cid:5)(cid:3)(cid:10)(cid:5)(cid:2)(cid:64)(cid:46)(cid:4)(cid:12)(cid:2)(cid:28)(cid:3,Unknown,10713.0
Unknown,Unknown,15,Unknown,Unknown,Unknown,Unknown,cid:50)(cid:46)(cid:12)(cid:2)(cid:7)(cid:8)(cid:10)(cid:5)(cid:3)(cid:48)(cid:46)(cid:3)(cid:12)(cid:13)(cid:5)(cid:2)(cid:14)(cid:46)(cid:2)(cid:28)(cid:5)(cid:3)(cid:10)(cid:5)(cid:2)(cid:64)(cid:46)(cid:4)(cid:12)(cid:2)(cid:28)(cid:3,Unknown,10728.0
Unknown,Unknown,2,Unknown,Unknown,Unknown,Unknown,cid:50)(cid:46)(cid:12)(cid:2)(cid:7)(cid:8)(cid:10)(cid:5)(cid:3)(cid:48)(cid:46)(cid:3)(cid:12)(cid:13)(cid:5)(cid:2)(cid:14)(cid:46)(cid:2)(cid:28)(cid:5)(cid:3)(cid:10)(cid:5)(cid:2)(cid:64)(cid:46)(cid:4)(cid:12)(cid:2)(cid:28)(cid:3,Unknown,10730.0
Unknown,Unknown,35,Unknown,Unknown,Unknown,Unknown,cid:50)(cid:46)(cid:12)(cid:2)(cid:7)(cid:8)(cid:10)(cid:5)(cid:3)(cid:48)(cid:46)(cid:3)(cid:12)(cid:13)(cid:5)(cid:2)(cid:14)(cid:46)(cid:2)(cid:28)(cid:5)(cid:3)(cid:10)(cid:5)(cid:2)(cid:64)(cid:46)(cid:4)(cid:12)(cid:2)(cid:28)(cid:3,Unknown,10765.0
Unknown,Unknown,18,Unknown,Unknown,Unknown,Unknown,cid:50)(cid:46)(cid:12)(cid:2)(cid:7)(cid:8)(cid:10)(cid:5)(cid:3)(cid:48)(cid:46)(cid:3)(cid:12)(cid:13)(cid:5)(cid:2)(cid:14)(cid:46)(cid:2)(cid:28)(cid:5)(cid:3)(cid:10)(cid:5)(cid:2)(cid:64)(cid:46)(cid:4)(cid:12)(cid:2)(cid:28)(cid:3,Unknown,10783.0
Unknown,Unknown,19,Unknown,Unknown,Unknown,Unknown,cid:50)(cid:46)(cid:12)(cid:2)(cid:7)(cid:8)(cid:10)(cid:5)(cid:3)(cid:48)(cid:46)(cid:3)(cid:12)(cid:13)(cid:5)(cid:2)(cid:14)(cid:46)(cid:2)(cid:28)(cid:5)(cid:3)(cid:10)(cid:5)(cid:2)(cid:64)(cid:46)(cid:4)(cid:12)(cid:2)(cid:28)(cid:3,Unknown,10802.0
Unknown,Unknown,18,Unknown,Unknown,Unknown,Unknown,cid:50)(cid:46)(cid:12)(cid:2)(cid:7)(cid:8)(cid:10)(cid:5)(cid:3)(cid:48)(cid:46)(cid:3)(cid:12)(cid:13)(cid:5)(cid:2)(cid:14)(cid:46)(cid:2)(cid:28)(cid:5)(cid:3)(cid:10)(cid:5)(cid:2)(cid:64)(cid:46)(cid:4)(cid:12)(cid:2)(cid:28)(cid:3,Unknown,10820.0
Unknown,Unknown,18,Unknown,Unknown,Unknown,Unknown,cid:50)(cid:46)(cid:12)(cid:2)(cid:7)(cid:8)(cid:10)(cid:5)(cid:3)(cid:48)(cid:46)(cid:3)(cid:12)(cid:13)(cid:5)(cid:2)(cid:14)(cid:46)(cid:2)(cid:28)(cid:5)(cid:3)(cid:10)(cid:5)(cid:2)(cid:64)(cid:46)(cid:4)(cid:12)(cid:2)(cid:28)(cid:3,Unknown,10838.0
Unknown,Unknown,2,Unknown,Unknown,Unknown,Unknown,cid:50)(cid:46)(cid:12)(cid:2)(cid:7)(cid:8)(cid:10)(cid:5)(cid:3)(cid:48)(cid:46)(cid:3)(cid:12)(cid:13)(cid:5)(cid:2)(cid:14)(cid:46)(cid:2)(cid:28)(cid:5)(cid:3)(cid:10)(cid:5)(cid:2)(cid:64)(cid:46)(cid:4)(cid:12)(cid:2)(cid:28)(cid:3,Unknown,10840.0
Unknown,Unknown,44,Unknown,Unknown,Unknown,Unknown,cid:50)(cid:46)(cid:12)(cid:2)(cid:7)(cid:8)(cid:10)(cid:5)(cid:3)(cid:48)(cid:46)(cid:3)(cid:12)(cid:13)(cid:5)(cid:2)(cid:14)(cid:46)(cid:2)(cid:28)(cid:5)(cid:3)(cid:10)(cid:5)(cid:2)(cid:64)(cid:46)(cid:4)(cid:12)(cid:2)(cid:28)(cid:3,Unknown,10884.0
Unknown,Unknown,12,Unknown,Unknown,Unknown,Unknown,cid:50)(cid:46)(cid:12)(cid:2)(cid:7)(cid:8)(cid:10)(cid:5)(cid:3)(cid:48)(cid:46)(cid:3)(cid:12)(cid:13)(cid:5)(cid:2)(cid:14)(cid:46)(cid:2)(cid:28)(cid:5)(cid:3)(cid:10)(cid:5)(cid:2)(cid:64)(cid:46)(cid:4)(cid:12)(cid:2)(cid:28)(cid:3,Unknown,10896.0
Unknown,Unknown,29,Unknown,Unknown,Unknown,Unknown,cid:50)(cid:46)(cid:12)(cid:2)(cid:7)(cid:8)(cid:10)(cid:5)(cid:3)(cid:48)(cid:46)(cid:3)(cid:12)(cid:13)(cid:5)(cid:2)(cid:14)(cid:46)(cid:2)(cid:28)(cid:5)(cid:3)(cid:10)(cid:5)(cid:2)(cid:64)(cid:46)(cid:4)(cid:12)(cid:2)(cid:28)(cid:3,Unknown,10925.0
Unknown,Unknown,26,Unknown,Unknown,Unknown,Unknown,cid:50)(cid:46)(cid:12)(cid:2)(cid:7)(cid:8)(cid:10)(cid:5)(cid:3)(cid:48)(cid:46)(cid:3)(cid:12)(cid:13)(cid:5)(cid:2)(cid:14)(cid:46)(cid:2)(cid:28)(cid:5)(cid:3)(cid:10)(cid:5)(cid:2)(cid:64)(cid:46)(cid:4)(cid:12)(cid:2)(cid:28)(cid:3,Unknown,10951.0
Unknown,Unknown,41,Unknown,Unknown,Unknown,Unknown,cid:50)(cid:46)(cid:12)(cid:2)(cid:7)(cid:8)(cid:10)(cid:5)(cid:3)(cid:48)(cid:46)(cid:3)(cid:12)(cid:13)(cid:5)(cid:2)(cid:14)(cid:46)(cid:2)(cid:28)(cid:5)(cid:3)(cid:10)(cid:5)(cid:2)(cid:64)(cid:46)(cid:4)(cid:12)(cid:2)(cid:28)(cid:3,Unknown,10992.0
Unknown,Unknown,25,Unknown,Unknown,Unknown,Unknown,cid:50)(cid:46)(cid:12)(cid:2)(cid:7)(cid:8)(cid:10)(cid:5)(cid:3)(cid:48)(cid:46)(cid:3)(cid:12)(cid:13)(cid:5)(cid:2)(cid:14)(cid:46)(cid:2)(cid:28)(cid:5)(cid:3)(cid:10)(cid:5)(cid:2)(cid:64)(cid:46)(cid:4)(cid:12)(cid:2)(cid:28)(cid:3,Unknown,11017.0
Unknown,Unknown,2,Unknown,Unknown,Unknown,Unknown,cid:50)(cid:46)(cid:12)(cid:2)(cid:7)(cid:8)(cid:10)(cid:5)(cid:3)(cid:48)(cid:46)(cid:3)(cid:12)(cid:13)(cid:5)(cid:2)(cid:14)(cid:46)(cid:2)(cid:28)(cid:5)(cid:3)(cid:10)(cid:5)(cid:2)(cid:64)(cid:46)(cid:4)(cid:12)(cid:2)(cid:28)(cid:3,Unknown,11019.0
Unknown,Unknown,58,Unknown,Unknown,Unknown,Unknown,cid:50)(cid:46)(cid:12)(cid:2)(cid:7)(cid:8)(cid:10)(cid:5)(cid:3)(cid:48)(cid:46)(cid:3)(cid:12)(cid:13)(cid:5)(cid:2)(cid:14)(cid:46)(cid:2)(cid:28)(cid:5)(cid:3)(cid:10)(cid:5)(cid:2)(cid:64)(cid:46)(cid:4)(cid:12)(cid:2)(cid:28)(cid:3,Unknown,11077.0
Unknown,Unknown,58,Unknown,Unknown,Unknown,Unknown,cid:50)(cid:46)(cid:12)(cid:2)(cid:7)(cid:8)(cid:10)(cid:5)(cid:3)(cid:48)(cid:46)(cid:3)(cid:12)(cid:13)(cid:5)(cid:2)(cid:14)(cid:46)(cid:2)(cid:28)(cid:5)(cid:3)(cid:10)(cid:5)(cid:2)(cid:64)(cid:46)(cid:4)(cid:12)(cid:2)(cid:28)(cid:3,Unknown,11135.0
Unknown,Unknown,18,Unknown,Unknown,Unknown,Unknown,cid:50)(cid:46)(cid:12)(cid:2)(cid:7)(cid:8)(cid:10)(cid:5)(cid:3)(cid:48)(cid:46)(cid:3)(cid:12)(cid:13)(cid:5)(cid:2)(cid:14)(cid:46)(cid:2)(cid:28)(cid:5)(cid:3)(cid:10)(cid:5)(cid:2)(cid:64)(cid:46)(cid:4)(cid:12)(cid:2)(cid:28)(cid:3,Unknown,11153.0
Unknown,Unknown,1,Unknown,Unknown,Unknown,Unknown,cid:50)(cid:46)(cid:12)(cid:2)(cid:7)(cid:8)(cid:10)(cid:5)(cid:3)(cid:48)(cid:46)(cid:3)(cid:12)(cid:13)(cid:5)(cid:2)(cid:14)(cid:46)(cid:2)(cid:28)(cid:5)(cid:3)(cid:10)(cid:5)(cid:2)(cid:64)(cid:46)(cid:4)(cid:12)(cid:2)(cid:28)(cid:3,Unknown,11154.0
Unknown,Unknown,1,Unknown,Unknown,Unknown,Unknown,cid:50)(cid:46)(cid:12)(cid:2)(cid:7)(cid:8)(cid:10)(cid:5)(cid:3)(cid:48)(cid:46)(cid:3)(cid:12)(cid:13)(cid:5)(cid:2)(cid:14)(cid:46)(cid:2)(cid:28)(cid:5)(cid:3)(cid:10)(cid:5)(cid:2)(cid:64)(cid:46)(cid:4)(cid:12)(cid:2)(cid:28)(cid:3,Unknown,11155.0
Unknown,Unknown,37,Unknown,Unknown,Unknown,Unknown,cid:50)(cid:46)(cid:12)(cid:2)(cid:7)(cid:8)(cid:10)(cid:5)(cid:3)(cid:48)(cid:46)(cid:3)(cid:12)(cid:13)(cid:5)(cid:2)(cid:14)(cid:46)(cid:2)(cid:28)(cid:5)(cid:3)(cid:10)(cid:5)(cid:2)(cid:64)(cid:46)(cid:4)(cid:12)(cid:2)(cid:28)(cid:3,Unknown,11192.0
Unknown,Unknown,18,Unknown,Unknown,Unknown,Unknown,cid:50)(cid:46)(cid:12)(cid:2)(cid:7)(cid:8)(cid:10)(cid:5)(cid:3)(cid:48)(cid:46)(cid:3)(cid:12)(cid:13)(cid:5)(cid:2)(cid:14)(cid:46)(cid:2)(cid:28)(cid:5)(cid:3)(cid:10)(cid:5)(cid:2)(cid:64)(cid:46)(cid:4)(cid:12)(cid:2)(cid:28)(cid:3,Unknown,11210.0
Unknown,Unknown,32,Unknown,Unknown,Unknown,Unknown,cid:50)(cid:46)(cid:12)(cid:2)(cid:7)(cid:8)(cid:10)(cid:5)(cid:3)(cid:48)(cid:46)(cid:3)(cid:12)(cid:13)(cid:5)(cid:2)(cid:14)(cid:46)(cid:2)(cid:28)(cid:5)(cid:3)(cid:10)(cid:5)(cid:2)(cid:64)(cid:46)(cid:4)(cid:12)(cid:2)(cid:28)(cid:3,Unknown,11242.0
Unknown,Unknown,45,Unknown,Unknown,Unknown,Unknown,cid:50)(cid:46)(cid:12)(cid:2)(cid:7)(cid:8)(cid:10)(cid:5)(cid:3)(cid:48)(cid:46)(cid:3)(cid:12)(cid:13)(cid:5)(cid:2)(cid:14)(cid:46)(cid:2)(cid:28)(cid:5)(cid:3)(cid:10)(cid:5)(cid:2)(cid:64)(cid:46)(cid:4)(cid:12)(cid:2)(cid:28)(cid:3,Unknown,11287.0
Unknown,Unknown,18,Unknown,Unknown,Unknown,Unknown,cid:50)(cid:46)(cid:12)(cid:2)(cid:7)(cid:8)(cid:10)(cid:5)(cid:3)(cid:48)(cid:46)(cid:3)(cid:12)(cid:13)(cid:5)(cid:2)(cid:14)(cid:46)(cid:2)(cid:28)(cid:5)(cid:3)(cid:10)(cid:5)(cid:2)(cid:64)(cid:46)(cid:4)(cid:12)(cid:2)(cid:28)(cid:3,Unknown,11305.0
Unknown,Unknown,16,Unknown,Unknown,Unknown,Unknown,cid:50)(cid:46)(cid:12)(cid:2)(cid:7)(cid:8)(cid:10)(cid:5)(cid:3)(cid:48)(cid:46)(cid:3)(cid:12)(cid:13)(cid:5)(cid:2)(cid:14)(cid:46)(cid:2)(cid:28)(cid:5)(cid:3)(cid:10)(cid:5)(cid:2)(cid:64)(cid:46)(cid:4)(cid:12)(cid:2)(cid:28)(cid:3,Unknown,11321.0
Unknown,Unknown,65,Unknown,Unknown,Unknown,Unknown,cid:50)(cid:46)(cid:12)(cid:2)(cid:7)(cid:8)(cid:10)(cid:5)(cid:3)(cid:48)(cid:46)(cid:3)(cid:12)(cid:13)(cid:5)(cid:2)(cid:14)(cid:46)(cid:2)(cid:28)(cid:5)(cid:3)(cid:10)(cid:5)(cid:2)(cid:64)(cid:46)(cid:4)(cid:12)(cid:2)(cid:28)(cid:3,Unknown,11386.0
Unknown,Unknown,28,Unknown,Unknown,Unknown,Unknown,cid:50)(cid:46)(cid:12)(cid:2)(cid:7)(cid:8)(cid:10)(cid:5)(cid:3)(cid:48)(cid:46)(cid:3)(cid:12)(cid:13)(cid:5)(cid:2)(cid:14)(cid:46)(cid:2)(cid:28)(cid:5)(cid:3)(cid:10)(cid:5)(cid:2)(cid:64)(cid:46)(cid:4)(cid:12)(cid:2)(cid:28)(cid:3,Unknown,11414.0
Unknown,Unknown,12,Unknown,Unknown,Unknown,Unknown,cid:50)(cid:46)(cid:12)(cid:2)(cid:7)(cid:8)(cid:10)(cid:5)(cid:3)(cid:48)(cid:46)(cid:3)(cid:12)(cid:13)(cid:5)(cid:2)(cid:14)(cid:46)(cid:2)(cid:28)(cid:5)(cid:3)(cid:10)(cid:5)(cid:2)(cid:64)(cid:46)(cid:4)(cid:12)(cid:2)(cid:28)(cid:3,Unknown,11426.0
Unknown,Unknown,2,Unknown,Unknown,Unknown,Unknown,cid:50)(cid:46)(cid:12)(cid:2)(cid:7)(cid:8)(cid:10)(cid:5)(cid:3)(cid:48)(cid:46)(cid:3)(cid:12)(cid:13)(cid:5)(cid:2)(cid:14)(cid:46)(cid:2)(cid:28)(cid:5)(cid:3)(cid:10)(cid:5)(cid:2)(cid:64)(cid:46)(cid:4)(cid:12)(cid:2)(cid:28)(cid:3,Unknown,11428.0
Unknown,Unknown,48,Unknown,Unknown,Unknown,Unknown,cid:50)(cid:46)(cid:12)(cid:2)(cid:7)(cid:8)(cid:10)(cid:5)(cid:3)(cid:48)(cid:46)(cid:3)(cid:12)(cid:13)(cid:5)(cid:2)(cid:14)(cid:46)(cid:2)(cid:28)(cid:5)(cid:3)(cid:10)(cid:5)(cid:2)(cid:64)(cid:46)(cid:4)(cid:12)(cid:2)(cid:28)(cid:3,Unknown,11476.0
Unknown,Unknown,5,Unknown,Unknown,Unknown,Unknown,cid:50)(cid:46)(cid:12)(cid:2)(cid:7)(cid:8)(cid:10)(cid:5)(cid:3)(cid:48)(cid:46)(cid:3)(cid:12)(cid:13)(cid:5)(cid:2)(cid:14)(cid:46)(cid:2)(cid:28)(cid:5)(cid:3)(cid:10)(cid:5)(cid:2)(cid:64)(cid:46)(cid:4)(cid:12)(cid:2)(cid:28)(cid:3,Unknown,11481.0
Unknown,Unknown,46,Unknown,Unknown,Unknown,Unknown,cid:50)(cid:46)(cid:12)(cid:2)(cid:7)(cid:8)(cid:10)(cid:5)(cid:3)(cid:48)(cid:46)(cid:3)(cid:12)(cid:13)(cid:5)(cid:2)(cid:14)(cid:46)(cid:2)(cid:28)(cid:5)(cid:3)(cid:10)(cid:5)(cid:2)(cid:64)(cid:46)(cid:4)(cid:12)(cid:2)(cid:28)(cid:3,Unknown,11527.0
Unknown,Unknown,4,Unknown,Unknown,Unknown,Unknown,cid:50)(cid:46)(cid:12)(cid:2)(cid:7)(cid:8)(cid:10)(cid:5)(cid:3)(cid:48)(cid:46)(cid:3)(cid:12)(cid:13)(cid:5)(cid:2)(cid:14)(cid:46)(cid:2)(cid:28)(cid:5)(cid:3)(cid:10)(cid:5)(cid:2)(cid:64)(cid:46)(cid:4)(cid:12)(cid:2)(cid:28)(cid:3,Unknown,11531.0
Unknown,Unknown,40,Unknown,Unknown,Unknown,Unknown,cid:50)(cid:46)(cid:12)(cid:2)(cid:7)(cid:8)(cid:10)(cid:5)(cid:3)(cid:48)(cid:46)(cid:3)(cid:12)(cid:13)(cid:5)(cid:2)(cid:14)(cid:46)(cid:2)(cid:28)(cid:5)(cid:3)(cid:10)(cid:5)(cid:2)(cid:64)(cid:46)(cid:4)(cid:12)(cid:2)(cid:28)(cid:3,Unknown,11571.0
Unknown,Unknown,2,Unknown,Unknown,Unknown,Unknown,cid:50)(cid:46)(cid:12)(cid:2)(cid:7)(cid:8)(cid:10)(cid:5)(cid:3)(cid:48)(cid:46)(cid:3)(cid:12)(cid:13)(cid:5)(cid:2)(cid:14)(cid:46)(cid:2)(cid:28)(cid:5)(cid:3)(cid:10)(cid:5)(cid:2)(cid:64)(cid:46)(cid:4)(cid:12)(cid:2)(cid:28)(cid:3,Unknown,11573.0
Unknown,Unknown,48,Unknown,Unknown,Unknown,Unknown,cid:50)(cid:46)(cid:12)(cid:2)(cid:7)(cid:8)(cid:10)(cid:5)(cid:3)(cid:48)(cid:46)(cid:3)(cid:12)(cid:13)(cid:5)(cid:2)(cid:14)(cid:46)(cid:2)(cid:28)(cid:5)(cid:3)(cid:10)(cid:5)(cid:2)(cid:64)(cid:46)(cid:4)(cid:12)(cid:2)(cid:28)(cid:3,Unknown,11621.0
Unknown,Unknown,5,Unknown,Unknown,Unknown,Unknown,cid:50)(cid:46)(cid:12)(cid:2)(cid:7)(cid:8)(cid:10)(cid:5)(cid:3)(cid:48)(cid:46)(cid:3)(cid:12)(cid:13)(cid:5)(cid:2)(cid:14)(cid:46)(cid:2)(cid:28)(cid:5)(cid:3)(cid:10)(cid:5)(cid:2)(cid:64)(cid:46)(cid:4)(cid:12)(cid:2)(cid:28)(cid:3,Unknown,11626.0
Unknown,Unknown,46,Unknown,Unknown,Unknown,Unknown,cid:50)(cid:46)(cid:12)(cid:2)(cid:7)(cid:8)(cid:10)(cid:5)(cid:3)(cid:48)(cid:46)(cid:3)(cid:12)(cid:13)(cid:5)(cid:2)(cid:14)(cid:46)(cid:2)(cid:28)(cid:5)(cid:3)(cid:10)(cid:5)(cid:2)(cid:64)(cid:46)(cid:4)(cid:12)(cid:2)(cid:28)(cid:3,Unknown,11672.0
Unknown,Unknown,4,Unknown,Unknown,Unknown,Unknown,cid:50)(cid:46)(cid:12)(cid:2)(cid:7)(cid:8)(cid:10)(cid:5)(cid:3)(cid:48)(cid:46)(cid:3)(cid:12)(cid:13)(cid:5)(cid:2)(cid:14)(cid:46)(cid:2)(cid:28)(cid:5)(cid:3)(cid:10)(cid:5)(cid:2)(cid:64)(cid:46)(cid:4)(cid:12)(cid:2)(cid:28)(cid:3,Unknown,11676.0
Unknown,Unknown,40,Unknown,Unknown,Unknown,Unknown,cid:50)(cid:46)(cid:12)(cid:2)(cid:7)(cid:8)(cid:10)(cid:5)(cid:3)(cid:48)(cid:46)(cid:3)(cid:12)(cid:13)(cid:5)(cid:2)(cid:14)(cid:46)(cid:2)(cid:28)(cid:5)(cid:3)(cid:10)(cid:5)(cid:2)(cid:64)(cid:46)(cid:4)(cid:12)(cid:2)(cid:28)(cid:3,Unknown,11716.0
Unknown,Unknown,2,Unknown,Unknown,Unknown,Unknown,cid:50)(cid:46)(cid:12)(cid:2)(cid:7)(cid:8)(cid:10)(cid:5)(cid:3)(cid:48)(cid:46)(cid:3)(cid:12)(cid:13)(cid:5)(cid:2)(cid:14)(cid:46)(cid:2)(cid:28)(cid:5)(cid:3)(cid:10)(cid:5)(cid:2)(cid:64)(cid:46)(cid:4)(cid:12)(cid:2)(cid:28)(cid:3,Unknown,11718.0
Unknown,Unknown,28,Unknown,Unknown,Unknown,Unknown,cid:50)(cid:46)(cid:12)(cid:2)(cid:7)(cid:8)(cid:10)(cid:5)(cid:3)(cid:48)(cid:46)(cid:3)(cid:12)(cid:13)(cid:5)(cid:2)(cid:14)(cid:46)(cid:2)(cid:28)(cid:5)(cid:3)(cid:10)(cid:5)(cid:2)(cid:64)(cid:46)(cid:4)(cid:12)(cid:2)(cid:28)(cid:3,Unknown,11746.0
Unknown,Unknown,3,Unknown,Unknown,Unknown,Unknown,cid:50)(cid:46)(cid:12)(cid:2)(cid:7)(cid:8)(cid:10)(cid:5)(cid:3)(cid:48)(cid:46)(cid:3)(cid:12)(cid:13)(cid:5)(cid:2)(cid:14)(cid:46)(cid:2)(cid:28)(cid:5)(cid:3)(cid:10)(cid:5)(cid:2)(cid:64)(cid:46)(cid:4)(cid:12)(cid:2)(cid:28)(cid:3,Unknown,11749.0
Unknown,Unknown,15,Unknown,Unknown,Unknown,Unknown,cid:50)(cid:46)(cid:12)(cid:2)(cid:7)(cid:8)(cid:10)(cid:5)(cid:3)(cid:48)(cid:46)(cid:3)(cid:12)(cid:13)(cid:5)(cid:2)(cid:14)(cid:46)(cid:2)(cid:28)(cid:5)(cid:3)(cid:10)(cid:5)(cid:2)(cid:64)(cid:46)(cid:4)(cid:12)(cid:2)(cid:28)(cid:3,Unknown,11764.0
Unknown,Unknown,2,Unknown,Unknown,Unknown,Unknown,cid:50)(cid:46)(cid:12)(cid:2)(cid:7)(cid:8)(cid:10)(cid:5)(cid:3)(cid:48)(cid:46)(cid:3)(cid:12)(cid:13)(cid:5)(cid:2)(cid:14)(cid:46)(cid:2)(cid:28)(cid:5)(cid:3)(cid:10)(cid:5)(cid:2)(cid:64)(cid:46)(cid:4)(cid:12)(cid:2)(cid:28)(cid:3,Unknown,11766.0
Unknown,Unknown,17,Unknown,Unknown,Unknown,Unknown,cid:50)(cid:46)(cid:12)(cid:2)(cid:7)(cid:8)(cid:10)(cid:5)(cid:3)(cid:48)(cid:46)(cid:3)(cid:12)(cid:13)(cid:5)(cid:2)(cid:14)(cid:46)(cid:2)(cid:28)(cid:5)(cid:3)(cid:10)(cid:5)(cid:2)(cid:64)(cid:46)(cid:4)(cid:12)(cid:2)(cid:28)(cid:3,Unknown,11783.0
Unknown,Unknown,1,Unknown,Unknown,Unknown,Unknown,cid:50)(cid:46)(cid:12)(cid:2)(cid:7)(cid:8)(cid:10)(cid:5)(cid:3)(cid:48)(cid:46)(cid:3)(cid:12)(cid:13)(cid:5)(cid:2)(cid:14)(cid:46)(cid:2)(cid:28)(cid:5)(cid:3)(cid:10)(cid:5)(cid:2)(cid:64)(cid:46)(cid:4)(cid:12)(cid:2)(cid:28)(cid:3,Unknown,11784.0
Unknown,Unknown,37,Unknown,Unknown,Unknown,Unknown,cid:50)(cid:46)(cid:12)(cid:2)(cid:7)(cid:8)(cid:10)(cid:5)(cid:3)(cid:48)(cid:46)(cid:3)(cid:12)(cid:13)(cid:5)(cid:2)(cid:14)(cid:46)(cid:2)(cid:28)(cid:5)(cid:3)(cid:10)(cid:5)(cid:2)(cid:64)(cid:46)(cid:4)(cid:12)(cid:2)(cid:28)(cid:3,Unknown,11821.0
Unknown,Unknown,19,Unknown,Unknown,Unknown,Unknown,cid:50)(cid:46)(cid:12)(cid:2)(cid:7)(cid:8)(cid:10)(cid:5)(cid:3)(cid:48)(cid:46)(cid:3)(cid:12)(cid:13)(cid:5)(cid:2)(cid:14)(cid:46)(cid:2)(cid:28)(cid:5)(cid:3)(cid:10)(cid:5)(cid:2)(cid:64)(cid:46)(cid:4)(cid:12)(cid:2)(cid:28)(cid:3,Unknown,11840.0
Unknown,Unknown,32,Unknown,Unknown,Unknown,Unknown,cid:50)(cid:46)(cid:12)(cid:2)(cid:7)(cid:8)(cid:10)(cid:5)(cid:3)(cid:48)(cid:46)(cid:3)(cid:12)(cid:13)(cid:5)(cid:2)(cid:14)(cid:46)(cid:2)(cid:28)(cid:5)(cid:3)(cid:10)(cid:5)(cid:2)(cid:64)(cid:46)(cid:4)(cid:12)(cid:2)(cid:28)(cid:3,Unknown,11872.0
Unknown,Unknown,34,Unknown,Unknown,Unknown,Unknown,cid:50)(cid:46)(cid:12)(cid:2)(cid:7)(cid:8)(cid:10)(cid:5)(cid:3)(cid:48)(cid:46)(cid:3)(cid:12)(cid:13)(cid:5)(cid:2)(cid:14)(cid:46)(cid:2)(cid:28)(cid:5)(cid:3)(cid:10)(cid:5)(cid:2)(cid:64)(cid:46)(cid:4)(cid:12)(cid:2)(cid:28)(cid:3,Unknown,11906.0
Unknown,Unknown,2,Unknown,Unknown,Unknown,Unknown,cid:50)(cid:46)(cid:12)(cid:2)(cid:7)(cid:8)(cid:10)(cid:5)(cid:3)(cid:48)(cid:46)(cid:3)(cid:12)(cid:13)(cid:5)(cid:2)(cid:14)(cid:46)(cid:2)(cid:28)(cid:5)(cid:3)(cid:10)(cid:5)(cid:2)(cid:64)(cid:46)(cid:4)(cid:12)(cid:2)(cid:28)(cid:3,Unknown,11908.0
Unknown,Unknown,44,Unknown,Unknown,Unknown,Unknown,cid:50)(cid:46)(cid:12)(cid:2)(cid:7)(cid:8)(cid:10)(cid:5)(cid:3)(cid:48)(cid:46)(cid:3)(cid:12)(cid:13)(cid:5)(cid:2)(cid:14)(cid:46)(cid:2)(cid:28)(cid:5)(cid:3)(cid:10)(cid:5)(cid:2)(cid:64)(cid:46)(cid:4)(cid:12)(cid:2)(cid:28)(cid:3,Unknown,11952.0
Unknown,Unknown,12,Unknown,Unknown,Unknown,Unknown,cid:50)(cid:46)(cid:12)(cid:2)(cid:7)(cid:8)(cid:10)(cid:5)(cid:3)(cid:48)(cid:46)(cid:3)(cid:12)(cid:13)(cid:5)(cid:2)(cid:14)(cid:46)(cid:2)(cid:28)(cid:5)(cid:3)(cid:10)(cid:5)(cid:2)(cid:64)(cid:46)(cid:4)(cid:12)(cid:2)(cid:28)(cid:3,Unknown,11964.0
Unknown,Unknown,29,Unknown,Unknown,Unknown,Unknown,cid:50)(cid:46)(cid:12)(cid:2)(cid:7)(cid:8)(cid:10)(cid:5)(cid:3)(cid:48)(cid:46)(cid:3)(cid:12)(cid:13)(cid:5)(cid:2)(cid:14)(cid:46)(cid:2)(cid:28)(cid:5)(cid:3)(cid:10)(cid:5)(cid:2)(cid:64)(cid:46)(cid:4)(cid:12)(cid:2)(cid:28)(cid:3,Unknown,11993.0
Unknown,Unknown,26,Unknown,Unknown,Unknown,Unknown,cid:50)(cid:46)(cid:12)(cid:2)(cid:7)(cid:8)(cid:10)(cid:5)(cid:3)(cid:48)(cid:46)(cid:3)(cid:12)(cid:13)(cid:5)(cid:2)(cid:14)(cid:46)(cid:2)(cid:28)(cid:5)(cid:3)(cid:10)(cid:5)(cid:2)(cid:64)(cid:46)(cid:4)(cid:12)(cid:2)(cid:28)(cid:3,Unknown,12019.0
Unknown,Unknown,41,Unknown,Unknown,Unknown,Unknown,cid:50)(cid:46)(cid:12)(cid:2)(cid:7)(cid:8)(cid:10)(cid:5)(cid:3)(cid:48)(cid:46)(cid:3)(cid:12)(cid:13)(cid:5)(cid:2)(cid:14)(cid:46)(cid:2)(cid:28)(cid:5)(cid:3)(cid:10)(cid:5)(cid:2)(cid:64)(cid:46)(cid:4)(cid:12)(cid:2)(cid:28)(cid:3,Unknown,12060.0
Unknown,Unknown,25,Unknown,Unknown,Unknown,Unknown,cid:50)(cid:46)(cid:12)(cid:2)(cid:7)(cid:8)(cid:10)(cid:5)(cid:3)(cid:48)(cid:46)(cid:3)(cid:12)(cid:13)(cid:5)(cid:2)(cid:14)(cid:46)(cid:2)(cid:28)(cid:5)(cid:3)(cid:10)(cid:5)(cid:2)(cid:64)(cid:46)(cid:4)(cid:12)(cid:2)(cid:28)(cid:3,Unknown,12085.0
Unknown,Unknown,2,Unknown,Unknown,Unknown,Unknown,cid:50)(cid:46)(cid:12)(cid:2)(cid:7)(cid:8)(cid:10)(cid:5)(cid:3)(cid:48)(cid:46)(cid:3)(cid:12)(cid:13)(cid:5)(cid:2)(cid:14)(cid:46)(cid:2)(cid:28)(cid:5)(cid:3)(cid:10)(cid:5)(cid:2)(cid:64)(cid:46)(cid:4)(cid:12)(cid:2)(cid:28)(cid:3,Unknown,12087.0
Unknown,Unknown,58,Unknown,Unknown,Unknown,Unknown,cid:50)(cid:46)(cid:12)(cid:2)(cid:7)(cid:8)(cid:10)(cid:5)(cid:3)(cid:48)(cid:46)(cid:3)(cid:12)(cid:13)(cid:5)(cid:2)(cid:14)(cid:46)(cid:2)(cid:28)(cid:5)(cid:3)(cid:10)(cid:5)(cid:2)(cid:64)(cid:46)(cid:4)(cid:12)(cid:2)(cid:28)(cid:3,Unknown,12145.0
Unknown,Unknown,58,Unknown,Unknown,Unknown,Unknown,cid:50)(cid:46)(cid:12)(cid:2)(cid:7)(cid:8)(cid:10)(cid:5)(cid:3)(cid:48)(cid:46)(cid:3)(cid:12)(cid:13)(cid:5)(cid:2)(cid:14)(cid:46)(cid:2)(cid:28)(cid:5)(cid:3)(cid:10)(cid:5)(cid:2)(cid:64)(cid:46)(cid:4)(cid:12)(cid:2)(cid:28)(cid:3,Unknown,12203.0
Unknown,Unknown,18,Unknown,Unknown,Unknown,Unknown,cid:50)(cid:46)(cid:12)(cid:2)(cid:7)(cid:8)(cid:10)(cid:5)(cid:3)(cid:48)(cid:46)(cid:3)(cid:12)(cid:13)(cid:5)(cid:2)(cid:14)(cid:46)(cid:2)(cid:28)(cid:5)(cid:3)(cid:10)(cid:5)(cid:2)(cid:64)(cid:46)(cid:4)(cid:12)(cid:2)(cid:28)(cid:3,Unknown,12221.0
Unknown,Unknown,1,Unknown,Unknown,Unknown,Unknown,cid:50)(cid:46)(cid:12)(cid:2)(cid:7)(cid:8)(cid:10)(cid:5)(cid:3)(cid:48)(cid:46)(cid:3)(cid:12)(cid:13)(cid:5)(cid:2)(cid:14)(cid:46)(cid:2)(cid:28)(cid:5)(cid:3)(cid:10)(cid:5)(cid:2)(cid:64)(cid:46)(cid:4)(cid:12)(cid:2)(cid:28)(cid:3,Unknown,12222.0
Unknown,Unknown,1,Unknown,Unknown,Unknown,Unknown,cid:50)(cid:46)(cid:12)(cid:2)(cid:7)(cid:8)(cid:10)(cid:5)(cid:3)(cid:48)(cid:46)(cid:3)(cid:12)(cid:13)(cid:5)(cid:2)(cid:14)(cid:46)(cid:2)(cid:28)(cid:5)(cid:3)(cid:10)(cid:5)(cid:2)(cid:64)(cid:46)(cid:4)(cid:12)(cid:2)(cid:28)(cid:3,Unknown,12223.0
Unknown,Unknown,37,Unknown,Unknown,Unknown,Unknown,cid:50)(cid:46)(cid:12)(cid:2)(cid:7)(cid:8)(cid:10)(cid:5)(cid:3)(cid:48)(cid:46)(cid:3)(cid:12)(cid:13)(cid:5)(cid:2)(cid:14)(cid:46)(cid:2)(cid:28)(cid:5)(cid:3)(cid:10)(cid:5)(cid:2)(cid:64)(cid:46)(cid:4)(cid:12)(cid:2)(cid:28)(cid:3,Unknown,12260.0
Unknown,Unknown,18,Unknown,Unknown,Unknown,Unknown,cid:50)(cid:46)(cid:12)(cid:2)(cid:7)(cid:8)(cid:10)(cid:5)(cid:3)(cid:48)(cid:46)(cid:3)(cid:12)(cid:13)(cid:5)(cid:2)(cid:14)(cid:46)(cid:2)(cid:28)(cid:5)(cid:3)(cid:10)(cid:5)(cid:2)(cid:64)(cid:46)(cid:4)(cid:12)(cid:2)(cid:28)(cid:3,Unknown,12278.0
Unknown,Unknown,32,Unknown,Unknown,Unknown,Unknown,cid:50)(cid:46)(cid:12)(cid:2)(cid:7)(cid:8)(cid:10)(cid:5)(cid:3)(cid:48)(cid:46)(cid:3)(cid:12)(cid:13)(cid:5)(cid:2)(cid:14)(cid:46)(cid:2)(cid:28)(cid:5)(cid:3)(cid:10)(cid:5)(cid:2)(cid:64)(cid:46)(cid:4)(cid:12)(cid:2)(cid:28)(cid:3,Unknown,12310.0
Unknown,Unknown,45,Unknown,Unknown,Unknown,Unknown,cid:50)(cid:46)(cid:12)(cid:2)(cid:7)(cid:8)(cid:10)(cid:5)(cid:3)(cid:48)(cid:46)(cid:3)(cid:12)(cid:13)(cid:5)(cid:2)(cid:14)(cid:46)(cid:2)(cid:28)(cid:5)(cid:3)(cid:10)(cid:5)(cid:2)(cid:64)(cid:46)(cid:4)(cid:12)(cid:2)(cid:28)(cid:3,Unknown,12355.0
Unknown,Unknown,18,Unknown,Unknown,Unknown,Unknown,cid:50)(cid:46)(cid:12)(cid:2)(cid:7)(cid:8)(cid:10)(cid:5)(cid:3)(cid:48)(cid:46)(cid:3)(cid:12)(cid:13)(cid:5)(cid:2)(cid:14)(cid:46)(cid:2)(cid:28)(cid:5)(cid:3)(cid:10)(cid:5)(cid:2)(cid:64)(cid:46)(cid:4)(cid:12)(cid:2)(cid:28)(cid:3,Unknown,12373.0
Unknown,Unknown,16,Unknown,Unknown,Unknown,Unknown,cid:50)(cid:46)(cid:12)(cid:2)(cid:7)(cid:8)(cid:10)(cid:5)(cid:3)(cid:48)(cid:46)(cid:3)(cid:12)(cid:13)(cid:5)(cid:2)(cid:14)(cid:46)(cid:2)(cid:28)(cid:5)(cid:3)(cid:10)(cid:5)(cid:2)(cid:64)(cid:46)(cid:4)(cid:12)(cid:2)(cid:28)(cid:3,Unknown,12389.0
Unknown,Unknown,14,Unknown,Unknown,Unknown,Unknown,cid:50)(cid:46)(cid:12)(cid:2)(cid:7)(cid:8)(cid:10)(cid:5)(cid:3)(cid:48)(cid:46)(cid:3)(cid:12)(cid:13)(cid:5)(cid:2)(cid:14)(cid:46)(cid:2)(cid:28)(cid:5)(cid:3)(cid:10)(cid:5)(cid:2)(cid:64)(cid:46)(cid:4)(cid:12)(cid:2)(cid:28)(cid:3,Unknown,12403.0
Unknown,Unknown,7,Unknown,Unknown,Unknown,Unknown,cid:50)(cid:46)(cid:12)(cid:2)(cid:7)(cid:8)(cid:10)(cid:5)(cid:3)(cid:48)(cid:46)(cid:3)(cid:12)(cid:13)(cid:5)(cid:2)(cid:14)(cid:46)(cid:2)(cid:28)(cid:5)(cid:3)(cid:10)(cid:5)(cid:2)(cid:64)(cid:46)(cid:4)(cid:12)(cid:2)(cid:28)(cid:3,Unknown,12410.0
Unknown,Unknown,8,Unknown,Unknown,Unknown,Unknown,cid:50)(cid:46)(cid:12)(cid:2)(cid:7)(cid:8)(cid:10)(cid:5)(cid:3)(cid:48)(cid:46)(cid:3)(cid:12)(cid:13)(cid:5)(cid:2)(cid:14)(cid:46)(cid:2)(cid:28)(cid:5)(cid:3)(cid:10)(cid:5)(cid:2)(cid:64)(cid:46)(cid:4)(cid:12)(cid:2)(cid:28)(cid:3,Unknown,12418.0
Unknown,Unknown,11,Unknown,Unknown,Unknown,Unknown,cid:50)(cid:46)(cid:12)(cid:2)(cid:7)(cid:8)(cid:10)(cid:5)(cid:3)(cid:48)(cid:46)(cid:3)(cid:12)(cid:13)(cid:5)(cid:2)(cid:14)(cid:46)(cid:2)(cid:28)(cid:5)(cid:3)(cid:10)(cid:5)(cid:2)(cid:64)(cid:46)(cid:4)(cid:12)(cid:2)(cid:28)(cid:3,Unknown,12429.0
Unknown,Unknown,8,Unknown,Unknown,Unknown,Unknown,cid:50)(cid:46)(cid:12)(cid:2)(cid:7)(cid:8)(cid:10)(cid:5)(cid:3)(cid:48)(cid:46)(cid:3)(cid:12)(cid:13)(cid:5)(cid:2)(cid:14)(cid:46)(cid:2)(cid:28)(cid:5)(cid:3)(cid:10)(cid:5)(cid:2)(cid:64)(cid:46)(cid:4)(cid:12)(cid:2)(cid:28)(cid:3,Unknown,12437.0
Unknown,Unknown,2,Unknown,Unknown,Unknown,Unknown,cid:50)(cid:46)(cid:12)(cid:2)(cid:7)(cid:8)(cid:10)(cid:5)(cid:3)(cid:48)(cid:46)(cid:3)(cid:12)(cid:13)(cid:5)(cid:2)(cid:14)(cid:46)(cid:2)(cid:28)(cid:5)(cid:3)(cid:10)(cid:5)(cid:2)(cid:64)(cid:46)(cid:4)(cid:12)(cid:2)(cid:28)(cid:3,Unknown,12439.0
Unknown,Unknown,39,Unknown,Unknown,Unknown,Unknown,cid:50)(cid:46)(cid:12)(cid:2)(cid:7)(cid:8)(cid:10)(cid:5)(cid:3)(cid:48)(cid:46)(cid:3)(cid:12)(cid:13)(cid:5)(cid:2)(cid:14)(cid:46)(cid:2)(cid:28)(cid:5)(cid:3)(cid:10)(cid:5)(cid:2)(cid:64)(cid:46)(cid:4)(cid:12)(cid:2)(cid:28)(cid:3,Unknown,12478.0
Unknown,Unknown,3,Unknown,Unknown,Unknown,Unknown,cid:50)(cid:46)(cid:12)(cid:2)(cid:7)(cid:8)(cid:10)(cid:5)(cid:3)(cid:48)(cid:46)(cid:3)(cid:12)(cid:13)(cid:5)(cid:2)(cid:14)(cid:46)(cid:2)(cid:28)(cid:5)(cid:3)(cid:10)(cid:5)(cid:2)(cid:64)(cid:46)(cid:4)(cid:12)(cid:2)(cid:28)(cid:3,Unknown,12481.0
Unknown,Unknown,11,Unknown,Unknown,Unknown,Unknown,cid:50)(cid:46)(cid:12)(cid:2)(cid:7)(cid:8)(cid:10)(cid:5)(cid:3)(cid:48)(cid:46)(cid:3)(cid:12)(cid:13)(cid:5)(cid:2)(cid:14)(cid:46)(cid:2)(cid:28)(cid:5)(cid:3)(cid:10)(cid:5)(cid:2)(cid:64)(cid:46)(cid:4)(cid:12)(cid:2)(cid:28)(cid:3,Unknown,12492.0
Unknown,Unknown,66,Unknown,Unknown,Unknown,Unknown,cid:50)(cid:46)(cid:12)(cid:2)(cid:7)(cid:8)(cid:10)(cid:5)(cid:3)(cid:48)(cid:46)(cid:3)(cid:12)(cid:13)(cid:5)(cid:2)(cid:14)(cid:46)(cid:2)(cid:28)(cid:5)(cid:3)(cid:10)(cid:5)(cid:2)(cid:64)(cid:46)(cid:4)(cid:12)(cid:2)(cid:28)(cid:3,Unknown,12558.0
Unknown,Unknown,7,Unknown,Unknown,Unknown,Unknown,cid:50)(cid:46)(cid:12)(cid:2)(cid:7)(cid:8)(cid:10)(cid:5)(cid:3)(cid:48)(cid:46)(cid:3)(cid:12)(cid:13)(cid:5)(cid:2)(cid:14)(cid:46)(cid:2)(cid:28)(cid:5)(cid:3)(cid:10)(cid:5)(cid:2)(cid:64)(cid:46)(cid:4)(cid:12)(cid:2)(cid:28)(cid:3,Unknown,12565.0
Unknown,Unknown,8,Unknown,Unknown,Unknown,Unknown,cid:50)(cid:46)(cid:12)(cid:2)(cid:7)(cid:8)(cid:10)(cid:5)(cid:3)(cid:48)(cid:46)(cid:3)(cid:12)(cid:13)(cid:5)(cid:2)(cid:14)(cid:46)(cid:2)(cid:28)(cid:5)(cid:3)(cid:10)(cid:5)(cid:2)(cid:64)(cid:46)(cid:4)(cid:12)(cid:2)(cid:28)(cid:3,Unknown,12573.0
Unknown,Unknown,9,Unknown,Unknown,Unknown,Unknown,cid:50)(cid:46)(cid:12)(cid:2)(cid:7)(cid:8)(cid:10)(cid:5)(cid:3)(cid:48)(cid:46)(cid:3)(cid:12)(cid:13)(cid:5)(cid:2)(cid:14)(cid:46)(cid:2)(cid:28)(cid:5)(cid:3)(cid:10)(cid:5)(cid:2)(cid:64)(cid:46)(cid:4)(cid:12)(cid:2)(cid:28)(cid:3,Unknown,12582.0
Unknown,Unknown,2,Unknown,Unknown,Unknown,Unknown,cid:50)(cid:46)(cid:12)(cid:2)(cid:7)(cid:8)(cid:10)(cid:5)(cid:3)(cid:48)(cid:46)(cid:3)(cid:12)(cid:13)(cid:5)(cid:2)(cid:14)(cid:46)(cid:2)(cid:28)(cid:5)(cid:3)(cid:10)(cid:5)(cid:2)(cid:64)(cid:46)(cid:4)(cid:12)(cid:2)(cid:28)(cid:3,Unknown,12584.0
Unknown,Unknown,28,Unknown,Unknown,Unknown,Unknown,cid:50)(cid:46)(cid:12)(cid:2)(cid:7)(cid:8)(cid:10)(cid:5)(cid:3)(cid:48)(cid:46)(cid:3)(cid:12)(cid:13)(cid:5)(cid:2)(cid:14)(cid:46)(cid:2)(cid:28)(cid:5)(cid:3)(cid:10)(cid:5)(cid:2)(cid:64)(cid:46)(cid:4)(cid:12)(cid:2)(cid:28)(cid:3,Unknown,12612.0
Unknown,Unknown,3,Unknown,Unknown,Unknown,Unknown,cid:50)(cid:46)(cid:12)(cid:2)(cid:7)(cid:8)(cid:10)(cid:5)(cid:3)(cid:48)(cid:46)(cid:3)(cid:12)(cid:13)(cid:5)(cid:2)(cid:14)(cid:46)(cid:2)(cid:28)(cid:5)(cid:3)(cid:10)(cid:5)(cid:2)(cid:64)(cid:46)(cid:4)(cid:12)(cid:2)(cid:28)(cid:3,Unknown,12615.0
Unknown,Unknown,15,Unknown,Unknown,Unknown,Unknown,cid:50)(cid:46)(cid:12)(cid:2)(cid:7)(cid:8)(cid:10)(cid:5)(cid:3)(cid:48)(cid:46)(cid:3)(cid:12)(cid:13)(cid:5)(cid:2)(cid:14)(cid:46)(cid:2)(cid:28)(cid:5)(cid:3)(cid:10)(cid:5)(cid:2)(cid:64)(cid:46)(cid:4)(cid:12)(cid:2)(cid:28)(cid:3,Unknown,12630.0
Unknown,Unknown,2,Unknown,Unknown,Unknown,Unknown,cid:50)(cid:46)(cid:12)(cid:2)(cid:7)(cid:8)(cid:10)(cid:5)(cid:3)(cid:48)(cid:46)(cid:3)(cid:12)(cid:13)(cid:5)(cid:2)(cid:14)(cid:46)(cid:2)(cid:28)(cid:5)(cid:3)(cid:10)(cid:5)(cid:2)(cid:64)(cid:46)(cid:4)(cid:12)(cid:2)(cid:28)(cid:3,Unknown,12632.0
Unknown,Unknown,17,Unknown,Unknown,Unknown,Unknown,cid:50)(cid:46)(cid:12)(cid:2)(cid:7)(cid:8)(cid:10)(cid:5)(cid:3)(cid:48)(cid:46)(cid:3)(cid:12)(cid:13)(cid:5)(cid:2)(cid:14)(cid:46)(cid:2)(cid:28)(cid:5)(cid:3)(cid:10)(cid:5)(cid:2)(cid:64)(cid:46)(cid:4)(cid:12)(cid:2)(cid:28)(cid:3,Unknown,12649.0
Unknown,Unknown,1,Unknown,Unknown,Unknown,Unknown,cid:50)(cid:46)(cid:12)(cid:2)(cid:7)(cid:8)(cid:10)(cid:5)(cid:3)(cid:48)(cid:46)(cid:3)(cid:12)(cid:13)(cid:5)(cid:2)(cid:14)(cid:46)(cid:2)(cid:28)(cid:5)(cid:3)(cid:10)(cid:5)(cid:2)(cid:64)(cid:46)(cid:4)(cid:12)(cid:2)(cid:28)(cid:3,Unknown,12650.0
Unknown,Unknown,19,Unknown,Unknown,Unknown,Unknown,cid:50)(cid:46)(cid:12)(cid:2)(cid:7)(cid:8)(cid:10)(cid:5)(cid:3)(cid:48)(cid:46)(cid:3)(cid:12)(cid:13)(cid:5)(cid:2)(cid:14)(cid:46)(cid:2)(cid:28)(cid:5)(cid:3)(cid:10)(cid:5)(cid:2)(cid:64)(cid:46)(cid:4)(cid:12)(cid:2)(cid:28)(cid:3,Unknown,12669.0
Unknown,Unknown,18,Unknown,Unknown,Unknown,Unknown,cid:50)(cid:46)(cid:12)(cid:2)(cid:7)(cid:8)(cid:10)(cid:5)(cid:3)(cid:48)(cid:46)(cid:3)(cid:12)(cid:13)(cid:5)(cid:2)(cid:14)(cid:46)(cid:2)(cid:28)(cid:5)(cid:3)(cid:10)(cid:5)(cid:2)(cid:64)(cid:46)(cid:4)(cid:12)(cid:2)(cid:28)(cid:3,Unknown,12687.0
Unknown,Unknown,18,Unknown,Unknown,Unknown,Unknown,cid:50)(cid:46)(cid:12)(cid:2)(cid:7)(cid:8)(cid:10)(cid:5)(cid:3)(cid:48)(cid:46)(cid:3)(cid:12)(cid:13)(cid:5)(cid:2)(cid:14)(cid:46)(cid:2)(cid:28)(cid:5)(cid:3)(cid:10)(cid:5)(cid:2)(cid:64)(cid:46)(cid:4)(cid:12)(cid:2)(cid:28)(cid:3,Unknown,12705.0
Unknown,Unknown,2,Unknown,Unknown,Unknown,Unknown,cid:50)(cid:46)(cid:12)(cid:2)(cid:7)(cid:8)(cid:10)(cid:5)(cid:3)(cid:48)(cid:46)(cid:3)(cid:12)(cid:13)(cid:5)(cid:2)(cid:14)(cid:46)(cid:2)(cid:28)(cid:5)(cid:3)(cid:10)(cid:5)(cid:2)(cid:64)(cid:46)(cid:4)(cid:12)(cid:2)(cid:28)(cid:3,Unknown,12707.0
Unknown,Unknown,44,Unknown,Unknown,Unknown,Unknown,cid:50)(cid:46)(cid:12)(cid:2)(cid:7)(cid:8)(cid:10)(cid:5)(cid:3)(cid:48)(cid:46)(cid:3)(cid:12)(cid:13)(cid:5)(cid:2)(cid:14)(cid:46)(cid:2)(cid:28)(cid:5)(cid:3)(cid:10)(cid:5)(cid:2)(cid:64)(cid:46)(cid:4)(cid:12)(cid:2)(cid:28)(cid:3,Unknown,12751.0
Unknown,Unknown,12,Unknown,Unknown,Unknown,Unknown,cid:50)(cid:46)(cid:12)(cid:2)(cid:7)(cid:8)(cid:10)(cid:5)(cid:3)(cid:48)(cid:46)(cid:3)(cid:12)(cid:13)(cid:5)(cid:2)(cid:14)(cid:46)(cid:2)(cid:28)(cid:5)(cid:3)(cid:10)(cid:5)(cid:2)(cid:64)(cid:46)(cid:4)(cid:12)(cid:2)(cid:28)(cid:3,Unknown,12763.0
Unknown,Unknown,29,Unknown,Unknown,Unknown,Unknown,cid:50)(cid:46)(cid:12)(cid:2)(cid:7)(cid:8)(cid:10)(cid:5)(cid:3)(cid:48)(cid:46)(cid:3)(cid:12)(cid:13)(cid:5)(cid:2)(cid:14)(cid:46)(cid:2)(cid:28)(cid:5)(cid:3)(cid:10)(cid:5)(cid:2)(cid:64)(cid:46)(cid:4)(cid:12)(cid:2)(cid:28)(cid:3,Unknown,12792.0
Unknown,Unknown,26,Unknown,Unknown,Unknown,Unknown,cid:50)(cid:46)(cid:12)(cid:2)(cid:7)(cid:8)(cid:10)(cid:5)(cid:3)(cid:48)(cid:46)(cid:3)(cid:12)(cid:13)(cid:5)(cid:2)(cid:14)(cid:46)(cid:2)(cid:28)(cid:5)(cid:3)(cid:10)(cid:5)(cid:2)(cid:64)(cid:46)(cid:4)(cid:12)(cid:2)(cid:28)(cid:3,Unknown,12818.0
Unknown,Unknown,41,Unknown,Unknown,Unknown,Unknown,cid:50)(cid:46)(cid:12)(cid:2)(cid:7)(cid:8)(cid:10)(cid:5)(cid:3)(cid:48)(cid:46)(cid:3)(cid:12)(cid:13)(cid:5)(cid:2)(cid:14)(cid:46)(cid:2)(cid:28)(cid:5)(cid:3)(cid:10)(cid:5)(cid:2)(cid:64)(cid:46)(cid:4)(cid:12)(cid:2)(cid:28)(cid:3,Unknown,12859.0
Unknown,Unknown,25,Unknown,Unknown,Unknown,Unknown,cid:50)(cid:46)(cid:12)(cid:2)(cid:7)(cid:8)(cid:10)(cid:5)(cid:3)(cid:48)(cid:46)(cid:3)(cid:12)(cid:13)(cid:5)(cid:2)(cid:14)(cid:46)(cid:2)(cid:28)(cid:5)(cid:3)(cid:10)(cid:5)(cid:2)(cid:64)(cid:46)(cid:4)(cid:12)(cid:2)(cid:28)(cid:3,Unknown,12884.0
Unknown,Unknown,2,Unknown,Unknown,Unknown,Unknown,cid:50)(cid:46)(cid:12)(cid:2)(cid:7)(cid:8)(cid:10)(cid:5)(cid:3)(cid:48)(cid:46)(cid:3)(cid:12)(cid:13)(cid:5)(cid:2)(cid:14)(cid:46)(cid:2)(cid:28)(cid:5)(cid:3)(cid:10)(cid:5)(cid:2)(cid:64)(cid:46)(cid:4)(cid:12)(cid:2)(cid:28)(cid:3,Unknown,12886.0
Unknown,Unknown,58,Unknown,Unknown,Unknown,Unknown,cid:50)(cid:46)(cid:12)(cid:2)(cid:7)(cid:8)(cid:10)(cid:5)(cid:3)(cid:48)(cid:46)(cid:3)(cid:12)(cid:13)(cid:5)(cid:2)(cid:14)(cid:46)(cid:2)(cid:28)(cid:5)(cid:3)(cid:10)(cid:5)(cid:2)(cid:64)(cid:46)(cid:4)(cid:12)(cid:2)(cid:28)(cid:3,Unknown,12944.0
Unknown,Unknown,58,Unknown,Unknown,Unknown,Unknown,cid:50)(cid:46)(cid:12)(cid:2)(cid:7)(cid:8)(cid:10)(cid:5)(cid:3)(cid:48)(cid:46)(cid:3)(cid:12)(cid:13)(cid:5)(cid:2)(cid:14)(cid:46)(cid:2)(cid:28)(cid:5)(cid:3)(cid:10)(cid:5)(cid:2)(cid:64)(cid:46)(cid:4)(cid:12)(cid:2)(cid:28)(cid:3,Unknown,13002.0
Unknown,Unknown,18,Unknown,Unknown,Unknown,Unknown,cid:50)(cid:46)(cid:12)(cid:2)(cid:7)(cid:8)(cid:10)(cid:5)(cid:3)(cid:48)(cid:46)(cid:3)(cid:12)(cid:13)(cid:5)(cid:2)(cid:14)(cid:46)(cid:2)(cid:28)(cid:5)(cid:3)(cid:10)(cid:5)(cid:2)(cid:64)(cid:46)(cid:4)(cid:12)(cid:2)(cid:28)(cid:3,Unknown,13020.0
Unknown,Unknown,1,Unknown,Unknown,Unknown,Unknown,cid:50)(cid:46)(cid:12)(cid:2)(cid:7)(cid:8)(cid:10)(cid:5)(cid:3)(cid:48)(cid:46)(cid:3)(cid:12)(cid:13)(cid:5)(cid:2)(cid:14)(cid:46)(cid:2)(cid:28)(cid:5)(cid:3)(cid:10)(cid:5)(cid:2)(cid:64)(cid:46)(cid:4)(cid:12)(cid:2)(cid:28)(cid:3,Unknown,13021.0
Unknown,Unknown,1,Unknown,Unknown,Unknown,Unknown,cid:50)(cid:46)(cid:12)(cid:2)(cid:7)(cid:8)(cid:10)(cid:5)(cid:3)(cid:48)(cid:46)(cid:3)(cid:12)(cid:13)(cid:5)(cid:2)(cid:14)(cid:46)(cid:2)(cid:28)(cid:5)(cid:3)(cid:10)(cid:5)(cid:2)(cid:64)(cid:46)(cid:4)(cid:12)(cid:2)(cid:28)(cid:3,Unknown,13022.0
Unknown,Unknown,37,Unknown,Unknown,Unknown,Unknown,cid:50)(cid:46)(cid:12)(cid:2)(cid:7)(cid:8)(cid:10)(cid:5)(cid:3)(cid:48)(cid:46)(cid:3)(cid:12)(cid:13)(cid:5)(cid:2)(cid:14)(cid:46)(cid:2)(cid:28)(cid:5)(cid:3)(cid:10)(cid:5)(cid:2)(cid:64)(cid:46)(cid:4)(cid:12)(cid:2)(cid:28)(cid:3,Unknown,13059.0
Unknown,Unknown,18,Unknown,Unknown,Unknown,Unknown,cid:50)(cid:46)(cid:12)(cid:2)(cid:7)(cid:8)(cid:10)(cid:5)(cid:3)(cid:48)(cid:46)(cid:3)(cid:12)(cid:13)(cid:5)(cid:2)(cid:14)(cid:46)(cid:2)(cid:28)(cid:5)(cid:3)(cid:10)(cid:5)(cid:2)(cid:64)(cid:46)(cid:4)(cid:12)(cid:2)(cid:28)(cid:3,Unknown,13077.0
Unknown,Unknown,16,Unknown,Unknown,Unknown,Unknown,cid:50)(cid:46)(cid:12)(cid:2)(cid:7)(cid:8)(cid:10)(cid:5)(cid:3)(cid:48)(cid:46)(cid:3)(cid:12)(cid:13)(cid:5)(cid:2)(cid:14)(cid:46)(cid:2)(cid:28)(cid:5)(cid:3)(cid:10)(cid:5)(cid:2)(cid:64)(cid:46)(cid:4)(cid:12)(cid:2)(cid:28)(cid:3,Unknown,13093.0
Unknown,Unknown,45,Unknown,Unknown,Unknown,Unknown,cid:50)(cid:46)(cid:12)(cid:2)(cid:7)(cid:8)(cid:10)(cid:5)(cid:3)(cid:48)(cid:46)(cid:3)(cid:12)(cid:13)(cid:5)(cid:2)(cid:14)(cid:46)(cid:2)(cid:28)(cid:5)(cid:3)(cid:10)(cid:5)(cid:2)(cid:64)(cid:46)(cid:4)(cid:12)(cid:2)(cid:28)(cid:3,Unknown,13138.0
Unknown,Unknown,18,Unknown,Unknown,Unknown,Unknown,cid:50)(cid:46)(cid:12)(cid:2)(cid:7)(cid:8)(cid:10)(cid:5)(cid:3)(cid:48)(cid:46)(cid:3)(cid:12)(cid:13)(cid:5)(cid:2)(cid:14)(cid:46)(cid:2)(cid:28)(cid:5)(cid:3)(cid:10)(cid:5)(cid:2)(cid:64)(cid:46)(cid:4)(cid:12)(cid:2)(cid:28)(cid:3,Unknown,13156.0
Unknown,Unknown,16,Unknown,Unknown,Unknown,Unknown,cid:50)(cid:46)(cid:12)(cid:2)(cid:7)(cid:8)(cid:10)(cid:5)(cid:3)(cid:48)(cid:46)(cid:3)(cid:12)(cid:13)(cid:5)(cid:2)(cid:14)(cid:46)(cid:2)(cid:28)(cid:5)(cid:3)(cid:10)(cid:5)(cid:2)(cid:64)(cid:46)(cid:4)(cid:12)(cid:2)(cid:28)(cid:3,Unknown,13172.0
Unknown,Unknown,64,Unknown,Unknown,Unknown,Unknown,cid:50)(cid:46)(cid:12)(cid:2)(cid:7)(cid:8)(cid:10)(cid:5)(cid:3)(cid:48)(cid:46)(cid:3)(cid:12)(cid:13)(cid:5)(cid:2)(cid:14)(cid:46)(cid:2)(cid:28)(cid:5)(cid:3)(cid:10)(cid:5)(cid:2)(cid:64)(cid:46)(cid:4)(cid:12)(cid:2)(cid:28)(cid:3,Unknown,13236.0
Unknown,Unknown,5,Unknown,Unknown,Unknown,Unknown,cid:50)(cid:46)(cid:12)(cid:2)(cid:7)(cid:8)(cid:10)(cid:5)(cid:3)(cid:48)(cid:46)(cid:3)(cid:12)(cid:13)(cid:5)(cid:2)(cid:14)(cid:46)(cid:2)(cid:28)(cid:5)(cid:3)(cid:10)(cid:5)(cid:2)(cid:64)(cid:46)(cid:4)(cid:12)(cid:2)(cid:28)(cid:3,Unknown,13241.0
Unknown,Unknown,8,Unknown,Unknown,Unknown,Unknown,cid:50)(cid:46)(cid:12)(cid:2)(cid:7)(cid:8)(cid:10)(cid:5)(cid:3)(cid:48)(cid:46)(cid:3)(cid:12)(cid:13)(cid:5)(cid:2)(cid:14)(cid:46)(cid:2)(cid:28)(cid:5)(cid:3)(cid:10)(cid:5)(cid:2)(cid:64)(cid:46)(cid:4)(cid:12)(cid:2)(cid:28)(cid:3,Unknown,13249.0
Unknown,Unknown,5,Unknown,Unknown,Unknown,Unknown,cid:50)(cid:46)(cid:12)(cid:2)(cid:7)(cid:8)(cid:10)(cid:5)(cid:3)(cid:48)(cid:46)(cid:3)(cid:12)(cid:13)(cid:5)(cid:2)(cid:14)(cid:46)(cid:2)(cid:28)(cid:5)(cid:3)(cid:10)(cid:5)(cid:2)(cid:64)(cid:46)(cid:4)(cid:12)(cid:2)(cid:28)(cid:3,Unknown,13254.0
Unknown,Unknown,3,Unknown,Unknown,Unknown,Unknown,cid:50)(cid:46)(cid:12)(cid:2)(cid:7)(cid:8)(cid:10)(cid:5)(cid:3)(cid:48)(cid:46)(cid:3)(cid:12)(cid:13)(cid:5)(cid:2)(cid:14)(cid:46)(cid:2)(cid:28)(cid:5)(cid:3)(cid:10)(cid:5)(cid:2)(cid:64)(cid:46)(cid:4)(cid:12)(cid:2)(cid:28)(cid:3,Unknown,13257.0
Unknown,Unknown,46,Unknown,Unknown,Unknown,Unknown,cid:50)(cid:46)(cid:12)(cid:2)(cid:7)(cid:8)(cid:10)(cid:5)(cid:3)(cid:48)(cid:46)(cid:3)(cid:12)(cid:13)(cid:5)(cid:2)(cid:14)(cid:46)(cid:2)(cid:28)(cid:5)(cid:3)(cid:10)(cid:5)(cid:2)(cid:64)(cid:46)(cid:4)(cid:12)(cid:2)(cid:28)(cid:3,Unknown,13303.0
Unknown,Unknown,14,Unknown,Unknown,Unknown,Unknown,cid:50)(cid:46)(cid:12)(cid:2)(cid:7)(cid:8)(cid:10)(cid:5)(cid:3)(cid:48)(cid:46)(cid:3)(cid:12)(cid:13)(cid:5)(cid:2)(cid:14)(cid:46)(cid:2)(cid:28)(cid:5)(cid:3)(cid:10)(cid:5)(cid:2)(cid:64)(cid:46)(cid:4)(cid:12)(cid:2)(cid:28)(cid:3,Unknown,13317.0
Unknown,Unknown,7,Unknown,Unknown,Unknown,Unknown,cid:50)(cid:46)(cid:12)(cid:2)(cid:7)(cid:8)(cid:10)(cid:5)(cid:3)(cid:48)(cid:46)(cid:3)(cid:12)(cid:13)(cid:5)(cid:2)(cid:14)(cid:46)(cid:2)(cid:28)(cid:5)(cid:3)(cid:10)(cid:5)(cid:2)(cid:64)(cid:46)(cid:4)(cid:12)(cid:2)(cid:28)(cid:3,Unknown,13324.0
Unknown,Unknown,2,Unknown,Unknown,Unknown,Unknown,cid:50)(cid:46)(cid:12)(cid:2)(cid:7)(cid:8)(cid:10)(cid:5)(cid:3)(cid:48)(cid:46)(cid:3)(cid:12)(cid:13)(cid:5)(cid:2)(cid:14)(cid:46)(cid:2)(cid:28)(cid:5)(cid:3)(cid:10)(cid:5)(cid:2)(cid:64)(cid:46)(cid:4)(cid:12)(cid:2)(cid:28)(cid:3,Unknown,13326.0
Unknown,Unknown,7,Unknown,Unknown,Unknown,Unknown,cid:50)(cid:46)(cid:12)(cid:2)(cid:7)(cid:8)(cid:10)(cid:5)(cid:3)(cid:48)(cid:46)(cid:3)(cid:12)(cid:13)(cid:5)(cid:2)(cid:14)(cid:46)(cid:2)(cid:28)(cid:5)(cid:3)(cid:10)(cid:5)(cid:2)(cid:64)(cid:46)(cid:4)(cid:12)(cid:2)(cid:28)(cid:3,Unknown,13333.0
Unknown,Unknown,46,Unknown,Unknown,Unknown,Unknown,cid:50)(cid:46)(cid:12)(cid:2)(cid:7)(cid:8)(cid:10)(cid:5)(cid:3)(cid:48)(cid:46)(cid:3)(cid:12)(cid:13)(cid:5)(cid:2)(cid:14)(cid:46)(cid:2)(cid:28)(cid:5)(cid:3)(cid:10)(cid:5)(cid:2)(cid:64)(cid:46)(cid:4)(cid:12)(cid:2)(cid:28)(cid:3,Unknown,13379.0
Unknown,Unknown,3,Unknown,Unknown,Unknown,Unknown,cid:50)(cid:46)(cid:12)(cid:2)(cid:7)(cid:8)(cid:10)(cid:5)(cid:3)(cid:48)(cid:46)(cid:3)(cid:12)(cid:13)(cid:5)(cid:2)(cid:14)(cid:46)(cid:2)(cid:28)(cid:5)(cid:3)(cid:10)(cid:5)(cid:2)(cid:64)(cid:46)(cid:4)(cid:12)(cid:2)(cid:28)(cid:3,Unknown,13382.0
Unknown,Unknown,50,Unknown,Unknown,Unknown,Unknown,cid:50)(cid:46)(cid:12)(cid:2)(cid:7)(cid:8)(cid:10)(cid:5)(cid:3)(cid:48)(cid:46)(cid:3)(cid:12)(cid:13)(cid:5)(cid:2)(cid:14)(cid:46)(cid:2)(cid:28)(cid:5)(cid:3)(cid:10)(cid:5)(cid:2)(cid:64)(cid:46)(cid:4)(cid:12)(cid:2)(cid:28)(cid:3,Unknown,13432.0
Unknown,Unknown,2,Unknown,Unknown,Unknown,Unknown,cid:50)(cid:46)(cid:12)(cid:2)(cid:7)(cid:8)(cid:10)(cid:5)(cid:3)(cid:48)(cid:46)(cid:3)(cid:12)(cid:13)(cid:5)(cid:2)(cid:14)(cid:46)(cid:2)(cid:28)(cid:5)(cid:3)(cid:10)(cid:5)(cid:2)(cid:64)(cid:46)(cid:4)(cid:12)(cid:2)(cid:28)(cid:3,Unknown,13434.0
Unknown,Unknown,9,Unknown,Unknown,Unknown,Unknown,cid:50)(cid:46)(cid:12)(cid:2)(cid:7)(cid:8)(cid:10)(cid:5)(cid:3)(cid:48)(cid:46)(cid:3)(cid:12)(cid:13)(cid:5)(cid:2)(cid:14)(cid:46)(cid:2)(cid:28)(cid:5)(cid:3)(cid:10)(cid:5)(cid:2)(cid:64)(cid:46)(cid:4)(cid:12)(cid:2)(cid:28)(cid:3,Unknown,13443.0
Unknown,Unknown,46,Unknown,Unknown,Unknown,Unknown,cid:50)(cid:46)(cid:12)(cid:2)(cid:7)(cid:8)(cid:10)(cid:5)(cid:3)(cid:48)(cid:46)(cid:3)(cid:12)(cid:13)(cid:5)(cid:2)(cid:14)(cid:46)(cid:2)(cid:28)(cid:5)(cid:3)(cid:10)(cid:5)(cid:2)(cid:64)(cid:46)(cid:4)(cid:12)(cid:2)(cid:28)(cid:3,Unknown,13489.0
Unknown,Unknown,15,Unknown,Unknown,Unknown,Unknown,cid:50)(cid:46)(cid:12)(cid:2)(cid:7)(cid:8)(cid:10)(cid:5)(cid:3)(cid:48)(cid:46)(cid:3)(cid:12)(cid:13)(cid:5)(cid:2)(cid:14)(cid:46)(cid:2)(cid:28)(cid:5)(cid:3)(cid:10)(cid:5)(cid:2)(cid:64)(cid:46)(cid:4)(cid:12)(cid:2)(cid:28)(cid:3,Unknown,13504.0
Unknown,Unknown,2,Unknown,Unknown,Unknown,Unknown,cid:50)(cid:46)(cid:12)(cid:2)(cid:7)(cid:8)(cid:10)(cid:5)(cid:3)(cid:48)(cid:46)(cid:3)(cid:12)(cid:13)(cid:5)(cid:2)(cid:14)(cid:46)(cid:2)(cid:28)(cid:5)(cid:3)(cid:10)(cid:5)(cid:2)(cid:64)(cid:46)(cid:4)(cid:12)(cid:2)(cid:28)(cid:3,Unknown,13506.0
Unknown,Unknown,1,Unknown,Unknown,Unknown,Unknown,cid:50)(cid:46)(cid:12)(cid:2)(cid:7)(cid:8)(cid:10)(cid:5)(cid:3)(cid:48)(cid:46)(cid:3)(cid:12)(cid:13)(cid:5)(cid:2)(cid:14)(cid:46)(cid:2)(cid:28)(cid:5)(cid:3)(cid:10)(cid:5)(cid:2)(cid:64)(cid:46)(cid:4)(cid:12)(cid:2)(cid:28)(cid:3,Unknown,13507.0
Unknown,Unknown,37,Unknown,Unknown,Unknown,Unknown,cid:50)(cid:46)(cid:12)(cid:2)(cid:7)(cid:8)(cid:10)(cid:5)(cid:3)(cid:48)(cid:46)(cid:3)(cid:12)(cid:13)(cid:5)(cid:2)(cid:14)(cid:46)(cid:2)(cid:28)(cid:5)(cid:3)(cid:10)(cid:5)(cid:2)(cid:64)(cid:46)(cid:4)(cid:12)(cid:2)(cid:28)(cid:3,Unknown,13544.0
Unknown,Unknown,36,Unknown,Unknown,Unknown,Unknown,cid:50)(cid:46)(cid:12)(cid:2)(cid:7)(cid:8)(cid:10)(cid:5)(cid:3)(cid:48)(cid:46)(cid:3)(cid:12)(cid:13)(cid:5)(cid:2)(cid:14)(cid:46)(cid:2)(cid:28)(cid:5)(cid:3)(cid:10)(cid:5)(cid:2)(cid:64)(cid:46)(cid:4)(cid:12)(cid:2)(cid:28)(cid:3,Unknown,13580.0
Unknown,Unknown,19,Unknown,Unknown,Unknown,Unknown,cid:50)(cid:46)(cid:12)(cid:2)(cid:7)(cid:8)(cid:10)(cid:5)(cid:3)(cid:48)(cid:46)(cid:3)(cid:12)(cid:13)(cid:5)(cid:2)(cid:14)(cid:46)(cid:2)(cid:28)(cid:5)(cid:3)(cid:10)(cid:5)(cid:2)(cid:64)(cid:46)(cid:4)(cid:12)(cid:2)(cid:28)(cid:3,Unknown,13599.0
Unknown,Unknown,32,Unknown,Unknown,Unknown,Unknown,cid:50)(cid:46)(cid:12)(cid:2)(cid:7)(cid:8)(cid:10)(cid:5)(cid:3)(cid:48)(cid:46)(cid:3)(cid:12)(cid:13)(cid:5)(cid:2)(cid:14)(cid:46)(cid:2)(cid:28)(cid:5)(cid:3)(cid:10)(cid:5)(cid:2)(cid:64)(cid:46)(cid:4)(cid:12)(cid:2)(cid:28)(cid:3,Unknown,13631.0
Unknown,Unknown,36,Unknown,Unknown,Unknown,Unknown,cid:50)(cid:46)(cid:12)(cid:2)(cid:7)(cid:8)(cid:10)(cid:5)(cid:3)(cid:48)(cid:46)(cid:3)(cid:12)(cid:13)(cid:5)(cid:2)(cid:14)(cid:46)(cid:2)(cid:28)(cid:5)(cid:3)(cid:10)(cid:5)(cid:2)(cid:64)(cid:46)(cid:4)(cid:12)(cid:2)(cid:28)(cid:3,Unknown,13667.0
Unknown,Unknown,2,Unknown,Unknown,Unknown,Unknown,cid:50)(cid:46)(cid:12)(cid:2)(cid:7)(cid:8)(cid:10)(cid:5)(cid:3)(cid:48)(cid:46)(cid:3)(cid:12)(cid:13)(cid:5)(cid:2)(cid:14)(cid:46)(cid:2)(cid:28)(cid:5)(cid:3)(cid:10)(cid:5)(cid:2)(cid:64)(cid:46)(cid:4)(cid:12)(cid:2)(cid:28)(cid:3,Unknown,13669.0
Unknown,Unknown,44,Unknown,Unknown,Unknown,Unknown,cid:50)(cid:46)(cid:12)(cid:2)(cid:7)(cid:8)(cid:10)(cid:5)(cid:3)(cid:48)(cid:46)(cid:3)(cid:12)(cid:13)(cid:5)(cid:2)(cid:14)(cid:46)(cid:2)(cid:28)(cid:5)(cid:3)(cid:10)(cid:5)(cid:2)(cid:64)(cid:46)(cid:4)(cid:12)(cid:2)(cid:28)(cid:3,Unknown,13713.0
Unknown,Unknown,12,Unknown,Unknown,Unknown,Unknown,cid:50)(cid:46)(cid:12)(cid:2)(cid:7)(cid:8)(cid:10)(cid:5)(cid:3)(cid:48)(cid:46)(cid:3)(cid:12)(cid:13)(cid:5)(cid:2)(cid:14)(cid:46)(cid:2)(cid:28)(cid:5)(cid:3)(cid:10)(cid:5)(cid:2)(cid:64)(cid:46)(cid:4)(cid:12)(cid:2)(cid:28)(cid:3,Unknown,13725.0
Unknown,Unknown,20,Unknown,Unknown,Unknown,Unknown,cid:50)(cid:46)(cid:12)(cid:2)(cid:7)(cid:8)(cid:10)(cid:5)(cid:3)(cid:48)(cid:46)(cid:3)(cid:12)(cid:13)(cid:5)(cid:2)(cid:14)(cid:46)(cid:2)(cid:28)(cid:5)(cid:3)(cid:10)(cid:5)(cid:2)(cid:64)(cid:46)(cid:4)(cid:12)(cid:2)(cid:28)(cid:3,Unknown,13745.0
Unknown,Unknown,30,Unknown,Unknown,Unknown,Unknown,cid:50)(cid:46)(cid:12)(cid:2)(cid:7)(cid:8)(cid:10)(cid:5)(cid:3)(cid:48)(cid:46)(cid:3)(cid:12)(cid:13)(cid:5)(cid:2)(cid:14)(cid:46)(cid:2)(cid:28)(cid:5)(cid:3)(cid:10)(cid:5)(cid:2)(cid:64)(cid:46)(cid:4)(cid:12)(cid:2)(cid:28)(cid:3,Unknown,13775.0
Unknown,Unknown,41,Unknown,Unknown,Unknown,Unknown,cid:50)(cid:46)(cid:12)(cid:2)(cid:7)(cid:8)(cid:10)(cid:5)(cid:3)(cid:48)(cid:46)(cid:3)(cid:12)(cid:13)(cid:5)(cid:2)(cid:14)(cid:46)(cid:2)(cid:28)(cid:5)(cid:3)(cid:10)(cid:5)(cid:2)(cid:64)(cid:46)(cid:4)(cid:12)(cid:2)(cid:28)(cid:3,Unknown,13816.0
Unknown,Unknown,26,Unknown,Unknown,Unknown,Unknown,cid:50)(cid:46)(cid:12)(cid:2)(cid:7)(cid:8)(cid:10)(cid:5)(cid:3)(cid:48)(cid:46)(cid:3)(cid:12)(cid:13)(cid:5)(cid:2)(cid:14)(cid:46)(cid:2)(cid:28)(cid:5)(cid:3)(cid:10)(cid:5)(cid:2)(cid:64)(cid:46)(cid:4)(cid:12)(cid:2)(cid:28)(cid:3,Unknown,13842.0
Unknown,Unknown,29,Unknown,Unknown,Unknown,Unknown,cid:50)(cid:46)(cid:12)(cid:2)(cid:7)(cid:8)(cid:10)(cid:5)(cid:3)(cid:48)(cid:46)(cid:3)(cid:12)(cid:13)(cid:5)(cid:2)(cid:14)(cid:46)(cid:2)(cid:28)(cid:5)(cid:3)(cid:10)(cid:5)(cid:2)(cid:64)(cid:46)(cid:4)(cid:12)(cid:2)(cid:28)(cid:3,Unknown,13871.0
Unknown,Unknown,41,Unknown,Unknown,Unknown,Unknown,cid:50)(cid:46)(cid:12)(cid:2)(cid:7)(cid:8)(cid:10)(cid:5)(cid:3)(cid:48)(cid:46)(cid:3)(cid:12)(cid:13)(cid:5)(cid:2)(cid:14)(cid:46)(cid:2)(cid:28)(cid:5)(cid:3)(cid:10)(cid:5)(cid:2)(cid:64)(cid:46)(cid:4)(cid:12)(cid:2)(cid:28)(cid:3,Unknown,13912.0
Unknown,Unknown,2,Unknown,Unknown,Unknown,Unknown,cid:50)(cid:46)(cid:12)(cid:2)(cid:7)(cid:8)(cid:10)(cid:5)(cid:3)(cid:48)(cid:46)(cid:3)(cid:12)(cid:13)(cid:5)(cid:2)(cid:14)(cid:46)(cid:2)(cid:28)(cid:5)(cid:3)(cid:10)(cid:5)(cid:2)(cid:64)(cid:46)(cid:4)(cid:12)(cid:2)(cid:28)(cid:3,Unknown,13914.0
Unknown,Unknown,46,Unknown,Unknown,Unknown,Unknown,cid:50)(cid:46)(cid:12)(cid:2)(cid:7)(cid:8)(cid:10)(cid:5)(cid:3)(cid:48)(cid:46)(cid:3)(cid:12)(cid:13)(cid:5)(cid:2)(cid:14)(cid:46)(cid:2)(cid:28)(cid:5)(cid:3)(cid:10)(cid:5)(cid:2)(cid:64)(cid:46)(cid:4)(cid:12)(cid:2)(cid:28)(cid:3,Unknown,13960.0
Unknown,Unknown,10,Unknown,Unknown,Unknown,Unknown,cid:50)(cid:46)(cid:12)(cid:2)(cid:7)(cid:8)(cid:10)(cid:5)(cid:3)(cid:48)(cid:46)(cid:3)(cid:12)(cid:13)(cid:5)(cid:2)(cid:14)(cid:46)(cid:2)(cid:28)(cid:5)(cid:3)(cid:10)(cid:5)(cid:2)(cid:64)(cid:46)(cid:4)(cid:12)(cid:2)(cid:28)(cid:3,Unknown,13970.0
Unknown,Unknown,1,Unknown,Unknown,Unknown,Unknown,cid:50)(cid:46)(cid:12)(cid:2)(cid:7)(cid:8)(cid:10)(cid:5)(cid:3)(cid:48)(cid:46)(cid:3)(cid:12)(cid:13)(cid:5)(cid:2)(cid:14)(cid:46)(cid:2)(cid:28)(cid:5)(cid:3)(cid:10)(cid:5)(cid:2)(cid:64)(cid:46)(cid:4)(cid:12)(cid:2)(cid:28)(cid:3,Unknown,13971.0
Unknown,Unknown,37,Unknown,Unknown,Unknown,Unknown,cid:50)(cid:46)(cid:12)(cid:2)(cid:7)(cid:8)(cid:10)(cid:5)(cid:3)(cid:48)(cid:46)(cid:3)(cid:12)(cid:13)(cid:5)(cid:2)(cid:14)(cid:46)(cid:2)(cid:28)(cid:5)(cid:3)(cid:10)(cid:5)(cid:2)(cid:64)(cid:46)(cid:4)(cid:12)(cid:2)(cid:28)(cid:3,Unknown,14008.0
Unknown,Unknown,37,Unknown,Unknown,Unknown,Unknown,cid:50)(cid:46)(cid:12)(cid:2)(cid:7)(cid:8)(cid:10)(cid:5)(cid:3)(cid:48)(cid:46)(cid:3)(cid:12)(cid:13)(cid:5)(cid:2)(cid:14)(cid:46)(cid:2)(cid:28)(cid:5)(cid:3)(cid:10)(cid:5)(cid:2)(cid:64)(cid:46)(cid:4)(cid:12)(cid:2)(cid:28)(cid:3,Unknown,14045.0
Unknown,Unknown,1,Unknown,Unknown,Unknown,Unknown,cid:50)(cid:46)(cid:12)(cid:2)(cid:7)(cid:8)(cid:10)(cid:5)(cid:3)(cid:48)(cid:46)(cid:3)(cid:12)(cid:13)(cid:5)(cid:2)(cid:14)(cid:46)(cid:2)(cid:28)(cid:5)(cid:3)(cid:10)(cid:5)(cid:2)(cid:64)(cid:46)(cid:4)(cid:12)(cid:2)(cid:28)(cid:3,Unknown,14046.0
Unknown,Unknown,34,Unknown,Unknown,Unknown,Unknown,cid:50)(cid:46)(cid:12)(cid:2)(cid:7)(cid:8)(cid:10)(cid:5)(cid:3)(cid:48)(cid:46)(cid:3)(cid:12)(cid:13)(cid:5)(cid:2)(cid:14)(cid:46)(cid:2)(cid:28)(cid:5)(cid:3)(cid:10)(cid:5)(cid:2)(cid:64)(cid:46)(cid:4)(cid:12)(cid:2)(cid:28)(cid:3,Unknown,14080.0
Unknown,Unknown,16,Unknown,Unknown,Unknown,Unknown,cid:50)(cid:46)(cid:12)(cid:2)(cid:7)(cid:8)(cid:10)(cid:5)(cid:3)(cid:48)(cid:46)(cid:3)(cid:12)(cid:13)(cid:5)(cid:2)(cid:14)(cid:46)(cid:2)(cid:28)(cid:5)(cid:3)(cid:10)(cid:5)(cid:2)(cid:64)(cid:46)(cid:4)(cid:12)(cid:2)(cid:28)(cid:3,Unknown,14096.0
Unknown,Unknown,2,Unknown,Unknown,Unknown,Unknown,cid:50)(cid:46)(cid:12)(cid:2)(cid:7)(cid:8)(cid:10)(cid:5)(cid:3)(cid:48)(cid:46)(cid:3)(cid:12)(cid:13)(cid:5)(cid:2)(cid:14)(cid:46)(cid:2)(cid:28)(cid:5)(cid:3)(cid:10)(cid:5)(cid:2)(cid:64)(cid:46)(cid:4)(cid:12)(cid:2)(cid:28)(cid:3,Unknown,14098.0
Unknown,Unknown,15,Unknown,Unknown,Unknown,Unknown,cid:50)(cid:46)(cid:12)(cid:2)(cid:7)(cid:8)(cid:10)(cid:5)(cid:3)(cid:48)(cid:46)(cid:3)(cid:12)(cid:13)(cid:5)(cid:2)(cid:14)(cid:46)(cid:2)(cid:28)(cid:5)(cid:3)(cid:10)(cid:5)(cid:2)(cid:64)(cid:46)(cid:4)(cid:12)(cid:2)(cid:28)(cid:3,Unknown,14113.0
Unknown,Unknown,2,Unknown,Unknown,Unknown,Unknown,cid:50)(cid:46)(cid:12)(cid:2)(cid:7)(cid:8)(cid:10)(cid:5)(cid:3)(cid:48)(cid:46)(cid:3)(cid:12)(cid:13)(cid:5)(cid:2)(cid:14)(cid:46)(cid:2)(cid:28)(cid:5)(cid:3)(cid:10)(cid:5)(cid:2)(cid:64)(cid:46)(cid:4)(cid:12)(cid:2)(cid:28)(cid:3,Unknown,14115.0
Unknown,Unknown,18,Unknown,Unknown,Unknown,Unknown,cid:50)(cid:46)(cid:12)(cid:2)(cid:7)(cid:8)(cid:10)(cid:5)(cid:3)(cid:48)(cid:46)(cid:3)(cid:12)(cid:13)(cid:5)(cid:2)(cid:14)(cid:46)(cid:2)(cid:28)(cid:5)(cid:3)(cid:10)(cid:5)(cid:2)(cid:64)(cid:46)(cid:4)(cid:12)(cid:2)(cid:28)(cid:3,Unknown,14133.0
Unknown,Unknown,32,Unknown,Unknown,Unknown,Unknown,cid:50)(cid:46)(cid:12)(cid:2)(cid:7)(cid:8)(cid:10)(cid:5)(cid:3)(cid:48)(cid:46)(cid:3)(cid:12)(cid:13)(cid:5)(cid:2)(cid:14)(cid:46)(cid:2)(cid:28)(cid:5)(cid:3)(cid:10)(cid:5)(cid:2)(cid:64)(cid:46)(cid:4)(cid:12)(cid:2)(cid:28)(cid:3,Unknown,14165.0
Unknown,Unknown,18,Unknown,Unknown,Unknown,Unknown,cid:50)(cid:46)(cid:12)(cid:2)(cid:7)(cid:8)(cid:10)(cid:5)(cid:3)(cid:48)(cid:46)(cid:3)(cid:12)(cid:13)(cid:5)(cid:2)(cid:14)(cid:46)(cid:2)(cid:28)(cid:5)(cid:3)(cid:10)(cid:5)(cid:2)(cid:64)(cid:46)(cid:4)(cid:12)(cid:2)(cid:28)(cid:3,Unknown,14183.0
Unknown,Unknown,16,Unknown,Unknown,Unknown,Unknown,cid:50)(cid:46)(cid:12)(cid:2)(cid:7)(cid:8)(cid:10)(cid:5)(cid:3)(cid:48)(cid:46)(cid:3)(cid:12)(cid:13)(cid:5)(cid:2)(cid:14)(cid:46)(cid:2)(cid:28)(cid:5)(cid:3)(cid:10)(cid:5)(cid:2)(cid:64)(cid:46)(cid:4)(cid:12)(cid:2)(cid:28)(cid:3,Unknown,14199.0
Unknown,Unknown,1,Unknown,Unknown,Unknown,Unknown,cid:50)(cid:46)(cid:12)(cid:2)(cid:7)(cid:8)(cid:10)(cid:5)(cid:3)(cid:48)(cid:46)(cid:3)(cid:12)(cid:13)(cid:5)(cid:2)(cid:14)(cid:46)(cid:2)(cid:28)(cid:5)(cid:3)(cid:10)(cid:5)(cid:2)(cid:64)(cid:46)(cid:4)(cid:12)(cid:2)(cid:28)(cid:3,Unknown,14200.0
Unknown,Unknown,18,Unknown,Unknown,Unknown,Unknown,cid:50)(cid:46)(cid:12)(cid:2)(cid:7)(cid:8)(cid:10)(cid:5)(cid:3)(cid:48)(cid:46)(cid:3)(cid:12)(cid:13)(cid:5)(cid:2)(cid:14)(cid:46)(cid:2)(cid:28)(cid:5)(cid:3)(cid:10)(cid:5)(cid:2)(cid:64)(cid:46)(cid:4)(cid:12)(cid:2)(cid:28)(cid:3,Unknown,14218.0
Unknown,Unknown,1,Unknown,Unknown,Unknown,Unknown,cid:50)(cid:46)(cid:12)(cid:2)(cid:7)(cid:8)(cid:10)(cid:5)(cid:3)(cid:48)(cid:46)(cid:3)(cid:12)(cid:13)(cid:5)(cid:2)(cid:14)(cid:46)(cid:2)(cid:28)(cid:5)(cid:3)(cid:10)(cid:5)(cid:2)(cid:64)(cid:46)(cid:4)(cid:12)(cid:2)(cid:28)(cid:3,Unknown,14219.0
Unknown,Unknown,17,Unknown,Unknown,Unknown,Unknown,cid:50)(cid:46)(cid:12)(cid:2)(cid:7)(cid:8)(cid:10)(cid:5)(cid:3)(cid:48)(cid:46)(cid:3)(cid:12)(cid:13)(cid:5)(cid:2)(cid:14)(cid:46)(cid:2)(cid:28)(cid:5)(cid:3)(cid:10)(cid:5)(cid:2)(cid:64)(cid:46)(cid:4)(cid:12)(cid:2)(cid:28)(cid:3,Unknown,14236.0
Unknown,Unknown,18,Unknown,Unknown,Unknown,Unknown,cid:50)(cid:46)(cid:12)(cid:2)(cid:7)(cid:8)(cid:10)(cid:5)(cid:3)(cid:48)(cid:46)(cid:3)(cid:12)(cid:13)(cid:5)(cid:2)(cid:14)(cid:46)(cid:2)(cid:28)(cid:5)(cid:3)(cid:10)(cid:5)(cid:2)(cid:64)(cid:46)(cid:4)(cid:12)(cid:2)(cid:28)(cid:3,Unknown,14254.0
Unknown,Unknown,18,Unknown,Unknown,Unknown,Unknown,cid:50)(cid:46)(cid:12)(cid:2)(cid:7)(cid:8)(cid:10)(cid:5)(cid:3)(cid:48)(cid:46)(cid:3)(cid:12)(cid:13)(cid:5)(cid:2)(cid:14)(cid:46)(cid:2)(cid:28)(cid:5)(cid:3)(cid:10)(cid:5)(cid:2)(cid:64)(cid:46)(cid:4)(cid:12)(cid:2)(cid:28)(cid:3,Unknown,14272.0
Unknown,Unknown,16,Unknown,Unknown,Unknown,Unknown,cid:50)(cid:46)(cid:12)(cid:2)(cid:7)(cid:8)(cid:10)(cid:5)(cid:3)(cid:48)(cid:46)(cid:3)(cid:12)(cid:13)(cid:5)(cid:2)(cid:14)(cid:46)(cid:2)(cid:28)(cid:5)(cid:3)(cid:10)(cid:5)(cid:2)(cid:64)(cid:46)(cid:4)(cid:12)(cid:2)(cid:28)(cid:3,Unknown,14288.0
Unknown,Unknown,35,Unknown,Unknown,Unknown,Unknown,cid:50)(cid:46)(cid:12)(cid:2)(cid:7)(cid:8)(cid:10)(cid:5)(cid:3)(cid:48)(cid:46)(cid:3)(cid:12)(cid:13)(cid:5)(cid:2)(cid:14)(cid:46)(cid:2)(cid:28)(cid:5)(cid:3)(cid:10)(cid:5)(cid:2)(cid:64)(cid:46)(cid:4)(cid:12)(cid:2)(cid:28)(cid:3,Unknown,14323.0
Unknown,Unknown,33,Unknown,Unknown,Unknown,Unknown,cid:50)(cid:46)(cid:12)(cid:2)(cid:7)(cid:8)(cid:10)(cid:5)(cid:3)(cid:48)(cid:46)(cid:3)(cid:12)(cid:13)(cid:5)(cid:2)(cid:14)(cid:46)(cid:2)(cid:28)(cid:5)(cid:3)(cid:10)(cid:5)(cid:2)(cid:64)(cid:46)(cid:4)(cid:12)(cid:2)(cid:28)(cid:3,Unknown,14356.0
Unknown,Unknown,18,Unknown,Unknown,Unknown,Unknown,cid:50)(cid:46)(cid:12)(cid:2)(cid:7)(cid:8)(cid:10)(cid:5)(cid:3)(cid:48)(cid:46)(cid:3)(cid:12)(cid:13)(cid:5)(cid:2)(cid:14)(cid:46)(cid:2)(cid:28)(cid:5)(cid:3)(cid:10)(cid:5)(cid:2)(cid:64)(cid:46)(cid:4)(cid:12)(cid:2)(cid:28)(cid:3,Unknown,14374.0
Unknown,Unknown,34,Unknown,Unknown,Unknown,Unknown,cid:50)(cid:46)(cid:12)(cid:2)(cid:7)(cid:8)(cid:10)(cid:5)(cid:3)(cid:48)(cid:46)(cid:3)(cid:12)(cid:13)(cid:5)(cid:2)(cid:14)(cid:46)(cid:2)(cid:28)(cid:5)(cid:3)(cid:10)(cid:5)(cid:2)(cid:64)(cid:46)(cid:4)(cid:12)(cid:2)(cid:28)(cid:3,Unknown,14408.0
Unknown,Unknown,18,Unknown,Unknown,Unknown,Unknown,cid:50)(cid:46)(cid:12)(cid:2)(cid:7)(cid:8)(cid:10)(cid:5)(cid:3)(cid:48)(cid:46)(cid:3)(cid:12)(cid:13)(cid:5)(cid:2)(cid:14)(cid:46)(cid:2)(cid:28)(cid:5)(cid:3)(cid:10)(cid:5)(cid:2)(cid:64)(cid:46)(cid:4)(cid:12)(cid:2)(cid:28)(cid:3,Unknown,14426.0
Unknown,Unknown,35,Unknown,Unknown,Unknown,Unknown,cid:50)(cid:46)(cid:12)(cid:2)(cid:7)(cid:8)(cid:10)(cid:5)(cid:3)(cid:48)(cid:46)(cid:3)(cid:12)(cid:13)(cid:5)(cid:2)(cid:14)(cid:46)(cid:2)(cid:28)(cid:5)(cid:3)(cid:10)(cid:5)(cid:2)(cid:64)(cid:46)(cid:4)(cid:12)(cid:2)(cid:28)(cid:3,Unknown,14461.0
Unknown,Unknown,45,Unknown,Unknown,Unknown,Unknown,cid:50)(cid:46)(cid:12)(cid:2)(cid:7)(cid:8)(cid:10)(cid:5)(cid:3)(cid:48)(cid:46)(cid:3)(cid:12)(cid:13)(cid:5)(cid:2)(cid:14)(cid:46)(cid:2)(cid:28)(cid:5)(cid:3)(cid:10)(cid:5)(cid:2)(cid:64)(cid:46)(cid:4)(cid:12)(cid:2)(cid:28)(cid:3,Unknown,14506.0
Unknown,Unknown,18,Unknown,Unknown,Unknown,Unknown,cid:50)(cid:46)(cid:12)(cid:2)(cid:7)(cid:8)(cid:10)(cid:5)(cid:3)(cid:48)(cid:46)(cid:3)(cid:12)(cid:13)(cid:5)(cid:2)(cid:14)(cid:46)(cid:2)(cid:28)(cid:5)(cid:3)(cid:10)(cid:5)(cid:2)(cid:64)(cid:46)(cid:4)(cid:12)(cid:2)(cid:28)(cid:3,Unknown,14524.0
Unknown,Unknown,16,Unknown,Unknown,Unknown,Unknown,cid:50)(cid:46)(cid:12)(cid:2)(cid:7)(cid:8)(cid:10)(cid:5)(cid:3)(cid:48)(cid:46)(cid:3)(cid:12)(cid:13)(cid:5)(cid:2)(cid:14)(cid:46)(cid:2)(cid:28)(cid:5)(cid:3)(cid:10)(cid:5)(cid:2)(cid:64)(cid:46)(cid:4)(cid:12)(cid:2)(cid:28)(cid:3,Unknown,14540.0
Unknown,Unknown,9,Unknown,Unknown,Unknown,Unknown,cid:50)(cid:46)(cid:12)(cid:2)(cid:7)(cid:8)(cid:10)(cid:5)(cid:3)(cid:48)(cid:46)(cid:3)(cid:12)(cid:13)(cid:5)(cid:2)(cid:14)(cid:46)(cid:2)(cid:28)(cid:5)(cid:3)(cid:10)(cid:5)(cid:2)(cid:64)(cid:46)(cid:4)(cid:12)(cid:2)(cid:28)(cid:3,Unknown,14549.0
Unknown,Unknown,41,Unknown,Unknown,Unknown,Unknown,cid:50)(cid:46)(cid:12)(cid:2)(cid:7)(cid:8)(cid:10)(cid:5)(cid:3)(cid:48)(cid:46)(cid:3)(cid:12)(cid:13)(cid:5)(cid:2)(cid:14)(cid:46)(cid:2)(cid:28)(cid:5)(cid:3)(cid:10)(cid:5)(cid:2)(cid:64)(cid:46)(cid:4)(cid:12)(cid:2)(cid:28)(cid:3,Unknown,14590.0
Unknown,Unknown,29,Unknown,Unknown,Unknown,Unknown,cid:50)(cid:46)(cid:12)(cid:2)(cid:7)(cid:8)(cid:10)(cid:5)(cid:3)(cid:48)(cid:46)(cid:3)(cid:12)(cid:13)(cid:5)(cid:2)(cid:14)(cid:46)(cid:2)(cid:28)(cid:5)(cid:3)(cid:10)(cid:5)(cid:2)(cid:64)(cid:46)(cid:4)(cid:12)(cid:2)(cid:28)(cid:3,Unknown,14619.0
Unknown,Unknown,41,Unknown,Unknown,Unknown,Unknown,cid:50)(cid:46)(cid:12)(cid:2)(cid:7)(cid:8)(cid:10)(cid:5)(cid:3)(cid:48)(cid:46)(cid:3)(cid:12)(cid:13)(cid:5)(cid:2)(cid:14)(cid:46)(cid:2)(cid:28)(cid:5)(cid:3)(cid:10)(cid:5)(cid:2)(cid:64)(cid:46)(cid:4)(cid:12)(cid:2)(cid:28)(cid:3,Unknown,14660.0
Unknown,Unknown,24,Unknown,Unknown,Unknown,Unknown,cid:50)(cid:46)(cid:12)(cid:2)(cid:7)(cid:8)(cid:10)(cid:5)(cid:3)(cid:48)(cid:46)(cid:3)(cid:12)(cid:13)(cid:5)(cid:2)(cid:14)(cid:46)(cid:2)(cid:28)(cid:5)(cid:3)(cid:10)(cid:5)(cid:2)(cid:64)(cid:46)(cid:4)(cid:12)(cid:2)(cid:28)(cid:3,Unknown,14684.0
Unknown,Unknown,20,Unknown,Unknown,Unknown,Unknown,cid:50)(cid:46)(cid:12)(cid:2)(cid:7)(cid:8)(cid:10)(cid:5)(cid:3)(cid:48)(cid:46)(cid:3)(cid:12)(cid:13)(cid:5)(cid:2)(cid:14)(cid:46)(cid:2)(cid:28)(cid:5)(cid:3)(cid:10)(cid:5)(cid:2)(cid:64)(cid:46)(cid:4)(cid:12)(cid:2)(cid:28)(cid:3,Unknown,14704.0
Unknown,Unknown,30,Unknown,Unknown,Unknown,Unknown,cid:50)(cid:46)(cid:12)(cid:2)(cid:7)(cid:8)(cid:10)(cid:5)(cid:3)(cid:48)(cid:46)(cid:3)(cid:12)(cid:13)(cid:5)(cid:2)(cid:14)(cid:46)(cid:2)(cid:28)(cid:5)(cid:3)(cid:10)(cid:5)(cid:2)(cid:64)(cid:46)(cid:4)(cid:12)(cid:2)(cid:28)(cid:3,Unknown,14734.0
Unknown,Unknown,2,Unknown,Unknown,Unknown,Unknown,cid:50)(cid:46)(cid:12)(cid:2)(cid:7)(cid:8)(cid:10)(cid:5)(cid:3)(cid:48)(cid:46)(cid:3)(cid:12)(cid:13)(cid:5)(cid:2)(cid:14)(cid:46)(cid:2)(cid:28)(cid:5)(cid:3)(cid:10)(cid:5)(cid:2)(cid:64)(cid:46)(cid:4)(cid:12)(cid:2)(cid:28)(cid:3,Unknown,14736.0
Unknown,Unknown,46,Unknown,Unknown,Unknown,Unknown,cid:50)(cid:46)(cid:12)(cid:2)(cid:7)(cid:8)(cid:10)(cid:5)(cid:3)(cid:48)(cid:46)(cid:3)(cid:12)(cid:13)(cid:5)(cid:2)(cid:14)(cid:46)(cid:2)(cid:28)(cid:5)(cid:3)(cid:10)(cid:5)(cid:2)(cid:64)(cid:46)(cid:4)(cid:12)(cid:2)(cid:28)(cid:3,Unknown,14782.0
Unknown,Unknown,62,Unknown,Unknown,Unknown,Unknown,cid:50)(cid:46)(cid:12)(cid:2)(cid:7)(cid:8)(cid:10)(cid:5)(cid:3)(cid:48)(cid:46)(cid:3)(cid:12)(cid:13)(cid:5)(cid:2)(cid:14)(cid:46)(cid:2)(cid:28)(cid:5)(cid:3)(cid:10)(cid:5)(cid:2)(cid:64)(cid:46)(cid:4)(cid:12)(cid:2)(cid:28)(cid:3,Unknown,14844.0
Unknown,Unknown,24,Unknown,Unknown,Unknown,Unknown,cid:50)(cid:46)(cid:12)(cid:2)(cid:7)(cid:8)(cid:10)(cid:5)(cid:3)(cid:48)(cid:46)(cid:3)(cid:12)(cid:13)(cid:5)(cid:2)(cid:14)(cid:46)(cid:2)(cid:28)(cid:5)(cid:3)(cid:10)(cid:5)(cid:2)(cid:64)(cid:46)(cid:4)(cid:12)(cid:2)(cid:28)(cid:3,Unknown,14868.0
Unknown,Unknown,29,Unknown,Unknown,Unknown,Unknown,cid:50)(cid:46)(cid:12)(cid:2)(cid:7)(cid:8)(cid:10)(cid:5)(cid:3)(cid:48)(cid:46)(cid:3)(cid:12)(cid:13)(cid:5)(cid:2)(cid:14)(cid:46)(cid:2)(cid:28)(cid:5)(cid:3)(cid:10)(cid:5)(cid:2)(cid:64)(cid:46)(cid:4)(cid:12)(cid:2)(cid:28)(cid:3,Unknown,14897.0
Unknown,Unknown,2,Unknown,Unknown,Unknown,Unknown,cid:50)(cid:46)(cid:12)(cid:2)(cid:7)(cid:8)(cid:10)(cid:5)(cid:3)(cid:48)(cid:46)(cid:3)(cid:12)(cid:13)(cid:5)(cid:2)(cid:14)(cid:46)(cid:2)(cid:28)(cid:5)(cid:3)(cid:10)(cid:5)(cid:2)(cid:64)(cid:46)(cid:4)(cid:12)(cid:2)(cid:28)(cid:3,Unknown,14899.0
Unknown,Unknown,66,Unknown,Unknown,Unknown,Unknown,cid:50)(cid:46)(cid:12)(cid:2)(cid:7)(cid:8)(cid:10)(cid:5)(cid:3)(cid:48)(cid:46)(cid:3)(cid:12)(cid:13)(cid:5)(cid:2)(cid:14)(cid:46)(cid:2)(cid:28)(cid:5)(cid:3)(cid:10)(cid:5)(cid:2)(cid:64)(cid:46)(cid:4)(cid:12)(cid:2)(cid:28)(cid:3,Unknown,14965.0
Unknown,Unknown,46,Unknown,Unknown,Unknown,Unknown,cid:50)(cid:46)(cid:12)(cid:2)(cid:7)(cid:8)(cid:10)(cid:5)(cid:3)(cid:48)(cid:46)(cid:3)(cid:12)(cid:13)(cid:5)(cid:2)(cid:14)(cid:46)(cid:2)(cid:28)(cid:5)(cid:3)(cid:10)(cid:5)(cid:2)(cid:64)(cid:46)(cid:4)(cid:12)(cid:2)(cid:28)(cid:3,Unknown,15011.0
Unknown,Unknown,4,Unknown,Unknown,Unknown,Unknown,cid:50)(cid:46)(cid:12)(cid:2)(cid:7)(cid:8)(cid:10)(cid:5)(cid:3)(cid:48)(cid:46)(cid:3)(cid:12)(cid:13)(cid:5)(cid:2)(cid:14)(cid:46)(cid:2)(cid:28)(cid:5)(cid:3)(cid:10)(cid:5)(cid:2)(cid:64)(cid:46)(cid:4)(cid:12)(cid:2)(cid:28)(cid:3,Unknown,15015.0
Unknown,Unknown,50,Unknown,Unknown,Unknown,Unknown,cid:50)(cid:46)(cid:12)(cid:2)(cid:7)(cid:8)(cid:10)(cid:5)(cid:3)(cid:48)(cid:46)(cid:3)(cid:12)(cid:13)(cid:5)(cid:2)(cid:14)(cid:46)(cid:2)(cid:28)(cid:5)(cid:3)(cid:10)(cid:5)(cid:2)(cid:64)(cid:46)(cid:4)(cid:12)(cid:2)(cid:28)(cid:3,Unknown,15065.0
Unknown,Unknown,11,Unknown,Unknown,Unknown,Unknown,cid:50)(cid:46)(cid:12)(cid:2)(cid:7)(cid:8)(cid:10)(cid:5)(cid:3)(cid:48)(cid:46)(cid:3)(cid:12)(cid:13)(cid:5)(cid:2)(cid:14)(cid:46)(cid:2)(cid:28)(cid:5)(cid:3)(cid:10)(cid:5)(cid:2)(cid:64)(cid:46)(cid:4)(cid:12)(cid:2)(cid:28)(cid:3,Unknown,15076.0
Unknown,Unknown,49,Unknown,Unknown,Unknown,Unknown,cid:50)(cid:46)(cid:12)(cid:2)(cid:7)(cid:8)(cid:10)(cid:5)(cid:3)(cid:48)(cid:46)(cid:3)(cid:12)(cid:13)(cid:5)(cid:2)(cid:14)(cid:46)(cid:2)(cid:28)(cid:5)(cid:3)(cid:10)(cid:5)(cid:2)(cid:64)(cid:46)(cid:4)(cid:12)(cid:2)(cid:28)(cid:3,Unknown,15125.0
Unknown,Unknown,2,Unknown,Unknown,Unknown,Unknown,cid:50)(cid:46)(cid:12)(cid:2)(cid:7)(cid:8)(cid:10)(cid:5)(cid:3)(cid:48)(cid:46)(cid:3)(cid:12)(cid:13)(cid:5)(cid:2)(cid:14)(cid:46)(cid:2)(cid:28)(cid:5)(cid:3)(cid:10)(cid:5)(cid:2)(cid:64)(cid:46)(cid:4)(cid:12)(cid:2)(cid:28)(cid:3,Unknown,15127.0
Unknown,Unknown,5,Unknown,Unknown,Unknown,Unknown,cid:50)(cid:46)(cid:12)(cid:2)(cid:7)(cid:8)(cid:10)(cid:5)(cid:3)(cid:48)(cid:46)(cid:3)(cid:12)(cid:13)(cid:5)(cid:2)(cid:14)(cid:46)(cid:2)(cid:28)(cid:5)(cid:3)(cid:10)(cid:5)(cid:2)(cid:64)(cid:46)(cid:4)(cid:12)(cid:2)(cid:28)(cid:3,Unknown,15132.0
Unknown,Unknown,8,Unknown,Unknown,Unknown,Unknown,cid:50)(cid:46)(cid:12)(cid:2)(cid:7)(cid:8)(cid:10)(cid:5)(cid:3)(cid:48)(cid:46)(cid:3)(cid:12)(cid:13)(cid:5)(cid:2)(cid:14)(cid:46)(cid:2)(cid:28)(cid:5)(cid:3)(cid:10)(cid:5)(cid:2)(cid:64)(cid:46)(cid:4)(cid:12)(cid:2)(cid:28)(cid:3,Unknown,15140.0
Unknown,Unknown,2,Unknown,Unknown,Unknown,Unknown,cid:50)(cid:46)(cid:12)(cid:2)(cid:7)(cid:8)(cid:10)(cid:5)(cid:3)(cid:48)(cid:46)(cid:3)(cid:12)(cid:13)(cid:5)(cid:2)(cid:14)(cid:46)(cid:2)(cid:28)(cid:5)(cid:3)(cid:10)(cid:5)(cid:2)(cid:64)(cid:46)(cid:4)(cid:12)(cid:2)(cid:28)(cid:3,Unknown,15142.0
Unknown,Unknown,47,Unknown,Unknown,Unknown,Unknown,cid:50)(cid:46)(cid:12)(cid:2)(cid:7)(cid:8)(cid:10)(cid:5)(cid:3)(cid:48)(cid:46)(cid:3)(cid:12)(cid:13)(cid:5)(cid:2)(cid:14)(cid:46)(cid:2)(cid:28)(cid:5)(cid:3)(cid:10)(cid:5)(cid:2)(cid:64)(cid:46)(cid:4)(cid:12)(cid:2)(cid:28)(cid:3,Unknown,15189.0
Unknown,Unknown,3,Unknown,Unknown,Unknown,Unknown,cid:50)(cid:46)(cid:12)(cid:2)(cid:7)(cid:8)(cid:10)(cid:5)(cid:3)(cid:48)(cid:46)(cid:3)(cid:12)(cid:13)(cid:5)(cid:2)(cid:14)(cid:46)(cid:2)(cid:28)(cid:5)(cid:3)(cid:10)(cid:5)(cid:2)(cid:64)(cid:46)(cid:4)(cid:12)(cid:2)(cid:28)(cid:3,Unknown,15192.0
Unknown,Unknown,7,Unknown,Unknown,Unknown,Unknown,cid:50)(cid:46)(cid:12)(cid:2)(cid:7)(cid:8)(cid:10)(cid:5)(cid:3)(cid:48)(cid:46)(cid:3)(cid:12)(cid:13)(cid:5)(cid:2)(cid:14)(cid:46)(cid:2)(cid:28)(cid:5)(cid:3)(cid:10)(cid:5)(cid:2)(cid:64)(cid:46)(cid:4)(cid:12)(cid:2)(cid:28)(cid:3,Unknown,15199.0
Unknown,Unknown,2,Unknown,Unknown,Unknown,Unknown,cid:50)(cid:46)(cid:12)(cid:2)(cid:7)(cid:8)(cid:10)(cid:5)(cid:3)(cid:48)(cid:46)(cid:3)(cid:12)(cid:13)(cid:5)(cid:2)(cid:14)(cid:46)(cid:2)(cid:28)(cid:5)(cid:3)(cid:10)(cid:5)(cid:2)(cid:64)(cid:46)(cid:4)(cid:12)(cid:2)(cid:28)(cid:3,Unknown,15201.0
Unknown,Unknown,28,Unknown,Unknown,Unknown,Unknown,cid:50)(cid:46)(cid:12)(cid:2)(cid:7)(cid:8)(cid:10)(cid:5)(cid:3)(cid:48)(cid:46)(cid:3)(cid:12)(cid:13)(cid:5)(cid:2)(cid:14)(cid:46)(cid:2)(cid:28)(cid:5)(cid:3)(cid:10)(cid:5)(cid:2)(cid:64)(cid:46)(cid:4)(cid:12)(cid:2)(cid:28)(cid:3,Unknown,15229.0
Unknown,Unknown,3,Unknown,Unknown,Unknown,Unknown,cid:50)(cid:46)(cid:12)(cid:2)(cid:7)(cid:8)(cid:10)(cid:5)(cid:3)(cid:48)(cid:46)(cid:3)(cid:12)(cid:13)(cid:5)(cid:2)(cid:14)(cid:46)(cid:2)(cid:28)(cid:5)(cid:3)(cid:10)(cid:5)(cid:2)(cid:64)(cid:46)(cid:4)(cid:12)(cid:2)(cid:28)(cid:3,Unknown,15232.0
Unknown,Unknown,15,Unknown,Unknown,Unknown,Unknown,cid:50)(cid:46)(cid:12)(cid:2)(cid:7)(cid:8)(cid:10)(cid:5)(cid:3)(cid:48)(cid:46)(cid:3)(cid:12)(cid:13)(cid:5)(cid:2)(cid:14)(cid:46)(cid:2)(cid:28)(cid:5)(cid:3)(cid:10)(cid:5)(cid:2)(cid:64)(cid:46)(cid:4)(cid:12)(cid:2)(cid:28)(cid:3,Unknown,15247.0
Unknown,Unknown,2,Unknown,Unknown,Unknown,Unknown,cid:50)(cid:46)(cid:12)(cid:2)(cid:7)(cid:8)(cid:10)(cid:5)(cid:3)(cid:48)(cid:46)(cid:3)(cid:12)(cid:13)(cid:5)(cid:2)(cid:14)(cid:46)(cid:2)(cid:28)(cid:5)(cid:3)(cid:10)(cid:5)(cid:2)(cid:64)(cid:46)(cid:4)(cid:12)(cid:2)(cid:28)(cid:3,Unknown,15249.0
Unknown,Unknown,37,Unknown,Unknown,Unknown,Unknown,cid:50)(cid:46)(cid:12)(cid:2)(cid:7)(cid:8)(cid:10)(cid:5)(cid:3)(cid:48)(cid:46)(cid:3)(cid:12)(cid:13)(cid:5)(cid:2)(cid:14)(cid:46)(cid:2)(cid:28)(cid:5)(cid:3)(cid:10)(cid:5)(cid:2)(cid:64)(cid:46)(cid:4)(cid:12)(cid:2)(cid:28)(cid:3,Unknown,15286.0
Unknown,Unknown,18,Unknown,Unknown,Unknown,Unknown,cid:50)(cid:46)(cid:12)(cid:2)(cid:7)(cid:8)(cid:10)(cid:5)(cid:3)(cid:48)(cid:46)(cid:3)(cid:12)(cid:13)(cid:5)(cid:2)(cid:14)(cid:46)(cid:2)(cid:28)(cid:5)(cid:3)(cid:10)(cid:5)(cid:2)(cid:64)(cid:46)(cid:4)(cid:12)(cid:2)(cid:28)(cid:3,Unknown,15304.0
Unknown,Unknown,19,Unknown,Unknown,Unknown,Unknown,cid:50)(cid:46)(cid:12)(cid:2)(cid:7)(cid:8)(cid:10)(cid:5)(cid:3)(cid:48)(cid:46)(cid:3)(cid:12)(cid:13)(cid:5)(cid:2)(cid:14)(cid:46)(cid:2)(cid:28)(cid:5)(cid:3)(cid:10)(cid:5)(cid:2)(cid:64)(cid:46)(cid:4)(cid:12)(cid:2)(cid:28)(cid:3,Unknown,15323.0
Unknown,Unknown,37,Unknown,Unknown,Unknown,Unknown,cid:50)(cid:46)(cid:12)(cid:2)(cid:7)(cid:8)(cid:10)(cid:5)(cid:3)(cid:48)(cid:46)(cid:3)(cid:12)(cid:13)(cid:5)(cid:2)(cid:14)(cid:46)(cid:2)(cid:28)(cid:5)(cid:3)(cid:10)(cid:5)(cid:2)(cid:64)(cid:46)(cid:4)(cid:12)(cid:2)(cid:28)(cid:3,Unknown,15360.0
Unknown,Unknown,33,Unknown,Unknown,Unknown,Unknown,cid:50)(cid:46)(cid:12)(cid:2)(cid:7)(cid:8)(cid:10)(cid:5)(cid:3)(cid:48)(cid:46)(cid:3)(cid:12)(cid:13)(cid:5)(cid:2)(cid:14)(cid:46)(cid:2)(cid:28)(cid:5)(cid:3)(cid:10)(cid:5)(cid:2)(cid:64)(cid:46)(cid:4)(cid:12)(cid:2)(cid:28)(cid:3,Unknown,15393.0
Unknown,Unknown,2,Unknown,Unknown,Unknown,Unknown,cid:50)(cid:46)(cid:12)(cid:2)(cid:7)(cid:8)(cid:10)(cid:5)(cid:3)(cid:48)(cid:46)(cid:3)(cid:12)(cid:13)(cid:5)(cid:2)(cid:14)(cid:46)(cid:2)(cid:28)(cid:5)(cid:3)(cid:10)(cid:5)(cid:2)(cid:64)(cid:46)(cid:4)(cid:12)(cid:2)(cid:28)(cid:3,Unknown,15395.0
Unknown,Unknown,44,Unknown,Unknown,Unknown,Unknown,cid:50)(cid:46)(cid:12)(cid:2)(cid:7)(cid:8)(cid:10)(cid:5)(cid:3)(cid:48)(cid:46)(cid:3)(cid:12)(cid:13)(cid:5)(cid:2)(cid:14)(cid:46)(cid:2)(cid:28)(cid:5)(cid:3)(cid:10)(cid:5)(cid:2)(cid:64)(cid:46)(cid:4)(cid:12)(cid:2)(cid:28)(cid:3,Unknown,15439.0
Unknown,Unknown,12,Unknown,Unknown,Unknown,Unknown,cid:50)(cid:46)(cid:12)(cid:2)(cid:7)(cid:8)(cid:10)(cid:5)(cid:3)(cid:48)(cid:46)(cid:3)(cid:12)(cid:13)(cid:5)(cid:2)(cid:14)(cid:46)(cid:2)(cid:28)(cid:5)(cid:3)(cid:10)(cid:5)(cid:2)(cid:64)(cid:46)(cid:4)(cid:12)(cid:2)(cid:28)(cid:3,Unknown,15451.0
Unknown,Unknown,29,Unknown,Unknown,Unknown,Unknown,cid:50)(cid:46)(cid:12)(cid:2)(cid:7)(cid:8)(cid:10)(cid:5)(cid:3)(cid:48)(cid:46)(cid:3)(cid:12)(cid:13)(cid:5)(cid:2)(cid:14)(cid:46)(cid:2)(cid:28)(cid:5)(cid:3)(cid:10)(cid:5)(cid:2)(cid:64)(cid:46)(cid:4)(cid:12)(cid:2)(cid:28)(cid:3,Unknown,15480.0
Unknown,Unknown,26,Unknown,Unknown,Unknown,Unknown,cid:50)(cid:46)(cid:12)(cid:2)(cid:7)(cid:8)(cid:10)(cid:5)(cid:3)(cid:48)(cid:46)(cid:3)(cid:12)(cid:13)(cid:5)(cid:2)(cid:14)(cid:46)(cid:2)(cid:28)(cid:5)(cid:3)(cid:10)(cid:5)(cid:2)(cid:64)(cid:46)(cid:4)(cid:12)(cid:2)(cid:28)(cid:3,Unknown,15506.0
Unknown,Unknown,41,Unknown,Unknown,Unknown,Unknown,cid:50)(cid:46)(cid:12)(cid:2)(cid:7)(cid:8)(cid:10)(cid:5)(cid:3)(cid:48)(cid:46)(cid:3)(cid:12)(cid:13)(cid:5)(cid:2)(cid:14)(cid:46)(cid:2)(cid:28)(cid:5)(cid:3)(cid:10)(cid:5)(cid:2)(cid:64)(cid:46)(cid:4)(cid:12)(cid:2)(cid:28)(cid:3,Unknown,15547.0
Unknown,Unknown,25,Unknown,Unknown,Unknown,Unknown,cid:50)(cid:46)(cid:12)(cid:2)(cid:7)(cid:8)(cid:10)(cid:5)(cid:3)(cid:48)(cid:46)(cid:3)(cid:12)(cid:13)(cid:5)(cid:2)(cid:14)(cid:46)(cid:2)(cid:28)(cid:5)(cid:3)(cid:10)(cid:5)(cid:2)(cid:64)(cid:46)(cid:4)(cid:12)(cid:2)(cid:28)(cid:3,Unknown,15572.0
Unknown,Unknown,2,Unknown,Unknown,Unknown,Unknown,cid:50)(cid:46)(cid:12)(cid:2)(cid:7)(cid:8)(cid:10)(cid:5)(cid:3)(cid:48)(cid:46)(cid:3)(cid:12)(cid:13)(cid:5)(cid:2)(cid:14)(cid:46)(cid:2)(cid:28)(cid:5)(cid:3)(cid:10)(cid:5)(cid:2)(cid:64)(cid:46)(cid:4)(cid:12)(cid:2)(cid:28)(cid:3,Unknown,15574.0
Unknown,Unknown,58,Unknown,Unknown,Unknown,Unknown,cid:50)(cid:46)(cid:12)(cid:2)(cid:7)(cid:8)(cid:10)(cid:5)(cid:3)(cid:48)(cid:46)(cid:3)(cid:12)(cid:13)(cid:5)(cid:2)(cid:14)(cid:46)(cid:2)(cid:28)(cid:5)(cid:3)(cid:10)(cid:5)(cid:2)(cid:64)(cid:46)(cid:4)(cid:12)(cid:2)(cid:28)(cid:3,Unknown,15632.0
Unknown,Unknown,58,Unknown,Unknown,Unknown,Unknown,cid:50)(cid:46)(cid:12)(cid:2)(cid:7)(cid:8)(cid:10)(cid:5)(cid:3)(cid:48)(cid:46)(cid:3)(cid:12)(cid:13)(cid:5)(cid:2)(cid:14)(cid:46)(cid:2)(cid:28)(cid:5)(cid:3)(cid:10)(cid:5)(cid:2)(cid:64)(cid:46)(cid:4)(cid:12)(cid:2)(cid:28)(cid:3,Unknown,15690.0
Unknown,Unknown,18,Unknown,Unknown,Unknown,Unknown,cid:50)(cid:46)(cid:12)(cid:2)(cid:7)(cid:8)(cid:10)(cid:5)(cid:3)(cid:48)(cid:46)(cid:3)(cid:12)(cid:13)(cid:5)(cid:2)(cid:14)(cid:46)(cid:2)(cid:28)(cid:5)(cid:3)(cid:10)(cid:5)(cid:2)(cid:64)(cid:46)(cid:4)(cid:12)(cid:2)(cid:28)(cid:3,Unknown,15708.0
Unknown,Unknown,1,Unknown,Unknown,Unknown,Unknown,cid:50)(cid:46)(cid:12)(cid:2)(cid:7)(cid:8)(cid:10)(cid:5)(cid:3)(cid:48)(cid:46)(cid:3)(cid:12)(cid:13)(cid:5)(cid:2)(cid:14)(cid:46)(cid:2)(cid:28)(cid:5)(cid:3)(cid:10)(cid:5)(cid:2)(cid:64)(cid:46)(cid:4)(cid:12)(cid:2)(cid:28)(cid:3,Unknown,15709.0
Unknown,Unknown,1,Unknown,Unknown,Unknown,Unknown,cid:50)(cid:46)(cid:12)(cid:2)(cid:7)(cid:8)(cid:10)(cid:5)(cid:3)(cid:48)(cid:46)(cid:3)(cid:12)(cid:13)(cid:5)(cid:2)(cid:14)(cid:46)(cid:2)(cid:28)(cid:5)(cid:3)(cid:10)(cid:5)(cid:2)(cid:64)(cid:46)(cid:4)(cid:12)(cid:2)(cid:28)(cid:3,Unknown,15710.0
Unknown,Unknown,37,Unknown,Unknown,Unknown,Unknown,cid:50)(cid:46)(cid:12)(cid:2)(cid:7)(cid:8)(cid:10)(cid:5)(cid:3)(cid:48)(cid:46)(cid:3)(cid:12)(cid:13)(cid:5)(cid:2)(cid:14)(cid:46)(cid:2)(cid:28)(cid:5)(cid:3)(cid:10)(cid:5)(cid:2)(cid:64)(cid:46)(cid:4)(cid:12)(cid:2)(cid:28)(cid:3,Unknown,15747.0
Unknown,Unknown,18,Unknown,Unknown,Unknown,Unknown,cid:50)(cid:46)(cid:12)(cid:2)(cid:7)(cid:8)(cid:10)(cid:5)(cid:3)(cid:48)(cid:46)(cid:3)(cid:12)(cid:13)(cid:5)(cid:2)(cid:14)(cid:46)(cid:2)(cid:28)(cid:5)(cid:3)(cid:10)(cid:5)(cid:2)(cid:64)(cid:46)(cid:4)(cid:12)(cid:2)(cid:28)(cid:3,Unknown,15765.0
Unknown,Unknown,35,Unknown,Unknown,Unknown,Unknown,cid:50)(cid:46)(cid:12)(cid:2)(cid:7)(cid:8)(cid:10)(cid:5)(cid:3)(cid:48)(cid:46)(cid:3)(cid:12)(cid:13)(cid:5)(cid:2)(cid:14)(cid:46)(cid:2)(cid:28)(cid:5)(cid:3)(cid:10)(cid:5)(cid:2)(cid:64)(cid:46)(cid:4)(cid:12)(cid:2)(cid:28)(cid:3,Unknown,15800.0
Unknown,Unknown,45,Unknown,Unknown,Unknown,Unknown,cid:50)(cid:46)(cid:12)(cid:2)(cid:7)(cid:8)(cid:10)(cid:5)(cid:3)(cid:48)(cid:46)(cid:3)(cid:12)(cid:13)(cid:5)(cid:2)(cid:14)(cid:46)(cid:2)(cid:28)(cid:5)(cid:3)(cid:10)(cid:5)(cid:2)(cid:64)(cid:46)(cid:4)(cid:12)(cid:2)(cid:28)(cid:3,Unknown,15845.0
Unknown,Unknown,18,Unknown,Unknown,Unknown,Unknown,cid:50)(cid:46)(cid:12)(cid:2)(cid:7)(cid:8)(cid:10)(cid:5)(cid:3)(cid:48)(cid:46)(cid:3)(cid:12)(cid:13)(cid:5)(cid:2)(cid:14)(cid:46)(cid:2)(cid:28)(cid:5)(cid:3)(cid:10)(cid:5)(cid:2)(cid:64)(cid:46)(cid:4)(cid:12)(cid:2)(cid:28)(cid:3,Unknown,15863.0
Unknown,Unknown,16,Unknown,Unknown,Unknown,Unknown,cid:50)(cid:46)(cid:12)(cid:2)(cid:7)(cid:8)(cid:10)(cid:5)(cid:3)(cid:48)(cid:46)(cid:3)(cid:12)(cid:13)(cid:5)(cid:2)(cid:14)(cid:46)(cid:2)(cid:28)(cid:5)(cid:3)(cid:10)(cid:5)(cid:2)(cid:64)(cid:46)(cid:4)(cid:12)(cid:2)(cid:28)(cid:3,Unknown,15879.0
Unknown,Unknown,9,Unknown,Unknown,Unknown,Unknown,cid:50)(cid:46)(cid:12)(cid:2)(cid:7)(cid:8)(cid:10)(cid:5)(cid:3)(cid:48)(cid:46)(cid:3)(cid:12)(cid:13)(cid:5)(cid:2)(cid:14)(cid:46)(cid:2)(cid:28)(cid:5)(cid:3)(cid:10)(cid:5)(cid:2)(cid:64)(cid:46)(cid:4)(cid:12)(cid:2)(cid:28)(cid:3,Unknown,15888.0
Unknown,Unknown,10,Unknown,Unknown,Unknown,Unknown,cid:50)(cid:46)(cid:12)(cid:2)(cid:7)(cid:8)(cid:10)(cid:5)(cid:3)(cid:48)(cid:46)(cid:3)(cid:12)(cid:13)(cid:5)(cid:2)(cid:14)(cid:46)(cid:2)(cid:28)(cid:5)(cid:3)(cid:10)(cid:5)(cid:2)(cid:64)(cid:46)(cid:4)(cid:12)(cid:2)(cid:28)(cid:3,Unknown,15898.0
Unknown,Unknown,46,Unknown,Unknown,Unknown,Unknown,cid:50)(cid:46)(cid:12)(cid:2)(cid:7)(cid:8)(cid:10)(cid:5)(cid:3)(cid:48)(cid:46)(cid:3)(cid:12)(cid:13)(cid:5)(cid:2)(cid:14)(cid:46)(cid:2)(cid:28)(cid:5)(cid:3)(cid:10)(cid:5)(cid:2)(cid:64)(cid:46)(cid:4)(cid:12)(cid:2)(cid:28)(cid:3,Unknown,15944.0
Unknown,Unknown,10,Unknown,Unknown,Unknown,Unknown,cid:50)(cid:46)(cid:12)(cid:2)(cid:7)(cid:8)(cid:10)(cid:5)(cid:3)(cid:48)(cid:46)(cid:3)(cid:12)(cid:13)(cid:5)(cid:2)(cid:14)(cid:46)(cid:2)(cid:28)(cid:5)(cid:3)(cid:10)(cid:5)(cid:2)(cid:64)(cid:46)(cid:4)(cid:12)(cid:2)(cid:28)(cid:3,Unknown,15954.0
Unknown,Unknown,7,Unknown,Unknown,Unknown,Unknown,cid:50)(cid:46)(cid:12)(cid:2)(cid:7)(cid:8)(cid:10)(cid:5)(cid:3)(cid:48)(cid:46)(cid:3)(cid:12)(cid:13)(cid:5)(cid:2)(cid:14)(cid:46)(cid:2)(cid:28)(cid:5)(cid:3)(cid:10)(cid:5)(cid:2)(cid:64)(cid:46)(cid:4)(cid:12)(cid:2)(cid:28)(cid:3,Unknown,15961.0
Unknown,Unknown,11,Unknown,Unknown,Unknown,Unknown,cid:50)(cid:46)(cid:12)(cid:2)(cid:7)(cid:8)(cid:10)(cid:5)(cid:3)(cid:48)(cid:46)(cid:3)(cid:12)(cid:13)(cid:5)(cid:2)(cid:14)(cid:46)(cid:2)(cid:28)(cid:5)(cid:3)(cid:10)(cid:5)(cid:2)(cid:64)(cid:46)(cid:4)(cid:12)(cid:2)(cid:28)(cid:3,Unknown,15972.0
Unknown,Unknown,8,Unknown,Unknown,Unknown,Unknown,cid:50)(cid:46)(cid:12)(cid:2)(cid:7)(cid:8)(cid:10)(cid:5)(cid:3)(cid:48)(cid:46)(cid:3)(cid:12)(cid:13)(cid:5)(cid:2)(cid:14)(cid:46)(cid:2)(cid:28)(cid:5)(cid:3)(cid:10)(cid:5)(cid:2)(cid:64)(cid:46)(cid:4)(cid:12)(cid:2)(cid:28)(cid:3,Unknown,15980.0
Unknown,Unknown,2,Unknown,Unknown,Unknown,Unknown,cid:50)(cid:46)(cid:12)(cid:2)(cid:7)(cid:8)(cid:10)(cid:5)(cid:3)(cid:48)(cid:46)(cid:3)(cid:12)(cid:13)(cid:5)(cid:2)(cid:14)(cid:46)(cid:2)(cid:28)(cid:5)(cid:3)(cid:10)(cid:5)(cid:2)(cid:64)(cid:46)(cid:4)(cid:12)(cid:2)(cid:28)(cid:3,Unknown,15982.0
Unknown,Unknown,46,Unknown,Unknown,Unknown,Unknown,cid:50)(cid:46)(cid:12)(cid:2)(cid:7)(cid:8)(cid:10)(cid:5)(cid:3)(cid:48)(cid:46)(cid:3)(cid:12)(cid:13)(cid:5)(cid:2)(cid:14)(cid:46)(cid:2)(cid:28)(cid:5)(cid:3)(cid:10)(cid:5)(cid:2)(cid:64)(cid:46)(cid:4)(cid:12)(cid:2)(cid:28)(cid:3,Unknown,16028.0
Unknown,Unknown,66,Unknown,Unknown,Unknown,Unknown,cid:50)(cid:46)(cid:12)(cid:2)(cid:7)(cid:8)(cid:10)(cid:5)(cid:3)(cid:48)(cid:46)(cid:3)(cid:12)(cid:13)(cid:5)(cid:2)(cid:14)(cid:46)(cid:2)(cid:28)(cid:5)(cid:3)(cid:10)(cid:5)(cid:2)(cid:64)(cid:46)(cid:4)(cid:12)(cid:2)(cid:28)(cid:3,Unknown,16094.0
Unknown,Unknown,7,Unknown,Unknown,Unknown,Unknown,cid:50)(cid:46)(cid:12)(cid:2)(cid:7)(cid:8)(cid:10)(cid:5)(cid:3)(cid:48)(cid:46)(cid:3)(cid:12)(cid:13)(cid:5)(cid:2)(cid:14)(cid:46)(cid:2)(cid:28)(cid:5)(cid:3)(cid:10)(cid:5)(cid:2)(cid:64)(cid:46)(cid:4)(cid:12)(cid:2)(cid:28)(cid:3,Unknown,16101.0
Unknown,Unknown,46,Unknown,Unknown,Unknown,Unknown,cid:50)(cid:46)(cid:12)(cid:2)(cid:7)(cid:8)(cid:10)(cid:5)(cid:3)(cid:48)(cid:46)(cid:3)(cid:12)(cid:13)(cid:5)(cid:2)(cid:14)(cid:46)(cid:2)(cid:28)(cid:5)(cid:3)(cid:10)(cid:5)(cid:2)(cid:64)(cid:46)(cid:4)(cid:12)(cid:2)(cid:28)(cid:3,Unknown,16147.0
Unknown,Unknown,2,Unknown,Unknown,Unknown,Unknown,cid:50)(cid:46)(cid:12)(cid:2)(cid:7)(cid:8)(cid:10)(cid:5)(cid:3)(cid:48)(cid:46)(cid:3)(cid:12)(cid:13)(cid:5)(cid:2)(cid:14)(cid:46)(cid:2)(cid:28)(cid:5)(cid:3)(cid:10)(cid:5)(cid:2)(cid:64)(cid:46)(cid:4)(cid:12)(cid:2)(cid:28)(cid:3,Unknown,16149.0
Unknown,Unknown,66,Unknown,Unknown,Unknown,Unknown,cid:50)(cid:46)(cid:12)(cid:2)(cid:7)(cid:8)(cid:10)(cid:5)(cid:3)(cid:48)(cid:46)(cid:3)(cid:12)(cid:13)(cid:5)(cid:2)(cid:14)(cid:46)(cid:2)(cid:28)(cid:5)(cid:3)(cid:10)(cid:5)(cid:2)(cid:64)(cid:46)(cid:4)(cid:12)(cid:2)(cid:28)(cid:3,Unknown,16215.0
Unknown,Unknown,46,Unknown,Unknown,Unknown,Unknown,cid:50)(cid:46)(cid:12)(cid:2)(cid:7)(cid:8)(cid:10)(cid:5)(cid:3)(cid:48)(cid:46)(cid:3)(cid:12)(cid:13)(cid:5)(cid:2)(cid:14)(cid:46)(cid:2)(cid:28)(cid:5)(cid:3)(cid:10)(cid:5)(cid:2)(cid:64)(cid:46)(cid:4)(cid:12)(cid:2)(cid:28)(cid:3,Unknown,16261.0
Unknown,Unknown,4,Unknown,Unknown,Unknown,Unknown,cid:50)(cid:46)(cid:12)(cid:2)(cid:7)(cid:8)(cid:10)(cid:5)(cid:3)(cid:48)(cid:46)(cid:3)(cid:12)(cid:13)(cid:5)(cid:2)(cid:14)(cid:46)(cid:2)(cid:28)(cid:5)(cid:3)(cid:10)(cid:5)(cid:2)(cid:64)(cid:46)(cid:4)(cid:12)(cid:2)(cid:28)(cid:3,Unknown,16265.0
Unknown,Unknown,50,Unknown,Unknown,Unknown,Unknown,cid:50)(cid:46)(cid:12)(cid:2)(cid:7)(cid:8)(cid:10)(cid:5)(cid:3)(cid:48)(cid:46)(cid:3)(cid:12)(cid:13)(cid:5)(cid:2)(cid:14)(cid:46)(cid:2)(cid:28)(cid:5)(cid:3)(cid:10)(cid:5)(cid:2)(cid:64)(cid:46)(cid:4)(cid:12)(cid:2)(cid:28)(cid:3,Unknown,16315.0
Unknown,Unknown,11,Unknown,Unknown,Unknown,Unknown,cid:50)(cid:46)(cid:12)(cid:2)(cid:7)(cid:8)(cid:10)(cid:5)(cid:3)(cid:48)(cid:46)(cid:3)(cid:12)(cid:13)(cid:5)(cid:2)(cid:14)(cid:46)(cid:2)(cid:28)(cid:5)(cid:3)(cid:10)(cid:5)(cid:2)(cid:64)(cid:46)(cid:4)(cid:12)(cid:2)(cid:28)(cid:3,Unknown,16326.0
Unknown,Unknown,49,Unknown,Unknown,Unknown,Unknown,cid:50)(cid:46)(cid:12)(cid:2)(cid:7)(cid:8)(cid:10)(cid:5)(cid:3)(cid:48)(cid:46)(cid:3)(cid:12)(cid:13)(cid:5)(cid:2)(cid:14)(cid:46)(cid:2)(cid:28)(cid:5)(cid:3)(cid:10)(cid:5)(cid:2)(cid:64)(cid:46)(cid:4)(cid:12)(cid:2)(cid:28)(cid:3,Unknown,16375.0
Unknown,Unknown,2,Unknown,Unknown,Unknown,Unknown,cid:50)(cid:46)(cid:12)(cid:2)(cid:7)(cid:8)(cid:10)(cid:5)(cid:3)(cid:48)(cid:46)(cid:3)(cid:12)(cid:13)(cid:5)(cid:2)(cid:14)(cid:46)(cid:2)(cid:28)(cid:5)(cid:3)(cid:10)(cid:5)(cid:2)(cid:64)(cid:46)(cid:4)(cid:12)(cid:2)(cid:28)(cid:3,Unknown,16377.0
Unknown,Unknown,5,Unknown,Unknown,Unknown,Unknown,cid:50)(cid:46)(cid:12)(cid:2)(cid:7)(cid:8)(cid:10)(cid:5)(cid:3)(cid:48)(cid:46)(cid:3)(cid:12)(cid:13)(cid:5)(cid:2)(cid:14)(cid:46)(cid:2)(cid:28)(cid:5)(cid:3)(cid:10)(cid:5)(cid:2)(cid:64)(cid:46)(cid:4)(cid:12)(cid:2)(cid:28)(cid:3,Unknown,16382.0
Unknown,Unknown,8,Unknown,Unknown,Unknown,Unknown,cid:50)(cid:46)(cid:12)(cid:2)(cid:7)(cid:8)(cid:10)(cid:5)(cid:3)(cid:48)(cid:46)(cid:3)(cid:12)(cid:13)(cid:5)(cid:2)(cid:14)(cid:46)(cid:2)(cid:28)(cid:5)(cid:3)(cid:10)(cid:5)(cid:2)(cid:64)(cid:46)(cid:4)(cid:12)(cid:2)(cid:28)(cid:3,Unknown,16390.0
Unknown,Unknown,2,Unknown,Unknown,Unknown,Unknown,cid:50)(cid:46)(cid:12)(cid:2)(cid:7)(cid:8)(cid:10)(cid:5)(cid:3)(cid:48)(cid:46)(cid:3)(cid:12)(cid:13)(cid:5)(cid:2)(cid:14)(cid:46)(cid:2)(cid:28)(cid:5)(cid:3)(cid:10)(cid:5)(cid:2)(cid:64)(cid:46)(cid:4)(cid:12)(cid:2)(cid:28)(cid:3,Unknown,16392.0
Unknown,Unknown,47,Unknown,Unknown,Unknown,Unknown,cid:50)(cid:46)(cid:12)(cid:2)(cid:7)(cid:8)(cid:10)(cid:5)(cid:3)(cid:48)(cid:46)(cid:3)(cid:12)(cid:13)(cid:5)(cid:2)(cid:14)(cid:46)(cid:2)(cid:28)(cid:5)(cid:3)(cid:10)(cid:5)(cid:2)(cid:64)(cid:46)(cid:4)(cid:12)(cid:2)(cid:28)(cid:3,Unknown,16439.0
Unknown,Unknown,3,Unknown,Unknown,Unknown,Unknown,cid:50)(cid:46)(cid:12)(cid:2)(cid:7)(cid:8)(cid:10)(cid:5)(cid:3)(cid:48)(cid:46)(cid:3)(cid:12)(cid:13)(cid:5)(cid:2)(cid:14)(cid:46)(cid:2)(cid:28)(cid:5)(cid:3)(cid:10)(cid:5)(cid:2)(cid:64)(cid:46)(cid:4)(cid:12)(cid:2)(cid:28)(cid:3,Unknown,16442.0
Unknown,Unknown,7,Unknown,Unknown,Unknown,Unknown,cid:50)(cid:46)(cid:12)(cid:2)(cid:7)(cid:8)(cid:10)(cid:5)(cid:3)(cid:48)(cid:46)(cid:3)(cid:12)(cid:13)(cid:5)(cid:2)(cid:14)(cid:46)(cid:2)(cid:28)(cid:5)(cid:3)(cid:10)(cid:5)(cid:2)(cid:64)(cid:46)(cid:4)(cid:12)(cid:2)(cid:28)(cid:3,Unknown,16449.0
Unknown,Unknown,2,Unknown,Unknown,Unknown,Unknown,cid:50)(cid:46)(cid:12)(cid:2)(cid:7)(cid:8)(cid:10)(cid:5)(cid:3)(cid:48)(cid:46)(cid:3)(cid:12)(cid:13)(cid:5)(cid:2)(cid:14)(cid:46)(cid:2)(cid:28)(cid:5)(cid:3)(cid:10)(cid:5)(cid:2)(cid:64)(cid:46)(cid:4)(cid:12)(cid:2)(cid:28)(cid:3,Unknown,16451.0
Unknown,Unknown,28,Unknown,Unknown,Unknown,Unknown,cid:50)(cid:46)(cid:12)(cid:2)(cid:7)(cid:8)(cid:10)(cid:5)(cid:3)(cid:48)(cid:46)(cid:3)(cid:12)(cid:13)(cid:5)(cid:2)(cid:14)(cid:46)(cid:2)(cid:28)(cid:5)(cid:3)(cid:10)(cid:5)(cid:2)(cid:64)(cid:46)(cid:4)(cid:12)(cid:2)(cid:28)(cid:3,Unknown,16479.0
Unknown,Unknown,3,Unknown,Unknown,Unknown,Unknown,cid:50)(cid:46)(cid:12)(cid:2)(cid:7)(cid:8)(cid:10)(cid:5)(cid:3)(cid:48)(cid:46)(cid:3)(cid:12)(cid:13)(cid:5)(cid:2)(cid:14)(cid:46)(cid:2)(cid:28)(cid:5)(cid:3)(cid:10)(cid:5)(cid:2)(cid:64)(cid:46)(cid:4)(cid:12)(cid:2)(cid:28)(cid:3,Unknown,16482.0
Unknown,Unknown,15,Unknown,Unknown,Unknown,Unknown,cid:50)(cid:46)(cid:12)(cid:2)(cid:7)(cid:8)(cid:10)(cid:5)(cid:3)(cid:48)(cid:46)(cid:3)(cid:12)(cid:13)(cid:5)(cid:2)(cid:14)(cid:46)(cid:2)(cid:28)(cid:5)(cid:3)(cid:10)(cid:5)(cid:2)(cid:64)(cid:46)(cid:4)(cid:12)(cid:2)(cid:28)(cid:3,Unknown,16497.0
Unknown,Unknown,2,Unknown,Unknown,Unknown,Unknown,cid:50)(cid:46)(cid:12)(cid:2)(cid:7)(cid:8)(cid:10)(cid:5)(cid:3)(cid:48)(cid:46)(cid:3)(cid:12)(cid:13)(cid:5)(cid:2)(cid:14)(cid:46)(cid:2)(cid:28)(cid:5)(cid:3)(cid:10)(cid:5)(cid:2)(cid:64)(cid:46)(cid:4)(cid:12)(cid:2)(cid:28)(cid:3,Unknown,16499.0
Unknown,Unknown,37,Unknown,Unknown,Unknown,Unknown,cid:50)(cid:46)(cid:12)(cid:2)(cid:7)(cid:8)(cid:10)(cid:5)(cid:3)(cid:48)(cid:46)(cid:3)(cid:12)(cid:13)(cid:5)(cid:2)(cid:14)(cid:46)(cid:2)(cid:28)(cid:5)(cid:3)(cid:10)(cid:5)(cid:2)(cid:64)(cid:46)(cid:4)(cid:12)(cid:2)(cid:28)(cid:3,Unknown,16536.0
Unknown,Unknown,18,Unknown,Unknown,Unknown,Unknown,cid:50)(cid:46)(cid:12)(cid:2)(cid:7)(cid:8)(cid:10)(cid:5)(cid:3)(cid:48)(cid:46)(cid:3)(cid:12)(cid:13)(cid:5)(cid:2)(cid:14)(cid:46)(cid:2)(cid:28)(cid:5)(cid:3)(cid:10)(cid:5)(cid:2)(cid:64)(cid:46)(cid:4)(cid:12)(cid:2)(cid:28)(cid:3,Unknown,16554.0
Unknown,Unknown,19,Unknown,Unknown,Unknown,Unknown,cid:50)(cid:46)(cid:12)(cid:2)(cid:7)(cid:8)(cid:10)(cid:5)(cid:3)(cid:48)(cid:46)(cid:3)(cid:12)(cid:13)(cid:5)(cid:2)(cid:14)(cid:46)(cid:2)(cid:28)(cid:5)(cid:3)(cid:10)(cid:5)(cid:2)(cid:64)(cid:46)(cid:4)(cid:12)(cid:2)(cid:28)(cid:3,Unknown,16573.0
Unknown,Unknown,18,Unknown,Unknown,Unknown,Unknown,cid:50)(cid:46)(cid:12)(cid:2)(cid:7)(cid:8)(cid:10)(cid:5)(cid:3)(cid:48)(cid:46)(cid:3)(cid:12)(cid:13)(cid:5)(cid:2)(cid:14)(cid:46)(cid:2)(cid:28)(cid:5)(cid:3)(cid:10)(cid:5)(cid:2)(cid:64)(cid:46)(cid:4)(cid:12)(cid:2)(cid:28)(cid:3,Unknown,16591.0
Unknown,Unknown,18,Unknown,Unknown,Unknown,Unknown,cid:50)(cid:46)(cid:12)(cid:2)(cid:7)(cid:8)(cid:10)(cid:5)(cid:3)(cid:48)(cid:46)(cid:3)(cid:12)(cid:13)(cid:5)(cid:2)(cid:14)(cid:46)(cid:2)(cid:28)(cid:5)(cid:3)(cid:10)(cid:5)(cid:2)(cid:64)(cid:46)(cid:4)(cid:12)(cid:2)(cid:28)(cid:3,Unknown,16609.0
Unknown,Unknown,2,Unknown,Unknown,Unknown,Unknown,cid:50)(cid:46)(cid:12)(cid:2)(cid:7)(cid:8)(cid:10)(cid:5)(cid:3)(cid:48)(cid:46)(cid:3)(cid:12)(cid:13)(cid:5)(cid:2)(cid:14)(cid:46)(cid:2)(cid:28)(cid:5)(cid:3)(cid:10)(cid:5)(cid:2)(cid:64)(cid:46)(cid:4)(cid:12)(cid:2)(cid:28)(cid:3,Unknown,16611.0
Unknown,Unknown,44,Unknown,Unknown,Unknown,Unknown,cid:50)(cid:46)(cid:12)(cid:2)(cid:7)(cid:8)(cid:10)(cid:5)(cid:3)(cid:48)(cid:46)(cid:3)(cid:12)(cid:13)(cid:5)(cid:2)(cid:14)(cid:46)(cid:2)(cid:28)(cid:5)(cid:3)(cid:10)(cid:5)(cid:2)(cid:64)(cid:46)(cid:4)(cid:12)(cid:2)(cid:28)(cid:3,Unknown,16655.0
Unknown,Unknown,12,Unknown,Unknown,Unknown,Unknown,cid:50)(cid:46)(cid:12)(cid:2)(cid:7)(cid:8)(cid:10)(cid:5)(cid:3)(cid:48)(cid:46)(cid:3)(cid:12)(cid:13)(cid:5)(cid:2)(cid:14)(cid:46)(cid:2)(cid:28)(cid:5)(cid:3)(cid:10)(cid:5)(cid:2)(cid:64)(cid:46)(cid:4)(cid:12)(cid:2)(cid:28)(cid:3,Unknown,16667.0
Unknown,Unknown,29,Unknown,Unknown,Unknown,Unknown,cid:50)(cid:46)(cid:12)(cid:2)(cid:7)(cid:8)(cid:10)(cid:5)(cid:3)(cid:48)(cid:46)(cid:3)(cid:12)(cid:13)(cid:5)(cid:2)(cid:14)(cid:46)(cid:2)(cid:28)(cid:5)(cid:3)(cid:10)(cid:5)(cid:2)(cid:64)(cid:46)(cid:4)(cid:12)(cid:2)(cid:28)(cid:3,Unknown,16696.0
Unknown,Unknown,26,Unknown,Unknown,Unknown,Unknown,cid:50)(cid:46)(cid:12)(cid:2)(cid:7)(cid:8)(cid:10)(cid:5)(cid:3)(cid:48)(cid:46)(cid:3)(cid:12)(cid:13)(cid:5)(cid:2)(cid:14)(cid:46)(cid:2)(cid:28)(cid:5)(cid:3)(cid:10)(cid:5)(cid:2)(cid:64)(cid:46)(cid:4)(cid:12)(cid:2)(cid:28)(cid:3,Unknown,16722.0
Unknown,Unknown,41,Unknown,Unknown,Unknown,Unknown,cid:50)(cid:46)(cid:12)(cid:2)(cid:7)(cid:8)(cid:10)(cid:5)(cid:3)(cid:48)(cid:46)(cid:3)(cid:12)(cid:13)(cid:5)(cid:2)(cid:14)(cid:46)(cid:2)(cid:28)(cid:5)(cid:3)(cid:10)(cid:5)(cid:2)(cid:64)(cid:46)(cid:4)(cid:12)(cid:2)(cid:28)(cid:3,Unknown,16763.0
Unknown,Unknown,25,Unknown,Unknown,Unknown,Unknown,cid:50)(cid:46)(cid:12)(cid:2)(cid:7)(cid:8)(cid:10)(cid:5)(cid:3)(cid:48)(cid:46)(cid:3)(cid:12)(cid:13)(cid:5)(cid:2)(cid:14)(cid:46)(cid:2)(cid:28)(cid:5)(cid:3)(cid:10)(cid:5)(cid:2)(cid:64)(cid:46)(cid:4)(cid:12)(cid:2)(cid:28)(cid:3,Unknown,16788.0
Unknown,Unknown,2,Unknown,Unknown,Unknown,Unknown,cid:50)(cid:46)(cid:12)(cid:2)(cid:7)(cid:8)(cid:10)(cid:5)(cid:3)(cid:48)(cid:46)(cid:3)(cid:12)(cid:13)(cid:5)(cid:2)(cid:14)(cid:46)(cid:2)(cid:28)(cid:5)(cid:3)(cid:10)(cid:5)(cid:2)(cid:64)(cid:46)(cid:4)(cid:12)(cid:2)(cid:28)(cid:3,Unknown,16790.0
Unknown,Unknown,58,Unknown,Unknown,Unknown,Unknown,cid:50)(cid:46)(cid:12)(cid:2)(cid:7)(cid:8)(cid:10)(cid:5)(cid:3)(cid:48)(cid:46)(cid:3)(cid:12)(cid:13)(cid:5)(cid:2)(cid:14)(cid:46)(cid:2)(cid:28)(cid:5)(cid:3)(cid:10)(cid:5)(cid:2)(cid:64)(cid:46)(cid:4)(cid:12)(cid:2)(cid:28)(cid:3,Unknown,16848.0
Unknown,Unknown,58,Unknown,Unknown,Unknown,Unknown,cid:50)(cid:46)(cid:12)(cid:2)(cid:7)(cid:8)(cid:10)(cid:5)(cid:3)(cid:48)(cid:46)(cid:3)(cid:12)(cid:13)(cid:5)(cid:2)(cid:14)(cid:46)(cid:2)(cid:28)(cid:5)(cid:3)(cid:10)(cid:5)(cid:2)(cid:64)(cid:46)(cid:4)(cid:12)(cid:2)(cid:28)(cid:3,Unknown,16906.0
Unknown,Unknown,18,Unknown,Unknown,Unknown,Unknown,cid:50)(cid:46)(cid:12)(cid:2)(cid:7)(cid:8)(cid:10)(cid:5)(cid:3)(cid:48)(cid:46)(cid:3)(cid:12)(cid:13)(cid:5)(cid:2)(cid:14)(cid:46)(cid:2)(cid:28)(cid:5)(cid:3)(cid:10)(cid:5)(cid:2)(cid:64)(cid:46)(cid:4)(cid:12)(cid:2)(cid:28)(cid:3,Unknown,16924.0
Unknown,Unknown,1,Unknown,Unknown,Unknown,Unknown,cid:50)(cid:46)(cid:12)(cid:2)(cid:7)(cid:8)(cid:10)(cid:5)(cid:3)(cid:48)(cid:46)(cid:3)(cid:12)(cid:13)(cid:5)(cid:2)(cid:14)(cid:46)(cid:2)(cid:28)(cid:5)(cid:3)(cid:10)(cid:5)(cid:2)(cid:64)(cid:46)(cid:4)(cid:12)(cid:2)(cid:28)(cid:3,Unknown,16925.0
Unknown,Unknown,1,Unknown,Unknown,Unknown,Unknown,cid:50)(cid:46)(cid:12)(cid:2)(cid:7)(cid:8)(cid:10)(cid:5)(cid:3)(cid:48)(cid:46)(cid:3)(cid:12)(cid:13)(cid:5)(cid:2)(cid:14)(cid:46)(cid:2)(cid:28)(cid:5)(cid:3)(cid:10)(cid:5)(cid:2)(cid:64)(cid:46)(cid:4)(cid:12)(cid:2)(cid:28)(cid:3,Unknown,16926.0
Unknown,Unknown,37,Unknown,Unknown,Unknown,Unknown,cid:50)(cid:46)(cid:12)(cid:2)(cid:7)(cid:8)(cid:10)(cid:5)(cid:3)(cid:48)(cid:46)(cid:3)(cid:12)(cid:13)(cid:5)(cid:2)(cid:14)(cid:46)(cid:2)(cid:28)(cid:5)(cid:3)(cid:10)(cid:5)(cid:2)(cid:64)(cid:46)(cid:4)(cid:12)(cid:2)(cid:28)(cid:3,Unknown,16963.0
Unknown,Unknown,18,Unknown,Unknown,Unknown,Unknown,cid:50)(cid:46)(cid:12)(cid:2)(cid:7)(cid:8)(cid:10)(cid:5)(cid:3)(cid:48)(cid:46)(cid:3)(cid:12)(cid:13)(cid:5)(cid:2)(cid:14)(cid:46)(cid:2)(cid:28)(cid:5)(cid:3)(cid:10)(cid:5)(cid:2)(cid:64)(cid:46)(cid:4)(cid:12)(cid:2)(cid:28)(cid:3,Unknown,16981.0
Unknown,Unknown,33,Unknown,Unknown,Unknown,Unknown,cid:50)(cid:46)(cid:12)(cid:2)(cid:7)(cid:8)(cid:10)(cid:5)(cid:3)(cid:48)(cid:46)(cid:3)(cid:12)(cid:13)(cid:5)(cid:2)(cid:14)(cid:46)(cid:2)(cid:28)(cid:5)(cid:3)(cid:10)(cid:5)(cid:2)(cid:64)(cid:46)(cid:4)(cid:12)(cid:2)(cid:28)(cid:3,Unknown,17014.0
Unknown,Unknown,45,Unknown,Unknown,Unknown,Unknown,cid:50)(cid:46)(cid:12)(cid:2)(cid:7)(cid:8)(cid:10)(cid:5)(cid:3)(cid:48)(cid:46)(cid:3)(cid:12)(cid:13)(cid:5)(cid:2)(cid:14)(cid:46)(cid:2)(cid:28)(cid:5)(cid:3)(cid:10)(cid:5)(cid:2)(cid:64)(cid:46)(cid:4)(cid:12)(cid:2)(cid:28)(cid:3,Unknown,17059.0
Unknown,Unknown,18,Unknown,Unknown,Unknown,Unknown,cid:50)(cid:46)(cid:12)(cid:2)(cid:7)(cid:8)(cid:10)(cid:5)(cid:3)(cid:48)(cid:46)(cid:3)(cid:12)(cid:13)(cid:5)(cid:2)(cid:14)(cid:46)(cid:2)(cid:28)(cid:5)(cid:3)(cid:10)(cid:5)(cid:2)(cid:64)(cid:46)(cid:4)(cid:12)(cid:2)(cid:28)(cid:3,Unknown,17077.0
Unknown,Unknown,16,Unknown,Unknown,Unknown,Unknown,cid:50)(cid:46)(cid:12)(cid:2)(cid:7)(cid:8)(cid:10)(cid:5)(cid:3)(cid:48)(cid:46)(cid:3)(cid:12)(cid:13)(cid:5)(cid:2)(cid:14)(cid:46)(cid:2)(cid:28)(cid:5)(cid:3)(cid:10)(cid:5)(cid:2)(cid:64)(cid:46)(cid:4)(cid:12)(cid:2)(cid:28)(cid:3,Unknown,17093.0
Unknown,Unknown,64,Unknown,Unknown,Unknown,Unknown,cid:50)(cid:46)(cid:12)(cid:2)(cid:7)(cid:8)(cid:10)(cid:5)(cid:3)(cid:48)(cid:46)(cid:3)(cid:12)(cid:13)(cid:5)(cid:2)(cid:14)(cid:46)(cid:2)(cid:28)(cid:5)(cid:3)(cid:10)(cid:5)(cid:2)(cid:64)(cid:46)(cid:4)(cid:12)(cid:2)(cid:28)(cid:3,Unknown,17157.0
Unknown,Unknown,3,Unknown,Unknown,Unknown,Unknown,cid:50)(cid:46)(cid:12)(cid:2)(cid:7)(cid:8)(cid:10)(cid:5)(cid:3)(cid:48)(cid:46)(cid:3)(cid:12)(cid:13)(cid:5)(cid:2)(cid:14)(cid:46)(cid:2)(cid:28)(cid:5)(cid:3)(cid:10)(cid:5)(cid:2)(cid:64)(cid:46)(cid:4)(cid:12)(cid:2)(cid:28)(cid:3,Unknown,17160.0
Unknown,Unknown,11,Unknown,Unknown,Unknown,Unknown,cid:50)(cid:46)(cid:12)(cid:2)(cid:7)(cid:8)(cid:10)(cid:5)(cid:3)(cid:48)(cid:46)(cid:3)(cid:12)(cid:13)(cid:5)(cid:2)(cid:14)(cid:46)(cid:2)(cid:28)(cid:5)(cid:3)(cid:10)(cid:5)(cid:2)(cid:64)(cid:46)(cid:4)(cid:12)(cid:2)(cid:28)(cid:3,Unknown,17171.0
Unknown,Unknown,4,Unknown,Unknown,Unknown,Unknown,cid:50)(cid:46)(cid:12)(cid:2)(cid:7)(cid:8)(cid:10)(cid:5)(cid:3)(cid:48)(cid:46)(cid:3)(cid:12)(cid:13)(cid:5)(cid:2)(cid:14)(cid:46)(cid:2)(cid:28)(cid:5)(cid:3)(cid:10)(cid:5)(cid:2)(cid:64)(cid:46)(cid:4)(cid:12)(cid:2)(cid:28)(cid:3,Unknown,17175.0
Unknown,Unknown,39,Unknown,Unknown,Unknown,Unknown,cid:50)(cid:46)(cid:12)(cid:2)(cid:7)(cid:8)(cid:10)(cid:5)(cid:3)(cid:48)(cid:46)(cid:3)(cid:12)(cid:13)(cid:5)(cid:2)(cid:14)(cid:46)(cid:2)(cid:28)(cid:5)(cid:3)(cid:10)(cid:5)(cid:2)(cid:64)(cid:46)(cid:4)(cid:12)(cid:2)(cid:28)(cid:3,Unknown,17214.0
Unknown,Unknown,46,Unknown,Unknown,Unknown,Unknown,cid:50)(cid:46)(cid:12)(cid:2)(cid:7)(cid:8)(cid:10)(cid:5)(cid:3)(cid:48)(cid:46)(cid:3)(cid:12)(cid:13)(cid:5)(cid:2)(cid:14)(cid:46)(cid:2)(cid:28)(cid:5)(cid:3)(cid:10)(cid:5)(cid:2)(cid:64)(cid:46)(cid:4)(cid:12)(cid:2)(cid:28)(cid:3,Unknown,17260.0
Unknown,Unknown,48,Unknown,Unknown,Unknown,Unknown,cid:50)(cid:46)(cid:12)(cid:2)(cid:7)(cid:8)(cid:10)(cid:5)(cid:3)(cid:48)(cid:46)(cid:3)(cid:12)(cid:13)(cid:5)(cid:2)(cid:14)(cid:46)(cid:2)(cid:28)(cid:5)(cid:3)(cid:10)(cid:5)(cid:2)(cid:64)(cid:46)(cid:4)(cid:12)(cid:2)(cid:28)(cid:3,Unknown,17308.0
Unknown,Unknown,46,Unknown,Unknown,Unknown,Unknown,cid:50)(cid:46)(cid:12)(cid:2)(cid:7)(cid:8)(cid:10)(cid:5)(cid:3)(cid:48)(cid:46)(cid:3)(cid:12)(cid:13)(cid:5)(cid:2)(cid:14)(cid:46)(cid:2)(cid:28)(cid:5)(cid:3)(cid:10)(cid:5)(cid:2)(cid:64)(cid:46)(cid:4)(cid:12)(cid:2)(cid:28)(cid:3,Unknown,17354.0
Unknown,Unknown,2,Unknown,Unknown,Unknown,Unknown,cid:50)(cid:46)(cid:12)(cid:2)(cid:7)(cid:8)(cid:10)(cid:5)(cid:3)(cid:48)(cid:46)(cid:3)(cid:12)(cid:13)(cid:5)(cid:2)(cid:14)(cid:46)(cid:2)(cid:28)(cid:5)(cid:3)(cid:10)(cid:5)(cid:2)(cid:64)(cid:46)(cid:4)(cid:12)(cid:2)(cid:28)(cid:3,Unknown,17356.0
Unknown,Unknown,36,Unknown,Unknown,Unknown,Unknown,cid:50)(cid:46)(cid:12)(cid:2)(cid:7)(cid:8)(cid:10)(cid:5)(cid:3)(cid:48)(cid:46)(cid:3)(cid:12)(cid:13)(cid:5)(cid:2)(cid:14)(cid:46)(cid:2)(cid:28)(cid:5)(cid:3)(cid:10)(cid:5)(cid:2)(cid:64)(cid:46)(cid:4)(cid:12)(cid:2)(cid:28)(cid:3,Unknown,17392.0
Unknown,Unknown,18,Unknown,Unknown,Unknown,Unknown,cid:50)(cid:46)(cid:12)(cid:2)(cid:7)(cid:8)(cid:10)(cid:5)(cid:3)(cid:48)(cid:46)(cid:3)(cid:12)(cid:13)(cid:5)(cid:2)(cid:14)(cid:46)(cid:2)(cid:28)(cid:5)(cid:3)(cid:10)(cid:5)(cid:2)(cid:64)(cid:46)(cid:4)(cid:12)(cid:2)(cid:28)(cid:3,Unknown,17410.0
Unknown,Unknown,17,Unknown,Unknown,Unknown,Unknown,cid:50)(cid:46)(cid:12)(cid:2)(cid:7)(cid:8)(cid:10)(cid:5)(cid:3)(cid:48)(cid:46)(cid:3)(cid:12)(cid:13)(cid:5)(cid:2)(cid:14)(cid:46)(cid:2)(cid:28)(cid:5)(cid:3)(cid:10)(cid:5)(cid:2)(cid:64)(cid:46)(cid:4)(cid:12)(cid:2)(cid:28)(cid:3,Unknown,17427.0
Unknown,Unknown,37,Unknown,Unknown,Unknown,Unknown,cid:50)(cid:46)(cid:12)(cid:2)(cid:7)(cid:8)(cid:10)(cid:5)(cid:3)(cid:48)(cid:46)(cid:3)(cid:12)(cid:13)(cid:5)(cid:2)(cid:14)(cid:46)(cid:2)(cid:28)(cid:5)(cid:3)(cid:10)(cid:5)(cid:2)(cid:64)(cid:46)(cid:4)(cid:12)(cid:2)(cid:28)(cid:3,Unknown,17464.0
Unknown,Unknown,16,Unknown,Unknown,Unknown,Unknown,cid:50)(cid:46)(cid:12)(cid:2)(cid:7)(cid:8)(cid:10)(cid:5)(cid:3)(cid:48)(cid:46)(cid:3)(cid:12)(cid:13)(cid:5)(cid:2)(cid:14)(cid:46)(cid:2)(cid:28)(cid:5)(cid:3)(cid:10)(cid:5)(cid:2)(cid:64)(cid:46)(cid:4)(cid:12)(cid:2)(cid:28)(cid:3,Unknown,17480.0
Unknown,Unknown,36,Unknown,Unknown,Unknown,Unknown,cid:50)(cid:46)(cid:12)(cid:2)(cid:7)(cid:8)(cid:10)(cid:5)(cid:3)(cid:48)(cid:46)(cid:3)(cid:12)(cid:13)(cid:5)(cid:2)(cid:14)(cid:46)(cid:2)(cid:28)(cid:5)(cid:3)(cid:10)(cid:5)(cid:2)(cid:64)(cid:46)(cid:4)(cid:12)(cid:2)(cid:28)(cid:3,Unknown,17516.0
Unknown,Unknown,15,Unknown,Unknown,Unknown,Unknown,cid:50)(cid:46)(cid:12)(cid:2)(cid:7)(cid:8)(cid:10)(cid:5)(cid:3)(cid:48)(cid:46)(cid:3)(cid:12)(cid:13)(cid:5)(cid:2)(cid:14)(cid:46)(cid:2)(cid:28)(cid:5)(cid:3)(cid:10)(cid:5)(cid:2)(cid:64)(cid:46)(cid:4)(cid:12)(cid:2)(cid:28)(cid:3,Unknown,17531.0
Unknown,Unknown,2,Unknown,Unknown,Unknown,Unknown,cid:50)(cid:46)(cid:12)(cid:2)(cid:7)(cid:8)(cid:10)(cid:5)(cid:3)(cid:48)(cid:46)(cid:3)(cid:12)(cid:13)(cid:5)(cid:2)(cid:14)(cid:46)(cid:2)(cid:28)(cid:5)(cid:3)(cid:10)(cid:5)(cid:2)(cid:64)(cid:46)(cid:4)(cid:12)(cid:2)(cid:28)(cid:3,Unknown,17533.0
Unknown,Unknown,1,Unknown,Unknown,Unknown,Unknown,cid:50)(cid:46)(cid:12)(cid:2)(cid:7)(cid:8)(cid:10)(cid:5)(cid:3)(cid:48)(cid:46)(cid:3)(cid:12)(cid:13)(cid:5)(cid:2)(cid:14)(cid:46)(cid:2)(cid:28)(cid:5)(cid:3)(cid:10)(cid:5)(cid:2)(cid:64)(cid:46)(cid:4)(cid:12)(cid:2)(cid:28)(cid:3,Unknown,17534.0
Unknown,Unknown,33,Unknown,Unknown,Unknown,Unknown,cid:50)(cid:46)(cid:12)(cid:2)(cid:7)(cid:8)(cid:10)(cid:5)(cid:3)(cid:48)(cid:46)(cid:3)(cid:12)(cid:13)(cid:5)(cid:2)(cid:14)(cid:46)(cid:2)(cid:28)(cid:5)(cid:3)(cid:10)(cid:5)(cid:2)(cid:64)(cid:46)(cid:4)(cid:12)(cid:2)(cid:28)(cid:3,Unknown,17567.0
Unknown,Unknown,19,Unknown,Unknown,Unknown,Unknown,cid:50)(cid:46)(cid:12)(cid:2)(cid:7)(cid:8)(cid:10)(cid:5)(cid:3)(cid:48)(cid:46)(cid:3)(cid:12)(cid:13)(cid:5)(cid:2)(cid:14)(cid:46)(cid:2)(cid:28)(cid:5)(cid:3)(cid:10)(cid:5)(cid:2)(cid:64)(cid:46)(cid:4)(cid:12)(cid:2)(cid:28)(cid:3,Unknown,17586.0
Unknown,Unknown,33,Unknown,Unknown,Unknown,Unknown,cid:50)(cid:46)(cid:12)(cid:2)(cid:7)(cid:8)(cid:10)(cid:5)(cid:3)(cid:48)(cid:46)(cid:3)(cid:12)(cid:13)(cid:5)(cid:2)(cid:14)(cid:46)(cid:2)(cid:28)(cid:5)(cid:3)(cid:10)(cid:5)(cid:2)(cid:64)(cid:46)(cid:4)(cid:12)(cid:2)(cid:28)(cid:3,Unknown,17619.0
Unknown,Unknown,33,Unknown,Unknown,Unknown,Unknown,cid:50)(cid:46)(cid:12)(cid:2)(cid:7)(cid:8)(cid:10)(cid:5)(cid:3)(cid:48)(cid:46)(cid:3)(cid:12)(cid:13)(cid:5)(cid:2)(cid:14)(cid:46)(cid:2)(cid:28)(cid:5)(cid:3)(cid:10)(cid:5)(cid:2)(cid:64)(cid:46)(cid:4)(cid:12)(cid:2)(cid:28)(cid:3,Unknown,17652.0
Unknown,Unknown,2,Unknown,Unknown,Unknown,Unknown,cid:50)(cid:46)(cid:12)(cid:2)(cid:7)(cid:8)(cid:10)(cid:5)(cid:3)(cid:48)(cid:46)(cid:3)(cid:12)(cid:13)(cid:5)(cid:2)(cid:14)(cid:46)(cid:2)(cid:28)(cid:5)(cid:3)(cid:10)(cid:5)(cid:2)(cid:64)(cid:46)(cid:4)(cid:12)(cid:2)(cid:28)(cid:3,Unknown,17654.0
Unknown,Unknown,44,Unknown,Unknown,Unknown,Unknown,cid:50)(cid:46)(cid:12)(cid:2)(cid:7)(cid:8)(cid:10)(cid:5)(cid:3)(cid:48)(cid:46)(cid:3)(cid:12)(cid:13)(cid:5)(cid:2)(cid:14)(cid:46)(cid:2)(cid:28)(cid:5)(cid:3)(cid:10)(cid:5)(cid:2)(cid:64)(cid:46)(cid:4)(cid:12)(cid:2)(cid:28)(cid:3,Unknown,17698.0
Unknown,Unknown,39,Unknown,Unknown,Unknown,Unknown,cid:50)(cid:46)(cid:12)(cid:2)(cid:7)(cid:8)(cid:10)(cid:5)(cid:3)(cid:48)(cid:46)(cid:3)(cid:12)(cid:13)(cid:5)(cid:2)(cid:14)(cid:46)(cid:2)(cid:28)(cid:5)(cid:3)(cid:10)(cid:5)(cid:2)(cid:64)(cid:46)(cid:4)(cid:12)(cid:2)(cid:28)(cid:3,Unknown,17737.0
Unknown,Unknown,18,Unknown,Unknown,Unknown,Unknown,cid:50)(cid:46)(cid:12)(cid:2)(cid:7)(cid:8)(cid:10)(cid:5)(cid:3)(cid:48)(cid:46)(cid:3)(cid:12)(cid:13)(cid:5)(cid:2)(cid:14)(cid:46)(cid:2)(cid:28)(cid:5)(cid:3)(cid:10)(cid:5)(cid:2)(cid:64)(cid:46)(cid:4)(cid:12)(cid:2)(cid:28)(cid:3,Unknown,17755.0
Unknown,Unknown,16,Unknown,Unknown,Unknown,Unknown,cid:50)(cid:46)(cid:12)(cid:2)(cid:7)(cid:8)(cid:10)(cid:5)(cid:3)(cid:48)(cid:46)(cid:3)(cid:12)(cid:13)(cid:5)(cid:2)(cid:14)(cid:46)(cid:2)(cid:28)(cid:5)(cid:3)(cid:10)(cid:5)(cid:2)(cid:64)(cid:46)(cid:4)(cid:12)(cid:2)(cid:28)(cid:3,Unknown,17771.0
Unknown,Unknown,1,Unknown,Unknown,Unknown,Unknown,cid:50)(cid:46)(cid:12)(cid:2)(cid:7)(cid:8)(cid:10)(cid:5)(cid:3)(cid:48)(cid:46)(cid:3)(cid:12)(cid:13)(cid:5)(cid:2)(cid:14)(cid:46)(cid:2)(cid:28)(cid:5)(cid:3)(cid:10)(cid:5)(cid:2)(cid:64)(cid:46)(cid:4)(cid:12)(cid:2)(cid:28)(cid:3,Unknown,17772.0
Unknown,Unknown,32,Unknown,Unknown,Unknown,Unknown,cid:50)(cid:46)(cid:12)(cid:2)(cid:7)(cid:8)(cid:10)(cid:5)(cid:3)(cid:48)(cid:46)(cid:3)(cid:12)(cid:13)(cid:5)(cid:2)(cid:14)(cid:46)(cid:2)(cid:28)(cid:5)(cid:3)(cid:10)(cid:5)(cid:2)(cid:64)(cid:46)(cid:4)(cid:12)(cid:2)(cid:28)(cid:3,Unknown,17804.0
Unknown,Unknown,32,Unknown,Unknown,Unknown,Unknown,cid:50)(cid:46)(cid:12)(cid:2)(cid:7)(cid:8)(cid:10)(cid:5)(cid:3)(cid:48)(cid:46)(cid:3)(cid:12)(cid:13)(cid:5)(cid:2)(cid:14)(cid:46)(cid:2)(cid:28)(cid:5)(cid:3)(cid:10)(cid:5)(cid:2)(cid:64)(cid:46)(cid:4)(cid:12)(cid:2)(cid:28)(cid:3,Unknown,17836.0
Unknown,Unknown,1,Unknown,Unknown,Unknown,Unknown,cid:50)(cid:46)(cid:12)(cid:2)(cid:7)(cid:8)(cid:10)(cid:5)(cid:3)(cid:48)(cid:46)(cid:3)(cid:12)(cid:13)(cid:5)(cid:2)(cid:14)(cid:46)(cid:2)(cid:28)(cid:5)(cid:3)(cid:10)(cid:5)(cid:2)(cid:64)(cid:46)(cid:4)(cid:12)(cid:2)(cid:28)(cid:3,Unknown,17837.0
Unknown,Unknown,33,Unknown,Unknown,Unknown,Unknown,cid:50)(cid:46)(cid:12)(cid:2)(cid:7)(cid:8)(cid:10)(cid:5)(cid:3)(cid:48)(cid:46)(cid:3)(cid:12)(cid:13)(cid:5)(cid:2)(cid:14)(cid:46)(cid:2)(cid:28)(cid:5)(cid:3)(cid:10)(cid:5)(cid:2)(cid:64)(cid:46)(cid:4)(cid:12)(cid:2)(cid:28)(cid:3,Unknown,17870.0
Unknown,Unknown,32,Unknown,Unknown,Unknown,Unknown,cid:50)(cid:46)(cid:12)(cid:2)(cid:7)(cid:8)(cid:10)(cid:5)(cid:3)(cid:48)(cid:46)(cid:3)(cid:12)(cid:13)(cid:5)(cid:2)(cid:14)(cid:46)(cid:2)(cid:28)(cid:5)(cid:3)(cid:10)(cid:5)(cid:2)(cid:64)(cid:46)(cid:4)(cid:12)(cid:2)(cid:28)(cid:3,Unknown,17902.0
Unknown,Unknown,18,Unknown,Unknown,Unknown,Unknown,cid:50)(cid:46)(cid:12)(cid:2)(cid:7)(cid:8)(cid:10)(cid:5)(cid:3)(cid:48)(cid:46)(cid:3)(cid:12)(cid:13)(cid:5)(cid:2)(cid:14)(cid:46)(cid:2)(cid:28)(cid:5)(cid:3)(cid:10)(cid:5)(cid:2)(cid:64)(cid:46)(cid:4)(cid:12)(cid:2)(cid:28)(cid:3,Unknown,17920.0
Unknown,Unknown,2,Unknown,Unknown,Unknown,Unknown,cid:50)(cid:46)(cid:12)(cid:2)(cid:7)(cid:8)(cid:10)(cid:5)(cid:3)(cid:48)(cid:46)(cid:3)(cid:12)(cid:13)(cid:5)(cid:2)(cid:14)(cid:46)(cid:2)(cid:28)(cid:5)(cid:3)(cid:10)(cid:5)(cid:2)(cid:64)(cid:46)(cid:4)(cid:12)(cid:2)(cid:28)(cid:3,Unknown,17922.0
Unknown,Unknown,17,Unknown,Unknown,Unknown,Unknown,cid:50)(cid:46)(cid:12)(cid:2)(cid:7)(cid:8)(cid:10)(cid:5)(cid:3)(cid:48)(cid:46)(cid:3)(cid:12)(cid:13)(cid:5)(cid:2)(cid:14)(cid:46)(cid:2)(cid:28)(cid:5)(cid:3)(cid:10)(cid:5)(cid:2)(cid:64)(cid:46)(cid:4)(cid:12)(cid:2)(cid:28)(cid:3,Unknown,17939.0
Unknown,Unknown,35,Unknown,Unknown,Unknown,Unknown,cid:50)(cid:46)(cid:12)(cid:2)(cid:7)(cid:8)(cid:10)(cid:5)(cid:3)(cid:48)(cid:46)(cid:3)(cid:12)(cid:13)(cid:5)(cid:2)(cid:14)(cid:46)(cid:2)(cid:28)(cid:5)(cid:3)(cid:10)(cid:5)(cid:2)(cid:64)(cid:46)(cid:4)(cid:12)(cid:2)(cid:28)(cid:3,Unknown,17974.0
Unknown,Unknown,37,Unknown,Unknown,Unknown,Unknown,cid:50)(cid:46)(cid:12)(cid:2)(cid:7)(cid:8)(cid:10)(cid:5)(cid:3)(cid:48)(cid:46)(cid:3)(cid:12)(cid:13)(cid:5)(cid:2)(cid:14)(cid:46)(cid:2)(cid:28)(cid:5)(cid:3)(cid:10)(cid:5)(cid:2)(cid:64)(cid:46)(cid:4)(cid:12)(cid:2)(cid:28)(cid:3,Unknown,18011.0
Unknown,Unknown,36,Unknown,Unknown,Unknown,Unknown,cid:50)(cid:46)(cid:12)(cid:2)(cid:7)(cid:8)(cid:10)(cid:5)(cid:3)(cid:48)(cid:46)(cid:3)(cid:12)(cid:13)(cid:5)(cid:2)(cid:14)(cid:46)(cid:2)(cid:28)(cid:5)(cid:3)(cid:10)(cid:5)(cid:2)(cid:64)(cid:46)(cid:4)(cid:12)(cid:2)(cid:28)(cid:3,Unknown,18047.0
Unknown,Unknown,16,Unknown,Unknown,Unknown,Unknown,cid:50)(cid:46)(cid:12)(cid:2)(cid:7)(cid:8)(cid:10)(cid:5)(cid:3)(cid:48)(cid:46)(cid:3)(cid:12)(cid:13)(cid:5)(cid:2)(cid:14)(cid:46)(cid:2)(cid:28)(cid:5)(cid:3)(cid:10)(cid:5)(cid:2)(cid:64)(cid:46)(cid:4)(cid:12)(cid:2)(cid:28)(cid:3,Unknown,18063.0
Unknown,Unknown,36,Unknown,Unknown,Unknown,Unknown,cid:50)(cid:46)(cid:12)(cid:2)(cid:7)(cid:8)(cid:10)(cid:5)(cid:3)(cid:48)(cid:46)(cid:3)(cid:12)(cid:13)(cid:5)(cid:2)(cid:14)(cid:46)(cid:2)(cid:28)(cid:5)(cid:3)(cid:10)(cid:5)(cid:2)(cid:64)(cid:46)(cid:4)(cid:12)(cid:2)(cid:28)(cid:3,Unknown,18099.0
Unknown,Unknown,32,Unknown,Unknown,Unknown,Unknown,cid:50)(cid:46)(cid:12)(cid:2)(cid:7)(cid:8)(cid:10)(cid:5)(cid:3)(cid:48)(cid:46)(cid:3)(cid:12)(cid:13)(cid:5)(cid:2)(cid:14)(cid:46)(cid:2)(cid:28)(cid:5)(cid:3)(cid:10)(cid:5)(cid:2)(cid:64)(cid:46)(cid:4)(cid:12)(cid:2)(cid:28)(cid:3,Unknown,18131.0
Unknown,Unknown,18,Unknown,Unknown,Unknown,Unknown,cid:50)(cid:46)(cid:12)(cid:2)(cid:7)(cid:8)(cid:10)(cid:5)(cid:3)(cid:48)(cid:46)(cid:3)(cid:12)(cid:13)(cid:5)(cid:2)(cid:14)(cid:46)(cid:2)(cid:28)(cid:5)(cid:3)(cid:10)(cid:5)(cid:2)(cid:64)(cid:46)(cid:4)(cid:12)(cid:2)(cid:28)(cid:3,Unknown,18149.0
Unknown,Unknown,18,Unknown,Unknown,Unknown,Unknown,cid:50)(cid:46)(cid:12)(cid:2)(cid:7)(cid:8)(cid:10)(cid:5)(cid:3)(cid:48)(cid:46)(cid:3)(cid:12)(cid:13)(cid:5)(cid:2)(cid:14)(cid:46)(cid:2)(cid:28)(cid:5)(cid:3)(cid:10)(cid:5)(cid:2)(cid:64)(cid:46)(cid:4)(cid:12)(cid:2)(cid:28)(cid:3,Unknown,18167.0
Unknown,Unknown,18,Unknown,Unknown,Unknown,Unknown,cid:50)(cid:46)(cid:12)(cid:2)(cid:7)(cid:8)(cid:10)(cid:5)(cid:3)(cid:48)(cid:46)(cid:3)(cid:12)(cid:13)(cid:5)(cid:2)(cid:14)(cid:46)(cid:2)(cid:28)(cid:5)(cid:3)(cid:10)(cid:5)(cid:2)(cid:64)(cid:46)(cid:4)(cid:12)(cid:2)(cid:28)(cid:3,Unknown,18185.0
Unknown,Unknown,18,Unknown,Unknown,Unknown,Unknown,cid:50)(cid:46)(cid:12)(cid:2)(cid:7)(cid:8)(cid:10)(cid:5)(cid:3)(cid:48)(cid:46)(cid:3)(cid:12)(cid:13)(cid:5)(cid:2)(cid:14)(cid:46)(cid:2)(cid:28)(cid:5)(cid:3)(cid:10)(cid:5)(cid:2)(cid:64)(cid:46)(cid:4)(cid:12)(cid:2)(cid:28)(cid:3,Unknown,18203.0
Unknown,Unknown,18,Unknown,Unknown,Unknown,Unknown,cid:50)(cid:46)(cid:12)(cid:2)(cid:7)(cid:8)(cid:10)(cid:5)(cid:3)(cid:48)(cid:46)(cid:3)(cid:12)(cid:13)(cid:5)(cid:2)(cid:14)(cid:46)(cid:2)(cid:28)(cid:5)(cid:3)(cid:10)(cid:5)(cid:2)(cid:64)(cid:46)(cid:4)(cid:12)(cid:2)(cid:28)(cid:3,Unknown,18221.0
Unknown,Unknown,18,Unknown,Unknown,Unknown,Unknown,cid:50)(cid:46)(cid:12)(cid:2)(cid:7)(cid:8)(cid:10)(cid:5)(cid:3)(cid:48)(cid:46)(cid:3)(cid:12)(cid:13)(cid:5)(cid:2)(cid:14)(cid:46)(cid:2)(cid:28)(cid:5)(cid:3)(cid:10)(cid:5)(cid:2)(cid:64)(cid:46)(cid:4)(cid:12)(cid:2)(cid:28)(cid:3,Unknown,18239.0
Unknown,Unknown,37,Unknown,Unknown,Unknown,Unknown,cid:50)(cid:46)(cid:12)(cid:2)(cid:7)(cid:8)(cid:10)(cid:5)(cid:3)(cid:48)(cid:46)(cid:3)(cid:12)(cid:13)(cid:5)(cid:2)(cid:14)(cid:46)(cid:2)(cid:28)(cid:5)(cid:3)(cid:10)(cid:5)(cid:2)(cid:64)(cid:46)(cid:4)(cid:12)(cid:2)(cid:28)(cid:3,Unknown,18276.0
Unknown,Unknown,18,Unknown,Unknown,Unknown,Unknown,cid:50)(cid:46)(cid:12)(cid:2)(cid:7)(cid:8)(cid:10)(cid:5)(cid:3)(cid:48)(cid:46)(cid:3)(cid:12)(cid:13)(cid:5)(cid:2)(cid:14)(cid:46)(cid:2)(cid:28)(cid:5)(cid:3)(cid:10)(cid:5)(cid:2)(cid:64)(cid:46)(cid:4)(cid:12)(cid:2)(cid:28)(cid:3,Unknown,18294.0
Unknown,Unknown,33,Unknown,Unknown,Unknown,Unknown,cid:50)(cid:46)(cid:12)(cid:2)(cid:7)(cid:8)(cid:10)(cid:5)(cid:3)(cid:48)(cid:46)(cid:3)(cid:12)(cid:13)(cid:5)(cid:2)(cid:14)(cid:46)(cid:2)(cid:28)(cid:5)(cid:3)(cid:10)(cid:5)(cid:2)(cid:64)(cid:46)(cid:4)(cid:12)(cid:2)(cid:28)(cid:3,Unknown,18327.0
Unknown,Unknown,45,Unknown,Unknown,Unknown,Unknown,cid:50)(cid:46)(cid:12)(cid:2)(cid:7)(cid:8)(cid:10)(cid:5)(cid:3)(cid:48)(cid:46)(cid:3)(cid:12)(cid:13)(cid:5)(cid:2)(cid:14)(cid:46)(cid:2)(cid:28)(cid:5)(cid:3)(cid:10)(cid:5)(cid:2)(cid:64)(cid:46)(cid:4)(cid:12)(cid:2)(cid:28)(cid:3,Unknown,18372.0
Unknown,Unknown,18,Unknown,Unknown,Unknown,Unknown,cid:50)(cid:46)(cid:12)(cid:2)(cid:7)(cid:8)(cid:10)(cid:5)(cid:3)(cid:48)(cid:46)(cid:3)(cid:12)(cid:13)(cid:5)(cid:2)(cid:14)(cid:46)(cid:2)(cid:28)(cid:5)(cid:3)(cid:10)(cid:5)(cid:2)(cid:64)(cid:46)(cid:4)(cid:12)(cid:2)(cid:28)(cid:3,Unknown,18390.0
Unknown,Unknown,16,Unknown,Unknown,Unknown,Unknown,cid:50)(cid:46)(cid:12)(cid:2)(cid:7)(cid:8)(cid:10)(cid:5)(cid:3)(cid:48)(cid:46)(cid:3)(cid:12)(cid:13)(cid:5)(cid:2)(cid:14)(cid:46)(cid:2)(cid:28)(cid:5)(cid:3)(cid:10)(cid:5)(cid:2)(cid:64)(cid:46)(cid:4)(cid:12)(cid:2)(cid:28)(cid:3,Unknown,18406.0
Unknown,Unknown,14,Unknown,Unknown,Unknown,Unknown,cid:50)(cid:46)(cid:12)(cid:2)(cid:7)(cid:8)(cid:10)(cid:5)(cid:3)(cid:48)(cid:46)(cid:3)(cid:12)(cid:13)(cid:5)(cid:2)(cid:14)(cid:46)(cid:2)(cid:28)(cid:5)(cid:3)(cid:10)(cid:5)(cid:2)(cid:64)(cid:46)(cid:4)(cid:12)(cid:2)(cid:28)(cid:3,Unknown,18420.0
Unknown,Unknown,5,Unknown,Unknown,Unknown,Unknown,cid:50)(cid:46)(cid:12)(cid:2)(cid:7)(cid:8)(cid:10)(cid:5)(cid:3)(cid:48)(cid:46)(cid:3)(cid:12)(cid:13)(cid:5)(cid:2)(cid:14)(cid:46)(cid:2)(cid:28)(cid:5)(cid:3)(cid:10)(cid:5)(cid:2)(cid:64)(cid:46)(cid:4)(cid:12)(cid:2)(cid:28)(cid:3,Unknown,18425.0
Unknown,Unknown,12,Unknown,Unknown,Unknown,Unknown,cid:50)(cid:46)(cid:12)(cid:2)(cid:7)(cid:8)(cid:10)(cid:5)(cid:3)(cid:48)(cid:46)(cid:3)(cid:12)(cid:13)(cid:5)(cid:2)(cid:14)(cid:46)(cid:2)(cid:28)(cid:5)(cid:3)(cid:10)(cid:5)(cid:2)(cid:64)(cid:46)(cid:4)(cid:12)(cid:2)(cid:28)(cid:3,Unknown,18437.0
Unknown,Unknown,14,Unknown,Unknown,Unknown,Unknown,cid:50)(cid:46)(cid:12)(cid:2)(cid:7)(cid:8)(cid:10)(cid:5)(cid:3)(cid:48)(cid:46)(cid:3)(cid:12)(cid:13)(cid:5)(cid:2)(cid:14)(cid:46)(cid:2)(cid:28)(cid:5)(cid:3)(cid:10)(cid:5)(cid:2)(cid:64)(cid:46)(cid:4)(cid:12)(cid:2)(cid:28)(cid:3,Unknown,18451.0
Unknown,Unknown,5,Unknown,Unknown,Unknown,Unknown,cid:50)(cid:46)(cid:12)(cid:2)(cid:7)(cid:8)(cid:10)(cid:5)(cid:3)(cid:48)(cid:46)(cid:3)(cid:12)(cid:13)(cid:5)(cid:2)(cid:14)(cid:46)(cid:2)(cid:28)(cid:5)(cid:3)(cid:10)(cid:5)(cid:2)(cid:64)(cid:46)(cid:4)(cid:12)(cid:2)(cid:28)(cid:3,Unknown,18456.0
Unknown,Unknown,3,Unknown,Unknown,Unknown,Unknown,cid:50)(cid:46)(cid:12)(cid:2)(cid:7)(cid:8)(cid:10)(cid:5)(cid:3)(cid:48)(cid:46)(cid:3)(cid:12)(cid:13)(cid:5)(cid:2)(cid:14)(cid:46)(cid:2)(cid:28)(cid:5)(cid:3)(cid:10)(cid:5)(cid:2)(cid:64)(cid:46)(cid:4)(cid:12)(cid:2)(cid:28)(cid:3,Unknown,18459.0
Unknown,Unknown,12,Unknown,Unknown,Unknown,Unknown,cid:50)(cid:46)(cid:12)(cid:2)(cid:7)(cid:8)(cid:10)(cid:5)(cid:3)(cid:48)(cid:46)(cid:3)(cid:12)(cid:13)(cid:5)(cid:2)(cid:14)(cid:46)(cid:2)(cid:28)(cid:5)(cid:3)(cid:10)(cid:5)(cid:2)(cid:64)(cid:46)(cid:4)(cid:12)(cid:2)(cid:28)(cid:3,Unknown,18471.0
Unknown,Unknown,2,Unknown,Unknown,Unknown,Unknown,cid:50)(cid:46)(cid:12)(cid:2)(cid:7)(cid:8)(cid:10)(cid:5)(cid:3)(cid:48)(cid:46)(cid:3)(cid:12)(cid:13)(cid:5)(cid:2)(cid:14)(cid:46)(cid:2)(cid:28)(cid:5)(cid:3)(cid:10)(cid:5)(cid:2)(cid:64)(cid:46)(cid:4)(cid:12)(cid:2)(cid:28)(cid:3,Unknown,18473.0
Unknown,Unknown,12,Unknown,Unknown,Unknown,Unknown,cid:50)(cid:46)(cid:12)(cid:2)(cid:7)(cid:8)(cid:10)(cid:5)(cid:3)(cid:48)(cid:46)(cid:3)(cid:12)(cid:13)(cid:5)(cid:2)(cid:14)(cid:46)(cid:2)(cid:28)(cid:5)(cid:3)(cid:10)(cid:5)(cid:2)(cid:64)(cid:46)(cid:4)(cid:12)(cid:2)(cid:28)(cid:3,Unknown,18485.0
Unknown,Unknown,11,Unknown,Unknown,Unknown,Unknown,cid:50)(cid:46)(cid:12)(cid:2)(cid:7)(cid:8)(cid:10)(cid:5)(cid:3)(cid:48)(cid:46)(cid:3)(cid:12)(cid:13)(cid:5)(cid:2)(cid:14)(cid:46)(cid:2)(cid:28)(cid:5)(cid:3)(cid:10)(cid:5)(cid:2)(cid:64)(cid:46)(cid:4)(cid:12)(cid:2)(cid:28)(cid:3,Unknown,18496.0
Unknown,Unknown,4,Unknown,Unknown,Unknown,Unknown,cid:50)(cid:46)(cid:12)(cid:2)(cid:7)(cid:8)(cid:10)(cid:5)(cid:3)(cid:48)(cid:46)(cid:3)(cid:12)(cid:13)(cid:5)(cid:2)(cid:14)(cid:46)(cid:2)(cid:28)(cid:5)(cid:3)(cid:10)(cid:5)(cid:2)(cid:64)(cid:46)(cid:4)(cid:12)(cid:2)(cid:28)(cid:3,Unknown,18500.0
Unknown,Unknown,14,Unknown,Unknown,Unknown,Unknown,cid:50)(cid:46)(cid:12)(cid:2)(cid:7)(cid:8)(cid:10)(cid:5)(cid:3)(cid:48)(cid:46)(cid:3)(cid:12)(cid:13)(cid:5)(cid:2)(cid:14)(cid:46)(cid:2)(cid:28)(cid:5)(cid:3)(cid:10)(cid:5)(cid:2)(cid:64)(cid:46)(cid:4)(cid:12)(cid:2)(cid:28)(cid:3,Unknown,18514.0
Unknown,Unknown,11,Unknown,Unknown,Unknown,Unknown,cid:50)(cid:46)(cid:12)(cid:2)(cid:7)(cid:8)(cid:10)(cid:5)(cid:3)(cid:48)(cid:46)(cid:3)(cid:12)(cid:13)(cid:5)(cid:2)(cid:14)(cid:46)(cid:2)(cid:28)(cid:5)(cid:3)(cid:10)(cid:5)(cid:2)(cid:64)(cid:46)(cid:4)(cid:12)(cid:2)(cid:28)(cid:3,Unknown,18525.0
Unknown,Unknown,48,Unknown,Unknown,Unknown,Unknown,cid:50)(cid:46)(cid:12)(cid:2)(cid:7)(cid:8)(cid:10)(cid:5)(cid:3)(cid:48)(cid:46)(cid:3)(cid:12)(cid:13)(cid:5)(cid:2)(cid:14)(cid:46)(cid:2)(cid:28)(cid:5)(cid:3)(cid:10)(cid:5)(cid:2)(cid:64)(cid:46)(cid:4)(cid:12)(cid:2)(cid:28)(cid:3,Unknown,18573.0
Unknown,Unknown,48,Unknown,Unknown,Unknown,Unknown,cid:50)(cid:46)(cid:12)(cid:2)(cid:7)(cid:8)(cid:10)(cid:5)(cid:3)(cid:48)(cid:46)(cid:3)(cid:12)(cid:13)(cid:5)(cid:2)(cid:14)(cid:46)(cid:2)(cid:28)(cid:5)(cid:3)(cid:10)(cid:5)(cid:2)(cid:64)(cid:46)(cid:4)(cid:12)(cid:2)(cid:28)(cid:3,Unknown,18621.0
Unknown,Unknown,7,Unknown,Unknown,Unknown,Unknown,cid:50)(cid:46)(cid:12)(cid:2)(cid:7)(cid:8)(cid:10)(cid:5)(cid:3)(cid:48)(cid:46)(cid:3)(cid:12)(cid:13)(cid:5)(cid:2)(cid:14)(cid:46)(cid:2)(cid:28)(cid:5)(cid:3)(cid:10)(cid:5)(cid:2)(cid:64)(cid:46)(cid:4)(cid:12)(cid:2)(cid:28)(cid:3,Unknown,18628.0
Unknown,Unknown,5,Unknown,Unknown,Unknown,Unknown,cid:50)(cid:46)(cid:12)(cid:2)(cid:7)(cid:8)(cid:10)(cid:5)(cid:3)(cid:48)(cid:46)(cid:3)(cid:12)(cid:13)(cid:5)(cid:2)(cid:14)(cid:46)(cid:2)(cid:28)(cid:5)(cid:3)(cid:10)(cid:5)(cid:2)(cid:64)(cid:46)(cid:4)(cid:12)(cid:2)(cid:28)(cid:3,Unknown,18633.0
Unknown,Unknown,3,Unknown,Unknown,Unknown,Unknown,cid:50)(cid:46)(cid:12)(cid:2)(cid:7)(cid:8)(cid:10)(cid:5)(cid:3)(cid:48)(cid:46)(cid:3)(cid:12)(cid:13)(cid:5)(cid:2)(cid:14)(cid:46)(cid:2)(cid:28)(cid:5)(cid:3)(cid:10)(cid:5)(cid:2)(cid:64)(cid:46)(cid:4)(cid:12)(cid:2)(cid:28)(cid:3,Unknown,18636.0
Unknown,Unknown,2,Unknown,Unknown,Unknown,Unknown,cid:50)(cid:46)(cid:12)(cid:2)(cid:7)(cid:8)(cid:10)(cid:5)(cid:3)(cid:48)(cid:46)(cid:3)(cid:12)(cid:13)(cid:5)(cid:2)(cid:14)(cid:46)(cid:2)(cid:28)(cid:5)(cid:3)(cid:10)(cid:5)(cid:2)(cid:64)(cid:46)(cid:4)(cid:12)(cid:2)(cid:28)(cid:3,Unknown,18638.0
Unknown,Unknown,28,Unknown,Unknown,Unknown,Unknown,cid:50)(cid:46)(cid:12)(cid:2)(cid:7)(cid:8)(cid:10)(cid:5)(cid:3)(cid:48)(cid:46)(cid:3)(cid:12)(cid:13)(cid:5)(cid:2)(cid:14)(cid:46)(cid:2)(cid:28)(cid:5)(cid:3)(cid:10)(cid:5)(cid:2)(cid:64)(cid:46)(cid:4)(cid:12)(cid:2)(cid:28)(cid:3,Unknown,18666.0
Unknown,Unknown,3,Unknown,Unknown,Unknown,Unknown,cid:50)(cid:46)(cid:12)(cid:2)(cid:7)(cid:8)(cid:10)(cid:5)(cid:3)(cid:48)(cid:46)(cid:3)(cid:12)(cid:13)(cid:5)(cid:2)(cid:14)(cid:46)(cid:2)(cid:28)(cid:5)(cid:3)(cid:10)(cid:5)(cid:2)(cid:64)(cid:46)(cid:4)(cid:12)(cid:2)(cid:28)(cid:3,Unknown,18669.0
Unknown,Unknown,15,Unknown,Unknown,Unknown,Unknown,cid:50)(cid:46)(cid:12)(cid:2)(cid:7)(cid:8)(cid:10)(cid:5)(cid:3)(cid:48)(cid:46)(cid:3)(cid:12)(cid:13)(cid:5)(cid:2)(cid:14)(cid:46)(cid:2)(cid:28)(cid:5)(cid:3)(cid:10)(cid:5)(cid:2)(cid:64)(cid:46)(cid:4)(cid:12)(cid:2)(cid:28)(cid:3,Unknown,18684.0
Unknown,Unknown,2,Unknown,Unknown,Unknown,Unknown,cid:50)(cid:46)(cid:12)(cid:2)(cid:7)(cid:8)(cid:10)(cid:5)(cid:3)(cid:48)(cid:46)(cid:3)(cid:12)(cid:13)(cid:5)(cid:2)(cid:14)(cid:46)(cid:2)(cid:28)(cid:5)(cid:3)(cid:10)(cid:5)(cid:2)(cid:64)(cid:46)(cid:4)(cid:12)(cid:2)(cid:28)(cid:3,Unknown,18686.0
Unknown,Unknown,17,Unknown,Unknown,Unknown,Unknown,cid:50)(cid:46)(cid:12)(cid:2)(cid:7)(cid:8)(cid:10)(cid:5)(cid:3)(cid:48)(cid:46)(cid:3)(cid:12)(cid:13)(cid:5)(cid:2)(cid:14)(cid:46)(cid:2)(cid:28)(cid:5)(cid:3)(cid:10)(cid:5)(cid:2)(cid:64)(cid:46)(cid:4)(cid:12)(cid:2)(cid:28)(cid:3,Unknown,18703.0
Unknown,Unknown,33,Unknown,Unknown,Unknown,Unknown,cid:50)(cid:46)(cid:12)(cid:2)(cid:7)(cid:8)(cid:10)(cid:5)(cid:3)(cid:48)(cid:46)(cid:3)(cid:12)(cid:13)(cid:5)(cid:2)(cid:14)(cid:46)(cid:2)(cid:28)(cid:5)(cid:3)(cid:10)(cid:5)(cid:2)(cid:64)(cid:46)(cid:4)(cid:12)(cid:2)(cid:28)(cid:3,Unknown,18736.0
Unknown,Unknown,19,Unknown,Unknown,Unknown,Unknown,cid:50)(cid:46)(cid:12)(cid:2)(cid:7)(cid:8)(cid:10)(cid:5)(cid:3)(cid:48)(cid:46)(cid:3)(cid:12)(cid:13)(cid:5)(cid:2)(cid:14)(cid:46)(cid:2)(cid:28)(cid:5)(cid:3)(cid:10)(cid:5)(cid:2)(cid:64)(cid:46)(cid:4)(cid:12)(cid:2)(cid:28)(cid:3,Unknown,18755.0
Unknown,Unknown,17,Unknown,Unknown,Unknown,Unknown,cid:50)(cid:46)(cid:12)(cid:2)(cid:7)(cid:8)(cid:10)(cid:5)(cid:3)(cid:48)(cid:46)(cid:3)(cid:12)(cid:13)(cid:5)(cid:2)(cid:14)(cid:46)(cid:2)(cid:28)(cid:5)(cid:3)(cid:10)(cid:5)(cid:2)(cid:64)(cid:46)(cid:4)(cid:12)(cid:2)(cid:28)(cid:3,Unknown,18772.0
Unknown,Unknown,37,Unknown,Unknown,Unknown,Unknown,cid:50)(cid:46)(cid:12)(cid:2)(cid:7)(cid:8)(cid:10)(cid:5)(cid:3)(cid:48)(cid:46)(cid:3)(cid:12)(cid:13)(cid:5)(cid:2)(cid:14)(cid:46)(cid:2)(cid:28)(cid:5)(cid:3)(cid:10)(cid:5)(cid:2)(cid:64)(cid:46)(cid:4)(cid:12)(cid:2)(cid:28)(cid:3,Unknown,18809.0
Unknown,Unknown,2,Unknown,Unknown,Unknown,Unknown,cid:50)(cid:46)(cid:12)(cid:2)(cid:7)(cid:8)(cid:10)(cid:5)(cid:3)(cid:48)(cid:46)(cid:3)(cid:12)(cid:13)(cid:5)(cid:2)(cid:14)(cid:46)(cid:2)(cid:28)(cid:5)(cid:3)(cid:10)(cid:5)(cid:2)(cid:64)(cid:46)(cid:4)(cid:12)(cid:2)(cid:28)(cid:3,Unknown,18811.0
Unknown,Unknown,44,Unknown,Unknown,Unknown,Unknown,cid:50)(cid:46)(cid:12)(cid:2)(cid:7)(cid:8)(cid:10)(cid:5)(cid:3)(cid:48)(cid:46)(cid:3)(cid:12)(cid:13)(cid:5)(cid:2)(cid:14)(cid:46)(cid:2)(cid:28)(cid:5)(cid:3)(cid:10)(cid:5)(cid:2)(cid:64)(cid:46)(cid:4)(cid:12)(cid:2)(cid:28)(cid:3,Unknown,18855.0
Unknown,Unknown,12,Unknown,Unknown,Unknown,Unknown,cid:50)(cid:46)(cid:12)(cid:2)(cid:7)(cid:8)(cid:10)(cid:5)(cid:3)(cid:48)(cid:46)(cid:3)(cid:12)(cid:13)(cid:5)(cid:2)(cid:14)(cid:46)(cid:2)(cid:28)(cid:5)(cid:3)(cid:10)(cid:5)(cid:2)(cid:64)(cid:46)(cid:4)(cid:12)(cid:2)(cid:28)(cid:3,Unknown,18867.0
Unknown,Unknown,29,Unknown,Unknown,Unknown,Unknown,cid:50)(cid:46)(cid:12)(cid:2)(cid:7)(cid:8)(cid:10)(cid:5)(cid:3)(cid:48)(cid:46)(cid:3)(cid:12)(cid:13)(cid:5)(cid:2)(cid:14)(cid:46)(cid:2)(cid:28)(cid:5)(cid:3)(cid:10)(cid:5)(cid:2)(cid:64)(cid:46)(cid:4)(cid:12)(cid:2)(cid:28)(cid:3,Unknown,18896.0
Unknown,Unknown,26,Unknown,Unknown,Unknown,Unknown,cid:50)(cid:46)(cid:12)(cid:2)(cid:7)(cid:8)(cid:10)(cid:5)(cid:3)(cid:48)(cid:46)(cid:3)(cid:12)(cid:13)(cid:5)(cid:2)(cid:14)(cid:46)(cid:2)(cid:28)(cid:5)(cid:3)(cid:10)(cid:5)(cid:2)(cid:64)(cid:46)(cid:4)(cid:12)(cid:2)(cid:28)(cid:3,Unknown,18922.0
Unknown,Unknown,41,Unknown,Unknown,Unknown,Unknown,cid:50)(cid:46)(cid:12)(cid:2)(cid:7)(cid:8)(cid:10)(cid:5)(cid:3)(cid:48)(cid:46)(cid:3)(cid:12)(cid:13)(cid:5)(cid:2)(cid:14)(cid:46)(cid:2)(cid:28)(cid:5)(cid:3)(cid:10)(cid:5)(cid:2)(cid:64)(cid:46)(cid:4)(cid:12)(cid:2)(cid:28)(cid:3,Unknown,18963.0
Unknown,Unknown,25,Unknown,Unknown,Unknown,Unknown,cid:50)(cid:46)(cid:12)(cid:2)(cid:7)(cid:8)(cid:10)(cid:5)(cid:3)(cid:48)(cid:46)(cid:3)(cid:12)(cid:13)(cid:5)(cid:2)(cid:14)(cid:46)(cid:2)(cid:28)(cid:5)(cid:3)(cid:10)(cid:5)(cid:2)(cid:64)(cid:46)(cid:4)(cid:12)(cid:2)(cid:28)(cid:3,Unknown,18988.0
Unknown,Unknown,2,Unknown,Unknown,Unknown,Unknown,cid:50)(cid:46)(cid:12)(cid:2)(cid:7)(cid:8)(cid:10)(cid:5)(cid:3)(cid:48)(cid:46)(cid:3)(cid:12)(cid:13)(cid:5)(cid:2)(cid:14)(cid:46)(cid:2)(cid:28)(cid:5)(cid:3)(cid:10)(cid:5)(cid:2)(cid:64)(cid:46)(cid:4)(cid:12)(cid:2)(cid:28)(cid:3,Unknown,18990.0
Unknown,Unknown,58,Unknown,Unknown,Unknown,Unknown,cid:50)(cid:46)(cid:12)(cid:2)(cid:7)(cid:8)(cid:10)(cid:5)(cid:3)(cid:48)(cid:46)(cid:3)(cid:12)(cid:13)(cid:5)(cid:2)(cid:14)(cid:46)(cid:2)(cid:28)(cid:5)(cid:3)(cid:10)(cid:5)(cid:2)(cid:64)(cid:46)(cid:4)(cid:12)(cid:2)(cid:28)(cid:3,Unknown,19048.0
Unknown,Unknown,58,Unknown,Unknown,Unknown,Unknown,cid:50)(cid:46)(cid:12)(cid:2)(cid:7)(cid:8)(cid:10)(cid:5)(cid:3)(cid:48)(cid:46)(cid:3)(cid:12)(cid:13)(cid:5)(cid:2)(cid:14)(cid:46)(cid:2)(cid:28)(cid:5)(cid:3)(cid:10)(cid:5)(cid:2)(cid:64)(cid:46)(cid:4)(cid:12)(cid:2)(cid:28)(cid:3,Unknown,19106.0
Unknown,Unknown,37,Unknown,Unknown,Unknown,Unknown,cid:50)(cid:46)(cid:12)(cid:2)(cid:7)(cid:8)(cid:10)(cid:5)(cid:3)(cid:48)(cid:46)(cid:3)(cid:12)(cid:13)(cid:5)(cid:2)(cid:14)(cid:46)(cid:2)(cid:28)(cid:5)(cid:3)(cid:10)(cid:5)(cid:2)(cid:64)(cid:46)(cid:4)(cid:12)(cid:2)(cid:28)(cid:3,Unknown,19143.0
Unknown,Unknown,16,Unknown,Unknown,Unknown,Unknown,cid:50)(cid:46)(cid:12)(cid:2)(cid:7)(cid:8)(cid:10)(cid:5)(cid:3)(cid:48)(cid:46)(cid:3)(cid:12)(cid:13)(cid:5)(cid:2)(cid:14)(cid:46)(cid:2)(cid:28)(cid:5)(cid:3)(cid:10)(cid:5)(cid:2)(cid:64)(cid:46)(cid:4)(cid:12)(cid:2)(cid:28)(cid:3,Unknown,19159.0
Unknown,Unknown,34,Unknown,Unknown,Unknown,Unknown,cid:50)(cid:46)(cid:12)(cid:2)(cid:7)(cid:8)(cid:10)(cid:5)(cid:3)(cid:48)(cid:46)(cid:3)(cid:12)(cid:13)(cid:5)(cid:2)(cid:14)(cid:46)(cid:2)(cid:28)(cid:5)(cid:3)(cid:10)(cid:5)(cid:2)(cid:64)(cid:46)(cid:4)(cid:12)(cid:2)(cid:28)(cid:3,Unknown,19193.0
Unknown,Unknown,33,Unknown,Unknown,Unknown,Unknown,cid:50)(cid:46)(cid:12)(cid:2)(cid:7)(cid:8)(cid:10)(cid:5)(cid:3)(cid:48)(cid:46)(cid:3)(cid:12)(cid:13)(cid:5)(cid:2)(cid:14)(cid:46)(cid:2)(cid:28)(cid:5)(cid:3)(cid:10)(cid:5)(cid:2)(cid:64)(cid:46)(cid:4)(cid:12)(cid:2)(cid:28)(cid:3,Unknown,19226.0
Unknown,Unknown,18,Unknown,Unknown,Unknown,Unknown,cid:3)(cid:5)(cid:14)(cid:70)(cid:12)(cid:11)(cid:4)(cid:14)(cid:11)(cid:48)(cid:48)(cid:7)(cid:5)(cid:3)(cid:9)(cid:2)(cid:12)(cid:11)(cid:4)(cid:14)(cid:11)(cid:48)(cid:48)(cid:7)(cid:5)(cid:3)(cid:9)(cid:2)(cid:28)(cid:3,cid:17)(cid:17)(cid:45)(cid:18)(cid:16,18.0
Unknown,Unknown,33,Unknown,Unknown,Unknown,Unknown,cid:3)(cid:5)(cid:14)(cid:70)(cid:12)(cid:11)(cid:4)(cid:14)(cid:11)(cid:48)(cid:48)(cid:7)(cid:5)(cid:3)(cid:9)(cid:2)(cid:12)(cid:11)(cid:4)(cid:14)(cid:11)(cid:48)(cid:48)(cid:7)(cid:5)(cid:3)(cid:9)(cid:2)(cid:28)(cid:3,cid:15)(cid:2)(cid:35)(cid:19)(cid:1)(cid:1)(cid:2)(cid:44,51.0
Unknown,Unknown,45,Unknown,Unknown,Unknown,Unknown,cid:3)(cid:5)(cid:14)(cid:70)(cid:12)(cid:11)(cid:4)(cid:14)(cid:11)(cid:48)(cid:48)(cid:7)(cid:5)(cid:3)(cid:9)(cid:2)(cid:12)(cid:11)(cid:4)(cid:14)(cid:11)(cid:48)(cid:48)(cid:7)(cid:5)(cid:3)(cid:9)(cid:2)(cid:28)(cid:3,cid:10)(cid:46)(cid:47)(cid:46)(cid:12)(cid:2)(cid:50)(cid:5)(cid:9)(cid:2)(cid:10)(cid:5)(cid:48)(cid:2)(cid:12)(cid:11)(cid:4)(cid:14)(cid:11)(cid:48)(cid:48)(cid:7)(cid:5)(cid:3)(cid:2)(cid:28)(cid:3,96.0
Unknown,Unknown,18,Unknown,Unknown,Unknown,Unknown,cid:3)(cid:5)(cid:14)(cid:70)(cid:12)(cid:11)(cid:4)(cid:14)(cid:11)(cid:48)(cid:48)(cid:7)(cid:5)(cid:3)(cid:9)(cid:2)(cid:12)(cid:11)(cid:4)(cid:14)(cid:11)(cid:48)(cid:48)(cid:7)(cid:5)(cid:3)(cid:9)(cid:2)(cid:28)(cid:3,cid:17)(cid:34)(cid:45)(cid:18)(cid:16,114.0
Unknown,Unknown,16,Unknown,Unknown,Unknown,Unknown,cid:3)(cid:5)(cid:14)(cid:70)(cid:12)(cid:11)(cid:4)(cid:14)(cid:11)(cid:48)(cid:48)(cid:7)(cid:5)(cid:3)(cid:9)(cid:2)(cid:12)(cid:11)(cid:4)(cid:14)(cid:11)(cid:48)(cid:48)(cid:7)(cid:5)(cid:3)(cid:9)(cid:2)(cid:28)(cid:3,cid:17)(cid:34)(cid:45)(cid:18)(cid:16,130.0
Unknown,Unknown,48,Unknown,Unknown,Unknown,Unknown,cid:3)(cid:5)(cid:14)(cid:70)(cid:12)(cid:11)(cid:4)(cid:14)(cid:11)(cid:48)(cid:48)(cid:7)(cid:5)(cid:3)(cid:9)(cid:2)(cid:12)(cid:11)(cid:4)(cid:14)(cid:11)(cid:48)(cid:48)(cid:7)(cid:5)(cid:3)(cid:9)(cid:2)(cid:28)(cid:3,cid:9)(cid:46)(cid:8)(cid:5)(cid:28)(cid:2)(cid:46)(cid:4)(cid:10)(cid:11)(cid:3)(cid:11)(cid:4)(cid:10)(cid:5)(cid:2)(cid:9)(cid:5)(cid:8)(cid:14)(cid:7)(cid:9)(cid:2)(cid:12)(cid:5)(cid:50)(cid:5)(cid:40)(cid:2)(cid:28)(cid:3,178.0
Unknown,Unknown,12,Unknown,Unknown,Unknown,Unknown,cid:3)(cid:5)(cid:14)(cid:70)(cid:12)(cid:11)(cid:4)(cid:14)(cid:11)(cid:48)(cid:48)(cid:7)(cid:5)(cid:3)(cid:9)(cid:2)(cid:12)(cid:11)(cid:4)(cid:14)(cid:11)(cid:48)(cid:48)(cid:7)(cid:5)(cid:3)(cid:9)(cid:2)(cid:28)(cid:3,cid:9)(cid:46)(cid:8)(cid:5)(cid:28)(cid:2)(cid:46)(cid:4)(cid:10)(cid:11)(cid:3)(cid:11)(cid:4)(cid:10)(cid:5)(cid:2)(cid:9)(cid:5)(cid:8)(cid:14)(cid:7)(cid:9)(cid:2)(cid:12)(cid:5)(cid:50)(cid:5)(cid:40)(cid:2)(cid:28)(cid:3,190.0
Unknown,Unknown,2,Unknown,Unknown,Unknown,Unknown,cid:3)(cid:5)(cid:14)(cid:70)(cid:12)(cid:11)(cid:4)(cid:14)(cid:11)(cid:48)(cid:48)(cid:7)(cid:5)(cid:3)(cid:9)(cid:2)(cid:12)(cid:11)(cid:4)(cid:14)(cid:11)(cid:48)(cid:48)(cid:7)(cid:5)(cid:3)(cid:9)(cid:2)(cid:28)(cid:3,cid:48)(cid:12)(cid:50)(cid:11)(cid:8)(cid:46)(cid:14)(cid:50)(cid:9)(cid:17)(cid:36)(cid:18)(cid:1)(cid:2)(cid:12)(cid:11)(cid:4)(cid:7)(cid:14)(cid:14)(cid:49)(cid:2)(cid:46)(cid:4)(cid:2)(cid:28)(cid:3,192.0
Unknown,Unknown,50,Unknown,Unknown,Unknown,Unknown,cid:3)(cid:5)(cid:14)(cid:70)(cid:12)(cid:11)(cid:4)(cid:14)(cid:11)(cid:48)(cid:48)(cid:7)(cid:5)(cid:3)(cid:9)(cid:2)(cid:12)(cid:11)(cid:4)(cid:14)(cid:11)(cid:48)(cid:48)(cid:7)(cid:5)(cid:3)(cid:9)(cid:2)(cid:28)(cid:3,cid:9)(cid:46)(cid:8)(cid:5)(cid:28)(cid:2)(cid:9)(cid:5)(cid:8)(cid:14)(cid:7)(cid:9)(cid:2)(cid:28)(cid:3,242.0
Unknown,Unknown,11,Unknown,Unknown,Unknown,Unknown,cid:3)(cid:5)(cid:14)(cid:70)(cid:12)(cid:11)(cid:4)(cid:14)(cid:11)(cid:48)(cid:48)(cid:7)(cid:5)(cid:3)(cid:9)(cid:2)(cid:12)(cid:11)(cid:4)(cid:14)(cid:11)(cid:48)(cid:48)(cid:7)(cid:5)(cid:3)(cid:9)(cid:2)(cid:28)(cid:3,cid:9)(cid:46)(cid:8)(cid:5)(cid:28)(cid:2)(cid:46)(cid:4)(cid:10)(cid:11)(cid:3)(cid:11)(cid:4)(cid:10)(cid:5)(cid:2)(cid:9)(cid:5)(cid:8)(cid:14)(cid:7)(cid:9)(cid:2)(cid:12)(cid:5)(cid:50)(cid:5)(cid:40)(cid:2)(cid:28)(cid:3,253.0
Unknown,Unknown,8,Unknown,Unknown,Unknown,Unknown,cid:3)(cid:5)(cid:14)(cid:70)(cid:12)(cid:11)(cid:4)(cid:14)(cid:11)(cid:48)(cid:48)(cid:7)(cid:5)(cid:3)(cid:9)(cid:2)(cid:12)(cid:11)(cid:4)(cid:14)(cid:11)(cid:48)(cid:48)(cid:7)(cid:5)(cid:3)(cid:9)(cid:2)(cid:28)(cid:3,Unknown,261.0
Unknown,Unknown,46,Unknown,Unknown,Unknown,Unknown,cid:3)(cid:5)(cid:14)(cid:70)(cid:12)(cid:11)(cid:4)(cid:14)(cid:11)(cid:48)(cid:48)(cid:7)(cid:5)(cid:3)(cid:9)(cid:2)(cid:12)(cid:11)(cid:4)(cid:14)(cid:11)(cid:48)(cid:48)(cid:7)(cid:5)(cid:3)(cid:9)(cid:2)(cid:28)(cid:3,Unknown,307.0
Unknown,Unknown,14,Unknown,Unknown,Unknown,Unknown,cid:3)(cid:5)(cid:14)(cid:70)(cid:12)(cid:11)(cid:4)(cid:14)(cid:11)(cid:48)(cid:48)(cid:7)(cid:5)(cid:3)(cid:9)(cid:2)(cid:12)(cid:11)(cid:4)(cid:14)(cid:11)(cid:48)(cid:48)(cid:7)(cid:5)(cid:3)(cid:9)(cid:2)(cid:28)(cid:3,Unknown,321.0
Unknown,Unknown,50,Unknown,Unknown,Unknown,Unknown,cid:3)(cid:5)(cid:14)(cid:70)(cid:12)(cid:11)(cid:4)(cid:14)(cid:11)(cid:48)(cid:48)(cid:7)(cid:5)(cid:3)(cid:9)(cid:2)(cid:12)(cid:11)(cid:4)(cid:14)(cid:11)(cid:48)(cid:48)(cid:7)(cid:5)(cid:3)(cid:9)(cid:2)(cid:28)(cid:3,Unknown,371.0
Unknown,Unknown,69,Unknown,Unknown,Unknown,Unknown,cid:3)(cid:5)(cid:14)(cid:70)(cid:12)(cid:11)(cid:4)(cid:14)(cid:11)(cid:48)(cid:48)(cid:7)(cid:5)(cid:3)(cid:9)(cid:2)(cid:12)(cid:11)(cid:4)(cid:14)(cid:11)(cid:48)(cid:48)(cid:7)(cid:5)(cid:3)(cid:9)(cid:2)(cid:28)(cid:3,Unknown,440.0
Unknown,Unknown,9,Unknown,Unknown,Unknown,Unknown,cid:3)(cid:5)(cid:14)(cid:70)(cid:12)(cid:11)(cid:4)(cid:14)(cid:11)(cid:48)(cid:48)(cid:7)(cid:5)(cid:3)(cid:9)(cid:2)(cid:12)(cid:11)(cid:4)(cid:14)(cid:11)(cid:48)(cid:48)(cid:7)(cid:5)(cid:3)(cid:9)(cid:2)(cid:28)(cid:3,Unknown,449.0
Unknown,Unknown,2,Unknown,Unknown,Unknown,Unknown,cid:3)(cid:5)(cid:14)(cid:70)(cid:12)(cid:11)(cid:4)(cid:14)(cid:11)(cid:48)(cid:48)(cid:7)(cid:5)(cid:3)(cid:9)(cid:2)(cid:12)(cid:11)(cid:4)(cid:14)(cid:11)(cid:48)(cid:48)(cid:7)(cid:5)(cid:3)(cid:9)(cid:2)(cid:28)(cid:3,Unknown,451.0
Unknown,Unknown,12,Unknown,Unknown,Unknown,Unknown,cid:3)(cid:5)(cid:14)(cid:70)(cid:12)(cid:11)(cid:4)(cid:14)(cid:11)(cid:48)(cid:48)(cid:7)(cid:5)(cid:3)(cid:9)(cid:2)(cid:12)(cid:11)(cid:4)(cid:14)(cid:11)(cid:48)(cid:48)(cid:7)(cid:5)(cid:3)(cid:9)(cid:2)(cid:28)(cid:3,Unknown,463.0
Unknown,Unknown,11,Unknown,Unknown,Unknown,Unknown,cid:3)(cid:5)(cid:14)(cid:70)(cid:12)(cid:11)(cid:4)(cid:14)(cid:11)(cid:48)(cid:48)(cid:7)(cid:5)(cid:3)(cid:9)(cid:2)(cid:12)(cid:11)(cid:4)(cid:14)(cid:11)(cid:48)(cid:48)(cid:7)(cid:5)(cid:3)(cid:9)(cid:2)(cid:28)(cid:3,Unknown,474.0
Unknown,Unknown,4,Unknown,Unknown,Unknown,Unknown,cid:3)(cid:5)(cid:14)(cid:70)(cid:12)(cid:11)(cid:4)(cid:14)(cid:11)(cid:48)(cid:48)(cid:7)(cid:5)(cid:3)(cid:9)(cid:2)(cid:12)(cid:11)(cid:4)(cid:14)(cid:11)(cid:48)(cid:48)(cid:7)(cid:5)(cid:3)(cid:9)(cid:2)(cid:28)(cid:3,Unknown,478.0
Unknown,Unknown,14,Unknown,Unknown,Unknown,Unknown,cid:3)(cid:5)(cid:14)(cid:70)(cid:12)(cid:11)(cid:4)(cid:14)(cid:11)(cid:48)(cid:48)(cid:7)(cid:5)(cid:3)(cid:9)(cid:2)(cid:12)(cid:11)(cid:4)(cid:14)(cid:11)(cid:48)(cid:48)(cid:7)(cid:5)(cid:3)(cid:9)(cid:2)(cid:28)(cid:3,Unknown,492.0
Unknown,Unknown,11,Unknown,Unknown,Unknown,Unknown,cid:3)(cid:5)(cid:14)(cid:70)(cid:12)(cid:11)(cid:4)(cid:14)(cid:11)(cid:48)(cid:48)(cid:7)(cid:5)(cid:3)(cid:9)(cid:2)(cid:12)(cid:11)(cid:4)(cid:14)(cid:11)(cid:48)(cid:48)(cid:7)(cid:5)(cid:3)(cid:9)(cid:2)(cid:28)(cid:3,Unknown,503.0
Unknown,Unknown,48,Unknown,Unknown,Unknown,Unknown,cid:3)(cid:5)(cid:14)(cid:70)(cid:12)(cid:11)(cid:4)(cid:14)(cid:11)(cid:48)(cid:48)(cid:7)(cid:5)(cid:3)(cid:9)(cid:2)(cid:12)(cid:11)(cid:4)(cid:14)(cid:11)(cid:48)(cid:48)(cid:7)(cid:5)(cid:3)(cid:9)(cid:2)(cid:28)(cid:3,Unknown,551.0
Unknown,Unknown,48,Unknown,Unknown,Unknown,Unknown,cid:3)(cid:5)(cid:14)(cid:70)(cid:12)(cid:11)(cid:4)(cid:14)(cid:11)(cid:48)(cid:48)(cid:7)(cid:5)(cid:3)(cid:9)(cid:2)(cid:12)(cid:11)(cid:4)(cid:14)(cid:11)(cid:48)(cid:48)(cid:7)(cid:5)(cid:3)(cid:9)(cid:2)(cid:28)(cid:3,Unknown,599.0
Unknown,Unknown,7,Unknown,Unknown,Unknown,Unknown,cid:3)(cid:5)(cid:14)(cid:70)(cid:12)(cid:11)(cid:4)(cid:14)(cid:11)(cid:48)(cid:48)(cid:7)(cid:5)(cid:3)(cid:9)(cid:2)(cid:12)(cid:11)(cid:4)(cid:14)(cid:11)(cid:48)(cid:48)(cid:7)(cid:5)(cid:3)(cid:9)(cid:2)(cid:28)(cid:3,Unknown,606.0
Unknown,Unknown,5,Unknown,Unknown,Unknown,Unknown,cid:3)(cid:5)(cid:14)(cid:70)(cid:12)(cid:11)(cid:4)(cid:14)(cid:11)(cid:48)(cid:48)(cid:7)(cid:5)(cid:3)(cid:9)(cid:2)(cid:12)(cid:11)(cid:4)(cid:14)(cid:11)(cid:48)(cid:48)(cid:7)(cid:5)(cid:3)(cid:9)(cid:2)(cid:28)(cid:3,Unknown,611.0
Unknown,Unknown,3,Unknown,Unknown,Unknown,Unknown,cid:3)(cid:5)(cid:14)(cid:70)(cid:12)(cid:11)(cid:4)(cid:14)(cid:11)(cid:48)(cid:48)(cid:7)(cid:5)(cid:3)(cid:9)(cid:2)(cid:12)(cid:11)(cid:4)(cid:14)(cid:11)(cid:48)(cid:48)(cid:7)(cid:5)(cid:3)(cid:9)(cid:2)(cid:28)(cid:3,Unknown,614.0
Unknown,Unknown,2,Unknown,Unknown,Unknown,Unknown,cid:3)(cid:5)(cid:14)(cid:70)(cid:12)(cid:11)(cid:4)(cid:14)(cid:11)(cid:48)(cid:48)(cid:7)(cid:5)(cid:3)(cid:9)(cid:2)(cid:12)(cid:11)(cid:4)(cid:14)(cid:11)(cid:48)(cid:48)(cid:7)(cid:5)(cid:3)(cid:9)(cid:2)(cid:28)(cid:3,Unknown,616.0
Unknown,Unknown,28,Unknown,Unknown,Unknown,Unknown,cid:3)(cid:5)(cid:14)(cid:70)(cid:12)(cid:11)(cid:4)(cid:14)(cid:11)(cid:48)(cid:48)(cid:7)(cid:5)(cid:3)(cid:9)(cid:2)(cid:12)(cid:11)(cid:4)(cid:14)(cid:11)(cid:48)(cid:48)(cid:7)(cid:5)(cid:3)(cid:9)(cid:2)(cid:28)(cid:3,Unknown,644.0
Unknown,Unknown,3,Unknown,Unknown,Unknown,Unknown,cid:3)(cid:5)(cid:14)(cid:70)(cid:12)(cid:11)(cid:4)(cid:14)(cid:11)(cid:48)(cid:48)(cid:7)(cid:5)(cid:3)(cid:9)(cid:2)(cid:12)(cid:11)(cid:4)(cid:14)(cid:11)(cid:48)(cid:48)(cid:7)(cid:5)(cid:3)(cid:9)(cid:2)(cid:28)(cid:3,Unknown,647.0
Unknown,Unknown,15,Unknown,Unknown,Unknown,Unknown,cid:3)(cid:5)(cid:14)(cid:70)(cid:12)(cid:11)(cid:4)(cid:14)(cid:11)(cid:48)(cid:48)(cid:7)(cid:5)(cid:3)(cid:9)(cid:2)(cid:12)(cid:11)(cid:4)(cid:14)(cid:11)(cid:48)(cid:48)(cid:7)(cid:5)(cid:3)(cid:9)(cid:2)(cid:28)(cid:3,Unknown,662.0
Unknown,Unknown,2,Unknown,Unknown,Unknown,Unknown,cid:3)(cid:5)(cid:14)(cid:70)(cid:12)(cid:11)(cid:4)(cid:14)(cid:11)(cid:48)(cid:48)(cid:7)(cid:5)(cid:3)(cid:9)(cid:2)(cid:12)(cid:11)(cid:4)(cid:14)(cid:11)(cid:48)(cid:48)(cid:7)(cid:5)(cid:3)(cid:9)(cid:2)(cid:28)(cid:3,Unknown,664.0
Unknown,Unknown,32,Unknown,Unknown,Unknown,Unknown,cid:3)(cid:5)(cid:14)(cid:70)(cid:12)(cid:11)(cid:4)(cid:14)(cid:11)(cid:48)(cid:48)(cid:7)(cid:5)(cid:3)(cid:9)(cid:2)(cid:12)(cid:11)(cid:4)(cid:14)(cid:11)(cid:48)(cid:48)(cid:7)(cid:5)(cid:3)(cid:9)(cid:2)(cid:28)(cid:3,Unknown,696.0
Unknown,Unknown,18,Unknown,Unknown,Unknown,Unknown,cid:3)(cid:5)(cid:14)(cid:70)(cid:12)(cid:11)(cid:4)(cid:14)(cid:11)(cid:48)(cid:48)(cid:7)(cid:5)(cid:3)(cid:9)(cid:2)(cid:12)(cid:11)(cid:4)(cid:14)(cid:11)(cid:48)(cid:48)(cid:7)(cid:5)(cid:3)(cid:9)(cid:2)(cid:28)(cid:3,Unknown,714.0
Unknown,Unknown,19,Unknown,Unknown,Unknown,Unknown,cid:3)(cid:5)(cid:14)(cid:70)(cid:12)(cid:11)(cid:4)(cid:14)(cid:11)(cid:48)(cid:48)(cid:7)(cid:5)(cid:3)(cid:9)(cid:2)(cid:12)(cid:11)(cid:4)(cid:14)(cid:11)(cid:48)(cid:48)(cid:7)(cid:5)(cid:3)(cid:9)(cid:2)(cid:28)(cid:3,Unknown,733.0
Unknown,Unknown,17,Unknown,Unknown,Unknown,Unknown,cid:3)(cid:5)(cid:14)(cid:70)(cid:12)(cid:11)(cid:4)(cid:14)(cid:11)(cid:48)(cid:48)(cid:7)(cid:5)(cid:3)(cid:9)(cid:2)(cid:12)(cid:11)(cid:4)(cid:14)(cid:11)(cid:48)(cid:48)(cid:7)(cid:5)(cid:3)(cid:9)(cid:2)(cid:28)(cid:3,Unknown,750.0
Unknown,Unknown,34,Unknown,Unknown,Unknown,Unknown,cid:3)(cid:5)(cid:14)(cid:70)(cid:12)(cid:11)(cid:4)(cid:14)(cid:11)(cid:48)(cid:48)(cid:7)(cid:5)(cid:3)(cid:9)(cid:2)(cid:12)(cid:11)(cid:4)(cid:14)(cid:11)(cid:48)(cid:48)(cid:7)(cid:5)(cid:3)(cid:9)(cid:2)(cid:28)(cid:3,Unknown,784.0
Unknown,Unknown,2,Unknown,Unknown,Unknown,Unknown,cid:3)(cid:5)(cid:14)(cid:70)(cid:12)(cid:11)(cid:4)(cid:14)(cid:11)(cid:48)(cid:48)(cid:7)(cid:5)(cid:3)(cid:9)(cid:2)(cid:12)(cid:11)(cid:4)(cid:14)(cid:11)(cid:48)(cid:48)(cid:7)(cid:5)(cid:3)(cid:9)(cid:2)(cid:28)(cid:3,Unknown,786.0
Unknown,Unknown,44,Unknown,Unknown,Unknown,Unknown,cid:3)(cid:5)(cid:14)(cid:70)(cid:12)(cid:11)(cid:4)(cid:14)(cid:11)(cid:48)(cid:48)(cid:7)(cid:5)(cid:3)(cid:9)(cid:2)(cid:12)(cid:11)(cid:4)(cid:14)(cid:11)(cid:48)(cid:48)(cid:7)(cid:5)(cid:3)(cid:9)(cid:2)(cid:28)(cid:3,Unknown,830.0
Unknown,Unknown,12,Unknown,Unknown,Unknown,Unknown,cid:3)(cid:5)(cid:14)(cid:70)(cid:12)(cid:11)(cid:4)(cid:14)(cid:11)(cid:48)(cid:48)(cid:7)(cid:5)(cid:3)(cid:9)(cid:2)(cid:12)(cid:11)(cid:4)(cid:14)(cid:11)(cid:48)(cid:48)(cid:7)(cid:5)(cid:3)(cid:9)(cid:2)(cid:28)(cid:3,Unknown,842.0
Unknown,Unknown,29,Unknown,Unknown,Unknown,Unknown,cid:3)(cid:5)(cid:14)(cid:70)(cid:12)(cid:11)(cid:4)(cid:14)(cid:11)(cid:48)(cid:48)(cid:7)(cid:5)(cid:3)(cid:9)(cid:2)(cid:12)(cid:11)(cid:4)(cid:14)(cid:11)(cid:48)(cid:48)(cid:7)(cid:5)(cid:3)(cid:9)(cid:2)(cid:28)(cid:3,Unknown,871.0
Unknown,Unknown,26,Unknown,Unknown,Unknown,Unknown,cid:3)(cid:5)(cid:14)(cid:70)(cid:12)(cid:11)(cid:4)(cid:14)(cid:11)(cid:48)(cid:48)(cid:7)(cid:5)(cid:3)(cid:9)(cid:2)(cid:12)(cid:11)(cid:4)(cid:14)(cid:11)(cid:48)(cid:48)(cid:7)(cid:5)(cid:3)(cid:9)(cid:2)(cid:28)(cid:3,Unknown,897.0
Unknown,Unknown,41,Unknown,Unknown,Unknown,Unknown,cid:3)(cid:5)(cid:14)(cid:70)(cid:12)(cid:11)(cid:4)(cid:14)(cid:11)(cid:48)(cid:48)(cid:7)(cid:5)(cid:3)(cid:9)(cid:2)(cid:12)(cid:11)(cid:4)(cid:14)(cid:11)(cid:48)(cid:48)(cid:7)(cid:5)(cid:3)(cid:9)(cid:2)(cid:28)(cid:3,Unknown,938.0
Unknown,Unknown,25,Unknown,Unknown,Unknown,Unknown,cid:3)(cid:5)(cid:14)(cid:70)(cid:12)(cid:11)(cid:4)(cid:14)(cid:11)(cid:48)(cid:48)(cid:7)(cid:5)(cid:3)(cid:9)(cid:2)(cid:12)(cid:11)(cid:4)(cid:14)(cid:11)(cid:48)(cid:48)(cid:7)(cid:5)(cid:3)(cid:9)(cid:2)(cid:28)(cid:3,Unknown,963.0
Unknown,Unknown,2,Unknown,Unknown,Unknown,Unknown,cid:3)(cid:5)(cid:14)(cid:70)(cid:12)(cid:11)(cid:4)(cid:14)(cid:11)(cid:48)(cid:48)(cid:7)(cid:5)(cid:3)(cid:9)(cid:2)(cid:12)(cid:11)(cid:4)(cid:14)(cid:11)(cid:48)(cid:48)(cid:7)(cid:5)(cid:3)(cid:9)(cid:2)(cid:28)(cid:3,Unknown,965.0
Unknown,Unknown,58,Unknown,Unknown,Unknown,Unknown,cid:3)(cid:5)(cid:14)(cid:70)(cid:12)(cid:11)(cid:4)(cid:14)(cid:11)(cid:48)(cid:48)(cid:7)(cid:5)(cid:3)(cid:9)(cid:2)(cid:12)(cid:11)(cid:4)(cid:14)(cid:11)(cid:48)(cid:48)(cid:7)(cid:5)(cid:3)(cid:9)(cid:2)(cid:28)(cid:3,Unknown,1023.0
Unknown,Unknown,58,Unknown,Unknown,Unknown,Unknown,cid:3)(cid:5)(cid:14)(cid:70)(cid:12)(cid:11)(cid:4)(cid:14)(cid:11)(cid:48)(cid:48)(cid:7)(cid:5)(cid:3)(cid:9)(cid:2)(cid:12)(cid:11)(cid:4)(cid:14)(cid:11)(cid:48)(cid:48)(cid:7)(cid:5)(cid:3)(cid:9)(cid:2)(cid:28)(cid:3,Unknown,1081.0
Unknown,Unknown,37,Unknown,Unknown,Unknown,Unknown,cid:3)(cid:5)(cid:14)(cid:70)(cid:12)(cid:11)(cid:4)(cid:14)(cid:11)(cid:48)(cid:48)(cid:7)(cid:5)(cid:3)(cid:9)(cid:2)(cid:12)(cid:11)(cid:4)(cid:14)(cid:11)(cid:48)(cid:48)(cid:7)(cid:5)(cid:3)(cid:9)(cid:2)(cid:28)(cid:3,Unknown,1118.0
Unknown,Unknown,16,Unknown,Unknown,Unknown,Unknown,cid:3)(cid:5)(cid:14)(cid:70)(cid:12)(cid:11)(cid:4)(cid:14)(cid:11)(cid:48)(cid:48)(cid:7)(cid:5)(cid:3)(cid:9)(cid:2)(cid:12)(cid:11)(cid:4)(cid:14)(cid:11)(cid:48)(cid:48)(cid:7)(cid:5)(cid:3)(cid:9)(cid:2)(cid:28)(cid:3,Unknown,1134.0
Unknown,Unknown,34,Unknown,Unknown,Unknown,Unknown,cid:3)(cid:5)(cid:14)(cid:70)(cid:12)(cid:11)(cid:4)(cid:14)(cid:11)(cid:48)(cid:48)(cid:7)(cid:5)(cid:3)(cid:9)(cid:2)(cid:12)(cid:11)(cid:4)(cid:14)(cid:11)(cid:48)(cid:48)(cid:7)(cid:5)(cid:3)(cid:9)(cid:2)(cid:28)(cid:3,Unknown,1168.0
Unknown,Unknown,33,Unknown,Unknown,Unknown,Unknown,cid:3)(cid:5)(cid:14)(cid:70)(cid:12)(cid:11)(cid:4)(cid:14)(cid:11)(cid:48)(cid:48)(cid:7)(cid:5)(cid:3)(cid:9)(cid:2)(cid:12)(cid:11)(cid:4)(cid:14)(cid:11)(cid:48)(cid:48)(cid:7)(cid:5)(cid:3)(cid:9)(cid:2)(cid:28)(cid:3,Unknown,1201.0
Unknown,Unknown,17,Unknown,Unknown,Unknown,Unknown,cid:3)(cid:5)(cid:14)(cid:70)(cid:12)(cid:11)(cid:4)(cid:14)(cid:11)(cid:48)(cid:48)(cid:7)(cid:5)(cid:3)(cid:9)(cid:2)(cid:12)(cid:11)(cid:4)(cid:14)(cid:11)(cid:48)(cid:48)(cid:7)(cid:5)(cid:3)(cid:9)(cid:2)(cid:28)(cid:3,Unknown,1218.0
Unknown,Unknown,18,Unknown,Unknown,Unknown,Unknown,cid:3)(cid:5)(cid:14)(cid:70)(cid:12)(cid:11)(cid:4)(cid:14)(cid:11)(cid:48)(cid:48)(cid:7)(cid:5)(cid:3)(cid:9)(cid:2)(cid:12)(cid:11)(cid:4)(cid:14)(cid:11)(cid:48)(cid:48)(cid:7)(cid:5)(cid:3)(cid:9)(cid:2)(cid:28)(cid:3,Unknown,1236.0
Unknown,Unknown,45,Unknown,Unknown,Unknown,Unknown,cid:3)(cid:5)(cid:14)(cid:70)(cid:12)(cid:11)(cid:4)(cid:14)(cid:11)(cid:48)(cid:48)(cid:7)(cid:5)(cid:3)(cid:9)(cid:2)(cid:12)(cid:11)(cid:4)(cid:14)(cid:11)(cid:48)(cid:48)(cid:7)(cid:5)(cid:3)(cid:9)(cid:2)(cid:28)(cid:3,Unknown,1281.0
Unknown,Unknown,18,Unknown,Unknown,Unknown,Unknown,cid:3)(cid:5)(cid:14)(cid:70)(cid:12)(cid:11)(cid:4)(cid:14)(cid:11)(cid:48)(cid:48)(cid:7)(cid:5)(cid:3)(cid:9)(cid:2)(cid:12)(cid:11)(cid:4)(cid:14)(cid:11)(cid:48)(cid:48)(cid:7)(cid:5)(cid:3)(cid:9)(cid:2)(cid:28)(cid:3,Unknown,1299.0
Unknown,Unknown,16,Unknown,Unknown,Unknown,Unknown,cid:3)(cid:5)(cid:14)(cid:70)(cid:12)(cid:11)(cid:4)(cid:14)(cid:11)(cid:48)(cid:48)(cid:7)(cid:5)(cid:3)(cid:9)(cid:2)(cid:12)(cid:11)(cid:4)(cid:14)(cid:11)(cid:48)(cid:48)(cid:7)(cid:5)(cid:3)(cid:9)(cid:2)(cid:28)(cid:3,Unknown,1315.0
Unknown,Unknown,3,Unknown,Unknown,Unknown,Unknown,cid:3)(cid:5)(cid:14)(cid:70)(cid:12)(cid:11)(cid:4)(cid:14)(cid:11)(cid:48)(cid:48)(cid:7)(cid:5)(cid:3)(cid:9)(cid:2)(cid:12)(cid:11)(cid:4)(cid:14)(cid:11)(cid:48)(cid:48)(cid:7)(cid:5)(cid:3)(cid:9)(cid:2)(cid:28)(cid:3,Unknown,1318.0
Unknown,Unknown,5,Unknown,Unknown,Unknown,Unknown,cid:3)(cid:5)(cid:14)(cid:70)(cid:12)(cid:11)(cid:4)(cid:14)(cid:11)(cid:48)(cid:48)(cid:7)(cid:5)(cid:3)(cid:9)(cid:2)(cid:12)(cid:11)(cid:4)(cid:14)(cid:11)(cid:48)(cid:48)(cid:7)(cid:5)(cid:3)(cid:9)(cid:2)(cid:28)(cid:3,Unknown,1323.0
Unknown,Unknown,14,Unknown,Unknown,Unknown,Unknown,cid:3)(cid:5)(cid:14)(cid:70)(cid:12)(cid:11)(cid:4)(cid:14)(cid:11)(cid:48)(cid:48)(cid:7)(cid:5)(cid:3)(cid:9)(cid:2)(cid:12)(cid:11)(cid:4)(cid:14)(cid:11)(cid:48)(cid:48)(cid:7)(cid:5)(cid:3)(cid:9)(cid:2)(cid:28)(cid:3,Unknown,1337.0
Unknown,Unknown,70,Unknown,Unknown,Unknown,Unknown,cid:3)(cid:5)(cid:14)(cid:70)(cid:12)(cid:11)(cid:4)(cid:14)(cid:11)(cid:48)(cid:48)(cid:7)(cid:5)(cid:3)(cid:9)(cid:2)(cid:12)(cid:11)(cid:4)(cid:14)(cid:11)(cid:48)(cid:48)(cid:7)(cid:5)(cid:3)(cid:9)(cid:2)(cid:28)(cid:3,Unknown,1407.0
Unknown,Unknown,12,Unknown,Unknown,Unknown,Unknown,cid:3)(cid:5)(cid:14)(cid:70)(cid:12)(cid:11)(cid:4)(cid:14)(cid:11)(cid:48)(cid:48)(cid:7)(cid:5)(cid:3)(cid:9)(cid:2)(cid:12)(cid:11)(cid:4)(cid:14)(cid:11)(cid:48)(cid:48)(cid:7)(cid:5)(cid:3)(cid:9)(cid:2)(cid:28)(cid:3,Unknown,1419.0
Unknown,Unknown,11,Unknown,Unknown,Unknown,Unknown,cid:3)(cid:5)(cid:14)(cid:70)(cid:12)(cid:11)(cid:4)(cid:14)(cid:11)(cid:48)(cid:48)(cid:7)(cid:5)(cid:3)(cid:9)(cid:2)(cid:12)(cid:11)(cid:4)(cid:14)(cid:11)(cid:48)(cid:48)(cid:7)(cid:5)(cid:3)(cid:9)(cid:2)(cid:28)(cid:3,Unknown,1430.0
Unknown,Unknown,4,Unknown,Unknown,Unknown,Unknown,cid:3)(cid:5)(cid:14)(cid:70)(cid:12)(cid:11)(cid:4)(cid:14)(cid:11)(cid:48)(cid:48)(cid:7)(cid:5)(cid:3)(cid:9)(cid:2)(cid:12)(cid:11)(cid:4)(cid:14)(cid:11)(cid:48)(cid:48)(cid:7)(cid:5)(cid:3)(cid:9)(cid:2)(cid:28)(cid:3,Unknown,1434.0
Unknown,Unknown,14,Unknown,Unknown,Unknown,Unknown,cid:3)(cid:5)(cid:14)(cid:70)(cid:12)(cid:11)(cid:4)(cid:14)(cid:11)(cid:48)(cid:48)(cid:7)(cid:5)(cid:3)(cid:9)(cid:2)(cid:12)(cid:11)(cid:4)(cid:14)(cid:11)(cid:48)(cid:48)(cid:7)(cid:5)(cid:3)(cid:9)(cid:2)(cid:28)(cid:3,Unknown,1448.0
Unknown,Unknown,11,Unknown,Unknown,Unknown,Unknown,cid:3)(cid:5)(cid:14)(cid:70)(cid:12)(cid:11)(cid:4)(cid:14)(cid:11)(cid:48)(cid:48)(cid:7)(cid:5)(cid:3)(cid:9)(cid:2)(cid:12)(cid:11)(cid:4)(cid:14)(cid:11)(cid:48)(cid:48)(cid:7)(cid:5)(cid:3)(cid:9)(cid:2)(cid:28)(cid:3,Unknown,1459.0
Unknown,Unknown,48,Unknown,Unknown,Unknown,Unknown,cid:3)(cid:5)(cid:14)(cid:70)(cid:12)(cid:11)(cid:4)(cid:14)(cid:11)(cid:48)(cid:48)(cid:7)(cid:5)(cid:3)(cid:9)(cid:2)(cid:12)(cid:11)(cid:4)(cid:14)(cid:11)(cid:48)(cid:48)(cid:7)(cid:5)(cid:3)(cid:9)(cid:2)(cid:28)(cid:3,Unknown,1507.0
Unknown,Unknown,48,Unknown,Unknown,Unknown,Unknown,cid:3)(cid:5)(cid:14)(cid:70)(cid:12)(cid:11)(cid:4)(cid:14)(cid:11)(cid:48)(cid:48)(cid:7)(cid:5)(cid:3)(cid:9)(cid:2)(cid:12)(cid:11)(cid:4)(cid:14)(cid:11)(cid:48)(cid:48)(cid:7)(cid:5)(cid:3)(cid:9)(cid:2)(cid:28)(cid:3,Unknown,1555.0
Unknown,Unknown,7,Unknown,Unknown,Unknown,Unknown,cid:3)(cid:5)(cid:14)(cid:70)(cid:12)(cid:11)(cid:4)(cid:14)(cid:11)(cid:48)(cid:48)(cid:7)(cid:5)(cid:3)(cid:9)(cid:2)(cid:12)(cid:11)(cid:4)(cid:14)(cid:11)(cid:48)(cid:48)(cid:7)(cid:5)(cid:3)(cid:9)(cid:2)(cid:28)(cid:3,Unknown,1562.0
Unknown,Unknown,5,Unknown,Unknown,Unknown,Unknown,cid:3)(cid:5)(cid:14)(cid:70)(cid:12)(cid:11)(cid:4)(cid:14)(cid:11)(cid:48)(cid:48)(cid:7)(cid:5)(cid:3)(cid:9)(cid:2)(cid:12)(cid:11)(cid:4)(cid:14)(cid:11)(cid:48)(cid:48)(cid:7)(cid:5)(cid:3)(cid:9)(cid:2)(cid:28)(cid:3,Unknown,1567.0
Unknown,Unknown,3,Unknown,Unknown,Unknown,Unknown,cid:3)(cid:5)(cid:14)(cid:70)(cid:12)(cid:11)(cid:4)(cid:14)(cid:11)(cid:48)(cid:48)(cid:7)(cid:5)(cid:3)(cid:9)(cid:2)(cid:12)(cid:11)(cid:4)(cid:14)(cid:11)(cid:48)(cid:48)(cid:7)(cid:5)(cid:3)(cid:9)(cid:2)(cid:28)(cid:3,Unknown,1570.0
Unknown,Unknown,9,Unknown,Unknown,Unknown,Unknown,cid:3)(cid:5)(cid:14)(cid:70)(cid:12)(cid:11)(cid:4)(cid:14)(cid:11)(cid:48)(cid:48)(cid:7)(cid:5)(cid:3)(cid:9)(cid:2)(cid:12)(cid:11)(cid:4)(cid:14)(cid:11)(cid:48)(cid:48)(cid:7)(cid:5)(cid:3)(cid:9)(cid:2)(cid:28)(cid:3,Unknown,1579.0
Unknown,Unknown,2,Unknown,Unknown,Unknown,Unknown,cid:3)(cid:5)(cid:14)(cid:70)(cid:12)(cid:11)(cid:4)(cid:14)(cid:11)(cid:48)(cid:48)(cid:7)(cid:5)(cid:3)(cid:9)(cid:2)(cid:12)(cid:11)(cid:4)(cid:14)(cid:11)(cid:48)(cid:48)(cid:7)(cid:5)(cid:3)(cid:9)(cid:2)(cid:28)(cid:3,Unknown,1581.0
Unknown,Unknown,12,Unknown,Unknown,Unknown,Unknown,cid:3)(cid:5)(cid:14)(cid:70)(cid:12)(cid:11)(cid:4)(cid:14)(cid:11)(cid:48)(cid:48)(cid:7)(cid:5)(cid:3)(cid:9)(cid:2)(cid:12)(cid:11)(cid:4)(cid:14)(cid:11)(cid:48)(cid:48)(cid:7)(cid:5)(cid:3)(cid:9)(cid:2)(cid:28)(cid:3,Unknown,1593.0
Unknown,Unknown,11,Unknown,Unknown,Unknown,Unknown,cid:3)(cid:5)(cid:14)(cid:70)(cid:12)(cid:11)(cid:4)(cid:14)(cid:11)(cid:48)(cid:48)(cid:7)(cid:5)(cid:3)(cid:9)(cid:2)(cid:12)(cid:11)(cid:4)(cid:14)(cid:11)(cid:48)(cid:48)(cid:7)(cid:5)(cid:3)(cid:9)(cid:2)(cid:28)(cid:3,Unknown,1604.0
Unknown,Unknown,4,Unknown,Unknown,Unknown,Unknown,cid:3)(cid:5)(cid:14)(cid:70)(cid:12)(cid:11)(cid:4)(cid:14)(cid:11)(cid:48)(cid:48)(cid:7)(cid:5)(cid:3)(cid:9)(cid:2)(cid:12)(cid:11)(cid:4)(cid:14)(cid:11)(cid:48)(cid:48)(cid:7)(cid:5)(cid:3)(cid:9)(cid:2)(cid:28)(cid:3,Unknown,1608.0
Unknown,Unknown,14,Unknown,Unknown,Unknown,Unknown,cid:3)(cid:5)(cid:14)(cid:70)(cid:12)(cid:11)(cid:4)(cid:14)(cid:11)(cid:48)(cid:48)(cid:7)(cid:5)(cid:3)(cid:9)(cid:2)(cid:12)(cid:11)(cid:4)(cid:14)(cid:11)(cid:48)(cid:48)(cid:7)(cid:5)(cid:3)(cid:9)(cid:2)(cid:28)(cid:3,Unknown,1622.0
Unknown,Unknown,11,Unknown,Unknown,Unknown,Unknown,cid:3)(cid:5)(cid:14)(cid:70)(cid:12)(cid:11)(cid:4)(cid:14)(cid:11)(cid:48)(cid:48)(cid:7)(cid:5)(cid:3)(cid:9)(cid:2)(cid:12)(cid:11)(cid:4)(cid:14)(cid:11)(cid:48)(cid:48)(cid:7)(cid:5)(cid:3)(cid:9)(cid:2)(cid:28)(cid:3,Unknown,1633.0
Unknown,Unknown,48,Unknown,Unknown,Unknown,Unknown,cid:3)(cid:5)(cid:14)(cid:70)(cid:12)(cid:11)(cid:4)(cid:14)(cid:11)(cid:48)(cid:48)(cid:7)(cid:5)(cid:3)(cid:9)(cid:2)(cid:12)(cid:11)(cid:4)(cid:14)(cid:11)(cid:48)(cid:48)(cid:7)(cid:5)(cid:3)(cid:9)(cid:2)(cid:28)(cid:3,Unknown,1681.0
Unknown,Unknown,48,Unknown,Unknown,Unknown,Unknown,cid:3)(cid:5)(cid:14)(cid:70)(cid:12)(cid:11)(cid:4)(cid:14)(cid:11)(cid:48)(cid:48)(cid:7)(cid:5)(cid:3)(cid:9)(cid:2)(cid:12)(cid:11)(cid:4)(cid:14)(cid:11)(cid:48)(cid:48)(cid:7)(cid:5)(cid:3)(cid:9)(cid:2)(cid:28)(cid:3,Unknown,1729.0
Unknown,Unknown,7,Unknown,Unknown,Unknown,Unknown,cid:3)(cid:5)(cid:14)(cid:70)(cid:12)(cid:11)(cid:4)(cid:14)(cid:11)(cid:48)(cid:48)(cid:7)(cid:5)(cid:3)(cid:9)(cid:2)(cid:12)(cid:11)(cid:4)(cid:14)(cid:11)(cid:48)(cid:48)(cid:7)(cid:5)(cid:3)(cid:9)(cid:2)(cid:28)(cid:3,Unknown,1736.0
Unknown,Unknown,5,Unknown,Unknown,Unknown,Unknown,cid:3)(cid:5)(cid:14)(cid:70)(cid:12)(cid:11)(cid:4)(cid:14)(cid:11)(cid:48)(cid:48)(cid:7)(cid:5)(cid:3)(cid:9)(cid:2)(cid:12)(cid:11)(cid:4)(cid:14)(cid:11)(cid:48)(cid:48)(cid:7)(cid:5)(cid:3)(cid:9)(cid:2)(cid:28)(cid:3,Unknown,1741.0
Unknown,Unknown,3,Unknown,Unknown,Unknown,Unknown,cid:3)(cid:5)(cid:14)(cid:70)(cid:12)(cid:11)(cid:4)(cid:14)(cid:11)(cid:48)(cid:48)(cid:7)(cid:5)(cid:3)(cid:9)(cid:2)(cid:12)(cid:11)(cid:4)(cid:14)(cid:11)(cid:48)(cid:48)(cid:7)(cid:5)(cid:3)(cid:9)(cid:2)(cid:28)(cid:3,Unknown,1744.0
Unknown,Unknown,9,Unknown,Unknown,Unknown,Unknown,cid:3)(cid:5)(cid:14)(cid:70)(cid:12)(cid:11)(cid:4)(cid:14)(cid:11)(cid:48)(cid:48)(cid:7)(cid:5)(cid:3)(cid:9)(cid:2)(cid:12)(cid:11)(cid:4)(cid:14)(cid:11)(cid:48)(cid:48)(cid:7)(cid:5)(cid:3)(cid:9)(cid:2)(cid:28)(cid:3,Unknown,1753.0
Unknown,Unknown,2,Unknown,Unknown,Unknown,Unknown,cid:3)(cid:5)(cid:14)(cid:70)(cid:12)(cid:11)(cid:4)(cid:14)(cid:11)(cid:48)(cid:48)(cid:7)(cid:5)(cid:3)(cid:9)(cid:2)(cid:12)(cid:11)(cid:4)(cid:14)(cid:11)(cid:48)(cid:48)(cid:7)(cid:5)(cid:3)(cid:9)(cid:2)(cid:28)(cid:3,Unknown,1755.0
Unknown,Unknown,28,Unknown,Unknown,Unknown,Unknown,cid:3)(cid:5)(cid:14)(cid:70)(cid:12)(cid:11)(cid:4)(cid:14)(cid:11)(cid:48)(cid:48)(cid:7)(cid:5)(cid:3)(cid:9)(cid:2)(cid:12)(cid:11)(cid:4)(cid:14)(cid:11)(cid:48)(cid:48)(cid:7)(cid:5)(cid:3)(cid:9)(cid:2)(cid:28)(cid:3,Unknown,1783.0
Unknown,Unknown,3,Unknown,Unknown,Unknown,Unknown,cid:3)(cid:5)(cid:14)(cid:70)(cid:12)(cid:11)(cid:4)(cid:14)(cid:11)(cid:48)(cid:48)(cid:7)(cid:5)(cid:3)(cid:9)(cid:2)(cid:12)(cid:11)(cid:4)(cid:14)(cid:11)(cid:48)(cid:48)(cid:7)(cid:5)(cid:3)(cid:9)(cid:2)(cid:28)(cid:3,Unknown,1786.0
Unknown,Unknown,15,Unknown,Unknown,Unknown,Unknown,cid:3)(cid:5)(cid:14)(cid:70)(cid:12)(cid:11)(cid:4)(cid:14)(cid:11)(cid:48)(cid:48)(cid:7)(cid:5)(cid:3)(cid:9)(cid:2)(cid:12)(cid:11)(cid:4)(cid:14)(cid:11)(cid:48)(cid:48)(cid:7)(cid:5)(cid:3)(cid:9)(cid:2)(cid:28)(cid:3,Unknown,1801.0
Unknown,Unknown,2,Unknown,Unknown,Unknown,Unknown,cid:3)(cid:5)(cid:14)(cid:70)(cid:12)(cid:11)(cid:4)(cid:14)(cid:11)(cid:48)(cid:48)(cid:7)(cid:5)(cid:3)(cid:9)(cid:2)(cid:12)(cid:11)(cid:4)(cid:14)(cid:11)(cid:48)(cid:48)(cid:7)(cid:5)(cid:3)(cid:9)(cid:2)(cid:28)(cid:3,Unknown,1803.0
Unknown,Unknown,34,Unknown,Unknown,Unknown,Unknown,cid:3)(cid:5)(cid:14)(cid:70)(cid:12)(cid:11)(cid:4)(cid:14)(cid:11)(cid:48)(cid:48)(cid:7)(cid:5)(cid:3)(cid:9)(cid:2)(cid:12)(cid:11)(cid:4)(cid:14)(cid:11)(cid:48)(cid:48)(cid:7)(cid:5)(cid:3)(cid:9)(cid:2)(cid:28)(cid:3,Unknown,1837.0
Unknown,Unknown,18,Unknown,Unknown,Unknown,Unknown,cid:3)(cid:5)(cid:14)(cid:70)(cid:12)(cid:11)(cid:4)(cid:14)(cid:11)(cid:48)(cid:48)(cid:7)(cid:5)(cid:3)(cid:9)(cid:2)(cid:12)(cid:11)(cid:4)(cid:14)(cid:11)(cid:48)(cid:48)(cid:7)(cid:5)(cid:3)(cid:9)(cid:2)(cid:28)(cid:3,Unknown,1855.0
Unknown,Unknown,19,Unknown,Unknown,Unknown,Unknown,cid:3)(cid:5)(cid:14)(cid:70)(cid:12)(cid:11)(cid:4)(cid:14)(cid:11)(cid:48)(cid:48)(cid:7)(cid:5)(cid:3)(cid:9)(cid:2)(cid:12)(cid:11)(cid:4)(cid:14)(cid:11)(cid:48)(cid:48)(cid:7)(cid:5)(cid:3)(cid:9)(cid:2)(cid:28)(cid:3,Unknown,1874.0
Unknown,Unknown,18,Unknown,Unknown,Unknown,Unknown,cid:3)(cid:5)(cid:14)(cid:70)(cid:12)(cid:11)(cid:4)(cid:14)(cid:11)(cid:48)(cid:48)(cid:7)(cid:5)(cid:3)(cid:9)(cid:2)(cid:12)(cid:11)(cid:4)(cid:14)(cid:11)(cid:48)(cid:48)(cid:7)(cid:5)(cid:3)(cid:9)(cid:2)(cid:28)(cid:3,Unknown,1892.0
Unknown,Unknown,18,Unknown,Unknown,Unknown,Unknown,cid:3)(cid:5)(cid:14)(cid:70)(cid:12)(cid:11)(cid:4)(cid:14)(cid:11)(cid:48)(cid:48)(cid:7)(cid:5)(cid:3)(cid:9)(cid:2)(cid:12)(cid:11)(cid:4)(cid:14)(cid:11)(cid:48)(cid:48)(cid:7)(cid:5)(cid:3)(cid:9)(cid:2)(cid:28)(cid:3,Unknown,1910.0
Unknown,Unknown,2,Unknown,Unknown,Unknown,Unknown,cid:3)(cid:5)(cid:14)(cid:70)(cid:12)(cid:11)(cid:4)(cid:14)(cid:11)(cid:48)(cid:48)(cid:7)(cid:5)(cid:3)(cid:9)(cid:2)(cid:12)(cid:11)(cid:4)(cid:14)(cid:11)(cid:48)(cid:48)(cid:7)(cid:5)(cid:3)(cid:9)(cid:2)(cid:28)(cid:3,Unknown,1912.0
Unknown,Unknown,44,Unknown,Unknown,Unknown,Unknown,cid:3)(cid:5)(cid:14)(cid:70)(cid:12)(cid:11)(cid:4)(cid:14)(cid:11)(cid:48)(cid:48)(cid:7)(cid:5)(cid:3)(cid:9)(cid:2)(cid:12)(cid:11)(cid:4)(cid:14)(cid:11)(cid:48)(cid:48)(cid:7)(cid:5)(cid:3)(cid:9)(cid:2)(cid:28)(cid:3,Unknown,1956.0
Unknown,Unknown,12,Unknown,Unknown,Unknown,Unknown,cid:3)(cid:5)(cid:14)(cid:70)(cid:12)(cid:11)(cid:4)(cid:14)(cid:11)(cid:48)(cid:48)(cid:7)(cid:5)(cid:3)(cid:9)(cid:2)(cid:12)(cid:11)(cid:4)(cid:14)(cid:11)(cid:48)(cid:48)(cid:7)(cid:5)(cid:3)(cid:9)(cid:2)(cid:28)(cid:3,Unknown,1968.0
Unknown,Unknown,29,Unknown,Unknown,Unknown,Unknown,cid:3)(cid:5)(cid:14)(cid:70)(cid:12)(cid:11)(cid:4)(cid:14)(cid:11)(cid:48)(cid:48)(cid:7)(cid:5)(cid:3)(cid:9)(cid:2)(cid:12)(cid:11)(cid:4)(cid:14)(cid:11)(cid:48)(cid:48)(cid:7)(cid:5)(cid:3)(cid:9)(cid:2)(cid:28)(cid:3,Unknown,1997.0
Unknown,Unknown,26,Unknown,Unknown,Unknown,Unknown,cid:3)(cid:5)(cid:14)(cid:70)(cid:12)(cid:11)(cid:4)(cid:14)(cid:11)(cid:48)(cid:48)(cid:7)(cid:5)(cid:3)(cid:9)(cid:2)(cid:12)(cid:11)(cid:4)(cid:14)(cid:11)(cid:48)(cid:48)(cid:7)(cid:5)(cid:3)(cid:9)(cid:2)(cid:28)(cid:3,Unknown,2023.0
Unknown,Unknown,41,Unknown,Unknown,Unknown,Unknown,cid:3)(cid:5)(cid:14)(cid:70)(cid:12)(cid:11)(cid:4)(cid:14)(cid:11)(cid:48)(cid:48)(cid:7)(cid:5)(cid:3)(cid:9)(cid:2)(cid:12)(cid:11)(cid:4)(cid:14)(cid:11)(cid:48)(cid:48)(cid:7)(cid:5)(cid:3)(cid:9)(cid:2)(cid:28)(cid:3,Unknown,2064.0
Unknown,Unknown,25,Unknown,Unknown,Unknown,Unknown,cid:3)(cid:5)(cid:14)(cid:70)(cid:12)(cid:11)(cid:4)(cid:14)(cid:11)(cid:48)(cid:48)(cid:7)(cid:5)(cid:3)(cid:9)(cid:2)(cid:12)(cid:11)(cid:4)(cid:14)(cid:11)(cid:48)(cid:48)(cid:7)(cid:5)(cid:3)(cid:9)(cid:2)(cid:28)(cid:3,Unknown,2089.0
Unknown,Unknown,2,Unknown,Unknown,Unknown,Unknown,cid:3)(cid:5)(cid:14)(cid:70)(cid:12)(cid:11)(cid:4)(cid:14)(cid:11)(cid:48)(cid:48)(cid:7)(cid:5)(cid:3)(cid:9)(cid:2)(cid:12)(cid:11)(cid:4)(cid:14)(cid:11)(cid:48)(cid:48)(cid:7)(cid:5)(cid:3)(cid:9)(cid:2)(cid:28)(cid:3,Unknown,2091.0
Unknown,Unknown,58,Unknown,Unknown,Unknown,Unknown,cid:3)(cid:5)(cid:14)(cid:70)(cid:12)(cid:11)(cid:4)(cid:14)(cid:11)(cid:48)(cid:48)(cid:7)(cid:5)(cid:3)(cid:9)(cid:2)(cid:12)(cid:11)(cid:4)(cid:14)(cid:11)(cid:48)(cid:48)(cid:7)(cid:5)(cid:3)(cid:9)(cid:2)(cid:28)(cid:3,Unknown,2149.0
Unknown,Unknown,58,Unknown,Unknown,Unknown,Unknown,cid:3)(cid:5)(cid:14)(cid:70)(cid:12)(cid:11)(cid:4)(cid:14)(cid:11)(cid:48)(cid:48)(cid:7)(cid:5)(cid:3)(cid:9)(cid:2)(cid:12)(cid:11)(cid:4)(cid:14)(cid:11)(cid:48)(cid:48)(cid:7)(cid:5)(cid:3)(cid:9)(cid:2)(cid:28)(cid:3,Unknown,2207.0
Unknown,Unknown,37,Unknown,Unknown,Unknown,Unknown,cid:3)(cid:5)(cid:14)(cid:70)(cid:12)(cid:11)(cid:4)(cid:14)(cid:11)(cid:48)(cid:48)(cid:7)(cid:5)(cid:3)(cid:9)(cid:2)(cid:12)(cid:11)(cid:4)(cid:14)(cid:11)(cid:48)(cid:48)(cid:7)(cid:5)(cid:3)(cid:9)(cid:2)(cid:28)(cid:3,Unknown,2244.0
Unknown,Unknown,16,Unknown,Unknown,Unknown,Unknown,cid:3)(cid:5)(cid:14)(cid:70)(cid:12)(cid:11)(cid:4)(cid:14)(cid:11)(cid:48)(cid:48)(cid:7)(cid:5)(cid:3)(cid:9)(cid:2)(cid:12)(cid:11)(cid:4)(cid:14)(cid:11)(cid:48)(cid:48)(cid:7)(cid:5)(cid:3)(cid:9)(cid:2)(cid:28)(cid:3,Unknown,2260.0
Unknown,Unknown,34,Unknown,Unknown,Unknown,Unknown,cid:3)(cid:5)(cid:14)(cid:70)(cid:12)(cid:11)(cid:4)(cid:14)(cid:11)(cid:48)(cid:48)(cid:7)(cid:5)(cid:3)(cid:9)(cid:2)(cid:12)(cid:11)(cid:4)(cid:14)(cid:11)(cid:48)(cid:48)(cid:7)(cid:5)(cid:3)(cid:9)(cid:2)(cid:28)(cid:3,Unknown,2294.0
Unknown,Unknown,33,Unknown,Unknown,Unknown,Unknown,cid:3)(cid:5)(cid:14)(cid:70)(cid:12)(cid:11)(cid:4)(cid:14)(cid:11)(cid:48)(cid:48)(cid:7)(cid:5)(cid:3)(cid:9)(cid:2)(cid:12)(cid:11)(cid:4)(cid:14)(cid:11)(cid:48)(cid:48)(cid:7)(cid:5)(cid:3)(cid:9)(cid:2)(cid:28)(cid:3,Unknown,2327.0
Unknown,Unknown,17,Unknown,Unknown,Unknown,Unknown,cid:3)(cid:5)(cid:14)(cid:70)(cid:12)(cid:11)(cid:4)(cid:14)(cid:11)(cid:48)(cid:48)(cid:7)(cid:5)(cid:3)(cid:9)(cid:2)(cid:12)(cid:11)(cid:4)(cid:14)(cid:11)(cid:48)(cid:48)(cid:7)(cid:5)(cid:3)(cid:9)(cid:2)(cid:28)(cid:3,Unknown,2344.0
Unknown,Unknown,18,Unknown,Unknown,Unknown,Unknown,cid:3)(cid:5)(cid:14)(cid:70)(cid:12)(cid:11)(cid:4)(cid:14)(cid:11)(cid:48)(cid:48)(cid:7)(cid:5)(cid:3)(cid:9)(cid:2)(cid:12)(cid:11)(cid:4)(cid:14)(cid:11)(cid:48)(cid:48)(cid:7)(cid:5)(cid:3)(cid:9)(cid:2)(cid:28)(cid:3,Unknown,2362.0
Unknown,Unknown,45,Unknown,Unknown,Unknown,Unknown,cid:3)(cid:5)(cid:14)(cid:70)(cid:12)(cid:11)(cid:4)(cid:14)(cid:11)(cid:48)(cid:48)(cid:7)(cid:5)(cid:3)(cid:9)(cid:2)(cid:12)(cid:11)(cid:4)(cid:14)(cid:11)(cid:48)(cid:48)(cid:7)(cid:5)(cid:3)(cid:9)(cid:2)(cid:28)(cid:3,Unknown,2407.0
Unknown,Unknown,18,Unknown,Unknown,Unknown,Unknown,cid:3)(cid:5)(cid:14)(cid:70)(cid:12)(cid:11)(cid:4)(cid:14)(cid:11)(cid:48)(cid:48)(cid:7)(cid:5)(cid:3)(cid:9)(cid:2)(cid:12)(cid:11)(cid:4)(cid:14)(cid:11)(cid:48)(cid:48)(cid:7)(cid:5)(cid:3)(cid:9)(cid:2)(cid:28)(cid:3,Unknown,2425.0
Unknown,Unknown,16,Unknown,Unknown,Unknown,Unknown,cid:3)(cid:5)(cid:14)(cid:70)(cid:12)(cid:11)(cid:4)(cid:14)(cid:11)(cid:48)(cid:48)(cid:7)(cid:5)(cid:3)(cid:9)(cid:2)(cid:12)(cid:11)(cid:4)(cid:14)(cid:11)(cid:48)(cid:48)(cid:7)(cid:5)(cid:3)(cid:9)(cid:2)(cid:28)(cid:3,Unknown,2441.0
Unknown,Unknown,14,Unknown,Unknown,Unknown,Unknown,cid:3)(cid:5)(cid:14)(cid:70)(cid:12)(cid:11)(cid:4)(cid:14)(cid:11)(cid:48)(cid:48)(cid:7)(cid:5)(cid:3)(cid:9)(cid:2)(cid:12)(cid:11)(cid:4)(cid:14)(cid:11)(cid:48)(cid:48)(cid:7)(cid:5)(cid:3)(cid:9)(cid:2)(cid:28)(cid:3,Unknown,2455.0
Unknown,Unknown,69,Unknown,Unknown,Unknown,Unknown,cid:3)(cid:5)(cid:14)(cid:70)(cid:12)(cid:11)(cid:4)(cid:14)(cid:11)(cid:48)(cid:48)(cid:7)(cid:5)(cid:3)(cid:9)(cid:2)(cid:12)(cid:11)(cid:4)(cid:14)(cid:11)(cid:48)(cid:48)(cid:7)(cid:5)(cid:3)(cid:9)(cid:2)(cid:28)(cid:3,Unknown,2524.0
Unknown,Unknown,46,Unknown,Unknown,Unknown,Unknown,cid:3)(cid:5)(cid:14)(cid:70)(cid:12)(cid:11)(cid:4)(cid:14)(cid:11)(cid:48)(cid:48)(cid:7)(cid:5)(cid:3)(cid:9)(cid:2)(cid:12)(cid:11)(cid:4)(cid:14)(cid:11)(cid:48)(cid:48)(cid:7)(cid:5)(cid:3)(cid:9)(cid:2)(cid:28)(cid:3,Unknown,2570.0
Unknown,Unknown,47,Unknown,Unknown,Unknown,Unknown,cid:3)(cid:5)(cid:14)(cid:70)(cid:12)(cid:11)(cid:4)(cid:14)(cid:11)(cid:48)(cid:48)(cid:7)(cid:5)(cid:3)(cid:9)(cid:2)(cid:12)(cid:11)(cid:4)(cid:14)(cid:11)(cid:48)(cid:48)(cid:7)(cid:5)(cid:3)(cid:9)(cid:2)(cid:28)(cid:3,Unknown,2617.0
Unknown,Unknown,46,Unknown,Unknown,Unknown,Unknown,cid:3)(cid:5)(cid:14)(cid:70)(cid:12)(cid:11)(cid:4)(cid:14)(cid:11)(cid:48)(cid:48)(cid:7)(cid:5)(cid:3)(cid:9)(cid:2)(cid:12)(cid:11)(cid:4)(cid:14)(cid:11)(cid:48)(cid:48)(cid:7)(cid:5)(cid:3)(cid:9)(cid:2)(cid:28)(cid:3,Unknown,2663.0
Unknown,Unknown,10,Unknown,Unknown,Unknown,Unknown,cid:3)(cid:5)(cid:14)(cid:70)(cid:12)(cid:11)(cid:4)(cid:14)(cid:11)(cid:48)(cid:48)(cid:7)(cid:5)(cid:3)(cid:9)(cid:2)(cid:12)(cid:11)(cid:4)(cid:14)(cid:11)(cid:48)(cid:48)(cid:7)(cid:5)(cid:3)(cid:9)(cid:2)(cid:28)(cid:3,Unknown,2673.0
Unknown,Unknown,10,Unknown,Unknown,Unknown,Unknown,cid:3)(cid:5)(cid:14)(cid:70)(cid:12)(cid:11)(cid:4)(cid:14)(cid:11)(cid:48)(cid:48)(cid:7)(cid:5)(cid:3)(cid:9)(cid:2)(cid:12)(cid:11)(cid:4)(cid:14)(cid:11)(cid:48)(cid:48)(cid:7)(cid:5)(cid:3)(cid:9)(cid:2)(cid:28)(cid:3,Unknown,2683.0
Unknown,Unknown,11,Unknown,Unknown,Unknown,Unknown,cid:3)(cid:5)(cid:14)(cid:70)(cid:12)(cid:11)(cid:4)(cid:14)(cid:11)(cid:48)(cid:48)(cid:7)(cid:5)(cid:3)(cid:9)(cid:2)(cid:12)(cid:11)(cid:4)(cid:14)(cid:11)(cid:48)(cid:48)(cid:7)(cid:5)(cid:3)(cid:9)(cid:2)(cid:28)(cid:3,Unknown,2694.0
Unknown,Unknown,7,Unknown,Unknown,Unknown,Unknown,cid:3)(cid:5)(cid:14)(cid:70)(cid:12)(cid:11)(cid:4)(cid:14)(cid:11)(cid:48)(cid:48)(cid:7)(cid:5)(cid:3)(cid:9)(cid:2)(cid:12)(cid:11)(cid:4)(cid:14)(cid:11)(cid:48)(cid:48)(cid:7)(cid:5)(cid:3)(cid:9)(cid:2)(cid:28)(cid:3,Unknown,2701.0
Unknown,Unknown,3,Unknown,Unknown,Unknown,Unknown,cid:3)(cid:5)(cid:14)(cid:70)(cid:12)(cid:11)(cid:4)(cid:14)(cid:11)(cid:48)(cid:48)(cid:7)(cid:5)(cid:3)(cid:9)(cid:2)(cid:12)(cid:11)(cid:4)(cid:14)(cid:11)(cid:48)(cid:48)(cid:7)(cid:5)(cid:3)(cid:9)(cid:2)(cid:28)(cid:3,Unknown,2704.0
Unknown,Unknown,2,Unknown,Unknown,Unknown,Unknown,cid:3)(cid:5)(cid:14)(cid:70)(cid:12)(cid:11)(cid:4)(cid:14)(cid:11)(cid:48)(cid:48)(cid:7)(cid:5)(cid:3)(cid:9)(cid:2)(cid:12)(cid:11)(cid:4)(cid:14)(cid:11)(cid:48)(cid:48)(cid:7)(cid:5)(cid:3)(cid:9)(cid:2)(cid:28)(cid:3,Unknown,2706.0
Unknown,Unknown,50,Unknown,Unknown,Unknown,Unknown,cid:3)(cid:5)(cid:14)(cid:70)(cid:12)(cid:11)(cid:4)(cid:14)(cid:11)(cid:48)(cid:48)(cid:7)(cid:5)(cid:3)(cid:9)(cid:2)(cid:12)(cid:11)(cid:4)(cid:14)(cid:11)(cid:48)(cid:48)(cid:7)(cid:5)(cid:3)(cid:9)(cid:2)(cid:28)(cid:3,Unknown,2756.0
Unknown,Unknown,5,Unknown,Unknown,Unknown,Unknown,cid:3)(cid:5)(cid:14)(cid:70)(cid:12)(cid:11)(cid:4)(cid:14)(cid:11)(cid:48)(cid:48)(cid:7)(cid:5)(cid:3)(cid:9)(cid:2)(cid:12)(cid:11)(cid:4)(cid:14)(cid:11)(cid:48)(cid:48)(cid:7)(cid:5)(cid:3)(cid:9)(cid:2)(cid:28)(cid:3,Unknown,2761.0
Unknown,Unknown,2,Unknown,Unknown,Unknown,Unknown,cid:3)(cid:5)(cid:14)(cid:70)(cid:12)(cid:11)(cid:4)(cid:14)(cid:11)(cid:48)(cid:48)(cid:7)(cid:5)(cid:3)(cid:9)(cid:2)(cid:12)(cid:11)(cid:4)(cid:14)(cid:11)(cid:48)(cid:48)(cid:7)(cid:5)(cid:3)(cid:9)(cid:2)(cid:28)(cid:3,Unknown,2763.0
Unknown,Unknown,14,Unknown,Unknown,Unknown,Unknown,cid:3)(cid:5)(cid:14)(cid:70)(cid:12)(cid:11)(cid:4)(cid:14)(cid:11)(cid:48)(cid:48)(cid:7)(cid:5)(cid:3)(cid:9)(cid:2)(cid:12)(cid:11)(cid:4)(cid:14)(cid:11)(cid:48)(cid:48)(cid:7)(cid:5)(cid:3)(cid:9)(cid:2)(cid:28)(cid:3,Unknown,2777.0
Unknown,Unknown,2,Unknown,Unknown,Unknown,Unknown,cid:3)(cid:5)(cid:14)(cid:70)(cid:12)(cid:11)(cid:4)(cid:14)(cid:11)(cid:48)(cid:48)(cid:7)(cid:5)(cid:3)(cid:9)(cid:2)(cid:12)(cid:11)(cid:4)(cid:14)(cid:11)(cid:48)(cid:48)(cid:7)(cid:5)(cid:3)(cid:9)(cid:2)(cid:28)(cid:3,Unknown,2779.0
Unknown,Unknown,12,Unknown,Unknown,Unknown,Unknown,cid:3)(cid:5)(cid:14)(cid:70)(cid:12)(cid:11)(cid:4)(cid:14)(cid:11)(cid:48)(cid:48)(cid:7)(cid:5)(cid:3)(cid:9)(cid:2)(cid:12)(cid:11)(cid:4)(cid:14)(cid:11)(cid:48)(cid:48)(cid:7)(cid:5)(cid:3)(cid:9)(cid:2)(cid:28)(cid:3,Unknown,2791.0
Unknown,Unknown,11,Unknown,Unknown,Unknown,Unknown,cid:3)(cid:5)(cid:14)(cid:70)(cid:12)(cid:11)(cid:4)(cid:14)(cid:11)(cid:48)(cid:48)(cid:7)(cid:5)(cid:3)(cid:9)(cid:2)(cid:12)(cid:11)(cid:4)(cid:14)(cid:11)(cid:48)(cid:48)(cid:7)(cid:5)(cid:3)(cid:9)(cid:2)(cid:28)(cid:3,Unknown,2802.0
Unknown,Unknown,4,Unknown,Unknown,Unknown,Unknown,cid:3)(cid:5)(cid:14)(cid:70)(cid:12)(cid:11)(cid:4)(cid:14)(cid:11)(cid:48)(cid:48)(cid:7)(cid:5)(cid:3)(cid:9)(cid:2)(cid:12)(cid:11)(cid:4)(cid:14)(cid:11)(cid:48)(cid:48)(cid:7)(cid:5)(cid:3)(cid:9)(cid:2)(cid:28)(cid:3,Unknown,2806.0
Unknown,Unknown,14,Unknown,Unknown,Unknown,Unknown,cid:3)(cid:5)(cid:14)(cid:70)(cid:12)(cid:11)(cid:4)(cid:14)(cid:11)(cid:48)(cid:48)(cid:7)(cid:5)(cid:3)(cid:9)(cid:2)(cid:12)(cid:11)(cid:4)(cid:14)(cid:11)(cid:48)(cid:48)(cid:7)(cid:5)(cid:3)(cid:9)(cid:2)(cid:28)(cid:3,Unknown,2820.0
Unknown,Unknown,11,Unknown,Unknown,Unknown,Unknown,cid:3)(cid:5)(cid:14)(cid:70)(cid:12)(cid:11)(cid:4)(cid:14)(cid:11)(cid:48)(cid:48)(cid:7)(cid:5)(cid:3)(cid:9)(cid:2)(cid:12)(cid:11)(cid:4)(cid:14)(cid:11)(cid:48)(cid:48)(cid:7)(cid:5)(cid:3)(cid:9)(cid:2)(cid:28)(cid:3,Unknown,2831.0
Unknown,Unknown,48,Unknown,Unknown,Unknown,Unknown,cid:3)(cid:5)(cid:14)(cid:70)(cid:12)(cid:11)(cid:4)(cid:14)(cid:11)(cid:48)(cid:48)(cid:7)(cid:5)(cid:3)(cid:9)(cid:2)(cid:12)(cid:11)(cid:4)(cid:14)(cid:11)(cid:48)(cid:48)(cid:7)(cid:5)(cid:3)(cid:9)(cid:2)(cid:28)(cid:3,Unknown,2879.0
Unknown,Unknown,48,Unknown,Unknown,Unknown,Unknown,cid:3)(cid:5)(cid:14)(cid:70)(cid:12)(cid:11)(cid:4)(cid:14)(cid:11)(cid:48)(cid:48)(cid:7)(cid:5)(cid:3)(cid:9)(cid:2)(cid:12)(cid:11)(cid:4)(cid:14)(cid:11)(cid:48)(cid:48)(cid:7)(cid:5)(cid:3)(cid:9)(cid:2)(cid:28)(cid:3,Unknown,2927.0
Unknown,Unknown,7,Unknown,Unknown,Unknown,Unknown,cid:3)(cid:5)(cid:14)(cid:70)(cid:12)(cid:11)(cid:4)(cid:14)(cid:11)(cid:48)(cid:48)(cid:7)(cid:5)(cid:3)(cid:9)(cid:2)(cid:12)(cid:11)(cid:4)(cid:14)(cid:11)(cid:48)(cid:48)(cid:7)(cid:5)(cid:3)(cid:9)(cid:2)(cid:28)(cid:3,Unknown,2934.0
Unknown,Unknown,5,Unknown,Unknown,Unknown,Unknown,cid:3)(cid:5)(cid:14)(cid:70)(cid:12)(cid:11)(cid:4)(cid:14)(cid:11)(cid:48)(cid:48)(cid:7)(cid:5)(cid:3)(cid:9)(cid:2)(cid:12)(cid:11)(cid:4)(cid:14)(cid:11)(cid:48)(cid:48)(cid:7)(cid:5)(cid:3)(cid:9)(cid:2)(cid:28)(cid:3,Unknown,2939.0
Unknown,Unknown,3,Unknown,Unknown,Unknown,Unknown,cid:3)(cid:5)(cid:14)(cid:70)(cid:12)(cid:11)(cid:4)(cid:14)(cid:11)(cid:48)(cid:48)(cid:7)(cid:5)(cid:3)(cid:9)(cid:2)(cid:12)(cid:11)(cid:4)(cid:14)(cid:11)(cid:48)(cid:48)(cid:7)(cid:5)(cid:3)(cid:9)(cid:2)(cid:28)(cid:3,Unknown,2942.0
Unknown,Unknown,9,Unknown,Unknown,Unknown,Unknown,cid:3)(cid:5)(cid:14)(cid:70)(cid:12)(cid:11)(cid:4)(cid:14)(cid:11)(cid:48)(cid:48)(cid:7)(cid:5)(cid:3)(cid:9)(cid:2)(cid:12)(cid:11)(cid:4)(cid:14)(cid:11)(cid:48)(cid:48)(cid:7)(cid:5)(cid:3)(cid:9)(cid:2)(cid:28)(cid:3,Unknown,2951.0
Unknown,Unknown,2,Unknown,Unknown,Unknown,Unknown,cid:3)(cid:5)(cid:14)(cid:70)(cid:12)(cid:11)(cid:4)(cid:14)(cid:11)(cid:48)(cid:48)(cid:7)(cid:5)(cid:3)(cid:9)(cid:2)(cid:12)(cid:11)(cid:4)(cid:14)(cid:11)(cid:48)(cid:48)(cid:7)(cid:5)(cid:3)(cid:9)(cid:2)(cid:28)(cid:3,Unknown,2953.0
Unknown,Unknown,28,Unknown,Unknown,Unknown,Unknown,cid:3)(cid:5)(cid:14)(cid:70)(cid:12)(cid:11)(cid:4)(cid:14)(cid:11)(cid:48)(cid:48)(cid:7)(cid:5)(cid:3)(cid:9)(cid:2)(cid:12)(cid:11)(cid:4)(cid:14)(cid:11)(cid:48)(cid:48)(cid:7)(cid:5)(cid:3)(cid:9)(cid:2)(cid:28)(cid:3,Unknown,2981.0
Unknown,Unknown,3,Unknown,Unknown,Unknown,Unknown,cid:3)(cid:5)(cid:14)(cid:70)(cid:12)(cid:11)(cid:4)(cid:14)(cid:11)(cid:48)(cid:48)(cid:7)(cid:5)(cid:3)(cid:9)(cid:2)(cid:12)(cid:11)(cid:4)(cid:14)(cid:11)(cid:48)(cid:48)(cid:7)(cid:5)(cid:3)(cid:9)(cid:2)(cid:28)(cid:3,Unknown,2984.0
Unknown,Unknown,15,Unknown,Unknown,Unknown,Unknown,cid:3)(cid:5)(cid:14)(cid:70)(cid:12)(cid:11)(cid:4)(cid:14)(cid:11)(cid:48)(cid:48)(cid:7)(cid:5)(cid:3)(cid:9)(cid:2)(cid:12)(cid:11)(cid:4)(cid:14)(cid:11)(cid:48)(cid:48)(cid:7)(cid:5)(cid:3)(cid:9)(cid:2)(cid:28)(cid:3,Unknown,2999.0
Unknown,Unknown,2,Unknown,Unknown,Unknown,Unknown,cid:3)(cid:5)(cid:14)(cid:70)(cid:12)(cid:11)(cid:4)(cid:14)(cid:11)(cid:48)(cid:48)(cid:7)(cid:5)(cid:3)(cid:9)(cid:2)(cid:12)(cid:11)(cid:4)(cid:14)(cid:11)(cid:48)(cid:48)(cid:7)(cid:5)(cid:3)(cid:9)(cid:2)(cid:28)(cid:3,Unknown,3001.0
Unknown,Unknown,34,Unknown,Unknown,Unknown,Unknown,cid:3)(cid:5)(cid:14)(cid:70)(cid:12)(cid:11)(cid:4)(cid:14)(cid:11)(cid:48)(cid:48)(cid:7)(cid:5)(cid:3)(cid:9)(cid:2)(cid:12)(cid:11)(cid:4)(cid:14)(cid:11)(cid:48)(cid:48)(cid:7)(cid:5)(cid:3)(cid:9)(cid:2)(cid:28)(cid:3,Unknown,3035.0
Unknown,Unknown,36,Unknown,Unknown,Unknown,Unknown,cid:3)(cid:5)(cid:14)(cid:70)(cid:12)(cid:11)(cid:4)(cid:14)(cid:11)(cid:48)(cid:48)(cid:7)(cid:5)(cid:3)(cid:9)(cid:2)(cid:12)(cid:11)(cid:4)(cid:14)(cid:11)(cid:48)(cid:48)(cid:7)(cid:5)(cid:3)(cid:9)(cid:2)(cid:28)(cid:3,Unknown,3071.0
Unknown,Unknown,19,Unknown,Unknown,Unknown,Unknown,cid:3)(cid:5)(cid:14)(cid:70)(cid:12)(cid:11)(cid:4)(cid:14)(cid:11)(cid:48)(cid:48)(cid:7)(cid:5)(cid:3)(cid:9)(cid:2)(cid:12)(cid:11)(cid:4)(cid:14)(cid:11)(cid:48)(cid:48)(cid:7)(cid:5)(cid:3)(cid:9)(cid:2)(cid:28)(cid:3,Unknown,3090.0
Unknown,Unknown,16,Unknown,Unknown,Unknown,Unknown,cid:3)(cid:5)(cid:14)(cid:70)(cid:12)(cid:11)(cid:4)(cid:14)(cid:11)(cid:48)(cid:48)(cid:7)(cid:5)(cid:3)(cid:9)(cid:2)(cid:12)(cid:11)(cid:4)(cid:14)(cid:11)(cid:48)(cid:48)(cid:7)(cid:5)(cid:3)(cid:9)(cid:2)(cid:28)(cid:3,Unknown,3106.0
Unknown,Unknown,18,Unknown,Unknown,Unknown,Unknown,cid:3)(cid:5)(cid:14)(cid:70)(cid:12)(cid:11)(cid:4)(cid:14)(cid:11)(cid:48)(cid:48)(cid:7)(cid:5)(cid:3)(cid:9)(cid:2)(cid:12)(cid:11)(cid:4)(cid:14)(cid:11)(cid:48)(cid:48)(cid:7)(cid:5)(cid:3)(cid:9)(cid:2)(cid:28)(cid:3,Unknown,3124.0
Unknown,Unknown,2,Unknown,Unknown,Unknown,Unknown,cid:3)(cid:5)(cid:14)(cid:70)(cid:12)(cid:11)(cid:4)(cid:14)(cid:11)(cid:48)(cid:48)(cid:7)(cid:5)(cid:3)(cid:9)(cid:2)(cid:12)(cid:11)(cid:4)(cid:14)(cid:11)(cid:48)(cid:48)(cid:7)(cid:5)(cid:3)(cid:9)(cid:2)(cid:28)(cid:3,Unknown,3126.0
Unknown,Unknown,44,Unknown,Unknown,Unknown,Unknown,cid:3)(cid:5)(cid:14)(cid:70)(cid:12)(cid:11)(cid:4)(cid:14)(cid:11)(cid:48)(cid:48)(cid:7)(cid:5)(cid:3)(cid:9)(cid:2)(cid:12)(cid:11)(cid:4)(cid:14)(cid:11)(cid:48)(cid:48)(cid:7)(cid:5)(cid:3)(cid:9)(cid:2)(cid:28)(cid:3,Unknown,3170.0
Unknown,Unknown,12,Unknown,Unknown,Unknown,Unknown,cid:3)(cid:5)(cid:14)(cid:70)(cid:12)(cid:11)(cid:4)(cid:14)(cid:11)(cid:48)(cid:48)(cid:7)(cid:5)(cid:3)(cid:9)(cid:2)(cid:12)(cid:11)(cid:4)(cid:14)(cid:11)(cid:48)(cid:48)(cid:7)(cid:5)(cid:3)(cid:9)(cid:2)(cid:28)(cid:3,Unknown,3182.0
Unknown,Unknown,29,Unknown,Unknown,Unknown,Unknown,cid:3)(cid:5)(cid:14)(cid:70)(cid:12)(cid:11)(cid:4)(cid:14)(cid:11)(cid:48)(cid:48)(cid:7)(cid:5)(cid:3)(cid:9)(cid:2)(cid:12)(cid:11)(cid:4)(cid:14)(cid:11)(cid:48)(cid:48)(cid:7)(cid:5)(cid:3)(cid:9)(cid:2)(cid:28)(cid:3,Unknown,3211.0
Unknown,Unknown,26,Unknown,Unknown,Unknown,Unknown,cid:3)(cid:5)(cid:14)(cid:70)(cid:12)(cid:11)(cid:4)(cid:14)(cid:11)(cid:48)(cid:48)(cid:7)(cid:5)(cid:3)(cid:9)(cid:2)(cid:12)(cid:11)(cid:4)(cid:14)(cid:11)(cid:48)(cid:48)(cid:7)(cid:5)(cid:3)(cid:9)(cid:2)(cid:28)(cid:3,Unknown,3237.0
Unknown,Unknown,41,Unknown,Unknown,Unknown,Unknown,cid:3)(cid:5)(cid:14)(cid:70)(cid:12)(cid:11)(cid:4)(cid:14)(cid:11)(cid:48)(cid:48)(cid:7)(cid:5)(cid:3)(cid:9)(cid:2)(cid:12)(cid:11)(cid:4)(cid:14)(cid:11)(cid:48)(cid:48)(cid:7)(cid:5)(cid:3)(cid:9)(cid:2)(cid:28)(cid:3,Unknown,3278.0
Unknown,Unknown,25,Unknown,Unknown,Unknown,Unknown,cid:3)(cid:5)(cid:14)(cid:70)(cid:12)(cid:11)(cid:4)(cid:14)(cid:11)(cid:48)(cid:48)(cid:7)(cid:5)(cid:3)(cid:9)(cid:2)(cid:12)(cid:11)(cid:4)(cid:14)(cid:11)(cid:48)(cid:48)(cid:7)(cid:5)(cid:3)(cid:9)(cid:2)(cid:28)(cid:3,Unknown,3303.0
Unknown,Unknown,2,Unknown,Unknown,Unknown,Unknown,cid:3)(cid:5)(cid:14)(cid:70)(cid:12)(cid:11)(cid:4)(cid:14)(cid:11)(cid:48)(cid:48)(cid:7)(cid:5)(cid:3)(cid:9)(cid:2)(cid:12)(cid:11)(cid:4)(cid:14)(cid:11)(cid:48)(cid:48)(cid:7)(cid:5)(cid:3)(cid:9)(cid:2)(cid:28)(cid:3,Unknown,3305.0
Unknown,Unknown,58,Unknown,Unknown,Unknown,Unknown,cid:3)(cid:5)(cid:14)(cid:70)(cid:12)(cid:11)(cid:4)(cid:14)(cid:11)(cid:48)(cid:48)(cid:7)(cid:5)(cid:3)(cid:9)(cid:2)(cid:12)(cid:11)(cid:4)(cid:14)(cid:11)(cid:48)(cid:48)(cid:7)(cid:5)(cid:3)(cid:9)(cid:2)(cid:28)(cid:3,Unknown,3363.0
Unknown,Unknown,58,Unknown,Unknown,Unknown,Unknown,cid:3)(cid:5)(cid:14)(cid:70)(cid:12)(cid:11)(cid:4)(cid:14)(cid:11)(cid:48)(cid:48)(cid:7)(cid:5)(cid:3)(cid:9)(cid:2)(cid:12)(cid:11)(cid:4)(cid:14)(cid:11)(cid:48)(cid:48)(cid:7)(cid:5)(cid:3)(cid:9)(cid:2)(cid:28)(cid:3,Unknown,3421.0
Unknown,Unknown,37,Unknown,Unknown,Unknown,Unknown,cid:3)(cid:5)(cid:14)(cid:70)(cid:12)(cid:11)(cid:4)(cid:14)(cid:11)(cid:48)(cid:48)(cid:7)(cid:5)(cid:3)(cid:9)(cid:2)(cid:12)(cid:11)(cid:4)(cid:14)(cid:11)(cid:48)(cid:48)(cid:7)(cid:5)(cid:3)(cid:9)(cid:2)(cid:28)(cid:3,Unknown,3458.0
Unknown,Unknown,16,Unknown,Unknown,Unknown,Unknown,cid:3)(cid:5)(cid:14)(cid:70)(cid:12)(cid:11)(cid:4)(cid:14)(cid:11)(cid:48)(cid:48)(cid:7)(cid:5)(cid:3)(cid:9)(cid:2)(cid:12)(cid:11)(cid:4)(cid:14)(cid:11)(cid:48)(cid:48)(cid:7)(cid:5)(cid:3)(cid:9)(cid:2)(cid:28)(cid:3,Unknown,3474.0
Unknown,Unknown,34,Unknown,Unknown,Unknown,Unknown,cid:3)(cid:5)(cid:14)(cid:70)(cid:12)(cid:11)(cid:4)(cid:14)(cid:11)(cid:48)(cid:48)(cid:7)(cid:5)(cid:3)(cid:9)(cid:2)(cid:12)(cid:11)(cid:4)(cid:14)(cid:11)(cid:48)(cid:48)(cid:7)(cid:5)(cid:3)(cid:9)(cid:2)(cid:28)(cid:3,Unknown,3508.0
Unknown,Unknown,33,Unknown,Unknown,Unknown,Unknown,cid:3)(cid:5)(cid:14)(cid:70)(cid:12)(cid:11)(cid:4)(cid:14)(cid:11)(cid:48)(cid:48)(cid:7)(cid:5)(cid:3)(cid:9)(cid:2)(cid:12)(cid:11)(cid:4)(cid:14)(cid:11)(cid:48)(cid:48)(cid:7)(cid:5)(cid:3)(cid:9)(cid:2)(cid:28)(cid:3,Unknown,3541.0
Unknown,Unknown,17,Unknown,Unknown,Unknown,Unknown,cid:3)(cid:5)(cid:14)(cid:70)(cid:12)(cid:11)(cid:4)(cid:14)(cid:11)(cid:48)(cid:48)(cid:7)(cid:5)(cid:3)(cid:9)(cid:2)(cid:12)(cid:11)(cid:4)(cid:14)(cid:11)(cid:48)(cid:48)(cid:7)(cid:5)(cid:3)(cid:9)(cid:2)(cid:28)(cid:3,Unknown,3558.0
Unknown,Unknown,17,Unknown,Unknown,Unknown,Unknown,cid:3)(cid:5)(cid:14)(cid:70)(cid:12)(cid:11)(cid:4)(cid:14)(cid:11)(cid:48)(cid:48)(cid:7)(cid:5)(cid:3)(cid:9)(cid:2)(cid:12)(cid:11)(cid:4)(cid:14)(cid:11)(cid:48)(cid:48)(cid:7)(cid:5)(cid:3)(cid:9)(cid:2)(cid:28)(cid:3,Unknown,3575.0
Unknown,Unknown,45,Unknown,Unknown,Unknown,Unknown,cid:3)(cid:5)(cid:14)(cid:70)(cid:12)(cid:11)(cid:4)(cid:14)(cid:11)(cid:48)(cid:48)(cid:7)(cid:5)(cid:3)(cid:9)(cid:2)(cid:12)(cid:11)(cid:4)(cid:14)(cid:11)(cid:48)(cid:48)(cid:7)(cid:5)(cid:3)(cid:9)(cid:2)(cid:28)(cid:3,Unknown,3620.0
Unknown,Unknown,18,Unknown,Unknown,Unknown,Unknown,cid:3)(cid:5)(cid:14)(cid:70)(cid:12)(cid:11)(cid:4)(cid:14)(cid:11)(cid:48)(cid:48)(cid:7)(cid:5)(cid:3)(cid:9)(cid:2)(cid:12)(cid:11)(cid:4)(cid:14)(cid:11)(cid:48)(cid:48)(cid:7)(cid:5)(cid:3)(cid:9)(cid:2)(cid:28)(cid:3,Unknown,3638.0
Unknown,Unknown,16,Unknown,Unknown,Unknown,Unknown,cid:3)(cid:5)(cid:14)(cid:70)(cid:12)(cid:11)(cid:4)(cid:14)(cid:11)(cid:48)(cid:48)(cid:7)(cid:5)(cid:3)(cid:9)(cid:2)(cid:12)(cid:11)(cid:4)(cid:14)(cid:11)(cid:48)(cid:48)(cid:7)(cid:5)(cid:3)(cid:9)(cid:2)(cid:28)(cid:3,Unknown,3654.0
Unknown,Unknown,14,Unknown,Unknown,Unknown,Unknown,cid:3)(cid:5)(cid:14)(cid:70)(cid:12)(cid:11)(cid:4)(cid:14)(cid:11)(cid:48)(cid:48)(cid:7)(cid:5)(cid:3)(cid:9)(cid:2)(cid:12)(cid:11)(cid:4)(cid:14)(cid:11)(cid:48)(cid:48)(cid:7)(cid:5)(cid:3)(cid:9)(cid:2)(cid:28)(cid:3,Unknown,3668.0
Unknown,Unknown,5,Unknown,Unknown,Unknown,Unknown,cid:3)(cid:5)(cid:14)(cid:70)(cid:12)(cid:11)(cid:4)(cid:14)(cid:11)(cid:48)(cid:48)(cid:7)(cid:5)(cid:3)(cid:9)(cid:2)(cid:12)(cid:11)(cid:4)(cid:14)(cid:11)(cid:48)(cid:48)(cid:7)(cid:5)(cid:3)(cid:9)(cid:2)(cid:28)(cid:3,Unknown,3673.0
Unknown,Unknown,12,Unknown,Unknown,Unknown,Unknown,cid:3)(cid:5)(cid:14)(cid:70)(cid:12)(cid:11)(cid:4)(cid:14)(cid:11)(cid:48)(cid:48)(cid:7)(cid:5)(cid:3)(cid:9)(cid:2)(cid:12)(cid:11)(cid:4)(cid:14)(cid:11)(cid:48)(cid:48)(cid:7)(cid:5)(cid:3)(cid:9)(cid:2)(cid:28)(cid:3,Unknown,3685.0
Unknown,Unknown,14,Unknown,Unknown,Unknown,Unknown,cid:3)(cid:5)(cid:14)(cid:70)(cid:12)(cid:11)(cid:4)(cid:14)(cid:11)(cid:48)(cid:48)(cid:7)(cid:5)(cid:3)(cid:9)(cid:2)(cid:12)(cid:11)(cid:4)(cid:14)(cid:11)(cid:48)(cid:48)(cid:7)(cid:5)(cid:3)(cid:9)(cid:2)(cid:28)(cid:3,Unknown,3699.0
Unknown,Unknown,5,Unknown,Unknown,Unknown,Unknown,cid:3)(cid:5)(cid:14)(cid:70)(cid:12)(cid:11)(cid:4)(cid:14)(cid:11)(cid:48)(cid:48)(cid:7)(cid:5)(cid:3)(cid:9)(cid:2)(cid:12)(cid:11)(cid:4)(cid:14)(cid:11)(cid:48)(cid:48)(cid:7)(cid:5)(cid:3)(cid:9)(cid:2)(cid:28)(cid:3,Unknown,3704.0
Unknown,Unknown,3,Unknown,Unknown,Unknown,Unknown,cid:3)(cid:5)(cid:14)(cid:70)(cid:12)(cid:11)(cid:4)(cid:14)(cid:11)(cid:48)(cid:48)(cid:7)(cid:5)(cid:3)(cid:9)(cid:2)(cid:12)(cid:11)(cid:4)(cid:14)(cid:11)(cid:48)(cid:48)(cid:7)(cid:5)(cid:3)(cid:9)(cid:2)(cid:28)(cid:3,Unknown,3707.0
Unknown,Unknown,12,Unknown,Unknown,Unknown,Unknown,cid:3)(cid:5)(cid:14)(cid:70)(cid:12)(cid:11)(cid:4)(cid:14)(cid:11)(cid:48)(cid:48)(cid:7)(cid:5)(cid:3)(cid:9)(cid:2)(cid:12)(cid:11)(cid:4)(cid:14)(cid:11)(cid:48)(cid:48)(cid:7)(cid:5)(cid:3)(cid:9)(cid:2)(cid:28)(cid:3,Unknown,3719.0
Unknown,Unknown,2,Unknown,Unknown,Unknown,Unknown,cid:3)(cid:5)(cid:14)(cid:70)(cid:12)(cid:11)(cid:4)(cid:14)(cid:11)(cid:48)(cid:48)(cid:7)(cid:5)(cid:3)(cid:9)(cid:2)(cid:12)(cid:11)(cid:4)(cid:14)(cid:11)(cid:48)(cid:48)(cid:7)(cid:5)(cid:3)(cid:9)(cid:2)(cid:28)(cid:3,Unknown,3721.0
Unknown,Unknown,50,Unknown,Unknown,Unknown,Unknown,cid:3)(cid:5)(cid:14)(cid:70)(cid:12)(cid:11)(cid:4)(cid:14)(cid:11)(cid:48)(cid:48)(cid:7)(cid:5)(cid:3)(cid:9)(cid:2)(cid:12)(cid:11)(cid:4)(cid:14)(cid:11)(cid:48)(cid:48)(cid:7)(cid:5)(cid:3)(cid:9)(cid:2)(cid:28)(cid:3,Unknown,3771.0
Unknown,Unknown,7,Unknown,Unknown,Unknown,Unknown,cid:3)(cid:5)(cid:14)(cid:70)(cid:12)(cid:11)(cid:4)(cid:14)(cid:11)(cid:48)(cid:48)(cid:7)(cid:5)(cid:3)(cid:9)(cid:2)(cid:12)(cid:11)(cid:4)(cid:14)(cid:11)(cid:48)(cid:48)(cid:7)(cid:5)(cid:3)(cid:9)(cid:2)(cid:28)(cid:3,Unknown,3778.0
Unknown,Unknown,9,Unknown,Unknown,Unknown,Unknown,cid:3)(cid:5)(cid:14)(cid:70)(cid:12)(cid:11)(cid:4)(cid:14)(cid:11)(cid:48)(cid:48)(cid:7)(cid:5)(cid:3)(cid:9)(cid:2)(cid:12)(cid:11)(cid:4)(cid:14)(cid:11)(cid:48)(cid:48)(cid:7)(cid:5)(cid:3)(cid:9)(cid:2)(cid:28)(cid:3,Unknown,3787.0
Unknown,Unknown,10,Unknown,Unknown,Unknown,Unknown,cid:3)(cid:5)(cid:14)(cid:70)(cid:12)(cid:11)(cid:4)(cid:14)(cid:11)(cid:48)(cid:48)(cid:7)(cid:5)(cid:3)(cid:9)(cid:2)(cid:12)(cid:11)(cid:4)(cid:14)(cid:11)(cid:48)(cid:48)(cid:7)(cid:5)(cid:3)(cid:9)(cid:2)(cid:28)(cid:3,Unknown,3797.0
Unknown,Unknown,3,Unknown,Unknown,Unknown,Unknown,cid:3)(cid:5)(cid:14)(cid:70)(cid:12)(cid:11)(cid:4)(cid:14)(cid:11)(cid:48)(cid:48)(cid:7)(cid:5)(cid:3)(cid:9)(cid:2)(cid:12)(cid:11)(cid:4)(cid:14)(cid:11)(cid:48)(cid:48)(cid:7)(cid:5)(cid:3)(cid:9)(cid:2)(cid:28)(cid:3,Unknown,3800.0
Unknown,Unknown,2,Unknown,Unknown,Unknown,Unknown,cid:3)(cid:5)(cid:14)(cid:70)(cid:12)(cid:11)(cid:4)(cid:14)(cid:11)(cid:48)(cid:48)(cid:7)(cid:5)(cid:3)(cid:9)(cid:2)(cid:12)(cid:11)(cid:4)(cid:14)(cid:11)(cid:48)(cid:48)(cid:7)(cid:5)(cid:3)(cid:9)(cid:2)(cid:28)(cid:3,Unknown,3802.0
Unknown,Unknown,12,Unknown,Unknown,Unknown,Unknown,cid:3)(cid:5)(cid:14)(cid:70)(cid:12)(cid:11)(cid:4)(cid:14)(cid:11)(cid:48)(cid:48)(cid:7)(cid:5)(cid:3)(cid:9)(cid:2)(cid:12)(cid:11)(cid:4)(cid:14)(cid:11)(cid:48)(cid:48)(cid:7)(cid:5)(cid:3)(cid:9)(cid:2)(cid:28)(cid:3,Unknown,3814.0
Unknown,Unknown,11,Unknown,Unknown,Unknown,Unknown,cid:3)(cid:5)(cid:14)(cid:70)(cid:12)(cid:11)(cid:4)(cid:14)(cid:11)(cid:48)(cid:48)(cid:7)(cid:5)(cid:3)(cid:9)(cid:2)(cid:12)(cid:11)(cid:4)(cid:14)(cid:11)(cid:48)(cid:48)(cid:7)(cid:5)(cid:3)(cid:9)(cid:2)(cid:28)(cid:3,Unknown,3825.0
Unknown,Unknown,4,Unknown,Unknown,Unknown,Unknown,cid:3)(cid:5)(cid:14)(cid:70)(cid:12)(cid:11)(cid:4)(cid:14)(cid:11)(cid:48)(cid:48)(cid:7)(cid:5)(cid:3)(cid:9)(cid:2)(cid:12)(cid:11)(cid:4)(cid:14)(cid:11)(cid:48)(cid:48)(cid:7)(cid:5)(cid:3)(cid:9)(cid:2)(cid:28)(cid:3,Unknown,3829.0
Unknown,Unknown,14,Unknown,Unknown,Unknown,Unknown,cid:3)(cid:5)(cid:14)(cid:70)(cid:12)(cid:11)(cid:4)(cid:14)(cid:11)(cid:48)(cid:48)(cid:7)(cid:5)(cid:3)(cid:9)(cid:2)(cid:12)(cid:11)(cid:4)(cid:14)(cid:11)(cid:48)(cid:48)(cid:7)(cid:5)(cid:3)(cid:9)(cid:2)(cid:28)(cid:3,Unknown,3843.0
Unknown,Unknown,11,Unknown,Unknown,Unknown,Unknown,cid:3)(cid:5)(cid:14)(cid:70)(cid:12)(cid:11)(cid:4)(cid:14)(cid:11)(cid:48)(cid:48)(cid:7)(cid:5)(cid:3)(cid:9)(cid:2)(cid:12)(cid:11)(cid:4)(cid:14)(cid:11)(cid:48)(cid:48)(cid:7)(cid:5)(cid:3)(cid:9)(cid:2)(cid:28)(cid:3,Unknown,3854.0
Unknown,Unknown,48,Unknown,Unknown,Unknown,Unknown,cid:3)(cid:5)(cid:14)(cid:70)(cid:12)(cid:11)(cid:4)(cid:14)(cid:11)(cid:48)(cid:48)(cid:7)(cid:5)(cid:3)(cid:9)(cid:2)(cid:12)(cid:11)(cid:4)(cid:14)(cid:11)(cid:48)(cid:48)(cid:7)(cid:5)(cid:3)(cid:9)(cid:2)(cid:28)(cid:3,Unknown,3902.0
Unknown,Unknown,48,Unknown,Unknown,Unknown,Unknown,cid:3)(cid:5)(cid:14)(cid:70)(cid:12)(cid:11)(cid:4)(cid:14)(cid:11)(cid:48)(cid:48)(cid:7)(cid:5)(cid:3)(cid:9)(cid:2)(cid:12)(cid:11)(cid:4)(cid:14)(cid:11)(cid:48)(cid:48)(cid:7)(cid:5)(cid:3)(cid:9)(cid:2)(cid:28)(cid:3,Unknown,3950.0
Unknown,Unknown,7,Unknown,Unknown,Unknown,Unknown,cid:3)(cid:5)(cid:14)(cid:70)(cid:12)(cid:11)(cid:4)(cid:14)(cid:11)(cid:48)(cid:48)(cid:7)(cid:5)(cid:3)(cid:9)(cid:2)(cid:12)(cid:11)(cid:4)(cid:14)(cid:11)(cid:48)(cid:48)(cid:7)(cid:5)(cid:3)(cid:9)(cid:2)(cid:28)(cid:3,Unknown,3957.0
Unknown,Unknown,5,Unknown,Unknown,Unknown,Unknown,cid:3)(cid:5)(cid:14)(cid:70)(cid:12)(cid:11)(cid:4)(cid:14)(cid:11)(cid:48)(cid:48)(cid:7)(cid:5)(cid:3)(cid:9)(cid:2)(cid:12)(cid:11)(cid:4)(cid:14)(cid:11)(cid:48)(cid:48)(cid:7)(cid:5)(cid:3)(cid:9)(cid:2)(cid:28)(cid:3,Unknown,3962.0
Unknown,Unknown,3,Unknown,Unknown,Unknown,Unknown,cid:3)(cid:5)(cid:14)(cid:70)(cid:12)(cid:11)(cid:4)(cid:14)(cid:11)(cid:48)(cid:48)(cid:7)(cid:5)(cid:3)(cid:9)(cid:2)(cid:12)(cid:11)(cid:4)(cid:14)(cid:11)(cid:48)(cid:48)(cid:7)(cid:5)(cid:3)(cid:9)(cid:2)(cid:28)(cid:3,Unknown,3965.0
Unknown,Unknown,2,Unknown,Unknown,Unknown,Unknown,cid:3)(cid:5)(cid:14)(cid:70)(cid:12)(cid:11)(cid:4)(cid:14)(cid:11)(cid:48)(cid:48)(cid:7)(cid:5)(cid:3)(cid:9)(cid:2)(cid:12)(cid:11)(cid:4)(cid:14)(cid:11)(cid:48)(cid:48)(cid:7)(cid:5)(cid:3)(cid:9)(cid:2)(cid:28)(cid:3,Unknown,3967.0
Unknown,Unknown,28,Unknown,Unknown,Unknown,Unknown,cid:3)(cid:5)(cid:14)(cid:70)(cid:12)(cid:11)(cid:4)(cid:14)(cid:11)(cid:48)(cid:48)(cid:7)(cid:5)(cid:3)(cid:9)(cid:2)(cid:12)(cid:11)(cid:4)(cid:14)(cid:11)(cid:48)(cid:48)(cid:7)(cid:5)(cid:3)(cid:9)(cid:2)(cid:28)(cid:3,Unknown,3995.0
Unknown,Unknown,3,Unknown,Unknown,Unknown,Unknown,cid:3)(cid:5)(cid:14)(cid:70)(cid:12)(cid:11)(cid:4)(cid:14)(cid:11)(cid:48)(cid:48)(cid:7)(cid:5)(cid:3)(cid:9)(cid:2)(cid:12)(cid:11)(cid:4)(cid:14)(cid:11)(cid:48)(cid:48)(cid:7)(cid:5)(cid:3)(cid:9)(cid:2)(cid:28)(cid:3,Unknown,3998.0
Unknown,Unknown,15,Unknown,Unknown,Unknown,Unknown,cid:3)(cid:5)(cid:14)(cid:70)(cid:12)(cid:11)(cid:4)(cid:14)(cid:11)(cid:48)(cid:48)(cid:7)(cid:5)(cid:3)(cid:9)(cid:2)(cid:12)(cid:11)(cid:4)(cid:14)(cid:11)(cid:48)(cid:48)(cid:7)(cid:5)(cid:3)(cid:9)(cid:2)(cid:28)(cid:3,Unknown,4013.0
Unknown,Unknown,2,Unknown,Unknown,Unknown,Unknown,cid:3)(cid:5)(cid:14)(cid:70)(cid:12)(cid:11)(cid:4)(cid:14)(cid:11)(cid:48)(cid:48)(cid:7)(cid:5)(cid:3)(cid:9)(cid:2)(cid:12)(cid:11)(cid:4)(cid:14)(cid:11)(cid:48)(cid:48)(cid:7)(cid:5)(cid:3)(cid:9)(cid:2)(cid:28)(cid:3,Unknown,4015.0
Unknown,Unknown,1,Unknown,Unknown,Unknown,Unknown,cid:3)(cid:5)(cid:14)(cid:70)(cid:12)(cid:11)(cid:4)(cid:14)(cid:11)(cid:48)(cid:48)(cid:7)(cid:5)(cid:3)(cid:9)(cid:2)(cid:12)(cid:11)(cid:4)(cid:14)(cid:11)(cid:48)(cid:48)(cid:7)(cid:5)(cid:3)(cid:9)(cid:2)(cid:28)(cid:3,Unknown,4016.0
Unknown,Unknown,37,Unknown,Unknown,Unknown,Unknown,cid:3)(cid:5)(cid:14)(cid:70)(cid:12)(cid:11)(cid:4)(cid:14)(cid:11)(cid:48)(cid:48)(cid:7)(cid:5)(cid:3)(cid:9)(cid:2)(cid:12)(cid:11)(cid:4)(cid:14)(cid:11)(cid:48)(cid:48)(cid:7)(cid:5)(cid:3)(cid:9)(cid:2)(cid:28)(cid:3,Unknown,4053.0
Unknown,Unknown,18,Unknown,Unknown,Unknown,Unknown,cid:3)(cid:5)(cid:14)(cid:70)(cid:12)(cid:11)(cid:4)(cid:14)(cid:11)(cid:48)(cid:48)(cid:7)(cid:5)(cid:3)(cid:9)(cid:2)(cid:12)(cid:11)(cid:4)(cid:14)(cid:11)(cid:48)(cid:48)(cid:7)(cid:5)(cid:3)(cid:9)(cid:2)(cid:28)(cid:3,Unknown,4071.0
Unknown,Unknown,19,Unknown,Unknown,Unknown,Unknown,cid:3)(cid:5)(cid:14)(cid:70)(cid:12)(cid:11)(cid:4)(cid:14)(cid:11)(cid:48)(cid:48)(cid:7)(cid:5)(cid:3)(cid:9)(cid:2)(cid:12)(cid:11)(cid:4)(cid:14)(cid:11)(cid:48)(cid:48)(cid:7)(cid:5)(cid:3)(cid:9)(cid:2)(cid:28)(cid:3,Unknown,4090.0
Unknown,Unknown,17,Unknown,Unknown,Unknown,Unknown,cid:3)(cid:5)(cid:14)(cid:70)(cid:12)(cid:11)(cid:4)(cid:14)(cid:11)(cid:48)(cid:48)(cid:7)(cid:5)(cid:3)(cid:9)(cid:2)(cid:12)(cid:11)(cid:4)(cid:14)(cid:11)(cid:48)(cid:48)(cid:7)(cid:5)(cid:3)(cid:9)(cid:2)(cid:28)(cid:3,Unknown,4107.0
Unknown,Unknown,1,Unknown,Unknown,Unknown,Unknown,cid:3)(cid:5)(cid:14)(cid:70)(cid:12)(cid:11)(cid:4)(cid:14)(cid:11)(cid:48)(cid:48)(cid:7)(cid:5)(cid:3)(cid:9)(cid:2)(cid:12)(cid:11)(cid:4)(cid:14)(cid:11)(cid:48)(cid:48)(cid:7)(cid:5)(cid:3)(cid:9)(cid:2)(cid:28)(cid:3,Unknown,4108.0
Unknown,Unknown,2,Unknown,Unknown,Unknown,Unknown,cid:3)(cid:5)(cid:14)(cid:70)(cid:12)(cid:11)(cid:4)(cid:14)(cid:11)(cid:48)(cid:48)(cid:7)(cid:5)(cid:3)(cid:9)(cid:2)(cid:12)(cid:11)(cid:4)(cid:14)(cid:11)(cid:48)(cid:48)(cid:7)(cid:5)(cid:3)(cid:9)(cid:2)(cid:28)(cid:3,Unknown,4110.0
Unknown,Unknown,44,Unknown,Unknown,Unknown,Unknown,cid:3)(cid:5)(cid:14)(cid:70)(cid:12)(cid:11)(cid:4)(cid:14)(cid:11)(cid:48)(cid:48)(cid:7)(cid:5)(cid:3)(cid:9)(cid:2)(cid:12)(cid:11)(cid:4)(cid:14)(cid:11)(cid:48)(cid:48)(cid:7)(cid:5)(cid:3)(cid:9)(cid:2)(cid:28)(cid:3,Unknown,4154.0
Unknown,Unknown,12,Unknown,Unknown,Unknown,Unknown,cid:3)(cid:5)(cid:14)(cid:70)(cid:12)(cid:11)(cid:4)(cid:14)(cid:11)(cid:48)(cid:48)(cid:7)(cid:5)(cid:3)(cid:9)(cid:2)(cid:12)(cid:11)(cid:4)(cid:14)(cid:11)(cid:48)(cid:48)(cid:7)(cid:5)(cid:3)(cid:9)(cid:2)(cid:28)(cid:3,Unknown,4166.0
Unknown,Unknown,29,Unknown,Unknown,Unknown,Unknown,cid:3)(cid:5)(cid:14)(cid:70)(cid:12)(cid:11)(cid:4)(cid:14)(cid:11)(cid:48)(cid:48)(cid:7)(cid:5)(cid:3)(cid:9)(cid:2)(cid:12)(cid:11)(cid:4)(cid:14)(cid:11)(cid:48)(cid:48)(cid:7)(cid:5)(cid:3)(cid:9)(cid:2)(cid:28)(cid:3,Unknown,4195.0
Unknown,Unknown,26,Unknown,Unknown,Unknown,Unknown,cid:3)(cid:5)(cid:14)(cid:70)(cid:12)(cid:11)(cid:4)(cid:14)(cid:11)(cid:48)(cid:48)(cid:7)(cid:5)(cid:3)(cid:9)(cid:2)(cid:12)(cid:11)(cid:4)(cid:14)(cid:11)(cid:48)(cid:48)(cid:7)(cid:5)(cid:3)(cid:9)(cid:2)(cid:28)(cid:3,Unknown,4221.0
Unknown,Unknown,41,Unknown,Unknown,Unknown,Unknown,cid:3)(cid:5)(cid:14)(cid:70)(cid:12)(cid:11)(cid:4)(cid:14)(cid:11)(cid:48)(cid:48)(cid:7)(cid:5)(cid:3)(cid:9)(cid:2)(cid:12)(cid:11)(cid:4)(cid:14)(cid:11)(cid:48)(cid:48)(cid:7)(cid:5)(cid:3)(cid:9)(cid:2)(cid:28)(cid:3,Unknown,4262.0
Unknown,Unknown,25,Unknown,Unknown,Unknown,Unknown,cid:3)(cid:5)(cid:14)(cid:70)(cid:12)(cid:11)(cid:4)(cid:14)(cid:11)(cid:48)(cid:48)(cid:7)(cid:5)(cid:3)(cid:9)(cid:2)(cid:12)(cid:11)(cid:4)(cid:14)(cid:11)(cid:48)(cid:48)(cid:7)(cid:5)(cid:3)(cid:9)(cid:2)(cid:28)(cid:3,Unknown,4287.0
Unknown,Unknown,2,Unknown,Unknown,Unknown,Unknown,cid:3)(cid:5)(cid:14)(cid:70)(cid:12)(cid:11)(cid:4)(cid:14)(cid:11)(cid:48)(cid:48)(cid:7)(cid:5)(cid:3)(cid:9)(cid:2)(cid:12)(cid:11)(cid:4)(cid:14)(cid:11)(cid:48)(cid:48)(cid:7)(cid:5)(cid:3)(cid:9)(cid:2)(cid:28)(cid:3,Unknown,4289.0
Unknown,Unknown,58,Unknown,Unknown,Unknown,Unknown,cid:3)(cid:5)(cid:14)(cid:70)(cid:12)(cid:11)(cid:4)(cid:14)(cid:11)(cid:48)(cid:48)(cid:7)(cid:5)(cid:3)(cid:9)(cid:2)(cid:12)(cid:11)(cid:4)(cid:14)(cid:11)(cid:48)(cid:48)(cid:7)(cid:5)(cid:3)(cid:9)(cid:2)(cid:28)(cid:3,Unknown,4347.0
Unknown,Unknown,58,Unknown,Unknown,Unknown,Unknown,cid:3)(cid:5)(cid:14)(cid:70)(cid:12)(cid:11)(cid:4)(cid:14)(cid:11)(cid:48)(cid:48)(cid:7)(cid:5)(cid:3)(cid:9)(cid:2)(cid:12)(cid:11)(cid:4)(cid:14)(cid:11)(cid:48)(cid:48)(cid:7)(cid:5)(cid:3)(cid:9)(cid:2)(cid:28)(cid:3,Unknown,4405.0
Unknown,Unknown,37,Unknown,Unknown,Unknown,Unknown,cid:3)(cid:5)(cid:14)(cid:70)(cid:12)(cid:11)(cid:4)(cid:14)(cid:11)(cid:48)(cid:48)(cid:7)(cid:5)(cid:3)(cid:9)(cid:2)(cid:12)(cid:11)(cid:4)(cid:14)(cid:11)(cid:48)(cid:48)(cid:7)(cid:5)(cid:3)(cid:9)(cid:2)(cid:28)(cid:3,Unknown,4442.0
Unknown,Unknown,16,Unknown,Unknown,Unknown,Unknown,cid:3)(cid:5)(cid:14)(cid:70)(cid:12)(cid:11)(cid:4)(cid:14)(cid:11)(cid:48)(cid:48)(cid:7)(cid:5)(cid:3)(cid:9)(cid:2)(cid:12)(cid:11)(cid:4)(cid:14)(cid:11)(cid:48)(cid:48)(cid:7)(cid:5)(cid:3)(cid:9)(cid:2)(cid:28)(cid:3,Unknown,4458.0
Unknown,Unknown,34,Unknown,Unknown,Unknown,Unknown,cid:3)(cid:5)(cid:14)(cid:70)(cid:12)(cid:11)(cid:4)(cid:14)(cid:11)(cid:48)(cid:48)(cid:7)(cid:5)(cid:3)(cid:9)(cid:2)(cid:12)(cid:11)(cid:4)(cid:14)(cid:11)(cid:48)(cid:48)(cid:7)(cid:5)(cid:3)(cid:9)(cid:2)(cid:28)(cid:3,Unknown,4492.0
Unknown,Unknown,33,Unknown,Unknown,Unknown,Unknown,cid:3)(cid:5)(cid:14)(cid:70)(cid:12)(cid:11)(cid:4)(cid:14)(cid:11)(cid:48)(cid:48)(cid:7)(cid:5)(cid:3)(cid:9)(cid:2)(cid:12)(cid:11)(cid:4)(cid:14)(cid:11)(cid:48)(cid:48)(cid:7)(cid:5)(cid:3)(cid:9)(cid:2)(cid:28)(cid:3,Unknown,4525.0
Unknown,Unknown,17,Unknown,Unknown,Unknown,Unknown,cid:3)(cid:5)(cid:14)(cid:70)(cid:12)(cid:11)(cid:4)(cid:14)(cid:11)(cid:48)(cid:48)(cid:7)(cid:5)(cid:3)(cid:9)(cid:2)(cid:12)(cid:11)(cid:4)(cid:14)(cid:11)(cid:48)(cid:48)(cid:7)(cid:5)(cid:3)(cid:9)(cid:2)(cid:28)(cid:3,Unknown,4542.0
Unknown,Unknown,1,Unknown,Unknown,Unknown,Unknown,cid:3)(cid:5)(cid:14)(cid:70)(cid:12)(cid:11)(cid:4)(cid:14)(cid:11)(cid:48)(cid:48)(cid:7)(cid:5)(cid:3)(cid:9)(cid:2)(cid:12)(cid:11)(cid:4)(cid:14)(cid:11)(cid:48)(cid:48)(cid:7)(cid:5)(cid:3)(cid:9)(cid:2)(cid:28)(cid:3,Unknown,4543.0
Unknown,Unknown,45,Unknown,Unknown,Unknown,Unknown,cid:3)(cid:5)(cid:14)(cid:70)(cid:12)(cid:11)(cid:4)(cid:14)(cid:11)(cid:48)(cid:48)(cid:7)(cid:5)(cid:3)(cid:9)(cid:2)(cid:12)(cid:11)(cid:4)(cid:14)(cid:11)(cid:48)(cid:48)(cid:7)(cid:5)(cid:3)(cid:9)(cid:2)(cid:28)(cid:3,Unknown,4588.0
Unknown,Unknown,18,Unknown,Unknown,Unknown,Unknown,cid:3)(cid:5)(cid:14)(cid:70)(cid:12)(cid:11)(cid:4)(cid:14)(cid:11)(cid:48)(cid:48)(cid:7)(cid:5)(cid:3)(cid:9)(cid:2)(cid:12)(cid:11)(cid:4)(cid:14)(cid:11)(cid:48)(cid:48)(cid:7)(cid:5)(cid:3)(cid:9)(cid:2)(cid:28)(cid:3,Unknown,4606.0
Unknown,Unknown,16,Unknown,Unknown,Unknown,Unknown,cid:3)(cid:5)(cid:14)(cid:70)(cid:12)(cid:11)(cid:4)(cid:14)(cid:11)(cid:48)(cid:48)(cid:7)(cid:5)(cid:3)(cid:9)(cid:2)(cid:12)(cid:11)(cid:4)(cid:14)(cid:11)(cid:48)(cid:48)(cid:7)(cid:5)(cid:3)(cid:9)(cid:2)(cid:28)(cid:3,Unknown,4622.0
Unknown,Unknown,9,Unknown,Unknown,Unknown,Unknown,cid:3)(cid:5)(cid:14)(cid:70)(cid:12)(cid:11)(cid:4)(cid:14)(cid:11)(cid:48)(cid:48)(cid:7)(cid:5)(cid:3)(cid:9)(cid:2)(cid:12)(cid:11)(cid:4)(cid:14)(cid:11)(cid:48)(cid:48)(cid:7)(cid:5)(cid:3)(cid:9)(cid:2)(cid:28)(cid:3,Unknown,4631.0
Unknown,Unknown,46,Unknown,Unknown,Unknown,Unknown,cid:3)(cid:5)(cid:14)(cid:70)(cid:12)(cid:11)(cid:4)(cid:14)(cid:11)(cid:48)(cid:48)(cid:7)(cid:5)(cid:3)(cid:9)(cid:2)(cid:12)(cid:11)(cid:4)(cid:14)(cid:11)(cid:48)(cid:48)(cid:7)(cid:5)(cid:3)(cid:9)(cid:2)(cid:28)(cid:3,Unknown,4677.0
Unknown,Unknown,3,Unknown,Unknown,Unknown,Unknown,cid:3)(cid:5)(cid:14)(cid:70)(cid:12)(cid:11)(cid:4)(cid:14)(cid:11)(cid:48)(cid:48)(cid:7)(cid:5)(cid:3)(cid:9)(cid:2)(cid:12)(cid:11)(cid:4)(cid:14)(cid:11)(cid:48)(cid:48)(cid:7)(cid:5)(cid:3)(cid:9)(cid:2)(cid:28)(cid:3,Unknown,4680.0
Unknown,Unknown,14,Unknown,Unknown,Unknown,Unknown,cid:3)(cid:5)(cid:14)(cid:70)(cid:12)(cid:11)(cid:4)(cid:14)(cid:11)(cid:48)(cid:48)(cid:7)(cid:5)(cid:3)(cid:9)(cid:2)(cid:12)(cid:11)(cid:4)(cid:14)(cid:11)(cid:48)(cid:48)(cid:7)(cid:5)(cid:3)(cid:9)(cid:2)(cid:28)(cid:3,Unknown,4694.0
Unknown,Unknown,2,Unknown,Unknown,Unknown,Unknown,cid:3)(cid:5)(cid:14)(cid:70)(cid:12)(cid:11)(cid:4)(cid:14)(cid:11)(cid:48)(cid:48)(cid:7)(cid:5)(cid:3)(cid:9)(cid:2)(cid:12)(cid:11)(cid:4)(cid:14)(cid:11)(cid:48)(cid:48)(cid:7)(cid:5)(cid:3)(cid:9)(cid:2)(cid:28)(cid:3,Unknown,4696.0
Unknown,Unknown,65,Unknown,Unknown,Unknown,Unknown,cid:3)(cid:5)(cid:14)(cid:70)(cid:12)(cid:11)(cid:4)(cid:14)(cid:11)(cid:48)(cid:48)(cid:7)(cid:5)(cid:3)(cid:9)(cid:2)(cid:12)(cid:11)(cid:4)(cid:14)(cid:11)(cid:48)(cid:48)(cid:7)(cid:5)(cid:3)(cid:9)(cid:2)(cid:28)(cid:3,Unknown,4761.0
Unknown,Unknown,39,Unknown,Unknown,Unknown,Unknown,cid:3)(cid:5)(cid:14)(cid:70)(cid:12)(cid:11)(cid:4)(cid:14)(cid:11)(cid:48)(cid:48)(cid:7)(cid:5)(cid:3)(cid:9)(cid:2)(cid:12)(cid:11)(cid:4)(cid:14)(cid:11)(cid:48)(cid:48)(cid:7)(cid:5)(cid:3)(cid:9)(cid:2)(cid:28)(cid:3,Unknown,4800.0
Unknown,Unknown,46,Unknown,Unknown,Unknown,Unknown,cid:3)(cid:5)(cid:14)(cid:70)(cid:12)(cid:11)(cid:4)(cid:14)(cid:11)(cid:48)(cid:48)(cid:7)(cid:5)(cid:3)(cid:9)(cid:2)(cid:12)(cid:11)(cid:4)(cid:14)(cid:11)(cid:48)(cid:48)(cid:7)(cid:5)(cid:3)(cid:9)(cid:2)(cid:28)(cid:3,Unknown,4846.0
Unknown,Unknown,2,Unknown,Unknown,Unknown,Unknown,cid:3)(cid:5)(cid:14)(cid:70)(cid:12)(cid:11)(cid:4)(cid:14)(cid:11)(cid:48)(cid:48)(cid:7)(cid:5)(cid:3)(cid:9)(cid:2)(cid:12)(cid:11)(cid:4)(cid:14)(cid:11)(cid:48)(cid:48)(cid:7)(cid:5)(cid:3)(cid:9)(cid:2)(cid:28)(cid:3,Unknown,4848.0
Unknown,Unknown,48,Unknown,Unknown,Unknown,Unknown,cid:3)(cid:5)(cid:14)(cid:70)(cid:12)(cid:11)(cid:4)(cid:14)(cid:11)(cid:48)(cid:48)(cid:7)(cid:5)(cid:3)(cid:9)(cid:2)(cid:12)(cid:11)(cid:4)(cid:14)(cid:11)(cid:48)(cid:48)(cid:7)(cid:5)(cid:3)(cid:9)(cid:2)(cid:28)(cid:3,Unknown,4896.0
Unknown,Unknown,46,Unknown,Unknown,Unknown,Unknown,cid:3)(cid:5)(cid:14)(cid:70)(cid:12)(cid:11)(cid:4)(cid:14)(cid:11)(cid:48)(cid:48)(cid:7)(cid:5)(cid:3)(cid:9)(cid:2)(cid:12)(cid:11)(cid:4)(cid:14)(cid:11)(cid:48)(cid:48)(cid:7)(cid:5)(cid:3)(cid:9)(cid:2)(cid:28)(cid:3,Unknown,4942.0
Unknown,Unknown,3,Unknown,Unknown,Unknown,Unknown,cid:3)(cid:5)(cid:14)(cid:70)(cid:12)(cid:11)(cid:4)(cid:14)(cid:11)(cid:48)(cid:48)(cid:7)(cid:5)(cid:3)(cid:9)(cid:2)(cid:12)(cid:11)(cid:4)(cid:14)(cid:11)(cid:48)(cid:48)(cid:7)(cid:5)(cid:3)(cid:9)(cid:2)(cid:28)(cid:3,Unknown,4945.0
Unknown,Unknown,65,Unknown,Unknown,Unknown,Unknown,cid:3)(cid:5)(cid:14)(cid:70)(cid:12)(cid:11)(cid:4)(cid:14)(cid:11)(cid:48)(cid:48)(cid:7)(cid:5)(cid:3)(cid:9)(cid:2)(cid:12)(cid:11)(cid:4)(cid:14)(cid:11)(cid:48)(cid:48)(cid:7)(cid:5)(cid:3)(cid:9)(cid:2)(cid:28)(cid:3,Unknown,5010.0
Unknown,Unknown,5,Unknown,Unknown,Unknown,Unknown,cid:3)(cid:5)(cid:14)(cid:70)(cid:12)(cid:11)(cid:4)(cid:14)(cid:11)(cid:48)(cid:48)(cid:7)(cid:5)(cid:3)(cid:9)(cid:2)(cid:12)(cid:11)(cid:4)(cid:14)(cid:11)(cid:48)(cid:48)(cid:7)(cid:5)(cid:3)(cid:9)(cid:2)(cid:28)(cid:3,Unknown,5015.0
Unknown,Unknown,10,Unknown,Unknown,Unknown,Unknown,cid:3)(cid:5)(cid:14)(cid:70)(cid:12)(cid:11)(cid:4)(cid:14)(cid:11)(cid:48)(cid:48)(cid:7)(cid:5)(cid:3)(cid:9)(cid:2)(cid:12)(cid:11)(cid:4)(cid:14)(cid:11)(cid:48)(cid:48)(cid:7)(cid:5)(cid:3)(cid:9)(cid:2)(cid:28)(cid:3,Unknown,5025.0
Unknown,Unknown,2,Unknown,Unknown,Unknown,Unknown,cid:3)(cid:5)(cid:14)(cid:70)(cid:12)(cid:11)(cid:4)(cid:14)(cid:11)(cid:48)(cid:48)(cid:7)(cid:5)(cid:3)(cid:9)(cid:2)(cid:12)(cid:11)(cid:4)(cid:14)(cid:11)(cid:48)(cid:48)(cid:7)(cid:5)(cid:3)(cid:9)(cid:2)(cid:28)(cid:3,Unknown,5027.0
Unknown,Unknown,12,Unknown,Unknown,Unknown,Unknown,cid:3)(cid:5)(cid:14)(cid:70)(cid:12)(cid:11)(cid:4)(cid:14)(cid:11)(cid:48)(cid:48)(cid:7)(cid:5)(cid:3)(cid:9)(cid:2)(cid:12)(cid:11)(cid:4)(cid:14)(cid:11)(cid:48)(cid:48)(cid:7)(cid:5)(cid:3)(cid:9)(cid:2)(cid:28)(cid:3,Unknown,5039.0
Unknown,Unknown,11,Unknown,Unknown,Unknown,Unknown,cid:3)(cid:5)(cid:14)(cid:70)(cid:12)(cid:11)(cid:4)(cid:14)(cid:11)(cid:48)(cid:48)(cid:7)(cid:5)(cid:3)(cid:9)(cid:2)(cid:12)(cid:11)(cid:4)(cid:14)(cid:11)(cid:48)(cid:48)(cid:7)(cid:5)(cid:3)(cid:9)(cid:2)(cid:28)(cid:3,Unknown,5050.0
Unknown,Unknown,4,Unknown,Unknown,Unknown,Unknown,cid:3)(cid:5)(cid:14)(cid:70)(cid:12)(cid:11)(cid:4)(cid:14)(cid:11)(cid:48)(cid:48)(cid:7)(cid:5)(cid:3)(cid:9)(cid:2)(cid:12)(cid:11)(cid:4)(cid:14)(cid:11)(cid:48)(cid:48)(cid:7)(cid:5)(cid:3)(cid:9)(cid:2)(cid:28)(cid:3,Unknown,5054.0
Unknown,Unknown,14,Unknown,Unknown,Unknown,Unknown,cid:3)(cid:5)(cid:14)(cid:70)(cid:12)(cid:11)(cid:4)(cid:14)(cid:11)(cid:48)(cid:48)(cid:7)(cid:5)(cid:3)(cid:9)(cid:2)(cid:12)(cid:11)(cid:4)(cid:14)(cid:11)(cid:48)(cid:48)(cid:7)(cid:5)(cid:3)(cid:9)(cid:2)(cid:28)(cid:3,Unknown,5068.0
Unknown,Unknown,11,Unknown,Unknown,Unknown,Unknown,cid:3)(cid:5)(cid:14)(cid:70)(cid:12)(cid:11)(cid:4)(cid:14)(cid:11)(cid:48)(cid:48)(cid:7)(cid:5)(cid:3)(cid:9)(cid:2)(cid:12)(cid:11)(cid:4)(cid:14)(cid:11)(cid:48)(cid:48)(cid:7)(cid:5)(cid:3)(cid:9)(cid:2)(cid:28)(cid:3,Unknown,5079.0
Unknown,Unknown,48,Unknown,Unknown,Unknown,Unknown,cid:3)(cid:5)(cid:14)(cid:70)(cid:12)(cid:11)(cid:4)(cid:14)(cid:11)(cid:48)(cid:48)(cid:7)(cid:5)(cid:3)(cid:9)(cid:2)(cid:12)(cid:11)(cid:4)(cid:14)(cid:11)(cid:48)(cid:48)(cid:7)(cid:5)(cid:3)(cid:9)(cid:2)(cid:28)(cid:3,Unknown,5127.0
Unknown,Unknown,48,Unknown,Unknown,Unknown,Unknown,cid:3)(cid:5)(cid:14)(cid:70)(cid:12)(cid:11)(cid:4)(cid:14)(cid:11)(cid:48)(cid:48)(cid:7)(cid:5)(cid:3)(cid:9)(cid:2)(cid:12)(cid:11)(cid:4)(cid:14)(cid:11)(cid:48)(cid:48)(cid:7)(cid:5)(cid:3)(cid:9)(cid:2)(cid:28)(cid:3,Unknown,5175.0
Unknown,Unknown,7,Unknown,Unknown,Unknown,Unknown,cid:3)(cid:5)(cid:14)(cid:70)(cid:12)(cid:11)(cid:4)(cid:14)(cid:11)(cid:48)(cid:48)(cid:7)(cid:5)(cid:3)(cid:9)(cid:2)(cid:12)(cid:11)(cid:4)(cid:14)(cid:11)(cid:48)(cid:48)(cid:7)(cid:5)(cid:3)(cid:9)(cid:2)(cid:28)(cid:3,Unknown,5182.0
Unknown,Unknown,5,Unknown,Unknown,Unknown,Unknown,cid:3)(cid:5)(cid:14)(cid:70)(cid:12)(cid:11)(cid:4)(cid:14)(cid:11)(cid:48)(cid:48)(cid:7)(cid:5)(cid:3)(cid:9)(cid:2)(cid:12)(cid:11)(cid:4)(cid:14)(cid:11)(cid:48)(cid:48)(cid:7)(cid:5)(cid:3)(cid:9)(cid:2)(cid:28)(cid:3,Unknown,5187.0
Unknown,Unknown,3,Unknown,Unknown,Unknown,Unknown,cid:3)(cid:5)(cid:14)(cid:70)(cid:12)(cid:11)(cid:4)(cid:14)(cid:11)(cid:48)(cid:48)(cid:7)(cid:5)(cid:3)(cid:9)(cid:2)(cid:12)(cid:11)(cid:4)(cid:14)(cid:11)(cid:48)(cid:48)(cid:7)(cid:5)(cid:3)(cid:9)(cid:2)(cid:28)(cid:3,Unknown,5190.0
Unknown,Unknown,9,Unknown,Unknown,Unknown,Unknown,cid:3)(cid:5)(cid:14)(cid:70)(cid:12)(cid:11)(cid:4)(cid:14)(cid:11)(cid:48)(cid:48)(cid:7)(cid:5)(cid:3)(cid:9)(cid:2)(cid:12)(cid:11)(cid:4)(cid:14)(cid:11)(cid:48)(cid:48)(cid:7)(cid:5)(cid:3)(cid:9)(cid:2)(cid:28)(cid:3,Unknown,5199.0
Unknown,Unknown,2,Unknown,Unknown,Unknown,Unknown,cid:3)(cid:5)(cid:14)(cid:70)(cid:12)(cid:11)(cid:4)(cid:14)(cid:11)(cid:48)(cid:48)(cid:7)(cid:5)(cid:3)(cid:9)(cid:2)(cid:12)(cid:11)(cid:4)(cid:14)(cid:11)(cid:48)(cid:48)(cid:7)(cid:5)(cid:3)(cid:9)(cid:2)(cid:28)(cid:3,Unknown,5201.0
Unknown,Unknown,28,Unknown,Unknown,Unknown,Unknown,cid:3)(cid:5)(cid:14)(cid:70)(cid:12)(cid:11)(cid:4)(cid:14)(cid:11)(cid:48)(cid:48)(cid:7)(cid:5)(cid:3)(cid:9)(cid:2)(cid:12)(cid:11)(cid:4)(cid:14)(cid:11)(cid:48)(cid:48)(cid:7)(cid:5)(cid:3)(cid:9)(cid:2)(cid:28)(cid:3,Unknown,5229.0
Unknown,Unknown,3,Unknown,Unknown,Unknown,Unknown,cid:3)(cid:5)(cid:14)(cid:70)(cid:12)(cid:11)(cid:4)(cid:14)(cid:11)(cid:48)(cid:48)(cid:7)(cid:5)(cid:3)(cid:9)(cid:2)(cid:12)(cid:11)(cid:4)(cid:14)(cid:11)(cid:48)(cid:48)(cid:7)(cid:5)(cid:3)(cid:9)(cid:2)(cid:28)(cid:3,Unknown,5232.0
Unknown,Unknown,15,Unknown,Unknown,Unknown,Unknown,cid:3)(cid:5)(cid:14)(cid:70)(cid:12)(cid:11)(cid:4)(cid:14)(cid:11)(cid:48)(cid:48)(cid:7)(cid:5)(cid:3)(cid:9)(cid:2)(cid:12)(cid:11)(cid:4)(cid:14)(cid:11)(cid:48)(cid:48)(cid:7)(cid:5)(cid:3)(cid:9)(cid:2)(cid:28)(cid:3,Unknown,5247.0
Unknown,Unknown,2,Unknown,Unknown,Unknown,Unknown,cid:3)(cid:5)(cid:14)(cid:70)(cid:12)(cid:11)(cid:4)(cid:14)(cid:11)(cid:48)(cid:48)(cid:7)(cid:5)(cid:3)(cid:9)(cid:2)(cid:12)(cid:11)(cid:4)(cid:14)(cid:11)(cid:48)(cid:48)(cid:7)(cid:5)(cid:3)(cid:9)(cid:2)(cid:28)(cid:3,Unknown,5249.0
Unknown,Unknown,35,Unknown,Unknown,Unknown,Unknown,cid:3)(cid:5)(cid:14)(cid:70)(cid:12)(cid:11)(cid:4)(cid:14)(cid:11)(cid:48)(cid:48)(cid:7)(cid:5)(cid:3)(cid:9)(cid:2)(cid:12)(cid:11)(cid:4)(cid:14)(cid:11)(cid:48)(cid:48)(cid:7)(cid:5)(cid:3)(cid:9)(cid:2)(cid:28)(cid:3,Unknown,5284.0
Unknown,Unknown,19,Unknown,Unknown,Unknown,Unknown,cid:3)(cid:5)(cid:14)(cid:70)(cid:12)(cid:11)(cid:4)(cid:14)(cid:11)(cid:48)(cid:48)(cid:7)(cid:5)(cid:3)(cid:9)(cid:2)(cid:12)(cid:11)(cid:4)(cid:14)(cid:11)(cid:48)(cid:48)(cid:7)(cid:5)(cid:3)(cid:9)(cid:2)(cid:28)(cid:3,Unknown,5303.0
Unknown,Unknown,1,Unknown,Unknown,Unknown,Unknown,cid:3)(cid:5)(cid:14)(cid:70)(cid:12)(cid:11)(cid:4)(cid:14)(cid:11)(cid:48)(cid:48)(cid:7)(cid:5)(cid:3)(cid:9)(cid:2)(cid:12)(cid:11)(cid:4)(cid:14)(cid:11)(cid:48)(cid:48)(cid:7)(cid:5)(cid:3)(cid:9)(cid:2)(cid:28)(cid:3,Unknown,5304.0
Unknown,Unknown,1,Unknown,Unknown,Unknown,Unknown,cid:3)(cid:5)(cid:14)(cid:70)(cid:12)(cid:11)(cid:4)(cid:14)(cid:11)(cid:48)(cid:48)(cid:7)(cid:5)(cid:3)(cid:9)(cid:2)(cid:12)(cid:11)(cid:4)(cid:14)(cid:11)(cid:48)(cid:48)(cid:7)(cid:5)(cid:3)(cid:9)(cid:2)(cid:28)(cid:3,Unknown,5305.0
Unknown,Unknown,2,Unknown,Unknown,Unknown,Unknown,cid:3)(cid:5)(cid:14)(cid:70)(cid:12)(cid:11)(cid:4)(cid:14)(cid:11)(cid:48)(cid:48)(cid:7)(cid:5)(cid:3)(cid:9)(cid:2)(cid:12)(cid:11)(cid:4)(cid:14)(cid:11)(cid:48)(cid:48)(cid:7)(cid:5)(cid:3)(cid:9)(cid:2)(cid:28)(cid:3,Unknown,5307.0
Unknown,Unknown,44,Unknown,Unknown,Unknown,Unknown,cid:3)(cid:5)(cid:14)(cid:70)(cid:12)(cid:11)(cid:4)(cid:14)(cid:11)(cid:48)(cid:48)(cid:7)(cid:5)(cid:3)(cid:9)(cid:2)(cid:12)(cid:11)(cid:4)(cid:14)(cid:11)(cid:48)(cid:48)(cid:7)(cid:5)(cid:3)(cid:9)(cid:2)(cid:28)(cid:3,Unknown,5351.0
Unknown,Unknown,12,Unknown,Unknown,Unknown,Unknown,cid:3)(cid:5)(cid:14)(cid:70)(cid:12)(cid:11)(cid:4)(cid:14)(cid:11)(cid:48)(cid:48)(cid:7)(cid:5)(cid:3)(cid:9)(cid:2)(cid:12)(cid:11)(cid:4)(cid:14)(cid:11)(cid:48)(cid:48)(cid:7)(cid:5)(cid:3)(cid:9)(cid:2)(cid:28)(cid:3,Unknown,5363.0
Unknown,Unknown,29,Unknown,Unknown,Unknown,Unknown,cid:3)(cid:5)(cid:14)(cid:70)(cid:12)(cid:11)(cid:4)(cid:14)(cid:11)(cid:48)(cid:48)(cid:7)(cid:5)(cid:3)(cid:9)(cid:2)(cid:12)(cid:11)(cid:4)(cid:14)(cid:11)(cid:48)(cid:48)(cid:7)(cid:5)(cid:3)(cid:9)(cid:2)(cid:28)(cid:3,Unknown,5392.0
Unknown,Unknown,26,Unknown,Unknown,Unknown,Unknown,cid:3)(cid:5)(cid:14)(cid:70)(cid:12)(cid:11)(cid:4)(cid:14)(cid:11)(cid:48)(cid:48)(cid:7)(cid:5)(cid:3)(cid:9)(cid:2)(cid:12)(cid:11)(cid:4)(cid:14)(cid:11)(cid:48)(cid:48)(cid:7)(cid:5)(cid:3)(cid:9)(cid:2)(cid:28)(cid:3,Unknown,5418.0
Unknown,Unknown,41,Unknown,Unknown,Unknown,Unknown,cid:3)(cid:5)(cid:14)(cid:70)(cid:12)(cid:11)(cid:4)(cid:14)(cid:11)(cid:48)(cid:48)(cid:7)(cid:5)(cid:3)(cid:9)(cid:2)(cid:12)(cid:11)(cid:4)(cid:14)(cid:11)(cid:48)(cid:48)(cid:7)(cid:5)(cid:3)(cid:9)(cid:2)(cid:28)(cid:3,Unknown,5459.0
Unknown,Unknown,25,Unknown,Unknown,Unknown,Unknown,cid:3)(cid:5)(cid:14)(cid:70)(cid:12)(cid:11)(cid:4)(cid:14)(cid:11)(cid:48)(cid:48)(cid:7)(cid:5)(cid:3)(cid:9)(cid:2)(cid:12)(cid:11)(cid:4)(cid:14)(cid:11)(cid:48)(cid:48)(cid:7)(cid:5)(cid:3)(cid:9)(cid:2)(cid:28)(cid:3,Unknown,5484.0
Unknown,Unknown,2,Unknown,Unknown,Unknown,Unknown,cid:3)(cid:5)(cid:14)(cid:70)(cid:12)(cid:11)(cid:4)(cid:14)(cid:11)(cid:48)(cid:48)(cid:7)(cid:5)(cid:3)(cid:9)(cid:2)(cid:12)(cid:11)(cid:4)(cid:14)(cid:11)(cid:48)(cid:48)(cid:7)(cid:5)(cid:3)(cid:9)(cid:2)(cid:28)(cid:3,Unknown,5486.0
Unknown,Unknown,58,Unknown,Unknown,Unknown,Unknown,cid:3)(cid:5)(cid:14)(cid:70)(cid:12)(cid:11)(cid:4)(cid:14)(cid:11)(cid:48)(cid:48)(cid:7)(cid:5)(cid:3)(cid:9)(cid:2)(cid:12)(cid:11)(cid:4)(cid:14)(cid:11)(cid:48)(cid:48)(cid:7)(cid:5)(cid:3)(cid:9)(cid:2)(cid:28)(cid:3,Unknown,5544.0
Unknown,Unknown,58,Unknown,Unknown,Unknown,Unknown,cid:3)(cid:5)(cid:14)(cid:70)(cid:12)(cid:11)(cid:4)(cid:14)(cid:11)(cid:48)(cid:48)(cid:7)(cid:5)(cid:3)(cid:9)(cid:2)(cid:12)(cid:11)(cid:4)(cid:14)(cid:11)(cid:48)(cid:48)(cid:7)(cid:5)(cid:3)(cid:9)(cid:2)(cid:28)(cid:3,Unknown,5602.0
Unknown,Unknown,37,Unknown,Unknown,Unknown,Unknown,cid:3)(cid:5)(cid:14)(cid:70)(cid:12)(cid:11)(cid:4)(cid:14)(cid:11)(cid:48)(cid:48)(cid:7)(cid:5)(cid:3)(cid:9)(cid:2)(cid:12)(cid:11)(cid:4)(cid:14)(cid:11)(cid:48)(cid:48)(cid:7)(cid:5)(cid:3)(cid:9)(cid:2)(cid:28)(cid:3,Unknown,5639.0
Unknown,Unknown,16,Unknown,Unknown,Unknown,Unknown,cid:3)(cid:5)(cid:14)(cid:70)(cid:12)(cid:11)(cid:4)(cid:14)(cid:11)(cid:48)(cid:48)(cid:7)(cid:5)(cid:3)(cid:9)(cid:2)(cid:12)(cid:11)(cid:4)(cid:14)(cid:11)(cid:48)(cid:48)(cid:7)(cid:5)(cid:3)(cid:9)(cid:2)(cid:28)(cid:3,Unknown,5655.0
Unknown,Unknown,34,Unknown,Unknown,Unknown,Unknown,cid:3)(cid:5)(cid:14)(cid:70)(cid:12)(cid:11)(cid:4)(cid:14)(cid:11)(cid:48)(cid:48)(cid:7)(cid:5)(cid:3)(cid:9)(cid:2)(cid:12)(cid:11)(cid:4)(cid:14)(cid:11)(cid:48)(cid:48)(cid:7)(cid:5)(cid:3)(cid:9)(cid:2)(cid:28)(cid:3,Unknown,5689.0
Unknown,Unknown,33,Unknown,Unknown,Unknown,Unknown,cid:3)(cid:5)(cid:14)(cid:70)(cid:12)(cid:11)(cid:4)(cid:14)(cid:11)(cid:48)(cid:48)(cid:7)(cid:5)(cid:3)(cid:9)(cid:2)(cid:12)(cid:11)(cid:4)(cid:14)(cid:11)(cid:48)(cid:48)(cid:7)(cid:5)(cid:3)(cid:9)(cid:2)(cid:28)(cid:3,Unknown,5722.0
Unknown,Unknown,17,Unknown,Unknown,Unknown,Unknown,cid:3)(cid:5)(cid:14)(cid:70)(cid:12)(cid:11)(cid:4)(cid:14)(cid:11)(cid:48)(cid:48)(cid:7)(cid:5)(cid:3)(cid:9)(cid:2)(cid:12)(cid:11)(cid:4)(cid:14)(cid:11)(cid:48)(cid:48)(cid:7)(cid:5)(cid:3)(cid:9)(cid:2)(cid:28)(cid:3,Unknown,5739.0
Unknown,Unknown,1,Unknown,Unknown,Unknown,Unknown,cid:3)(cid:5)(cid:14)(cid:70)(cid:12)(cid:11)(cid:4)(cid:14)(cid:11)(cid:48)(cid:48)(cid:7)(cid:5)(cid:3)(cid:9)(cid:2)(cid:12)(cid:11)(cid:4)(cid:14)(cid:11)(cid:48)(cid:48)(cid:7)(cid:5)(cid:3)(cid:9)(cid:2)(cid:28)(cid:3,Unknown,5740.0
Unknown,Unknown,45,Unknown,Unknown,Unknown,Unknown,cid:3)(cid:5)(cid:14)(cid:70)(cid:12)(cid:11)(cid:4)(cid:14)(cid:11)(cid:48)(cid:48)(cid:7)(cid:5)(cid:3)(cid:9)(cid:2)(cid:12)(cid:11)(cid:4)(cid:14)(cid:11)(cid:48)(cid:48)(cid:7)(cid:5)(cid:3)(cid:9)(cid:2)(cid:28)(cid:3,Unknown,5785.0
Unknown,Unknown,18,Unknown,Unknown,Unknown,Unknown,cid:3)(cid:5)(cid:14)(cid:70)(cid:12)(cid:11)(cid:4)(cid:14)(cid:11)(cid:48)(cid:48)(cid:7)(cid:5)(cid:3)(cid:9)(cid:2)(cid:12)(cid:11)(cid:4)(cid:14)(cid:11)(cid:48)(cid:48)(cid:7)(cid:5)(cid:3)(cid:9)(cid:2)(cid:28)(cid:3,Unknown,5803.0
Unknown,Unknown,16,Unknown,Unknown,Unknown,Unknown,cid:3)(cid:5)(cid:14)(cid:70)(cid:12)(cid:11)(cid:4)(cid:14)(cid:11)(cid:48)(cid:48)(cid:7)(cid:5)(cid:3)(cid:9)(cid:2)(cid:12)(cid:11)(cid:4)(cid:14)(cid:11)(cid:48)(cid:48)(cid:7)(cid:5)(cid:3)(cid:9)(cid:2)(cid:28)(cid:3,Unknown,5819.0
Unknown,Unknown,10,Unknown,Unknown,Unknown,Unknown,cid:3)(cid:5)(cid:14)(cid:70)(cid:12)(cid:11)(cid:4)(cid:14)(cid:11)(cid:48)(cid:48)(cid:7)(cid:5)(cid:3)(cid:9)(cid:2)(cid:12)(cid:11)(cid:4)(cid:14)(cid:11)(cid:48)(cid:48)(cid:7)(cid:5)(cid:3)(cid:9)(cid:2)(cid:28)(cid:3,Unknown,5829.0
Unknown,Unknown,11,Unknown,Unknown,Unknown,Unknown,cid:3)(cid:5)(cid:14)(cid:70)(cid:12)(cid:11)(cid:4)(cid:14)(cid:11)(cid:48)(cid:48)(cid:7)(cid:5)(cid:3)(cid:9)(cid:2)(cid:12)(cid:11)(cid:4)(cid:14)(cid:11)(cid:48)(cid:48)(cid:7)(cid:5)(cid:3)(cid:9)(cid:2)(cid:28)(cid:3,Unknown,5840.0
Unknown,Unknown,10,Unknown,Unknown,Unknown,Unknown,cid:3)(cid:5)(cid:14)(cid:70)(cid:12)(cid:11)(cid:4)(cid:14)(cid:11)(cid:48)(cid:48)(cid:7)(cid:5)(cid:3)(cid:9)(cid:2)(cid:12)(cid:11)(cid:4)(cid:14)(cid:11)(cid:48)(cid:48)(cid:7)(cid:5)(cid:3)(cid:9)(cid:2)(cid:28)(cid:3,Unknown,5850.0
Unknown,Unknown,46,Unknown,Unknown,Unknown,Unknown,cid:3)(cid:5)(cid:14)(cid:70)(cid:12)(cid:11)(cid:4)(cid:14)(cid:11)(cid:48)(cid:48)(cid:7)(cid:5)(cid:3)(cid:9)(cid:2)(cid:12)(cid:11)(cid:4)(cid:14)(cid:11)(cid:48)(cid:48)(cid:7)(cid:5)(cid:3)(cid:9)(cid:2)(cid:28)(cid:3,Unknown,5896.0
Unknown,Unknown,14,Unknown,Unknown,Unknown,Unknown,cid:3)(cid:5)(cid:14)(cid:70)(cid:12)(cid:11)(cid:4)(cid:14)(cid:11)(cid:48)(cid:48)(cid:7)(cid:5)(cid:3)(cid:9)(cid:2)(cid:12)(cid:11)(cid:4)(cid:14)(cid:11)(cid:48)(cid:48)(cid:7)(cid:5)(cid:3)(cid:9)(cid:2)(cid:28)(cid:3,Unknown,5910.0
Unknown,Unknown,2,Unknown,Unknown,Unknown,Unknown,cid:3)(cid:5)(cid:14)(cid:70)(cid:12)(cid:11)(cid:4)(cid:14)(cid:11)(cid:48)(cid:48)(cid:7)(cid:5)(cid:3)(cid:9)(cid:2)(cid:12)(cid:11)(cid:4)(cid:14)(cid:11)(cid:48)(cid:48)(cid:7)(cid:5)(cid:3)(cid:9)(cid:2)(cid:28)(cid:3,Unknown,5912.0
Unknown,Unknown,12,Unknown,Unknown,Unknown,Unknown,cid:3)(cid:5)(cid:14)(cid:70)(cid:12)(cid:11)(cid:4)(cid:14)(cid:11)(cid:48)(cid:48)(cid:7)(cid:5)(cid:3)(cid:9)(cid:2)(cid:12)(cid:11)(cid:4)(cid:14)(cid:11)(cid:48)(cid:48)(cid:7)(cid:5)(cid:3)(cid:9)(cid:2)(cid:28)(cid:3,Unknown,5924.0
Unknown,Unknown,11,Unknown,Unknown,Unknown,Unknown,cid:3)(cid:5)(cid:14)(cid:70)(cid:12)(cid:11)(cid:4)(cid:14)(cid:11)(cid:48)(cid:48)(cid:7)(cid:5)(cid:3)(cid:9)(cid:2)(cid:12)(cid:11)(cid:4)(cid:14)(cid:11)(cid:48)(cid:48)(cid:7)(cid:5)(cid:3)(cid:9)(cid:2)(cid:28)(cid:3,Unknown,5935.0
Unknown,Unknown,4,Unknown,Unknown,Unknown,Unknown,cid:3)(cid:5)(cid:14)(cid:70)(cid:12)(cid:11)(cid:4)(cid:14)(cid:11)(cid:48)(cid:48)(cid:7)(cid:5)(cid:3)(cid:9)(cid:2)(cid:12)(cid:11)(cid:4)(cid:14)(cid:11)(cid:48)(cid:48)(cid:7)(cid:5)(cid:3)(cid:9)(cid:2)(cid:28)(cid:3,Unknown,5939.0
Unknown,Unknown,14,Unknown,Unknown,Unknown,Unknown,cid:3)(cid:5)(cid:14)(cid:70)(cid:12)(cid:11)(cid:4)(cid:14)(cid:11)(cid:48)(cid:48)(cid:7)(cid:5)(cid:3)(cid:9)(cid:2)(cid:12)(cid:11)(cid:4)(cid:14)(cid:11)(cid:48)(cid:48)(cid:7)(cid:5)(cid:3)(cid:9)(cid:2)(cid:28)(cid:3,Unknown,5953.0
Unknown,Unknown,11,Unknown,Unknown,Unknown,Unknown,cid:3)(cid:5)(cid:14)(cid:70)(cid:12)(cid:11)(cid:4)(cid:14)(cid:11)(cid:48)(cid:48)(cid:7)(cid:5)(cid:3)(cid:9)(cid:2)(cid:12)(cid:11)(cid:4)(cid:14)(cid:11)(cid:48)(cid:48)(cid:7)(cid:5)(cid:3)(cid:9)(cid:2)(cid:28)(cid:3,Unknown,5964.0
Unknown,Unknown,48,Unknown,Unknown,Unknown,Unknown,cid:3)(cid:5)(cid:14)(cid:70)(cid:12)(cid:11)(cid:4)(cid:14)(cid:11)(cid:48)(cid:48)(cid:7)(cid:5)(cid:3)(cid:9)(cid:2)(cid:12)(cid:11)(cid:4)(cid:14)(cid:11)(cid:48)(cid:48)(cid:7)(cid:5)(cid:3)(cid:9)(cid:2)(cid:28)(cid:3,Unknown,6012.0
Unknown,Unknown,48,Unknown,Unknown,Unknown,Unknown,cid:3)(cid:5)(cid:14)(cid:70)(cid:12)(cid:11)(cid:4)(cid:14)(cid:11)(cid:48)(cid:48)(cid:7)(cid:5)(cid:3)(cid:9)(cid:2)(cid:12)(cid:11)(cid:4)(cid:14)(cid:11)(cid:48)(cid:48)(cid:7)(cid:5)(cid:3)(cid:9)(cid:2)(cid:28)(cid:3,Unknown,6060.0
Unknown,Unknown,7,Unknown,Unknown,Unknown,Unknown,cid:3)(cid:5)(cid:14)(cid:70)(cid:12)(cid:11)(cid:4)(cid:14)(cid:11)(cid:48)(cid:48)(cid:7)(cid:5)(cid:3)(cid:9)(cid:2)(cid:12)(cid:11)(cid:4)(cid:14)(cid:11)(cid:48)(cid:48)(cid:7)(cid:5)(cid:3)(cid:9)(cid:2)(cid:28)(cid:3,Unknown,6067.0
Unknown,Unknown,5,Unknown,Unknown,Unknown,Unknown,cid:3)(cid:5)(cid:14)(cid:70)(cid:12)(cid:11)(cid:4)(cid:14)(cid:11)(cid:48)(cid:48)(cid:7)(cid:5)(cid:3)(cid:9)(cid:2)(cid:12)(cid:11)(cid:4)(cid:14)(cid:11)(cid:48)(cid:48)(cid:7)(cid:5)(cid:3)(cid:9)(cid:2)(cid:28)(cid:3,Unknown,6072.0
Unknown,Unknown,3,Unknown,Unknown,Unknown,Unknown,cid:3)(cid:5)(cid:14)(cid:70)(cid:12)(cid:11)(cid:4)(cid:14)(cid:11)(cid:48)(cid:48)(cid:7)(cid:5)(cid:3)(cid:9)(cid:2)(cid:12)(cid:11)(cid:4)(cid:14)(cid:11)(cid:48)(cid:48)(cid:7)(cid:5)(cid:3)(cid:9)(cid:2)(cid:28)(cid:3,Unknown,6075.0
Unknown,Unknown,9,Unknown,Unknown,Unknown,Unknown,cid:3)(cid:5)(cid:14)(cid:70)(cid:12)(cid:11)(cid:4)(cid:14)(cid:11)(cid:48)(cid:48)(cid:7)(cid:5)(cid:3)(cid:9)(cid:2)(cid:12)(cid:11)(cid:4)(cid:14)(cid:11)(cid:48)(cid:48)(cid:7)(cid:5)(cid:3)(cid:9)(cid:2)(cid:28)(cid:3,Unknown,6084.0
Unknown,Unknown,2,Unknown,Unknown,Unknown,Unknown,cid:3)(cid:5)(cid:14)(cid:70)(cid:12)(cid:11)(cid:4)(cid:14)(cid:11)(cid:48)(cid:48)(cid:7)(cid:5)(cid:3)(cid:9)(cid:2)(cid:12)(cid:11)(cid:4)(cid:14)(cid:11)(cid:48)(cid:48)(cid:7)(cid:5)(cid:3)(cid:9)(cid:2)(cid:28)(cid:3,Unknown,6086.0
Unknown,Unknown,28,Unknown,Unknown,Unknown,Unknown,cid:3)(cid:5)(cid:14)(cid:70)(cid:12)(cid:11)(cid:4)(cid:14)(cid:11)(cid:48)(cid:48)(cid:7)(cid:5)(cid:3)(cid:9)(cid:2)(cid:12)(cid:11)(cid:4)(cid:14)(cid:11)(cid:48)(cid:48)(cid:7)(cid:5)(cid:3)(cid:9)(cid:2)(cid:28)(cid:3,Unknown,6114.0
Unknown,Unknown,3,Unknown,Unknown,Unknown,Unknown,cid:3)(cid:5)(cid:14)(cid:70)(cid:12)(cid:11)(cid:4)(cid:14)(cid:11)(cid:48)(cid:48)(cid:7)(cid:5)(cid:3)(cid:9)(cid:2)(cid:12)(cid:11)(cid:4)(cid:14)(cid:11)(cid:48)(cid:48)(cid:7)(cid:5)(cid:3)(cid:9)(cid:2)(cid:28)(cid:3,Unknown,6117.0
Unknown,Unknown,15,Unknown,Unknown,Unknown,Unknown,cid:3)(cid:5)(cid:14)(cid:70)(cid:12)(cid:11)(cid:4)(cid:14)(cid:11)(cid:48)(cid:48)(cid:7)(cid:5)(cid:3)(cid:9)(cid:2)(cid:12)(cid:11)(cid:4)(cid:14)(cid:11)(cid:48)(cid:48)(cid:7)(cid:5)(cid:3)(cid:9)(cid:2)(cid:28)(cid:3,Unknown,6132.0
Unknown,Unknown,2,Unknown,Unknown,Unknown,Unknown,cid:3)(cid:5)(cid:14)(cid:70)(cid:12)(cid:11)(cid:4)(cid:14)(cid:11)(cid:48)(cid:48)(cid:7)(cid:5)(cid:3)(cid:9)(cid:2)(cid:12)(cid:11)(cid:4)(cid:14)(cid:11)(cid:48)(cid:48)(cid:7)(cid:5)(cid:3)(cid:9)(cid:2)(cid:28)(cid:3,Unknown,6134.0
Unknown,Unknown,16,Unknown,Unknown,Unknown,Unknown,cid:3)(cid:5)(cid:14)(cid:70)(cid:12)(cid:11)(cid:4)(cid:14)(cid:11)(cid:48)(cid:48)(cid:7)(cid:5)(cid:3)(cid:9)(cid:2)(cid:12)(cid:11)(cid:4)(cid:14)(cid:11)(cid:48)(cid:48)(cid:7)(cid:5)(cid:3)(cid:9)(cid:2)(cid:28)(cid:3,Unknown,6150.0
Unknown,Unknown,18,Unknown,Unknown,Unknown,Unknown,cid:3)(cid:5)(cid:14)(cid:70)(cid:12)(cid:11)(cid:4)(cid:14)(cid:11)(cid:48)(cid:48)(cid:7)(cid:5)(cid:3)(cid:9)(cid:2)(cid:12)(cid:11)(cid:4)(cid:14)(cid:11)(cid:48)(cid:48)(cid:7)(cid:5)(cid:3)(cid:9)(cid:2)(cid:28)(cid:3,Unknown,6168.0
Unknown,Unknown,19,Unknown,Unknown,Unknown,Unknown,cid:3)(cid:5)(cid:14)(cid:70)(cid:12)(cid:11)(cid:4)(cid:14)(cid:11)(cid:48)(cid:48)(cid:7)(cid:5)(cid:3)(cid:9)(cid:2)(cid:12)(cid:11)(cid:4)(cid:14)(cid:11)(cid:48)(cid:48)(cid:7)(cid:5)(cid:3)(cid:9)(cid:2)(cid:28)(cid:3,Unknown,6187.0
Unknown,Unknown,18,Unknown,Unknown,Unknown,Unknown,cid:3)(cid:5)(cid:14)(cid:70)(cid:12)(cid:11)(cid:4)(cid:14)(cid:11)(cid:48)(cid:48)(cid:7)(cid:5)(cid:3)(cid:9)(cid:2)(cid:12)(cid:11)(cid:4)(cid:14)(cid:11)(cid:48)(cid:48)(cid:7)(cid:5)(cid:3)(cid:9)(cid:2)(cid:28)(cid:3,Unknown,6205.0
Unknown,Unknown,18,Unknown,Unknown,Unknown,Unknown,cid:3)(cid:5)(cid:14)(cid:70)(cid:12)(cid:11)(cid:4)(cid:14)(cid:11)(cid:48)(cid:48)(cid:7)(cid:5)(cid:3)(cid:9)(cid:2)(cid:12)(cid:11)(cid:4)(cid:14)(cid:11)(cid:48)(cid:48)(cid:7)(cid:5)(cid:3)(cid:9)(cid:2)(cid:28)(cid:3,Unknown,6223.0
Unknown,Unknown,2,Unknown,Unknown,Unknown,Unknown,cid:3)(cid:5)(cid:14)(cid:70)(cid:12)(cid:11)(cid:4)(cid:14)(cid:11)(cid:48)(cid:48)(cid:7)(cid:5)(cid:3)(cid:9)(cid:2)(cid:12)(cid:11)(cid:4)(cid:14)(cid:11)(cid:48)(cid:48)(cid:7)(cid:5)(cid:3)(cid:9)(cid:2)(cid:28)(cid:3,Unknown,6225.0
Unknown,Unknown,44,Unknown,Unknown,Unknown,Unknown,cid:3)(cid:5)(cid:14)(cid:70)(cid:12)(cid:11)(cid:4)(cid:14)(cid:11)(cid:48)(cid:48)(cid:7)(cid:5)(cid:3)(cid:9)(cid:2)(cid:12)(cid:11)(cid:4)(cid:14)(cid:11)(cid:48)(cid:48)(cid:7)(cid:5)(cid:3)(cid:9)(cid:2)(cid:28)(cid:3,Unknown,6269.0
Unknown,Unknown,12,Unknown,Unknown,Unknown,Unknown,cid:3)(cid:5)(cid:14)(cid:70)(cid:12)(cid:11)(cid:4)(cid:14)(cid:11)(cid:48)(cid:48)(cid:7)(cid:5)(cid:3)(cid:9)(cid:2)(cid:12)(cid:11)(cid:4)(cid:14)(cid:11)(cid:48)(cid:48)(cid:7)(cid:5)(cid:3)(cid:9)(cid:2)(cid:28)(cid:3,Unknown,6281.0
Unknown,Unknown,29,Unknown,Unknown,Unknown,Unknown,cid:3)(cid:5)(cid:14)(cid:70)(cid:12)(cid:11)(cid:4)(cid:14)(cid:11)(cid:48)(cid:48)(cid:7)(cid:5)(cid:3)(cid:9)(cid:2)(cid:12)(cid:11)(cid:4)(cid:14)(cid:11)(cid:48)(cid:48)(cid:7)(cid:5)(cid:3)(cid:9)(cid:2)(cid:28)(cid:3,Unknown,6310.0
Unknown,Unknown,26,Unknown,Unknown,Unknown,Unknown,cid:3)(cid:5)(cid:14)(cid:70)(cid:12)(cid:11)(cid:4)(cid:14)(cid:11)(cid:48)(cid:48)(cid:7)(cid:5)(cid:3)(cid:9)(cid:2)(cid:12)(cid:11)(cid:4)(cid:14)(cid:11)(cid:48)(cid:48)(cid:7)(cid:5)(cid:3)(cid:9)(cid:2)(cid:28)(cid:3,Unknown,6336.0
Unknown,Unknown,41,Unknown,Unknown,Unknown,Unknown,cid:3)(cid:5)(cid:14)(cid:70)(cid:12)(cid:11)(cid:4)(cid:14)(cid:11)(cid:48)(cid:48)(cid:7)(cid:5)(cid:3)(cid:9)(cid:2)(cid:12)(cid:11)(cid:4)(cid:14)(cid:11)(cid:48)(cid:48)(cid:7)(cid:5)(cid:3)(cid:9)(cid:2)(cid:28)(cid:3,Unknown,6377.0
Unknown,Unknown,25,Unknown,Unknown,Unknown,Unknown,cid:3)(cid:5)(cid:14)(cid:70)(cid:12)(cid:11)(cid:4)(cid:14)(cid:11)(cid:48)(cid:48)(cid:7)(cid:5)(cid:3)(cid:9)(cid:2)(cid:12)(cid:11)(cid:4)(cid:14)(cid:11)(cid:48)(cid:48)(cid:7)(cid:5)(cid:3)(cid:9)(cid:2)(cid:28)(cid:3,Unknown,6402.0
Unknown,Unknown,2,Unknown,Unknown,Unknown,Unknown,cid:3)(cid:5)(cid:14)(cid:70)(cid:12)(cid:11)(cid:4)(cid:14)(cid:11)(cid:48)(cid:48)(cid:7)(cid:5)(cid:3)(cid:9)(cid:2)(cid:12)(cid:11)(cid:4)(cid:14)(cid:11)(cid:48)(cid:48)(cid:7)(cid:5)(cid:3)(cid:9)(cid:2)(cid:28)(cid:3,Unknown,6404.0
Unknown,Unknown,58,Unknown,Unknown,Unknown,Unknown,cid:3)(cid:5)(cid:14)(cid:70)(cid:12)(cid:11)(cid:4)(cid:14)(cid:11)(cid:48)(cid:48)(cid:7)(cid:5)(cid:3)(cid:9)(cid:2)(cid:12)(cid:11)(cid:4)(cid:14)(cid:11)(cid:48)(cid:48)(cid:7)(cid:5)(cid:3)(cid:9)(cid:2)(cid:28)(cid:3,Unknown,6462.0
Unknown,Unknown,58,Unknown,Unknown,Unknown,Unknown,cid:3)(cid:5)(cid:14)(cid:70)(cid:12)(cid:11)(cid:4)(cid:14)(cid:11)(cid:48)(cid:48)(cid:7)(cid:5)(cid:3)(cid:9)(cid:2)(cid:12)(cid:11)(cid:4)(cid:14)(cid:11)(cid:48)(cid:48)(cid:7)(cid:5)(cid:3)(cid:9)(cid:2)(cid:28)(cid:3,Unknown,6520.0
Unknown,Unknown,18,Unknown,Unknown,Unknown,Unknown,cid:3)(cid:5)(cid:14)(cid:70)(cid:12)(cid:11)(cid:4)(cid:14)(cid:11)(cid:48)(cid:48)(cid:7)(cid:5)(cid:3)(cid:9)(cid:2)(cid:12)(cid:11)(cid:4)(cid:14)(cid:11)(cid:48)(cid:48)(cid:7)(cid:5)(cid:3)(cid:9)(cid:2)(cid:28)(cid:3,Unknown,6538.0
Unknown,Unknown,1,Unknown,Unknown,Unknown,Unknown,cid:3)(cid:5)(cid:14)(cid:70)(cid:12)(cid:11)(cid:4)(cid:14)(cid:11)(cid:48)(cid:48)(cid:7)(cid:5)(cid:3)(cid:9)(cid:2)(cid:12)(cid:11)(cid:4)(cid:14)(cid:11)(cid:48)(cid:48)(cid:7)(cid:5)(cid:3)(cid:9)(cid:2)(cid:28)(cid:3,Unknown,6539.0
Unknown,Unknown,1,Unknown,Unknown,Unknown,Unknown,cid:3)(cid:5)(cid:14)(cid:70)(cid:12)(cid:11)(cid:4)(cid:14)(cid:11)(cid:48)(cid:48)(cid:7)(cid:5)(cid:3)(cid:9)(cid:2)(cid:12)(cid:11)(cid:4)(cid:14)(cid:11)(cid:48)(cid:48)(cid:7)(cid:5)(cid:3)(cid:9)(cid:2)(cid:28)(cid:3,Unknown,6540.0
Unknown,Unknown,37,Unknown,Unknown,Unknown,Unknown,cid:3)(cid:5)(cid:14)(cid:70)(cid:12)(cid:11)(cid:4)(cid:14)(cid:11)(cid:48)(cid:48)(cid:7)(cid:5)(cid:3)(cid:9)(cid:2)(cid:12)(cid:11)(cid:4)(cid:14)(cid:11)(cid:48)(cid:48)(cid:7)(cid:5)(cid:3)(cid:9)(cid:2)(cid:28)(cid:3,Unknown,6577.0
Unknown,Unknown,17,Unknown,Unknown,Unknown,Unknown,cid:3)(cid:5)(cid:14)(cid:70)(cid:12)(cid:11)(cid:4)(cid:14)(cid:11)(cid:48)(cid:48)(cid:7)(cid:5)(cid:3)(cid:9)(cid:2)(cid:12)(cid:11)(cid:4)(cid:14)(cid:11)(cid:48)(cid:48)(cid:7)(cid:5)(cid:3)(cid:9)(cid:2)(cid:28)(cid:3,Unknown,6594.0
Unknown,Unknown,37,Unknown,Unknown,Unknown,Unknown,cid:3)(cid:5)(cid:14)(cid:70)(cid:12)(cid:11)(cid:4)(cid:14)(cid:11)(cid:48)(cid:48)(cid:7)(cid:5)(cid:3)(cid:9)(cid:2)(cid:12)(cid:11)(cid:4)(cid:14)(cid:11)(cid:48)(cid:48)(cid:7)(cid:5)(cid:3)(cid:9)(cid:2)(cid:28)(cid:3,Unknown,6631.0
Unknown,Unknown,45,Unknown,Unknown,Unknown,Unknown,cid:3)(cid:5)(cid:14)(cid:70)(cid:12)(cid:11)(cid:4)(cid:14)(cid:11)(cid:48)(cid:48)(cid:7)(cid:5)(cid:3)(cid:9)(cid:2)(cid:12)(cid:11)(cid:4)(cid:14)(cid:11)(cid:48)(cid:48)(cid:7)(cid:5)(cid:3)(cid:9)(cid:2)(cid:28)(cid:3,Unknown,6676.0
Unknown,Unknown,18,Unknown,Unknown,Unknown,Unknown,cid:3)(cid:5)(cid:14)(cid:70)(cid:12)(cid:11)(cid:4)(cid:14)(cid:11)(cid:48)(cid:48)(cid:7)(cid:5)(cid:3)(cid:9)(cid:2)(cid:12)(cid:11)(cid:4)(cid:14)(cid:11)(cid:48)(cid:48)(cid:7)(cid:5)(cid:3)(cid:9)(cid:2)(cid:28)(cid:3,Unknown,6694.0
Unknown,Unknown,16,Unknown,Unknown,Unknown,Unknown,cid:3)(cid:5)(cid:14)(cid:70)(cid:12)(cid:11)(cid:4)(cid:14)(cid:11)(cid:48)(cid:48)(cid:7)(cid:5)(cid:3)(cid:9)(cid:2)(cid:12)(cid:11)(cid:4)(cid:14)(cid:11)(cid:48)(cid:48)(cid:7)(cid:5)(cid:3)(cid:9)(cid:2)(cid:28)(cid:3,Unknown,6710.0
Unknown,Unknown,11,Unknown,Unknown,Unknown,Unknown,cid:3)(cid:5)(cid:14)(cid:70)(cid:12)(cid:11)(cid:4)(cid:14)(cid:11)(cid:48)(cid:48)(cid:7)(cid:5)(cid:3)(cid:9)(cid:2)(cid:12)(cid:11)(cid:4)(cid:14)(cid:11)(cid:48)(cid:48)(cid:7)(cid:5)(cid:3)(cid:9)(cid:2)(cid:28)(cid:3,Unknown,6721.0
Unknown,Unknown,39,Unknown,Unknown,Unknown,Unknown,cid:3)(cid:5)(cid:14)(cid:70)(cid:12)(cid:11)(cid:4)(cid:14)(cid:11)(cid:48)(cid:48)(cid:7)(cid:5)(cid:3)(cid:9)(cid:2)(cid:12)(cid:11)(cid:4)(cid:14)(cid:11)(cid:48)(cid:48)(cid:7)(cid:5)(cid:3)(cid:9)(cid:2)(cid:28)(cid:3,Unknown,6760.0
Unknown,Unknown,13,Unknown,Unknown,Unknown,Unknown,cid:3)(cid:5)(cid:14)(cid:70)(cid:12)(cid:11)(cid:4)(cid:14)(cid:11)(cid:48)(cid:48)(cid:7)(cid:5)(cid:3)(cid:9)(cid:2)(cid:12)(cid:11)(cid:4)(cid:14)(cid:11)(cid:48)(cid:48)(cid:7)(cid:5)(cid:3)(cid:9)(cid:2)(cid:28)(cid:3,Unknown,6773.0
Unknown,Unknown,2,Unknown,Unknown,Unknown,Unknown,cid:3)(cid:5)(cid:14)(cid:70)(cid:12)(cid:11)(cid:4)(cid:14)(cid:11)(cid:48)(cid:48)(cid:7)(cid:5)(cid:3)(cid:9)(cid:2)(cid:12)(cid:11)(cid:4)(cid:14)(cid:11)(cid:48)(cid:48)(cid:7)(cid:5)(cid:3)(cid:9)(cid:2)(cid:28)(cid:3,Unknown,6775.0
Unknown,Unknown,12,Unknown,Unknown,Unknown,Unknown,cid:3)(cid:5)(cid:14)(cid:70)(cid:12)(cid:11)(cid:4)(cid:14)(cid:11)(cid:48)(cid:48)(cid:7)(cid:5)(cid:3)(cid:9)(cid:2)(cid:12)(cid:11)(cid:4)(cid:14)(cid:11)(cid:48)(cid:48)(cid:7)(cid:5)(cid:3)(cid:9)(cid:2)(cid:28)(cid:3,Unknown,6787.0
Unknown,Unknown,11,Unknown,Unknown,Unknown,Unknown,cid:3)(cid:5)(cid:14)(cid:70)(cid:12)(cid:11)(cid:4)(cid:14)(cid:11)(cid:48)(cid:48)(cid:7)(cid:5)(cid:3)(cid:9)(cid:2)(cid:12)(cid:11)(cid:4)(cid:14)(cid:11)(cid:48)(cid:48)(cid:7)(cid:5)(cid:3)(cid:9)(cid:2)(cid:28)(cid:3,Unknown,6798.0
Unknown,Unknown,4,Unknown,Unknown,Unknown,Unknown,cid:3)(cid:5)(cid:14)(cid:70)(cid:12)(cid:11)(cid:4)(cid:14)(cid:11)(cid:48)(cid:48)(cid:7)(cid:5)(cid:3)(cid:9)(cid:2)(cid:12)(cid:11)(cid:4)(cid:14)(cid:11)(cid:48)(cid:48)(cid:7)(cid:5)(cid:3)(cid:9)(cid:2)(cid:28)(cid:3,Unknown,6802.0
Unknown,Unknown,14,Unknown,Unknown,Unknown,Unknown,cid:3)(cid:5)(cid:14)(cid:70)(cid:12)(cid:11)(cid:4)(cid:14)(cid:11)(cid:48)(cid:48)(cid:7)(cid:5)(cid:3)(cid:9)(cid:2)(cid:12)(cid:11)(cid:4)(cid:14)(cid:11)(cid:48)(cid:48)(cid:7)(cid:5)(cid:3)(cid:9)(cid:2)(cid:28)(cid:3,Unknown,6816.0
Unknown,Unknown,11,Unknown,Unknown,Unknown,Unknown,cid:3)(cid:5)(cid:14)(cid:70)(cid:12)(cid:11)(cid:4)(cid:14)(cid:11)(cid:48)(cid:48)(cid:7)(cid:5)(cid:3)(cid:9)(cid:2)(cid:12)(cid:11)(cid:4)(cid:14)(cid:11)(cid:48)(cid:48)(cid:7)(cid:5)(cid:3)(cid:9)(cid:2)(cid:28)(cid:3,Unknown,6827.0
Unknown,Unknown,48,Unknown,Unknown,Unknown,Unknown,cid:3)(cid:5)(cid:14)(cid:70)(cid:12)(cid:11)(cid:4)(cid:14)(cid:11)(cid:48)(cid:48)(cid:7)(cid:5)(cid:3)(cid:9)(cid:2)(cid:12)(cid:11)(cid:4)(cid:14)(cid:11)(cid:48)(cid:48)(cid:7)(cid:5)(cid:3)(cid:9)(cid:2)(cid:28)(cid:3,Unknown,6875.0
Unknown,Unknown,48,Unknown,Unknown,Unknown,Unknown,cid:3)(cid:5)(cid:14)(cid:70)(cid:12)(cid:11)(cid:4)(cid:14)(cid:11)(cid:48)(cid:48)(cid:7)(cid:5)(cid:3)(cid:9)(cid:2)(cid:12)(cid:11)(cid:4)(cid:14)(cid:11)(cid:48)(cid:48)(cid:7)(cid:5)(cid:3)(cid:9)(cid:2)(cid:28)(cid:3,Unknown,6923.0
Unknown,Unknown,7,Unknown,Unknown,Unknown,Unknown,cid:3)(cid:5)(cid:14)(cid:70)(cid:12)(cid:11)(cid:4)(cid:14)(cid:11)(cid:48)(cid:48)(cid:7)(cid:5)(cid:3)(cid:9)(cid:2)(cid:12)(cid:11)(cid:4)(cid:14)(cid:11)(cid:48)(cid:48)(cid:7)(cid:5)(cid:3)(cid:9)(cid:2)(cid:28)(cid:3,Unknown,6930.0
Unknown,Unknown,5,Unknown,Unknown,Unknown,Unknown,cid:3)(cid:5)(cid:14)(cid:70)(cid:12)(cid:11)(cid:4)(cid:14)(cid:11)(cid:48)(cid:48)(cid:7)(cid:5)(cid:3)(cid:9)(cid:2)(cid:12)(cid:11)(cid:4)(cid:14)(cid:11)(cid:48)(cid:48)(cid:7)(cid:5)(cid:3)(cid:9)(cid:2)(cid:28)(cid:3,Unknown,6935.0
Unknown,Unknown,3,Unknown,Unknown,Unknown,Unknown,cid:3)(cid:5)(cid:14)(cid:70)(cid:12)(cid:11)(cid:4)(cid:14)(cid:11)(cid:48)(cid:48)(cid:7)(cid:5)(cid:3)(cid:9)(cid:2)(cid:12)(cid:11)(cid:4)(cid:14)(cid:11)(cid:48)(cid:48)(cid:7)(cid:5)(cid:3)(cid:9)(cid:2)(cid:28)(cid:3,Unknown,6938.0
Unknown,Unknown,9,Unknown,Unknown,Unknown,Unknown,cid:3)(cid:5)(cid:14)(cid:70)(cid:12)(cid:11)(cid:4)(cid:14)(cid:11)(cid:48)(cid:48)(cid:7)(cid:5)(cid:3)(cid:9)(cid:2)(cid:12)(cid:11)(cid:4)(cid:14)(cid:11)(cid:48)(cid:48)(cid:7)(cid:5)(cid:3)(cid:9)(cid:2)(cid:28)(cid:3,Unknown,6947.0
Unknown,Unknown,2,Unknown,Unknown,Unknown,Unknown,cid:3)(cid:5)(cid:14)(cid:70)(cid:12)(cid:11)(cid:4)(cid:14)(cid:11)(cid:48)(cid:48)(cid:7)(cid:5)(cid:3)(cid:9)(cid:2)(cid:12)(cid:11)(cid:4)(cid:14)(cid:11)(cid:48)(cid:48)(cid:7)(cid:5)(cid:3)(cid:9)(cid:2)(cid:28)(cid:3,Unknown,6949.0
Unknown,Unknown,12,Unknown,Unknown,Unknown,Unknown,cid:3)(cid:5)(cid:14)(cid:70)(cid:12)(cid:11)(cid:4)(cid:14)(cid:11)(cid:48)(cid:48)(cid:7)(cid:5)(cid:3)(cid:9)(cid:2)(cid:12)(cid:11)(cid:4)(cid:14)(cid:11)(cid:48)(cid:48)(cid:7)(cid:5)(cid:3)(cid:9)(cid:2)(cid:28)(cid:3,Unknown,6961.0
Unknown,Unknown,11,Unknown,Unknown,Unknown,Unknown,cid:3)(cid:5)(cid:14)(cid:70)(cid:12)(cid:11)(cid:4)(cid:14)(cid:11)(cid:48)(cid:48)(cid:7)(cid:5)(cid:3)(cid:9)(cid:2)(cid:12)(cid:11)(cid:4)(cid:14)(cid:11)(cid:48)(cid:48)(cid:7)(cid:5)(cid:3)(cid:9)(cid:2)(cid:28)(cid:3,Unknown,6972.0
Unknown,Unknown,4,Unknown,Unknown,Unknown,Unknown,cid:3)(cid:5)(cid:14)(cid:70)(cid:12)(cid:11)(cid:4)(cid:14)(cid:11)(cid:48)(cid:48)(cid:7)(cid:5)(cid:3)(cid:9)(cid:2)(cid:12)(cid:11)(cid:4)(cid:14)(cid:11)(cid:48)(cid:48)(cid:7)(cid:5)(cid:3)(cid:9)(cid:2)(cid:28)(cid:3,Unknown,6976.0
Unknown,Unknown,14,Unknown,Unknown,Unknown,Unknown,cid:3)(cid:5)(cid:14)(cid:70)(cid:12)(cid:11)(cid:4)(cid:14)(cid:11)(cid:48)(cid:48)(cid:7)(cid:5)(cid:3)(cid:9)(cid:2)(cid:12)(cid:11)(cid:4)(cid:14)(cid:11)(cid:48)(cid:48)(cid:7)(cid:5)(cid:3)(cid:9)(cid:2)(cid:28)(cid:3,Unknown,6990.0
Unknown,Unknown,11,Unknown,Unknown,Unknown,Unknown,cid:3)(cid:5)(cid:14)(cid:70)(cid:12)(cid:11)(cid:4)(cid:14)(cid:11)(cid:48)(cid:48)(cid:7)(cid:5)(cid:3)(cid:9)(cid:2)(cid:12)(cid:11)(cid:4)(cid:14)(cid:11)(cid:48)(cid:48)(cid:7)(cid:5)(cid:3)(cid:9)(cid:2)(cid:28)(cid:3,Unknown,7001.0
Unknown,Unknown,48,Unknown,Unknown,Unknown,Unknown,cid:3)(cid:5)(cid:14)(cid:70)(cid:12)(cid:11)(cid:4)(cid:14)(cid:11)(cid:48)(cid:48)(cid:7)(cid:5)(cid:3)(cid:9)(cid:2)(cid:12)(cid:11)(cid:4)(cid:14)(cid:11)(cid:48)(cid:48)(cid:7)(cid:5)(cid:3)(cid:9)(cid:2)(cid:28)(cid:3,Unknown,7049.0
Unknown,Unknown,48,Unknown,Unknown,Unknown,Unknown,cid:3)(cid:5)(cid:14)(cid:70)(cid:12)(cid:11)(cid:4)(cid:14)(cid:11)(cid:48)(cid:48)(cid:7)(cid:5)(cid:3)(cid:9)(cid:2)(cid:12)(cid:11)(cid:4)(cid:14)(cid:11)(cid:48)(cid:48)(cid:7)(cid:5)(cid:3)(cid:9)(cid:2)(cid:28)(cid:3,Unknown,7097.0
Unknown,Unknown,7,Unknown,Unknown,Unknown,Unknown,cid:3)(cid:5)(cid:14)(cid:70)(cid:12)(cid:11)(cid:4)(cid:14)(cid:11)(cid:48)(cid:48)(cid:7)(cid:5)(cid:3)(cid:9)(cid:2)(cid:12)(cid:11)(cid:4)(cid:14)(cid:11)(cid:48)(cid:48)(cid:7)(cid:5)(cid:3)(cid:9)(cid:2)(cid:28)(cid:3,Unknown,7104.0
Unknown,Unknown,5,Unknown,Unknown,Unknown,Unknown,cid:3)(cid:5)(cid:14)(cid:70)(cid:12)(cid:11)(cid:4)(cid:14)(cid:11)(cid:48)(cid:48)(cid:7)(cid:5)(cid:3)(cid:9)(cid:2)(cid:12)(cid:11)(cid:4)(cid:14)(cid:11)(cid:48)(cid:48)(cid:7)(cid:5)(cid:3)(cid:9)(cid:2)(cid:28)(cid:3,Unknown,7109.0
Unknown,Unknown,3,Unknown,Unknown,Unknown,Unknown,cid:3)(cid:5)(cid:14)(cid:70)(cid:12)(cid:11)(cid:4)(cid:14)(cid:11)(cid:48)(cid:48)(cid:7)(cid:5)(cid:3)(cid:9)(cid:2)(cid:12)(cid:11)(cid:4)(cid:14)(cid:11)(cid:48)(cid:48)(cid:7)(cid:5)(cid:3)(cid:9)(cid:2)(cid:28)(cid:3,Unknown,7112.0
Unknown,Unknown,9,Unknown,Unknown,Unknown,Unknown,cid:3)(cid:5)(cid:14)(cid:70)(cid:12)(cid:11)(cid:4)(cid:14)(cid:11)(cid:48)(cid:48)(cid:7)(cid:5)(cid:3)(cid:9)(cid:2)(cid:12)(cid:11)(cid:4)(cid:14)(cid:11)(cid:48)(cid:48)(cid:7)(cid:5)(cid:3)(cid:9)(cid:2)(cid:28)(cid:3,Unknown,7121.0
Unknown,Unknown,2,Unknown,Unknown,Unknown,Unknown,cid:3)(cid:5)(cid:14)(cid:70)(cid:12)(cid:11)(cid:4)(cid:14)(cid:11)(cid:48)(cid:48)(cid:7)(cid:5)(cid:3)(cid:9)(cid:2)(cid:12)(cid:11)(cid:4)(cid:14)(cid:11)(cid:48)(cid:48)(cid:7)(cid:5)(cid:3)(cid:9)(cid:2)(cid:28)(cid:3,Unknown,7123.0
Unknown,Unknown,28,Unknown,Unknown,Unknown,Unknown,cid:3)(cid:5)(cid:14)(cid:70)(cid:12)(cid:11)(cid:4)(cid:14)(cid:11)(cid:48)(cid:48)(cid:7)(cid:5)(cid:3)(cid:9)(cid:2)(cid:12)(cid:11)(cid:4)(cid:14)(cid:11)(cid:48)(cid:48)(cid:7)(cid:5)(cid:3)(cid:9)(cid:2)(cid:28)(cid:3,Unknown,7151.0
Unknown,Unknown,3,Unknown,Unknown,Unknown,Unknown,cid:3)(cid:5)(cid:14)(cid:70)(cid:12)(cid:11)(cid:4)(cid:14)(cid:11)(cid:48)(cid:48)(cid:7)(cid:5)(cid:3)(cid:9)(cid:2)(cid:12)(cid:11)(cid:4)(cid:14)(cid:11)(cid:48)(cid:48)(cid:7)(cid:5)(cid:3)(cid:9)(cid:2)(cid:28)(cid:3,Unknown,7154.0
Unknown,Unknown,15,Unknown,Unknown,Unknown,Unknown,cid:3)(cid:5)(cid:14)(cid:70)(cid:12)(cid:11)(cid:4)(cid:14)(cid:11)(cid:48)(cid:48)(cid:7)(cid:5)(cid:3)(cid:9)(cid:2)(cid:12)(cid:11)(cid:4)(cid:14)(cid:11)(cid:48)(cid:48)(cid:7)(cid:5)(cid:3)(cid:9)(cid:2)(cid:28)(cid:3,Unknown,7169.0
Unknown,Unknown,2,Unknown,Unknown,Unknown,Unknown,cid:3)(cid:5)(cid:14)(cid:70)(cid:12)(cid:11)(cid:4)(cid:14)(cid:11)(cid:48)(cid:48)(cid:7)(cid:5)(cid:3)(cid:9)(cid:2)(cid:12)(cid:11)(cid:4)(cid:14)(cid:11)(cid:48)(cid:48)(cid:7)(cid:5)(cid:3)(cid:9)(cid:2)(cid:28)(cid:3,Unknown,7171.0
Unknown,Unknown,17,Unknown,Unknown,Unknown,Unknown,cid:3)(cid:5)(cid:14)(cid:70)(cid:12)(cid:11)(cid:4)(cid:14)(cid:11)(cid:48)(cid:48)(cid:7)(cid:5)(cid:3)(cid:9)(cid:2)(cid:12)(cid:11)(cid:4)(cid:14)(cid:11)(cid:48)(cid:48)(cid:7)(cid:5)(cid:3)(cid:9)(cid:2)(cid:28)(cid:3,Unknown,7188.0
Unknown,Unknown,37,Unknown,Unknown,Unknown,Unknown,cid:3)(cid:5)(cid:14)(cid:70)(cid:12)(cid:11)(cid:4)(cid:14)(cid:11)(cid:48)(cid:48)(cid:7)(cid:5)(cid:3)(cid:9)(cid:2)(cid:12)(cid:11)(cid:4)(cid:14)(cid:11)(cid:48)(cid:48)(cid:7)(cid:5)(cid:3)(cid:9)(cid:2)(cid:28)(cid:3,Unknown,7225.0
Unknown,Unknown,32,Unknown,Unknown,Unknown,Unknown,cid:3)(cid:5)(cid:14)(cid:70)(cid:12)(cid:11)(cid:4)(cid:14)(cid:11)(cid:48)(cid:48)(cid:7)(cid:5)(cid:3)(cid:9)(cid:2)(cid:12)(cid:11)(cid:4)(cid:14)(cid:11)(cid:48)(cid:48)(cid:7)(cid:5)(cid:3)(cid:9)(cid:2)(cid:28)(cid:3,Unknown,7257.0
Unknown,Unknown,19,Unknown,Unknown,Unknown,Unknown,cid:3)(cid:5)(cid:14)(cid:70)(cid:12)(cid:11)(cid:4)(cid:14)(cid:11)(cid:48)(cid:48)(cid:7)(cid:5)(cid:3)(cid:9)(cid:2)(cid:12)(cid:11)(cid:4)(cid:14)(cid:11)(cid:48)(cid:48)(cid:7)(cid:5)(cid:3)(cid:9)(cid:2)(cid:28)(cid:3,Unknown,7276.0
Unknown,Unknown,36,Unknown,Unknown,Unknown,Unknown,cid:3)(cid:5)(cid:14)(cid:70)(cid:12)(cid:11)(cid:4)(cid:14)(cid:11)(cid:48)(cid:48)(cid:7)(cid:5)(cid:3)(cid:9)(cid:2)(cid:12)(cid:11)(cid:4)(cid:14)(cid:11)(cid:48)(cid:48)(cid:7)(cid:5)(cid:3)(cid:9)(cid:2)(cid:28)(cid:3,Unknown,7312.0
Unknown,Unknown,18,Unknown,Unknown,Unknown,Unknown,cid:3)(cid:5)(cid:14)(cid:70)(cid:12)(cid:11)(cid:4)(cid:14)(cid:11)(cid:48)(cid:48)(cid:7)(cid:5)(cid:3)(cid:9)(cid:2)(cid:12)(cid:11)(cid:4)(cid:14)(cid:11)(cid:48)(cid:48)(cid:7)(cid:5)(cid:3)(cid:9)(cid:2)(cid:28)(cid:3,Unknown,7330.0
Unknown,Unknown,2,Unknown,Unknown,Unknown,Unknown,cid:3)(cid:5)(cid:14)(cid:70)(cid:12)(cid:11)(cid:4)(cid:14)(cid:11)(cid:48)(cid:48)(cid:7)(cid:5)(cid:3)(cid:9)(cid:2)(cid:12)(cid:11)(cid:4)(cid:14)(cid:11)(cid:48)(cid:48)(cid:7)(cid:5)(cid:3)(cid:9)(cid:2)(cid:28)(cid:3,Unknown,7332.0
Unknown,Unknown,44,Unknown,Unknown,Unknown,Unknown,cid:3)(cid:5)(cid:14)(cid:70)(cid:12)(cid:11)(cid:4)(cid:14)(cid:11)(cid:48)(cid:48)(cid:7)(cid:5)(cid:3)(cid:9)(cid:2)(cid:12)(cid:11)(cid:4)(cid:14)(cid:11)(cid:48)(cid:48)(cid:7)(cid:5)(cid:3)(cid:9)(cid:2)(cid:28)(cid:3,Unknown,7376.0
Unknown,Unknown,12,Unknown,Unknown,Unknown,Unknown,cid:3)(cid:5)(cid:14)(cid:70)(cid:12)(cid:11)(cid:4)(cid:14)(cid:11)(cid:48)(cid:48)(cid:7)(cid:5)(cid:3)(cid:9)(cid:2)(cid:12)(cid:11)(cid:4)(cid:14)(cid:11)(cid:48)(cid:48)(cid:7)(cid:5)(cid:3)(cid:9)(cid:2)(cid:28)(cid:3,Unknown,7388.0
Unknown,Unknown,29,Unknown,Unknown,Unknown,Unknown,cid:3)(cid:5)(cid:14)(cid:70)(cid:12)(cid:11)(cid:4)(cid:14)(cid:11)(cid:48)(cid:48)(cid:7)(cid:5)(cid:3)(cid:9)(cid:2)(cid:12)(cid:11)(cid:4)(cid:14)(cid:11)(cid:48)(cid:48)(cid:7)(cid:5)(cid:3)(cid:9)(cid:2)(cid:28)(cid:3,Unknown,7417.0
Unknown,Unknown,26,Unknown,Unknown,Unknown,Unknown,cid:3)(cid:5)(cid:14)(cid:70)(cid:12)(cid:11)(cid:4)(cid:14)(cid:11)(cid:48)(cid:48)(cid:7)(cid:5)(cid:3)(cid:9)(cid:2)(cid:12)(cid:11)(cid:4)(cid:14)(cid:11)(cid:48)(cid:48)(cid:7)(cid:5)(cid:3)(cid:9)(cid:2)(cid:28)(cid:3,Unknown,7443.0
Unknown,Unknown,41,Unknown,Unknown,Unknown,Unknown,cid:3)(cid:5)(cid:14)(cid:70)(cid:12)(cid:11)(cid:4)(cid:14)(cid:11)(cid:48)(cid:48)(cid:7)(cid:5)(cid:3)(cid:9)(cid:2)(cid:12)(cid:11)(cid:4)(cid:14)(cid:11)(cid:48)(cid:48)(cid:7)(cid:5)(cid:3)(cid:9)(cid:2)(cid:28)(cid:3,Unknown,7484.0
Unknown,Unknown,25,Unknown,Unknown,Unknown,Unknown,cid:3)(cid:5)(cid:14)(cid:70)(cid:12)(cid:11)(cid:4)(cid:14)(cid:11)(cid:48)(cid:48)(cid:7)(cid:5)(cid:3)(cid:9)(cid:2)(cid:12)(cid:11)(cid:4)(cid:14)(cid:11)(cid:48)(cid:48)(cid:7)(cid:5)(cid:3)(cid:9)(cid:2)(cid:28)(cid:3,Unknown,7509.0
Unknown,Unknown,2,Unknown,Unknown,Unknown,Unknown,cid:3)(cid:5)(cid:14)(cid:70)(cid:12)(cid:11)(cid:4)(cid:14)(cid:11)(cid:48)(cid:48)(cid:7)(cid:5)(cid:3)(cid:9)(cid:2)(cid:12)(cid:11)(cid:4)(cid:14)(cid:11)(cid:48)(cid:48)(cid:7)(cid:5)(cid:3)(cid:9)(cid:2)(cid:28)(cid:3,Unknown,7511.0
Unknown,Unknown,58,Unknown,Unknown,Unknown,Unknown,cid:3)(cid:5)(cid:14)(cid:70)(cid:12)(cid:11)(cid:4)(cid:14)(cid:11)(cid:48)(cid:48)(cid:7)(cid:5)(cid:3)(cid:9)(cid:2)(cid:12)(cid:11)(cid:4)(cid:14)(cid:11)(cid:48)(cid:48)(cid:7)(cid:5)(cid:3)(cid:9)(cid:2)(cid:28)(cid:3,Unknown,7569.0
Unknown,Unknown,58,Unknown,Unknown,Unknown,Unknown,cid:3)(cid:5)(cid:14)(cid:70)(cid:12)(cid:11)(cid:4)(cid:14)(cid:11)(cid:48)(cid:48)(cid:7)(cid:5)(cid:3)(cid:9)(cid:2)(cid:12)(cid:11)(cid:4)(cid:14)(cid:11)(cid:48)(cid:48)(cid:7)(cid:5)(cid:3)(cid:9)(cid:2)(cid:28)(cid:3,Unknown,7627.0
Unknown,Unknown,37,Unknown,Unknown,Unknown,Unknown,cid:3)(cid:5)(cid:14)(cid:70)(cid:12)(cid:11)(cid:4)(cid:14)(cid:11)(cid:48)(cid:48)(cid:7)(cid:5)(cid:3)(cid:9)(cid:2)(cid:12)(cid:11)(cid:4)(cid:14)(cid:11)(cid:48)(cid:48)(cid:7)(cid:5)(cid:3)(cid:9)(cid:2)(cid:28)(cid:3,Unknown,7664.0
Unknown,Unknown,16,Unknown,Unknown,Unknown,Unknown,cid:3)(cid:5)(cid:14)(cid:70)(cid:12)(cid:11)(cid:4)(cid:14)(cid:11)(cid:48)(cid:48)(cid:7)(cid:5)(cid:3)(cid:9)(cid:2)(cid:12)(cid:11)(cid:4)(cid:14)(cid:11)(cid:48)(cid:48)(cid:7)(cid:5)(cid:3)(cid:9)(cid:2)(cid:28)(cid:3,Unknown,7680.0
Unknown,Unknown,34,Unknown,Unknown,Unknown,Unknown,cid:3)(cid:5)(cid:14)(cid:70)(cid:12)(cid:11)(cid:4)(cid:14)(cid:11)(cid:48)(cid:48)(cid:7)(cid:5)(cid:3)(cid:9)(cid:2)(cid:12)(cid:11)(cid:4)(cid:14)(cid:11)(cid:48)(cid:48)(cid:7)(cid:5)(cid:3)(cid:9)(cid:2)(cid:28)(cid:3,Unknown,7714.0
Unknown,Unknown,33,Unknown,Unknown,Unknown,Unknown,cid:3)(cid:5)(cid:14)(cid:70)(cid:12)(cid:11)(cid:4)(cid:14)(cid:11)(cid:48)(cid:48)(cid:7)(cid:5)(cid:3)(cid:9)(cid:2)(cid:12)(cid:11)(cid:4)(cid:14)(cid:11)(cid:48)(cid:48)(cid:7)(cid:5)(cid:3)(cid:9)(cid:2)(cid:28)(cid:3,Unknown,7747.0
Unknown,Unknown,17,Unknown,Unknown,Unknown,Unknown,cid:3)(cid:5)(cid:14)(cid:70)(cid:12)(cid:11)(cid:4)(cid:14)(cid:11)(cid:48)(cid:48)(cid:7)(cid:5)(cid:3)(cid:9)(cid:2)(cid:12)(cid:11)(cid:4)(cid:14)(cid:11)(cid:48)(cid:48)(cid:7)(cid:5)(cid:3)(cid:9)(cid:2)(cid:28)(cid:3,Unknown,7764.0
Unknown,Unknown,37,Unknown,Unknown,Unknown,Unknown,cid:3)(cid:5)(cid:14)(cid:70)(cid:12)(cid:11)(cid:4)(cid:14)(cid:11)(cid:48)(cid:48)(cid:7)(cid:5)(cid:3)(cid:9)(cid:2)(cid:12)(cid:11)(cid:4)(cid:14)(cid:11)(cid:48)(cid:48)(cid:7)(cid:5)(cid:3)(cid:9)(cid:2)(cid:28)(cid:3,Unknown,7801.0
Unknown,Unknown,45,Unknown,Unknown,Unknown,Unknown,cid:3)(cid:5)(cid:14)(cid:70)(cid:12)(cid:11)(cid:4)(cid:14)(cid:11)(cid:48)(cid:48)(cid:7)(cid:5)(cid:3)(cid:9)(cid:2)(cid:12)(cid:11)(cid:4)(cid:14)(cid:11)(cid:48)(cid:48)(cid:7)(cid:5)(cid:3)(cid:9)(cid:2)(cid:28)(cid:3,Unknown,7846.0
Unknown,Unknown,18,Unknown,Unknown,Unknown,Unknown,cid:3)(cid:5)(cid:14)(cid:70)(cid:12)(cid:11)(cid:4)(cid:14)(cid:11)(cid:48)(cid:48)(cid:7)(cid:5)(cid:3)(cid:9)(cid:2)(cid:12)(cid:11)(cid:4)(cid:14)(cid:11)(cid:48)(cid:48)(cid:7)(cid:5)(cid:3)(cid:9)(cid:2)(cid:28)(cid:3,Unknown,7864.0
Unknown,Unknown,16,Unknown,Unknown,Unknown,Unknown,cid:3)(cid:5)(cid:14)(cid:70)(cid:12)(cid:11)(cid:4)(cid:14)(cid:11)(cid:48)(cid:48)(cid:7)(cid:5)(cid:3)(cid:9)(cid:2)(cid:12)(cid:11)(cid:4)(cid:14)(cid:11)(cid:48)(cid:48)(cid:7)(cid:5)(cid:3)(cid:9)(cid:2)(cid:28)(cid:3,Unknown,7880.0
Unknown,Unknown,39,Unknown,Unknown,Unknown,Unknown,cid:3)(cid:5)(cid:14)(cid:70)(cid:12)(cid:11)(cid:4)(cid:14)(cid:11)(cid:48)(cid:48)(cid:7)(cid:5)(cid:3)(cid:9)(cid:2)(cid:12)(cid:11)(cid:4)(cid:14)(cid:11)(cid:48)(cid:48)(cid:7)(cid:5)(cid:3)(cid:9)(cid:2)(cid:28)(cid:3,Unknown,7919.0
Unknown,Unknown,5,Unknown,Unknown,Unknown,Unknown,cid:3)(cid:5)(cid:14)(cid:70)(cid:12)(cid:11)(cid:4)(cid:14)(cid:11)(cid:48)(cid:48)(cid:7)(cid:5)(cid:3)(cid:9)(cid:2)(cid:12)(cid:11)(cid:4)(cid:14)(cid:11)(cid:48)(cid:48)(cid:7)(cid:5)(cid:3)(cid:9)(cid:2)(cid:28)(cid:3,Unknown,7924.0
Unknown,Unknown,71,Unknown,Unknown,Unknown,Unknown,cid:3)(cid:5)(cid:14)(cid:70)(cid:12)(cid:11)(cid:4)(cid:14)(cid:11)(cid:48)(cid:48)(cid:7)(cid:5)(cid:3)(cid:9)(cid:2)(cid:12)(cid:11)(cid:4)(cid:14)(cid:11)(cid:48)(cid:48)(cid:7)(cid:5)(cid:3)(cid:9)(cid:2)(cid:28)(cid:3,Unknown,7995.0
Unknown,Unknown,71,Unknown,Unknown,Unknown,Unknown,cid:3)(cid:5)(cid:14)(cid:70)(cid:12)(cid:11)(cid:4)(cid:14)(cid:11)(cid:48)(cid:48)(cid:7)(cid:5)(cid:3)(cid:9)(cid:2)(cid:12)(cid:11)(cid:4)(cid:14)(cid:11)(cid:48)(cid:48)(cid:7)(cid:5)(cid:3)(cid:9)(cid:2)(cid:28)(cid:3,Unknown,8066.0
Unknown,Unknown,5,Unknown,Unknown,Unknown,Unknown,cid:3)(cid:5)(cid:14)(cid:70)(cid:12)(cid:11)(cid:4)(cid:14)(cid:11)(cid:48)(cid:48)(cid:7)(cid:5)(cid:3)(cid:9)(cid:2)(cid:12)(cid:11)(cid:4)(cid:14)(cid:11)(cid:48)(cid:48)(cid:7)(cid:5)(cid:3)(cid:9)(cid:2)(cid:28)(cid:3,Unknown,8071.0
Unknown,Unknown,10,Unknown,Unknown,Unknown,Unknown,cid:3)(cid:5)(cid:14)(cid:70)(cid:12)(cid:11)(cid:4)(cid:14)(cid:11)(cid:48)(cid:48)(cid:7)(cid:5)(cid:3)(cid:9)(cid:2)(cid:12)(cid:11)(cid:4)(cid:14)(cid:11)(cid:48)(cid:48)(cid:7)(cid:5)(cid:3)(cid:9)(cid:2)(cid:28)(cid:3,Unknown,8081.0
Unknown,Unknown,10,Unknown,Unknown,Unknown,Unknown,cid:3)(cid:5)(cid:14)(cid:70)(cid:12)(cid:11)(cid:4)(cid:14)(cid:11)(cid:48)(cid:48)(cid:7)(cid:5)(cid:3)(cid:9)(cid:2)(cid:12)(cid:11)(cid:4)(cid:14)(cid:11)(cid:48)(cid:48)(cid:7)(cid:5)(cid:3)(cid:9)(cid:2)(cid:28)(cid:3,Unknown,8091.0
Unknown,Unknown,46,Unknown,Unknown,Unknown,Unknown,cid:3)(cid:5)(cid:14)(cid:70)(cid:12)(cid:11)(cid:4)(cid:14)(cid:11)(cid:48)(cid:48)(cid:7)(cid:5)(cid:3)(cid:9)(cid:2)(cid:12)(cid:11)(cid:4)(cid:14)(cid:11)(cid:48)(cid:48)(cid:7)(cid:5)(cid:3)(cid:9)(cid:2)(cid:28)(cid:3,Unknown,8137.0
Unknown,Unknown,2,Unknown,Unknown,Unknown,Unknown,cid:3)(cid:5)(cid:14)(cid:70)(cid:12)(cid:11)(cid:4)(cid:14)(cid:11)(cid:48)(cid:48)(cid:7)(cid:5)(cid:3)(cid:9)(cid:2)(cid:12)(cid:11)(cid:4)(cid:14)(cid:11)(cid:48)(cid:48)(cid:7)(cid:5)(cid:3)(cid:9)(cid:2)(cid:28)(cid:3,Unknown,8139.0
Unknown,Unknown,50,Unknown,Unknown,Unknown,Unknown,cid:3)(cid:5)(cid:14)(cid:70)(cid:12)(cid:11)(cid:4)(cid:14)(cid:11)(cid:48)(cid:48)(cid:7)(cid:5)(cid:3)(cid:9)(cid:2)(cid:12)(cid:11)(cid:4)(cid:14)(cid:11)(cid:48)(cid:48)(cid:7)(cid:5)(cid:3)(cid:9)(cid:2)(cid:28)(cid:3,Unknown,8189.0
Unknown,Unknown,5,Unknown,Unknown,Unknown,Unknown,cid:3)(cid:5)(cid:14)(cid:70)(cid:12)(cid:11)(cid:4)(cid:14)(cid:11)(cid:48)(cid:48)(cid:7)(cid:5)(cid:3)(cid:9)(cid:2)(cid:12)(cid:11)(cid:4)(cid:14)(cid:11)(cid:48)(cid:48)(cid:7)(cid:5)(cid:3)(cid:9)(cid:2)(cid:28)(cid:3,Unknown,8194.0
Unknown,Unknown,48,Unknown,Unknown,Unknown,Unknown,cid:3)(cid:5)(cid:14)(cid:70)(cid:12)(cid:11)(cid:4)(cid:14)(cid:11)(cid:48)(cid:48)(cid:7)(cid:5)(cid:3)(cid:9)(cid:2)(cid:12)(cid:11)(cid:4)(cid:14)(cid:11)(cid:48)(cid:48)(cid:7)(cid:5)(cid:3)(cid:9)(cid:2)(cid:28)(cid:3,Unknown,8242.0
Unknown,Unknown,5,Unknown,Unknown,Unknown,Unknown,cid:3)(cid:5)(cid:14)(cid:70)(cid:12)(cid:11)(cid:4)(cid:14)(cid:11)(cid:48)(cid:48)(cid:7)(cid:5)(cid:3)(cid:9)(cid:2)(cid:12)(cid:11)(cid:4)(cid:14)(cid:11)(cid:48)(cid:48)(cid:7)(cid:5)(cid:3)(cid:9)(cid:2)(cid:28)(cid:3,Unknown,8247.0
Unknown,Unknown,2,Unknown,Unknown,Unknown,Unknown,cid:3)(cid:5)(cid:14)(cid:70)(cid:12)(cid:11)(cid:4)(cid:14)(cid:11)(cid:48)(cid:48)(cid:7)(cid:5)(cid:3)(cid:9)(cid:2)(cid:12)(cid:11)(cid:4)(cid:14)(cid:11)(cid:48)(cid:48)(cid:7)(cid:5)(cid:3)(cid:9)(cid:2)(cid:28)(cid:3,Unknown,8249.0
Unknown,Unknown,14,Unknown,Unknown,Unknown,Unknown,cid:3)(cid:5)(cid:14)(cid:70)(cid:12)(cid:11)(cid:4)(cid:14)(cid:11)(cid:48)(cid:48)(cid:7)(cid:5)(cid:3)(cid:9)(cid:2)(cid:12)(cid:11)(cid:4)(cid:14)(cid:11)(cid:48)(cid:48)(cid:7)(cid:5)(cid:3)(cid:9)(cid:2)(cid:28)(cid:3,Unknown,8263.0
Unknown,Unknown,46,Unknown,Unknown,Unknown,Unknown,cid:3)(cid:5)(cid:14)(cid:70)(cid:12)(cid:11)(cid:4)(cid:14)(cid:11)(cid:48)(cid:48)(cid:7)(cid:5)(cid:3)(cid:9)(cid:2)(cid:12)(cid:11)(cid:4)(cid:14)(cid:11)(cid:48)(cid:48)(cid:7)(cid:5)(cid:3)(cid:9)(cid:2)(cid:28)(cid:3,Unknown,8309.0
Unknown,Unknown,2,Unknown,Unknown,Unknown,Unknown,cid:3)(cid:5)(cid:14)(cid:70)(cid:12)(cid:11)(cid:4)(cid:14)(cid:11)(cid:48)(cid:48)(cid:7)(cid:5)(cid:3)(cid:9)(cid:2)(cid:12)(cid:11)(cid:4)(cid:14)(cid:11)(cid:48)(cid:48)(cid:7)(cid:5)(cid:3)(cid:9)(cid:2)(cid:28)(cid:3,Unknown,8311.0
Unknown,Unknown,28,Unknown,Unknown,Unknown,Unknown,cid:3)(cid:5)(cid:14)(cid:70)(cid:12)(cid:11)(cid:4)(cid:14)(cid:11)(cid:48)(cid:48)(cid:7)(cid:5)(cid:3)(cid:9)(cid:2)(cid:12)(cid:11)(cid:4)(cid:14)(cid:11)(cid:48)(cid:48)(cid:7)(cid:5)(cid:3)(cid:9)(cid:2)(cid:28)(cid:3,Unknown,8339.0
Unknown,Unknown,5,Unknown,Unknown,Unknown,Unknown,cid:3)(cid:5)(cid:14)(cid:70)(cid:12)(cid:11)(cid:4)(cid:14)(cid:11)(cid:48)(cid:48)(cid:7)(cid:5)(cid:3)(cid:9)(cid:2)(cid:12)(cid:11)(cid:4)(cid:14)(cid:11)(cid:48)(cid:48)(cid:7)(cid:5)(cid:3)(cid:9)(cid:2)(cid:28)(cid:3,Unknown,8344.0
Unknown,Unknown,3,Unknown,Unknown,Unknown,Unknown,cid:3)(cid:5)(cid:14)(cid:70)(cid:12)(cid:11)(cid:4)(cid:14)(cid:11)(cid:48)(cid:48)(cid:7)(cid:5)(cid:3)(cid:9)(cid:2)(cid:12)(cid:11)(cid:4)(cid:14)(cid:11)(cid:48)(cid:48)(cid:7)(cid:5)(cid:3)(cid:9)(cid:2)(cid:28)(cid:3,Unknown,8347.0
Unknown,Unknown,10,Unknown,Unknown,Unknown,Unknown,cid:3)(cid:5)(cid:14)(cid:70)(cid:12)(cid:11)(cid:4)(cid:14)(cid:11)(cid:48)(cid:48)(cid:7)(cid:5)(cid:3)(cid:9)(cid:2)(cid:12)(cid:11)(cid:4)(cid:14)(cid:11)(cid:48)(cid:48)(cid:7)(cid:5)(cid:3)(cid:9)(cid:2)(cid:28)(cid:3,Unknown,8357.0
Unknown,Unknown,5,Unknown,Unknown,Unknown,Unknown,cid:3)(cid:5)(cid:14)(cid:70)(cid:12)(cid:11)(cid:4)(cid:14)(cid:11)(cid:48)(cid:48)(cid:7)(cid:5)(cid:3)(cid:9)(cid:2)(cid:12)(cid:11)(cid:4)(cid:14)(cid:11)(cid:48)(cid:48)(cid:7)(cid:5)(cid:3)(cid:9)(cid:2)(cid:28)(cid:3,Unknown,8362.0
Unknown,Unknown,2,Unknown,Unknown,Unknown,Unknown,cid:3)(cid:5)(cid:14)(cid:70)(cid:12)(cid:11)(cid:4)(cid:14)(cid:11)(cid:48)(cid:48)(cid:7)(cid:5)(cid:3)(cid:9)(cid:2)(cid:12)(cid:11)(cid:4)(cid:14)(cid:11)(cid:48)(cid:48)(cid:7)(cid:5)(cid:3)(cid:9)(cid:2)(cid:28)(cid:3,Unknown,8364.0
Unknown,Unknown,9,Unknown,Unknown,Unknown,Unknown,cid:3)(cid:5)(cid:14)(cid:70)(cid:12)(cid:11)(cid:4)(cid:14)(cid:11)(cid:48)(cid:48)(cid:7)(cid:5)(cid:3)(cid:9)(cid:2)(cid:12)(cid:11)(cid:4)(cid:14)(cid:11)(cid:48)(cid:48)(cid:7)(cid:5)(cid:3)(cid:9)(cid:2)(cid:28)(cid:3,Unknown,8373.0
Unknown,Unknown,11,Unknown,Unknown,Unknown,Unknown,cid:3)(cid:5)(cid:14)(cid:70)(cid:12)(cid:11)(cid:4)(cid:14)(cid:11)(cid:48)(cid:48)(cid:7)(cid:5)(cid:3)(cid:9)(cid:2)(cid:12)(cid:11)(cid:4)(cid:14)(cid:11)(cid:48)(cid:48)(cid:7)(cid:5)(cid:3)(cid:9)(cid:2)(cid:28)(cid:3,Unknown,8384.0
Unknown,Unknown,4,Unknown,Unknown,Unknown,Unknown,cid:3)(cid:5)(cid:14)(cid:70)(cid:12)(cid:11)(cid:4)(cid:14)(cid:11)(cid:48)(cid:48)(cid:7)(cid:5)(cid:3)(cid:9)(cid:2)(cid:12)(cid:11)(cid:4)(cid:14)(cid:11)(cid:48)(cid:48)(cid:7)(cid:5)(cid:3)(cid:9)(cid:2)(cid:28)(cid:3,Unknown,8388.0
Unknown,Unknown,2,Unknown,Unknown,Unknown,Unknown,cid:3)(cid:5)(cid:14)(cid:70)(cid:12)(cid:11)(cid:4)(cid:14)(cid:11)(cid:48)(cid:48)(cid:7)(cid:5)(cid:3)(cid:9)(cid:2)(cid:12)(cid:11)(cid:4)(cid:14)(cid:11)(cid:48)(cid:48)(cid:7)(cid:5)(cid:3)(cid:9)(cid:2)(cid:28)(cid:3,Unknown,8390.0
Unknown,Unknown,28,Unknown,Unknown,Unknown,Unknown,cid:3)(cid:5)(cid:14)(cid:70)(cid:12)(cid:11)(cid:4)(cid:14)(cid:11)(cid:48)(cid:48)(cid:7)(cid:5)(cid:3)(cid:9)(cid:2)(cid:12)(cid:11)(cid:4)(cid:14)(cid:11)(cid:48)(cid:48)(cid:7)(cid:5)(cid:3)(cid:9)(cid:2)(cid:28)(cid:3,Unknown,8418.0
Unknown,Unknown,3,Unknown,Unknown,Unknown,Unknown,cid:3)(cid:5)(cid:14)(cid:70)(cid:12)(cid:11)(cid:4)(cid:14)(cid:11)(cid:48)(cid:48)(cid:7)(cid:5)(cid:3)(cid:9)(cid:2)(cid:12)(cid:11)(cid:4)(cid:14)(cid:11)(cid:48)(cid:48)(cid:7)(cid:5)(cid:3)(cid:9)(cid:2)(cid:28)(cid:3,Unknown,8421.0
Unknown,Unknown,15,Unknown,Unknown,Unknown,Unknown,cid:3)(cid:5)(cid:14)(cid:70)(cid:12)(cid:11)(cid:4)(cid:14)(cid:11)(cid:48)(cid:48)(cid:7)(cid:5)(cid:3)(cid:9)(cid:2)(cid:12)(cid:11)(cid:4)(cid:14)(cid:11)(cid:48)(cid:48)(cid:7)(cid:5)(cid:3)(cid:9)(cid:2)(cid:28)(cid:3,Unknown,8436.0
Unknown,Unknown,2,Unknown,Unknown,Unknown,Unknown,cid:3)(cid:5)(cid:14)(cid:70)(cid:12)(cid:11)(cid:4)(cid:14)(cid:11)(cid:48)(cid:48)(cid:7)(cid:5)(cid:3)(cid:9)(cid:2)(cid:12)(cid:11)(cid:4)(cid:14)(cid:11)(cid:48)(cid:48)(cid:7)(cid:5)(cid:3)(cid:9)(cid:2)(cid:28)(cid:3,Unknown,8438.0
Unknown,Unknown,17,Unknown,Unknown,Unknown,Unknown,cid:3)(cid:5)(cid:14)(cid:70)(cid:12)(cid:11)(cid:4)(cid:14)(cid:11)(cid:48)(cid:48)(cid:7)(cid:5)(cid:3)(cid:9)(cid:2)(cid:12)(cid:11)(cid:4)(cid:14)(cid:11)(cid:48)(cid:48)(cid:7)(cid:5)(cid:3)(cid:9)(cid:2)(cid:28)(cid:3,Unknown,8455.0
Unknown,Unknown,18,Unknown,Unknown,Unknown,Unknown,cid:3)(cid:5)(cid:14)(cid:70)(cid:12)(cid:11)(cid:4)(cid:14)(cid:11)(cid:48)(cid:48)(cid:7)(cid:5)(cid:3)(cid:9)(cid:2)(cid:12)(cid:11)(cid:4)(cid:14)(cid:11)(cid:48)(cid:48)(cid:7)(cid:5)(cid:3)(cid:9)(cid:2)(cid:28)(cid:3,Unknown,8473.0
Unknown,Unknown,18,Unknown,Unknown,Unknown,Unknown,cid:3)(cid:5)(cid:14)(cid:70)(cid:12)(cid:11)(cid:4)(cid:14)(cid:11)(cid:48)(cid:48)(cid:7)(cid:5)(cid:3)(cid:9)(cid:2)(cid:12)(cid:11)(cid:4)(cid:14)(cid:11)(cid:48)(cid:48)(cid:7)(cid:5)(cid:3)(cid:9)(cid:2)(cid:28)(cid:3,Unknown,8491.0
Unknown,Unknown,19,Unknown,Unknown,Unknown,Unknown,cid:3)(cid:5)(cid:14)(cid:70)(cid:12)(cid:11)(cid:4)(cid:14)(cid:11)(cid:48)(cid:48)(cid:7)(cid:5)(cid:3)(cid:9)(cid:2)(cid:12)(cid:11)(cid:4)(cid:14)(cid:11)(cid:48)(cid:48)(cid:7)(cid:5)(cid:3)(cid:9)(cid:2)(cid:28)(cid:3,Unknown,8510.0
Unknown,Unknown,34,Unknown,Unknown,Unknown,Unknown,cid:3)(cid:5)(cid:14)(cid:70)(cid:12)(cid:11)(cid:4)(cid:14)(cid:11)(cid:48)(cid:48)(cid:7)(cid:5)(cid:3)(cid:9)(cid:2)(cid:12)(cid:11)(cid:4)(cid:14)(cid:11)(cid:48)(cid:48)(cid:7)(cid:5)(cid:3)(cid:9)(cid:2)(cid:28)(cid:3,Unknown,8544.0
Unknown,Unknown,18,Unknown,Unknown,Unknown,Unknown,cid:3)(cid:5)(cid:14)(cid:70)(cid:12)(cid:11)(cid:4)(cid:14)(cid:11)(cid:48)(cid:48)(cid:7)(cid:5)(cid:3)(cid:9)(cid:2)(cid:12)(cid:11)(cid:4)(cid:14)(cid:11)(cid:48)(cid:48)(cid:7)(cid:5)(cid:3)(cid:9)(cid:2)(cid:28)(cid:3,Unknown,8562.0
Unknown,Unknown,2,Unknown,Unknown,Unknown,Unknown,cid:3)(cid:5)(cid:14)(cid:70)(cid:12)(cid:11)(cid:4)(cid:14)(cid:11)(cid:48)(cid:48)(cid:7)(cid:5)(cid:3)(cid:9)(cid:2)(cid:12)(cid:11)(cid:4)(cid:14)(cid:11)(cid:48)(cid:48)(cid:7)(cid:5)(cid:3)(cid:9)(cid:2)(cid:28)(cid:3,Unknown,8564.0
Unknown,Unknown,44,Unknown,Unknown,Unknown,Unknown,cid:3)(cid:5)(cid:14)(cid:70)(cid:12)(cid:11)(cid:4)(cid:14)(cid:11)(cid:48)(cid:48)(cid:7)(cid:5)(cid:3)(cid:9)(cid:2)(cid:12)(cid:11)(cid:4)(cid:14)(cid:11)(cid:48)(cid:48)(cid:7)(cid:5)(cid:3)(cid:9)(cid:2)(cid:28)(cid:3,Unknown,8608.0
Unknown,Unknown,12,Unknown,Unknown,Unknown,Unknown,cid:3)(cid:5)(cid:14)(cid:70)(cid:12)(cid:11)(cid:4)(cid:14)(cid:11)(cid:48)(cid:48)(cid:7)(cid:5)(cid:3)(cid:9)(cid:2)(cid:12)(cid:11)(cid:4)(cid:14)(cid:11)(cid:48)(cid:48)(cid:7)(cid:5)(cid:3)(cid:9)(cid:2)(cid:28)(cid:3,Unknown,8620.0
Unknown,Unknown,29,Unknown,Unknown,Unknown,Unknown,cid:3)(cid:5)(cid:14)(cid:70)(cid:12)(cid:11)(cid:4)(cid:14)(cid:11)(cid:48)(cid:48)(cid:7)(cid:5)(cid:3)(cid:9)(cid:2)(cid:12)(cid:11)(cid:4)(cid:14)(cid:11)(cid:48)(cid:48)(cid:7)(cid:5)(cid:3)(cid:9)(cid:2)(cid:28)(cid:3,Unknown,8649.0
Unknown,Unknown,26,Unknown,Unknown,Unknown,Unknown,cid:3)(cid:5)(cid:14)(cid:70)(cid:12)(cid:11)(cid:4)(cid:14)(cid:11)(cid:48)(cid:48)(cid:7)(cid:5)(cid:3)(cid:9)(cid:2)(cid:12)(cid:11)(cid:4)(cid:14)(cid:11)(cid:48)(cid:48)(cid:7)(cid:5)(cid:3)(cid:9)(cid:2)(cid:28)(cid:3,Unknown,8675.0
Unknown,Unknown,41,Unknown,Unknown,Unknown,Unknown,cid:3)(cid:5)(cid:14)(cid:70)(cid:12)(cid:11)(cid:4)(cid:14)(cid:11)(cid:48)(cid:48)(cid:7)(cid:5)(cid:3)(cid:9)(cid:2)(cid:12)(cid:11)(cid:4)(cid:14)(cid:11)(cid:48)(cid:48)(cid:7)(cid:5)(cid:3)(cid:9)(cid:2)(cid:28)(cid:3,Unknown,8716.0
Unknown,Unknown,25,Unknown,Unknown,Unknown,Unknown,cid:3)(cid:5)(cid:14)(cid:70)(cid:12)(cid:11)(cid:4)(cid:14)(cid:11)(cid:48)(cid:48)(cid:7)(cid:5)(cid:3)(cid:9)(cid:2)(cid:12)(cid:11)(cid:4)(cid:14)(cid:11)(cid:48)(cid:48)(cid:7)(cid:5)(cid:3)(cid:9)(cid:2)(cid:28)(cid:3,Unknown,8741.0
Unknown,Unknown,2,Unknown,Unknown,Unknown,Unknown,cid:3)(cid:5)(cid:14)(cid:70)(cid:12)(cid:11)(cid:4)(cid:14)(cid:11)(cid:48)(cid:48)(cid:7)(cid:5)(cid:3)(cid:9)(cid:2)(cid:12)(cid:11)(cid:4)(cid:14)(cid:11)(cid:48)(cid:48)(cid:7)(cid:5)(cid:3)(cid:9)(cid:2)(cid:28)(cid:3,Unknown,8743.0
Unknown,Unknown,58,Unknown,Unknown,Unknown,Unknown,cid:3)(cid:5)(cid:14)(cid:70)(cid:12)(cid:11)(cid:4)(cid:14)(cid:11)(cid:48)(cid:48)(cid:7)(cid:5)(cid:3)(cid:9)(cid:2)(cid:12)(cid:11)(cid:4)(cid:14)(cid:11)(cid:48)(cid:48)(cid:7)(cid:5)(cid:3)(cid:9)(cid:2)(cid:28)(cid:3,Unknown,8801.0
Unknown,Unknown,58,Unknown,Unknown,Unknown,Unknown,cid:3)(cid:5)(cid:14)(cid:70)(cid:12)(cid:11)(cid:4)(cid:14)(cid:11)(cid:48)(cid:48)(cid:7)(cid:5)(cid:3)(cid:9)(cid:2)(cid:12)(cid:11)(cid:4)(cid:14)(cid:11)(cid:48)(cid:48)(cid:7)(cid:5)(cid:3)(cid:9)(cid:2)(cid:28)(cid:3,Unknown,8859.0
Unknown,Unknown,18,Unknown,Unknown,Unknown,Unknown,cid:3)(cid:5)(cid:14)(cid:70)(cid:12)(cid:11)(cid:4)(cid:14)(cid:11)(cid:48)(cid:48)(cid:7)(cid:5)(cid:3)(cid:9)(cid:2)(cid:12)(cid:11)(cid:4)(cid:14)(cid:11)(cid:48)(cid:48)(cid:7)(cid:5)(cid:3)(cid:9)(cid:2)(cid:28)(cid:3,Unknown,8877.0
Unknown,Unknown,1,Unknown,Unknown,Unknown,Unknown,cid:3)(cid:5)(cid:14)(cid:70)(cid:12)(cid:11)(cid:4)(cid:14)(cid:11)(cid:48)(cid:48)(cid:7)(cid:5)(cid:3)(cid:9)(cid:2)(cid:12)(cid:11)(cid:4)(cid:14)(cid:11)(cid:48)(cid:48)(cid:7)(cid:5)(cid:3)(cid:9)(cid:2)(cid:28)(cid:3,Unknown,8878.0
Unknown,Unknown,1,Unknown,Unknown,Unknown,Unknown,cid:3)(cid:5)(cid:14)(cid:70)(cid:12)(cid:11)(cid:4)(cid:14)(cid:11)(cid:48)(cid:48)(cid:7)(cid:5)(cid:3)(cid:9)(cid:2)(cid:12)(cid:11)(cid:4)(cid:14)(cid:11)(cid:48)(cid:48)(cid:7)(cid:5)(cid:3)(cid:9)(cid:2)(cid:28)(cid:3,Unknown,8879.0
Unknown,Unknown,37,Unknown,Unknown,Unknown,Unknown,cid:3)(cid:5)(cid:14)(cid:70)(cid:12)(cid:11)(cid:4)(cid:14)(cid:11)(cid:48)(cid:48)(cid:7)(cid:5)(cid:3)(cid:9)(cid:2)(cid:12)(cid:11)(cid:4)(cid:14)(cid:11)(cid:48)(cid:48)(cid:7)(cid:5)(cid:3)(cid:9)(cid:2)(cid:28)(cid:3,Unknown,8916.0
Unknown,Unknown,17,Unknown,Unknown,Unknown,Unknown,cid:3)(cid:5)(cid:14)(cid:70)(cid:12)(cid:11)(cid:4)(cid:14)(cid:11)(cid:48)(cid:48)(cid:7)(cid:5)(cid:3)(cid:9)(cid:2)(cid:12)(cid:11)(cid:4)(cid:14)(cid:11)(cid:48)(cid:48)(cid:7)(cid:5)(cid:3)(cid:9)(cid:2)(cid:28)(cid:3,Unknown,8933.0
Unknown,Unknown,37,Unknown,Unknown,Unknown,Unknown,cid:3)(cid:5)(cid:14)(cid:70)(cid:12)(cid:11)(cid:4)(cid:14)(cid:11)(cid:48)(cid:48)(cid:7)(cid:5)(cid:3)(cid:9)(cid:2)(cid:12)(cid:11)(cid:4)(cid:14)(cid:11)(cid:48)(cid:48)(cid:7)(cid:5)(cid:3)(cid:9)(cid:2)(cid:28)(cid:3,Unknown,8970.0
Unknown,Unknown,45,Unknown,Unknown,Unknown,Unknown,cid:3)(cid:5)(cid:14)(cid:70)(cid:12)(cid:11)(cid:4)(cid:14)(cid:11)(cid:48)(cid:48)(cid:7)(cid:5)(cid:3)(cid:9)(cid:2)(cid:12)(cid:11)(cid:4)(cid:14)(cid:11)(cid:48)(cid:48)(cid:7)(cid:5)(cid:3)(cid:9)(cid:2)(cid:28)(cid:3,Unknown,9015.0
Unknown,Unknown,18,Unknown,Unknown,Unknown,Unknown,cid:3)(cid:5)(cid:14)(cid:70)(cid:12)(cid:11)(cid:4)(cid:14)(cid:11)(cid:48)(cid:48)(cid:7)(cid:5)(cid:3)(cid:9)(cid:2)(cid:12)(cid:11)(cid:4)(cid:14)(cid:11)(cid:48)(cid:48)(cid:7)(cid:5)(cid:3)(cid:9)(cid:2)(cid:28)(cid:3,Unknown,9033.0
Unknown,Unknown,16,Unknown,Unknown,Unknown,Unknown,cid:3)(cid:5)(cid:14)(cid:70)(cid:12)(cid:11)(cid:4)(cid:14)(cid:11)(cid:48)(cid:48)(cid:7)(cid:5)(cid:3)(cid:9)(cid:2)(cid:12)(cid:11)(cid:4)(cid:14)(cid:11)(cid:48)(cid:48)(cid:7)(cid:5)(cid:3)(cid:9)(cid:2)(cid:28)(cid:3,Unknown,9049.0
Unknown,Unknown,39,Unknown,Unknown,Unknown,Unknown,cid:3)(cid:5)(cid:14)(cid:70)(cid:12)(cid:11)(cid:4)(cid:14)(cid:11)(cid:48)(cid:48)(cid:7)(cid:5)(cid:3)(cid:9)(cid:2)(cid:12)(cid:11)(cid:4)(cid:14)(cid:11)(cid:48)(cid:48)(cid:7)(cid:5)(cid:3)(cid:9)(cid:2)(cid:28)(cid:3,Unknown,9088.0
Unknown,Unknown,5,Unknown,Unknown,Unknown,Unknown,cid:3)(cid:5)(cid:14)(cid:70)(cid:12)(cid:11)(cid:4)(cid:14)(cid:11)(cid:48)(cid:48)(cid:7)(cid:5)(cid:3)(cid:9)(cid:2)(cid:12)(cid:11)(cid:4)(cid:14)(cid:11)(cid:48)(cid:48)(cid:7)(cid:5)(cid:3)(cid:9)(cid:2)(cid:28)(cid:3,Unknown,9093.0
Unknown,Unknown,71,Unknown,Unknown,Unknown,Unknown,cid:3)(cid:5)(cid:14)(cid:70)(cid:12)(cid:11)(cid:4)(cid:14)(cid:11)(cid:48)(cid:48)(cid:7)(cid:5)(cid:3)(cid:9)(cid:2)(cid:12)(cid:11)(cid:4)(cid:14)(cid:11)(cid:48)(cid:48)(cid:7)(cid:5)(cid:3)(cid:9)(cid:2)(cid:28)(cid:3,Unknown,9164.0
Unknown,Unknown,71,Unknown,Unknown,Unknown,Unknown,cid:3)(cid:5)(cid:14)(cid:70)(cid:12)(cid:11)(cid:4)(cid:14)(cid:11)(cid:48)(cid:48)(cid:7)(cid:5)(cid:3)(cid:9)(cid:2)(cid:12)(cid:11)(cid:4)(cid:14)(cid:11)(cid:48)(cid:48)(cid:7)(cid:5)(cid:3)(cid:9)(cid:2)(cid:28)(cid:3,Unknown,9235.0
Unknown,Unknown,5,Unknown,Unknown,Unknown,Unknown,cid:3)(cid:5)(cid:14)(cid:70)(cid:12)(cid:11)(cid:4)(cid:14)(cid:11)(cid:48)(cid:48)(cid:7)(cid:5)(cid:3)(cid:9)(cid:2)(cid:12)(cid:11)(cid:4)(cid:14)(cid:11)(cid:48)(cid:48)(cid:7)(cid:5)(cid:3)(cid:9)(cid:2)(cid:28)(cid:3,Unknown,9240.0
Unknown,Unknown,10,Unknown,Unknown,Unknown,Unknown,cid:3)(cid:5)(cid:14)(cid:70)(cid:12)(cid:11)(cid:4)(cid:14)(cid:11)(cid:48)(cid:48)(cid:7)(cid:5)(cid:3)(cid:9)(cid:2)(cid:12)(cid:11)(cid:4)(cid:14)(cid:11)(cid:48)(cid:48)(cid:7)(cid:5)(cid:3)(cid:9)(cid:2)(cid:28)(cid:3,Unknown,9250.0
Unknown,Unknown,10,Unknown,Unknown,Unknown,Unknown,cid:3)(cid:5)(cid:14)(cid:70)(cid:12)(cid:11)(cid:4)(cid:14)(cid:11)(cid:48)(cid:48)(cid:7)(cid:5)(cid:3)(cid:9)(cid:2)(cid:12)(cid:11)(cid:4)(cid:14)(cid:11)(cid:48)(cid:48)(cid:7)(cid:5)(cid:3)(cid:9)(cid:2)(cid:28)(cid:3,Unknown,9260.0
Unknown,Unknown,46,Unknown,Unknown,Unknown,Unknown,cid:3)(cid:5)(cid:14)(cid:70)(cid:12)(cid:11)(cid:4)(cid:14)(cid:11)(cid:48)(cid:48)(cid:7)(cid:5)(cid:3)(cid:9)(cid:2)(cid:12)(cid:11)(cid:4)(cid:14)(cid:11)(cid:48)(cid:48)(cid:7)(cid:5)(cid:3)(cid:9)(cid:2)(cid:28)(cid:3,Unknown,9306.0
Unknown,Unknown,2,Unknown,Unknown,Unknown,Unknown,cid:3)(cid:5)(cid:14)(cid:70)(cid:12)(cid:11)(cid:4)(cid:14)(cid:11)(cid:48)(cid:48)(cid:7)(cid:5)(cid:3)(cid:9)(cid:2)(cid:12)(cid:11)(cid:4)(cid:14)(cid:11)(cid:48)(cid:48)(cid:7)(cid:5)(cid:3)(cid:9)(cid:2)(cid:28)(cid:3,Unknown,9308.0
Unknown,Unknown,50,Unknown,Unknown,Unknown,Unknown,cid:3)(cid:5)(cid:14)(cid:70)(cid:12)(cid:11)(cid:4)(cid:14)(cid:11)(cid:48)(cid:48)(cid:7)(cid:5)(cid:3)(cid:9)(cid:2)(cid:12)(cid:11)(cid:4)(cid:14)(cid:11)(cid:48)(cid:48)(cid:7)(cid:5)(cid:3)(cid:9)(cid:2)(cid:28)(cid:3,Unknown,9358.0
Unknown,Unknown,5,Unknown,Unknown,Unknown,Unknown,cid:3)(cid:5)(cid:14)(cid:70)(cid:12)(cid:11)(cid:4)(cid:14)(cid:11)(cid:48)(cid:48)(cid:7)(cid:5)(cid:3)(cid:9)(cid:2)(cid:12)(cid:11)(cid:4)(cid:14)(cid:11)(cid:48)(cid:48)(cid:7)(cid:5)(cid:3)(cid:9)(cid:2)(cid:28)(cid:3,Unknown,9363.0
Unknown,Unknown,48,Unknown,Unknown,Unknown,Unknown,cid:3)(cid:5)(cid:14)(cid:70)(cid:12)(cid:11)(cid:4)(cid:14)(cid:11)(cid:48)(cid:48)(cid:7)(cid:5)(cid:3)(cid:9)(cid:2)(cid:12)(cid:11)(cid:4)(cid:14)(cid:11)(cid:48)(cid:48)(cid:7)(cid:5)(cid:3)(cid:9)(cid:2)(cid:28)(cid:3,Unknown,9411.0
Unknown,Unknown,5,Unknown,Unknown,Unknown,Unknown,cid:3)(cid:5)(cid:14)(cid:70)(cid:12)(cid:11)(cid:4)(cid:14)(cid:11)(cid:48)(cid:48)(cid:7)(cid:5)(cid:3)(cid:9)(cid:2)(cid:12)(cid:11)(cid:4)(cid:14)(cid:11)(cid:48)(cid:48)(cid:7)(cid:5)(cid:3)(cid:9)(cid:2)(cid:28)(cid:3,Unknown,9416.0
Unknown,Unknown,2,Unknown,Unknown,Unknown,Unknown,cid:3)(cid:5)(cid:14)(cid:70)(cid:12)(cid:11)(cid:4)(cid:14)(cid:11)(cid:48)(cid:48)(cid:7)(cid:5)(cid:3)(cid:9)(cid:2)(cid:12)(cid:11)(cid:4)(cid:14)(cid:11)(cid:48)(cid:48)(cid:7)(cid:5)(cid:3)(cid:9)(cid:2)(cid:28)(cid:3,Unknown,9418.0
Unknown,Unknown,14,Unknown,Unknown,Unknown,Unknown,cid:3)(cid:5)(cid:14)(cid:70)(cid:12)(cid:11)(cid:4)(cid:14)(cid:11)(cid:48)(cid:48)(cid:7)(cid:5)(cid:3)(cid:9)(cid:2)(cid:12)(cid:11)(cid:4)(cid:14)(cid:11)(cid:48)(cid:48)(cid:7)(cid:5)(cid:3)(cid:9)(cid:2)(cid:28)(cid:3,Unknown,9432.0
Unknown,Unknown,46,Unknown,Unknown,Unknown,Unknown,cid:3)(cid:5)(cid:14)(cid:70)(cid:12)(cid:11)(cid:4)(cid:14)(cid:11)(cid:48)(cid:48)(cid:7)(cid:5)(cid:3)(cid:9)(cid:2)(cid:12)(cid:11)(cid:4)(cid:14)(cid:11)(cid:48)(cid:48)(cid:7)(cid:5)(cid:3)(cid:9)(cid:2)(cid:28)(cid:3,Unknown,9478.0
Unknown,Unknown,2,Unknown,Unknown,Unknown,Unknown,cid:3)(cid:5)(cid:14)(cid:70)(cid:12)(cid:11)(cid:4)(cid:14)(cid:11)(cid:48)(cid:48)(cid:7)(cid:5)(cid:3)(cid:9)(cid:2)(cid:12)(cid:11)(cid:4)(cid:14)(cid:11)(cid:48)(cid:48)(cid:7)(cid:5)(cid:3)(cid:9)(cid:2)(cid:28)(cid:3,Unknown,9480.0
Unknown,Unknown,28,Unknown,Unknown,Unknown,Unknown,cid:3)(cid:5)(cid:14)(cid:70)(cid:12)(cid:11)(cid:4)(cid:14)(cid:11)(cid:48)(cid:48)(cid:7)(cid:5)(cid:3)(cid:9)(cid:2)(cid:12)(cid:11)(cid:4)(cid:14)(cid:11)(cid:48)(cid:48)(cid:7)(cid:5)(cid:3)(cid:9)(cid:2)(cid:28)(cid:3,Unknown,9508.0
Unknown,Unknown,5,Unknown,Unknown,Unknown,Unknown,cid:3)(cid:5)(cid:14)(cid:70)(cid:12)(cid:11)(cid:4)(cid:14)(cid:11)(cid:48)(cid:48)(cid:7)(cid:5)(cid:3)(cid:9)(cid:2)(cid:12)(cid:11)(cid:4)(cid:14)(cid:11)(cid:48)(cid:48)(cid:7)(cid:5)(cid:3)(cid:9)(cid:2)(cid:28)(cid:3,Unknown,9513.0
Unknown,Unknown,3,Unknown,Unknown,Unknown,Unknown,cid:3)(cid:5)(cid:14)(cid:70)(cid:12)(cid:11)(cid:4)(cid:14)(cid:11)(cid:48)(cid:48)(cid:7)(cid:5)(cid:3)(cid:9)(cid:2)(cid:12)(cid:11)(cid:4)(cid:14)(cid:11)(cid:48)(cid:48)(cid:7)(cid:5)(cid:3)(cid:9)(cid:2)(cid:28)(cid:3,Unknown,9516.0
Unknown,Unknown,10,Unknown,Unknown,Unknown,Unknown,cid:3)(cid:5)(cid:14)(cid:70)(cid:12)(cid:11)(cid:4)(cid:14)(cid:11)(cid:48)(cid:48)(cid:7)(cid:5)(cid:3)(cid:9)(cid:2)(cid:12)(cid:11)(cid:4)(cid:14)(cid:11)(cid:48)(cid:48)(cid:7)(cid:5)(cid:3)(cid:9)(cid:2)(cid:28)(cid:3,Unknown,9526.0
Unknown,Unknown,5,Unknown,Unknown,Unknown,Unknown,cid:3)(cid:5)(cid:14)(cid:70)(cid:12)(cid:11)(cid:4)(cid:14)(cid:11)(cid:48)(cid:48)(cid:7)(cid:5)(cid:3)(cid:9)(cid:2)(cid:12)(cid:11)(cid:4)(cid:14)(cid:11)(cid:48)(cid:48)(cid:7)(cid:5)(cid:3)(cid:9)(cid:2)(cid:28)(cid:3,Unknown,9531.0
Unknown,Unknown,2,Unknown,Unknown,Unknown,Unknown,cid:3)(cid:5)(cid:14)(cid:70)(cid:12)(cid:11)(cid:4)(cid:14)(cid:11)(cid:48)(cid:48)(cid:7)(cid:5)(cid:3)(cid:9)(cid:2)(cid:12)(cid:11)(cid:4)(cid:14)(cid:11)(cid:48)(cid:48)(cid:7)(cid:5)(cid:3)(cid:9)(cid:2)(cid:28)(cid:3,Unknown,9533.0
Unknown,Unknown,9,Unknown,Unknown,Unknown,Unknown,cid:3)(cid:5)(cid:14)(cid:70)(cid:12)(cid:11)(cid:4)(cid:14)(cid:11)(cid:48)(cid:48)(cid:7)(cid:5)(cid:3)(cid:9)(cid:2)(cid:12)(cid:11)(cid:4)(cid:14)(cid:11)(cid:48)(cid:48)(cid:7)(cid:5)(cid:3)(cid:9)(cid:2)(cid:28)(cid:3,Unknown,9542.0
Unknown,Unknown,11,Unknown,Unknown,Unknown,Unknown,cid:3)(cid:5)(cid:14)(cid:70)(cid:12)(cid:11)(cid:4)(cid:14)(cid:11)(cid:48)(cid:48)(cid:7)(cid:5)(cid:3)(cid:9)(cid:2)(cid:12)(cid:11)(cid:4)(cid:14)(cid:11)(cid:48)(cid:48)(cid:7)(cid:5)(cid:3)(cid:9)(cid:2)(cid:28)(cid:3,Unknown,9553.0
Unknown,Unknown,4,Unknown,Unknown,Unknown,Unknown,cid:3)(cid:5)(cid:14)(cid:70)(cid:12)(cid:11)(cid:4)(cid:14)(cid:11)(cid:48)(cid:48)(cid:7)(cid:5)(cid:3)(cid:9)(cid:2)(cid:12)(cid:11)(cid:4)(cid:14)(cid:11)(cid:48)(cid:48)(cid:7)(cid:5)(cid:3)(cid:9)(cid:2)(cid:28)(cid:3,Unknown,9557.0
Unknown,Unknown,2,Unknown,Unknown,Unknown,Unknown,cid:3)(cid:5)(cid:14)(cid:70)(cid:12)(cid:11)(cid:4)(cid:14)(cid:11)(cid:48)(cid:48)(cid:7)(cid:5)(cid:3)(cid:9)(cid:2)(cid:12)(cid:11)(cid:4)(cid:14)(cid:11)(cid:48)(cid:48)(cid:7)(cid:5)(cid:3)(cid:9)(cid:2)(cid:28)(cid:3,Unknown,9559.0
Unknown,Unknown,28,Unknown,Unknown,Unknown,Unknown,cid:3)(cid:5)(cid:14)(cid:70)(cid:12)(cid:11)(cid:4)(cid:14)(cid:11)(cid:48)(cid:48)(cid:7)(cid:5)(cid:3)(cid:9)(cid:2)(cid:12)(cid:11)(cid:4)(cid:14)(cid:11)(cid:48)(cid:48)(cid:7)(cid:5)(cid:3)(cid:9)(cid:2)(cid:28)(cid:3,Unknown,9587.0
Unknown,Unknown,3,Unknown,Unknown,Unknown,Unknown,cid:3)(cid:5)(cid:14)(cid:70)(cid:12)(cid:11)(cid:4)(cid:14)(cid:11)(cid:48)(cid:48)(cid:7)(cid:5)(cid:3)(cid:9)(cid:2)(cid:12)(cid:11)(cid:4)(cid:14)(cid:11)(cid:48)(cid:48)(cid:7)(cid:5)(cid:3)(cid:9)(cid:2)(cid:28)(cid:3,Unknown,9590.0
Unknown,Unknown,15,Unknown,Unknown,Unknown,Unknown,cid:3)(cid:5)(cid:14)(cid:70)(cid:12)(cid:11)(cid:4)(cid:14)(cid:11)(cid:48)(cid:48)(cid:7)(cid:5)(cid:3)(cid:9)(cid:2)(cid:12)(cid:11)(cid:4)(cid:14)(cid:11)(cid:48)(cid:48)(cid:7)(cid:5)(cid:3)(cid:9)(cid:2)(cid:28)(cid:3,Unknown,9605.0
Unknown,Unknown,2,Unknown,Unknown,Unknown,Unknown,cid:3)(cid:5)(cid:14)(cid:70)(cid:12)(cid:11)(cid:4)(cid:14)(cid:11)(cid:48)(cid:48)(cid:7)(cid:5)(cid:3)(cid:9)(cid:2)(cid:12)(cid:11)(cid:4)(cid:14)(cid:11)(cid:48)(cid:48)(cid:7)(cid:5)(cid:3)(cid:9)(cid:2)(cid:28)(cid:3,Unknown,9607.0
Unknown,Unknown,33,Unknown,Unknown,Unknown,Unknown,cid:3)(cid:5)(cid:14)(cid:70)(cid:12)(cid:11)(cid:4)(cid:14)(cid:11)(cid:48)(cid:48)(cid:7)(cid:5)(cid:3)(cid:9)(cid:2)(cid:12)(cid:11)(cid:4)(cid:14)(cid:11)(cid:48)(cid:48)(cid:7)(cid:5)(cid:3)(cid:9)(cid:2)(cid:28)(cid:3,Unknown,9640.0
Unknown,Unknown,16,Unknown,Unknown,Unknown,Unknown,cid:3)(cid:5)(cid:14)(cid:70)(cid:12)(cid:11)(cid:4)(cid:14)(cid:11)(cid:48)(cid:48)(cid:7)(cid:5)(cid:3)(cid:9)(cid:2)(cid:12)(cid:11)(cid:4)(cid:14)(cid:11)(cid:48)(cid:48)(cid:7)(cid:5)(cid:3)(cid:9)(cid:2)(cid:28)(cid:3,Unknown,9656.0
Unknown,Unknown,19,Unknown,Unknown,Unknown,Unknown,cid:3)(cid:5)(cid:14)(cid:70)(cid:12)(cid:11)(cid:4)(cid:14)(cid:11)(cid:48)(cid:48)(cid:7)(cid:5)(cid:3)(cid:9)(cid:2)(cid:12)(cid:11)(cid:4)(cid:14)(cid:11)(cid:48)(cid:48)(cid:7)(cid:5)(cid:3)(cid:9)(cid:2)(cid:28)(cid:3,Unknown,9675.0
Unknown,Unknown,34,Unknown,Unknown,Unknown,Unknown,cid:3)(cid:5)(cid:14)(cid:70)(cid:12)(cid:11)(cid:4)(cid:14)(cid:11)(cid:48)(cid:48)(cid:7)(cid:5)(cid:3)(cid:9)(cid:2)(cid:12)(cid:11)(cid:4)(cid:14)(cid:11)(cid:48)(cid:48)(cid:7)(cid:5)(cid:3)(cid:9)(cid:2)(cid:28)(cid:3,Unknown,9709.0
Unknown,Unknown,18,Unknown,Unknown,Unknown,Unknown,cid:3)(cid:5)(cid:14)(cid:70)(cid:12)(cid:11)(cid:4)(cid:14)(cid:11)(cid:48)(cid:48)(cid:7)(cid:5)(cid:3)(cid:9)(cid:2)(cid:12)(cid:11)(cid:4)(cid:14)(cid:11)(cid:48)(cid:48)(cid:7)(cid:5)(cid:3)(cid:9)(cid:2)(cid:28)(cid:3,Unknown,9727.0
Unknown,Unknown,2,Unknown,Unknown,Unknown,Unknown,cid:3)(cid:5)(cid:14)(cid:70)(cid:12)(cid:11)(cid:4)(cid:14)(cid:11)(cid:48)(cid:48)(cid:7)(cid:5)(cid:3)(cid:9)(cid:2)(cid:12)(cid:11)(cid:4)(cid:14)(cid:11)(cid:48)(cid:48)(cid:7)(cid:5)(cid:3)(cid:9)(cid:2)(cid:28)(cid:3,Unknown,9729.0
Unknown,Unknown,44,Unknown,Unknown,Unknown,Unknown,cid:3)(cid:5)(cid:14)(cid:70)(cid:12)(cid:11)(cid:4)(cid:14)(cid:11)(cid:48)(cid:48)(cid:7)(cid:5)(cid:3)(cid:9)(cid:2)(cid:12)(cid:11)(cid:4)(cid:14)(cid:11)(cid:48)(cid:48)(cid:7)(cid:5)(cid:3)(cid:9)(cid:2)(cid:28)(cid:3,Unknown,9773.0
Unknown,Unknown,12,Unknown,Unknown,Unknown,Unknown,cid:3)(cid:5)(cid:14)(cid:70)(cid:12)(cid:11)(cid:4)(cid:14)(cid:11)(cid:48)(cid:48)(cid:7)(cid:5)(cid:3)(cid:9)(cid:2)(cid:12)(cid:11)(cid:4)(cid:14)(cid:11)(cid:48)(cid:48)(cid:7)(cid:5)(cid:3)(cid:9)(cid:2)(cid:28)(cid:3,Unknown,9785.0
Unknown,Unknown,29,Unknown,Unknown,Unknown,Unknown,cid:3)(cid:5)(cid:14)(cid:70)(cid:12)(cid:11)(cid:4)(cid:14)(cid:11)(cid:48)(cid:48)(cid:7)(cid:5)(cid:3)(cid:9)(cid:2)(cid:12)(cid:11)(cid:4)(cid:14)(cid:11)(cid:48)(cid:48)(cid:7)(cid:5)(cid:3)(cid:9)(cid:2)(cid:28)(cid:3,Unknown,9814.0
Unknown,Unknown,26,Unknown,Unknown,Unknown,Unknown,cid:3)(cid:5)(cid:14)(cid:70)(cid:12)(cid:11)(cid:4)(cid:14)(cid:11)(cid:48)(cid:48)(cid:7)(cid:5)(cid:3)(cid:9)(cid:2)(cid:12)(cid:11)(cid:4)(cid:14)(cid:11)(cid:48)(cid:48)(cid:7)(cid:5)(cid:3)(cid:9)(cid:2)(cid:28)(cid:3,Unknown,9840.0
Unknown,Unknown,41,Unknown,Unknown,Unknown,Unknown,cid:3)(cid:5)(cid:14)(cid:70)(cid:12)(cid:11)(cid:4)(cid:14)(cid:11)(cid:48)(cid:48)(cid:7)(cid:5)(cid:3)(cid:9)(cid:2)(cid:12)(cid:11)(cid:4)(cid:14)(cid:11)(cid:48)(cid:48)(cid:7)(cid:5)(cid:3)(cid:9)(cid:2)(cid:28)(cid:3,Unknown,9881.0
Unknown,Unknown,25,Unknown,Unknown,Unknown,Unknown,cid:3)(cid:5)(cid:14)(cid:70)(cid:12)(cid:11)(cid:4)(cid:14)(cid:11)(cid:48)(cid:48)(cid:7)(cid:5)(cid:3)(cid:9)(cid:2)(cid:12)(cid:11)(cid:4)(cid:14)(cid:11)(cid:48)(cid:48)(cid:7)(cid:5)(cid:3)(cid:9)(cid:2)(cid:28)(cid:3,Unknown,9906.0
Unknown,Unknown,2,Unknown,Unknown,Unknown,Unknown,cid:3)(cid:5)(cid:14)(cid:70)(cid:12)(cid:11)(cid:4)(cid:14)(cid:11)(cid:48)(cid:48)(cid:7)(cid:5)(cid:3)(cid:9)(cid:2)(cid:12)(cid:11)(cid:4)(cid:14)(cid:11)(cid:48)(cid:48)(cid:7)(cid:5)(cid:3)(cid:9)(cid:2)(cid:28)(cid:3,Unknown,9908.0
Unknown,Unknown,58,Unknown,Unknown,Unknown,Unknown,cid:3)(cid:5)(cid:14)(cid:70)(cid:12)(cid:11)(cid:4)(cid:14)(cid:11)(cid:48)(cid:48)(cid:7)(cid:5)(cid:3)(cid:9)(cid:2)(cid:12)(cid:11)(cid:4)(cid:14)(cid:11)(cid:48)(cid:48)(cid:7)(cid:5)(cid:3)(cid:9)(cid:2)(cid:28)(cid:3,Unknown,9966.0
Unknown,Unknown,58,Unknown,Unknown,Unknown,Unknown,cid:3)(cid:5)(cid:14)(cid:70)(cid:12)(cid:11)(cid:4)(cid:14)(cid:11)(cid:48)(cid:48)(cid:7)(cid:5)(cid:3)(cid:9)(cid:2)(cid:12)(cid:11)(cid:4)(cid:14)(cid:11)(cid:48)(cid:48)(cid:7)(cid:5)(cid:3)(cid:9)(cid:2)(cid:28)(cid:3,Unknown,10024.0
Unknown,Unknown,18,Unknown,Unknown,Unknown,Unknown,cid:3)(cid:5)(cid:14)(cid:70)(cid:12)(cid:11)(cid:4)(cid:14)(cid:11)(cid:48)(cid:48)(cid:7)(cid:5)(cid:3)(cid:9)(cid:2)(cid:12)(cid:11)(cid:4)(cid:14)(cid:11)(cid:48)(cid:48)(cid:7)(cid:5)(cid:3)(cid:9)(cid:2)(cid:28)(cid:3,Unknown,10042.0
Unknown,Unknown,1,Unknown,Unknown,Unknown,Unknown,cid:3)(cid:5)(cid:14)(cid:70)(cid:12)(cid:11)(cid:4)(cid:14)(cid:11)(cid:48)(cid:48)(cid:7)(cid:5)(cid:3)(cid:9)(cid:2)(cid:12)(cid:11)(cid:4)(cid:14)(cid:11)(cid:48)(cid:48)(cid:7)(cid:5)(cid:3)(cid:9)(cid:2)(cid:28)(cid:3,Unknown,10043.0
Unknown,Unknown,1,Unknown,Unknown,Unknown,Unknown,cid:3)(cid:5)(cid:14)(cid:70)(cid:12)(cid:11)(cid:4)(cid:14)(cid:11)(cid:48)(cid:48)(cid:7)(cid:5)(cid:3)(cid:9)(cid:2)(cid:12)(cid:11)(cid:4)(cid:14)(cid:11)(cid:48)(cid:48)(cid:7)(cid:5)(cid:3)(cid:9)(cid:2)(cid:28)(cid:3,Unknown,10044.0
Unknown,Unknown,37,Unknown,Unknown,Unknown,Unknown,cid:3)(cid:5)(cid:14)(cid:70)(cid:12)(cid:11)(cid:4)(cid:14)(cid:11)(cid:48)(cid:48)(cid:7)(cid:5)(cid:3)(cid:9)(cid:2)(cid:12)(cid:11)(cid:4)(cid:14)(cid:11)(cid:48)(cid:48)(cid:7)(cid:5)(cid:3)(cid:9)(cid:2)(cid:28)(cid:3,Unknown,10081.0
Unknown,Unknown,17,Unknown,Unknown,Unknown,Unknown,cid:3)(cid:5)(cid:14)(cid:70)(cid:12)(cid:11)(cid:4)(cid:14)(cid:11)(cid:48)(cid:48)(cid:7)(cid:5)(cid:3)(cid:9)(cid:2)(cid:12)(cid:11)(cid:4)(cid:14)(cid:11)(cid:48)(cid:48)(cid:7)(cid:5)(cid:3)(cid:9)(cid:2)(cid:28)(cid:3,Unknown,10098.0
Unknown,Unknown,37,Unknown,Unknown,Unknown,Unknown,cid:3)(cid:5)(cid:14)(cid:70)(cid:12)(cid:11)(cid:4)(cid:14)(cid:11)(cid:48)(cid:48)(cid:7)(cid:5)(cid:3)(cid:9)(cid:2)(cid:12)(cid:11)(cid:4)(cid:14)(cid:11)(cid:48)(cid:48)(cid:7)(cid:5)(cid:3)(cid:9)(cid:2)(cid:28)(cid:3,Unknown,10135.0
Unknown,Unknown,45,Unknown,Unknown,Unknown,Unknown,cid:3)(cid:5)(cid:14)(cid:70)(cid:12)(cid:11)(cid:4)(cid:14)(cid:11)(cid:48)(cid:48)(cid:7)(cid:5)(cid:3)(cid:9)(cid:2)(cid:12)(cid:11)(cid:4)(cid:14)(cid:11)(cid:48)(cid:48)(cid:7)(cid:5)(cid:3)(cid:9)(cid:2)(cid:28)(cid:3,Unknown,10180.0
Unknown,Unknown,18,Unknown,Unknown,Unknown,Unknown,cid:3)(cid:5)(cid:14)(cid:70)(cid:12)(cid:11)(cid:4)(cid:14)(cid:11)(cid:48)(cid:48)(cid:7)(cid:5)(cid:3)(cid:9)(cid:2)(cid:12)(cid:11)(cid:4)(cid:14)(cid:11)(cid:48)(cid:48)(cid:7)(cid:5)(cid:3)(cid:9)(cid:2)(cid:28)(cid:3,Unknown,10198.0
Unknown,Unknown,16,Unknown,Unknown,Unknown,Unknown,cid:3)(cid:5)(cid:14)(cid:70)(cid:12)(cid:11)(cid:4)(cid:14)(cid:11)(cid:48)(cid:48)(cid:7)(cid:5)(cid:3)(cid:9)(cid:2)(cid:12)(cid:11)(cid:4)(cid:14)(cid:11)(cid:48)(cid:48)(cid:7)(cid:5)(cid:3)(cid:9)(cid:2)(cid:28)(cid:3,Unknown,10214.0
Unknown,Unknown,10,Unknown,Unknown,Unknown,Unknown,cid:3)(cid:5)(cid:14)(cid:70)(cid:12)(cid:11)(cid:4)(cid:14)(cid:11)(cid:48)(cid:48)(cid:7)(cid:5)(cid:3)(cid:9)(cid:2)(cid:12)(cid:11)(cid:4)(cid:14)(cid:11)(cid:48)(cid:48)(cid:7)(cid:5)(cid:3)(cid:9)(cid:2)(cid:28)(cid:3,Unknown,10224.0
Unknown,Unknown,46,Unknown,Unknown,Unknown,Unknown,cid:3)(cid:5)(cid:14)(cid:70)(cid:12)(cid:11)(cid:4)(cid:14)(cid:11)(cid:48)(cid:48)(cid:7)(cid:5)(cid:3)(cid:9)(cid:2)(cid:12)(cid:11)(cid:4)(cid:14)(cid:11)(cid:48)(cid:48)(cid:7)(cid:5)(cid:3)(cid:9)(cid:2)(cid:28)(cid:3,Unknown,10270.0
Unknown,Unknown,47,Unknown,Unknown,Unknown,Unknown,cid:3)(cid:5)(cid:14)(cid:70)(cid:12)(cid:11)(cid:4)(cid:14)(cid:11)(cid:48)(cid:48)(cid:7)(cid:5)(cid:3)(cid:9)(cid:2)(cid:12)(cid:11)(cid:4)(cid:14)(cid:11)(cid:48)(cid:48)(cid:7)(cid:5)(cid:3)(cid:9)(cid:2)(cid:28)(cid:3,Unknown,10317.0
Unknown,Unknown,46,Unknown,Unknown,Unknown,Unknown,cid:3)(cid:5)(cid:14)(cid:70)(cid:12)(cid:11)(cid:4)(cid:14)(cid:11)(cid:48)(cid:48)(cid:7)(cid:5)(cid:3)(cid:9)(cid:2)(cid:12)(cid:11)(cid:4)(cid:14)(cid:11)(cid:48)(cid:48)(cid:7)(cid:5)(cid:3)(cid:9)(cid:2)(cid:28)(cid:3,Unknown,10363.0
Unknown,Unknown,12,Unknown,Unknown,Unknown,Unknown,cid:3)(cid:5)(cid:14)(cid:70)(cid:12)(cid:11)(cid:4)(cid:14)(cid:11)(cid:48)(cid:48)(cid:7)(cid:5)(cid:3)(cid:9)(cid:2)(cid:12)(cid:11)(cid:4)(cid:14)(cid:11)(cid:48)(cid:48)(cid:7)(cid:5)(cid:3)(cid:9)(cid:2)(cid:28)(cid:3,Unknown,10375.0
Unknown,Unknown,2,Unknown,Unknown,Unknown,Unknown,cid:3)(cid:5)(cid:14)(cid:70)(cid:12)(cid:11)(cid:4)(cid:14)(cid:11)(cid:48)(cid:48)(cid:7)(cid:5)(cid:3)(cid:9)(cid:2)(cid:12)(cid:11)(cid:4)(cid:14)(cid:11)(cid:48)(cid:48)(cid:7)(cid:5)(cid:3)(cid:9)(cid:2)(cid:28)(cid:3,Unknown,10377.0
Unknown,Unknown,50,Unknown,Unknown,Unknown,Unknown,cid:3)(cid:5)(cid:14)(cid:70)(cid:12)(cid:11)(cid:4)(cid:14)(cid:11)(cid:48)(cid:48)(cid:7)(cid:5)(cid:3)(cid:9)(cid:2)(cid:12)(cid:11)(cid:4)(cid:14)(cid:11)(cid:48)(cid:48)(cid:7)(cid:5)(cid:3)(cid:9)(cid:2)(cid:28)(cid:3,Unknown,10427.0
Unknown,Unknown,5,Unknown,Unknown,Unknown,Unknown,cid:3)(cid:5)(cid:14)(cid:70)(cid:12)(cid:11)(cid:4)(cid:14)(cid:11)(cid:48)(cid:48)(cid:7)(cid:5)(cid:3)(cid:9)(cid:2)(cid:12)(cid:11)(cid:4)(cid:14)(cid:11)(cid:48)(cid:48)(cid:7)(cid:5)(cid:3)(cid:9)(cid:2)(cid:28)(cid:3,Unknown,10432.0
Unknown,Unknown,9,Unknown,Unknown,Unknown,Unknown,cid:3)(cid:5)(cid:14)(cid:70)(cid:12)(cid:11)(cid:4)(cid:14)(cid:11)(cid:48)(cid:48)(cid:7)(cid:5)(cid:3)(cid:9)(cid:2)(cid:12)(cid:11)(cid:4)(cid:14)(cid:11)(cid:48)(cid:48)(cid:7)(cid:5)(cid:3)(cid:9)(cid:2)(cid:28)(cid:3,Unknown,10441.0
Unknown,Unknown,2,Unknown,Unknown,Unknown,Unknown,cid:3)(cid:5)(cid:14)(cid:70)(cid:12)(cid:11)(cid:4)(cid:14)(cid:11)(cid:48)(cid:48)(cid:7)(cid:5)(cid:3)(cid:9)(cid:2)(cid:12)(cid:11)(cid:4)(cid:14)(cid:11)(cid:48)(cid:48)(cid:7)(cid:5)(cid:3)(cid:9)(cid:2)(cid:28)(cid:3,Unknown,10443.0
Unknown,Unknown,10,Unknown,Unknown,Unknown,Unknown,cid:3)(cid:5)(cid:14)(cid:70)(cid:12)(cid:11)(cid:4)(cid:14)(cid:11)(cid:48)(cid:48)(cid:7)(cid:5)(cid:3)(cid:9)(cid:2)(cid:12)(cid:11)(cid:4)(cid:14)(cid:11)(cid:48)(cid:48)(cid:7)(cid:5)(cid:3)(cid:9)(cid:2)(cid:28)(cid:3,Unknown,10453.0
Unknown,Unknown,5,Unknown,Unknown,Unknown,Unknown,cid:3)(cid:5)(cid:14)(cid:70)(cid:12)(cid:11)(cid:4)(cid:14)(cid:11)(cid:48)(cid:48)(cid:7)(cid:5)(cid:3)(cid:9)(cid:2)(cid:12)(cid:11)(cid:4)(cid:14)(cid:11)(cid:48)(cid:48)(cid:7)(cid:5)(cid:3)(cid:9)(cid:2)(cid:28)(cid:3,Unknown,10458.0
Unknown,Unknown,48,Unknown,Unknown,Unknown,Unknown,cid:3)(cid:5)(cid:14)(cid:70)(cid:12)(cid:11)(cid:4)(cid:14)(cid:11)(cid:48)(cid:48)(cid:7)(cid:5)(cid:3)(cid:9)(cid:2)(cid:12)(cid:11)(cid:4)(cid:14)(cid:11)(cid:48)(cid:48)(cid:7)(cid:5)(cid:3)(cid:9)(cid:2)(cid:28)(cid:3,Unknown,10506.0
Unknown,Unknown,2,Unknown,Unknown,Unknown,Unknown,cid:3)(cid:5)(cid:14)(cid:70)(cid:12)(cid:11)(cid:4)(cid:14)(cid:11)(cid:48)(cid:48)(cid:7)(cid:5)(cid:3)(cid:9)(cid:2)(cid:12)(cid:11)(cid:4)(cid:14)(cid:11)(cid:48)(cid:48)(cid:7)(cid:5)(cid:3)(cid:9)(cid:2)(cid:28)(cid:3,Unknown,10508.0
Unknown,Unknown,12,Unknown,Unknown,Unknown,Unknown,cid:3)(cid:5)(cid:14)(cid:70)(cid:12)(cid:11)(cid:4)(cid:14)(cid:11)(cid:48)(cid:48)(cid:7)(cid:5)(cid:3)(cid:9)(cid:2)(cid:12)(cid:11)(cid:4)(cid:14)(cid:11)(cid:48)(cid:48)(cid:7)(cid:5)(cid:3)(cid:9)(cid:2)(cid:28)(cid:3,Unknown,10520.0
Unknown,Unknown,11,Unknown,Unknown,Unknown,Unknown,cid:3)(cid:5)(cid:14)(cid:70)(cid:12)(cid:11)(cid:4)(cid:14)(cid:11)(cid:48)(cid:48)(cid:7)(cid:5)(cid:3)(cid:9)(cid:2)(cid:12)(cid:11)(cid:4)(cid:14)(cid:11)(cid:48)(cid:48)(cid:7)(cid:5)(cid:3)(cid:9)(cid:2)(cid:28)(cid:3,Unknown,10531.0
Unknown,Unknown,4,Unknown,Unknown,Unknown,Unknown,cid:3)(cid:5)(cid:14)(cid:70)(cid:12)(cid:11)(cid:4)(cid:14)(cid:11)(cid:48)(cid:48)(cid:7)(cid:5)(cid:3)(cid:9)(cid:2)(cid:12)(cid:11)(cid:4)(cid:14)(cid:11)(cid:48)(cid:48)(cid:7)(cid:5)(cid:3)(cid:9)(cid:2)(cid:28)(cid:3,Unknown,10535.0
Unknown,Unknown,14,Unknown,Unknown,Unknown,Unknown,cid:3)(cid:5)(cid:14)(cid:70)(cid:12)(cid:11)(cid:4)(cid:14)(cid:11)(cid:48)(cid:48)(cid:7)(cid:5)(cid:3)(cid:9)(cid:2)(cid:12)(cid:11)(cid:4)(cid:14)(cid:11)(cid:48)(cid:48)(cid:7)(cid:5)(cid:3)(cid:9)(cid:2)(cid:28)(cid:3,Unknown,10549.0
Unknown,Unknown,11,Unknown,Unknown,Unknown,Unknown,cid:3)(cid:5)(cid:14)(cid:70)(cid:12)(cid:11)(cid:4)(cid:14)(cid:11)(cid:48)(cid:48)(cid:7)(cid:5)(cid:3)(cid:9)(cid:2)(cid:12)(cid:11)(cid:4)(cid:14)(cid:11)(cid:48)(cid:48)(cid:7)(cid:5)(cid:3)(cid:9)(cid:2)(cid:28)(cid:3,Unknown,10560.0
Unknown,Unknown,48,Unknown,Unknown,Unknown,Unknown,cid:3)(cid:5)(cid:14)(cid:70)(cid:12)(cid:11)(cid:4)(cid:14)(cid:11)(cid:48)(cid:48)(cid:7)(cid:5)(cid:3)(cid:9)(cid:2)(cid:12)(cid:11)(cid:4)(cid:14)(cid:11)(cid:48)(cid:48)(cid:7)(cid:5)(cid:3)(cid:9)(cid:2)(cid:28)(cid:3,Unknown,10608.0
Unknown,Unknown,48,Unknown,Unknown,Unknown,Unknown,cid:3)(cid:5)(cid:14)(cid:70)(cid:12)(cid:11)(cid:4)(cid:14)(cid:11)(cid:48)(cid:48)(cid:7)(cid:5)(cid:3)(cid:9)(cid:2)(cid:12)(cid:11)(cid:4)(cid:14)(cid:11)(cid:48)(cid:48)(cid:7)(cid:5)(cid:3)(cid:9)(cid:2)(cid:28)(cid:3,Unknown,10656.0
Unknown,Unknown,7,Unknown,Unknown,Unknown,Unknown,cid:3)(cid:5)(cid:14)(cid:70)(cid:12)(cid:11)(cid:4)(cid:14)(cid:11)(cid:48)(cid:48)(cid:7)(cid:5)(cid:3)(cid:9)(cid:2)(cid:12)(cid:11)(cid:4)(cid:14)(cid:11)(cid:48)(cid:48)(cid:7)(cid:5)(cid:3)(cid:9)(cid:2)(cid:28)(cid:3,Unknown,10663.0
Unknown,Unknown,5,Unknown,Unknown,Unknown,Unknown,cid:3)(cid:5)(cid:14)(cid:70)(cid:12)(cid:11)(cid:4)(cid:14)(cid:11)(cid:48)(cid:48)(cid:7)(cid:5)(cid:3)(cid:9)(cid:2)(cid:12)(cid:11)(cid:4)(cid:14)(cid:11)(cid:48)(cid:48)(cid:7)(cid:5)(cid:3)(cid:9)(cid:2)(cid:28)(cid:3,Unknown,10668.0
Unknown,Unknown,3,Unknown,Unknown,Unknown,Unknown,cid:3)(cid:5)(cid:14)(cid:70)(cid:12)(cid:11)(cid:4)(cid:14)(cid:11)(cid:48)(cid:48)(cid:7)(cid:5)(cid:3)(cid:9)(cid:2)(cid:12)(cid:11)(cid:4)(cid:14)(cid:11)(cid:48)(cid:48)(cid:7)(cid:5)(cid:3)(cid:9)(cid:2)(cid:28)(cid:3,Unknown,10671.0
Unknown,Unknown,2,Unknown,Unknown,Unknown,Unknown,cid:3)(cid:5)(cid:14)(cid:70)(cid:12)(cid:11)(cid:4)(cid:14)(cid:11)(cid:48)(cid:48)(cid:7)(cid:5)(cid:3)(cid:9)(cid:2)(cid:12)(cid:11)(cid:4)(cid:14)(cid:11)(cid:48)(cid:48)(cid:7)(cid:5)(cid:3)(cid:9)(cid:2)(cid:28)(cid:3,Unknown,10673.0
Unknown,Unknown,28,Unknown,Unknown,Unknown,Unknown,cid:3)(cid:5)(cid:14)(cid:70)(cid:12)(cid:11)(cid:4)(cid:14)(cid:11)(cid:48)(cid:48)(cid:7)(cid:5)(cid:3)(cid:9)(cid:2)(cid:12)(cid:11)(cid:4)(cid:14)(cid:11)(cid:48)(cid:48)(cid:7)(cid:5)(cid:3)(cid:9)(cid:2)(cid:28)(cid:3,Unknown,10701.0
Unknown,Unknown,3,Unknown,Unknown,Unknown,Unknown,cid:3)(cid:5)(cid:14)(cid:70)(cid:12)(cid:11)(cid:4)(cid:14)(cid:11)(cid:48)(cid:48)(cid:7)(cid:5)(cid:3)(cid:9)(cid:2)(cid:12)(cid:11)(cid:4)(cid:14)(cid:11)(cid:48)(cid:48)(cid:7)(cid:5)(cid:3)(cid:9)(cid:2)(cid:28)(cid:3,Unknown,10704.0
Unknown,Unknown,15,Unknown,Unknown,Unknown,Unknown,cid:3)(cid:5)(cid:14)(cid:70)(cid:12)(cid:11)(cid:4)(cid:14)(cid:11)(cid:48)(cid:48)(cid:7)(cid:5)(cid:3)(cid:9)(cid:2)(cid:12)(cid:11)(cid:4)(cid:14)(cid:11)(cid:48)(cid:48)(cid:7)(cid:5)(cid:3)(cid:9)(cid:2)(cid:28)(cid:3,Unknown,10719.0
Unknown,Unknown,2,Unknown,Unknown,Unknown,Unknown,cid:3)(cid:5)(cid:14)(cid:70)(cid:12)(cid:11)(cid:4)(cid:14)(cid:11)(cid:48)(cid:48)(cid:7)(cid:5)(cid:3)(cid:9)(cid:2)(cid:12)(cid:11)(cid:4)(cid:14)(cid:11)(cid:48)(cid:48)(cid:7)(cid:5)(cid:3)(cid:9)(cid:2)(cid:28)(cid:3,Unknown,10721.0
Unknown,Unknown,37,Unknown,Unknown,Unknown,Unknown,cid:3)(cid:5)(cid:14)(cid:70)(cid:12)(cid:11)(cid:4)(cid:14)(cid:11)(cid:48)(cid:48)(cid:7)(cid:5)(cid:3)(cid:9)(cid:2)(cid:12)(cid:11)(cid:4)(cid:14)(cid:11)(cid:48)(cid:48)(cid:7)(cid:5)(cid:3)(cid:9)(cid:2)(cid:28)(cid:3,Unknown,10758.0
Unknown,Unknown,17,Unknown,Unknown,Unknown,Unknown,cid:3)(cid:5)(cid:14)(cid:70)(cid:12)(cid:11)(cid:4)(cid:14)(cid:11)(cid:48)(cid:48)(cid:7)(cid:5)(cid:3)(cid:9)(cid:2)(cid:12)(cid:11)(cid:4)(cid:14)(cid:11)(cid:48)(cid:48)(cid:7)(cid:5)(cid:3)(cid:9)(cid:2)(cid:28)(cid:3,Unknown,10775.0
Unknown,Unknown,19,Unknown,Unknown,Unknown,Unknown,cid:3)(cid:5)(cid:14)(cid:70)(cid:12)(cid:11)(cid:4)(cid:14)(cid:11)(cid:48)(cid:48)(cid:7)(cid:5)(cid:3)(cid:9)(cid:2)(cid:12)(cid:11)(cid:4)(cid:14)(cid:11)(cid:48)(cid:48)(cid:7)(cid:5)(cid:3)(cid:9)(cid:2)(cid:28)(cid:3,Unknown,10794.0
Unknown,Unknown,36,Unknown,Unknown,Unknown,Unknown,cid:3)(cid:5)(cid:14)(cid:70)(cid:12)(cid:11)(cid:4)(cid:14)(cid:11)(cid:48)(cid:48)(cid:7)(cid:5)(cid:3)(cid:9)(cid:2)(cid:12)(cid:11)(cid:4)(cid:14)(cid:11)(cid:48)(cid:48)(cid:7)(cid:5)(cid:3)(cid:9)(cid:2)(cid:28)(cid:3,Unknown,10830.0
Unknown,Unknown,18,Unknown,Unknown,Unknown,Unknown,cid:3)(cid:5)(cid:14)(cid:70)(cid:12)(cid:11)(cid:4)(cid:14)(cid:11)(cid:48)(cid:48)(cid:7)(cid:5)(cid:3)(cid:9)(cid:2)(cid:12)(cid:11)(cid:4)(cid:14)(cid:11)(cid:48)(cid:48)(cid:7)(cid:5)(cid:3)(cid:9)(cid:2)(cid:28)(cid:3,Unknown,10848.0
Unknown,Unknown,2,Unknown,Unknown,Unknown,Unknown,cid:3)(cid:5)(cid:14)(cid:70)(cid:12)(cid:11)(cid:4)(cid:14)(cid:11)(cid:48)(cid:48)(cid:7)(cid:5)(cid:3)(cid:9)(cid:2)(cid:12)(cid:11)(cid:4)(cid:14)(cid:11)(cid:48)(cid:48)(cid:7)(cid:5)(cid:3)(cid:9)(cid:2)(cid:28)(cid:3,Unknown,10850.0
Unknown,Unknown,44,Unknown,Unknown,Unknown,Unknown,cid:3)(cid:5)(cid:14)(cid:70)(cid:12)(cid:11)(cid:4)(cid:14)(cid:11)(cid:48)(cid:48)(cid:7)(cid:5)(cid:3)(cid:9)(cid:2)(cid:12)(cid:11)(cid:4)(cid:14)(cid:11)(cid:48)(cid:48)(cid:7)(cid:5)(cid:3)(cid:9)(cid:2)(cid:28)(cid:3,Unknown,10894.0
Unknown,Unknown,12,Unknown,Unknown,Unknown,Unknown,cid:3)(cid:5)(cid:14)(cid:70)(cid:12)(cid:11)(cid:4)(cid:14)(cid:11)(cid:48)(cid:48)(cid:7)(cid:5)(cid:3)(cid:9)(cid:2)(cid:12)(cid:11)(cid:4)(cid:14)(cid:11)(cid:48)(cid:48)(cid:7)(cid:5)(cid:3)(cid:9)(cid:2)(cid:28)(cid:3,Unknown,10906.0
Unknown,Unknown,29,Unknown,Unknown,Unknown,Unknown,cid:3)(cid:5)(cid:14)(cid:70)(cid:12)(cid:11)(cid:4)(cid:14)(cid:11)(cid:48)(cid:48)(cid:7)(cid:5)(cid:3)(cid:9)(cid:2)(cid:12)(cid:11)(cid:4)(cid:14)(cid:11)(cid:48)(cid:48)(cid:7)(cid:5)(cid:3)(cid:9)(cid:2)(cid:28)(cid:3,Unknown,10935.0
Unknown,Unknown,26,Unknown,Unknown,Unknown,Unknown,cid:3)(cid:5)(cid:14)(cid:70)(cid:12)(cid:11)(cid:4)(cid:14)(cid:11)(cid:48)(cid:48)(cid:7)(cid:5)(cid:3)(cid:9)(cid:2)(cid:12)(cid:11)(cid:4)(cid:14)(cid:11)(cid:48)(cid:48)(cid:7)(cid:5)(cid:3)(cid:9)(cid:2)(cid:28)(cid:3,Unknown,10961.0
Unknown,Unknown,41,Unknown,Unknown,Unknown,Unknown,cid:3)(cid:5)(cid:14)(cid:70)(cid:12)(cid:11)(cid:4)(cid:14)(cid:11)(cid:48)(cid:48)(cid:7)(cid:5)(cid:3)(cid:9)(cid:2)(cid:12)(cid:11)(cid:4)(cid:14)(cid:11)(cid:48)(cid:48)(cid:7)(cid:5)(cid:3)(cid:9)(cid:2)(cid:28)(cid:3,Unknown,11002.0
Unknown,Unknown,25,Unknown,Unknown,Unknown,Unknown,cid:3)(cid:5)(cid:14)(cid:70)(cid:12)(cid:11)(cid:4)(cid:14)(cid:11)(cid:48)(cid:48)(cid:7)(cid:5)(cid:3)(cid:9)(cid:2)(cid:12)(cid:11)(cid:4)(cid:14)(cid:11)(cid:48)(cid:48)(cid:7)(cid:5)(cid:3)(cid:9)(cid:2)(cid:28)(cid:3,Unknown,11027.0
Unknown,Unknown,2,Unknown,Unknown,Unknown,Unknown,cid:3)(cid:5)(cid:14)(cid:70)(cid:12)(cid:11)(cid:4)(cid:14)(cid:11)(cid:48)(cid:48)(cid:7)(cid:5)(cid:3)(cid:9)(cid:2)(cid:12)(cid:11)(cid:4)(cid:14)(cid:11)(cid:48)(cid:48)(cid:7)(cid:5)(cid:3)(cid:9)(cid:2)(cid:28)(cid:3,Unknown,11029.0
Unknown,Unknown,58,Unknown,Unknown,Unknown,Unknown,cid:3)(cid:5)(cid:14)(cid:70)(cid:12)(cid:11)(cid:4)(cid:14)(cid:11)(cid:48)(cid:48)(cid:7)(cid:5)(cid:3)(cid:9)(cid:2)(cid:12)(cid:11)(cid:4)(cid:14)(cid:11)(cid:48)(cid:48)(cid:7)(cid:5)(cid:3)(cid:9)(cid:2)(cid:28)(cid:3,Unknown,11087.0
Unknown,Unknown,58,Unknown,Unknown,Unknown,Unknown,cid:3)(cid:5)(cid:14)(cid:70)(cid:12)(cid:11)(cid:4)(cid:14)(cid:11)(cid:48)(cid:48)(cid:7)(cid:5)(cid:3)(cid:9)(cid:2)(cid:12)(cid:11)(cid:4)(cid:14)(cid:11)(cid:48)(cid:48)(cid:7)(cid:5)(cid:3)(cid:9)(cid:2)(cid:28)(cid:3,Unknown,11145.0
Unknown,Unknown,37,Unknown,Unknown,Unknown,Unknown,cid:3)(cid:5)(cid:14)(cid:70)(cid:12)(cid:11)(cid:4)(cid:14)(cid:11)(cid:48)(cid:48)(cid:7)(cid:5)(cid:3)(cid:9)(cid:2)(cid:12)(cid:11)(cid:4)(cid:14)(cid:11)(cid:48)(cid:48)(cid:7)(cid:5)(cid:3)(cid:9)(cid:2)(cid:28)(cid:3,Unknown,11182.0
Unknown,Unknown,16,Unknown,Unknown,Unknown,Unknown,cid:3)(cid:5)(cid:14)(cid:70)(cid:12)(cid:11)(cid:4)(cid:14)(cid:11)(cid:48)(cid:48)(cid:7)(cid:5)(cid:3)(cid:9)(cid:2)(cid:12)(cid:11)(cid:4)(cid:14)(cid:11)(cid:48)(cid:48)(cid:7)(cid:5)(cid:3)(cid:9)(cid:2)(cid:28)(cid:3,Unknown,11198.0
Unknown,Unknown,34,Unknown,Unknown,Unknown,Unknown,cid:3)(cid:5)(cid:14)(cid:70)(cid:12)(cid:11)(cid:4)(cid:14)(cid:11)(cid:48)(cid:48)(cid:7)(cid:5)(cid:3)(cid:9)(cid:2)(cid:12)(cid:11)(cid:4)(cid:14)(cid:11)(cid:48)(cid:48)(cid:7)(cid:5)(cid:3)(cid:9)(cid:2)(cid:28)(cid:3,Unknown,11232.0
Unknown,Unknown,33,Unknown,Unknown,Unknown,Unknown,cid:3)(cid:5)(cid:14)(cid:70)(cid:12)(cid:11)(cid:4)(cid:14)(cid:11)(cid:48)(cid:48)(cid:7)(cid:5)(cid:3)(cid:9)(cid:2)(cid:12)(cid:11)(cid:4)(cid:14)(cid:11)(cid:48)(cid:48)(cid:7)(cid:5)(cid:3)(cid:9)(cid:2)(cid:28)(cid:3,Unknown,11265.0
Unknown,Unknown,17,Unknown,Unknown,Unknown,Unknown,cid:3)(cid:5)(cid:14)(cid:70)(cid:12)(cid:11)(cid:4)(cid:14)(cid:11)(cid:48)(cid:48)(cid:7)(cid:5)(cid:3)(cid:9)(cid:2)(cid:12)(cid:11)(cid:4)(cid:14)(cid:11)(cid:48)(cid:48)(cid:7)(cid:5)(cid:3)(cid:9)(cid:2)(cid:28)(cid:3,Unknown,11282.0
Unknown,Unknown,36,Unknown,Unknown,Unknown,Unknown,cid:3)(cid:5)(cid:14)(cid:70)(cid:12)(cid:11)(cid:4)(cid:14)(cid:11)(cid:48)(cid:48)(cid:7)(cid:5)(cid:3)(cid:9)(cid:2)(cid:12)(cid:11)(cid:4)(cid:14)(cid:11)(cid:48)(cid:48)(cid:7)(cid:5)(cid:3)(cid:9)(cid:2)(cid:28)(cid:3,Unknown,11318.0
Unknown,Unknown,45,Unknown,Unknown,Unknown,Unknown,cid:3)(cid:5)(cid:14)(cid:70)(cid:12)(cid:11)(cid:4)(cid:14)(cid:11)(cid:48)(cid:48)(cid:7)(cid:5)(cid:3)(cid:9)(cid:2)(cid:12)(cid:11)(cid:4)(cid:14)(cid:11)(cid:48)(cid:48)(cid:7)(cid:5)(cid:3)(cid:9)(cid:2)(cid:28)(cid:3,Unknown,11363.0
Unknown,Unknown,18,Unknown,Unknown,Unknown,Unknown,cid:3)(cid:5)(cid:14)(cid:70)(cid:12)(cid:11)(cid:4)(cid:14)(cid:11)(cid:48)(cid:48)(cid:7)(cid:5)(cid:3)(cid:9)(cid:2)(cid:12)(cid:11)(cid:4)(cid:14)(cid:11)(cid:48)(cid:48)(cid:7)(cid:5)(cid:3)(cid:9)(cid:2)(cid:28)(cid:3,Unknown,11381.0
Unknown,Unknown,16,Unknown,Unknown,Unknown,Unknown,cid:3)(cid:5)(cid:14)(cid:70)(cid:12)(cid:11)(cid:4)(cid:14)(cid:11)(cid:48)(cid:48)(cid:7)(cid:5)(cid:3)(cid:9)(cid:2)(cid:12)(cid:11)(cid:4)(cid:14)(cid:11)(cid:48)(cid:48)(cid:7)(cid:5)(cid:3)(cid:9)(cid:2)(cid:28)(cid:3,Unknown,11397.0
Unknown,Unknown,48,Unknown,Unknown,Unknown,Unknown,cid:3)(cid:5)(cid:14)(cid:70)(cid:12)(cid:11)(cid:4)(cid:14)(cid:11)(cid:48)(cid:48)(cid:7)(cid:5)(cid:3)(cid:9)(cid:2)(cid:12)(cid:11)(cid:4)(cid:14)(cid:11)(cid:48)(cid:48)(cid:7)(cid:5)(cid:3)(cid:9)(cid:2)(cid:28)(cid:3,Unknown,11445.0
Unknown,Unknown,12,Unknown,Unknown,Unknown,Unknown,cid:3)(cid:5)(cid:14)(cid:70)(cid:12)(cid:11)(cid:4)(cid:14)(cid:11)(cid:48)(cid:48)(cid:7)(cid:5)(cid:3)(cid:9)(cid:2)(cid:12)(cid:11)(cid:4)(cid:14)(cid:11)(cid:48)(cid:48)(cid:7)(cid:5)(cid:3)(cid:9)(cid:2)(cid:28)(cid:3,Unknown,11457.0
Unknown,Unknown,2,Unknown,Unknown,Unknown,Unknown,cid:3)(cid:5)(cid:14)(cid:70)(cid:12)(cid:11)(cid:4)(cid:14)(cid:11)(cid:48)(cid:48)(cid:7)(cid:5)(cid:3)(cid:9)(cid:2)(cid:12)(cid:11)(cid:4)(cid:14)(cid:11)(cid:48)(cid:48)(cid:7)(cid:5)(cid:3)(cid:9)(cid:2)(cid:28)(cid:3,Unknown,11459.0
Unknown,Unknown,50,Unknown,Unknown,Unknown,Unknown,cid:3)(cid:5)(cid:14)(cid:70)(cid:12)(cid:11)(cid:4)(cid:14)(cid:11)(cid:48)(cid:48)(cid:7)(cid:5)(cid:3)(cid:9)(cid:2)(cid:12)(cid:11)(cid:4)(cid:14)(cid:11)(cid:48)(cid:48)(cid:7)(cid:5)(cid:3)(cid:9)(cid:2)(cid:28)(cid:3,Unknown,11509.0
Unknown,Unknown,11,Unknown,Unknown,Unknown,Unknown,cid:3)(cid:5)(cid:14)(cid:70)(cid:12)(cid:11)(cid:4)(cid:14)(cid:11)(cid:48)(cid:48)(cid:7)(cid:5)(cid:3)(cid:9)(cid:2)(cid:12)(cid:11)(cid:4)(cid:14)(cid:11)(cid:48)(cid:48)(cid:7)(cid:5)(cid:3)(cid:9)(cid:2)(cid:28)(cid:3,Unknown,11520.0
Unknown,Unknown,8,Unknown,Unknown,Unknown,Unknown,cid:3)(cid:5)(cid:14)(cid:70)(cid:12)(cid:11)(cid:4)(cid:14)(cid:11)(cid:48)(cid:48)(cid:7)(cid:5)(cid:3)(cid:9)(cid:2)(cid:12)(cid:11)(cid:4)(cid:14)(cid:11)(cid:48)(cid:48)(cid:7)(cid:5)(cid:3)(cid:9)(cid:2)(cid:28)(cid:3,Unknown,11528.0
Unknown,Unknown,46,Unknown,Unknown,Unknown,Unknown,cid:3)(cid:5)(cid:14)(cid:70)(cid:12)(cid:11)(cid:4)(cid:14)(cid:11)(cid:48)(cid:48)(cid:7)(cid:5)(cid:3)(cid:9)(cid:2)(cid:12)(cid:11)(cid:4)(cid:14)(cid:11)(cid:48)(cid:48)(cid:7)(cid:5)(cid:3)(cid:9)(cid:2)(cid:28)(cid:3,Unknown,11574.0
Unknown,Unknown,14,Unknown,Unknown,Unknown,Unknown,cid:3)(cid:5)(cid:14)(cid:70)(cid:12)(cid:11)(cid:4)(cid:14)(cid:11)(cid:48)(cid:48)(cid:7)(cid:5)(cid:3)(cid:9)(cid:2)(cid:12)(cid:11)(cid:4)(cid:14)(cid:11)(cid:48)(cid:48)(cid:7)(cid:5)(cid:3)(cid:9)(cid:2)(cid:28)(cid:3,Unknown,11588.0
Unknown,Unknown,50,Unknown,Unknown,Unknown,Unknown,cid:3)(cid:5)(cid:14)(cid:70)(cid:12)(cid:11)(cid:4)(cid:14)(cid:11)(cid:48)(cid:48)(cid:7)(cid:5)(cid:3)(cid:9)(cid:2)(cid:12)(cid:11)(cid:4)(cid:14)(cid:11)(cid:48)(cid:48)(cid:7)(cid:5)(cid:3)(cid:9)(cid:2)(cid:28)(cid:3,Unknown,11638.0
Unknown,Unknown,69,Unknown,Unknown,Unknown,Unknown,cid:3)(cid:5)(cid:14)(cid:70)(cid:12)(cid:11)(cid:4)(cid:14)(cid:11)(cid:48)(cid:48)(cid:7)(cid:5)(cid:3)(cid:9)(cid:2)(cid:12)(cid:11)(cid:4)(cid:14)(cid:11)(cid:48)(cid:48)(cid:7)(cid:5)(cid:3)(cid:9)(cid:2)(cid:28)(cid:3,Unknown,11707.0
Unknown,Unknown,9,Unknown,Unknown,Unknown,Unknown,cid:3)(cid:5)(cid:14)(cid:70)(cid:12)(cid:11)(cid:4)(cid:14)(cid:11)(cid:48)(cid:48)(cid:7)(cid:5)(cid:3)(cid:9)(cid:2)(cid:12)(cid:11)(cid:4)(cid:14)(cid:11)(cid:48)(cid:48)(cid:7)(cid:5)(cid:3)(cid:9)(cid:2)(cid:28)(cid:3,Unknown,11716.0
Unknown,Unknown,2,Unknown,Unknown,Unknown,Unknown,cid:3)(cid:5)(cid:14)(cid:70)(cid:12)(cid:11)(cid:4)(cid:14)(cid:11)(cid:48)(cid:48)(cid:7)(cid:5)(cid:3)(cid:9)(cid:2)(cid:12)(cid:11)(cid:4)(cid:14)(cid:11)(cid:48)(cid:48)(cid:7)(cid:5)(cid:3)(cid:9)(cid:2)(cid:28)(cid:3,Unknown,11718.0
Unknown,Unknown,12,Unknown,Unknown,Unknown,Unknown,cid:3)(cid:5)(cid:14)(cid:70)(cid:12)(cid:11)(cid:4)(cid:14)(cid:11)(cid:48)(cid:48)(cid:7)(cid:5)(cid:3)(cid:9)(cid:2)(cid:12)(cid:11)(cid:4)(cid:14)(cid:11)(cid:48)(cid:48)(cid:7)(cid:5)(cid:3)(cid:9)(cid:2)(cid:28)(cid:3,Unknown,11730.0
Unknown,Unknown,11,Unknown,Unknown,Unknown,Unknown,cid:3)(cid:5)(cid:14)(cid:70)(cid:12)(cid:11)(cid:4)(cid:14)(cid:11)(cid:48)(cid:48)(cid:7)(cid:5)(cid:3)(cid:9)(cid:2)(cid:12)(cid:11)(cid:4)(cid:14)(cid:11)(cid:48)(cid:48)(cid:7)(cid:5)(cid:3)(cid:9)(cid:2)(cid:28)(cid:3,Unknown,11741.0
Unknown,Unknown,4,Unknown,Unknown,Unknown,Unknown,cid:3)(cid:5)(cid:14)(cid:70)(cid:12)(cid:11)(cid:4)(cid:14)(cid:11)(cid:48)(cid:48)(cid:7)(cid:5)(cid:3)(cid:9)(cid:2)(cid:12)(cid:11)(cid:4)(cid:14)(cid:11)(cid:48)(cid:48)(cid:7)(cid:5)(cid:3)(cid:9)(cid:2)(cid:28)(cid:3,Unknown,11745.0
Unknown,Unknown,14,Unknown,Unknown,Unknown,Unknown,cid:3)(cid:5)(cid:14)(cid:70)(cid:12)(cid:11)(cid:4)(cid:14)(cid:11)(cid:48)(cid:48)(cid:7)(cid:5)(cid:3)(cid:9)(cid:2)(cid:12)(cid:11)(cid:4)(cid:14)(cid:11)(cid:48)(cid:48)(cid:7)(cid:5)(cid:3)(cid:9)(cid:2)(cid:28)(cid:3,Unknown,11759.0
Unknown,Unknown,11,Unknown,Unknown,Unknown,Unknown,cid:3)(cid:5)(cid:14)(cid:70)(cid:12)(cid:11)(cid:4)(cid:14)(cid:11)(cid:48)(cid:48)(cid:7)(cid:5)(cid:3)(cid:9)(cid:2)(cid:12)(cid:11)(cid:4)(cid:14)(cid:11)(cid:48)(cid:48)(cid:7)(cid:5)(cid:3)(cid:9)(cid:2)(cid:28)(cid:3,Unknown,11770.0
Unknown,Unknown,48,Unknown,Unknown,Unknown,Unknown,cid:3)(cid:5)(cid:14)(cid:70)(cid:12)(cid:11)(cid:4)(cid:14)(cid:11)(cid:48)(cid:48)(cid:7)(cid:5)(cid:3)(cid:9)(cid:2)(cid:12)(cid:11)(cid:4)(cid:14)(cid:11)(cid:48)(cid:48)(cid:7)(cid:5)(cid:3)(cid:9)(cid:2)(cid:28)(cid:3,Unknown,11818.0
Unknown,Unknown,48,Unknown,Unknown,Unknown,Unknown,cid:3)(cid:5)(cid:14)(cid:70)(cid:12)(cid:11)(cid:4)(cid:14)(cid:11)(cid:48)(cid:48)(cid:7)(cid:5)(cid:3)(cid:9)(cid:2)(cid:12)(cid:11)(cid:4)(cid:14)(cid:11)(cid:48)(cid:48)(cid:7)(cid:5)(cid:3)(cid:9)(cid:2)(cid:28)(cid:3,Unknown,11866.0
Unknown,Unknown,7,Unknown,Unknown,Unknown,Unknown,cid:3)(cid:5)(cid:14)(cid:70)(cid:12)(cid:11)(cid:4)(cid:14)(cid:11)(cid:48)(cid:48)(cid:7)(cid:5)(cid:3)(cid:9)(cid:2)(cid:12)(cid:11)(cid:4)(cid:14)(cid:11)(cid:48)(cid:48)(cid:7)(cid:5)(cid:3)(cid:9)(cid:2)(cid:28)(cid:3,Unknown,11873.0
Unknown,Unknown,5,Unknown,Unknown,Unknown,Unknown,cid:3)(cid:5)(cid:14)(cid:70)(cid:12)(cid:11)(cid:4)(cid:14)(cid:11)(cid:48)(cid:48)(cid:7)(cid:5)(cid:3)(cid:9)(cid:2)(cid:12)(cid:11)(cid:4)(cid:14)(cid:11)(cid:48)(cid:48)(cid:7)(cid:5)(cid:3)(cid:9)(cid:2)(cid:28)(cid:3,Unknown,11878.0
Unknown,Unknown,3,Unknown,Unknown,Unknown,Unknown,cid:3)(cid:5)(cid:14)(cid:70)(cid:12)(cid:11)(cid:4)(cid:14)(cid:11)(cid:48)(cid:48)(cid:7)(cid:5)(cid:3)(cid:9)(cid:2)(cid:12)(cid:11)(cid:4)(cid:14)(cid:11)(cid:48)(cid:48)(cid:7)(cid:5)(cid:3)(cid:9)(cid:2)(cid:28)(cid:3,Unknown,11881.0
Unknown,Unknown,2,Unknown,Unknown,Unknown,Unknown,cid:3)(cid:5)(cid:14)(cid:70)(cid:12)(cid:11)(cid:4)(cid:14)(cid:11)(cid:48)(cid:48)(cid:7)(cid:5)(cid:3)(cid:9)(cid:2)(cid:12)(cid:11)(cid:4)(cid:14)(cid:11)(cid:48)(cid:48)(cid:7)(cid:5)(cid:3)(cid:9)(cid:2)(cid:28)(cid:3,Unknown,11883.0
Unknown,Unknown,28,Unknown,Unknown,Unknown,Unknown,cid:3)(cid:5)(cid:14)(cid:70)(cid:12)(cid:11)(cid:4)(cid:14)(cid:11)(cid:48)(cid:48)(cid:7)(cid:5)(cid:3)(cid:9)(cid:2)(cid:12)(cid:11)(cid:4)(cid:14)(cid:11)(cid:48)(cid:48)(cid:7)(cid:5)(cid:3)(cid:9)(cid:2)(cid:28)(cid:3,Unknown,11911.0
Unknown,Unknown,3,Unknown,Unknown,Unknown,Unknown,cid:3)(cid:5)(cid:14)(cid:70)(cid:12)(cid:11)(cid:4)(cid:14)(cid:11)(cid:48)(cid:48)(cid:7)(cid:5)(cid:3)(cid:9)(cid:2)(cid:12)(cid:11)(cid:4)(cid:14)(cid:11)(cid:48)(cid:48)(cid:7)(cid:5)(cid:3)(cid:9)(cid:2)(cid:28)(cid:3,Unknown,11914.0
Unknown,Unknown,15,Unknown,Unknown,Unknown,Unknown,cid:3)(cid:5)(cid:14)(cid:70)(cid:12)(cid:11)(cid:4)(cid:14)(cid:11)(cid:48)(cid:48)(cid:7)(cid:5)(cid:3)(cid:9)(cid:2)(cid:12)(cid:11)(cid:4)(cid:14)(cid:11)(cid:48)(cid:48)(cid:7)(cid:5)(cid:3)(cid:9)(cid:2)(cid:28)(cid:3,Unknown,11929.0
Unknown,Unknown,2,Unknown,Unknown,Unknown,Unknown,cid:3)(cid:5)(cid:14)(cid:70)(cid:12)(cid:11)(cid:4)(cid:14)(cid:11)(cid:48)(cid:48)(cid:7)(cid:5)(cid:3)(cid:9)(cid:2)(cid:12)(cid:11)(cid:4)(cid:14)(cid:11)(cid:48)(cid:48)(cid:7)(cid:5)(cid:3)(cid:9)(cid:2)(cid:28)(cid:3,Unknown,11931.0
Unknown,Unknown,36,Unknown,Unknown,Unknown,Unknown,cid:3)(cid:5)(cid:14)(cid:70)(cid:12)(cid:11)(cid:4)(cid:14)(cid:11)(cid:48)(cid:48)(cid:7)(cid:5)(cid:3)(cid:9)(cid:2)(cid:12)(cid:11)(cid:4)(cid:14)(cid:11)(cid:48)(cid:48)(cid:7)(cid:5)(cid:3)(cid:9)(cid:2)(cid:28)(cid:3,Unknown,11967.0
Unknown,Unknown,36,Unknown,Unknown,Unknown,Unknown,cid:3)(cid:5)(cid:14)(cid:70)(cid:12)(cid:11)(cid:4)(cid:14)(cid:11)(cid:48)(cid:48)(cid:7)(cid:5)(cid:3)(cid:9)(cid:2)(cid:12)(cid:11)(cid:4)(cid:14)(cid:11)(cid:48)(cid:48)(cid:7)(cid:5)(cid:3)(cid:9)(cid:2)(cid:28)(cid:3,Unknown,12003.0
Unknown,Unknown,19,Unknown,Unknown,Unknown,Unknown,cid:3)(cid:5)(cid:14)(cid:70)(cid:12)(cid:11)(cid:4)(cid:14)(cid:11)(cid:48)(cid:48)(cid:7)(cid:5)(cid:3)(cid:9)(cid:2)(cid:12)(cid:11)(cid:4)(cid:14)(cid:11)(cid:48)(cid:48)(cid:7)(cid:5)(cid:3)(cid:9)(cid:2)(cid:28)(cid:3,Unknown,12022.0
Unknown,Unknown,33,Unknown,Unknown,Unknown,Unknown,cid:3)(cid:5)(cid:14)(cid:70)(cid:12)(cid:11)(cid:4)(cid:14)(cid:11)(cid:48)(cid:48)(cid:7)(cid:5)(cid:3)(cid:9)(cid:2)(cid:12)(cid:11)(cid:4)(cid:14)(cid:11)(cid:48)(cid:48)(cid:7)(cid:5)(cid:3)(cid:9)(cid:2)(cid:28)(cid:3,Unknown,12055.0
Unknown,Unknown,18,Unknown,Unknown,Unknown,Unknown,cid:3)(cid:5)(cid:14)(cid:70)(cid:12)(cid:11)(cid:4)(cid:14)(cid:11)(cid:48)(cid:48)(cid:7)(cid:5)(cid:3)(cid:9)(cid:2)(cid:12)(cid:11)(cid:4)(cid:14)(cid:11)(cid:48)(cid:48)(cid:7)(cid:5)(cid:3)(cid:9)(cid:2)(cid:28)(cid:3,Unknown,12073.0
Unknown,Unknown,2,Unknown,Unknown,Unknown,Unknown,cid:3)(cid:5)(cid:14)(cid:70)(cid:12)(cid:11)(cid:4)(cid:14)(cid:11)(cid:48)(cid:48)(cid:7)(cid:5)(cid:3)(cid:9)(cid:2)(cid:12)(cid:11)(cid:4)(cid:14)(cid:11)(cid:48)(cid:48)(cid:7)(cid:5)(cid:3)(cid:9)(cid:2)(cid:28)(cid:3,Unknown,12075.0
Unknown,Unknown,44,Unknown,Unknown,Unknown,Unknown,cid:3)(cid:5)(cid:14)(cid:70)(cid:12)(cid:11)(cid:4)(cid:14)(cid:11)(cid:48)(cid:48)(cid:7)(cid:5)(cid:3)(cid:9)(cid:2)(cid:12)(cid:11)(cid:4)(cid:14)(cid:11)(cid:48)(cid:48)(cid:7)(cid:5)(cid:3)(cid:9)(cid:2)(cid:28)(cid:3,Unknown,12119.0
Unknown,Unknown,12,Unknown,Unknown,Unknown,Unknown,cid:3)(cid:5)(cid:14)(cid:70)(cid:12)(cid:11)(cid:4)(cid:14)(cid:11)(cid:48)(cid:48)(cid:7)(cid:5)(cid:3)(cid:9)(cid:2)(cid:12)(cid:11)(cid:4)(cid:14)(cid:11)(cid:48)(cid:48)(cid:7)(cid:5)(cid:3)(cid:9)(cid:2)(cid:28)(cid:3,Unknown,12131.0
Unknown,Unknown,29,Unknown,Unknown,Unknown,Unknown,cid:3)(cid:5)(cid:14)(cid:70)(cid:12)(cid:11)(cid:4)(cid:14)(cid:11)(cid:48)(cid:48)(cid:7)(cid:5)(cid:3)(cid:9)(cid:2)(cid:12)(cid:11)(cid:4)(cid:14)(cid:11)(cid:48)(cid:48)(cid:7)(cid:5)(cid:3)(cid:9)(cid:2)(cid:28)(cid:3,Unknown,12160.0
Unknown,Unknown,26,Unknown,Unknown,Unknown,Unknown,cid:3)(cid:5)(cid:14)(cid:70)(cid:12)(cid:11)(cid:4)(cid:14)(cid:11)(cid:48)(cid:48)(cid:7)(cid:5)(cid:3)(cid:9)(cid:2)(cid:12)(cid:11)(cid:4)(cid:14)(cid:11)(cid:48)(cid:48)(cid:7)(cid:5)(cid:3)(cid:9)(cid:2)(cid:28)(cid:3,Unknown,12186.0
Unknown,Unknown,41,Unknown,Unknown,Unknown,Unknown,cid:3)(cid:5)(cid:14)(cid:70)(cid:12)(cid:11)(cid:4)(cid:14)(cid:11)(cid:48)(cid:48)(cid:7)(cid:5)(cid:3)(cid:9)(cid:2)(cid:12)(cid:11)(cid:4)(cid:14)(cid:11)(cid:48)(cid:48)(cid:7)(cid:5)(cid:3)(cid:9)(cid:2)(cid:28)(cid:3,Unknown,12227.0
Unknown,Unknown,25,Unknown,Unknown,Unknown,Unknown,cid:3)(cid:5)(cid:14)(cid:70)(cid:12)(cid:11)(cid:4)(cid:14)(cid:11)(cid:48)(cid:48)(cid:7)(cid:5)(cid:3)(cid:9)(cid:2)(cid:12)(cid:11)(cid:4)(cid:14)(cid:11)(cid:48)(cid:48)(cid:7)(cid:5)(cid:3)(cid:9)(cid:2)(cid:28)(cid:3,Unknown,12252.0
Unknown,Unknown,2,Unknown,Unknown,Unknown,Unknown,cid:3)(cid:5)(cid:14)(cid:70)(cid:12)(cid:11)(cid:4)(cid:14)(cid:11)(cid:48)(cid:48)(cid:7)(cid:5)(cid:3)(cid:9)(cid:2)(cid:12)(cid:11)(cid:4)(cid:14)(cid:11)(cid:48)(cid:48)(cid:7)(cid:5)(cid:3)(cid:9)(cid:2)(cid:28)(cid:3,Unknown,12254.0
Unknown,Unknown,58,Unknown,Unknown,Unknown,Unknown,cid:3)(cid:5)(cid:14)(cid:70)(cid:12)(cid:11)(cid:4)(cid:14)(cid:11)(cid:48)(cid:48)(cid:7)(cid:5)(cid:3)(cid:9)(cid:2)(cid:12)(cid:11)(cid:4)(cid:14)(cid:11)(cid:48)(cid:48)(cid:7)(cid:5)(cid:3)(cid:9)(cid:2)(cid:28)(cid:3,Unknown,12312.0
Unknown,Unknown,58,Unknown,Unknown,Unknown,Unknown,cid:3)(cid:5)(cid:14)(cid:70)(cid:12)(cid:11)(cid:4)(cid:14)(cid:11)(cid:48)(cid:48)(cid:7)(cid:5)(cid:3)(cid:9)(cid:2)(cid:12)(cid:11)(cid:4)(cid:14)(cid:11)(cid:48)(cid:48)(cid:7)(cid:5)(cid:3)(cid:9)(cid:2)(cid:28)(cid:3,Unknown,12370.0
Unknown,Unknown,37,Unknown,Unknown,Unknown,Unknown,cid:3)(cid:5)(cid:14)(cid:70)(cid:12)(cid:11)(cid:4)(cid:14)(cid:11)(cid:48)(cid:48)(cid:7)(cid:5)(cid:3)(cid:9)(cid:2)(cid:12)(cid:11)(cid:4)(cid:14)(cid:11)(cid:48)(cid:48)(cid:7)(cid:5)(cid:3)(cid:9)(cid:2)(cid:28)(cid:3,Unknown,12407.0
Unknown,Unknown,16,Unknown,Unknown,Unknown,Unknown,cid:3)(cid:5)(cid:14)(cid:70)(cid:12)(cid:11)(cid:4)(cid:14)(cid:11)(cid:48)(cid:48)(cid:7)(cid:5)(cid:3)(cid:9)(cid:2)(cid:12)(cid:11)(cid:4)(cid:14)(cid:11)(cid:48)(cid:48)(cid:7)(cid:5)(cid:3)(cid:9)(cid:2)(cid:28)(cid:3,Unknown,12423.0
Unknown,Unknown,34,Unknown,Unknown,Unknown,Unknown,cid:3)(cid:5)(cid:14)(cid:70)(cid:12)(cid:11)(cid:4)(cid:14)(cid:11)(cid:48)(cid:48)(cid:7)(cid:5)(cid:3)(cid:9)(cid:2)(cid:12)(cid:11)(cid:4)(cid:14)(cid:11)(cid:48)(cid:48)(cid:7)(cid:5)(cid:3)(cid:9)(cid:2)(cid:28)(cid:3,Unknown,12457.0
Unknown,Unknown,33,Unknown,Unknown,Unknown,Unknown,cid:3)(cid:5)(cid:14)(cid:70)(cid:12)(cid:11)(cid:4)(cid:14)(cid:11)(cid:48)(cid:48)(cid:7)(cid:5)(cid:3)(cid:9)(cid:2)(cid:12)(cid:11)(cid:4)(cid:14)(cid:11)(cid:48)(cid:48)(cid:7)(cid:5)(cid:3)(cid:9)(cid:2)(cid:28)(cid:3,Unknown,12490.0
Unknown,Unknown,17,Unknown,Unknown,Unknown,Unknown,cid:3)(cid:5)(cid:14)(cid:70)(cid:12)(cid:11)(cid:4)(cid:14)(cid:11)(cid:48)(cid:48)(cid:7)(cid:5)(cid:3)(cid:9)(cid:2)(cid:12)(cid:11)(cid:4)(cid:14)(cid:11)(cid:48)(cid:48)(cid:7)(cid:5)(cid:3)(cid:9)(cid:2)(cid:28)(cid:3,Unknown,12507.0
Unknown,Unknown,34,Unknown,Unknown,Unknown,Unknown,cid:3)(cid:5)(cid:14)(cid:70)(cid:12)(cid:11)(cid:4)(cid:14)(cid:11)(cid:48)(cid:48)(cid:7)(cid:5)(cid:3)(cid:9)(cid:2)(cid:12)(cid:11)(cid:4)(cid:14)(cid:11)(cid:48)(cid:48)(cid:7)(cid:5)(cid:3)(cid:9)(cid:2)(cid:28)(cid:3,Unknown,12541.0
Unknown,Unknown,45,Unknown,Unknown,Unknown,Unknown,cid:3)(cid:5)(cid:14)(cid:70)(cid:12)(cid:11)(cid:4)(cid:14)(cid:11)(cid:48)(cid:48)(cid:7)(cid:5)(cid:3)(cid:9)(cid:2)(cid:12)(cid:11)(cid:4)(cid:14)(cid:11)(cid:48)(cid:48)(cid:7)(cid:5)(cid:3)(cid:9)(cid:2)(cid:28)(cid:3,Unknown,12586.0
Unknown,Unknown,18,Unknown,Unknown,Unknown,Unknown,cid:3)(cid:5)(cid:14)(cid:70)(cid:12)(cid:11)(cid:4)(cid:14)(cid:11)(cid:48)(cid:48)(cid:7)(cid:5)(cid:3)(cid:9)(cid:2)(cid:12)(cid:11)(cid:4)(cid:14)(cid:11)(cid:48)(cid:48)(cid:7)(cid:5)(cid:3)(cid:9)(cid:2)(cid:28)(cid:3,Unknown,12604.0
Unknown,Unknown,16,Unknown,Unknown,Unknown,Unknown,cid:3)(cid:5)(cid:14)(cid:70)(cid:12)(cid:11)(cid:4)(cid:14)(cid:11)(cid:48)(cid:48)(cid:7)(cid:5)(cid:3)(cid:9)(cid:2)(cid:12)(cid:11)(cid:4)(cid:14)(cid:11)(cid:48)(cid:48)(cid:7)(cid:5)(cid:3)(cid:9)(cid:2)(cid:28)(cid:3,Unknown,12620.0
Unknown,Unknown,12,Unknown,Unknown,Unknown,Unknown,cid:3)(cid:5)(cid:14)(cid:70)(cid:12)(cid:11)(cid:4)(cid:14)(cid:11)(cid:48)(cid:48)(cid:7)(cid:5)(cid:3)(cid:9)(cid:2)(cid:12)(cid:11)(cid:4)(cid:14)(cid:11)(cid:48)(cid:48)(cid:7)(cid:5)(cid:3)(cid:9)(cid:2)(cid:28)(cid:3,Unknown,12632.0
Unknown,Unknown,11,Unknown,Unknown,Unknown,Unknown,cid:3)(cid:5)(cid:14)(cid:70)(cid:12)(cid:11)(cid:4)(cid:14)(cid:11)(cid:48)(cid:48)(cid:7)(cid:5)(cid:3)(cid:9)(cid:2)(cid:12)(cid:11)(cid:4)(cid:14)(cid:11)(cid:48)(cid:48)(cid:7)(cid:5)(cid:3)(cid:9)(cid:2)(cid:28)(cid:3,Unknown,12643.0
Unknown,Unknown,8,Unknown,Unknown,Unknown,Unknown,cid:3)(cid:5)(cid:14)(cid:70)(cid:12)(cid:11)(cid:4)(cid:14)(cid:11)(cid:48)(cid:48)(cid:7)(cid:5)(cid:3)(cid:9)(cid:2)(cid:12)(cid:11)(cid:4)(cid:14)(cid:11)(cid:48)(cid:48)(cid:7)(cid:5)(cid:3)(cid:9)(cid:2)(cid:28)(cid:3,Unknown,12651.0
Unknown,Unknown,10,Unknown,Unknown,Unknown,Unknown,cid:3)(cid:5)(cid:14)(cid:70)(cid:12)(cid:11)(cid:4)(cid:14)(cid:11)(cid:48)(cid:48)(cid:7)(cid:5)(cid:3)(cid:9)(cid:2)(cid:12)(cid:11)(cid:4)(cid:14)(cid:11)(cid:48)(cid:48)(cid:7)(cid:5)(cid:3)(cid:9)(cid:2)(cid:28)(cid:3,Unknown,12661.0
Unknown,Unknown,3,Unknown,Unknown,Unknown,Unknown,cid:3)(cid:5)(cid:14)(cid:70)(cid:12)(cid:11)(cid:4)(cid:14)(cid:11)(cid:48)(cid:48)(cid:7)(cid:5)(cid:3)(cid:9)(cid:2)(cid:12)(cid:11)(cid:4)(cid:14)(cid:11)(cid:48)(cid:48)(cid:7)(cid:5)(cid:3)(cid:9)(cid:2)(cid:28)(cid:3,Unknown,12664.0
Unknown,Unknown,11,Unknown,Unknown,Unknown,Unknown,cid:3)(cid:5)(cid:14)(cid:70)(cid:12)(cid:11)(cid:4)(cid:14)(cid:11)(cid:48)(cid:48)(cid:7)(cid:5)(cid:3)(cid:9)(cid:2)(cid:12)(cid:11)(cid:4)(cid:14)(cid:11)(cid:48)(cid:48)(cid:7)(cid:5)(cid:3)(cid:9)(cid:2)(cid:28)(cid:3,Unknown,12675.0
Unknown,Unknown,14,Unknown,Unknown,Unknown,Unknown,cid:3)(cid:5)(cid:14)(cid:70)(cid:12)(cid:11)(cid:4)(cid:14)(cid:11)(cid:48)(cid:48)(cid:7)(cid:5)(cid:3)(cid:9)(cid:2)(cid:12)(cid:11)(cid:4)(cid:14)(cid:11)(cid:48)(cid:48)(cid:7)(cid:5)(cid:3)(cid:9)(cid:2)(cid:28)(cid:3,Unknown,12689.0
Unknown,Unknown,5,Unknown,Unknown,Unknown,Unknown,cid:3)(cid:5)(cid:14)(cid:70)(cid:12)(cid:11)(cid:4)(cid:14)(cid:11)(cid:48)(cid:48)(cid:7)(cid:5)(cid:3)(cid:9)(cid:2)(cid:12)(cid:11)(cid:4)(cid:14)(cid:11)(cid:48)(cid:48)(cid:7)(cid:5)(cid:3)(cid:9)(cid:2)(cid:28)(cid:3,Unknown,12694.0
Unknown,Unknown,2,Unknown,Unknown,Unknown,Unknown,cid:3)(cid:5)(cid:14)(cid:70)(cid:12)(cid:11)(cid:4)(cid:14)(cid:11)(cid:48)(cid:48)(cid:7)(cid:5)(cid:3)(cid:9)(cid:2)(cid:12)(cid:11)(cid:4)(cid:14)(cid:11)(cid:48)(cid:48)(cid:7)(cid:5)(cid:3)(cid:9)(cid:2)(cid:28)(cid:3,Unknown,12696.0
Unknown,Unknown,10,Unknown,Unknown,Unknown,Unknown,cid:3)(cid:5)(cid:14)(cid:70)(cid:12)(cid:11)(cid:4)(cid:14)(cid:11)(cid:48)(cid:48)(cid:7)(cid:5)(cid:3)(cid:9)(cid:2)(cid:12)(cid:11)(cid:4)(cid:14)(cid:11)(cid:48)(cid:48)(cid:7)(cid:5)(cid:3)(cid:9)(cid:2)(cid:28)(cid:3,Unknown,12706.0
Unknown,Unknown,5,Unknown,Unknown,Unknown,Unknown,cid:3)(cid:5)(cid:14)(cid:70)(cid:12)(cid:11)(cid:4)(cid:14)(cid:11)(cid:48)(cid:48)(cid:7)(cid:5)(cid:3)(cid:9)(cid:2)(cid:12)(cid:11)(cid:4)(cid:14)(cid:11)(cid:48)(cid:48)(cid:7)(cid:5)(cid:3)(cid:9)(cid:2)(cid:28)(cid:3,Unknown,12711.0
Unknown,Unknown,12,Unknown,Unknown,Unknown,Unknown,cid:3)(cid:5)(cid:14)(cid:70)(cid:12)(cid:11)(cid:4)(cid:14)(cid:11)(cid:48)(cid:48)(cid:7)(cid:5)(cid:3)(cid:9)(cid:2)(cid:12)(cid:11)(cid:4)(cid:14)(cid:11)(cid:48)(cid:48)(cid:7)(cid:5)(cid:3)(cid:9)(cid:2)(cid:28)(cid:3,Unknown,12723.0
Unknown,Unknown,13,Unknown,Unknown,Unknown,Unknown,cid:3)(cid:5)(cid:14)(cid:70)(cid:12)(cid:11)(cid:4)(cid:14)(cid:11)(cid:48)(cid:48)(cid:7)(cid:5)(cid:3)(cid:9)(cid:2)(cid:12)(cid:11)(cid:4)(cid:14)(cid:11)(cid:48)(cid:48)(cid:7)(cid:5)(cid:3)(cid:9)(cid:2)(cid:28)(cid:3,Unknown,12736.0
Unknown,Unknown,2,Unknown,Unknown,Unknown,Unknown,cid:3)(cid:5)(cid:14)(cid:70)(cid:12)(cid:11)(cid:4)(cid:14)(cid:11)(cid:48)(cid:48)(cid:7)(cid:5)(cid:3)(cid:9)(cid:2)(cid:12)(cid:11)(cid:4)(cid:14)(cid:11)(cid:48)(cid:48)(cid:7)(cid:5)(cid:3)(cid:9)(cid:2)(cid:28)(cid:3,Unknown,12738.0
Unknown,Unknown,48,Unknown,Unknown,Unknown,Unknown,cid:3)(cid:5)(cid:14)(cid:70)(cid:12)(cid:11)(cid:4)(cid:14)(cid:11)(cid:48)(cid:48)(cid:7)(cid:5)(cid:3)(cid:9)(cid:2)(cid:12)(cid:11)(cid:4)(cid:14)(cid:11)(cid:48)(cid:48)(cid:7)(cid:5)(cid:3)(cid:9)(cid:2)(cid:28)(cid:3,Unknown,12786.0
Unknown,Unknown,11,Unknown,Unknown,Unknown,Unknown,cid:3)(cid:5)(cid:14)(cid:70)(cid:12)(cid:11)(cid:4)(cid:14)(cid:11)(cid:48)(cid:48)(cid:7)(cid:5)(cid:3)(cid:9)(cid:2)(cid:12)(cid:11)(cid:4)(cid:14)(cid:11)(cid:48)(cid:48)(cid:7)(cid:5)(cid:3)(cid:9)(cid:2)(cid:28)(cid:3,Unknown,12797.0
Unknown,Unknown,4,Unknown,Unknown,Unknown,Unknown,cid:3)(cid:5)(cid:14)(cid:70)(cid:12)(cid:11)(cid:4)(cid:14)(cid:11)(cid:48)(cid:48)(cid:7)(cid:5)(cid:3)(cid:9)(cid:2)(cid:12)(cid:11)(cid:4)(cid:14)(cid:11)(cid:48)(cid:48)(cid:7)(cid:5)(cid:3)(cid:9)(cid:2)(cid:28)(cid:3,Unknown,12801.0
Unknown,Unknown,3,Unknown,Unknown,Unknown,Unknown,cid:3)(cid:5)(cid:14)(cid:70)(cid:12)(cid:11)(cid:4)(cid:14)(cid:11)(cid:48)(cid:48)(cid:7)(cid:5)(cid:3)(cid:9)(cid:2)(cid:12)(cid:11)(cid:4)(cid:14)(cid:11)(cid:48)(cid:48)(cid:7)(cid:5)(cid:3)(cid:9)(cid:2)(cid:28)(cid:3,Unknown,12804.0
Unknown,Unknown,11,Unknown,Unknown,Unknown,Unknown,cid:3)(cid:5)(cid:14)(cid:70)(cid:12)(cid:11)(cid:4)(cid:14)(cid:11)(cid:48)(cid:48)(cid:7)(cid:5)(cid:3)(cid:9)(cid:2)(cid:12)(cid:11)(cid:4)(cid:14)(cid:11)(cid:48)(cid:48)(cid:7)(cid:5)(cid:3)(cid:9)(cid:2)(cid:28)(cid:3,Unknown,12815.0
Unknown,Unknown,4,Unknown,Unknown,Unknown,Unknown,cid:3)(cid:5)(cid:14)(cid:70)(cid:12)(cid:11)(cid:4)(cid:14)(cid:11)(cid:48)(cid:48)(cid:7)(cid:5)(cid:3)(cid:9)(cid:2)(cid:12)(cid:11)(cid:4)(cid:14)(cid:11)(cid:48)(cid:48)(cid:7)(cid:5)(cid:3)(cid:9)(cid:2)(cid:28)(cid:3,Unknown,12819.0
Unknown,Unknown,40,Unknown,Unknown,Unknown,Unknown,cid:3)(cid:5)(cid:14)(cid:70)(cid:12)(cid:11)(cid:4)(cid:14)(cid:11)(cid:48)(cid:48)(cid:7)(cid:5)(cid:3)(cid:9)(cid:2)(cid:12)(cid:11)(cid:4)(cid:14)(cid:11)(cid:48)(cid:48)(cid:7)(cid:5)(cid:3)(cid:9)(cid:2)(cid:28)(cid:3,Unknown,12859.0
Unknown,Unknown,2,Unknown,Unknown,Unknown,Unknown,cid:3)(cid:5)(cid:14)(cid:70)(cid:12)(cid:11)(cid:4)(cid:14)(cid:11)(cid:48)(cid:48)(cid:7)(cid:5)(cid:3)(cid:9)(cid:2)(cid:12)(cid:11)(cid:4)(cid:14)(cid:11)(cid:48)(cid:48)(cid:7)(cid:5)(cid:3)(cid:9)(cid:2)(cid:28)(cid:3,Unknown,12861.0
Unknown,Unknown,28,Unknown,Unknown,Unknown,Unknown,cid:3)(cid:5)(cid:14)(cid:70)(cid:12)(cid:11)(cid:4)(cid:14)(cid:11)(cid:48)(cid:48)(cid:7)(cid:5)(cid:3)(cid:9)(cid:2)(cid:12)(cid:11)(cid:4)(cid:14)(cid:11)(cid:48)(cid:48)(cid:7)(cid:5)(cid:3)(cid:9)(cid:2)(cid:28)(cid:3,Unknown,12889.0
Unknown,Unknown,3,Unknown,Unknown,Unknown,Unknown,cid:3)(cid:5)(cid:14)(cid:70)(cid:12)(cid:11)(cid:4)(cid:14)(cid:11)(cid:48)(cid:48)(cid:7)(cid:5)(cid:3)(cid:9)(cid:2)(cid:12)(cid:11)(cid:4)(cid:14)(cid:11)(cid:48)(cid:48)(cid:7)(cid:5)(cid:3)(cid:9)(cid:2)(cid:28)(cid:3,Unknown,12892.0
Unknown,Unknown,15,Unknown,Unknown,Unknown,Unknown,cid:3)(cid:5)(cid:14)(cid:70)(cid:12)(cid:11)(cid:4)(cid:14)(cid:11)(cid:48)(cid:48)(cid:7)(cid:5)(cid:3)(cid:9)(cid:2)(cid:12)(cid:11)(cid:4)(cid:14)(cid:11)(cid:48)(cid:48)(cid:7)(cid:5)(cid:3)(cid:9)(cid:2)(cid:28)(cid:3,Unknown,12907.0
Unknown,Unknown,2,Unknown,Unknown,Unknown,Unknown,cid:3)(cid:5)(cid:14)(cid:70)(cid:12)(cid:11)(cid:4)(cid:14)(cid:11)(cid:48)(cid:48)(cid:7)(cid:5)(cid:3)(cid:9)(cid:2)(cid:12)(cid:11)(cid:4)(cid:14)(cid:11)(cid:48)(cid:48)(cid:7)(cid:5)(cid:3)(cid:9)(cid:2)(cid:28)(cid:3,Unknown,12909.0
Unknown,Unknown,35,Unknown,Unknown,Unknown,Unknown,cid:3)(cid:5)(cid:14)(cid:70)(cid:12)(cid:11)(cid:4)(cid:14)(cid:11)(cid:48)(cid:48)(cid:7)(cid:5)(cid:3)(cid:9)(cid:2)(cid:12)(cid:11)(cid:4)(cid:14)(cid:11)(cid:48)(cid:48)(cid:7)(cid:5)(cid:3)(cid:9)(cid:2)(cid:28)(cid:3,Unknown,12944.0
Unknown,Unknown,18,Unknown,Unknown,Unknown,Unknown,cid:3)(cid:5)(cid:14)(cid:70)(cid:12)(cid:11)(cid:4)(cid:14)(cid:11)(cid:48)(cid:48)(cid:7)(cid:5)(cid:3)(cid:9)(cid:2)(cid:12)(cid:11)(cid:4)(cid:14)(cid:11)(cid:48)(cid:48)(cid:7)(cid:5)(cid:3)(cid:9)(cid:2)(cid:28)(cid:3,Unknown,12962.0
Unknown,Unknown,19,Unknown,Unknown,Unknown,Unknown,cid:3)(cid:5)(cid:14)(cid:70)(cid:12)(cid:11)(cid:4)(cid:14)(cid:11)(cid:48)(cid:48)(cid:7)(cid:5)(cid:3)(cid:9)(cid:2)(cid:12)(cid:11)(cid:4)(cid:14)(cid:11)(cid:48)(cid:48)(cid:7)(cid:5)(cid:3)(cid:9)(cid:2)(cid:28)(cid:3,Unknown,12981.0
Unknown,Unknown,18,Unknown,Unknown,Unknown,Unknown,cid:3)(cid:5)(cid:14)(cid:70)(cid:12)(cid:11)(cid:4)(cid:14)(cid:11)(cid:48)(cid:48)(cid:7)(cid:5)(cid:3)(cid:9)(cid:2)(cid:12)(cid:11)(cid:4)(cid:14)(cid:11)(cid:48)(cid:48)(cid:7)(cid:5)(cid:3)(cid:9)(cid:2)(cid:28)(cid:3,Unknown,12999.0
Unknown,Unknown,18,Unknown,Unknown,Unknown,Unknown,cid:3)(cid:5)(cid:14)(cid:70)(cid:12)(cid:11)(cid:4)(cid:14)(cid:11)(cid:48)(cid:48)(cid:7)(cid:5)(cid:3)(cid:9)(cid:2)(cid:12)(cid:11)(cid:4)(cid:14)(cid:11)(cid:48)(cid:48)(cid:7)(cid:5)(cid:3)(cid:9)(cid:2)(cid:28)(cid:3,Unknown,13017.0
Unknown,Unknown,2,Unknown,Unknown,Unknown,Unknown,cid:3)(cid:5)(cid:14)(cid:70)(cid:12)(cid:11)(cid:4)(cid:14)(cid:11)(cid:48)(cid:48)(cid:7)(cid:5)(cid:3)(cid:9)(cid:2)(cid:12)(cid:11)(cid:4)(cid:14)(cid:11)(cid:48)(cid:48)(cid:7)(cid:5)(cid:3)(cid:9)(cid:2)(cid:28)(cid:3,Unknown,13019.0
Unknown,Unknown,44,Unknown,Unknown,Unknown,Unknown,cid:3)(cid:5)(cid:14)(cid:70)(cid:12)(cid:11)(cid:4)(cid:14)(cid:11)(cid:48)(cid:48)(cid:7)(cid:5)(cid:3)(cid:9)(cid:2)(cid:12)(cid:11)(cid:4)(cid:14)(cid:11)(cid:48)(cid:48)(cid:7)(cid:5)(cid:3)(cid:9)(cid:2)(cid:28)(cid:3,Unknown,13063.0
Unknown,Unknown,12,Unknown,Unknown,Unknown,Unknown,cid:3)(cid:5)(cid:14)(cid:70)(cid:12)(cid:11)(cid:4)(cid:14)(cid:11)(cid:48)(cid:48)(cid:7)(cid:5)(cid:3)(cid:9)(cid:2)(cid:12)(cid:11)(cid:4)(cid:14)(cid:11)(cid:48)(cid:48)(cid:7)(cid:5)(cid:3)(cid:9)(cid:2)(cid:28)(cid:3,Unknown,13075.0
Unknown,Unknown,29,Unknown,Unknown,Unknown,Unknown,cid:3)(cid:5)(cid:14)(cid:70)(cid:12)(cid:11)(cid:4)(cid:14)(cid:11)(cid:48)(cid:48)(cid:7)(cid:5)(cid:3)(cid:9)(cid:2)(cid:12)(cid:11)(cid:4)(cid:14)(cid:11)(cid:48)(cid:48)(cid:7)(cid:5)(cid:3)(cid:9)(cid:2)(cid:28)(cid:3,Unknown,13104.0
Unknown,Unknown,26,Unknown,Unknown,Unknown,Unknown,cid:3)(cid:5)(cid:14)(cid:70)(cid:12)(cid:11)(cid:4)(cid:14)(cid:11)(cid:48)(cid:48)(cid:7)(cid:5)(cid:3)(cid:9)(cid:2)(cid:12)(cid:11)(cid:4)(cid:14)(cid:11)(cid:48)(cid:48)(cid:7)(cid:5)(cid:3)(cid:9)(cid:2)(cid:28)(cid:3,Unknown,13130.0
Unknown,Unknown,41,Unknown,Unknown,Unknown,Unknown,cid:3)(cid:5)(cid:14)(cid:70)(cid:12)(cid:11)(cid:4)(cid:14)(cid:11)(cid:48)(cid:48)(cid:7)(cid:5)(cid:3)(cid:9)(cid:2)(cid:12)(cid:11)(cid:4)(cid:14)(cid:11)(cid:48)(cid:48)(cid:7)(cid:5)(cid:3)(cid:9)(cid:2)(cid:28)(cid:3,Unknown,13171.0
Unknown,Unknown,25,Unknown,Unknown,Unknown,Unknown,cid:3)(cid:5)(cid:14)(cid:70)(cid:12)(cid:11)(cid:4)(cid:14)(cid:11)(cid:48)(cid:48)(cid:7)(cid:5)(cid:3)(cid:9)(cid:2)(cid:12)(cid:11)(cid:4)(cid:14)(cid:11)(cid:48)(cid:48)(cid:7)(cid:5)(cid:3)(cid:9)(cid:2)(cid:28)(cid:3,Unknown,13196.0
Unknown,Unknown,2,Unknown,Unknown,Unknown,Unknown,cid:3)(cid:5)(cid:14)(cid:70)(cid:12)(cid:11)(cid:4)(cid:14)(cid:11)(cid:48)(cid:48)(cid:7)(cid:5)(cid:3)(cid:9)(cid:2)(cid:12)(cid:11)(cid:4)(cid:14)(cid:11)(cid:48)(cid:48)(cid:7)(cid:5)(cid:3)(cid:9)(cid:2)(cid:28)(cid:3,Unknown,13198.0
Unknown,Unknown,58,Unknown,Unknown,Unknown,Unknown,cid:3)(cid:5)(cid:14)(cid:70)(cid:12)(cid:11)(cid:4)(cid:14)(cid:11)(cid:48)(cid:48)(cid:7)(cid:5)(cid:3)(cid:9)(cid:2)(cid:12)(cid:11)(cid:4)(cid:14)(cid:11)(cid:48)(cid:48)(cid:7)(cid:5)(cid:3)(cid:9)(cid:2)(cid:28)(cid:3,Unknown,13256.0
Unknown,Unknown,58,Unknown,Unknown,Unknown,Unknown,cid:3)(cid:5)(cid:14)(cid:70)(cid:12)(cid:11)(cid:4)(cid:14)(cid:11)(cid:48)(cid:48)(cid:7)(cid:5)(cid:3)(cid:9)(cid:2)(cid:12)(cid:11)(cid:4)(cid:14)(cid:11)(cid:48)(cid:48)(cid:7)(cid:5)(cid:3)(cid:9)(cid:2)(cid:28)(cid:3,Unknown,13314.0
Unknown,Unknown,18,Unknown,Unknown,Unknown,Unknown,cid:3)(cid:5)(cid:14)(cid:70)(cid:12)(cid:11)(cid:4)(cid:14)(cid:11)(cid:48)(cid:48)(cid:7)(cid:5)(cid:3)(cid:9)(cid:2)(cid:12)(cid:11)(cid:4)(cid:14)(cid:11)(cid:48)(cid:48)(cid:7)(cid:5)(cid:3)(cid:9)(cid:2)(cid:28)(cid:3,Unknown,13332.0
Unknown,Unknown,1,Unknown,Unknown,Unknown,Unknown,cid:3)(cid:5)(cid:14)(cid:70)(cid:12)(cid:11)(cid:4)(cid:14)(cid:11)(cid:48)(cid:48)(cid:7)(cid:5)(cid:3)(cid:9)(cid:2)(cid:12)(cid:11)(cid:4)(cid:14)(cid:11)(cid:48)(cid:48)(cid:7)(cid:5)(cid:3)(cid:9)(cid:2)(cid:28)(cid:3,Unknown,13333.0
Unknown,Unknown,1,Unknown,Unknown,Unknown,Unknown,cid:3)(cid:5)(cid:14)(cid:70)(cid:12)(cid:11)(cid:4)(cid:14)(cid:11)(cid:48)(cid:48)(cid:7)(cid:5)(cid:3)(cid:9)(cid:2)(cid:12)(cid:11)(cid:4)(cid:14)(cid:11)(cid:48)(cid:48)(cid:7)(cid:5)(cid:3)(cid:9)(cid:2)(cid:28)(cid:3,Unknown,13334.0
Unknown,Unknown,37,Unknown,Unknown,Unknown,Unknown,cid:3)(cid:5)(cid:14)(cid:70)(cid:12)(cid:11)(cid:4)(cid:14)(cid:11)(cid:48)(cid:48)(cid:7)(cid:5)(cid:3)(cid:9)(cid:2)(cid:12)(cid:11)(cid:4)(cid:14)(cid:11)(cid:48)(cid:48)(cid:7)(cid:5)(cid:3)(cid:9)(cid:2)(cid:28)(cid:3,Unknown,13371.0
Unknown,Unknown,17,Unknown,Unknown,Unknown,Unknown,cid:3)(cid:5)(cid:14)(cid:70)(cid:12)(cid:11)(cid:4)(cid:14)(cid:11)(cid:48)(cid:48)(cid:7)(cid:5)(cid:3)(cid:9)(cid:2)(cid:12)(cid:11)(cid:4)(cid:14)(cid:11)(cid:48)(cid:48)(cid:7)(cid:5)(cid:3)(cid:9)(cid:2)(cid:28)(cid:3,Unknown,13388.0
Unknown,Unknown,34,Unknown,Unknown,Unknown,Unknown,cid:3)(cid:5)(cid:14)(cid:70)(cid:12)(cid:11)(cid:4)(cid:14)(cid:11)(cid:48)(cid:48)(cid:7)(cid:5)(cid:3)(cid:9)(cid:2)(cid:12)(cid:11)(cid:4)(cid:14)(cid:11)(cid:48)(cid:48)(cid:7)(cid:5)(cid:3)(cid:9)(cid:2)(cid:28)(cid:3,Unknown,13422.0
Unknown,Unknown,45,Unknown,Unknown,Unknown,Unknown,cid:3)(cid:5)(cid:14)(cid:70)(cid:12)(cid:11)(cid:4)(cid:14)(cid:11)(cid:48)(cid:48)(cid:7)(cid:5)(cid:3)(cid:9)(cid:2)(cid:12)(cid:11)(cid:4)(cid:14)(cid:11)(cid:48)(cid:48)(cid:7)(cid:5)(cid:3)(cid:9)(cid:2)(cid:28)(cid:3,Unknown,13467.0
Unknown,Unknown,18,Unknown,Unknown,Unknown,Unknown,cid:3)(cid:5)(cid:14)(cid:70)(cid:12)(cid:11)(cid:4)(cid:14)(cid:11)(cid:48)(cid:48)(cid:7)(cid:5)(cid:3)(cid:9)(cid:2)(cid:12)(cid:11)(cid:4)(cid:14)(cid:11)(cid:48)(cid:48)(cid:7)(cid:5)(cid:3)(cid:9)(cid:2)(cid:28)(cid:3,Unknown,13485.0
Unknown,Unknown,16,Unknown,Unknown,Unknown,Unknown,cid:3)(cid:5)(cid:14)(cid:70)(cid:12)(cid:11)(cid:4)(cid:14)(cid:11)(cid:48)(cid:48)(cid:7)(cid:5)(cid:3)(cid:9)(cid:2)(cid:12)(cid:11)(cid:4)(cid:14)(cid:11)(cid:48)(cid:48)(cid:7)(cid:5)(cid:3)(cid:9)(cid:2)(cid:28)(cid:3,Unknown,13501.0
Unknown,Unknown,48,Unknown,Unknown,Unknown,Unknown,cid:3)(cid:5)(cid:14)(cid:70)(cid:12)(cid:11)(cid:4)(cid:14)(cid:11)(cid:48)(cid:48)(cid:7)(cid:5)(cid:3)(cid:9)(cid:2)(cid:12)(cid:11)(cid:4)(cid:14)(cid:11)(cid:48)(cid:48)(cid:7)(cid:5)(cid:3)(cid:9)(cid:2)(cid:28)(cid:3,Unknown,13549.0
Unknown,Unknown,12,Unknown,Unknown,Unknown,Unknown,cid:3)(cid:5)(cid:14)(cid:70)(cid:12)(cid:11)(cid:4)(cid:14)(cid:11)(cid:48)(cid:48)(cid:7)(cid:5)(cid:3)(cid:9)(cid:2)(cid:12)(cid:11)(cid:4)(cid:14)(cid:11)(cid:48)(cid:48)(cid:7)(cid:5)(cid:3)(cid:9)(cid:2)(cid:28)(cid:3,Unknown,13561.0
Unknown,Unknown,50,Unknown,Unknown,Unknown,Unknown,cid:3)(cid:5)(cid:14)(cid:70)(cid:12)(cid:11)(cid:4)(cid:14)(cid:11)(cid:48)(cid:48)(cid:7)(cid:5)(cid:3)(cid:9)(cid:2)(cid:12)(cid:11)(cid:4)(cid:14)(cid:11)(cid:48)(cid:48)(cid:7)(cid:5)(cid:3)(cid:9)(cid:2)(cid:28)(cid:3,Unknown,13611.0
Unknown,Unknown,11,Unknown,Unknown,Unknown,Unknown,cid:3)(cid:5)(cid:14)(cid:70)(cid:12)(cid:11)(cid:4)(cid:14)(cid:11)(cid:48)(cid:48)(cid:7)(cid:5)(cid:3)(cid:9)(cid:2)(cid:12)(cid:11)(cid:4)(cid:14)(cid:11)(cid:48)(cid:48)(cid:7)(cid:5)(cid:3)(cid:9)(cid:2)(cid:28)(cid:3,Unknown,13622.0
Unknown,Unknown,8,Unknown,Unknown,Unknown,Unknown,cid:3)(cid:5)(cid:14)(cid:70)(cid:12)(cid:11)(cid:4)(cid:14)(cid:11)(cid:48)(cid:48)(cid:7)(cid:5)(cid:3)(cid:9)(cid:2)(cid:12)(cid:11)(cid:4)(cid:14)(cid:11)(cid:48)(cid:48)(cid:7)(cid:5)(cid:3)(cid:9)(cid:2)(cid:28)(cid:3,Unknown,13630.0
Unknown,Unknown,46,Unknown,Unknown,Unknown,Unknown,cid:3)(cid:5)(cid:14)(cid:70)(cid:12)(cid:11)(cid:4)(cid:14)(cid:11)(cid:48)(cid:48)(cid:7)(cid:5)(cid:3)(cid:9)(cid:2)(cid:12)(cid:11)(cid:4)(cid:14)(cid:11)(cid:48)(cid:48)(cid:7)(cid:5)(cid:3)(cid:9)(cid:2)(cid:28)(cid:3,Unknown,13676.0
Unknown,Unknown,14,Unknown,Unknown,Unknown,Unknown,cid:3)(cid:5)(cid:14)(cid:70)(cid:12)(cid:11)(cid:4)(cid:14)(cid:11)(cid:48)(cid:48)(cid:7)(cid:5)(cid:3)(cid:9)(cid:2)(cid:12)(cid:11)(cid:4)(cid:14)(cid:11)(cid:48)(cid:48)(cid:7)(cid:5)(cid:3)(cid:9)(cid:2)(cid:28)(cid:3,Unknown,13690.0
Unknown,Unknown,50,Unknown,Unknown,Unknown,Unknown,cid:3)(cid:5)(cid:14)(cid:70)(cid:12)(cid:11)(cid:4)(cid:14)(cid:11)(cid:48)(cid:48)(cid:7)(cid:5)(cid:3)(cid:9)(cid:2)(cid:12)(cid:11)(cid:4)(cid:14)(cid:11)(cid:48)(cid:48)(cid:7)(cid:5)(cid:3)(cid:9)(cid:2)(cid:28)(cid:3,Unknown,13740.0
Unknown,Unknown,9,Unknown,Unknown,Unknown,Unknown,cid:3)(cid:5)(cid:14)(cid:70)(cid:12)(cid:11)(cid:4)(cid:14)(cid:11)(cid:48)(cid:48)(cid:7)(cid:5)(cid:3)(cid:9)(cid:2)(cid:12)(cid:11)(cid:4)(cid:14)(cid:11)(cid:48)(cid:48)(cid:7)(cid:5)(cid:3)(cid:9)(cid:2)(cid:28)(cid:3,Unknown,13749.0
Unknown,Unknown,17,Unknown,Unknown,Unknown,Unknown,cid:3)(cid:5)(cid:14)(cid:70)(cid:12)(cid:11)(cid:4)(cid:14)(cid:11)(cid:48)(cid:48)(cid:7)(cid:5)(cid:3)(cid:9)(cid:2)(cid:12)(cid:11)(cid:4)(cid:14)(cid:11)(cid:48)(cid:48)(cid:7)(cid:5)(cid:3)(cid:9)(cid:2)(cid:28)(cid:3,Unknown,13766.0
Unknown,Unknown,36,Unknown,Unknown,Unknown,Unknown,cid:3)(cid:5)(cid:14)(cid:70)(cid:12)(cid:11)(cid:4)(cid:14)(cid:11)(cid:48)(cid:48)(cid:7)(cid:5)(cid:3)(cid:9)(cid:2)(cid:12)(cid:11)(cid:4)(cid:14)(cid:11)(cid:48)(cid:48)(cid:7)(cid:5)(cid:3)(cid:9)(cid:2)(cid:28)(cid:3,Unknown,13802.0
Unknown,Unknown,18,Unknown,Unknown,Unknown,Unknown,cid:3)(cid:5)(cid:14)(cid:70)(cid:12)(cid:11)(cid:4)(cid:14)(cid:11)(cid:48)(cid:48)(cid:7)(cid:5)(cid:3)(cid:9)(cid:2)(cid:12)(cid:11)(cid:4)(cid:14)(cid:11)(cid:48)(cid:48)(cid:7)(cid:5)(cid:3)(cid:9)(cid:2)(cid:28)(cid:3,Unknown,13820.0
Unknown,Unknown,1,Unknown,Unknown,Unknown,Unknown,cid:3)(cid:5)(cid:14)(cid:70)(cid:12)(cid:11)(cid:4)(cid:14)(cid:11)(cid:48)(cid:48)(cid:7)(cid:5)(cid:3)(cid:9)(cid:2)(cid:12)(cid:11)(cid:4)(cid:14)(cid:11)(cid:48)(cid:48)(cid:7)(cid:5)(cid:3)(cid:9)(cid:2)(cid:28)(cid:3,Unknown,13821.0
Unknown,Unknown,2,Unknown,Unknown,Unknown,Unknown,cid:3)(cid:5)(cid:14)(cid:70)(cid:12)(cid:11)(cid:4)(cid:14)(cid:11)(cid:48)(cid:48)(cid:7)(cid:5)(cid:3)(cid:9)(cid:2)(cid:12)(cid:11)(cid:4)(cid:14)(cid:11)(cid:48)(cid:48)(cid:7)(cid:5)(cid:3)(cid:9)(cid:2)(cid:28)(cid:3,Unknown,13823.0
Unknown,Unknown,12,Unknown,Unknown,Unknown,Unknown,cid:3)(cid:5)(cid:14)(cid:70)(cid:12)(cid:11)(cid:4)(cid:14)(cid:11)(cid:48)(cid:48)(cid:7)(cid:5)(cid:3)(cid:9)(cid:2)(cid:12)(cid:11)(cid:4)(cid:14)(cid:11)(cid:48)(cid:48)(cid:7)(cid:5)(cid:3)(cid:9)(cid:2)(cid:28)(cid:3,Unknown,13835.0
Unknown,Unknown,11,Unknown,Unknown,Unknown,Unknown,cid:3)(cid:5)(cid:14)(cid:70)(cid:12)(cid:11)(cid:4)(cid:14)(cid:11)(cid:48)(cid:48)(cid:7)(cid:5)(cid:3)(cid:9)(cid:2)(cid:12)(cid:11)(cid:4)(cid:14)(cid:11)(cid:48)(cid:48)(cid:7)(cid:5)(cid:3)(cid:9)(cid:2)(cid:28)(cid:3,Unknown,13846.0
Unknown,Unknown,4,Unknown,Unknown,Unknown,Unknown,cid:3)(cid:5)(cid:14)(cid:70)(cid:12)(cid:11)(cid:4)(cid:14)(cid:11)(cid:48)(cid:48)(cid:7)(cid:5)(cid:3)(cid:9)(cid:2)(cid:12)(cid:11)(cid:4)(cid:14)(cid:11)(cid:48)(cid:48)(cid:7)(cid:5)(cid:3)(cid:9)(cid:2)(cid:28)(cid:3,Unknown,13850.0
Unknown,Unknown,7,Unknown,Unknown,Unknown,Unknown,cid:3)(cid:5)(cid:14)(cid:70)(cid:12)(cid:11)(cid:4)(cid:14)(cid:11)(cid:48)(cid:48)(cid:7)(cid:5)(cid:3)(cid:9)(cid:2)(cid:12)(cid:11)(cid:4)(cid:14)(cid:11)(cid:48)(cid:48)(cid:7)(cid:5)(cid:3)(cid:9)(cid:2)(cid:28)(cid:3,Unknown,13857.0
Unknown,Unknown,14,Unknown,Unknown,Unknown,Unknown,cid:3)(cid:5)(cid:14)(cid:70)(cid:12)(cid:11)(cid:4)(cid:14)(cid:11)(cid:48)(cid:48)(cid:7)(cid:5)(cid:3)(cid:9)(cid:2)(cid:12)(cid:11)(cid:4)(cid:14)(cid:11)(cid:48)(cid:48)(cid:7)(cid:5)(cid:3)(cid:9)(cid:2)(cid:28)(cid:3,Unknown,13871.0
Unknown,Unknown,14,Unknown,Unknown,Unknown,Unknown,cid:3)(cid:5)(cid:14)(cid:70)(cid:12)(cid:11)(cid:4)(cid:14)(cid:11)(cid:48)(cid:48)(cid:7)(cid:5)(cid:3)(cid:9)(cid:2)(cid:12)(cid:11)(cid:4)(cid:14)(cid:11)(cid:48)(cid:48)(cid:7)(cid:5)(cid:3)(cid:9)(cid:2)(cid:28)(cid:3,Unknown,13885.0
Unknown,Unknown,49,Unknown,Unknown,Unknown,Unknown,cid:3)(cid:5)(cid:14)(cid:70)(cid:12)(cid:11)(cid:4)(cid:14)(cid:11)(cid:48)(cid:48)(cid:7)(cid:5)(cid:3)(cid:9)(cid:2)(cid:12)(cid:11)(cid:4)(cid:14)(cid:11)(cid:48)(cid:48)(cid:7)(cid:5)(cid:3)(cid:9)(cid:2)(cid:28)(cid:3,Unknown,13934.0
Unknown,Unknown,2,Unknown,Unknown,Unknown,Unknown,cid:3)(cid:5)(cid:14)(cid:70)(cid:12)(cid:11)(cid:4)(cid:14)(cid:11)(cid:48)(cid:48)(cid:7)(cid:5)(cid:3)(cid:9)(cid:2)(cid:12)(cid:11)(cid:4)(cid:14)(cid:11)(cid:48)(cid:48)(cid:7)(cid:5)(cid:3)(cid:9)(cid:2)(cid:28)(cid:3,Unknown,13936.0
Unknown,Unknown,39,Unknown,Unknown,Unknown,Unknown,cid:3)(cid:5)(cid:14)(cid:70)(cid:12)(cid:11)(cid:4)(cid:14)(cid:11)(cid:48)(cid:48)(cid:7)(cid:5)(cid:3)(cid:9)(cid:2)(cid:12)(cid:11)(cid:4)(cid:14)(cid:11)(cid:48)(cid:48)(cid:7)(cid:5)(cid:3)(cid:9)(cid:2)(cid:28)(cid:3,Unknown,13975.0
Unknown,Unknown,11,Unknown,Unknown,Unknown,Unknown,cid:3)(cid:5)(cid:14)(cid:70)(cid:12)(cid:11)(cid:4)(cid:14)(cid:11)(cid:48)(cid:48)(cid:7)(cid:5)(cid:3)(cid:9)(cid:2)(cid:12)(cid:11)(cid:4)(cid:14)(cid:11)(cid:48)(cid:48)(cid:7)(cid:5)(cid:3)(cid:9)(cid:2)(cid:28)(cid:3,Unknown,13986.0
Unknown,Unknown,2,Unknown,Unknown,Unknown,Unknown,cid:3)(cid:5)(cid:14)(cid:70)(cid:12)(cid:11)(cid:4)(cid:14)(cid:11)(cid:48)(cid:48)(cid:7)(cid:5)(cid:3)(cid:9)(cid:2)(cid:12)(cid:11)(cid:4)(cid:14)(cid:11)(cid:48)(cid:48)(cid:7)(cid:5)(cid:3)(cid:9)(cid:2)(cid:28)(cid:3,Unknown,13988.0
Unknown,Unknown,28,Unknown,Unknown,Unknown,Unknown,cid:3)(cid:5)(cid:14)(cid:70)(cid:12)(cid:11)(cid:4)(cid:14)(cid:11)(cid:48)(cid:48)(cid:7)(cid:5)(cid:3)(cid:9)(cid:2)(cid:12)(cid:11)(cid:4)(cid:14)(cid:11)(cid:48)(cid:48)(cid:7)(cid:5)(cid:3)(cid:9)(cid:2)(cid:28)(cid:3,Unknown,14016.0
Unknown,Unknown,3,Unknown,Unknown,Unknown,Unknown,cid:3)(cid:5)(cid:14)(cid:70)(cid:12)(cid:11)(cid:4)(cid:14)(cid:11)(cid:48)(cid:48)(cid:7)(cid:5)(cid:3)(cid:9)(cid:2)(cid:12)(cid:11)(cid:4)(cid:14)(cid:11)(cid:48)(cid:48)(cid:7)(cid:5)(cid:3)(cid:9)(cid:2)(cid:28)(cid:3,Unknown,14019.0
Unknown,Unknown,15,Unknown,Unknown,Unknown,Unknown,cid:3)(cid:5)(cid:14)(cid:70)(cid:12)(cid:11)(cid:4)(cid:14)(cid:11)(cid:48)(cid:48)(cid:7)(cid:5)(cid:3)(cid:9)(cid:2)(cid:12)(cid:11)(cid:4)(cid:14)(cid:11)(cid:48)(cid:48)(cid:7)(cid:5)(cid:3)(cid:9)(cid:2)(cid:28)(cid:3,Unknown,14034.0
Unknown,Unknown,2,Unknown,Unknown,Unknown,Unknown,cid:3)(cid:5)(cid:14)(cid:70)(cid:12)(cid:11)(cid:4)(cid:14)(cid:11)(cid:48)(cid:48)(cid:7)(cid:5)(cid:3)(cid:9)(cid:2)(cid:12)(cid:11)(cid:4)(cid:14)(cid:11)(cid:48)(cid:48)(cid:7)(cid:5)(cid:3)(cid:9)(cid:2)(cid:28)(cid:3,Unknown,14036.0
Unknown,Unknown,17,Unknown,Unknown,Unknown,Unknown,cid:3)(cid:5)(cid:14)(cid:70)(cid:12)(cid:11)(cid:4)(cid:14)(cid:11)(cid:48)(cid:48)(cid:7)(cid:5)(cid:3)(cid:9)(cid:2)(cid:12)(cid:11)(cid:4)(cid:14)(cid:11)(cid:48)(cid:48)(cid:7)(cid:5)(cid:3)(cid:9)(cid:2)(cid:28)(cid:3,Unknown,14053.0
Unknown,Unknown,33,Unknown,Unknown,Unknown,Unknown,cid:3)(cid:5)(cid:14)(cid:70)(cid:12)(cid:11)(cid:4)(cid:14)(cid:11)(cid:48)(cid:48)(cid:7)(cid:5)(cid:3)(cid:9)(cid:2)(cid:12)(cid:11)(cid:4)(cid:14)(cid:11)(cid:48)(cid:48)(cid:7)(cid:5)(cid:3)(cid:9)(cid:2)(cid:28)(cid:3,Unknown,14086.0
Unknown,Unknown,19,Unknown,Unknown,Unknown,Unknown,cid:3)(cid:5)(cid:14)(cid:70)(cid:12)(cid:11)(cid:4)(cid:14)(cid:11)(cid:48)(cid:48)(cid:7)(cid:5)(cid:3)(cid:9)(cid:2)(cid:12)(cid:11)(cid:4)(cid:14)(cid:11)(cid:48)(cid:48)(cid:7)(cid:5)(cid:3)(cid:9)(cid:2)(cid:28)(cid:3,Unknown,14105.0
Unknown,Unknown,17,Unknown,Unknown,Unknown,Unknown,cid:3)(cid:5)(cid:14)(cid:70)(cid:12)(cid:11)(cid:4)(cid:14)(cid:11)(cid:48)(cid:48)(cid:7)(cid:5)(cid:3)(cid:9)(cid:2)(cid:12)(cid:11)(cid:4)(cid:14)(cid:11)(cid:48)(cid:48)(cid:7)(cid:5)(cid:3)(cid:9)(cid:2)(cid:28)(cid:3,Unknown,14122.0
Unknown,Unknown,18,Unknown,Unknown,Unknown,Unknown,cid:3)(cid:5)(cid:14)(cid:70)(cid:12)(cid:11)(cid:4)(cid:14)(cid:11)(cid:48)(cid:48)(cid:7)(cid:5)(cid:3)(cid:9)(cid:2)(cid:12)(cid:11)(cid:4)(cid:14)(cid:11)(cid:48)(cid:48)(cid:7)(cid:5)(cid:3)(cid:9)(cid:2)(cid:28)(cid:3,Unknown,14140.0
Unknown,Unknown,2,Unknown,Unknown,Unknown,Unknown,cid:3)(cid:5)(cid:14)(cid:70)(cid:12)(cid:11)(cid:4)(cid:14)(cid:11)(cid:48)(cid:48)(cid:7)(cid:5)(cid:3)(cid:9)(cid:2)(cid:12)(cid:11)(cid:4)(cid:14)(cid:11)(cid:48)(cid:48)(cid:7)(cid:5)(cid:3)(cid:9)(cid:2)(cid:28)(cid:3,Unknown,14142.0
Unknown,Unknown,44,Unknown,Unknown,Unknown,Unknown,cid:3)(cid:5)(cid:14)(cid:70)(cid:12)(cid:11)(cid:4)(cid:14)(cid:11)(cid:48)(cid:48)(cid:7)(cid:5)(cid:3)(cid:9)(cid:2)(cid:12)(cid:11)(cid:4)(cid:14)(cid:11)(cid:48)(cid:48)(cid:7)(cid:5)(cid:3)(cid:9)(cid:2)(cid:28)(cid:3,Unknown,14186.0
Unknown,Unknown,12,Unknown,Unknown,Unknown,Unknown,cid:3)(cid:5)(cid:14)(cid:70)(cid:12)(cid:11)(cid:4)(cid:14)(cid:11)(cid:48)(cid:48)(cid:7)(cid:5)(cid:3)(cid:9)(cid:2)(cid:12)(cid:11)(cid:4)(cid:14)(cid:11)(cid:48)(cid:48)(cid:7)(cid:5)(cid:3)(cid:9)(cid:2)(cid:28)(cid:3,Unknown,14198.0
Unknown,Unknown,29,Unknown,Unknown,Unknown,Unknown,cid:3)(cid:5)(cid:14)(cid:70)(cid:12)(cid:11)(cid:4)(cid:14)(cid:11)(cid:48)(cid:48)(cid:7)(cid:5)(cid:3)(cid:9)(cid:2)(cid:12)(cid:11)(cid:4)(cid:14)(cid:11)(cid:48)(cid:48)(cid:7)(cid:5)(cid:3)(cid:9)(cid:2)(cid:28)(cid:3,Unknown,14227.0
Unknown,Unknown,26,Unknown,Unknown,Unknown,Unknown,cid:3)(cid:5)(cid:14)(cid:70)(cid:12)(cid:11)(cid:4)(cid:14)(cid:11)(cid:48)(cid:48)(cid:7)(cid:5)(cid:3)(cid:9)(cid:2)(cid:12)(cid:11)(cid:4)(cid:14)(cid:11)(cid:48)(cid:48)(cid:7)(cid:5)(cid:3)(cid:9)(cid:2)(cid:28)(cid:3,Unknown,14253.0
Unknown,Unknown,41,Unknown,Unknown,Unknown,Unknown,cid:3)(cid:5)(cid:14)(cid:70)(cid:12)(cid:11)(cid:4)(cid:14)(cid:11)(cid:48)(cid:48)(cid:7)(cid:5)(cid:3)(cid:9)(cid:2)(cid:12)(cid:11)(cid:4)(cid:14)(cid:11)(cid:48)(cid:48)(cid:7)(cid:5)(cid:3)(cid:9)(cid:2)(cid:28)(cid:3,Unknown,14294.0
Unknown,Unknown,25,Unknown,Unknown,Unknown,Unknown,cid:3)(cid:5)(cid:14)(cid:70)(cid:12)(cid:11)(cid:4)(cid:14)(cid:11)(cid:48)(cid:48)(cid:7)(cid:5)(cid:3)(cid:9)(cid:2)(cid:12)(cid:11)(cid:4)(cid:14)(cid:11)(cid:48)(cid:48)(cid:7)(cid:5)(cid:3)(cid:9)(cid:2)(cid:28)(cid:3,Unknown,14319.0
Unknown,Unknown,2,Unknown,Unknown,Unknown,Unknown,cid:3)(cid:5)(cid:14)(cid:70)(cid:12)(cid:11)(cid:4)(cid:14)(cid:11)(cid:48)(cid:48)(cid:7)(cid:5)(cid:3)(cid:9)(cid:2)(cid:12)(cid:11)(cid:4)(cid:14)(cid:11)(cid:48)(cid:48)(cid:7)(cid:5)(cid:3)(cid:9)(cid:2)(cid:28)(cid:3,Unknown,14321.0
Unknown,Unknown,58,Unknown,Unknown,Unknown,Unknown,cid:3)(cid:5)(cid:14)(cid:70)(cid:12)(cid:11)(cid:4)(cid:14)(cid:11)(cid:48)(cid:48)(cid:7)(cid:5)(cid:3)(cid:9)(cid:2)(cid:12)(cid:11)(cid:4)(cid:14)(cid:11)(cid:48)(cid:48)(cid:7)(cid:5)(cid:3)(cid:9)(cid:2)(cid:28)(cid:3,Unknown,14379.0
Unknown,Unknown,58,Unknown,Unknown,Unknown,Unknown,cid:3)(cid:5)(cid:14)(cid:70)(cid:12)(cid:11)(cid:4)(cid:14)(cid:11)(cid:48)(cid:48)(cid:7)(cid:5)(cid:3)(cid:9)(cid:2)(cid:12)(cid:11)(cid:4)(cid:14)(cid:11)(cid:48)(cid:48)(cid:7)(cid:5)(cid:3)(cid:9)(cid:2)(cid:28)(cid:3,Unknown,14437.0
Unknown,Unknown,18,Unknown,Unknown,Unknown,Unknown,cid:3)(cid:5)(cid:14)(cid:70)(cid:12)(cid:11)(cid:4)(cid:14)(cid:11)(cid:48)(cid:48)(cid:7)(cid:5)(cid:3)(cid:9)(cid:2)(cid:12)(cid:11)(cid:4)(cid:14)(cid:11)(cid:48)(cid:48)(cid:7)(cid:5)(cid:3)(cid:9)(cid:2)(cid:28)(cid:3,Unknown,14455.0
Unknown,Unknown,1,Unknown,Unknown,Unknown,Unknown,cid:3)(cid:5)(cid:14)(cid:70)(cid:12)(cid:11)(cid:4)(cid:14)(cid:11)(cid:48)(cid:48)(cid:7)(cid:5)(cid:3)(cid:9)(cid:2)(cid:12)(cid:11)(cid:4)(cid:14)(cid:11)(cid:48)(cid:48)(cid:7)(cid:5)(cid:3)(cid:9)(cid:2)(cid:28)(cid:3,Unknown,14456.0
Unknown,Unknown,1,Unknown,Unknown,Unknown,Unknown,cid:3)(cid:5)(cid:14)(cid:70)(cid:12)(cid:11)(cid:4)(cid:14)(cid:11)(cid:48)(cid:48)(cid:7)(cid:5)(cid:3)(cid:9)(cid:2)(cid:12)(cid:11)(cid:4)(cid:14)(cid:11)(cid:48)(cid:48)(cid:7)(cid:5)(cid:3)(cid:9)(cid:2)(cid:28)(cid:3,Unknown,14457.0
Unknown,Unknown,37,Unknown,Unknown,Unknown,Unknown,cid:3)(cid:5)(cid:14)(cid:70)(cid:12)(cid:11)(cid:4)(cid:14)(cid:11)(cid:48)(cid:48)(cid:7)(cid:5)(cid:3)(cid:9)(cid:2)(cid:12)(cid:11)(cid:4)(cid:14)(cid:11)(cid:48)(cid:48)(cid:7)(cid:5)(cid:3)(cid:9)(cid:2)(cid:28)(cid:3,Unknown,14494.0
Unknown,Unknown,17,Unknown,Unknown,Unknown,Unknown,cid:3)(cid:5)(cid:14)(cid:70)(cid:12)(cid:11)(cid:4)(cid:14)(cid:11)(cid:48)(cid:48)(cid:7)(cid:5)(cid:3)(cid:9)(cid:2)(cid:12)(cid:11)(cid:4)(cid:14)(cid:11)(cid:48)(cid:48)(cid:7)(cid:5)(cid:3)(cid:9)(cid:2)(cid:28)(cid:3,Unknown,14511.0
Unknown,Unknown,16,Unknown,Unknown,Unknown,Unknown,cid:3)(cid:5)(cid:14)(cid:70)(cid:12)(cid:11)(cid:4)(cid:14)(cid:11)(cid:48)(cid:48)(cid:7)(cid:5)(cid:3)(cid:9)(cid:2)(cid:12)(cid:11)(cid:4)(cid:14)(cid:11)(cid:48)(cid:48)(cid:7)(cid:5)(cid:3)(cid:9)(cid:2)(cid:28)(cid:3,Unknown,14527.0
Unknown,Unknown,45,Unknown,Unknown,Unknown,Unknown,cid:3)(cid:5)(cid:14)(cid:70)(cid:12)(cid:11)(cid:4)(cid:14)(cid:11)(cid:48)(cid:48)(cid:7)(cid:5)(cid:3)(cid:9)(cid:2)(cid:12)(cid:11)(cid:4)(cid:14)(cid:11)(cid:48)(cid:48)(cid:7)(cid:5)(cid:3)(cid:9)(cid:2)(cid:28)(cid:3,Unknown,14572.0
Unknown,Unknown,18,Unknown,Unknown,Unknown,Unknown,cid:3)(cid:5)(cid:14)(cid:70)(cid:12)(cid:11)(cid:4)(cid:14)(cid:11)(cid:48)(cid:48)(cid:7)(cid:5)(cid:3)(cid:9)(cid:2)(cid:12)(cid:11)(cid:4)(cid:14)(cid:11)(cid:48)(cid:48)(cid:7)(cid:5)(cid:3)(cid:9)(cid:2)(cid:28)(cid:3,Unknown,14590.0
Unknown,Unknown,16,Unknown,Unknown,Unknown,Unknown,cid:3)(cid:5)(cid:14)(cid:70)(cid:12)(cid:11)(cid:4)(cid:14)(cid:11)(cid:48)(cid:48)(cid:7)(cid:5)(cid:3)(cid:9)(cid:2)(cid:12)(cid:11)(cid:4)(cid:14)(cid:11)(cid:48)(cid:48)(cid:7)(cid:5)(cid:3)(cid:9)(cid:2)(cid:28)(cid:3,Unknown,14606.0
Unknown,Unknown,9,Unknown,Unknown,Unknown,Unknown,cid:3)(cid:5)(cid:14)(cid:70)(cid:12)(cid:11)(cid:4)(cid:14)(cid:11)(cid:48)(cid:48)(cid:7)(cid:5)(cid:3)(cid:9)(cid:2)(cid:12)(cid:11)(cid:4)(cid:14)(cid:11)(cid:48)(cid:48)(cid:7)(cid:5)(cid:3)(cid:9)(cid:2)(cid:28)(cid:3,Unknown,14615.0
Unknown,Unknown,46,Unknown,Unknown,Unknown,Unknown,cid:3)(cid:5)(cid:14)(cid:70)(cid:12)(cid:11)(cid:4)(cid:14)(cid:11)(cid:48)(cid:48)(cid:7)(cid:5)(cid:3)(cid:9)(cid:2)(cid:12)(cid:11)(cid:4)(cid:14)(cid:11)(cid:48)(cid:48)(cid:7)(cid:5)(cid:3)(cid:9)(cid:2)(cid:28)(cid:3,Unknown,14661.0
Unknown,Unknown,8,Unknown,Unknown,Unknown,Unknown,cid:3)(cid:5)(cid:14)(cid:70)(cid:12)(cid:11)(cid:4)(cid:14)(cid:11)(cid:48)(cid:48)(cid:7)(cid:5)(cid:3)(cid:9)(cid:2)(cid:12)(cid:11)(cid:4)(cid:14)(cid:11)(cid:48)(cid:48)(cid:7)(cid:5)(cid:3)(cid:9)(cid:2)(cid:28)(cid:3,Unknown,14669.0
Unknown,Unknown,5,Unknown,Unknown,Unknown,Unknown,cid:3)(cid:5)(cid:14)(cid:70)(cid:12)(cid:11)(cid:4)(cid:14)(cid:11)(cid:48)(cid:48)(cid:7)(cid:5)(cid:3)(cid:9)(cid:2)(cid:12)(cid:11)(cid:4)(cid:14)(cid:11)(cid:48)(cid:48)(cid:7)(cid:5)(cid:3)(cid:9)(cid:2)(cid:28)(cid:3,Unknown,14674.0
Unknown,Unknown,28,Unknown,Unknown,Unknown,Unknown,cid:3)(cid:5)(cid:14)(cid:70)(cid:12)(cid:11)(cid:4)(cid:14)(cid:11)(cid:48)(cid:48)(cid:7)(cid:5)(cid:3)(cid:9)(cid:2)(cid:12)(cid:11)(cid:4)(cid:14)(cid:11)(cid:48)(cid:48)(cid:7)(cid:5)(cid:3)(cid:9)(cid:2)(cid:28)(cid:3,Unknown,14702.0
Unknown,Unknown,2,Unknown,Unknown,Unknown,Unknown,cid:3)(cid:5)(cid:14)(cid:70)(cid:12)(cid:11)(cid:4)(cid:14)(cid:11)(cid:48)(cid:48)(cid:7)(cid:5)(cid:3)(cid:9)(cid:2)(cid:12)(cid:11)(cid:4)(cid:14)(cid:11)(cid:48)(cid:48)(cid:7)(cid:5)(cid:3)(cid:9)(cid:2)(cid:28)(cid:3,Unknown,14704.0
Unknown,Unknown,46,Unknown,Unknown,Unknown,Unknown,cid:3)(cid:5)(cid:14)(cid:70)(cid:12)(cid:11)(cid:4)(cid:14)(cid:11)(cid:48)(cid:48)(cid:7)(cid:5)(cid:3)(cid:9)(cid:2)(cid:12)(cid:11)(cid:4)(cid:14)(cid:11)(cid:48)(cid:48)(cid:7)(cid:5)(cid:3)(cid:9)(cid:2)(cid:28)(cid:3,Unknown,14750.0
Unknown,Unknown,4,Unknown,Unknown,Unknown,Unknown,cid:3)(cid:5)(cid:14)(cid:70)(cid:12)(cid:11)(cid:4)(cid:14)(cid:11)(cid:48)(cid:48)(cid:7)(cid:5)(cid:3)(cid:9)(cid:2)(cid:12)(cid:11)(cid:4)(cid:14)(cid:11)(cid:48)(cid:48)(cid:7)(cid:5)(cid:3)(cid:9)(cid:2)(cid:28)(cid:3,Unknown,14754.0
Unknown,Unknown,10,Unknown,Unknown,Unknown,Unknown,cid:3)(cid:5)(cid:14)(cid:70)(cid:12)(cid:11)(cid:4)(cid:14)(cid:11)(cid:48)(cid:48)(cid:7)(cid:5)(cid:3)(cid:9)(cid:2)(cid:12)(cid:11)(cid:4)(cid:14)(cid:11)(cid:48)(cid:48)(cid:7)(cid:5)(cid:3)(cid:9)(cid:2)(cid:28)(cid:3,Unknown,14764.0
Unknown,Unknown,11,Unknown,Unknown,Unknown,Unknown,cid:3)(cid:5)(cid:14)(cid:70)(cid:12)(cid:11)(cid:4)(cid:14)(cid:11)(cid:48)(cid:48)(cid:7)(cid:5)(cid:3)(cid:9)(cid:2)(cid:12)(cid:11)(cid:4)(cid:14)(cid:11)(cid:48)(cid:48)(cid:7)(cid:5)(cid:3)(cid:9)(cid:2)(cid:28)(cid:3,Unknown,14775.0
Unknown,Unknown,3,Unknown,Unknown,Unknown,Unknown,cid:3)(cid:5)(cid:14)(cid:70)(cid:12)(cid:11)(cid:4)(cid:14)(cid:11)(cid:48)(cid:48)(cid:7)(cid:5)(cid:3)(cid:9)(cid:2)(cid:12)(cid:11)(cid:4)(cid:14)(cid:11)(cid:48)(cid:48)(cid:7)(cid:5)(cid:3)(cid:9)(cid:2)(cid:28)(cid:3,Unknown,14778.0
Unknown,Unknown,11,Unknown,Unknown,Unknown,Unknown,cid:3)(cid:5)(cid:14)(cid:70)(cid:12)(cid:11)(cid:4)(cid:14)(cid:11)(cid:48)(cid:48)(cid:7)(cid:5)(cid:3)(cid:9)(cid:2)(cid:12)(cid:11)(cid:4)(cid:14)(cid:11)(cid:48)(cid:48)(cid:7)(cid:5)(cid:3)(cid:9)(cid:2)(cid:28)(cid:3,Unknown,14789.0
Unknown,Unknown,4,Unknown,Unknown,Unknown,Unknown,cid:3)(cid:5)(cid:14)(cid:70)(cid:12)(cid:11)(cid:4)(cid:14)(cid:11)(cid:48)(cid:48)(cid:7)(cid:5)(cid:3)(cid:9)(cid:2)(cid:12)(cid:11)(cid:4)(cid:14)(cid:11)(cid:48)(cid:48)(cid:7)(cid:5)(cid:3)(cid:9)(cid:2)(cid:28)(cid:3,Unknown,14793.0
Unknown,Unknown,10,Unknown,Unknown,Unknown,Unknown,cid:3)(cid:5)(cid:14)(cid:70)(cid:12)(cid:11)(cid:4)(cid:14)(cid:11)(cid:48)(cid:48)(cid:7)(cid:5)(cid:3)(cid:9)(cid:2)(cid:12)(cid:11)(cid:4)(cid:14)(cid:11)(cid:48)(cid:48)(cid:7)(cid:5)(cid:3)(cid:9)(cid:2)(cid:28)(cid:3,Unknown,14803.0
Unknown,Unknown,5,Unknown,Unknown,Unknown,Unknown,cid:3)(cid:5)(cid:14)(cid:70)(cid:12)(cid:11)(cid:4)(cid:14)(cid:11)(cid:48)(cid:48)(cid:7)(cid:5)(cid:3)(cid:9)(cid:2)(cid:12)(cid:11)(cid:4)(cid:14)(cid:11)(cid:48)(cid:48)(cid:7)(cid:5)(cid:3)(cid:9)(cid:2)(cid:28)(cid:3,Unknown,14808.0
Unknown,Unknown,2,Unknown,Unknown,Unknown,Unknown,cid:3)(cid:5)(cid:14)(cid:70)(cid:12)(cid:11)(cid:4)(cid:14)(cid:11)(cid:48)(cid:48)(cid:7)(cid:5)(cid:3)(cid:9)(cid:2)(cid:12)(cid:11)(cid:4)(cid:14)(cid:11)(cid:48)(cid:48)(cid:7)(cid:5)(cid:3)(cid:9)(cid:2)(cid:28)(cid:3,Unknown,14810.0
Unknown,Unknown,9,Unknown,Unknown,Unknown,Unknown,cid:3)(cid:5)(cid:14)(cid:70)(cid:12)(cid:11)(cid:4)(cid:14)(cid:11)(cid:48)(cid:48)(cid:7)(cid:5)(cid:3)(cid:9)(cid:2)(cid:12)(cid:11)(cid:4)(cid:14)(cid:11)(cid:48)(cid:48)(cid:7)(cid:5)(cid:3)(cid:9)(cid:2)(cid:28)(cid:3,Unknown,14819.0
Unknown,Unknown,5,Unknown,Unknown,Unknown,Unknown,cid:3)(cid:5)(cid:14)(cid:70)(cid:12)(cid:11)(cid:4)(cid:14)(cid:11)(cid:48)(cid:48)(cid:7)(cid:5)(cid:3)(cid:9)(cid:2)(cid:12)(cid:11)(cid:4)(cid:14)(cid:11)(cid:48)(cid:48)(cid:7)(cid:5)(cid:3)(cid:9)(cid:2)(cid:28)(cid:3,Unknown,14824.0
Unknown,Unknown,8,Unknown,Unknown,Unknown,Unknown,cid:3)(cid:5)(cid:14)(cid:70)(cid:12)(cid:11)(cid:4)(cid:14)(cid:11)(cid:48)(cid:48)(cid:7)(cid:5)(cid:3)(cid:9)(cid:2)(cid:12)(cid:11)(cid:4)(cid:14)(cid:11)(cid:48)(cid:48)(cid:7)(cid:5)(cid:3)(cid:9)(cid:2)(cid:28)(cid:3,Unknown,14832.0
Unknown,Unknown,14,Unknown,Unknown,Unknown,Unknown,cid:3)(cid:5)(cid:14)(cid:70)(cid:12)(cid:11)(cid:4)(cid:14)(cid:11)(cid:48)(cid:48)(cid:7)(cid:5)(cid:3)(cid:9)(cid:2)(cid:12)(cid:11)(cid:4)(cid:14)(cid:11)(cid:48)(cid:48)(cid:7)(cid:5)(cid:3)(cid:9)(cid:2)(cid:28)(cid:3,Unknown,14846.0
Unknown,Unknown,7,Unknown,Unknown,Unknown,Unknown,cid:3)(cid:5)(cid:14)(cid:70)(cid:12)(cid:11)(cid:4)(cid:14)(cid:11)(cid:48)(cid:48)(cid:7)(cid:5)(cid:3)(cid:9)(cid:2)(cid:12)(cid:11)(cid:4)(cid:14)(cid:11)(cid:48)(cid:48)(cid:7)(cid:5)(cid:3)(cid:9)(cid:2)(cid:28)(cid:3,Unknown,14853.0
Unknown,Unknown,9,Unknown,Unknown,Unknown,Unknown,cid:3)(cid:5)(cid:14)(cid:70)(cid:12)(cid:11)(cid:4)(cid:14)(cid:11)(cid:48)(cid:48)(cid:7)(cid:5)(cid:3)(cid:9)(cid:2)(cid:12)(cid:11)(cid:4)(cid:14)(cid:11)(cid:48)(cid:48)(cid:7)(cid:5)(cid:3)(cid:9)(cid:2)(cid:28)(cid:3,Unknown,14862.0
Unknown,Unknown,2,Unknown,Unknown,Unknown,Unknown,cid:3)(cid:5)(cid:14)(cid:70)(cid:12)(cid:11)(cid:4)(cid:14)(cid:11)(cid:48)(cid:48)(cid:7)(cid:5)(cid:3)(cid:9)(cid:2)(cid:12)(cid:11)(cid:4)(cid:14)(cid:11)(cid:48)(cid:48)(cid:7)(cid:5)(cid:3)(cid:9)(cid:2)(cid:28)(cid:3,Unknown,14864.0
Unknown,Unknown,12,Unknown,Unknown,Unknown,Unknown,cid:3)(cid:5)(cid:14)(cid:70)(cid:12)(cid:11)(cid:4)(cid:14)(cid:11)(cid:48)(cid:48)(cid:7)(cid:5)(cid:3)(cid:9)(cid:2)(cid:12)(cid:11)(cid:4)(cid:14)(cid:11)(cid:48)(cid:48)(cid:7)(cid:5)(cid:3)(cid:9)(cid:2)(cid:28)(cid:3,Unknown,14876.0
Unknown,Unknown,5,Unknown,Unknown,Unknown,Unknown,cid:3)(cid:5)(cid:14)(cid:70)(cid:12)(cid:11)(cid:4)(cid:14)(cid:11)(cid:48)(cid:48)(cid:7)(cid:5)(cid:3)(cid:9)(cid:2)(cid:12)(cid:11)(cid:4)(cid:14)(cid:11)(cid:48)(cid:48)(cid:7)(cid:5)(cid:3)(cid:9)(cid:2)(cid:28)(cid:3,Unknown,14881.0
Unknown,Unknown,50,Unknown,Unknown,Unknown,Unknown,cid:3)(cid:5)(cid:14)(cid:70)(cid:12)(cid:11)(cid:4)(cid:14)(cid:11)(cid:48)(cid:48)(cid:7)(cid:5)(cid:3)(cid:9)(cid:2)(cid:12)(cid:11)(cid:4)(cid:14)(cid:11)(cid:48)(cid:48)(cid:7)(cid:5)(cid:3)(cid:9)(cid:2)(cid:28)(cid:3,Unknown,14931.0
Unknown,Unknown,5,Unknown,Unknown,Unknown,Unknown,cid:3)(cid:5)(cid:14)(cid:70)(cid:12)(cid:11)(cid:4)(cid:14)(cid:11)(cid:48)(cid:48)(cid:7)(cid:5)(cid:3)(cid:9)(cid:2)(cid:12)(cid:11)(cid:4)(cid:14)(cid:11)(cid:48)(cid:48)(cid:7)(cid:5)(cid:3)(cid:9)(cid:2)(cid:28)(cid:3,Unknown,14936.0
Unknown,Unknown,40,Unknown,Unknown,Unknown,Unknown,cid:3)(cid:5)(cid:14)(cid:70)(cid:12)(cid:11)(cid:4)(cid:14)(cid:11)(cid:48)(cid:48)(cid:7)(cid:5)(cid:3)(cid:9)(cid:2)(cid:12)(cid:11)(cid:4)(cid:14)(cid:11)(cid:48)(cid:48)(cid:7)(cid:5)(cid:3)(cid:9)(cid:2)(cid:28)(cid:3,Unknown,14976.0
Unknown,Unknown,2,Unknown,Unknown,Unknown,Unknown,cid:3)(cid:5)(cid:14)(cid:70)(cid:12)(cid:11)(cid:4)(cid:14)(cid:11)(cid:48)(cid:48)(cid:7)(cid:5)(cid:3)(cid:9)(cid:2)(cid:12)(cid:11)(cid:4)(cid:14)(cid:11)(cid:48)(cid:48)(cid:7)(cid:5)(cid:3)(cid:9)(cid:2)(cid:28)(cid:3,Unknown,14978.0
Unknown,Unknown,28,Unknown,Unknown,Unknown,Unknown,cid:3)(cid:5)(cid:14)(cid:70)(cid:12)(cid:11)(cid:4)(cid:14)(cid:11)(cid:48)(cid:48)(cid:7)(cid:5)(cid:3)(cid:9)(cid:2)(cid:12)(cid:11)(cid:4)(cid:14)(cid:11)(cid:48)(cid:48)(cid:7)(cid:5)(cid:3)(cid:9)(cid:2)(cid:28)(cid:3,Unknown,15006.0
Unknown,Unknown,3,Unknown,Unknown,Unknown,Unknown,cid:3)(cid:5)(cid:14)(cid:70)(cid:12)(cid:11)(cid:4)(cid:14)(cid:11)(cid:48)(cid:48)(cid:7)(cid:5)(cid:3)(cid:9)(cid:2)(cid:12)(cid:11)(cid:4)(cid:14)(cid:11)(cid:48)(cid:48)(cid:7)(cid:5)(cid:3)(cid:9)(cid:2)(cid:28)(cid:3,Unknown,15009.0
Unknown,Unknown,15,Unknown,Unknown,Unknown,Unknown,cid:3)(cid:5)(cid:14)(cid:70)(cid:12)(cid:11)(cid:4)(cid:14)(cid:11)(cid:48)(cid:48)(cid:7)(cid:5)(cid:3)(cid:9)(cid:2)(cid:12)(cid:11)(cid:4)(cid:14)(cid:11)(cid:48)(cid:48)(cid:7)(cid:5)(cid:3)(cid:9)(cid:2)(cid:28)(cid:3,Unknown,15024.0
Unknown,Unknown,2,Unknown,Unknown,Unknown,Unknown,cid:3)(cid:5)(cid:14)(cid:70)(cid:12)(cid:11)(cid:4)(cid:14)(cid:11)(cid:48)(cid:48)(cid:7)(cid:5)(cid:3)(cid:9)(cid:2)(cid:12)(cid:11)(cid:4)(cid:14)(cid:11)(cid:48)(cid:48)(cid:7)(cid:5)(cid:3)(cid:9)(cid:2)(cid:28)(cid:3,Unknown,15026.0
Unknown,Unknown,1,Unknown,Unknown,Unknown,Unknown,cid:3)(cid:5)(cid:14)(cid:70)(cid:12)(cid:11)(cid:4)(cid:14)(cid:11)(cid:48)(cid:48)(cid:7)(cid:5)(cid:3)(cid:9)(cid:2)(cid:12)(cid:11)(cid:4)(cid:14)(cid:11)(cid:48)(cid:48)(cid:7)(cid:5)(cid:3)(cid:9)(cid:2)(cid:28)(cid:3,Unknown,15027.0
Unknown,Unknown,19,Unknown,Unknown,Unknown,Unknown,cid:3)(cid:5)(cid:14)(cid:70)(cid:12)(cid:11)(cid:4)(cid:14)(cid:11)(cid:48)(cid:48)(cid:7)(cid:5)(cid:3)(cid:9)(cid:2)(cid:12)(cid:11)(cid:4)(cid:14)(cid:11)(cid:48)(cid:48)(cid:7)(cid:5)(cid:3)(cid:9)(cid:2)(cid:28)(cid:3,Unknown,15046.0
Unknown,Unknown,37,Unknown,Unknown,Unknown,Unknown,cid:3)(cid:5)(cid:14)(cid:70)(cid:12)(cid:11)(cid:4)(cid:14)(cid:11)(cid:48)(cid:48)(cid:7)(cid:5)(cid:3)(cid:9)(cid:2)(cid:12)(cid:11)(cid:4)(cid:14)(cid:11)(cid:48)(cid:48)(cid:7)(cid:5)(cid:3)(cid:9)(cid:2)(cid:28)(cid:3,Unknown,15083.0
Unknown,Unknown,18,Unknown,Unknown,Unknown,Unknown,cid:3)(cid:5)(cid:14)(cid:70)(cid:12)(cid:11)(cid:4)(cid:14)(cid:11)(cid:48)(cid:48)(cid:7)(cid:5)(cid:3)(cid:9)(cid:2)(cid:12)(cid:11)(cid:4)(cid:14)(cid:11)(cid:48)(cid:48)(cid:7)(cid:5)(cid:3)(cid:9)(cid:2)(cid:28)(cid:3,Unknown,15101.0
Unknown,Unknown,2,Unknown,Unknown,Unknown,Unknown,cid:3)(cid:5)(cid:14)(cid:70)(cid:12)(cid:11)(cid:4)(cid:14)(cid:11)(cid:48)(cid:48)(cid:7)(cid:5)(cid:3)(cid:9)(cid:2)(cid:12)(cid:11)(cid:4)(cid:14)(cid:11)(cid:48)(cid:48)(cid:7)(cid:5)(cid:3)(cid:9)(cid:2)(cid:28)(cid:3,Unknown,15103.0
Unknown,Unknown,44,Unknown,Unknown,Unknown,Unknown,cid:3)(cid:5)(cid:14)(cid:70)(cid:12)(cid:11)(cid:4)(cid:14)(cid:11)(cid:48)(cid:48)(cid:7)(cid:5)(cid:3)(cid:9)(cid:2)(cid:12)(cid:11)(cid:4)(cid:14)(cid:11)(cid:48)(cid:48)(cid:7)(cid:5)(cid:3)(cid:9)(cid:2)(cid:28)(cid:3,Unknown,15147.0
Unknown,Unknown,12,Unknown,Unknown,Unknown,Unknown,cid:3)(cid:5)(cid:14)(cid:70)(cid:12)(cid:11)(cid:4)(cid:14)(cid:11)(cid:48)(cid:48)(cid:7)(cid:5)(cid:3)(cid:9)(cid:2)(cid:12)(cid:11)(cid:4)(cid:14)(cid:11)(cid:48)(cid:48)(cid:7)(cid:5)(cid:3)(cid:9)(cid:2)(cid:28)(cid:3,Unknown,15159.0
Unknown,Unknown,29,Unknown,Unknown,Unknown,Unknown,cid:3)(cid:5)(cid:14)(cid:70)(cid:12)(cid:11)(cid:4)(cid:14)(cid:11)(cid:48)(cid:48)(cid:7)(cid:5)(cid:3)(cid:9)(cid:2)(cid:12)(cid:11)(cid:4)(cid:14)(cid:11)(cid:48)(cid:48)(cid:7)(cid:5)(cid:3)(cid:9)(cid:2)(cid:28)(cid:3,Unknown,15188.0
Unknown,Unknown,26,Unknown,Unknown,Unknown,Unknown,cid:3)(cid:5)(cid:14)(cid:70)(cid:12)(cid:11)(cid:4)(cid:14)(cid:11)(cid:48)(cid:48)(cid:7)(cid:5)(cid:3)(cid:9)(cid:2)(cid:12)(cid:11)(cid:4)(cid:14)(cid:11)(cid:48)(cid:48)(cid:7)(cid:5)(cid:3)(cid:9)(cid:2)(cid:28)(cid:3,Unknown,15214.0
Unknown,Unknown,41,Unknown,Unknown,Unknown,Unknown,cid:3)(cid:5)(cid:14)(cid:70)(cid:12)(cid:11)(cid:4)(cid:14)(cid:11)(cid:48)(cid:48)(cid:7)(cid:5)(cid:3)(cid:9)(cid:2)(cid:12)(cid:11)(cid:4)(cid:14)(cid:11)(cid:48)(cid:48)(cid:7)(cid:5)(cid:3)(cid:9)(cid:2)(cid:28)(cid:3,Unknown,15255.0
Unknown,Unknown,25,Unknown,Unknown,Unknown,Unknown,cid:3)(cid:5)(cid:14)(cid:70)(cid:12)(cid:11)(cid:4)(cid:14)(cid:11)(cid:48)(cid:48)(cid:7)(cid:5)(cid:3)(cid:9)(cid:2)(cid:12)(cid:11)(cid:4)(cid:14)(cid:11)(cid:48)(cid:48)(cid:7)(cid:5)(cid:3)(cid:9)(cid:2)(cid:28)(cid:3,Unknown,15280.0
Unknown,Unknown,2,Unknown,Unknown,Unknown,Unknown,cid:3)(cid:5)(cid:14)(cid:70)(cid:12)(cid:11)(cid:4)(cid:14)(cid:11)(cid:48)(cid:48)(cid:7)(cid:5)(cid:3)(cid:9)(cid:2)(cid:12)(cid:11)(cid:4)(cid:14)(cid:11)(cid:48)(cid:48)(cid:7)(cid:5)(cid:3)(cid:9)(cid:2)(cid:28)(cid:3,Unknown,15282.0
Unknown,Unknown,58,Unknown,Unknown,Unknown,Unknown,cid:3)(cid:5)(cid:14)(cid:70)(cid:12)(cid:11)(cid:4)(cid:14)(cid:11)(cid:48)(cid:48)(cid:7)(cid:5)(cid:3)(cid:9)(cid:2)(cid:12)(cid:11)(cid:4)(cid:14)(cid:11)(cid:48)(cid:48)(cid:7)(cid:5)(cid:3)(cid:9)(cid:2)(cid:28)(cid:3,Unknown,15340.0
Unknown,Unknown,58,Unknown,Unknown,Unknown,Unknown,cid:3)(cid:5)(cid:14)(cid:70)(cid:12)(cid:11)(cid:4)(cid:14)(cid:11)(cid:48)(cid:48)(cid:7)(cid:5)(cid:3)(cid:9)(cid:2)(cid:12)(cid:11)(cid:4)(cid:14)(cid:11)(cid:48)(cid:48)(cid:7)(cid:5)(cid:3)(cid:9)(cid:2)(cid:28)(cid:3,Unknown,15398.0
Unknown,Unknown,18,Unknown,Unknown,Unknown,Unknown,cid:3)(cid:5)(cid:14)(cid:70)(cid:12)(cid:11)(cid:4)(cid:14)(cid:11)(cid:48)(cid:48)(cid:7)(cid:5)(cid:3)(cid:9)(cid:2)(cid:12)(cid:11)(cid:4)(cid:14)(cid:11)(cid:48)(cid:48)(cid:7)(cid:5)(cid:3)(cid:9)(cid:2)(cid:28)(cid:3,Unknown,15416.0
Unknown,Unknown,1,Unknown,Unknown,Unknown,Unknown,cid:3)(cid:5)(cid:14)(cid:70)(cid:12)(cid:11)(cid:4)(cid:14)(cid:11)(cid:48)(cid:48)(cid:7)(cid:5)(cid:3)(cid:9)(cid:2)(cid:12)(cid:11)(cid:4)(cid:14)(cid:11)(cid:48)(cid:48)(cid:7)(cid:5)(cid:3)(cid:9)(cid:2)(cid:28)(cid:3,Unknown,15417.0
Unknown,Unknown,1,Unknown,Unknown,Unknown,Unknown,cid:3)(cid:5)(cid:14)(cid:70)(cid:12)(cid:11)(cid:4)(cid:14)(cid:11)(cid:48)(cid:48)(cid:7)(cid:5)(cid:3)(cid:9)(cid:2)(cid:12)(cid:11)(cid:4)(cid:14)(cid:11)(cid:48)(cid:48)(cid:7)(cid:5)(cid:3)(cid:9)(cid:2)(cid:28)(cid:3,Unknown,15418.0
Unknown,Unknown,37,Unknown,Unknown,Unknown,Unknown,cid:3)(cid:5)(cid:14)(cid:70)(cid:12)(cid:11)(cid:4)(cid:14)(cid:11)(cid:48)(cid:48)(cid:7)(cid:5)(cid:3)(cid:9)(cid:2)(cid:12)(cid:11)(cid:4)(cid:14)(cid:11)(cid:48)(cid:48)(cid:7)(cid:5)(cid:3)(cid:9)(cid:2)(cid:28)(cid:3,Unknown,15455.0
Unknown,Unknown,17,Unknown,Unknown,Unknown,Unknown,cid:3)(cid:5)(cid:14)(cid:70)(cid:12)(cid:11)(cid:4)(cid:14)(cid:11)(cid:48)(cid:48)(cid:7)(cid:5)(cid:3)(cid:9)(cid:2)(cid:12)(cid:11)(cid:4)(cid:14)(cid:11)(cid:48)(cid:48)(cid:7)(cid:5)(cid:3)(cid:9)(cid:2)(cid:28)(cid:3,Unknown,15472.0
Unknown,Unknown,16,Unknown,Unknown,Unknown,Unknown,cid:3)(cid:5)(cid:14)(cid:70)(cid:12)(cid:11)(cid:4)(cid:14)(cid:11)(cid:48)(cid:48)(cid:7)(cid:5)(cid:3)(cid:9)(cid:2)(cid:12)(cid:11)(cid:4)(cid:14)(cid:11)(cid:48)(cid:48)(cid:7)(cid:5)(cid:3)(cid:9)(cid:2)(cid:28)(cid:3,Unknown,15488.0
Unknown,Unknown,45,Unknown,Unknown,Unknown,Unknown,cid:3)(cid:5)(cid:14)(cid:70)(cid:12)(cid:11)(cid:4)(cid:14)(cid:11)(cid:48)(cid:48)(cid:7)(cid:5)(cid:3)(cid:9)(cid:2)(cid:12)(cid:11)(cid:4)(cid:14)(cid:11)(cid:48)(cid:48)(cid:7)(cid:5)(cid:3)(cid:9)(cid:2)(cid:28)(cid:3,Unknown,15533.0
Unknown,Unknown,18,Unknown,Unknown,Unknown,Unknown,cid:3)(cid:5)(cid:14)(cid:70)(cid:12)(cid:11)(cid:4)(cid:14)(cid:11)(cid:48)(cid:48)(cid:7)(cid:5)(cid:3)(cid:9)(cid:2)(cid:12)(cid:11)(cid:4)(cid:14)(cid:11)(cid:48)(cid:48)(cid:7)(cid:5)(cid:3)(cid:9)(cid:2)(cid:28)(cid:3,Unknown,15551.0
Unknown,Unknown,16,Unknown,Unknown,Unknown,Unknown,cid:3)(cid:5)(cid:14)(cid:70)(cid:12)(cid:11)(cid:4)(cid:14)(cid:11)(cid:48)(cid:48)(cid:7)(cid:5)(cid:3)(cid:9)(cid:2)(cid:12)(cid:11)(cid:4)(cid:14)(cid:11)(cid:48)(cid:48)(cid:7)(cid:5)(cid:3)(cid:9)(cid:2)(cid:28)(cid:3,Unknown,15567.0
Unknown,Unknown,9,Unknown,Unknown,Unknown,Unknown,cid:3)(cid:5)(cid:14)(cid:70)(cid:12)(cid:11)(cid:4)(cid:14)(cid:11)(cid:48)(cid:48)(cid:7)(cid:5)(cid:3)(cid:9)(cid:2)(cid:12)(cid:11)(cid:4)(cid:14)(cid:11)(cid:48)(cid:48)(cid:7)(cid:5)(cid:3)(cid:9)(cid:2)(cid:28)(cid:3,Unknown,15576.0
Unknown,Unknown,46,Unknown,Unknown,Unknown,Unknown,cid:3)(cid:5)(cid:14)(cid:70)(cid:12)(cid:11)(cid:4)(cid:14)(cid:11)(cid:48)(cid:48)(cid:7)(cid:5)(cid:3)(cid:9)(cid:2)(cid:12)(cid:11)(cid:4)(cid:14)(cid:11)(cid:48)(cid:48)(cid:7)(cid:5)(cid:3)(cid:9)(cid:2)(cid:28)(cid:3,Unknown,15622.0
Unknown,Unknown,8,Unknown,Unknown,Unknown,Unknown,cid:3)(cid:5)(cid:14)(cid:70)(cid:12)(cid:11)(cid:4)(cid:14)(cid:11)(cid:48)(cid:48)(cid:7)(cid:5)(cid:3)(cid:9)(cid:2)(cid:12)(cid:11)(cid:4)(cid:14)(cid:11)(cid:48)(cid:48)(cid:7)(cid:5)(cid:3)(cid:9)(cid:2)(cid:28)(cid:3,Unknown,15630.0
Unknown,Unknown,5,Unknown,Unknown,Unknown,Unknown,cid:3)(cid:5)(cid:14)(cid:70)(cid:12)(cid:11)(cid:4)(cid:14)(cid:11)(cid:48)(cid:48)(cid:7)(cid:5)(cid:3)(cid:9)(cid:2)(cid:12)(cid:11)(cid:4)(cid:14)(cid:11)(cid:48)(cid:48)(cid:7)(cid:5)(cid:3)(cid:9)(cid:2)(cid:28)(cid:3,Unknown,15635.0
Unknown,Unknown,28,Unknown,Unknown,Unknown,Unknown,cid:3)(cid:5)(cid:14)(cid:70)(cid:12)(cid:11)(cid:4)(cid:14)(cid:11)(cid:48)(cid:48)(cid:7)(cid:5)(cid:3)(cid:9)(cid:2)(cid:12)(cid:11)(cid:4)(cid:14)(cid:11)(cid:48)(cid:48)(cid:7)(cid:5)(cid:3)(cid:9)(cid:2)(cid:28)(cid:3,Unknown,15663.0
Unknown,Unknown,2,Unknown,Unknown,Unknown,Unknown,cid:3)(cid:5)(cid:14)(cid:70)(cid:12)(cid:11)(cid:4)(cid:14)(cid:11)(cid:48)(cid:48)(cid:7)(cid:5)(cid:3)(cid:9)(cid:2)(cid:12)(cid:11)(cid:4)(cid:14)(cid:11)(cid:48)(cid:48)(cid:7)(cid:5)(cid:3)(cid:9)(cid:2)(cid:28)(cid:3,Unknown,15665.0
Unknown,Unknown,46,Unknown,Unknown,Unknown,Unknown,cid:3)(cid:5)(cid:14)(cid:70)(cid:12)(cid:11)(cid:4)(cid:14)(cid:11)(cid:48)(cid:48)(cid:7)(cid:5)(cid:3)(cid:9)(cid:2)(cid:12)(cid:11)(cid:4)(cid:14)(cid:11)(cid:48)(cid:48)(cid:7)(cid:5)(cid:3)(cid:9)(cid:2)(cid:28)(cid:3,Unknown,15711.0
Unknown,Unknown,4,Unknown,Unknown,Unknown,Unknown,cid:3)(cid:5)(cid:14)(cid:70)(cid:12)(cid:11)(cid:4)(cid:14)(cid:11)(cid:48)(cid:48)(cid:7)(cid:5)(cid:3)(cid:9)(cid:2)(cid:12)(cid:11)(cid:4)(cid:14)(cid:11)(cid:48)(cid:48)(cid:7)(cid:5)(cid:3)(cid:9)(cid:2)(cid:28)(cid:3,Unknown,15715.0
Unknown,Unknown,10,Unknown,Unknown,Unknown,Unknown,cid:3)(cid:5)(cid:14)(cid:70)(cid:12)(cid:11)(cid:4)(cid:14)(cid:11)(cid:48)(cid:48)(cid:7)(cid:5)(cid:3)(cid:9)(cid:2)(cid:12)(cid:11)(cid:4)(cid:14)(cid:11)(cid:48)(cid:48)(cid:7)(cid:5)(cid:3)(cid:9)(cid:2)(cid:28)(cid:3,Unknown,15725.0
Unknown,Unknown,11,Unknown,Unknown,Unknown,Unknown,cid:3)(cid:5)(cid:14)(cid:70)(cid:12)(cid:11)(cid:4)(cid:14)(cid:11)(cid:48)(cid:48)(cid:7)(cid:5)(cid:3)(cid:9)(cid:2)(cid:12)(cid:11)(cid:4)(cid:14)(cid:11)(cid:48)(cid:48)(cid:7)(cid:5)(cid:3)(cid:9)(cid:2)(cid:28)(cid:3,Unknown,15736.0
Unknown,Unknown,3,Unknown,Unknown,Unknown,Unknown,cid:3)(cid:5)(cid:14)(cid:70)(cid:12)(cid:11)(cid:4)(cid:14)(cid:11)(cid:48)(cid:48)(cid:7)(cid:5)(cid:3)(cid:9)(cid:2)(cid:12)(cid:11)(cid:4)(cid:14)(cid:11)(cid:48)(cid:48)(cid:7)(cid:5)(cid:3)(cid:9)(cid:2)(cid:28)(cid:3,Unknown,15739.0
Unknown,Unknown,11,Unknown,Unknown,Unknown,Unknown,cid:3)(cid:5)(cid:14)(cid:70)(cid:12)(cid:11)(cid:4)(cid:14)(cid:11)(cid:48)(cid:48)(cid:7)(cid:5)(cid:3)(cid:9)(cid:2)(cid:12)(cid:11)(cid:4)(cid:14)(cid:11)(cid:48)(cid:48)(cid:7)(cid:5)(cid:3)(cid:9)(cid:2)(cid:28)(cid:3,Unknown,15750.0
Unknown,Unknown,4,Unknown,Unknown,Unknown,Unknown,cid:3)(cid:5)(cid:14)(cid:70)(cid:12)(cid:11)(cid:4)(cid:14)(cid:11)(cid:48)(cid:48)(cid:7)(cid:5)(cid:3)(cid:9)(cid:2)(cid:12)(cid:11)(cid:4)(cid:14)(cid:11)(cid:48)(cid:48)(cid:7)(cid:5)(cid:3)(cid:9)(cid:2)(cid:28)(cid:3,Unknown,15754.0
Unknown,Unknown,10,Unknown,Unknown,Unknown,Unknown,cid:3)(cid:5)(cid:14)(cid:70)(cid:12)(cid:11)(cid:4)(cid:14)(cid:11)(cid:48)(cid:48)(cid:7)(cid:5)(cid:3)(cid:9)(cid:2)(cid:12)(cid:11)(cid:4)(cid:14)(cid:11)(cid:48)(cid:48)(cid:7)(cid:5)(cid:3)(cid:9)(cid:2)(cid:28)(cid:3,Unknown,15764.0
Unknown,Unknown,5,Unknown,Unknown,Unknown,Unknown,cid:3)(cid:5)(cid:14)(cid:70)(cid:12)(cid:11)(cid:4)(cid:14)(cid:11)(cid:48)(cid:48)(cid:7)(cid:5)(cid:3)(cid:9)(cid:2)(cid:12)(cid:11)(cid:4)(cid:14)(cid:11)(cid:48)(cid:48)(cid:7)(cid:5)(cid:3)(cid:9)(cid:2)(cid:28)(cid:3,Unknown,15769.0
Unknown,Unknown,2,Unknown,Unknown,Unknown,Unknown,cid:3)(cid:5)(cid:14)(cid:70)(cid:12)(cid:11)(cid:4)(cid:14)(cid:11)(cid:48)(cid:48)(cid:7)(cid:5)(cid:3)(cid:9)(cid:2)(cid:12)(cid:11)(cid:4)(cid:14)(cid:11)(cid:48)(cid:48)(cid:7)(cid:5)(cid:3)(cid:9)(cid:2)(cid:28)(cid:3,Unknown,15771.0
Unknown,Unknown,9,Unknown,Unknown,Unknown,Unknown,cid:3)(cid:5)(cid:14)(cid:70)(cid:12)(cid:11)(cid:4)(cid:14)(cid:11)(cid:48)(cid:48)(cid:7)(cid:5)(cid:3)(cid:9)(cid:2)(cid:12)(cid:11)(cid:4)(cid:14)(cid:11)(cid:48)(cid:48)(cid:7)(cid:5)(cid:3)(cid:9)(cid:2)(cid:28)(cid:3,Unknown,15780.0
Unknown,Unknown,5,Unknown,Unknown,Unknown,Unknown,cid:3)(cid:5)(cid:14)(cid:70)(cid:12)(cid:11)(cid:4)(cid:14)(cid:11)(cid:48)(cid:48)(cid:7)(cid:5)(cid:3)(cid:9)(cid:2)(cid:12)(cid:11)(cid:4)(cid:14)(cid:11)(cid:48)(cid:48)(cid:7)(cid:5)(cid:3)(cid:9)(cid:2)(cid:28)(cid:3,Unknown,15785.0
Unknown,Unknown,8,Unknown,Unknown,Unknown,Unknown,cid:3)(cid:5)(cid:14)(cid:70)(cid:12)(cid:11)(cid:4)(cid:14)(cid:11)(cid:48)(cid:48)(cid:7)(cid:5)(cid:3)(cid:9)(cid:2)(cid:12)(cid:11)(cid:4)(cid:14)(cid:11)(cid:48)(cid:48)(cid:7)(cid:5)(cid:3)(cid:9)(cid:2)(cid:28)(cid:3,Unknown,15793.0
Unknown,Unknown,14,Unknown,Unknown,Unknown,Unknown,cid:3)(cid:5)(cid:14)(cid:70)(cid:12)(cid:11)(cid:4)(cid:14)(cid:11)(cid:48)(cid:48)(cid:7)(cid:5)(cid:3)(cid:9)(cid:2)(cid:12)(cid:11)(cid:4)(cid:14)(cid:11)(cid:48)(cid:48)(cid:7)(cid:5)(cid:3)(cid:9)(cid:2)(cid:28)(cid:3,Unknown,15807.0
Unknown,Unknown,7,Unknown,Unknown,Unknown,Unknown,cid:3)(cid:5)(cid:14)(cid:70)(cid:12)(cid:11)(cid:4)(cid:14)(cid:11)(cid:48)(cid:48)(cid:7)(cid:5)(cid:3)(cid:9)(cid:2)(cid:12)(cid:11)(cid:4)(cid:14)(cid:11)(cid:48)(cid:48)(cid:7)(cid:5)(cid:3)(cid:9)(cid:2)(cid:28)(cid:3,Unknown,15814.0
Unknown,Unknown,9,Unknown,Unknown,Unknown,Unknown,cid:3)(cid:5)(cid:14)(cid:70)(cid:12)(cid:11)(cid:4)(cid:14)(cid:11)(cid:48)(cid:48)(cid:7)(cid:5)(cid:3)(cid:9)(cid:2)(cid:12)(cid:11)(cid:4)(cid:14)(cid:11)(cid:48)(cid:48)(cid:7)(cid:5)(cid:3)(cid:9)(cid:2)(cid:28)(cid:3,Unknown,15823.0
Unknown,Unknown,2,Unknown,Unknown,Unknown,Unknown,cid:3)(cid:5)(cid:14)(cid:70)(cid:12)(cid:11)(cid:4)(cid:14)(cid:11)(cid:48)(cid:48)(cid:7)(cid:5)(cid:3)(cid:9)(cid:2)(cid:12)(cid:11)(cid:4)(cid:14)(cid:11)(cid:48)(cid:48)(cid:7)(cid:5)(cid:3)(cid:9)(cid:2)(cid:28)(cid:3,Unknown,15825.0
Unknown,Unknown,12,Unknown,Unknown,Unknown,Unknown,cid:3)(cid:5)(cid:14)(cid:70)(cid:12)(cid:11)(cid:4)(cid:14)(cid:11)(cid:48)(cid:48)(cid:7)(cid:5)(cid:3)(cid:9)(cid:2)(cid:12)(cid:11)(cid:4)(cid:14)(cid:11)(cid:48)(cid:48)(cid:7)(cid:5)(cid:3)(cid:9)(cid:2)(cid:28)(cid:3,Unknown,15837.0
Unknown,Unknown,5,Unknown,Unknown,Unknown,Unknown,cid:3)(cid:5)(cid:14)(cid:70)(cid:12)(cid:11)(cid:4)(cid:14)(cid:11)(cid:48)(cid:48)(cid:7)(cid:5)(cid:3)(cid:9)(cid:2)(cid:12)(cid:11)(cid:4)(cid:14)(cid:11)(cid:48)(cid:48)(cid:7)(cid:5)(cid:3)(cid:9)(cid:2)(cid:28)(cid:3,Unknown,15842.0
Unknown,Unknown,50,Unknown,Unknown,Unknown,Unknown,cid:3)(cid:5)(cid:14)(cid:70)(cid:12)(cid:11)(cid:4)(cid:14)(cid:11)(cid:48)(cid:48)(cid:7)(cid:5)(cid:3)(cid:9)(cid:2)(cid:12)(cid:11)(cid:4)(cid:14)(cid:11)(cid:48)(cid:48)(cid:7)(cid:5)(cid:3)(cid:9)(cid:2)(cid:28)(cid:3,Unknown,15892.0
Unknown,Unknown,5,Unknown,Unknown,Unknown,Unknown,cid:3)(cid:5)(cid:14)(cid:70)(cid:12)(cid:11)(cid:4)(cid:14)(cid:11)(cid:48)(cid:48)(cid:7)(cid:5)(cid:3)(cid:9)(cid:2)(cid:12)(cid:11)(cid:4)(cid:14)(cid:11)(cid:48)(cid:48)(cid:7)(cid:5)(cid:3)(cid:9)(cid:2)(cid:28)(cid:3,Unknown,15897.0
Unknown,Unknown,40,Unknown,Unknown,Unknown,Unknown,cid:3)(cid:5)(cid:14)(cid:70)(cid:12)(cid:11)(cid:4)(cid:14)(cid:11)(cid:48)(cid:48)(cid:7)(cid:5)(cid:3)(cid:9)(cid:2)(cid:12)(cid:11)(cid:4)(cid:14)(cid:11)(cid:48)(cid:48)(cid:7)(cid:5)(cid:3)(cid:9)(cid:2)(cid:28)(cid:3,Unknown,15937.0
Unknown,Unknown,2,Unknown,Unknown,Unknown,Unknown,cid:3)(cid:5)(cid:14)(cid:70)(cid:12)(cid:11)(cid:4)(cid:14)(cid:11)(cid:48)(cid:48)(cid:7)(cid:5)(cid:3)(cid:9)(cid:2)(cid:12)(cid:11)(cid:4)(cid:14)(cid:11)(cid:48)(cid:48)(cid:7)(cid:5)(cid:3)(cid:9)(cid:2)(cid:28)(cid:3,Unknown,15939.0
Unknown,Unknown,28,Unknown,Unknown,Unknown,Unknown,cid:3)(cid:5)(cid:14)(cid:70)(cid:12)(cid:11)(cid:4)(cid:14)(cid:11)(cid:48)(cid:48)(cid:7)(cid:5)(cid:3)(cid:9)(cid:2)(cid:12)(cid:11)(cid:4)(cid:14)(cid:11)(cid:48)(cid:48)(cid:7)(cid:5)(cid:3)(cid:9)(cid:2)(cid:28)(cid:3,Unknown,15967.0
Unknown,Unknown,3,Unknown,Unknown,Unknown,Unknown,cid:3)(cid:5)(cid:14)(cid:70)(cid:12)(cid:11)(cid:4)(cid:14)(cid:11)(cid:48)(cid:48)(cid:7)(cid:5)(cid:3)(cid:9)(cid:2)(cid:12)(cid:11)(cid:4)(cid:14)(cid:11)(cid:48)(cid:48)(cid:7)(cid:5)(cid:3)(cid:9)(cid:2)(cid:28)(cid:3,Unknown,15970.0
Unknown,Unknown,15,Unknown,Unknown,Unknown,Unknown,cid:3)(cid:5)(cid:14)(cid:70)(cid:12)(cid:11)(cid:4)(cid:14)(cid:11)(cid:48)(cid:48)(cid:7)(cid:5)(cid:3)(cid:9)(cid:2)(cid:12)(cid:11)(cid:4)(cid:14)(cid:11)(cid:48)(cid:48)(cid:7)(cid:5)(cid:3)(cid:9)(cid:2)(cid:28)(cid:3,Unknown,15985.0
Unknown,Unknown,2,Unknown,Unknown,Unknown,Unknown,cid:3)(cid:5)(cid:14)(cid:70)(cid:12)(cid:11)(cid:4)(cid:14)(cid:11)(cid:48)(cid:48)(cid:7)(cid:5)(cid:3)(cid:9)(cid:2)(cid:12)(cid:11)(cid:4)(cid:14)(cid:11)(cid:48)(cid:48)(cid:7)(cid:5)(cid:3)(cid:9)(cid:2)(cid:28)(cid:3,Unknown,15987.0
Unknown,Unknown,1,Unknown,Unknown,Unknown,Unknown,cid:3)(cid:5)(cid:14)(cid:70)(cid:12)(cid:11)(cid:4)(cid:14)(cid:11)(cid:48)(cid:48)(cid:7)(cid:5)(cid:3)(cid:9)(cid:2)(cid:12)(cid:11)(cid:4)(cid:14)(cid:11)(cid:48)(cid:48)(cid:7)(cid:5)(cid:3)(cid:9)(cid:2)(cid:28)(cid:3,Unknown,15988.0
Unknown,Unknown,19,Unknown,Unknown,Unknown,Unknown,cid:3)(cid:5)(cid:14)(cid:70)(cid:12)(cid:11)(cid:4)(cid:14)(cid:11)(cid:48)(cid:48)(cid:7)(cid:5)(cid:3)(cid:9)(cid:2)(cid:12)(cid:11)(cid:4)(cid:14)(cid:11)(cid:48)(cid:48)(cid:7)(cid:5)(cid:3)(cid:9)(cid:2)(cid:28)(cid:3,Unknown,16007.0
Unknown,Unknown,37,Unknown,Unknown,Unknown,Unknown,cid:3)(cid:5)(cid:14)(cid:70)(cid:12)(cid:11)(cid:4)(cid:14)(cid:11)(cid:48)(cid:48)(cid:7)(cid:5)(cid:3)(cid:9)(cid:2)(cid:12)(cid:11)(cid:4)(cid:14)(cid:11)(cid:48)(cid:48)(cid:7)(cid:5)(cid:3)(cid:9)(cid:2)(cid:28)(cid:3,Unknown,16044.0
Unknown,Unknown,18,Unknown,Unknown,Unknown,Unknown,cid:3)(cid:5)(cid:14)(cid:70)(cid:12)(cid:11)(cid:4)(cid:14)(cid:11)(cid:48)(cid:48)(cid:7)(cid:5)(cid:3)(cid:9)(cid:2)(cid:12)(cid:11)(cid:4)(cid:14)(cid:11)(cid:48)(cid:48)(cid:7)(cid:5)(cid:3)(cid:9)(cid:2)(cid:28)(cid:3,Unknown,16062.0
Unknown,Unknown,2,Unknown,Unknown,Unknown,Unknown,cid:3)(cid:5)(cid:14)(cid:70)(cid:12)(cid:11)(cid:4)(cid:14)(cid:11)(cid:48)(cid:48)(cid:7)(cid:5)(cid:3)(cid:9)(cid:2)(cid:12)(cid:11)(cid:4)(cid:14)(cid:11)(cid:48)(cid:48)(cid:7)(cid:5)(cid:3)(cid:9)(cid:2)(cid:28)(cid:3,Unknown,16064.0
Unknown,Unknown,44,Unknown,Unknown,Unknown,Unknown,cid:3)(cid:5)(cid:14)(cid:70)(cid:12)(cid:11)(cid:4)(cid:14)(cid:11)(cid:48)(cid:48)(cid:7)(cid:5)(cid:3)(cid:9)(cid:2)(cid:12)(cid:11)(cid:4)(cid:14)(cid:11)(cid:48)(cid:48)(cid:7)(cid:5)(cid:3)(cid:9)(cid:2)(cid:28)(cid:3,Unknown,16108.0
Unknown,Unknown,12,Unknown,Unknown,Unknown,Unknown,cid:3)(cid:5)(cid:14)(cid:70)(cid:12)(cid:11)(cid:4)(cid:14)(cid:11)(cid:48)(cid:48)(cid:7)(cid:5)(cid:3)(cid:9)(cid:2)(cid:12)(cid:11)(cid:4)(cid:14)(cid:11)(cid:48)(cid:48)(cid:7)(cid:5)(cid:3)(cid:9)(cid:2)(cid:28)(cid:3,Unknown,16120.0
Unknown,Unknown,29,Unknown,Unknown,Unknown,Unknown,cid:3)(cid:5)(cid:14)(cid:70)(cid:12)(cid:11)(cid:4)(cid:14)(cid:11)(cid:48)(cid:48)(cid:7)(cid:5)(cid:3)(cid:9)(cid:2)(cid:12)(cid:11)(cid:4)(cid:14)(cid:11)(cid:48)(cid:48)(cid:7)(cid:5)(cid:3)(cid:9)(cid:2)(cid:28)(cid:3,Unknown,16149.0
Unknown,Unknown,26,Unknown,Unknown,Unknown,Unknown,cid:3)(cid:5)(cid:14)(cid:70)(cid:12)(cid:11)(cid:4)(cid:14)(cid:11)(cid:48)(cid:48)(cid:7)(cid:5)(cid:3)(cid:9)(cid:2)(cid:12)(cid:11)(cid:4)(cid:14)(cid:11)(cid:48)(cid:48)(cid:7)(cid:5)(cid:3)(cid:9)(cid:2)(cid:28)(cid:3,Unknown,16175.0
Unknown,Unknown,41,Unknown,Unknown,Unknown,Unknown,cid:3)(cid:5)(cid:14)(cid:70)(cid:12)(cid:11)(cid:4)(cid:14)(cid:11)(cid:48)(cid:48)(cid:7)(cid:5)(cid:3)(cid:9)(cid:2)(cid:12)(cid:11)(cid:4)(cid:14)(cid:11)(cid:48)(cid:48)(cid:7)(cid:5)(cid:3)(cid:9)(cid:2)(cid:28)(cid:3,Unknown,16216.0
Unknown,Unknown,25,Unknown,Unknown,Unknown,Unknown,cid:3)(cid:5)(cid:14)(cid:70)(cid:12)(cid:11)(cid:4)(cid:14)(cid:11)(cid:48)(cid:48)(cid:7)(cid:5)(cid:3)(cid:9)(cid:2)(cid:12)(cid:11)(cid:4)(cid:14)(cid:11)(cid:48)(cid:48)(cid:7)(cid:5)(cid:3)(cid:9)(cid:2)(cid:28)(cid:3,Unknown,16241.0
Unknown,Unknown,2,Unknown,Unknown,Unknown,Unknown,cid:3)(cid:5)(cid:14)(cid:70)(cid:12)(cid:11)(cid:4)(cid:14)(cid:11)(cid:48)(cid:48)(cid:7)(cid:5)(cid:3)(cid:9)(cid:2)(cid:12)(cid:11)(cid:4)(cid:14)(cid:11)(cid:48)(cid:48)(cid:7)(cid:5)(cid:3)(cid:9)(cid:2)(cid:28)(cid:3,Unknown,16243.0
Unknown,Unknown,58,Unknown,Unknown,Unknown,Unknown,cid:3)(cid:5)(cid:14)(cid:70)(cid:12)(cid:11)(cid:4)(cid:14)(cid:11)(cid:48)(cid:48)(cid:7)(cid:5)(cid:3)(cid:9)(cid:2)(cid:12)(cid:11)(cid:4)(cid:14)(cid:11)(cid:48)(cid:48)(cid:7)(cid:5)(cid:3)(cid:9)(cid:2)(cid:28)(cid:3,Unknown,16301.0
Unknown,Unknown,58,Unknown,Unknown,Unknown,Unknown,cid:3)(cid:5)(cid:14)(cid:70)(cid:12)(cid:11)(cid:4)(cid:14)(cid:11)(cid:48)(cid:48)(cid:7)(cid:5)(cid:3)(cid:9)(cid:2)(cid:12)(cid:11)(cid:4)(cid:14)(cid:11)(cid:48)(cid:48)(cid:7)(cid:5)(cid:3)(cid:9)(cid:2)(cid:28)(cid:3,Unknown,16359.0
Unknown,Unknown,18,Unknown,Unknown,Unknown,Unknown,cid:3)(cid:5)(cid:14)(cid:70)(cid:12)(cid:11)(cid:4)(cid:14)(cid:11)(cid:48)(cid:48)(cid:7)(cid:5)(cid:3)(cid:9)(cid:2)(cid:12)(cid:11)(cid:4)(cid:14)(cid:11)(cid:48)(cid:48)(cid:7)(cid:5)(cid:3)(cid:9)(cid:2)(cid:28)(cid:3,Unknown,16377.0
Unknown,Unknown,1,Unknown,Unknown,Unknown,Unknown,cid:3)(cid:5)(cid:14)(cid:70)(cid:12)(cid:11)(cid:4)(cid:14)(cid:11)(cid:48)(cid:48)(cid:7)(cid:5)(cid:3)(cid:9)(cid:2)(cid:12)(cid:11)(cid:4)(cid:14)(cid:11)(cid:48)(cid:48)(cid:7)(cid:5)(cid:3)(cid:9)(cid:2)(cid:28)(cid:3,Unknown,16378.0
Unknown,Unknown,1,Unknown,Unknown,Unknown,Unknown,cid:3)(cid:5)(cid:14)(cid:70)(cid:12)(cid:11)(cid:4)(cid:14)(cid:11)(cid:48)(cid:48)(cid:7)(cid:5)(cid:3)(cid:9)(cid:2)(cid:12)(cid:11)(cid:4)(cid:14)(cid:11)(cid:48)(cid:48)(cid:7)(cid:5)(cid:3)(cid:9)(cid:2)(cid:28)(cid:3,Unknown,16379.0
Unknown,Unknown,37,Unknown,Unknown,Unknown,Unknown,cid:3)(cid:5)(cid:14)(cid:70)(cid:12)(cid:11)(cid:4)(cid:14)(cid:11)(cid:48)(cid:48)(cid:7)(cid:5)(cid:3)(cid:9)(cid:2)(cid:12)(cid:11)(cid:4)(cid:14)(cid:11)(cid:48)(cid:48)(cid:7)(cid:5)(cid:3)(cid:9)(cid:2)(cid:28)(cid:3,Unknown,16416.0
Unknown,Unknown,17,Unknown,Unknown,Unknown,Unknown,cid:3)(cid:5)(cid:14)(cid:70)(cid:12)(cid:11)(cid:4)(cid:14)(cid:11)(cid:48)(cid:48)(cid:7)(cid:5)(cid:3)(cid:9)(cid:2)(cid:12)(cid:11)(cid:4)(cid:14)(cid:11)(cid:48)(cid:48)(cid:7)(cid:5)(cid:3)(cid:9)(cid:2)(cid:28)(cid:3,Unknown,16433.0
Unknown,Unknown,16,Unknown,Unknown,Unknown,Unknown,cid:3)(cid:5)(cid:14)(cid:70)(cid:12)(cid:11)(cid:4)(cid:14)(cid:11)(cid:48)(cid:48)(cid:7)(cid:5)(cid:3)(cid:9)(cid:2)(cid:12)(cid:11)(cid:4)(cid:14)(cid:11)(cid:48)(cid:48)(cid:7)(cid:5)(cid:3)(cid:9)(cid:2)(cid:28)(cid:3,Unknown,16449.0
Unknown,Unknown,45,Unknown,Unknown,Unknown,Unknown,cid:3)(cid:5)(cid:14)(cid:70)(cid:12)(cid:11)(cid:4)(cid:14)(cid:11)(cid:48)(cid:48)(cid:7)(cid:5)(cid:3)(cid:9)(cid:2)(cid:12)(cid:11)(cid:4)(cid:14)(cid:11)(cid:48)(cid:48)(cid:7)(cid:5)(cid:3)(cid:9)(cid:2)(cid:28)(cid:3,Unknown,16494.0
Unknown,Unknown,18,Unknown,Unknown,Unknown,Unknown,cid:3)(cid:5)(cid:14)(cid:70)(cid:12)(cid:11)(cid:4)(cid:14)(cid:11)(cid:48)(cid:48)(cid:7)(cid:5)(cid:3)(cid:9)(cid:2)(cid:12)(cid:11)(cid:4)(cid:14)(cid:11)(cid:48)(cid:48)(cid:7)(cid:5)(cid:3)(cid:9)(cid:2)(cid:28)(cid:3,Unknown,16512.0
Unknown,Unknown,16,Unknown,Unknown,Unknown,Unknown,cid:3)(cid:5)(cid:14)(cid:70)(cid:12)(cid:11)(cid:4)(cid:14)(cid:11)(cid:48)(cid:48)(cid:7)(cid:5)(cid:3)(cid:9)(cid:2)(cid:12)(cid:11)(cid:4)(cid:14)(cid:11)(cid:48)(cid:48)(cid:7)(cid:5)(cid:3)(cid:9)(cid:2)(cid:28)(cid:3,Unknown,16528.0
Unknown,Unknown,39,Unknown,Unknown,Unknown,Unknown,cid:3)(cid:5)(cid:14)(cid:70)(cid:12)(cid:11)(cid:4)(cid:14)(cid:11)(cid:48)(cid:48)(cid:7)(cid:5)(cid:3)(cid:9)(cid:2)(cid:12)(cid:11)(cid:4)(cid:14)(cid:11)(cid:48)(cid:48)(cid:7)(cid:5)(cid:3)(cid:9)(cid:2)(cid:28)(cid:3,Unknown,16567.0
Unknown,Unknown,3,Unknown,Unknown,Unknown,Unknown,cid:3)(cid:5)(cid:14)(cid:70)(cid:12)(cid:11)(cid:4)(cid:14)(cid:11)(cid:48)(cid:48)(cid:7)(cid:5)(cid:3)(cid:9)(cid:2)(cid:12)(cid:11)(cid:4)(cid:14)(cid:11)(cid:48)(cid:48)(cid:7)(cid:5)(cid:3)(cid:9)(cid:2)(cid:28)(cid:3,Unknown,16570.0
Unknown,Unknown,7,Unknown,Unknown,Unknown,Unknown,cid:3)(cid:5)(cid:14)(cid:70)(cid:12)(cid:11)(cid:4)(cid:14)(cid:11)(cid:48)(cid:48)(cid:7)(cid:5)(cid:3)(cid:9)(cid:2)(cid:12)(cid:11)(cid:4)(cid:14)(cid:11)(cid:48)(cid:48)(cid:7)(cid:5)(cid:3)(cid:9)(cid:2)(cid:28)(cid:3,Unknown,16577.0
Unknown,Unknown,48,Unknown,Unknown,Unknown,Unknown,cid:3)(cid:5)(cid:14)(cid:70)(cid:12)(cid:11)(cid:4)(cid:14)(cid:11)(cid:48)(cid:48)(cid:7)(cid:5)(cid:3)(cid:9)(cid:2)(cid:12)(cid:11)(cid:4)(cid:14)(cid:11)(cid:48)(cid:48)(cid:7)(cid:5)(cid:3)(cid:9)(cid:2)(cid:28)(cid:3,Unknown,16625.0
Unknown,Unknown,46,Unknown,Unknown,Unknown,Unknown,cid:3)(cid:5)(cid:14)(cid:70)(cid:12)(cid:11)(cid:4)(cid:14)(cid:11)(cid:48)(cid:48)(cid:7)(cid:5)(cid:3)(cid:9)(cid:2)(cid:12)(cid:11)(cid:4)(cid:14)(cid:11)(cid:48)(cid:48)(cid:7)(cid:5)(cid:3)(cid:9)(cid:2)(cid:28)(cid:3,Unknown,16671.0
Unknown,Unknown,3,Unknown,Unknown,Unknown,Unknown,cid:3)(cid:5)(cid:14)(cid:70)(cid:12)(cid:11)(cid:4)(cid:14)(cid:11)(cid:48)(cid:48)(cid:7)(cid:5)(cid:3)(cid:9)(cid:2)(cid:12)(cid:11)(cid:4)(cid:14)(cid:11)(cid:48)(cid:48)(cid:7)(cid:5)(cid:3)(cid:9)(cid:2)(cid:28)(cid:3,Unknown,16674.0
Unknown,Unknown,65,Unknown,Unknown,Unknown,Unknown,cid:3)(cid:5)(cid:14)(cid:70)(cid:12)(cid:11)(cid:4)(cid:14)(cid:11)(cid:48)(cid:48)(cid:7)(cid:5)(cid:3)(cid:9)(cid:2)(cid:12)(cid:11)(cid:4)(cid:14)(cid:11)(cid:48)(cid:48)(cid:7)(cid:5)(cid:3)(cid:9)(cid:2)(cid:28)(cid:3,Unknown,16739.0
Unknown,Unknown,2,Unknown,Unknown,Unknown,Unknown,cid:3)(cid:5)(cid:14)(cid:70)(cid:12)(cid:11)(cid:4)(cid:14)(cid:11)(cid:48)(cid:48)(cid:7)(cid:5)(cid:3)(cid:9)(cid:2)(cid:12)(cid:11)(cid:4)(cid:14)(cid:11)(cid:48)(cid:48)(cid:7)(cid:5)(cid:3)(cid:9)(cid:2)(cid:28)(cid:3,Unknown,16741.0
Unknown,Unknown,9,Unknown,Unknown,Unknown,Unknown,cid:3)(cid:5)(cid:14)(cid:70)(cid:12)(cid:11)(cid:4)(cid:14)(cid:11)(cid:48)(cid:48)(cid:7)(cid:5)(cid:3)(cid:9)(cid:2)(cid:12)(cid:11)(cid:4)(cid:14)(cid:11)(cid:48)(cid:48)(cid:7)(cid:5)(cid:3)(cid:9)(cid:2)(cid:28)(cid:3,Unknown,16750.0
Unknown,Unknown,5,Unknown,Unknown,Unknown,Unknown,cid:3)(cid:5)(cid:14)(cid:70)(cid:12)(cid:11)(cid:4)(cid:14)(cid:11)(cid:48)(cid:48)(cid:7)(cid:5)(cid:3)(cid:9)(cid:2)(cid:12)(cid:11)(cid:4)(cid:14)(cid:11)(cid:48)(cid:48)(cid:7)(cid:5)(cid:3)(cid:9)(cid:2)(cid:28)(cid:3,Unknown,16755.0
Unknown,Unknown,3,Unknown,Unknown,Unknown,Unknown,cid:3)(cid:5)(cid:14)(cid:70)(cid:12)(cid:11)(cid:4)(cid:14)(cid:11)(cid:48)(cid:48)(cid:7)(cid:5)(cid:3)(cid:9)(cid:2)(cid:12)(cid:11)(cid:4)(cid:14)(cid:11)(cid:48)(cid:48)(cid:7)(cid:5)(cid:3)(cid:9)(cid:2)(cid:28)(cid:3,Unknown,16758.0
Unknown,Unknown,3,Unknown,Unknown,Unknown,Unknown,cid:3)(cid:5)(cid:14)(cid:70)(cid:12)(cid:11)(cid:4)(cid:14)(cid:11)(cid:48)(cid:48)(cid:7)(cid:5)(cid:3)(cid:9)(cid:2)(cid:12)(cid:11)(cid:4)(cid:14)(cid:11)(cid:48)(cid:48)(cid:7)(cid:5)(cid:3)(cid:9)(cid:2)(cid:28)(cid:3,Unknown,16761.0
Unknown,Unknown,7,Unknown,Unknown,Unknown,Unknown,cid:3)(cid:5)(cid:14)(cid:70)(cid:12)(cid:11)(cid:4)(cid:14)(cid:11)(cid:48)(cid:48)(cid:7)(cid:5)(cid:3)(cid:9)(cid:2)(cid:12)(cid:11)(cid:4)(cid:14)(cid:11)(cid:48)(cid:48)(cid:7)(cid:5)(cid:3)(cid:9)(cid:2)(cid:28)(cid:3,Unknown,16768.0
Unknown,Unknown,9,Unknown,Unknown,Unknown,Unknown,cid:3)(cid:5)(cid:14)(cid:70)(cid:12)(cid:11)(cid:4)(cid:14)(cid:11)(cid:48)(cid:48)(cid:7)(cid:5)(cid:3)(cid:9)(cid:2)(cid:12)(cid:11)(cid:4)(cid:14)(cid:11)(cid:48)(cid:48)(cid:7)(cid:5)(cid:3)(cid:9)(cid:2)(cid:28)(cid:3,Unknown,16777.0
Unknown,Unknown,2,Unknown,Unknown,Unknown,Unknown,cid:3)(cid:5)(cid:14)(cid:70)(cid:12)(cid:11)(cid:4)(cid:14)(cid:11)(cid:48)(cid:48)(cid:7)(cid:5)(cid:3)(cid:9)(cid:2)(cid:12)(cid:11)(cid:4)(cid:14)(cid:11)(cid:48)(cid:48)(cid:7)(cid:5)(cid:3)(cid:9)(cid:2)(cid:28)(cid:3,Unknown,16779.0
Unknown,Unknown,9,Unknown,Unknown,Unknown,Unknown,cid:3)(cid:5)(cid:14)(cid:70)(cid:12)(cid:11)(cid:4)(cid:14)(cid:11)(cid:48)(cid:48)(cid:7)(cid:5)(cid:3)(cid:9)(cid:2)(cid:12)(cid:11)(cid:4)(cid:14)(cid:11)(cid:48)(cid:48)(cid:7)(cid:5)(cid:3)(cid:9)(cid:2)(cid:28)(cid:3,Unknown,16788.0
Unknown,Unknown,5,Unknown,Unknown,Unknown,Unknown,cid:3)(cid:5)(cid:14)(cid:70)(cid:12)(cid:11)(cid:4)(cid:14)(cid:11)(cid:48)(cid:48)(cid:7)(cid:5)(cid:3)(cid:9)(cid:2)(cid:12)(cid:11)(cid:4)(cid:14)(cid:11)(cid:48)(cid:48)(cid:7)(cid:5)(cid:3)(cid:9)(cid:2)(cid:28)(cid:3,Unknown,16793.0
Unknown,Unknown,3,Unknown,Unknown,Unknown,Unknown,cid:3)(cid:5)(cid:14)(cid:70)(cid:12)(cid:11)(cid:4)(cid:14)(cid:11)(cid:48)(cid:48)(cid:7)(cid:5)(cid:3)(cid:9)(cid:2)(cid:12)(cid:11)(cid:4)(cid:14)(cid:11)(cid:48)(cid:48)(cid:7)(cid:5)(cid:3)(cid:9)(cid:2)(cid:28)(cid:3,Unknown,16796.0
Unknown,Unknown,3,Unknown,Unknown,Unknown,Unknown,cid:3)(cid:5)(cid:14)(cid:70)(cid:12)(cid:11)(cid:4)(cid:14)(cid:11)(cid:48)(cid:48)(cid:7)(cid:5)(cid:3)(cid:9)(cid:2)(cid:12)(cid:11)(cid:4)(cid:14)(cid:11)(cid:48)(cid:48)(cid:7)(cid:5)(cid:3)(cid:9)(cid:2)(cid:28)(cid:3,Unknown,16799.0
Unknown,Unknown,7,Unknown,Unknown,Unknown,Unknown,cid:3)(cid:5)(cid:14)(cid:70)(cid:12)(cid:11)(cid:4)(cid:14)(cid:11)(cid:48)(cid:48)(cid:7)(cid:5)(cid:3)(cid:9)(cid:2)(cid:12)(cid:11)(cid:4)(cid:14)(cid:11)(cid:48)(cid:48)(cid:7)(cid:5)(cid:3)(cid:9)(cid:2)(cid:28)(cid:3,Unknown,16806.0
Unknown,Unknown,9,Unknown,Unknown,Unknown,Unknown,cid:3)(cid:5)(cid:14)(cid:70)(cid:12)(cid:11)(cid:4)(cid:14)(cid:11)(cid:48)(cid:48)(cid:7)(cid:5)(cid:3)(cid:9)(cid:2)(cid:12)(cid:11)(cid:4)(cid:14)(cid:11)(cid:48)(cid:48)(cid:7)(cid:5)(cid:3)(cid:9)(cid:2)(cid:28)(cid:3,Unknown,16815.0
Unknown,Unknown,2,Unknown,Unknown,Unknown,Unknown,cid:3)(cid:5)(cid:14)(cid:70)(cid:12)(cid:11)(cid:4)(cid:14)(cid:11)(cid:48)(cid:48)(cid:7)(cid:5)(cid:3)(cid:9)(cid:2)(cid:12)(cid:11)(cid:4)(cid:14)(cid:11)(cid:48)(cid:48)(cid:7)(cid:5)(cid:3)(cid:9)(cid:2)(cid:28)(cid:3,Unknown,16817.0
Unknown,Unknown,28,Unknown,Unknown,Unknown,Unknown,cid:3)(cid:5)(cid:14)(cid:70)(cid:12)(cid:11)(cid:4)(cid:14)(cid:11)(cid:48)(cid:48)(cid:7)(cid:5)(cid:3)(cid:9)(cid:2)(cid:12)(cid:11)(cid:4)(cid:14)(cid:11)(cid:48)(cid:48)(cid:7)(cid:5)(cid:3)(cid:9)(cid:2)(cid:28)(cid:3,Unknown,16845.0
Unknown,Unknown,3,Unknown,Unknown,Unknown,Unknown,cid:3)(cid:5)(cid:14)(cid:70)(cid:12)(cid:11)(cid:4)(cid:14)(cid:11)(cid:48)(cid:48)(cid:7)(cid:5)(cid:3)(cid:9)(cid:2)(cid:12)(cid:11)(cid:4)(cid:14)(cid:11)(cid:48)(cid:48)(cid:7)(cid:5)(cid:3)(cid:9)(cid:2)(cid:28)(cid:3,Unknown,16848.0
Unknown,Unknown,15,Unknown,Unknown,Unknown,Unknown,cid:3)(cid:5)(cid:14)(cid:70)(cid:12)(cid:11)(cid:4)(cid:14)(cid:11)(cid:48)(cid:48)(cid:7)(cid:5)(cid:3)(cid:9)(cid:2)(cid:12)(cid:11)(cid:4)(cid:14)(cid:11)(cid:48)(cid:48)(cid:7)(cid:5)(cid:3)(cid:9)(cid:2)(cid:28)(cid:3,Unknown,16863.0
Unknown,Unknown,2,Unknown,Unknown,Unknown,Unknown,cid:3)(cid:5)(cid:14)(cid:70)(cid:12)(cid:11)(cid:4)(cid:14)(cid:11)(cid:48)(cid:48)(cid:7)(cid:5)(cid:3)(cid:9)(cid:2)(cid:12)(cid:11)(cid:4)(cid:14)(cid:11)(cid:48)(cid:48)(cid:7)(cid:5)(cid:3)(cid:9)(cid:2)(cid:28)(cid:3,Unknown,16865.0
Unknown,Unknown,17,Unknown,Unknown,Unknown,Unknown,cid:3)(cid:5)(cid:14)(cid:70)(cid:12)(cid:11)(cid:4)(cid:14)(cid:11)(cid:48)(cid:48)(cid:7)(cid:5)(cid:3)(cid:9)(cid:2)(cid:12)(cid:11)(cid:4)(cid:14)(cid:11)(cid:48)(cid:48)(cid:7)(cid:5)(cid:3)(cid:9)(cid:2)(cid:28)(cid:3,Unknown,16882.0
Unknown,Unknown,17,Unknown,Unknown,Unknown,Unknown,cid:3)(cid:5)(cid:14)(cid:70)(cid:12)(cid:11)(cid:4)(cid:14)(cid:11)(cid:48)(cid:48)(cid:7)(cid:5)(cid:3)(cid:9)(cid:2)(cid:12)(cid:11)(cid:4)(cid:14)(cid:11)(cid:48)(cid:48)(cid:7)(cid:5)(cid:3)(cid:9)(cid:2)(cid:28)(cid:3,Unknown,16899.0
Unknown,Unknown,35,Unknown,Unknown,Unknown,Unknown,cid:3)(cid:5)(cid:14)(cid:70)(cid:12)(cid:11)(cid:4)(cid:14)(cid:11)(cid:48)(cid:48)(cid:7)(cid:5)(cid:3)(cid:9)(cid:2)(cid:12)(cid:11)(cid:4)(cid:14)(cid:11)(cid:48)(cid:48)(cid:7)(cid:5)(cid:3)(cid:9)(cid:2)(cid:28)(cid:3,Unknown,16934.0
Unknown,Unknown,19,Unknown,Unknown,Unknown,Unknown,cid:3)(cid:5)(cid:14)(cid:70)(cid:12)(cid:11)(cid:4)(cid:14)(cid:11)(cid:48)(cid:48)(cid:7)(cid:5)(cid:3)(cid:9)(cid:2)(cid:12)(cid:11)(cid:4)(cid:14)(cid:11)(cid:48)(cid:48)(cid:7)(cid:5)(cid:3)(cid:9)(cid:2)(cid:28)(cid:3,Unknown,16953.0
Unknown,Unknown,34,Unknown,Unknown,Unknown,Unknown,cid:3)(cid:5)(cid:14)(cid:70)(cid:12)(cid:11)(cid:4)(cid:14)(cid:11)(cid:48)(cid:48)(cid:7)(cid:5)(cid:3)(cid:9)(cid:2)(cid:12)(cid:11)(cid:4)(cid:14)(cid:11)(cid:48)(cid:48)(cid:7)(cid:5)(cid:3)(cid:9)(cid:2)(cid:28)(cid:3,Unknown,16987.0
Unknown,Unknown,18,Unknown,Unknown,Unknown,Unknown,cid:3)(cid:5)(cid:14)(cid:70)(cid:12)(cid:11)(cid:4)(cid:14)(cid:11)(cid:48)(cid:48)(cid:7)(cid:5)(cid:3)(cid:9)(cid:2)(cid:12)(cid:11)(cid:4)(cid:14)(cid:11)(cid:48)(cid:48)(cid:7)(cid:5)(cid:3)(cid:9)(cid:2)(cid:28)(cid:3,Unknown,17005.0
Unknown,Unknown,2,Unknown,Unknown,Unknown,Unknown,cid:3)(cid:5)(cid:14)(cid:70)(cid:12)(cid:11)(cid:4)(cid:14)(cid:11)(cid:48)(cid:48)(cid:7)(cid:5)(cid:3)(cid:9)(cid:2)(cid:12)(cid:11)(cid:4)(cid:14)(cid:11)(cid:48)(cid:48)(cid:7)(cid:5)(cid:3)(cid:9)(cid:2)(cid:28)(cid:3,Unknown,17007.0
Unknown,Unknown,44,Unknown,Unknown,Unknown,Unknown,cid:3)(cid:5)(cid:14)(cid:70)(cid:12)(cid:11)(cid:4)(cid:14)(cid:11)(cid:48)(cid:48)(cid:7)(cid:5)(cid:3)(cid:9)(cid:2)(cid:12)(cid:11)(cid:4)(cid:14)(cid:11)(cid:48)(cid:48)(cid:7)(cid:5)(cid:3)(cid:9)(cid:2)(cid:28)(cid:3,Unknown,17051.0
Unknown,Unknown,12,Unknown,Unknown,Unknown,Unknown,cid:3)(cid:5)(cid:14)(cid:70)(cid:12)(cid:11)(cid:4)(cid:14)(cid:11)(cid:48)(cid:48)(cid:7)(cid:5)(cid:3)(cid:9)(cid:2)(cid:12)(cid:11)(cid:4)(cid:14)(cid:11)(cid:48)(cid:48)(cid:7)(cid:5)(cid:3)(cid:9)(cid:2)(cid:28)(cid:3,Unknown,17063.0
Unknown,Unknown,29,Unknown,Unknown,Unknown,Unknown,cid:3)(cid:5)(cid:14)(cid:70)(cid:12)(cid:11)(cid:4)(cid:14)(cid:11)(cid:48)(cid:48)(cid:7)(cid:5)(cid:3)(cid:9)(cid:2)(cid:12)(cid:11)(cid:4)(cid:14)(cid:11)(cid:48)(cid:48)(cid:7)(cid:5)(cid:3)(cid:9)(cid:2)(cid:28)(cid:3,Unknown,17092.0
Unknown,Unknown,26,Unknown,Unknown,Unknown,Unknown,cid:3)(cid:5)(cid:14)(cid:70)(cid:12)(cid:11)(cid:4)(cid:14)(cid:11)(cid:48)(cid:48)(cid:7)(cid:5)(cid:3)(cid:9)(cid:2)(cid:12)(cid:11)(cid:4)(cid:14)(cid:11)(cid:48)(cid:48)(cid:7)(cid:5)(cid:3)(cid:9)(cid:2)(cid:28)(cid:3,Unknown,17118.0
Unknown,Unknown,41,Unknown,Unknown,Unknown,Unknown,cid:3)(cid:5)(cid:14)(cid:70)(cid:12)(cid:11)(cid:4)(cid:14)(cid:11)(cid:48)(cid:48)(cid:7)(cid:5)(cid:3)(cid:9)(cid:2)(cid:12)(cid:11)(cid:4)(cid:14)(cid:11)(cid:48)(cid:48)(cid:7)(cid:5)(cid:3)(cid:9)(cid:2)(cid:28)(cid:3,Unknown,17159.0
Unknown,Unknown,25,Unknown,Unknown,Unknown,Unknown,cid:3)(cid:5)(cid:14)(cid:70)(cid:12)(cid:11)(cid:4)(cid:14)(cid:11)(cid:48)(cid:48)(cid:7)(cid:5)(cid:3)(cid:9)(cid:2)(cid:12)(cid:11)(cid:4)(cid:14)(cid:11)(cid:48)(cid:48)(cid:7)(cid:5)(cid:3)(cid:9)(cid:2)(cid:28)(cid:3,Unknown,17184.0
Unknown,Unknown,2,Unknown,Unknown,Unknown,Unknown,cid:3)(cid:5)(cid:14)(cid:70)(cid:12)(cid:11)(cid:4)(cid:14)(cid:11)(cid:48)(cid:48)(cid:7)(cid:5)(cid:3)(cid:9)(cid:2)(cid:12)(cid:11)(cid:4)(cid:14)(cid:11)(cid:48)(cid:48)(cid:7)(cid:5)(cid:3)(cid:9)(cid:2)(cid:28)(cid:3,Unknown,17186.0
Unknown,Unknown,58,Unknown,Unknown,Unknown,Unknown,cid:3)(cid:5)(cid:14)(cid:70)(cid:12)(cid:11)(cid:4)(cid:14)(cid:11)(cid:48)(cid:48)(cid:7)(cid:5)(cid:3)(cid:9)(cid:2)(cid:12)(cid:11)(cid:4)(cid:14)(cid:11)(cid:48)(cid:48)(cid:7)(cid:5)(cid:3)(cid:9)(cid:2)(cid:28)(cid:3,Unknown,17244.0
Unknown,Unknown,58,Unknown,Unknown,Unknown,Unknown,cid:3)(cid:5)(cid:14)(cid:70)(cid:12)(cid:11)(cid:4)(cid:14)(cid:11)(cid:48)(cid:48)(cid:7)(cid:5)(cid:3)(cid:9)(cid:2)(cid:12)(cid:11)(cid:4)(cid:14)(cid:11)(cid:48)(cid:48)(cid:7)(cid:5)(cid:3)(cid:9)(cid:2)(cid:28)(cid:3,Unknown,17302.0
Unknown,Unknown,37,Unknown,Unknown,Unknown,Unknown,cid:3)(cid:5)(cid:14)(cid:70)(cid:12)(cid:11)(cid:4)(cid:14)(cid:11)(cid:48)(cid:48)(cid:7)(cid:5)(cid:3)(cid:9)(cid:2)(cid:12)(cid:11)(cid:4)(cid:14)(cid:11)(cid:48)(cid:48)(cid:7)(cid:5)(cid:3)(cid:9)(cid:2)(cid:28)(cid:3,Unknown,17339.0
Unknown,Unknown,16,Unknown,Unknown,Unknown,Unknown,cid:3)(cid:5)(cid:14)(cid:70)(cid:12)(cid:11)(cid:4)(cid:14)(cid:11)(cid:48)(cid:48)(cid:7)(cid:5)(cid:3)(cid:9)(cid:2)(cid:12)(cid:11)(cid:4)(cid:14)(cid:11)(cid:48)(cid:48)(cid:7)(cid:5)(cid:3)(cid:9)(cid:2)(cid:28)(cid:3,Unknown,17355.0
Unknown,Unknown,34,Unknown,Unknown,Unknown,Unknown,cid:3)(cid:5)(cid:14)(cid:70)(cid:12)(cid:11)(cid:4)(cid:14)(cid:11)(cid:48)(cid:48)(cid:7)(cid:5)(cid:3)(cid:9)(cid:2)(cid:12)(cid:11)(cid:4)(cid:14)(cid:11)(cid:48)(cid:48)(cid:7)(cid:5)(cid:3)(cid:9)(cid:2)(cid:28)(cid:3,Unknown,17389.0
Unknown,Unknown,33,Unknown,Unknown,Unknown,Unknown,cid:3)(cid:5)(cid:14)(cid:70)(cid:12)(cid:11)(cid:4)(cid:14)(cid:11)(cid:48)(cid:48)(cid:7)(cid:5)(cid:3)(cid:9)(cid:2)(cid:12)(cid:11)(cid:4)(cid:14)(cid:11)(cid:48)(cid:48)(cid:7)(cid:5)(cid:3)(cid:9)(cid:2)(cid:28)(cid:3,Unknown,17422.0
Unknown,Unknown,17,Unknown,Unknown,Unknown,Unknown,cid:3)(cid:5)(cid:14)(cid:70)(cid:12)(cid:11)(cid:4)(cid:14)(cid:11)(cid:48)(cid:48)(cid:7)(cid:5)(cid:3)(cid:9)(cid:2)(cid:12)(cid:11)(cid:4)(cid:14)(cid:11)(cid:48)(cid:48)(cid:7)(cid:5)(cid:3)(cid:9)(cid:2)(cid:28)(cid:3,Unknown,17439.0
Unknown,Unknown,16,Unknown,Unknown,Unknown,Unknown,cid:3)(cid:5)(cid:14)(cid:70)(cid:12)(cid:11)(cid:4)(cid:14)(cid:11)(cid:48)(cid:48)(cid:7)(cid:5)(cid:3)(cid:9)(cid:2)(cid:12)(cid:11)(cid:4)(cid:14)(cid:11)(cid:48)(cid:48)(cid:7)(cid:5)(cid:3)(cid:9)(cid:2)(cid:28)(cid:3,Unknown,17455.0
Unknown,Unknown,45,Unknown,Unknown,Unknown,Unknown,cid:3)(cid:5)(cid:14)(cid:70)(cid:12)(cid:11)(cid:4)(cid:14)(cid:11)(cid:48)(cid:48)(cid:7)(cid:5)(cid:3)(cid:9)(cid:2)(cid:12)(cid:11)(cid:4)(cid:14)(cid:11)(cid:48)(cid:48)(cid:7)(cid:5)(cid:3)(cid:9)(cid:2)(cid:28)(cid:3,Unknown,17500.0
Unknown,Unknown,18,Unknown,Unknown,Unknown,Unknown,cid:3)(cid:5)(cid:14)(cid:70)(cid:12)(cid:11)(cid:4)(cid:14)(cid:11)(cid:48)(cid:48)(cid:7)(cid:5)(cid:3)(cid:9)(cid:2)(cid:12)(cid:11)(cid:4)(cid:14)(cid:11)(cid:48)(cid:48)(cid:7)(cid:5)(cid:3)(cid:9)(cid:2)(cid:28)(cid:3,Unknown,17518.0
Unknown,Unknown,16,Unknown,Unknown,Unknown,Unknown,cid:3)(cid:5)(cid:14)(cid:70)(cid:12)(cid:11)(cid:4)(cid:14)(cid:11)(cid:48)(cid:48)(cid:7)(cid:5)(cid:3)(cid:9)(cid:2)(cid:12)(cid:11)(cid:4)(cid:14)(cid:11)(cid:48)(cid:48)(cid:7)(cid:5)(cid:3)(cid:9)(cid:2)(cid:28)(cid:3,Unknown,17534.0
Unknown,Unknown,14,Unknown,Unknown,Unknown,Unknown,cid:3)(cid:5)(cid:14)(cid:70)(cid:12)(cid:11)(cid:4)(cid:14)(cid:11)(cid:48)(cid:48)(cid:7)(cid:5)(cid:3)(cid:9)(cid:2)(cid:12)(cid:11)(cid:4)(cid:14)(cid:11)(cid:48)(cid:48)(cid:7)(cid:5)(cid:3)(cid:9)(cid:2)(cid:28)(cid:3,Unknown,17548.0
Unknown,Unknown,5,Unknown,Unknown,Unknown,Unknown,cid:3)(cid:5)(cid:14)(cid:70)(cid:12)(cid:11)(cid:4)(cid:14)(cid:11)(cid:48)(cid:48)(cid:7)(cid:5)(cid:3)(cid:9)(cid:2)(cid:12)(cid:11)(cid:4)(cid:14)(cid:11)(cid:48)(cid:48)(cid:7)(cid:5)(cid:3)(cid:9)(cid:2)(cid:28)(cid:3,Unknown,17553.0
Unknown,Unknown,12,Unknown,Unknown,Unknown,Unknown,cid:3)(cid:5)(cid:14)(cid:70)(cid:12)(cid:11)(cid:4)(cid:14)(cid:11)(cid:48)(cid:48)(cid:7)(cid:5)(cid:3)(cid:9)(cid:2)(cid:12)(cid:11)(cid:4)(cid:14)(cid:11)(cid:48)(cid:48)(cid:7)(cid:5)(cid:3)(cid:9)(cid:2)(cid:28)(cid:3,Unknown,17565.0
Unknown,Unknown,14,Unknown,Unknown,Unknown,Unknown,cid:3)(cid:5)(cid:14)(cid:70)(cid:12)(cid:11)(cid:4)(cid:14)(cid:11)(cid:48)(cid:48)(cid:7)(cid:5)(cid:3)(cid:9)(cid:2)(cid:12)(cid:11)(cid:4)(cid:14)(cid:11)(cid:48)(cid:48)(cid:7)(cid:5)(cid:3)(cid:9)(cid:2)(cid:28)(cid:3,Unknown,17579.0
Unknown,Unknown,5,Unknown,Unknown,Unknown,Unknown,cid:3)(cid:5)(cid:14)(cid:70)(cid:12)(cid:11)(cid:4)(cid:14)(cid:11)(cid:48)(cid:48)(cid:7)(cid:5)(cid:3)(cid:9)(cid:2)(cid:12)(cid:11)(cid:4)(cid:14)(cid:11)(cid:48)(cid:48)(cid:7)(cid:5)(cid:3)(cid:9)(cid:2)(cid:28)(cid:3,Unknown,17584.0
Unknown,Unknown,3,Unknown,Unknown,Unknown,Unknown,cid:3)(cid:5)(cid:14)(cid:70)(cid:12)(cid:11)(cid:4)(cid:14)(cid:11)(cid:48)(cid:48)(cid:7)(cid:5)(cid:3)(cid:9)(cid:2)(cid:12)(cid:11)(cid:4)(cid:14)(cid:11)(cid:48)(cid:48)(cid:7)(cid:5)(cid:3)(cid:9)(cid:2)(cid:28)(cid:3,Unknown,17587.0
Unknown,Unknown,12,Unknown,Unknown,Unknown,Unknown,cid:3)(cid:5)(cid:14)(cid:70)(cid:12)(cid:11)(cid:4)(cid:14)(cid:11)(cid:48)(cid:48)(cid:7)(cid:5)(cid:3)(cid:9)(cid:2)(cid:12)(cid:11)(cid:4)(cid:14)(cid:11)(cid:48)(cid:48)(cid:7)(cid:5)(cid:3)(cid:9)(cid:2)(cid:28)(cid:3,Unknown,17599.0
Unknown,Unknown,2,Unknown,Unknown,Unknown,Unknown,cid:3)(cid:5)(cid:14)(cid:70)(cid:12)(cid:11)(cid:4)(cid:14)(cid:11)(cid:48)(cid:48)(cid:7)(cid:5)(cid:3)(cid:9)(cid:2)(cid:12)(cid:11)(cid:4)(cid:14)(cid:11)(cid:48)(cid:48)(cid:7)(cid:5)(cid:3)(cid:9)(cid:2)(cid:28)(cid:3,Unknown,17601.0
Unknown,Unknown,50,Unknown,Unknown,Unknown,Unknown,cid:3)(cid:5)(cid:14)(cid:70)(cid:12)(cid:11)(cid:4)(cid:14)(cid:11)(cid:48)(cid:48)(cid:7)(cid:5)(cid:3)(cid:9)(cid:2)(cid:12)(cid:11)(cid:4)(cid:14)(cid:11)(cid:48)(cid:48)(cid:7)(cid:5)(cid:3)(cid:9)(cid:2)(cid:28)(cid:3,Unknown,17651.0
Unknown,Unknown,7,Unknown,Unknown,Unknown,Unknown,cid:3)(cid:5)(cid:14)(cid:70)(cid:12)(cid:11)(cid:4)(cid:14)(cid:11)(cid:48)(cid:48)(cid:7)(cid:5)(cid:3)(cid:9)(cid:2)(cid:12)(cid:11)(cid:4)(cid:14)(cid:11)(cid:48)(cid:48)(cid:7)(cid:5)(cid:3)(cid:9)(cid:2)(cid:28)(cid:3,Unknown,17658.0
Unknown,Unknown,9,Unknown,Unknown,Unknown,Unknown,cid:3)(cid:5)(cid:14)(cid:70)(cid:12)(cid:11)(cid:4)(cid:14)(cid:11)(cid:48)(cid:48)(cid:7)(cid:5)(cid:3)(cid:9)(cid:2)(cid:12)(cid:11)(cid:4)(cid:14)(cid:11)(cid:48)(cid:48)(cid:7)(cid:5)(cid:3)(cid:9)(cid:2)(cid:28)(cid:3,Unknown,17667.0
Unknown,Unknown,10,Unknown,Unknown,Unknown,Unknown,cid:3)(cid:5)(cid:14)(cid:70)(cid:12)(cid:11)(cid:4)(cid:14)(cid:11)(cid:48)(cid:48)(cid:7)(cid:5)(cid:3)(cid:9)(cid:2)(cid:12)(cid:11)(cid:4)(cid:14)(cid:11)(cid:48)(cid:48)(cid:7)(cid:5)(cid:3)(cid:9)(cid:2)(cid:28)(cid:3,Unknown,17677.0
Unknown,Unknown,3,Unknown,Unknown,Unknown,Unknown,cid:3)(cid:5)(cid:14)(cid:70)(cid:12)(cid:11)(cid:4)(cid:14)(cid:11)(cid:48)(cid:48)(cid:7)(cid:5)(cid:3)(cid:9)(cid:2)(cid:12)(cid:11)(cid:4)(cid:14)(cid:11)(cid:48)(cid:48)(cid:7)(cid:5)(cid:3)(cid:9)(cid:2)(cid:28)(cid:3,Unknown,17680.0
Unknown,Unknown,2,Unknown,Unknown,Unknown,Unknown,cid:3)(cid:5)(cid:14)(cid:70)(cid:12)(cid:11)(cid:4)(cid:14)(cid:11)(cid:48)(cid:48)(cid:7)(cid:5)(cid:3)(cid:9)(cid:2)(cid:12)(cid:11)(cid:4)(cid:14)(cid:11)(cid:48)(cid:48)(cid:7)(cid:5)(cid:3)(cid:9)(cid:2)(cid:28)(cid:3,Unknown,17682.0
Unknown,Unknown,12,Unknown,Unknown,Unknown,Unknown,cid:3)(cid:5)(cid:14)(cid:70)(cid:12)(cid:11)(cid:4)(cid:14)(cid:11)(cid:48)(cid:48)(cid:7)(cid:5)(cid:3)(cid:9)(cid:2)(cid:12)(cid:11)(cid:4)(cid:14)(cid:11)(cid:48)(cid:48)(cid:7)(cid:5)(cid:3)(cid:9)(cid:2)(cid:28)(cid:3,Unknown,17694.0
Unknown,Unknown,11,Unknown,Unknown,Unknown,Unknown,cid:3)(cid:5)(cid:14)(cid:70)(cid:12)(cid:11)(cid:4)(cid:14)(cid:11)(cid:48)(cid:48)(cid:7)(cid:5)(cid:3)(cid:9)(cid:2)(cid:12)(cid:11)(cid:4)(cid:14)(cid:11)(cid:48)(cid:48)(cid:7)(cid:5)(cid:3)(cid:9)(cid:2)(cid:28)(cid:3,Unknown,17705.0
Unknown,Unknown,4,Unknown,Unknown,Unknown,Unknown,cid:3)(cid:5)(cid:14)(cid:70)(cid:12)(cid:11)(cid:4)(cid:14)(cid:11)(cid:48)(cid:48)(cid:7)(cid:5)(cid:3)(cid:9)(cid:2)(cid:12)(cid:11)(cid:4)(cid:14)(cid:11)(cid:48)(cid:48)(cid:7)(cid:5)(cid:3)(cid:9)(cid:2)(cid:28)(cid:3,Unknown,17709.0
Unknown,Unknown,14,Unknown,Unknown,Unknown,Unknown,cid:3)(cid:5)(cid:14)(cid:70)(cid:12)(cid:11)(cid:4)(cid:14)(cid:11)(cid:48)(cid:48)(cid:7)(cid:5)(cid:3)(cid:9)(cid:2)(cid:12)(cid:11)(cid:4)(cid:14)(cid:11)(cid:48)(cid:48)(cid:7)(cid:5)(cid:3)(cid:9)(cid:2)(cid:28)(cid:3,Unknown,17723.0
Unknown,Unknown,11,Unknown,Unknown,Unknown,Unknown,cid:3)(cid:5)(cid:14)(cid:70)(cid:12)(cid:11)(cid:4)(cid:14)(cid:11)(cid:48)(cid:48)(cid:7)(cid:5)(cid:3)(cid:9)(cid:2)(cid:12)(cid:11)(cid:4)(cid:14)(cid:11)(cid:48)(cid:48)(cid:7)(cid:5)(cid:3)(cid:9)(cid:2)(cid:28)(cid:3,Unknown,17734.0
Unknown,Unknown,48,Unknown,Unknown,Unknown,Unknown,cid:3)(cid:5)(cid:14)(cid:70)(cid:12)(cid:11)(cid:4)(cid:14)(cid:11)(cid:48)(cid:48)(cid:7)(cid:5)(cid:3)(cid:9)(cid:2)(cid:12)(cid:11)(cid:4)(cid:14)(cid:11)(cid:48)(cid:48)(cid:7)(cid:5)(cid:3)(cid:9)(cid:2)(cid:28)(cid:3,Unknown,17782.0
Unknown,Unknown,48,Unknown,Unknown,Unknown,Unknown,cid:3)(cid:5)(cid:14)(cid:70)(cid:12)(cid:11)(cid:4)(cid:14)(cid:11)(cid:48)(cid:48)(cid:7)(cid:5)(cid:3)(cid:9)(cid:2)(cid:12)(cid:11)(cid:4)(cid:14)(cid:11)(cid:48)(cid:48)(cid:7)(cid:5)(cid:3)(cid:9)(cid:2)(cid:28)(cid:3,Unknown,17830.0
Unknown,Unknown,7,Unknown,Unknown,Unknown,Unknown,cid:3)(cid:5)(cid:14)(cid:70)(cid:12)(cid:11)(cid:4)(cid:14)(cid:11)(cid:48)(cid:48)(cid:7)(cid:5)(cid:3)(cid:9)(cid:2)(cid:12)(cid:11)(cid:4)(cid:14)(cid:11)(cid:48)(cid:48)(cid:7)(cid:5)(cid:3)(cid:9)(cid:2)(cid:28)(cid:3,Unknown,17837.0
Unknown,Unknown,5,Unknown,Unknown,Unknown,Unknown,cid:3)(cid:5)(cid:14)(cid:70)(cid:12)(cid:11)(cid:4)(cid:14)(cid:11)(cid:48)(cid:48)(cid:7)(cid:5)(cid:3)(cid:9)(cid:2)(cid:12)(cid:11)(cid:4)(cid:14)(cid:11)(cid:48)(cid:48)(cid:7)(cid:5)(cid:3)(cid:9)(cid:2)(cid:28)(cid:3,Unknown,17842.0
Unknown,Unknown,3,Unknown,Unknown,Unknown,Unknown,cid:3)(cid:5)(cid:14)(cid:70)(cid:12)(cid:11)(cid:4)(cid:14)(cid:11)(cid:48)(cid:48)(cid:7)(cid:5)(cid:3)(cid:9)(cid:2)(cid:12)(cid:11)(cid:4)(cid:14)(cid:11)(cid:48)(cid:48)(cid:7)(cid:5)(cid:3)(cid:9)(cid:2)(cid:28)(cid:3,Unknown,17845.0
Unknown,Unknown,2,Unknown,Unknown,Unknown,Unknown,cid:3)(cid:5)(cid:14)(cid:70)(cid:12)(cid:11)(cid:4)(cid:14)(cid:11)(cid:48)(cid:48)(cid:7)(cid:5)(cid:3)(cid:9)(cid:2)(cid:12)(cid:11)(cid:4)(cid:14)(cid:11)(cid:48)(cid:48)(cid:7)(cid:5)(cid:3)(cid:9)(cid:2)(cid:28)(cid:3,Unknown,17847.0
Unknown,Unknown,28,Unknown,Unknown,Unknown,Unknown,cid:3)(cid:5)(cid:14)(cid:70)(cid:12)(cid:11)(cid:4)(cid:14)(cid:11)(cid:48)(cid:48)(cid:7)(cid:5)(cid:3)(cid:9)(cid:2)(cid:12)(cid:11)(cid:4)(cid:14)(cid:11)(cid:48)(cid:48)(cid:7)(cid:5)(cid:3)(cid:9)(cid:2)(cid:28)(cid:3,Unknown,17875.0
Unknown,Unknown,3,Unknown,Unknown,Unknown,Unknown,cid:3)(cid:5)(cid:14)(cid:70)(cid:12)(cid:11)(cid:4)(cid:14)(cid:11)(cid:48)(cid:48)(cid:7)(cid:5)(cid:3)(cid:9)(cid:2)(cid:12)(cid:11)(cid:4)(cid:14)(cid:11)(cid:48)(cid:48)(cid:7)(cid:5)(cid:3)(cid:9)(cid:2)(cid:28)(cid:3,Unknown,17878.0
Unknown,Unknown,15,Unknown,Unknown,Unknown,Unknown,cid:3)(cid:5)(cid:14)(cid:70)(cid:12)(cid:11)(cid:4)(cid:14)(cid:11)(cid:48)(cid:48)(cid:7)(cid:5)(cid:3)(cid:9)(cid:2)(cid:12)(cid:11)(cid:4)(cid:14)(cid:11)(cid:48)(cid:48)(cid:7)(cid:5)(cid:3)(cid:9)(cid:2)(cid:28)(cid:3,Unknown,17893.0
Unknown,Unknown,2,Unknown,Unknown,Unknown,Unknown,cid:3)(cid:5)(cid:14)(cid:70)(cid:12)(cid:11)(cid:4)(cid:14)(cid:11)(cid:48)(cid:48)(cid:7)(cid:5)(cid:3)(cid:9)(cid:2)(cid:12)(cid:11)(cid:4)(cid:14)(cid:11)(cid:48)(cid:48)(cid:7)(cid:5)(cid:3)(cid:9)(cid:2)(cid:28)(cid:3,Unknown,17895.0
Unknown,Unknown,17,Unknown,Unknown,Unknown,Unknown,cid:3)(cid:5)(cid:14)(cid:70)(cid:12)(cid:11)(cid:4)(cid:14)(cid:11)(cid:48)(cid:48)(cid:7)(cid:5)(cid:3)(cid:9)(cid:2)(cid:12)(cid:11)(cid:4)(cid:14)(cid:11)(cid:48)(cid:48)(cid:7)(cid:5)(cid:3)(cid:9)(cid:2)(cid:28)(cid:3,Unknown,17912.0
Unknown,Unknown,18,Unknown,Unknown,Unknown,Unknown,cid:3)(cid:5)(cid:14)(cid:70)(cid:12)(cid:11)(cid:4)(cid:14)(cid:11)(cid:48)(cid:48)(cid:7)(cid:5)(cid:3)(cid:9)(cid:2)(cid:12)(cid:11)(cid:4)(cid:14)(cid:11)(cid:48)(cid:48)(cid:7)(cid:5)(cid:3)(cid:9)(cid:2)(cid:28)(cid:3,Unknown,17930.0
Unknown,Unknown,18,Unknown,Unknown,Unknown,Unknown,cid:3)(cid:5)(cid:14)(cid:70)(cid:12)(cid:11)(cid:4)(cid:14)(cid:11)(cid:48)(cid:48)(cid:7)(cid:5)(cid:3)(cid:9)(cid:2)(cid:12)(cid:11)(cid:4)(cid:14)(cid:11)(cid:48)(cid:48)(cid:7)(cid:5)(cid:3)(cid:9)(cid:2)(cid:28)(cid:3,Unknown,17948.0
Unknown,Unknown,19,Unknown,Unknown,Unknown,Unknown,cid:3)(cid:5)(cid:14)(cid:70)(cid:12)(cid:11)(cid:4)(cid:14)(cid:11)(cid:48)(cid:48)(cid:7)(cid:5)(cid:3)(cid:9)(cid:2)(cid:12)(cid:11)(cid:4)(cid:14)(cid:11)(cid:48)(cid:48)(cid:7)(cid:5)(cid:3)(cid:9)(cid:2)(cid:28)(cid:3,Unknown,17967.0
Unknown,Unknown,18,Unknown,Unknown,Unknown,Unknown,cid:3)(cid:5)(cid:14)(cid:70)(cid:12)(cid:11)(cid:4)(cid:14)(cid:11)(cid:48)(cid:48)(cid:7)(cid:5)(cid:3)(cid:9)(cid:2)(cid:12)(cid:11)(cid:4)(cid:14)(cid:11)(cid:48)(cid:48)(cid:7)(cid:5)(cid:3)(cid:9)(cid:2)(cid:28)(cid:3,Unknown,17985.0
Unknown,Unknown,18,Unknown,Unknown,Unknown,Unknown,cid:3)(cid:5)(cid:14)(cid:70)(cid:12)(cid:11)(cid:4)(cid:14)(cid:11)(cid:48)(cid:48)(cid:7)(cid:5)(cid:3)(cid:9)(cid:2)(cid:12)(cid:11)(cid:4)(cid:14)(cid:11)(cid:48)(cid:48)(cid:7)(cid:5)(cid:3)(cid:9)(cid:2)(cid:28)(cid:3,Unknown,18003.0
Unknown,Unknown,2,Unknown,Unknown,Unknown,Unknown,cid:3)(cid:5)(cid:14)(cid:70)(cid:12)(cid:11)(cid:4)(cid:14)(cid:11)(cid:48)(cid:48)(cid:7)(cid:5)(cid:3)(cid:9)(cid:2)(cid:12)(cid:11)(cid:4)(cid:14)(cid:11)(cid:48)(cid:48)(cid:7)(cid:5)(cid:3)(cid:9)(cid:2)(cid:28)(cid:3,Unknown,18005.0
Unknown,Unknown,44,Unknown,Unknown,Unknown,Unknown,cid:3)(cid:5)(cid:14)(cid:70)(cid:12)(cid:11)(cid:4)(cid:14)(cid:11)(cid:48)(cid:48)(cid:7)(cid:5)(cid:3)(cid:9)(cid:2)(cid:12)(cid:11)(cid:4)(cid:14)(cid:11)(cid:48)(cid:48)(cid:7)(cid:5)(cid:3)(cid:9)(cid:2)(cid:28)(cid:3,Unknown,18049.0
Unknown,Unknown,12,Unknown,Unknown,Unknown,Unknown,cid:3)(cid:5)(cid:14)(cid:70)(cid:12)(cid:11)(cid:4)(cid:14)(cid:11)(cid:48)(cid:48)(cid:7)(cid:5)(cid:3)(cid:9)(cid:2)(cid:12)(cid:11)(cid:4)(cid:14)(cid:11)(cid:48)(cid:48)(cid:7)(cid:5)(cid:3)(cid:9)(cid:2)(cid:28)(cid:3,Unknown,18061.0
Unknown,Unknown,29,Unknown,Unknown,Unknown,Unknown,cid:3)(cid:5)(cid:14)(cid:70)(cid:12)(cid:11)(cid:4)(cid:14)(cid:11)(cid:48)(cid:48)(cid:7)(cid:5)(cid:3)(cid:9)(cid:2)(cid:12)(cid:11)(cid:4)(cid:14)(cid:11)(cid:48)(cid:48)(cid:7)(cid:5)(cid:3)(cid:9)(cid:2)(cid:28)(cid:3,Unknown,18090.0
Unknown,Unknown,26,Unknown,Unknown,Unknown,Unknown,cid:3)(cid:5)(cid:14)(cid:70)(cid:12)(cid:11)(cid:4)(cid:14)(cid:11)(cid:48)(cid:48)(cid:7)(cid:5)(cid:3)(cid:9)(cid:2)(cid:12)(cid:11)(cid:4)(cid:14)(cid:11)(cid:48)(cid:48)(cid:7)(cid:5)(cid:3)(cid:9)(cid:2)(cid:28)(cid:3,Unknown,18116.0
Unknown,Unknown,41,Unknown,Unknown,Unknown,Unknown,cid:3)(cid:5)(cid:14)(cid:70)(cid:12)(cid:11)(cid:4)(cid:14)(cid:11)(cid:48)(cid:48)(cid:7)(cid:5)(cid:3)(cid:9)(cid:2)(cid:12)(cid:11)(cid:4)(cid:14)(cid:11)(cid:48)(cid:48)(cid:7)(cid:5)(cid:3)(cid:9)(cid:2)(cid:28)(cid:3,Unknown,18157.0
Unknown,Unknown,25,Unknown,Unknown,Unknown,Unknown,cid:3)(cid:5)(cid:14)(cid:70)(cid:12)(cid:11)(cid:4)(cid:14)(cid:11)(cid:48)(cid:48)(cid:7)(cid:5)(cid:3)(cid:9)(cid:2)(cid:12)(cid:11)(cid:4)(cid:14)(cid:11)(cid:48)(cid:48)(cid:7)(cid:5)(cid:3)(cid:9)(cid:2)(cid:28)(cid:3,Unknown,18182.0
Unknown,Unknown,2,Unknown,Unknown,Unknown,Unknown,cid:3)(cid:5)(cid:14)(cid:70)(cid:12)(cid:11)(cid:4)(cid:14)(cid:11)(cid:48)(cid:48)(cid:7)(cid:5)(cid:3)(cid:9)(cid:2)(cid:12)(cid:11)(cid:4)(cid:14)(cid:11)(cid:48)(cid:48)(cid:7)(cid:5)(cid:3)(cid:9)(cid:2)(cid:28)(cid:3,Unknown,18184.0
Unknown,Unknown,58,Unknown,Unknown,Unknown,Unknown,cid:3)(cid:5)(cid:14)(cid:70)(cid:12)(cid:11)(cid:4)(cid:14)(cid:11)(cid:48)(cid:48)(cid:7)(cid:5)(cid:3)(cid:9)(cid:2)(cid:12)(cid:11)(cid:4)(cid:14)(cid:11)(cid:48)(cid:48)(cid:7)(cid:5)(cid:3)(cid:9)(cid:2)(cid:28)(cid:3,Unknown,18242.0
Unknown,Unknown,58,Unknown,Unknown,Unknown,Unknown,cid:3)(cid:5)(cid:14)(cid:70)(cid:12)(cid:11)(cid:4)(cid:14)(cid:11)(cid:48)(cid:48)(cid:7)(cid:5)(cid:3)(cid:9)(cid:2)(cid:12)(cid:11)(cid:4)(cid:14)(cid:11)(cid:48)(cid:48)(cid:7)(cid:5)(cid:3)(cid:9)(cid:2)(cid:28)(cid:3,Unknown,18300.0
Unknown,Unknown,37,Unknown,Unknown,Unknown,Unknown,cid:3)(cid:5)(cid:14)(cid:70)(cid:12)(cid:11)(cid:4)(cid:14)(cid:11)(cid:48)(cid:48)(cid:7)(cid:5)(cid:3)(cid:9)(cid:2)(cid:12)(cid:11)(cid:4)(cid:14)(cid:11)(cid:48)(cid:48)(cid:7)(cid:5)(cid:3)(cid:9)(cid:2)(cid:28)(cid:3,Unknown,18337.0
Unknown,Unknown,16,Unknown,Unknown,Unknown,Unknown,cid:3)(cid:5)(cid:14)(cid:70)(cid:12)(cid:11)(cid:4)(cid:14)(cid:11)(cid:48)(cid:48)(cid:7)(cid:5)(cid:3)(cid:9)(cid:2)(cid:12)(cid:11)(cid:4)(cid:14)(cid:11)(cid:48)(cid:48)(cid:7)(cid:5)(cid:3)(cid:9)(cid:2)(cid:28)(cid:3,Unknown,18353.0
Unknown,Unknown,34,Unknown,Unknown,Unknown,Unknown,cid:3)(cid:5)(cid:14)(cid:70)(cid:12)(cid:11)(cid:4)(cid:14)(cid:11)(cid:48)(cid:48)(cid:7)(cid:5)(cid:3)(cid:9)(cid:2)(cid:12)(cid:11)(cid:4)(cid:14)(cid:11)(cid:48)(cid:48)(cid:7)(cid:5)(cid:3)(cid:9)(cid:2)(cid:28)(cid:3,Unknown,18387.0
Unknown,Unknown,33,Unknown,Unknown,Unknown,Unknown,cid:3)(cid:5)(cid:14)(cid:70)(cid:12)(cid:11)(cid:4)(cid:14)(cid:11)(cid:48)(cid:48)(cid:7)(cid:5)(cid:3)(cid:9)(cid:2)(cid:12)(cid:11)(cid:4)(cid:14)(cid:11)(cid:48)(cid:48)(cid:7)(cid:5)(cid:3)(cid:9)(cid:2)(cid:28)(cid:3,Unknown,18420.0
Unknown,Unknown,17,Unknown,Unknown,Unknown,Unknown,cid:3)(cid:5)(cid:14)(cid:70)(cid:12)(cid:11)(cid:4)(cid:14)(cid:11)(cid:48)(cid:48)(cid:7)(cid:5)(cid:3)(cid:9)(cid:2)(cid:12)(cid:11)(cid:4)(cid:14)(cid:11)(cid:48)(cid:48)(cid:7)(cid:5)(cid:3)(cid:9)(cid:2)(cid:28)(cid:3,Unknown,18437.0
Unknown,Unknown,35,Unknown,Unknown,Unknown,Unknown,cid:3)(cid:5)(cid:14)(cid:70)(cid:12)(cid:11)(cid:4)(cid:14)(cid:11)(cid:48)(cid:48)(cid:7)(cid:5)(cid:3)(cid:9)(cid:2)(cid:12)(cid:11)(cid:4)(cid:14)(cid:11)(cid:48)(cid:48)(cid:7)(cid:5)(cid:3)(cid:9)(cid:2)(cid:28)(cid:3,Unknown,18472.0
Unknown,Unknown,45,Unknown,Unknown,Unknown,Unknown,cid:3)(cid:5)(cid:14)(cid:70)(cid:12)(cid:11)(cid:4)(cid:14)(cid:11)(cid:48)(cid:48)(cid:7)(cid:5)(cid:3)(cid:9)(cid:2)(cid:12)(cid:11)(cid:4)(cid:14)(cid:11)(cid:48)(cid:48)(cid:7)(cid:5)(cid:3)(cid:9)(cid:2)(cid:28)(cid:3,Unknown,18517.0
Unknown,Unknown,18,Unknown,Unknown,Unknown,Unknown,cid:3)(cid:5)(cid:14)(cid:70)(cid:12)(cid:11)(cid:4)(cid:14)(cid:11)(cid:48)(cid:48)(cid:7)(cid:5)(cid:3)(cid:9)(cid:2)(cid:12)(cid:11)(cid:4)(cid:14)(cid:11)(cid:48)(cid:48)(cid:7)(cid:5)(cid:3)(cid:9)(cid:2)(cid:28)(cid:3,Unknown,18535.0
Unknown,Unknown,16,Unknown,Unknown,Unknown,Unknown,cid:3)(cid:5)(cid:14)(cid:70)(cid:12)(cid:11)(cid:4)(cid:14)(cid:11)(cid:48)(cid:48)(cid:7)(cid:5)(cid:3)(cid:9)(cid:2)(cid:12)(cid:11)(cid:4)(cid:14)(cid:11)(cid:48)(cid:48)(cid:7)(cid:5)(cid:3)(cid:9)(cid:2)(cid:28)(cid:3,Unknown,18551.0
Unknown,Unknown,10,Unknown,Unknown,Unknown,Unknown,cid:3)(cid:5)(cid:14)(cid:70)(cid:12)(cid:11)(cid:4)(cid:14)(cid:11)(cid:48)(cid:48)(cid:7)(cid:5)(cid:3)(cid:9)(cid:2)(cid:12)(cid:11)(cid:4)(cid:14)(cid:11)(cid:48)(cid:48)(cid:7)(cid:5)(cid:3)(cid:9)(cid:2)(cid:28)(cid:3,Unknown,18561.0
Unknown,Unknown,11,Unknown,Unknown,Unknown,Unknown,cid:3)(cid:5)(cid:14)(cid:70)(cid:12)(cid:11)(cid:4)(cid:14)(cid:11)(cid:48)(cid:48)(cid:7)(cid:5)(cid:3)(cid:9)(cid:2)(cid:12)(cid:11)(cid:4)(cid:14)(cid:11)(cid:48)(cid:48)(cid:7)(cid:5)(cid:3)(cid:9)(cid:2)(cid:28)(cid:3,Unknown,18572.0
Unknown,Unknown,10,Unknown,Unknown,Unknown,Unknown,cid:3)(cid:5)(cid:14)(cid:70)(cid:12)(cid:11)(cid:4)(cid:14)(cid:11)(cid:48)(cid:48)(cid:7)(cid:5)(cid:3)(cid:9)(cid:2)(cid:12)(cid:11)(cid:4)(cid:14)(cid:11)(cid:48)(cid:48)(cid:7)(cid:5)(cid:3)(cid:9)(cid:2)(cid:28)(cid:3,Unknown,18582.0
Unknown,Unknown,46,Unknown,Unknown,Unknown,Unknown,cid:3)(cid:5)(cid:14)(cid:70)(cid:12)(cid:11)(cid:4)(cid:14)(cid:11)(cid:48)(cid:48)(cid:7)(cid:5)(cid:3)(cid:9)(cid:2)(cid:12)(cid:11)(cid:4)(cid:14)(cid:11)(cid:48)(cid:48)(cid:7)(cid:5)(cid:3)(cid:9)(cid:2)(cid:28)(cid:3,Unknown,18628.0
Unknown,Unknown,14,Unknown,Unknown,Unknown,Unknown,cid:3)(cid:5)(cid:14)(cid:70)(cid:12)(cid:11)(cid:4)(cid:14)(cid:11)(cid:48)(cid:48)(cid:7)(cid:5)(cid:3)(cid:9)(cid:2)(cid:12)(cid:11)(cid:4)(cid:14)(cid:11)(cid:48)(cid:48)(cid:7)(cid:5)(cid:3)(cid:9)(cid:2)(cid:28)(cid:3,Unknown,18642.0
Unknown,Unknown,2,Unknown,Unknown,Unknown,Unknown,cid:3)(cid:5)(cid:14)(cid:70)(cid:12)(cid:11)(cid:4)(cid:14)(cid:11)(cid:48)(cid:48)(cid:7)(cid:5)(cid:3)(cid:9)(cid:2)(cid:12)(cid:11)(cid:4)(cid:14)(cid:11)(cid:48)(cid:48)(cid:7)(cid:5)(cid:3)(cid:9)(cid:2)(cid:28)(cid:3,Unknown,18644.0
Unknown,Unknown,12,Unknown,Unknown,Unknown,Unknown,cid:3)(cid:5)(cid:14)(cid:70)(cid:12)(cid:11)(cid:4)(cid:14)(cid:11)(cid:48)(cid:48)(cid:7)(cid:5)(cid:3)(cid:9)(cid:2)(cid:12)(cid:11)(cid:4)(cid:14)(cid:11)(cid:48)(cid:48)(cid:7)(cid:5)(cid:3)(cid:9)(cid:2)(cid:28)(cid:3,Unknown,18656.0
Unknown,Unknown,11,Unknown,Unknown,Unknown,Unknown,cid:3)(cid:5)(cid:14)(cid:70)(cid:12)(cid:11)(cid:4)(cid:14)(cid:11)(cid:48)(cid:48)(cid:7)(cid:5)(cid:3)(cid:9)(cid:2)(cid:12)(cid:11)(cid:4)(cid:14)(cid:11)(cid:48)(cid:48)(cid:7)(cid:5)(cid:3)(cid:9)(cid:2)(cid:28)(cid:3,Unknown,18667.0
Unknown,Unknown,4,Unknown,Unknown,Unknown,Unknown,cid:3)(cid:5)(cid:14)(cid:70)(cid:12)(cid:11)(cid:4)(cid:14)(cid:11)(cid:48)(cid:48)(cid:7)(cid:5)(cid:3)(cid:9)(cid:2)(cid:12)(cid:11)(cid:4)(cid:14)(cid:11)(cid:48)(cid:48)(cid:7)(cid:5)(cid:3)(cid:9)(cid:2)(cid:28)(cid:3,Unknown,18671.0
Unknown,Unknown,14,Unknown,Unknown,Unknown,Unknown,cid:3)(cid:5)(cid:14)(cid:70)(cid:12)(cid:11)(cid:4)(cid:14)(cid:11)(cid:48)(cid:48)(cid:7)(cid:5)(cid:3)(cid:9)(cid:2)(cid:12)(cid:11)(cid:4)(cid:14)(cid:11)(cid:48)(cid:48)(cid:7)(cid:5)(cid:3)(cid:9)(cid:2)(cid:28)(cid:3,Unknown,18685.0
Unknown,Unknown,11,Unknown,Unknown,Unknown,Unknown,cid:3)(cid:5)(cid:14)(cid:70)(cid:12)(cid:11)(cid:4)(cid:14)(cid:11)(cid:48)(cid:48)(cid:7)(cid:5)(cid:3)(cid:9)(cid:2)(cid:12)(cid:11)(cid:4)(cid:14)(cid:11)(cid:48)(cid:48)(cid:7)(cid:5)(cid:3)(cid:9)(cid:2)(cid:28)(cid:3,Unknown,18696.0
Unknown,Unknown,48,Unknown,Unknown,Unknown,Unknown,cid:3)(cid:5)(cid:14)(cid:70)(cid:12)(cid:11)(cid:4)(cid:14)(cid:11)(cid:48)(cid:48)(cid:7)(cid:5)(cid:3)(cid:9)(cid:2)(cid:12)(cid:11)(cid:4)(cid:14)(cid:11)(cid:48)(cid:48)(cid:7)(cid:5)(cid:3)(cid:9)(cid:2)(cid:28)(cid:3,Unknown,18744.0
Unknown,Unknown,48,Unknown,Unknown,Unknown,Unknown,cid:3)(cid:5)(cid:14)(cid:70)(cid:12)(cid:11)(cid:4)(cid:14)(cid:11)(cid:48)(cid:48)(cid:7)(cid:5)(cid:3)(cid:9)(cid:2)(cid:12)(cid:11)(cid:4)(cid:14)(cid:11)(cid:48)(cid:48)(cid:7)(cid:5)(cid:3)(cid:9)(cid:2)(cid:28)(cid:3,Unknown,18792.0
Unknown,Unknown,7,Unknown,Unknown,Unknown,Unknown,cid:3)(cid:5)(cid:14)(cid:70)(cid:12)(cid:11)(cid:4)(cid:14)(cid:11)(cid:48)(cid:48)(cid:7)(cid:5)(cid:3)(cid:9)(cid:2)(cid:12)(cid:11)(cid:4)(cid:14)(cid:11)(cid:48)(cid:48)(cid:7)(cid:5)(cid:3)(cid:9)(cid:2)(cid:28)(cid:3,Unknown,18799.0
Unknown,Unknown,5,Unknown,Unknown,Unknown,Unknown,cid:3)(cid:5)(cid:14)(cid:70)(cid:12)(cid:11)(cid:4)(cid:14)(cid:11)(cid:48)(cid:48)(cid:7)(cid:5)(cid:3)(cid:9)(cid:2)(cid:12)(cid:11)(cid:4)(cid:14)(cid:11)(cid:48)(cid:48)(cid:7)(cid:5)(cid:3)(cid:9)(cid:2)(cid:28)(cid:3,Unknown,18804.0
Unknown,Unknown,3,Unknown,Unknown,Unknown,Unknown,cid:3)(cid:5)(cid:14)(cid:70)(cid:12)(cid:11)(cid:4)(cid:14)(cid:11)(cid:48)(cid:48)(cid:7)(cid:5)(cid:3)(cid:9)(cid:2)(cid:12)(cid:11)(cid:4)(cid:14)(cid:11)(cid:48)(cid:48)(cid:7)(cid:5)(cid:3)(cid:9)(cid:2)(cid:28)(cid:3,Unknown,18807.0
Unknown,Unknown,9,Unknown,Unknown,Unknown,Unknown,cid:3)(cid:5)(cid:14)(cid:70)(cid:12)(cid:11)(cid:4)(cid:14)(cid:11)(cid:48)(cid:48)(cid:7)(cid:5)(cid:3)(cid:9)(cid:2)(cid:12)(cid:11)(cid:4)(cid:14)(cid:11)(cid:48)(cid:48)(cid:7)(cid:5)(cid:3)(cid:9)(cid:2)(cid:28)(cid:3,Unknown,18816.0
Unknown,Unknown,2,Unknown,Unknown,Unknown,Unknown,cid:3)(cid:5)(cid:14)(cid:70)(cid:12)(cid:11)(cid:4)(cid:14)(cid:11)(cid:48)(cid:48)(cid:7)(cid:5)(cid:3)(cid:9)(cid:2)(cid:12)(cid:11)(cid:4)(cid:14)(cid:11)(cid:48)(cid:48)(cid:7)(cid:5)(cid:3)(cid:9)(cid:2)(cid:28)(cid:3,Unknown,18818.0
Unknown,Unknown,28,Unknown,Unknown,Unknown,Unknown,cid:3)(cid:5)(cid:14)(cid:70)(cid:12)(cid:11)(cid:4)(cid:14)(cid:11)(cid:48)(cid:48)(cid:7)(cid:5)(cid:3)(cid:9)(cid:2)(cid:12)(cid:11)(cid:4)(cid:14)(cid:11)(cid:48)(cid:48)(cid:7)(cid:5)(cid:3)(cid:9)(cid:2)(cid:28)(cid:3,Unknown,18846.0
Unknown,Unknown,3,Unknown,Unknown,Unknown,Unknown,cid:3)(cid:5)(cid:14)(cid:70)(cid:12)(cid:11)(cid:4)(cid:14)(cid:11)(cid:48)(cid:48)(cid:7)(cid:5)(cid:3)(cid:9)(cid:2)(cid:12)(cid:11)(cid:4)(cid:14)(cid:11)(cid:48)(cid:48)(cid:7)(cid:5)(cid:3)(cid:9)(cid:2)(cid:28)(cid:3,Unknown,18849.0
Unknown,Unknown,15,Unknown,Unknown,Unknown,Unknown,cid:3)(cid:5)(cid:14)(cid:70)(cid:12)(cid:11)(cid:4)(cid:14)(cid:11)(cid:48)(cid:48)(cid:7)(cid:5)(cid:3)(cid:9)(cid:2)(cid:12)(cid:11)(cid:4)(cid:14)(cid:11)(cid:48)(cid:48)(cid:7)(cid:5)(cid:3)(cid:9)(cid:2)(cid:28)(cid:3,Unknown,18864.0
Unknown,Unknown,2,Unknown,Unknown,Unknown,Unknown,cid:3)(cid:5)(cid:14)(cid:70)(cid:12)(cid:11)(cid:4)(cid:14)(cid:11)(cid:48)(cid:48)(cid:7)(cid:5)(cid:3)(cid:9)(cid:2)(cid:12)(cid:11)(cid:4)(cid:14)(cid:11)(cid:48)(cid:48)(cid:7)(cid:5)(cid:3)(cid:9)(cid:2)(cid:28)(cid:3,Unknown,18866.0
Unknown,Unknown,32,Unknown,Unknown,Unknown,Unknown,cid:3)(cid:5)(cid:14)(cid:70)(cid:12)(cid:11)(cid:4)(cid:14)(cid:11)(cid:48)(cid:48)(cid:7)(cid:5)(cid:3)(cid:9)(cid:2)(cid:12)(cid:11)(cid:4)(cid:14)(cid:11)(cid:48)(cid:48)(cid:7)(cid:5)(cid:3)(cid:9)(cid:2)(cid:28)(cid:3,Unknown,18898.0
Unknown,Unknown,18,Unknown,Unknown,Unknown,Unknown,cid:3)(cid:5)(cid:14)(cid:70)(cid:12)(cid:11)(cid:4)(cid:14)(cid:11)(cid:48)(cid:48)(cid:7)(cid:5)(cid:3)(cid:9)(cid:2)(cid:12)(cid:11)(cid:4)(cid:14)(cid:11)(cid:48)(cid:48)(cid:7)(cid:5)(cid:3)(cid:9)(cid:2)(cid:28)(cid:3,Unknown,18916.0
Unknown,Unknown,19,Unknown,Unknown,Unknown,Unknown,cid:3)(cid:5)(cid:14)(cid:70)(cid:12)(cid:11)(cid:4)(cid:14)(cid:11)(cid:48)(cid:48)(cid:7)(cid:5)(cid:3)(cid:9)(cid:2)(cid:12)(cid:11)(cid:4)(cid:14)(cid:11)(cid:48)(cid:48)(cid:7)(cid:5)(cid:3)(cid:9)(cid:2)(cid:28)(cid:3,Unknown,18935.0
Unknown,Unknown,18,Unknown,Unknown,Unknown,Unknown,cid:3)(cid:5)(cid:14)(cid:70)(cid:12)(cid:11)(cid:4)(cid:14)(cid:11)(cid:48)(cid:48)(cid:7)(cid:5)(cid:3)(cid:9)(cid:2)(cid:12)(cid:11)(cid:4)(cid:14)(cid:11)(cid:48)(cid:48)(cid:7)(cid:5)(cid:3)(cid:9)(cid:2)(cid:28)(cid:3,Unknown,18953.0
Unknown,Unknown,17,Unknown,Unknown,Unknown,Unknown,cid:3)(cid:5)(cid:14)(cid:70)(cid:12)(cid:11)(cid:4)(cid:14)(cid:11)(cid:48)(cid:48)(cid:7)(cid:5)(cid:3)(cid:9)(cid:2)(cid:12)(cid:11)(cid:4)(cid:14)(cid:11)(cid:48)(cid:48)(cid:7)(cid:5)(cid:3)(cid:9)(cid:2)(cid:28)(cid:3,Unknown,18970.0
Unknown,Unknown,2,Unknown,Unknown,Unknown,Unknown,cid:3)(cid:5)(cid:14)(cid:70)(cid:12)(cid:11)(cid:4)(cid:14)(cid:11)(cid:48)(cid:48)(cid:7)(cid:5)(cid:3)(cid:9)(cid:2)(cid:12)(cid:11)(cid:4)(cid:14)(cid:11)(cid:48)(cid:48)(cid:7)(cid:5)(cid:3)(cid:9)(cid:2)(cid:28)(cid:3,Unknown,18972.0
Unknown,Unknown,44,Unknown,Unknown,Unknown,Unknown,cid:3)(cid:5)(cid:14)(cid:70)(cid:12)(cid:11)(cid:4)(cid:14)(cid:11)(cid:48)(cid:48)(cid:7)(cid:5)(cid:3)(cid:9)(cid:2)(cid:12)(cid:11)(cid:4)(cid:14)(cid:11)(cid:48)(cid:48)(cid:7)(cid:5)(cid:3)(cid:9)(cid:2)(cid:28)(cid:3,Unknown,19016.0
Unknown,Unknown,12,Unknown,Unknown,Unknown,Unknown,cid:3)(cid:5)(cid:14)(cid:70)(cid:12)(cid:11)(cid:4)(cid:14)(cid:11)(cid:48)(cid:48)(cid:7)(cid:5)(cid:3)(cid:9)(cid:2)(cid:12)(cid:11)(cid:4)(cid:14)(cid:11)(cid:48)(cid:48)(cid:7)(cid:5)(cid:3)(cid:9)(cid:2)(cid:28)(cid:3,Unknown,19028.0
Unknown,Unknown,29,Unknown,Unknown,Unknown,Unknown,cid:3)(cid:5)(cid:14)(cid:70)(cid:12)(cid:11)(cid:4)(cid:14)(cid:11)(cid:48)(cid:48)(cid:7)(cid:5)(cid:3)(cid:9)(cid:2)(cid:12)(cid:11)(cid:4)(cid:14)(cid:11)(cid:48)(cid:48)(cid:7)(cid:5)(cid:3)(cid:9)(cid:2)(cid:28)(cid:3,Unknown,19057.0
Unknown,Unknown,26,Unknown,Unknown,Unknown,Unknown,cid:3)(cid:5)(cid:14)(cid:70)(cid:12)(cid:11)(cid:4)(cid:14)(cid:11)(cid:48)(cid:48)(cid:7)(cid:5)(cid:3)(cid:9)(cid:2)(cid:12)(cid:11)(cid:4)(cid:14)(cid:11)(cid:48)(cid:48)(cid:7)(cid:5)(cid:3)(cid:9)(cid:2)(cid:28)(cid:3,Unknown,19083.0
Unknown,Unknown,41,Unknown,Unknown,Unknown,Unknown,cid:3)(cid:5)(cid:14)(cid:70)(cid:12)(cid:11)(cid:4)(cid:14)(cid:11)(cid:48)(cid:48)(cid:7)(cid:5)(cid:3)(cid:9)(cid:2)(cid:12)(cid:11)(cid:4)(cid:14)(cid:11)(cid:48)(cid:48)(cid:7)(cid:5)(cid:3)(cid:9)(cid:2)(cid:28)(cid:3,Unknown,19124.0
Unknown,Unknown,25,Unknown,Unknown,Unknown,Unknown,cid:3)(cid:5)(cid:14)(cid:70)(cid:12)(cid:11)(cid:4)(cid:14)(cid:11)(cid:48)(cid:48)(cid:7)(cid:5)(cid:3)(cid:9)(cid:2)(cid:12)(cid:11)(cid:4)(cid:14)(cid:11)(cid:48)(cid:48)(cid:7)(cid:5)(cid:3)(cid:9)(cid:2)(cid:28)(cid:3,Unknown,19149.0
Unknown,Unknown,2,Unknown,Unknown,Unknown,Unknown,cid:3)(cid:5)(cid:14)(cid:70)(cid:12)(cid:11)(cid:4)(cid:14)(cid:11)(cid:48)(cid:48)(cid:7)(cid:5)(cid:3)(cid:9)(cid:2)(cid:12)(cid:11)(cid:4)(cid:14)(cid:11)(cid:48)(cid:48)(cid:7)(cid:5)(cid:3)(cid:9)(cid:2)(cid:28)(cid:3,Unknown,19151.0
Unknown,Unknown,58,Unknown,Unknown,Unknown,Unknown,cid:3)(cid:5)(cid:14)(cid:70)(cid:12)(cid:11)(cid:4)(cid:14)(cid:11)(cid:48)(cid:48)(cid:7)(cid:5)(cid:3)(cid:9)(cid:2)(cid:12)(cid:11)(cid:4)(cid:14)(cid:11)(cid:48)(cid:48)(cid:7)(cid:5)(cid:3)(cid:9)(cid:2)(cid:28)(cid:3,Unknown,19209.0
Unknown,Unknown,58,Unknown,Unknown,Unknown,Unknown,cid:3)(cid:5)(cid:14)(cid:70)(cid:12)(cid:11)(cid:4)(cid:14)(cid:11)(cid:48)(cid:48)(cid:7)(cid:5)(cid:3)(cid:9)(cid:2)(cid:12)(cid:11)(cid:4)(cid:14)(cid:11)(cid:48)(cid:48)(cid:7)(cid:5)(cid:3)(cid:9)(cid:2)(cid:28)(cid:3,Unknown,19267.0
Unknown,Unknown,37,Unknown,Unknown,Unknown,Unknown,cid:3)(cid:5)(cid:14)(cid:70)(cid:12)(cid:11)(cid:4)(cid:14)(cid:11)(cid:48)(cid:48)(cid:7)(cid:5)(cid:3)(cid:9)(cid:2)(cid:12)(cid:11)(cid:4)(cid:14)(cid:11)(cid:48)(cid:48)(cid:7)(cid:5)(cid:3)(cid:9)(cid:2)(cid:28)(cid:3,Unknown,19304.0
Unknown,Unknown,16,Unknown,Unknown,Unknown,Unknown,cid:3)(cid:5)(cid:14)(cid:70)(cid:12)(cid:11)(cid:4)(cid:14)(cid:11)(cid:48)(cid:48)(cid:7)(cid:5)(cid:3)(cid:9)(cid:2)(cid:12)(cid:11)(cid:4)(cid:14)(cid:11)(cid:48)(cid:48)(cid:7)(cid:5)(cid:3)(cid:9)(cid:2)(cid:28)(cid:3,Unknown,19320.0
Unknown,Unknown,34,Unknown,Unknown,Unknown,Unknown,cid:3)(cid:5)(cid:14)(cid:70)(cid:12)(cid:11)(cid:4)(cid:14)(cid:11)(cid:48)(cid:48)(cid:7)(cid:5)(cid:3)(cid:9)(cid:2)(cid:12)(cid:11)(cid:4)(cid:14)(cid:11)(cid:48)(cid:48)(cid:7)(cid:5)(cid:3)(cid:9)(cid:2)(cid:28)(cid:3,Unknown,19354.0
Unknown,Unknown,33,Unknown,Unknown,Unknown,Unknown,cid:3)(cid:5)(cid:14)(cid:70)(cid:12)(cid:11)(cid:4)(cid:14)(cid:11)(cid:48)(cid:48)(cid:7)(cid:5)(cid:3)(cid:9)(cid:2)(cid:12)(cid:11)(cid:4)(cid:14)(cid:11)(cid:48)(cid:48)(cid:7)(cid:5)(cid:3)(cid:9)(cid:2)(cid:28)(cid:3,Unknown,19387.0
Unknown,Unknown,17,Unknown,Unknown,Unknown,Unknown,cid:3)(cid:5)(cid:14)(cid:70)(cid:12)(cid:11)(cid:4)(cid:14)(cid:11)(cid:48)(cid:48)(cid:7)(cid:5)(cid:3)(cid:9)(cid:2)(cid:12)(cid:11)(cid:4)(cid:14)(cid:11)(cid:48)(cid:48)(cid:7)(cid:5)(cid:3)(cid:9)(cid:2)(cid:28)(cid:3,Unknown,19404.0
Unknown,Unknown,33,Unknown,Unknown,Unknown,Unknown,cid:3)(cid:5)(cid:14)(cid:70)(cid:12)(cid:11)(cid:4)(cid:14)(cid:11)(cid:48)(cid:48)(cid:7)(cid:5)(cid:3)(cid:9)(cid:2)(cid:12)(cid:11)(cid:4)(cid:14)(cid:11)(cid:48)(cid:48)(cid:7)(cid:5)(cid:3)(cid:9)(cid:2)(cid:28)(cid:3,Unknown,19437.0
Unknown,Unknown,45,Unknown,Unknown,Unknown,Unknown,cid:3)(cid:5)(cid:14)(cid:70)(cid:12)(cid:11)(cid:4)(cid:14)(cid:11)(cid:48)(cid:48)(cid:7)(cid:5)(cid:3)(cid:9)(cid:2)(cid:12)(cid:11)(cid:4)(cid:14)(cid:11)(cid:48)(cid:48)(cid:7)(cid:5)(cid:3)(cid:9)(cid:2)(cid:28)(cid:3,Unknown,19482.0
Unknown,Unknown,18,Unknown,Unknown,Unknown,Unknown,cid:3)(cid:5)(cid:14)(cid:70)(cid:12)(cid:11)(cid:4)(cid:14)(cid:11)(cid:48)(cid:48)(cid:7)(cid:5)(cid:3)(cid:9)(cid:2)(cid:12)(cid:11)(cid:4)(cid:14)(cid:11)(cid:48)(cid:48)(cid:7)(cid:5)(cid:3)(cid:9)(cid:2)(cid:28)(cid:3,Unknown,19500.0
Unknown,Unknown,16,Unknown,Unknown,Unknown,Unknown,cid:3)(cid:5)(cid:14)(cid:70)(cid:12)(cid:11)(cid:4)(cid:14)(cid:11)(cid:48)(cid:48)(cid:7)(cid:5)(cid:3)(cid:9)(cid:2)(cid:12)(cid:11)(cid:4)(cid:14)(cid:11)(cid:48)(cid:48)(cid:7)(cid:5)(cid:3)(cid:9)(cid:2)(cid:28)(cid:3,Unknown,19516.0
Unknown,Unknown,39,Unknown,Unknown,Unknown,Unknown,cid:3)(cid:5)(cid:14)(cid:70)(cid:12)(cid:11)(cid:4)(cid:14)(cid:11)(cid:48)(cid:48)(cid:7)(cid:5)(cid:3)(cid:9)(cid:2)(cid:12)(cid:11)(cid:4)(cid:14)(cid:11)(cid:48)(cid:48)(cid:7)(cid:5)(cid:3)(cid:9)(cid:2)(cid:28)(cid:3,Unknown,19555.0
Unknown,Unknown,7,Unknown,Unknown,Unknown,Unknown,cid:3)(cid:5)(cid:14)(cid:70)(cid:12)(cid:11)(cid:4)(cid:14)(cid:11)(cid:48)(cid:48)(cid:7)(cid:5)(cid:3)(cid:9)(cid:2)(cid:12)(cid:11)(cid:4)(cid:14)(cid:11)(cid:48)(cid:48)(cid:7)(cid:5)(cid:3)(cid:9)(cid:2)(cid:28)(cid:3,Unknown,19562.0
Unknown,Unknown,71,Unknown,Unknown,Unknown,Unknown,cid:3)(cid:5)(cid:14)(cid:70)(cid:12)(cid:11)(cid:4)(cid:14)(cid:11)(cid:48)(cid:48)(cid:7)(cid:5)(cid:3)(cid:9)(cid:2)(cid:12)(cid:11)(cid:4)(cid:14)(cid:11)(cid:48)(cid:48)(cid:7)(cid:5)(cid:3)(cid:9)(cid:2)(cid:28)(cid:3,Unknown,19633.0
Unknown,Unknown,71,Unknown,Unknown,Unknown,Unknown,cid:3)(cid:5)(cid:14)(cid:70)(cid:12)(cid:11)(cid:4)(cid:14)(cid:11)(cid:48)(cid:48)(cid:7)(cid:5)(cid:3)(cid:9)(cid:2)(cid:12)(cid:11)(cid:4)(cid:14)(cid:11)(cid:48)(cid:48)(cid:7)(cid:5)(cid:3)(cid:9)(cid:2)(cid:28)(cid:3,Unknown,19704.0
Unknown,Unknown,5,Unknown,Unknown,Unknown,Unknown,cid:3)(cid:5)(cid:14)(cid:70)(cid:12)(cid:11)(cid:4)(cid:14)(cid:11)(cid:48)(cid:48)(cid:7)(cid:5)(cid:3)(cid:9)(cid:2)(cid:12)(cid:11)(cid:4)(cid:14)(cid:11)(cid:48)(cid:48)(cid:7)(cid:5)(cid:3)(cid:9)(cid:2)(cid:28)(cid:3,Unknown,19709.0
Unknown,Unknown,3,Unknown,Unknown,Unknown,Unknown,cid:3)(cid:5)(cid:14)(cid:70)(cid:12)(cid:11)(cid:4)(cid:14)(cid:11)(cid:48)(cid:48)(cid:7)(cid:5)(cid:3)(cid:9)(cid:2)(cid:12)(cid:11)(cid:4)(cid:14)(cid:11)(cid:48)(cid:48)(cid:7)(cid:5)(cid:3)(cid:9)(cid:2)(cid:28)(cid:3,Unknown,19712.0
Unknown,Unknown,7,Unknown,Unknown,Unknown,Unknown,cid:3)(cid:5)(cid:14)(cid:70)(cid:12)(cid:11)(cid:4)(cid:14)(cid:11)(cid:48)(cid:48)(cid:7)(cid:5)(cid:3)(cid:9)(cid:2)(cid:12)(cid:11)(cid:4)(cid:14)(cid:11)(cid:48)(cid:48)(cid:7)(cid:5)(cid:3)(cid:9)(cid:2)(cid:28)(cid:3,Unknown,19719.0
Unknown,Unknown,46,Unknown,Unknown,Unknown,Unknown,cid:3)(cid:5)(cid:14)(cid:70)(cid:12)(cid:11)(cid:4)(cid:14)(cid:11)(cid:48)(cid:48)(cid:7)(cid:5)(cid:3)(cid:9)(cid:2)(cid:12)(cid:11)(cid:4)(cid:14)(cid:11)(cid:48)(cid:48)(cid:7)(cid:5)(cid:3)(cid:9)(cid:2)(cid:28)(cid:3,Unknown,19765.0
Unknown,Unknown,2,Unknown,Unknown,Unknown,Unknown,cid:3)(cid:5)(cid:14)(cid:70)(cid:12)(cid:11)(cid:4)(cid:14)(cid:11)(cid:48)(cid:48)(cid:7)(cid:5)(cid:3)(cid:9)(cid:2)(cid:12)(cid:11)(cid:4)(cid:14)(cid:11)(cid:48)(cid:48)(cid:7)(cid:5)(cid:3)(cid:9)(cid:2)(cid:28)(cid:3,Unknown,19767.0
Unknown,Unknown,12,Unknown,Unknown,Unknown,Unknown,cid:3)(cid:5)(cid:14)(cid:70)(cid:12)(cid:11)(cid:4)(cid:14)(cid:11)(cid:48)(cid:48)(cid:7)(cid:5)(cid:3)(cid:9)(cid:2)(cid:12)(cid:11)(cid:4)(cid:14)(cid:11)(cid:48)(cid:48)(cid:7)(cid:5)(cid:3)(cid:9)(cid:2)(cid:28)(cid:3,Unknown,19779.0
Unknown,Unknown,11,Unknown,Unknown,Unknown,Unknown,cid:3)(cid:5)(cid:14)(cid:70)(cid:12)(cid:11)(cid:4)(cid:14)(cid:11)(cid:48)(cid:48)(cid:7)(cid:5)(cid:3)(cid:9)(cid:2)(cid:12)(cid:11)(cid:4)(cid:14)(cid:11)(cid:48)(cid:48)(cid:7)(cid:5)(cid:3)(cid:9)(cid:2)(cid:28)(cid:3,Unknown,19790.0
Unknown,Unknown,4,Unknown,Unknown,Unknown,Unknown,cid:3)(cid:5)(cid:14)(cid:70)(cid:12)(cid:11)(cid:4)(cid:14)(cid:11)(cid:48)(cid:48)(cid:7)(cid:5)(cid:3)(cid:9)(cid:2)(cid:12)(cid:11)(cid:4)(cid:14)(cid:11)(cid:48)(cid:48)(cid:7)(cid:5)(cid:3)(cid:9)(cid:2)(cid:28)(cid:3,Unknown,19794.0
Unknown,Unknown,14,Unknown,Unknown,Unknown,Unknown,cid:3)(cid:5)(cid:14)(cid:70)(cid:12)(cid:11)(cid:4)(cid:14)(cid:11)(cid:48)(cid:48)(cid:7)(cid:5)(cid:3)(cid:9)(cid:2)(cid:12)(cid:11)(cid:4)(cid:14)(cid:11)(cid:48)(cid:48)(cid:7)(cid:5)(cid:3)(cid:9)(cid:2)(cid:28)(cid:3,Unknown,19808.0
Unknown,Unknown,11,Unknown,Unknown,Unknown,Unknown,cid:3)(cid:5)(cid:14)(cid:70)(cid:12)(cid:11)(cid:4)(cid:14)(cid:11)(cid:48)(cid:48)(cid:7)(cid:5)(cid:3)(cid:9)(cid:2)(cid:12)(cid:11)(cid:4)(cid:14)(cid:11)(cid:48)(cid:48)(cid:7)(cid:5)(cid:3)(cid:9)(cid:2)(cid:28)(cid:3,Unknown,19819.0
Unknown,Unknown,48,Unknown,Unknown,Unknown,Unknown,cid:3)(cid:5)(cid:14)(cid:70)(cid:12)(cid:11)(cid:4)(cid:14)(cid:11)(cid:48)(cid:48)(cid:7)(cid:5)(cid:3)(cid:9)(cid:2)(cid:12)(cid:11)(cid:4)(cid:14)(cid:11)(cid:48)(cid:48)(cid:7)(cid:5)(cid:3)(cid:9)(cid:2)(cid:28)(cid:3,Unknown,19867.0
Unknown,Unknown,48,Unknown,Unknown,Unknown,Unknown,cid:3)(cid:5)(cid:14)(cid:70)(cid:12)(cid:11)(cid:4)(cid:14)(cid:11)(cid:48)(cid:48)(cid:7)(cid:5)(cid:3)(cid:9)(cid:2)(cid:12)(cid:11)(cid:4)(cid:14)(cid:11)(cid:48)(cid:48)(cid:7)(cid:5)(cid:3)(cid:9)(cid:2)(cid:28)(cid:3,Unknown,19915.0
Unknown,Unknown,7,Unknown,Unknown,Unknown,Unknown,cid:3)(cid:5)(cid:14)(cid:70)(cid:12)(cid:11)(cid:4)(cid:14)(cid:11)(cid:48)(cid:48)(cid:7)(cid:5)(cid:3)(cid:9)(cid:2)(cid:12)(cid:11)(cid:4)(cid:14)(cid:11)(cid:48)(cid:48)(cid:7)(cid:5)(cid:3)(cid:9)(cid:2)(cid:28)(cid:3,Unknown,19922.0
Unknown,Unknown,5,Unknown,Unknown,Unknown,Unknown,cid:3)(cid:5)(cid:14)(cid:70)(cid:12)(cid:11)(cid:4)(cid:14)(cid:11)(cid:48)(cid:48)(cid:7)(cid:5)(cid:3)(cid:9)(cid:2)(cid:12)(cid:11)(cid:4)(cid:14)(cid:11)(cid:48)(cid:48)(cid:7)(cid:5)(cid:3)(cid:9)(cid:2)(cid:28)(cid:3,Unknown,19927.0
Unknown,Unknown,3,Unknown,Unknown,Unknown,Unknown,cid:3)(cid:5)(cid:14)(cid:70)(cid:12)(cid:11)(cid:4)(cid:14)(cid:11)(cid:48)(cid:48)(cid:7)(cid:5)(cid:3)(cid:9)(cid:2)(cid:12)(cid:11)(cid:4)(cid:14)(cid:11)(cid:48)(cid:48)(cid:7)(cid:5)(cid:3)(cid:9)(cid:2)(cid:28)(cid:3,Unknown,19930.0
Unknown,Unknown,9,Unknown,Unknown,Unknown,Unknown,cid:3)(cid:5)(cid:14)(cid:70)(cid:12)(cid:11)(cid:4)(cid:14)(cid:11)(cid:48)(cid:48)(cid:7)(cid:5)(cid:3)(cid:9)(cid:2)(cid:12)(cid:11)(cid:4)(cid:14)(cid:11)(cid:48)(cid:48)(cid:7)(cid:5)(cid:3)(cid:9)(cid:2)(cid:28)(cid:3,Unknown,19939.0
Unknown,Unknown,2,Unknown,Unknown,Unknown,Unknown,cid:3)(cid:5)(cid:14)(cid:70)(cid:12)(cid:11)(cid:4)(cid:14)(cid:11)(cid:48)(cid:48)(cid:7)(cid:5)(cid:3)(cid:9)(cid:2)(cid:12)(cid:11)(cid:4)(cid:14)(cid:11)(cid:48)(cid:48)(cid:7)(cid:5)(cid:3)(cid:9)(cid:2)(cid:28)(cid:3,Unknown,19941.0
Unknown,Unknown,28,Unknown,Unknown,Unknown,Unknown,cid:3)(cid:5)(cid:14)(cid:70)(cid:12)(cid:11)(cid:4)(cid:14)(cid:11)(cid:48)(cid:48)(cid:7)(cid:5)(cid:3)(cid:9)(cid:2)(cid:12)(cid:11)(cid:4)(cid:14)(cid:11)(cid:48)(cid:48)(cid:7)(cid:5)(cid:3)(cid:9)(cid:2)(cid:28)(cid:3,Unknown,19969.0
Unknown,Unknown,3,Unknown,Unknown,Unknown,Unknown,cid:3)(cid:5)(cid:14)(cid:70)(cid:12)(cid:11)(cid:4)(cid:14)(cid:11)(cid:48)(cid:48)(cid:7)(cid:5)(cid:3)(cid:9)(cid:2)(cid:12)(cid:11)(cid:4)(cid:14)(cid:11)(cid:48)(cid:48)(cid:7)(cid:5)(cid:3)(cid:9)(cid:2)(cid:28)(cid:3,Unknown,19972.0
Unknown,Unknown,15,Unknown,Unknown,Unknown,Unknown,cid:3)(cid:5)(cid:14)(cid:70)(cid:12)(cid:11)(cid:4)(cid:14)(cid:11)(cid:48)(cid:48)(cid:7)(cid:5)(cid:3)(cid:9)(cid:2)(cid:12)(cid:11)(cid:4)(cid:14)(cid:11)(cid:48)(cid:48)(cid:7)(cid:5)(cid:3)(cid:9)(cid:2)(cid:28)(cid:3,Unknown,19987.0
Unknown,Unknown,2,Unknown,Unknown,Unknown,Unknown,cid:3)(cid:5)(cid:14)(cid:70)(cid:12)(cid:11)(cid:4)(cid:14)(cid:11)(cid:48)(cid:48)(cid:7)(cid:5)(cid:3)(cid:9)(cid:2)(cid:12)(cid:11)(cid:4)(cid:14)(cid:11)(cid:48)(cid:48)(cid:7)(cid:5)(cid:3)(cid:9)(cid:2)(cid:28)(cid:3,Unknown,19989.0
Unknown,Unknown,36,Unknown,Unknown,Unknown,Unknown,cid:3)(cid:5)(cid:14)(cid:70)(cid:12)(cid:11)(cid:4)(cid:14)(cid:11)(cid:48)(cid:48)(cid:7)(cid:5)(cid:3)(cid:9)(cid:2)(cid:12)(cid:11)(cid:4)(cid:14)(cid:11)(cid:48)(cid:48)(cid:7)(cid:5)(cid:3)(cid:9)(cid:2)(cid:28)(cid:3,Unknown,20025.0
Unknown,Unknown,34,Unknown,Unknown,Unknown,Unknown,cid:3)(cid:5)(cid:14)(cid:70)(cid:12)(cid:11)(cid:4)(cid:14)(cid:11)(cid:48)(cid:48)(cid:7)(cid:5)(cid:3)(cid:9)(cid:2)(cid:12)(cid:11)(cid:4)(cid:14)(cid:11)(cid:48)(cid:48)(cid:7)(cid:5)(cid:3)(cid:9)(cid:2)(cid:28)(cid:3,Unknown,20059.0
Unknown,Unknown,19,Unknown,Unknown,Unknown,Unknown,cid:3)(cid:5)(cid:14)(cid:70)(cid:12)(cid:11)(cid:4)(cid:14)(cid:11)(cid:48)(cid:48)(cid:7)(cid:5)(cid:3)(cid:9)(cid:2)(cid:12)(cid:11)(cid:4)(cid:14)(cid:11)(cid:48)(cid:48)(cid:7)(cid:5)(cid:3)(cid:9)(cid:2)(cid:28)(cid:3,Unknown,20078.0
Unknown,Unknown,18,Unknown,Unknown,Unknown,Unknown,cid:3)(cid:5)(cid:14)(cid:70)(cid:12)(cid:11)(cid:4)(cid:14)(cid:11)(cid:48)(cid:48)(cid:7)(cid:5)(cid:3)(cid:9)(cid:2)(cid:12)(cid:11)(cid:4)(cid:14)(cid:11)(cid:48)(cid:48)(cid:7)(cid:5)(cid:3)(cid:9)(cid:2)(cid:28)(cid:3,Unknown,20096.0
Unknown,Unknown,18,Unknown,Unknown,Unknown,Unknown,cid:3)(cid:5)(cid:14)(cid:70)(cid:12)(cid:11)(cid:4)(cid:14)(cid:11)(cid:48)(cid:48)(cid:7)(cid:5)(cid:3)(cid:9)(cid:2)(cid:12)(cid:11)(cid:4)(cid:14)(cid:11)(cid:48)(cid:48)(cid:7)(cid:5)(cid:3)(cid:9)(cid:2)(cid:28)(cid:3,Unknown,20114.0
Unknown,Unknown,2,Unknown,Unknown,Unknown,Unknown,cid:3)(cid:5)(cid:14)(cid:70)(cid:12)(cid:11)(cid:4)(cid:14)(cid:11)(cid:48)(cid:48)(cid:7)(cid:5)(cid:3)(cid:9)(cid:2)(cid:12)(cid:11)(cid:4)(cid:14)(cid:11)(cid:48)(cid:48)(cid:7)(cid:5)(cid:3)(cid:9)(cid:2)(cid:28)(cid:3,Unknown,20116.0
Unknown,Unknown,44,Unknown,Unknown,Unknown,Unknown,cid:3)(cid:5)(cid:14)(cid:70)(cid:12)(cid:11)(cid:4)(cid:14)(cid:11)(cid:48)(cid:48)(cid:7)(cid:5)(cid:3)(cid:9)(cid:2)(cid:12)(cid:11)(cid:4)(cid:14)(cid:11)(cid:48)(cid:48)(cid:7)(cid:5)(cid:3)(cid:9)(cid:2)(cid:28)(cid:3,Unknown,20160.0
Unknown,Unknown,12,Unknown,Unknown,Unknown,Unknown,cid:3)(cid:5)(cid:14)(cid:70)(cid:12)(cid:11)(cid:4)(cid:14)(cid:11)(cid:48)(cid:48)(cid:7)(cid:5)(cid:3)(cid:9)(cid:2)(cid:12)(cid:11)(cid:4)(cid:14)(cid:11)(cid:48)(cid:48)(cid:7)(cid:5)(cid:3)(cid:9)(cid:2)(cid:28)(cid:3,Unknown,20172.0
Unknown,Unknown,29,Unknown,Unknown,Unknown,Unknown,cid:3)(cid:5)(cid:14)(cid:70)(cid:12)(cid:11)(cid:4)(cid:14)(cid:11)(cid:48)(cid:48)(cid:7)(cid:5)(cid:3)(cid:9)(cid:2)(cid:12)(cid:11)(cid:4)(cid:14)(cid:11)(cid:48)(cid:48)(cid:7)(cid:5)(cid:3)(cid:9)(cid:2)(cid:28)(cid:3,Unknown,20201.0
Unknown,Unknown,26,Unknown,Unknown,Unknown,Unknown,cid:3)(cid:5)(cid:14)(cid:70)(cid:12)(cid:11)(cid:4)(cid:14)(cid:11)(cid:48)(cid:48)(cid:7)(cid:5)(cid:3)(cid:9)(cid:2)(cid:12)(cid:11)(cid:4)(cid:14)(cid:11)(cid:48)(cid:48)(cid:7)(cid:5)(cid:3)(cid:9)(cid:2)(cid:28)(cid:3,Unknown,20227.0
Unknown,Unknown,41,Unknown,Unknown,Unknown,Unknown,cid:3)(cid:5)(cid:14)(cid:70)(cid:12)(cid:11)(cid:4)(cid:14)(cid:11)(cid:48)(cid:48)(cid:7)(cid:5)(cid:3)(cid:9)(cid:2)(cid:12)(cid:11)(cid:4)(cid:14)(cid:11)(cid:48)(cid:48)(cid:7)(cid:5)(cid:3)(cid:9)(cid:2)(cid:28)(cid:3,Unknown,20268.0
Unknown,Unknown,25,Unknown,Unknown,Unknown,Unknown,cid:3)(cid:5)(cid:14)(cid:70)(cid:12)(cid:11)(cid:4)(cid:14)(cid:11)(cid:48)(cid:48)(cid:7)(cid:5)(cid:3)(cid:9)(cid:2)(cid:12)(cid:11)(cid:4)(cid:14)(cid:11)(cid:48)(cid:48)(cid:7)(cid:5)(cid:3)(cid:9)(cid:2)(cid:28)(cid:3,Unknown,20293.0
Unknown,Unknown,2,Unknown,Unknown,Unknown,Unknown,cid:3)(cid:5)(cid:14)(cid:70)(cid:12)(cid:11)(cid:4)(cid:14)(cid:11)(cid:48)(cid:48)(cid:7)(cid:5)(cid:3)(cid:9)(cid:2)(cid:12)(cid:11)(cid:4)(cid:14)(cid:11)(cid:48)(cid:48)(cid:7)(cid:5)(cid:3)(cid:9)(cid:2)(cid:28)(cid:3,Unknown,20295.0
Unknown,Unknown,58,Unknown,Unknown,Unknown,Unknown,cid:3)(cid:5)(cid:14)(cid:70)(cid:12)(cid:11)(cid:4)(cid:14)(cid:11)(cid:48)(cid:48)(cid:7)(cid:5)(cid:3)(cid:9)(cid:2)(cid:12)(cid:11)(cid:4)(cid:14)(cid:11)(cid:48)(cid:48)(cid:7)(cid:5)(cid:3)(cid:9)(cid:2)(cid:28)(cid:3,Unknown,20353.0
Unknown,Unknown,58,Unknown,Unknown,Unknown,Unknown,cid:3)(cid:5)(cid:14)(cid:70)(cid:12)(cid:11)(cid:4)(cid:14)(cid:11)(cid:48)(cid:48)(cid:7)(cid:5)(cid:3)(cid:9)(cid:2)(cid:12)(cid:11)(cid:4)(cid:14)(cid:11)(cid:48)(cid:48)(cid:7)(cid:5)(cid:3)(cid:9)(cid:2)(cid:28)(cid:3,Unknown,20411.0
Unknown,Unknown,37,Unknown,Unknown,Unknown,Unknown,cid:3)(cid:5)(cid:14)(cid:70)(cid:12)(cid:11)(cid:4)(cid:14)(cid:11)(cid:48)(cid:48)(cid:7)(cid:5)(cid:3)(cid:9)(cid:2)(cid:12)(cid:11)(cid:4)(cid:14)(cid:11)(cid:48)(cid:48)(cid:7)(cid:5)(cid:3)(cid:9)(cid:2)(cid:28)(cid:3,Unknown,20448.0
Unknown,Unknown,16,Unknown,Unknown,Unknown,Unknown,cid:3)(cid:5)(cid:14)(cid:70)(cid:12)(cid:11)(cid:4)(cid:14)(cid:11)(cid:48)(cid:48)(cid:7)(cid:5)(cid:3)(cid:9)(cid:2)(cid:12)(cid:11)(cid:4)(cid:14)(cid:11)(cid:48)(cid:48)(cid:7)(cid:5)(cid:3)(cid:9)(cid:2)(cid:28)(cid:3,Unknown,20464.0
Unknown,Unknown,34,Unknown,Unknown,Unknown,Unknown,cid:3)(cid:5)(cid:14)(cid:70)(cid:12)(cid:11)(cid:4)(cid:14)(cid:11)(cid:48)(cid:48)(cid:7)(cid:5)(cid:3)(cid:9)(cid:2)(cid:12)(cid:11)(cid:4)(cid:14)(cid:11)(cid:48)(cid:48)(cid:7)(cid:5)(cid:3)(cid:9)(cid:2)(cid:28)(cid:3,Unknown,20498.0
Unknown,Unknown,33,Unknown,Unknown,Unknown,Unknown,cid:3)(cid:5)(cid:14)(cid:70)(cid:12)(cid:11)(cid:4)(cid:14)(cid:11)(cid:48)(cid:48)(cid:7)(cid:5)(cid:3)(cid:9)(cid:2)(cid:12)(cid:11)(cid:4)(cid:14)(cid:11)(cid:48)(cid:48)(cid:7)(cid:5)(cid:3)(cid:9)(cid:2)(cid:28)(cid:3,Unknown,20531.0
Unknown,Unknown,17,Unknown,Unknown,Unknown,Unknown,cid:3)(cid:5)(cid:14)(cid:70)(cid:12)(cid:11)(cid:4)(cid:14)(cid:11)(cid:48)(cid:48)(cid:7)(cid:5)(cid:3)(cid:9)(cid:2)(cid:12)(cid:11)(cid:4)(cid:14)(cid:11)(cid:48)(cid:48)(cid:7)(cid:5)(cid:3)(cid:9)(cid:2)(cid:28)(cid:3,Unknown,20548.0
Unknown,Unknown,33,Unknown,Unknown,Unknown,Unknown,cid:3)(cid:5)(cid:14)(cid:70)(cid:12)(cid:11)(cid:4)(cid:14)(cid:11)(cid:48)(cid:48)(cid:7)(cid:5)(cid:3)(cid:9)(cid:2)(cid:12)(cid:11)(cid:4)(cid:14)(cid:11)(cid:48)(cid:48)(cid:7)(cid:5)(cid:3)(cid:9)(cid:2)(cid:28)(cid:3,Unknown,20581.0
Unknown,Unknown,45,Unknown,Unknown,Unknown,Unknown,cid:3)(cid:5)(cid:14)(cid:70)(cid:12)(cid:11)(cid:4)(cid:14)(cid:11)(cid:48)(cid:48)(cid:7)(cid:5)(cid:3)(cid:9)(cid:2)(cid:12)(cid:11)(cid:4)(cid:14)(cid:11)(cid:48)(cid:48)(cid:7)(cid:5)(cid:3)(cid:9)(cid:2)(cid:28)(cid:3,Unknown,20626.0
Unknown,Unknown,18,Unknown,Unknown,Unknown,Unknown,cid:3)(cid:5)(cid:14)(cid:70)(cid:12)(cid:11)(cid:4)(cid:14)(cid:11)(cid:48)(cid:48)(cid:7)(cid:5)(cid:3)(cid:9)(cid:2)(cid:12)(cid:11)(cid:4)(cid:14)(cid:11)(cid:48)(cid:48)(cid:7)(cid:5)(cid:3)(cid:9)(cid:2)(cid:28)(cid:3,Unknown,20644.0
Unknown,Unknown,16,Unknown,Unknown,Unknown,Unknown,cid:3)(cid:5)(cid:14)(cid:70)(cid:12)(cid:11)(cid:4)(cid:14)(cid:11)(cid:48)(cid:48)(cid:7)(cid:5)(cid:3)(cid:9)(cid:2)(cid:12)(cid:11)(cid:4)(cid:14)(cid:11)(cid:48)(cid:48)(cid:7)(cid:5)(cid:3)(cid:9)(cid:2)(cid:28)(cid:3,Unknown,20660.0
Unknown,Unknown,48,Unknown,Unknown,Unknown,Unknown,cid:3)(cid:5)(cid:14)(cid:70)(cid:12)(cid:11)(cid:4)(cid:14)(cid:11)(cid:48)(cid:48)(cid:7)(cid:5)(cid:3)(cid:9)(cid:2)(cid:12)(cid:11)(cid:4)(cid:14)(cid:11)(cid:48)(cid:48)(cid:7)(cid:5)(cid:3)(cid:9)(cid:2)(cid:28)(cid:3,Unknown,20708.0
Unknown,Unknown,12,Unknown,Unknown,Unknown,Unknown,cid:3)(cid:5)(cid:14)(cid:70)(cid:12)(cid:11)(cid:4)(cid:14)(cid:11)(cid:48)(cid:48)(cid:7)(cid:5)(cid:3)(cid:9)(cid:2)(cid:12)(cid:11)(cid:4)(cid:14)(cid:11)(cid:48)(cid:48)(cid:7)(cid:5)(cid:3)(cid:9)(cid:2)(cid:28)(cid:3,Unknown,20720.0
Unknown,Unknown,50,Unknown,Unknown,Unknown,Unknown,cid:3)(cid:5)(cid:14)(cid:70)(cid:12)(cid:11)(cid:4)(cid:14)(cid:11)(cid:48)(cid:48)(cid:7)(cid:5)(cid:3)(cid:9)(cid:2)(cid:12)(cid:11)(cid:4)(cid:14)(cid:11)(cid:48)(cid:48)(cid:7)(cid:5)(cid:3)(cid:9)(cid:2)(cid:28)(cid:3,Unknown,20770.0
Unknown,Unknown,11,Unknown,Unknown,Unknown,Unknown,cid:3)(cid:5)(cid:14)(cid:70)(cid:12)(cid:11)(cid:4)(cid:14)(cid:11)(cid:48)(cid:48)(cid:7)(cid:5)(cid:3)(cid:9)(cid:2)(cid:12)(cid:11)(cid:4)(cid:14)(cid:11)(cid:48)(cid:48)(cid:7)(cid:5)(cid:3)(cid:9)(cid:2)(cid:28)(cid:3,Unknown,20781.0
Unknown,Unknown,8,Unknown,Unknown,Unknown,Unknown,cid:3)(cid:5)(cid:14)(cid:70)(cid:12)(cid:11)(cid:4)(cid:14)(cid:11)(cid:48)(cid:48)(cid:7)(cid:5)(cid:3)(cid:9)(cid:2)(cid:12)(cid:11)(cid:4)(cid:14)(cid:11)(cid:48)(cid:48)(cid:7)(cid:5)(cid:3)(cid:9)(cid:2)(cid:28)(cid:3,Unknown,20789.0
Unknown,Unknown,46,Unknown,Unknown,Unknown,Unknown,cid:3)(cid:5)(cid:14)(cid:70)(cid:12)(cid:11)(cid:4)(cid:14)(cid:11)(cid:48)(cid:48)(cid:7)(cid:5)(cid:3)(cid:9)(cid:2)(cid:12)(cid:11)(cid:4)(cid:14)(cid:11)(cid:48)(cid:48)(cid:7)(cid:5)(cid:3)(cid:9)(cid:2)(cid:28)(cid:3,Unknown,20835.0
Unknown,Unknown,14,Unknown,Unknown,Unknown,Unknown,cid:3)(cid:5)(cid:14)(cid:70)(cid:12)(cid:11)(cid:4)(cid:14)(cid:11)(cid:48)(cid:48)(cid:7)(cid:5)(cid:3)(cid:9)(cid:2)(cid:12)(cid:11)(cid:4)(cid:14)(cid:11)(cid:48)(cid:48)(cid:7)(cid:5)(cid:3)(cid:9)(cid:2)(cid:28)(cid:3,Unknown,20849.0
Unknown,Unknown,50,Unknown,Unknown,Unknown,Unknown,cid:3)(cid:5)(cid:14)(cid:70)(cid:12)(cid:11)(cid:4)(cid:14)(cid:11)(cid:48)(cid:48)(cid:7)(cid:5)(cid:3)(cid:9)(cid:2)(cid:12)(cid:11)(cid:4)(cid:14)(cid:11)(cid:48)(cid:48)(cid:7)(cid:5)(cid:3)(cid:9)(cid:2)(cid:28)(cid:3,Unknown,20899.0
Unknown,Unknown,9,Unknown,Unknown,Unknown,Unknown,cid:3)(cid:5)(cid:14)(cid:70)(cid:12)(cid:11)(cid:4)(cid:14)(cid:11)(cid:48)(cid:48)(cid:7)(cid:5)(cid:3)(cid:9)(cid:2)(cid:12)(cid:11)(cid:4)(cid:14)(cid:11)(cid:48)(cid:48)(cid:7)(cid:5)(cid:3)(cid:9)(cid:2)(cid:28)(cid:3,Unknown,20908.0
Unknown,Unknown,17,Unknown,Unknown,Unknown,Unknown,cid:3)(cid:5)(cid:14)(cid:70)(cid:12)(cid:11)(cid:4)(cid:14)(cid:11)(cid:48)(cid:48)(cid:7)(cid:5)(cid:3)(cid:9)(cid:2)(cid:12)(cid:11)(cid:4)(cid:14)(cid:11)(cid:48)(cid:48)(cid:7)(cid:5)(cid:3)(cid:9)(cid:2)(cid:28)(cid:3,Unknown,20925.0
Unknown,Unknown,36,Unknown,Unknown,Unknown,Unknown,cid:3)(cid:5)(cid:14)(cid:70)(cid:12)(cid:11)(cid:4)(cid:14)(cid:11)(cid:48)(cid:48)(cid:7)(cid:5)(cid:3)(cid:9)(cid:2)(cid:12)(cid:11)(cid:4)(cid:14)(cid:11)(cid:48)(cid:48)(cid:7)(cid:5)(cid:3)(cid:9)(cid:2)(cid:28)(cid:3,Unknown,20961.0
Unknown,Unknown,18,Unknown,Unknown,Unknown,Unknown,cid:3)(cid:5)(cid:14)(cid:70)(cid:12)(cid:11)(cid:4)(cid:14)(cid:11)(cid:48)(cid:48)(cid:7)(cid:5)(cid:3)(cid:9)(cid:2)(cid:12)(cid:11)(cid:4)(cid:14)(cid:11)(cid:48)(cid:48)(cid:7)(cid:5)(cid:3)(cid:9)(cid:2)(cid:28)(cid:3,Unknown,20979.0
Unknown,Unknown,1,Unknown,Unknown,Unknown,Unknown,cid:3)(cid:5)(cid:14)(cid:70)(cid:12)(cid:11)(cid:4)(cid:14)(cid:11)(cid:48)(cid:48)(cid:7)(cid:5)(cid:3)(cid:9)(cid:2)(cid:12)(cid:11)(cid:4)(cid:14)(cid:11)(cid:48)(cid:48)(cid:7)(cid:5)(cid:3)(cid:9)(cid:2)(cid:28)(cid:3,Unknown,20980.0
Unknown,Unknown,2,Unknown,Unknown,Unknown,Unknown,cid:3)(cid:5)(cid:14)(cid:70)(cid:12)(cid:11)(cid:4)(cid:14)(cid:11)(cid:48)(cid:48)(cid:7)(cid:5)(cid:3)(cid:9)(cid:2)(cid:12)(cid:11)(cid:4)(cid:14)(cid:11)(cid:48)(cid:48)(cid:7)(cid:5)(cid:3)(cid:9)(cid:2)(cid:28)(cid:3,Unknown,20982.0
Unknown,Unknown,12,Unknown,Unknown,Unknown,Unknown,cid:3)(cid:5)(cid:14)(cid:70)(cid:12)(cid:11)(cid:4)(cid:14)(cid:11)(cid:48)(cid:48)(cid:7)(cid:5)(cid:3)(cid:9)(cid:2)(cid:12)(cid:11)(cid:4)(cid:14)(cid:11)(cid:48)(cid:48)(cid:7)(cid:5)(cid:3)(cid:9)(cid:2)(cid:28)(cid:3,Unknown,20994.0
Unknown,Unknown,11,Unknown,Unknown,Unknown,Unknown,cid:3)(cid:5)(cid:14)(cid:70)(cid:12)(cid:11)(cid:4)(cid:14)(cid:11)(cid:48)(cid:48)(cid:7)(cid:5)(cid:3)(cid:9)(cid:2)(cid:12)(cid:11)(cid:4)(cid:14)(cid:11)(cid:48)(cid:48)(cid:7)(cid:5)(cid:3)(cid:9)(cid:2)(cid:28)(cid:3,Unknown,21005.0
Unknown,Unknown,4,Unknown,Unknown,Unknown,Unknown,cid:3)(cid:5)(cid:14)(cid:70)(cid:12)(cid:11)(cid:4)(cid:14)(cid:11)(cid:48)(cid:48)(cid:7)(cid:5)(cid:3)(cid:9)(cid:2)(cid:12)(cid:11)(cid:4)(cid:14)(cid:11)(cid:48)(cid:48)(cid:7)(cid:5)(cid:3)(cid:9)(cid:2)(cid:28)(cid:3,Unknown,21009.0
Unknown,Unknown,7,Unknown,Unknown,Unknown,Unknown,cid:3)(cid:5)(cid:14)(cid:70)(cid:12)(cid:11)(cid:4)(cid:14)(cid:11)(cid:48)(cid:48)(cid:7)(cid:5)(cid:3)(cid:9)(cid:2)(cid:12)(cid:11)(cid:4)(cid:14)(cid:11)(cid:48)(cid:48)(cid:7)(cid:5)(cid:3)(cid:9)(cid:2)(cid:28)(cid:3,Unknown,21016.0
Unknown,Unknown,14,Unknown,Unknown,Unknown,Unknown,cid:3)(cid:5)(cid:14)(cid:70)(cid:12)(cid:11)(cid:4)(cid:14)(cid:11)(cid:48)(cid:48)(cid:7)(cid:5)(cid:3)(cid:9)(cid:2)(cid:12)(cid:11)(cid:4)(cid:14)(cid:11)(cid:48)(cid:48)(cid:7)(cid:5)(cid:3)(cid:9)(cid:2)(cid:28)(cid:3,Unknown,21030.0
Unknown,Unknown,14,Unknown,Unknown,Unknown,Unknown,cid:3)(cid:5)(cid:14)(cid:70)(cid:12)(cid:11)(cid:4)(cid:14)(cid:11)(cid:48)(cid:48)(cid:7)(cid:5)(cid:3)(cid:9)(cid:2)(cid:12)(cid:11)(cid:4)(cid:14)(cid:11)(cid:48)(cid:48)(cid:7)(cid:5)(cid:3)(cid:9)(cid:2)(cid:28)(cid:3,Unknown,21044.0
Unknown,Unknown,49,Unknown,Unknown,Unknown,Unknown,cid:3)(cid:5)(cid:14)(cid:70)(cid:12)(cid:11)(cid:4)(cid:14)(cid:11)(cid:48)(cid:48)(cid:7)(cid:5)(cid:3)(cid:9)(cid:2)(cid:12)(cid:11)(cid:4)(cid:14)(cid:11)(cid:48)(cid:48)(cid:7)(cid:5)(cid:3)(cid:9)(cid:2)(cid:28)(cid:3,Unknown,21093.0
Unknown,Unknown,2,Unknown,Unknown,Unknown,Unknown,cid:3)(cid:5)(cid:14)(cid:70)(cid:12)(cid:11)(cid:4)(cid:14)(cid:11)(cid:48)(cid:48)(cid:7)(cid:5)(cid:3)(cid:9)(cid:2)(cid:12)(cid:11)(cid:4)(cid:14)(cid:11)(cid:48)(cid:48)(cid:7)(cid:5)(cid:3)(cid:9)(cid:2)(cid:28)(cid:3,Unknown,21095.0
Unknown,Unknown,46,Unknown,Unknown,Unknown,Unknown,cid:3)(cid:5)(cid:14)(cid:70)(cid:12)(cid:11)(cid:4)(cid:14)(cid:11)(cid:48)(cid:48)(cid:7)(cid:5)(cid:3)(cid:9)(cid:2)(cid:12)(cid:11)(cid:4)(cid:14)(cid:11)(cid:48)(cid:48)(cid:7)(cid:5)(cid:3)(cid:9)(cid:2)(cid:28)(cid:3,Unknown,21141.0
Unknown,Unknown,4,Unknown,Unknown,Unknown,Unknown,cid:3)(cid:5)(cid:14)(cid:70)(cid:12)(cid:11)(cid:4)(cid:14)(cid:11)(cid:48)(cid:48)(cid:7)(cid:5)(cid:3)(cid:9)(cid:2)(cid:12)(cid:11)(cid:4)(cid:14)(cid:11)(cid:48)(cid:48)(cid:7)(cid:5)(cid:3)(cid:9)(cid:2)(cid:28)(cid:3,Unknown,21145.0
Unknown,Unknown,2,Unknown,Unknown,Unknown,Unknown,cid:3)(cid:5)(cid:14)(cid:70)(cid:12)(cid:11)(cid:4)(cid:14)(cid:11)(cid:48)(cid:48)(cid:7)(cid:5)(cid:3)(cid:9)(cid:2)(cid:12)(cid:11)(cid:4)(cid:14)(cid:11)(cid:48)(cid:48)(cid:7)(cid:5)(cid:3)(cid:9)(cid:2)(cid:28)(cid:3,Unknown,21147.0
Unknown,Unknown,28,Unknown,Unknown,Unknown,Unknown,cid:3)(cid:5)(cid:14)(cid:70)(cid:12)(cid:11)(cid:4)(cid:14)(cid:11)(cid:48)(cid:48)(cid:7)(cid:5)(cid:3)(cid:9)(cid:2)(cid:12)(cid:11)(cid:4)(cid:14)(cid:11)(cid:48)(cid:48)(cid:7)(cid:5)(cid:3)(cid:9)(cid:2)(cid:28)(cid:3,Unknown,21175.0
Unknown,Unknown,3,Unknown,Unknown,Unknown,Unknown,cid:3)(cid:5)(cid:14)(cid:70)(cid:12)(cid:11)(cid:4)(cid:14)(cid:11)(cid:48)(cid:48)(cid:7)(cid:5)(cid:3)(cid:9)(cid:2)(cid:12)(cid:11)(cid:4)(cid:14)(cid:11)(cid:48)(cid:48)(cid:7)(cid:5)(cid:3)(cid:9)(cid:2)(cid:28)(cid:3,Unknown,21178.0
Unknown,Unknown,15,Unknown,Unknown,Unknown,Unknown,cid:3)(cid:5)(cid:14)(cid:70)(cid:12)(cid:11)(cid:4)(cid:14)(cid:11)(cid:48)(cid:48)(cid:7)(cid:5)(cid:3)(cid:9)(cid:2)(cid:12)(cid:11)(cid:4)(cid:14)(cid:11)(cid:48)(cid:48)(cid:7)(cid:5)(cid:3)(cid:9)(cid:2)(cid:28)(cid:3,Unknown,21193.0
Unknown,Unknown,2,Unknown,Unknown,Unknown,Unknown,cid:3)(cid:5)(cid:14)(cid:70)(cid:12)(cid:11)(cid:4)(cid:14)(cid:11)(cid:48)(cid:48)(cid:7)(cid:5)(cid:3)(cid:9)(cid:2)(cid:12)(cid:11)(cid:4)(cid:14)(cid:11)(cid:48)(cid:48)(cid:7)(cid:5)(cid:3)(cid:9)(cid:2)(cid:28)(cid:3,Unknown,21195.0
Unknown,Unknown,1,Unknown,Unknown,Unknown,Unknown,cid:3)(cid:5)(cid:14)(cid:70)(cid:12)(cid:11)(cid:4)(cid:14)(cid:11)(cid:48)(cid:48)(cid:7)(cid:5)(cid:3)(cid:9)(cid:2)(cid:12)(cid:11)(cid:4)(cid:14)(cid:11)(cid:48)(cid:48)(cid:7)(cid:5)(cid:3)(cid:9)(cid:2)(cid:28)(cid:3,Unknown,21196.0
Unknown,Unknown,19,Unknown,Unknown,Unknown,Unknown,cid:3)(cid:5)(cid:14)(cid:70)(cid:12)(cid:11)(cid:4)(cid:14)(cid:11)(cid:48)(cid:48)(cid:7)(cid:5)(cid:3)(cid:9)(cid:2)(cid:12)(cid:11)(cid:4)(cid:14)(cid:11)(cid:48)(cid:48)(cid:7)(cid:5)(cid:3)(cid:9)(cid:2)(cid:28)(cid:3,Unknown,21215.0
Unknown,Unknown,1,Unknown,Unknown,Unknown,Unknown,cid:3)(cid:5)(cid:14)(cid:70)(cid:12)(cid:11)(cid:4)(cid:14)(cid:11)(cid:48)(cid:48)(cid:7)(cid:5)(cid:3)(cid:9)(cid:2)(cid:12)(cid:11)(cid:4)(cid:14)(cid:11)(cid:48)(cid:48)(cid:7)(cid:5)(cid:3)(cid:9)(cid:2)(cid:28)(cid:3,Unknown,21216.0
Unknown,Unknown,18,Unknown,Unknown,Unknown,Unknown,cid:3)(cid:5)(cid:14)(cid:70)(cid:12)(cid:11)(cid:4)(cid:14)(cid:11)(cid:48)(cid:48)(cid:7)(cid:5)(cid:3)(cid:9)(cid:2)(cid:12)(cid:11)(cid:4)(cid:14)(cid:11)(cid:48)(cid:48)(cid:7)(cid:5)(cid:3)(cid:9)(cid:2)(cid:28)(cid:3,Unknown,21234.0
Unknown,Unknown,2,Unknown,Unknown,Unknown,Unknown,cid:3)(cid:5)(cid:14)(cid:70)(cid:12)(cid:11)(cid:4)(cid:14)(cid:11)(cid:48)(cid:48)(cid:7)(cid:5)(cid:3)(cid:9)(cid:2)(cid:12)(cid:11)(cid:4)(cid:14)(cid:11)(cid:48)(cid:48)(cid:7)(cid:5)(cid:3)(cid:9)(cid:2)(cid:28)(cid:3,Unknown,21236.0
Unknown,Unknown,44,Unknown,Unknown,Unknown,Unknown,cid:3)(cid:5)(cid:14)(cid:70)(cid:12)(cid:11)(cid:4)(cid:14)(cid:11)(cid:48)(cid:48)(cid:7)(cid:5)(cid:3)(cid:9)(cid:2)(cid:12)(cid:11)(cid:4)(cid:14)(cid:11)(cid:48)(cid:48)(cid:7)(cid:5)(cid:3)(cid:9)(cid:2)(cid:28)(cid:3,Unknown,21280.0
Unknown,Unknown,12,Unknown,Unknown,Unknown,Unknown,cid:3)(cid:5)(cid:14)(cid:70)(cid:12)(cid:11)(cid:4)(cid:14)(cid:11)(cid:48)(cid:48)(cid:7)(cid:5)(cid:3)(cid:9)(cid:2)(cid:12)(cid:11)(cid:4)(cid:14)(cid:11)(cid:48)(cid:48)(cid:7)(cid:5)(cid:3)(cid:9)(cid:2)(cid:28)(cid:3,Unknown,21292.0
Unknown,Unknown,29,Unknown,Unknown,Unknown,Unknown,cid:3)(cid:5)(cid:14)(cid:70)(cid:12)(cid:11)(cid:4)(cid:14)(cid:11)(cid:48)(cid:48)(cid:7)(cid:5)(cid:3)(cid:9)(cid:2)(cid:12)(cid:11)(cid:4)(cid:14)(cid:11)(cid:48)(cid:48)(cid:7)(cid:5)(cid:3)(cid:9)(cid:2)(cid:28)(cid:3,Unknown,21321.0
Unknown,Unknown,26,Unknown,Unknown,Unknown,Unknown,cid:3)(cid:5)(cid:14)(cid:70)(cid:12)(cid:11)(cid:4)(cid:14)(cid:11)(cid:48)(cid:48)(cid:7)(cid:5)(cid:3)(cid:9)(cid:2)(cid:12)(cid:11)(cid:4)(cid:14)(cid:11)(cid:48)(cid:48)(cid:7)(cid:5)(cid:3)(cid:9)(cid:2)(cid:28)(cid:3,Unknown,21347.0
Unknown,Unknown,41,Unknown,Unknown,Unknown,Unknown,cid:3)(cid:5)(cid:14)(cid:70)(cid:12)(cid:11)(cid:4)(cid:14)(cid:11)(cid:48)(cid:48)(cid:7)(cid:5)(cid:3)(cid:9)(cid:2)(cid:12)(cid:11)(cid:4)(cid:14)(cid:11)(cid:48)(cid:48)(cid:7)(cid:5)(cid:3)(cid:9)(cid:2)(cid:28)(cid:3,Unknown,21388.0
Unknown,Unknown,25,Unknown,Unknown,Unknown,Unknown,cid:3)(cid:5)(cid:14)(cid:70)(cid:12)(cid:11)(cid:4)(cid:14)(cid:11)(cid:48)(cid:48)(cid:7)(cid:5)(cid:3)(cid:9)(cid:2)(cid:12)(cid:11)(cid:4)(cid:14)(cid:11)(cid:48)(cid:48)(cid:7)(cid:5)(cid:3)(cid:9)(cid:2)(cid:28)(cid:3,Unknown,21413.0
Unknown,Unknown,2,Unknown,Unknown,Unknown,Unknown,cid:3)(cid:5)(cid:14)(cid:70)(cid:12)(cid:11)(cid:4)(cid:14)(cid:11)(cid:48)(cid:48)(cid:7)(cid:5)(cid:3)(cid:9)(cid:2)(cid:12)(cid:11)(cid:4)(cid:14)(cid:11)(cid:48)(cid:48)(cid:7)(cid:5)(cid:3)(cid:9)(cid:2)(cid:28)(cid:3,Unknown,21415.0
Unknown,Unknown,58,Unknown,Unknown,Unknown,Unknown,cid:3)(cid:5)(cid:14)(cid:70)(cid:12)(cid:11)(cid:4)(cid:14)(cid:11)(cid:48)(cid:48)(cid:7)(cid:5)(cid:3)(cid:9)(cid:2)(cid:12)(cid:11)(cid:4)(cid:14)(cid:11)(cid:48)(cid:48)(cid:7)(cid:5)(cid:3)(cid:9)(cid:2)(cid:28)(cid:3,Unknown,21473.0
Unknown,Unknown,58,Unknown,Unknown,Unknown,Unknown,cid:3)(cid:5)(cid:14)(cid:70)(cid:12)(cid:11)(cid:4)(cid:14)(cid:11)(cid:48)(cid:48)(cid:7)(cid:5)(cid:3)(cid:9)(cid:2)(cid:12)(cid:11)(cid:4)(cid:14)(cid:11)(cid:48)(cid:48)(cid:7)(cid:5)(cid:3)(cid:9)(cid:2)(cid:28)(cid:3,Unknown,21531.0
Unknown,Unknown,37,Unknown,Unknown,Unknown,Unknown,cid:3)(cid:5)(cid:14)(cid:70)(cid:12)(cid:11)(cid:4)(cid:14)(cid:11)(cid:48)(cid:48)(cid:7)(cid:5)(cid:3)(cid:9)(cid:2)(cid:12)(cid:11)(cid:4)(cid:14)(cid:11)(cid:48)(cid:48)(cid:7)(cid:5)(cid:3)(cid:9)(cid:2)(cid:28)(cid:3,Unknown,21568.0
Unknown,Unknown,16,Unknown,Unknown,Unknown,Unknown,cid:3)(cid:5)(cid:14)(cid:70)(cid:12)(cid:11)(cid:4)(cid:14)(cid:11)(cid:48)(cid:48)(cid:7)(cid:5)(cid:3)(cid:9)(cid:2)(cid:12)(cid:11)(cid:4)(cid:14)(cid:11)(cid:48)(cid:48)(cid:7)(cid:5)(cid:3)(cid:9)(cid:2)(cid:28)(cid:3,Unknown,21584.0
Unknown,Unknown,34,Unknown,Unknown,Unknown,Unknown,cid:3)(cid:5)(cid:14)(cid:70)(cid:12)(cid:11)(cid:4)(cid:14)(cid:11)(cid:48)(cid:48)(cid:7)(cid:5)(cid:3)(cid:9)(cid:2)(cid:12)(cid:11)(cid:4)(cid:14)(cid:11)(cid:48)(cid:48)(cid:7)(cid:5)(cid:3)(cid:9)(cid:2)(cid:28)(cid:3,Unknown,21618.0
Unknown,Unknown,33,Unknown,Unknown,Unknown,Unknown,cid:3)(cid:5)(cid:14)(cid:70)(cid:12)(cid:11)(cid:4)(cid:14)(cid:11)(cid:48)(cid:48)(cid:7)(cid:5)(cid:3)(cid:9)(cid:2)(cid:12)(cid:11)(cid:4)(cid:14)(cid:11)(cid:48)(cid:48)(cid:7)(cid:5)(cid:3)(cid:9)(cid:2)(cid:28)(cid:3,Unknown,21651.0
Unknown,Unknown,17,Unknown,Unknown,Unknown,Unknown,cid:3)(cid:5)(cid:14)(cid:70)(cid:12)(cid:11)(cid:4)(cid:14)(cid:11)(cid:48)(cid:48)(cid:7)(cid:5)(cid:3)(cid:9)(cid:2)(cid:12)(cid:11)(cid:4)(cid:14)(cid:11)(cid:48)(cid:48)(cid:7)(cid:5)(cid:3)(cid:9)(cid:2)(cid:28)(cid:3,Unknown,21668.0
Unknown,Unknown,33,Unknown,Unknown,Unknown,Unknown,cid:3)(cid:5)(cid:14)(cid:70)(cid:12)(cid:11)(cid:4)(cid:14)(cid:11)(cid:48)(cid:48)(cid:7)(cid:5)(cid:3)(cid:9)(cid:2)(cid:12)(cid:11)(cid:4)(cid:14)(cid:11)(cid:48)(cid:48)(cid:7)(cid:5)(cid:3)(cid:9)(cid:2)(cid:28)(cid:3,Unknown,21701.0
Unknown,Unknown,45,Unknown,Unknown,Unknown,Unknown,cid:3)(cid:5)(cid:14)(cid:70)(cid:12)(cid:11)(cid:4)(cid:14)(cid:11)(cid:48)(cid:48)(cid:7)(cid:5)(cid:3)(cid:9)(cid:2)(cid:12)(cid:11)(cid:4)(cid:14)(cid:11)(cid:48)(cid:48)(cid:7)(cid:5)(cid:3)(cid:9)(cid:2)(cid:28)(cid:3,Unknown,21746.0
Unknown,Unknown,18,Unknown,Unknown,Unknown,Unknown,cid:3)(cid:5)(cid:14)(cid:70)(cid:12)(cid:11)(cid:4)(cid:14)(cid:11)(cid:48)(cid:48)(cid:7)(cid:5)(cid:3)(cid:9)(cid:2)(cid:12)(cid:11)(cid:4)(cid:14)(cid:11)(cid:48)(cid:48)(cid:7)(cid:5)(cid:3)(cid:9)(cid:2)(cid:28)(cid:3,Unknown,21764.0
Unknown,Unknown,16,Unknown,Unknown,Unknown,Unknown,cid:3)(cid:5)(cid:14)(cid:70)(cid:12)(cid:11)(cid:4)(cid:14)(cid:11)(cid:48)(cid:48)(cid:7)(cid:5)(cid:3)(cid:9)(cid:2)(cid:12)(cid:11)(cid:4)(cid:14)(cid:11)(cid:48)(cid:48)(cid:7)(cid:5)(cid:3)(cid:9)(cid:2)(cid:28)(cid:3,Unknown,21780.0
Unknown,Unknown,48,Unknown,Unknown,Unknown,Unknown,cid:3)(cid:5)(cid:14)(cid:70)(cid:12)(cid:11)(cid:4)(cid:14)(cid:11)(cid:48)(cid:48)(cid:7)(cid:5)(cid:3)(cid:9)(cid:2)(cid:12)(cid:11)(cid:4)(cid:14)(cid:11)(cid:48)(cid:48)(cid:7)(cid:5)(cid:3)(cid:9)(cid:2)(cid:28)(cid:3,Unknown,21828.0
Unknown,Unknown,12,Unknown,Unknown,Unknown,Unknown,cid:3)(cid:5)(cid:14)(cid:70)(cid:12)(cid:11)(cid:4)(cid:14)(cid:11)(cid:48)(cid:48)(cid:7)(cid:5)(cid:3)(cid:9)(cid:2)(cid:12)(cid:11)(cid:4)(cid:14)(cid:11)(cid:48)(cid:48)(cid:7)(cid:5)(cid:3)(cid:9)(cid:2)(cid:28)(cid:3,Unknown,21840.0
Unknown,Unknown,50,Unknown,Unknown,Unknown,Unknown,cid:3)(cid:5)(cid:14)(cid:70)(cid:12)(cid:11)(cid:4)(cid:14)(cid:11)(cid:48)(cid:48)(cid:7)(cid:5)(cid:3)(cid:9)(cid:2)(cid:12)(cid:11)(cid:4)(cid:14)(cid:11)(cid:48)(cid:48)(cid:7)(cid:5)(cid:3)(cid:9)(cid:2)(cid:28)(cid:3,Unknown,21890.0
Unknown,Unknown,11,Unknown,Unknown,Unknown,Unknown,cid:3)(cid:5)(cid:14)(cid:70)(cid:12)(cid:11)(cid:4)(cid:14)(cid:11)(cid:48)(cid:48)(cid:7)(cid:5)(cid:3)(cid:9)(cid:2)(cid:12)(cid:11)(cid:4)(cid:14)(cid:11)(cid:48)(cid:48)(cid:7)(cid:5)(cid:3)(cid:9)(cid:2)(cid:28)(cid:3,Unknown,21901.0
Unknown,Unknown,8,Unknown,Unknown,Unknown,Unknown,cid:3)(cid:5)(cid:14)(cid:70)(cid:12)(cid:11)(cid:4)(cid:14)(cid:11)(cid:48)(cid:48)(cid:7)(cid:5)(cid:3)(cid:9)(cid:2)(cid:12)(cid:11)(cid:4)(cid:14)(cid:11)(cid:48)(cid:48)(cid:7)(cid:5)(cid:3)(cid:9)(cid:2)(cid:28)(cid:3,Unknown,21909.0
Unknown,Unknown,46,Unknown,Unknown,Unknown,Unknown,cid:3)(cid:5)(cid:14)(cid:70)(cid:12)(cid:11)(cid:4)(cid:14)(cid:11)(cid:48)(cid:48)(cid:7)(cid:5)(cid:3)(cid:9)(cid:2)(cid:12)(cid:11)(cid:4)(cid:14)(cid:11)(cid:48)(cid:48)(cid:7)(cid:5)(cid:3)(cid:9)(cid:2)(cid:28)(cid:3,Unknown,21955.0
Unknown,Unknown,14,Unknown,Unknown,Unknown,Unknown,cid:3)(cid:5)(cid:14)(cid:70)(cid:12)(cid:11)(cid:4)(cid:14)(cid:11)(cid:48)(cid:48)(cid:7)(cid:5)(cid:3)(cid:9)(cid:2)(cid:12)(cid:11)(cid:4)(cid:14)(cid:11)(cid:48)(cid:48)(cid:7)(cid:5)(cid:3)(cid:9)(cid:2)(cid:28)(cid:3,Unknown,21969.0
Unknown,Unknown,50,Unknown,Unknown,Unknown,Unknown,cid:3)(cid:5)(cid:14)(cid:70)(cid:12)(cid:11)(cid:4)(cid:14)(cid:11)(cid:48)(cid:48)(cid:7)(cid:5)(cid:3)(cid:9)(cid:2)(cid:12)(cid:11)(cid:4)(cid:14)(cid:11)(cid:48)(cid:48)(cid:7)(cid:5)(cid:3)(cid:9)(cid:2)(cid:28)(cid:3,Unknown,22019.0
Unknown,Unknown,9,Unknown,Unknown,Unknown,Unknown,cid:3)(cid:5)(cid:14)(cid:70)(cid:12)(cid:11)(cid:4)(cid:14)(cid:11)(cid:48)(cid:48)(cid:7)(cid:5)(cid:3)(cid:9)(cid:2)(cid:12)(cid:11)(cid:4)(cid:14)(cid:11)(cid:48)(cid:48)(cid:7)(cid:5)(cid:3)(cid:9)(cid:2)(cid:28)(cid:3,Unknown,22028.0
Unknown,Unknown,17,Unknown,Unknown,Unknown,Unknown,cid:3)(cid:5)(cid:14)(cid:70)(cid:12)(cid:11)(cid:4)(cid:14)(cid:11)(cid:48)(cid:48)(cid:7)(cid:5)(cid:3)(cid:9)(cid:2)(cid:12)(cid:11)(cid:4)(cid:14)(cid:11)(cid:48)(cid:48)(cid:7)(cid:5)(cid:3)(cid:9)(cid:2)(cid:28)(cid:3,Unknown,22045.0
Unknown,Unknown,36,Unknown,Unknown,Unknown,Unknown,cid:3)(cid:5)(cid:14)(cid:70)(cid:12)(cid:11)(cid:4)(cid:14)(cid:11)(cid:48)(cid:48)(cid:7)(cid:5)(cid:3)(cid:9)(cid:2)(cid:12)(cid:11)(cid:4)(cid:14)(cid:11)(cid:48)(cid:48)(cid:7)(cid:5)(cid:3)(cid:9)(cid:2)(cid:28)(cid:3,Unknown,22081.0
Unknown,Unknown,18,Unknown,Unknown,Unknown,Unknown,cid:3)(cid:5)(cid:14)(cid:70)(cid:12)(cid:11)(cid:4)(cid:14)(cid:11)(cid:48)(cid:48)(cid:7)(cid:5)(cid:3)(cid:9)(cid:2)(cid:12)(cid:11)(cid:4)(cid:14)(cid:11)(cid:48)(cid:48)(cid:7)(cid:5)(cid:3)(cid:9)(cid:2)(cid:28)(cid:3,Unknown,22099.0
Unknown,Unknown,1,Unknown,Unknown,Unknown,Unknown,cid:3)(cid:5)(cid:14)(cid:70)(cid:12)(cid:11)(cid:4)(cid:14)(cid:11)(cid:48)(cid:48)(cid:7)(cid:5)(cid:3)(cid:9)(cid:2)(cid:12)(cid:11)(cid:4)(cid:14)(cid:11)(cid:48)(cid:48)(cid:7)(cid:5)(cid:3)(cid:9)(cid:2)(cid:28)(cid:3,Unknown,22100.0
Unknown,Unknown,2,Unknown,Unknown,Unknown,Unknown,cid:3)(cid:5)(cid:14)(cid:70)(cid:12)(cid:11)(cid:4)(cid:14)(cid:11)(cid:48)(cid:48)(cid:7)(cid:5)(cid:3)(cid:9)(cid:2)(cid:12)(cid:11)(cid:4)(cid:14)(cid:11)(cid:48)(cid:48)(cid:7)(cid:5)(cid:3)(cid:9)(cid:2)(cid:28)(cid:3,Unknown,22102.0
Unknown,Unknown,12,Unknown,Unknown,Unknown,Unknown,cid:3)(cid:5)(cid:14)(cid:70)(cid:12)(cid:11)(cid:4)(cid:14)(cid:11)(cid:48)(cid:48)(cid:7)(cid:5)(cid:3)(cid:9)(cid:2)(cid:12)(cid:11)(cid:4)(cid:14)(cid:11)(cid:48)(cid:48)(cid:7)(cid:5)(cid:3)(cid:9)(cid:2)(cid:28)(cid:3,Unknown,22114.0
Unknown,Unknown,11,Unknown,Unknown,Unknown,Unknown,cid:3)(cid:5)(cid:14)(cid:70)(cid:12)(cid:11)(cid:4)(cid:14)(cid:11)(cid:48)(cid:48)(cid:7)(cid:5)(cid:3)(cid:9)(cid:2)(cid:12)(cid:11)(cid:4)(cid:14)(cid:11)(cid:48)(cid:48)(cid:7)(cid:5)(cid:3)(cid:9)(cid:2)(cid:28)(cid:3,Unknown,22125.0
Unknown,Unknown,4,Unknown,Unknown,Unknown,Unknown,cid:3)(cid:5)(cid:14)(cid:70)(cid:12)(cid:11)(cid:4)(cid:14)(cid:11)(cid:48)(cid:48)(cid:7)(cid:5)(cid:3)(cid:9)(cid:2)(cid:12)(cid:11)(cid:4)(cid:14)(cid:11)(cid:48)(cid:48)(cid:7)(cid:5)(cid:3)(cid:9)(cid:2)(cid:28)(cid:3,Unknown,22129.0
Unknown,Unknown,7,Unknown,Unknown,Unknown,Unknown,cid:3)(cid:5)(cid:14)(cid:70)(cid:12)(cid:11)(cid:4)(cid:14)(cid:11)(cid:48)(cid:48)(cid:7)(cid:5)(cid:3)(cid:9)(cid:2)(cid:12)(cid:11)(cid:4)(cid:14)(cid:11)(cid:48)(cid:48)(cid:7)(cid:5)(cid:3)(cid:9)(cid:2)(cid:28)(cid:3,Unknown,22136.0
Unknown,Unknown,14,Unknown,Unknown,Unknown,Unknown,cid:3)(cid:5)(cid:14)(cid:70)(cid:12)(cid:11)(cid:4)(cid:14)(cid:11)(cid:48)(cid:48)(cid:7)(cid:5)(cid:3)(cid:9)(cid:2)(cid:12)(cid:11)(cid:4)(cid:14)(cid:11)(cid:48)(cid:48)(cid:7)(cid:5)(cid:3)(cid:9)(cid:2)(cid:28)(cid:3,Unknown,22150.0
Unknown,Unknown,14,Unknown,Unknown,Unknown,Unknown,cid:3)(cid:5)(cid:14)(cid:70)(cid:12)(cid:11)(cid:4)(cid:14)(cid:11)(cid:48)(cid:48)(cid:7)(cid:5)(cid:3)(cid:9)(cid:2)(cid:12)(cid:11)(cid:4)(cid:14)(cid:11)(cid:48)(cid:48)(cid:7)(cid:5)(cid:3)(cid:9)(cid:2)(cid:28)(cid:3,Unknown,22164.0
Unknown,Unknown,49,Unknown,Unknown,Unknown,Unknown,cid:3)(cid:5)(cid:14)(cid:70)(cid:12)(cid:11)(cid:4)(cid:14)(cid:11)(cid:48)(cid:48)(cid:7)(cid:5)(cid:3)(cid:9)(cid:2)(cid:12)(cid:11)(cid:4)(cid:14)(cid:11)(cid:48)(cid:48)(cid:7)(cid:5)(cid:3)(cid:9)(cid:2)(cid:28)(cid:3,Unknown,22213.0
Unknown,Unknown,2,Unknown,Unknown,Unknown,Unknown,cid:3)(cid:5)(cid:14)(cid:70)(cid:12)(cid:11)(cid:4)(cid:14)(cid:11)(cid:48)(cid:48)(cid:7)(cid:5)(cid:3)(cid:9)(cid:2)(cid:12)(cid:11)(cid:4)(cid:14)(cid:11)(cid:48)(cid:48)(cid:7)(cid:5)(cid:3)(cid:9)(cid:2)(cid:28)(cid:3,Unknown,22215.0
Unknown,Unknown,39,Unknown,Unknown,Unknown,Unknown,cid:3)(cid:5)(cid:14)(cid:70)(cid:12)(cid:11)(cid:4)(cid:14)(cid:11)(cid:48)(cid:48)(cid:7)(cid:5)(cid:3)(cid:9)(cid:2)(cid:12)(cid:11)(cid:4)(cid:14)(cid:11)(cid:48)(cid:48)(cid:7)(cid:5)(cid:3)(cid:9)(cid:2)(cid:28)(cid:3,Unknown,22254.0
Unknown,Unknown,11,Unknown,Unknown,Unknown,Unknown,cid:3)(cid:5)(cid:14)(cid:70)(cid:12)(cid:11)(cid:4)(cid:14)(cid:11)(cid:48)(cid:48)(cid:7)(cid:5)(cid:3)(cid:9)(cid:2)(cid:12)(cid:11)(cid:4)(cid:14)(cid:11)(cid:48)(cid:48)(cid:7)(cid:5)(cid:3)(cid:9)(cid:2)(cid:28)(cid:3,Unknown,22265.0
Unknown,Unknown,2,Unknown,Unknown,Unknown,Unknown,cid:3)(cid:5)(cid:14)(cid:70)(cid:12)(cid:11)(cid:4)(cid:14)(cid:11)(cid:48)(cid:48)(cid:7)(cid:5)(cid:3)(cid:9)(cid:2)(cid:12)(cid:11)(cid:4)(cid:14)(cid:11)(cid:48)(cid:48)(cid:7)(cid:5)(cid:3)(cid:9)(cid:2)(cid:28)(cid:3,Unknown,22267.0
Unknown,Unknown,28,Unknown,Unknown,Unknown,Unknown,cid:3)(cid:5)(cid:14)(cid:70)(cid:12)(cid:11)(cid:4)(cid:14)(cid:11)(cid:48)(cid:48)(cid:7)(cid:5)(cid:3)(cid:9)(cid:2)(cid:12)(cid:11)(cid:4)(cid:14)(cid:11)(cid:48)(cid:48)(cid:7)(cid:5)(cid:3)(cid:9)(cid:2)(cid:28)(cid:3,Unknown,22295.0
Unknown,Unknown,3,Unknown,Unknown,Unknown,Unknown,cid:3)(cid:5)(cid:14)(cid:70)(cid:12)(cid:11)(cid:4)(cid:14)(cid:11)(cid:48)(cid:48)(cid:7)(cid:5)(cid:3)(cid:9)(cid:2)(cid:12)(cid:11)(cid:4)(cid:14)(cid:11)(cid:48)(cid:48)(cid:7)(cid:5)(cid:3)(cid:9)(cid:2)(cid:28)(cid:3,Unknown,22298.0
Unknown,Unknown,15,Unknown,Unknown,Unknown,Unknown,cid:3)(cid:5)(cid:14)(cid:70)(cid:12)(cid:11)(cid:4)(cid:14)(cid:11)(cid:48)(cid:48)(cid:7)(cid:5)(cid:3)(cid:9)(cid:2)(cid:12)(cid:11)(cid:4)(cid:14)(cid:11)(cid:48)(cid:48)(cid:7)(cid:5)(cid:3)(cid:9)(cid:2)(cid:28)(cid:3,Unknown,22313.0
Unknown,Unknown,2,Unknown,Unknown,Unknown,Unknown,cid:3)(cid:5)(cid:14)(cid:70)(cid:12)(cid:11)(cid:4)(cid:14)(cid:11)(cid:48)(cid:48)(cid:7)(cid:5)(cid:3)(cid:9)(cid:2)(cid:12)(cid:11)(cid:4)(cid:14)(cid:11)(cid:48)(cid:48)(cid:7)(cid:5)(cid:3)(cid:9)(cid:2)(cid:28)(cid:3,Unknown,22315.0
Unknown,Unknown,37,Unknown,Unknown,Unknown,Unknown,cid:3)(cid:5)(cid:14)(cid:70)(cid:12)(cid:11)(cid:4)(cid:14)(cid:11)(cid:48)(cid:48)(cid:7)(cid:5)(cid:3)(cid:9)(cid:2)(cid:12)(cid:11)(cid:4)(cid:14)(cid:11)(cid:48)(cid:48)(cid:7)(cid:5)(cid:3)(cid:9)(cid:2)(cid:28)(cid:3,Unknown,22352.0
Unknown,Unknown,36,Unknown,Unknown,Unknown,Unknown,cid:3)(cid:5)(cid:14)(cid:70)(cid:12)(cid:11)(cid:4)(cid:14)(cid:11)(cid:48)(cid:48)(cid:7)(cid:5)(cid:3)(cid:9)(cid:2)(cid:12)(cid:11)(cid:4)(cid:14)(cid:11)(cid:48)(cid:48)(cid:7)(cid:5)(cid:3)(cid:9)(cid:2)(cid:28)(cid:3,Unknown,22388.0
Unknown,Unknown,19,Unknown,Unknown,Unknown,Unknown,cid:3)(cid:5)(cid:14)(cid:70)(cid:12)(cid:11)(cid:4)(cid:14)(cid:11)(cid:48)(cid:48)(cid:7)(cid:5)(cid:3)(cid:9)(cid:2)(cid:12)(cid:11)(cid:4)(cid:14)(cid:11)(cid:48)(cid:48)(cid:7)(cid:5)(cid:3)(cid:9)(cid:2)(cid:28)(cid:3,Unknown,22407.0
Unknown,Unknown,1,Unknown,Unknown,Unknown,Unknown,cid:3)(cid:5)(cid:14)(cid:70)(cid:12)(cid:11)(cid:4)(cid:14)(cid:11)(cid:48)(cid:48)(cid:7)(cid:5)(cid:3)(cid:9)(cid:2)(cid:12)(cid:11)(cid:4)(cid:14)(cid:11)(cid:48)(cid:48)(cid:7)(cid:5)(cid:3)(cid:9)(cid:2)(cid:28)(cid:3,Unknown,22408.0
Unknown,Unknown,34,Unknown,Unknown,Unknown,Unknown,cid:3)(cid:5)(cid:14)(cid:70)(cid:12)(cid:11)(cid:4)(cid:14)(cid:11)(cid:48)(cid:48)(cid:7)(cid:5)(cid:3)(cid:9)(cid:2)(cid:12)(cid:11)(cid:4)(cid:14)(cid:11)(cid:48)(cid:48)(cid:7)(cid:5)(cid:3)(cid:9)(cid:2)(cid:28)(cid:3,Unknown,22442.0
Unknown,Unknown,2,Unknown,Unknown,Unknown,Unknown,cid:3)(cid:5)(cid:14)(cid:70)(cid:12)(cid:11)(cid:4)(cid:14)(cid:11)(cid:48)(cid:48)(cid:7)(cid:5)(cid:3)(cid:9)(cid:2)(cid:12)(cid:11)(cid:4)(cid:14)(cid:11)(cid:48)(cid:48)(cid:7)(cid:5)(cid:3)(cid:9)(cid:2)(cid:28)(cid:3,Unknown,22444.0
Unknown,Unknown,44,Unknown,Unknown,Unknown,Unknown,cid:3)(cid:5)(cid:14)(cid:70)(cid:12)(cid:11)(cid:4)(cid:14)(cid:11)(cid:48)(cid:48)(cid:7)(cid:5)(cid:3)(cid:9)(cid:2)(cid:12)(cid:11)(cid:4)(cid:14)(cid:11)(cid:48)(cid:48)(cid:7)(cid:5)(cid:3)(cid:9)(cid:2)(cid:28)(cid:3,Unknown,22488.0
Unknown,Unknown,12,Unknown,Unknown,Unknown,Unknown,cid:3)(cid:5)(cid:14)(cid:70)(cid:12)(cid:11)(cid:4)(cid:14)(cid:11)(cid:48)(cid:48)(cid:7)(cid:5)(cid:3)(cid:9)(cid:2)(cid:12)(cid:11)(cid:4)(cid:14)(cid:11)(cid:48)(cid:48)(cid:7)(cid:5)(cid:3)(cid:9)(cid:2)(cid:28)(cid:3,Unknown,22500.0
Unknown,Unknown,29,Unknown,Unknown,Unknown,Unknown,cid:3)(cid:5)(cid:14)(cid:70)(cid:12)(cid:11)(cid:4)(cid:14)(cid:11)(cid:48)(cid:48)(cid:7)(cid:5)(cid:3)(cid:9)(cid:2)(cid:12)(cid:11)(cid:4)(cid:14)(cid:11)(cid:48)(cid:48)(cid:7)(cid:5)(cid:3)(cid:9)(cid:2)(cid:28)(cid:3,Unknown,22529.0
Unknown,Unknown,26,Unknown,Unknown,Unknown,Unknown,cid:3)(cid:5)(cid:14)(cid:70)(cid:12)(cid:11)(cid:4)(cid:14)(cid:11)(cid:48)(cid:48)(cid:7)(cid:5)(cid:3)(cid:9)(cid:2)(cid:12)(cid:11)(cid:4)(cid:14)(cid:11)(cid:48)(cid:48)(cid:7)(cid:5)(cid:3)(cid:9)(cid:2)(cid:28)(cid:3,Unknown,22555.0
Unknown,Unknown,41,Unknown,Unknown,Unknown,Unknown,cid:3)(cid:5)(cid:14)(cid:70)(cid:12)(cid:11)(cid:4)(cid:14)(cid:11)(cid:48)(cid:48)(cid:7)(cid:5)(cid:3)(cid:9)(cid:2)(cid:12)(cid:11)(cid:4)(cid:14)(cid:11)(cid:48)(cid:48)(cid:7)(cid:5)(cid:3)(cid:9)(cid:2)(cid:28)(cid:3,Unknown,22596.0
Unknown,Unknown,25,Unknown,Unknown,Unknown,Unknown,cid:3)(cid:5)(cid:14)(cid:70)(cid:12)(cid:11)(cid:4)(cid:14)(cid:11)(cid:48)(cid:48)(cid:7)(cid:5)(cid:3)(cid:9)(cid:2)(cid:12)(cid:11)(cid:4)(cid:14)(cid:11)(cid:48)(cid:48)(cid:7)(cid:5)(cid:3)(cid:9)(cid:2)(cid:28)(cid:3,Unknown,22621.0
Unknown,Unknown,2,Unknown,Unknown,Unknown,Unknown,cid:3)(cid:5)(cid:14)(cid:70)(cid:12)(cid:11)(cid:4)(cid:14)(cid:11)(cid:48)(cid:48)(cid:7)(cid:5)(cid:3)(cid:9)(cid:2)(cid:12)(cid:11)(cid:4)(cid:14)(cid:11)(cid:48)(cid:48)(cid:7)(cid:5)(cid:3)(cid:9)(cid:2)(cid:28)(cid:3,Unknown,22623.0
Unknown,Unknown,58,Unknown,Unknown,Unknown,Unknown,cid:3)(cid:5)(cid:14)(cid:70)(cid:12)(cid:11)(cid:4)(cid:14)(cid:11)(cid:48)(cid:48)(cid:7)(cid:5)(cid:3)(cid:9)(cid:2)(cid:12)(cid:11)(cid:4)(cid:14)(cid:11)(cid:48)(cid:48)(cid:7)(cid:5)(cid:3)(cid:9)(cid:2)(cid:28)(cid:3,Unknown,22681.0
Unknown,Unknown,58,Unknown,Unknown,Unknown,Unknown,cid:3)(cid:5)(cid:14)(cid:70)(cid:12)(cid:11)(cid:4)(cid:14)(cid:11)(cid:48)(cid:48)(cid:7)(cid:5)(cid:3)(cid:9)(cid:2)(cid:12)(cid:11)(cid:4)(cid:14)(cid:11)(cid:48)(cid:48)(cid:7)(cid:5)(cid:3)(cid:9)(cid:2)(cid:28)(cid:3,Unknown,22739.0
Unknown,Unknown,37,Unknown,Unknown,Unknown,Unknown,cid:3)(cid:5)(cid:14)(cid:70)(cid:12)(cid:11)(cid:4)(cid:14)(cid:11)(cid:48)(cid:48)(cid:7)(cid:5)(cid:3)(cid:9)(cid:2)(cid:12)(cid:11)(cid:4)(cid:14)(cid:11)(cid:48)(cid:48)(cid:7)(cid:5)(cid:3)(cid:9)(cid:2)(cid:28)(cid:3,Unknown,22776.0
Unknown,Unknown,16,Unknown,Unknown,Unknown,Unknown,cid:3)(cid:5)(cid:14)(cid:70)(cid:12)(cid:11)(cid:4)(cid:14)(cid:11)(cid:48)(cid:48)(cid:7)(cid:5)(cid:3)(cid:9)(cid:2)(cid:12)(cid:11)(cid:4)(cid:14)(cid:11)(cid:48)(cid:48)(cid:7)(cid:5)(cid:3)(cid:9)(cid:2)(cid:28)(cid:3,Unknown,22792.0
Unknown,Unknown,34,Unknown,Unknown,Unknown,Unknown,cid:3)(cid:5)(cid:14)(cid:70)(cid:12)(cid:11)(cid:4)(cid:14)(cid:11)(cid:48)(cid:48)(cid:7)(cid:5)(cid:3)(cid:9)(cid:2)(cid:12)(cid:11)(cid:4)(cid:14)(cid:11)(cid:48)(cid:48)(cid:7)(cid:5)(cid:3)(cid:9)(cid:2)(cid:28)(cid:3,Unknown,22826.0
Unknown,Unknown,33,Unknown,Unknown,Unknown,Unknown,cid:3)(cid:5)(cid:14)(cid:70)(cid:12)(cid:11)(cid:4)(cid:14)(cid:11)(cid:48)(cid:48)(cid:7)(cid:5)(cid:3)(cid:9)(cid:2)(cid:12)(cid:11)(cid:4)(cid:14)(cid:11)(cid:48)(cid:48)(cid:7)(cid:5)(cid:3)(cid:9)(cid:2)(cid:28)(cid:3,Unknown,22859.0
Unknown,Unknown,17,Unknown,Unknown,Unknown,Unknown,cid:3)(cid:5)(cid:14)(cid:70)(cid:12)(cid:11)(cid:4)(cid:14)(cid:11)(cid:48)(cid:48)(cid:7)(cid:5)(cid:3)(cid:9)(cid:2)(cid:12)(cid:11)(cid:4)(cid:14)(cid:11)(cid:48)(cid:48)(cid:7)(cid:5)(cid:3)(cid:9)(cid:2)(cid:28)(cid:3,Unknown,22876.0
Unknown,Unknown,33,Unknown,Unknown,Unknown,Unknown,cid:3)(cid:5)(cid:14)(cid:70)(cid:12)(cid:11)(cid:4)(cid:14)(cid:11)(cid:48)(cid:48)(cid:7)(cid:5)(cid:3)(cid:9)(cid:2)(cid:12)(cid:11)(cid:4)(cid:14)(cid:11)(cid:48)(cid:48)(cid:7)(cid:5)(cid:3)(cid:9)(cid:2)(cid:28)(cid:3,Unknown,22909.0
Unknown,Unknown,45,Unknown,Unknown,Unknown,Unknown,cid:3)(cid:5)(cid:14)(cid:70)(cid:12)(cid:11)(cid:4)(cid:14)(cid:11)(cid:48)(cid:48)(cid:7)(cid:5)(cid:3)(cid:9)(cid:2)(cid:12)(cid:11)(cid:4)(cid:14)(cid:11)(cid:48)(cid:48)(cid:7)(cid:5)(cid:3)(cid:9)(cid:2)(cid:28)(cid:3,Unknown,22954.0
Unknown,Unknown,18,Unknown,Unknown,Unknown,Unknown,cid:3)(cid:5)(cid:14)(cid:70)(cid:12)(cid:11)(cid:4)(cid:14)(cid:11)(cid:48)(cid:48)(cid:7)(cid:5)(cid:3)(cid:9)(cid:2)(cid:12)(cid:11)(cid:4)(cid:14)(cid:11)(cid:48)(cid:48)(cid:7)(cid:5)(cid:3)(cid:9)(cid:2)(cid:28)(cid:3,Unknown,22972.0
Unknown,Unknown,16,Unknown,Unknown,Unknown,Unknown,cid:3)(cid:5)(cid:14)(cid:70)(cid:12)(cid:11)(cid:4)(cid:14)(cid:11)(cid:48)(cid:48)(cid:7)(cid:5)(cid:3)(cid:9)(cid:2)(cid:12)(cid:11)(cid:4)(cid:14)(cid:11)(cid:48)(cid:48)(cid:7)(cid:5)(cid:3)(cid:9)(cid:2)(cid:28)(cid:3,Unknown,22988.0
Unknown,Unknown,11,Unknown,Unknown,Unknown,Unknown,cid:3)(cid:5)(cid:14)(cid:70)(cid:12)(cid:11)(cid:4)(cid:14)(cid:11)(cid:48)(cid:48)(cid:7)(cid:5)(cid:3)(cid:9)(cid:2)(cid:12)(cid:11)(cid:4)(cid:14)(cid:11)(cid:48)(cid:48)(cid:7)(cid:5)(cid:3)(cid:9)(cid:2)(cid:28)(cid:3,Unknown,22999.0
Unknown,Unknown,50,Unknown,Unknown,Unknown,Unknown,cid:3)(cid:5)(cid:14)(cid:70)(cid:12)(cid:11)(cid:4)(cid:14)(cid:11)(cid:48)(cid:48)(cid:7)(cid:5)(cid:3)(cid:9)(cid:2)(cid:12)(cid:11)(cid:4)(cid:14)(cid:11)(cid:48)(cid:48)(cid:7)(cid:5)(cid:3)(cid:9)(cid:2)(cid:28)(cid:3,Unknown,23049.0
Unknown,Unknown,7,Unknown,Unknown,Unknown,Unknown,cid:3)(cid:5)(cid:14)(cid:70)(cid:12)(cid:11)(cid:4)(cid:14)(cid:11)(cid:48)(cid:48)(cid:7)(cid:5)(cid:3)(cid:9)(cid:2)(cid:12)(cid:11)(cid:4)(cid:14)(cid:11)(cid:48)(cid:48)(cid:7)(cid:5)(cid:3)(cid:9)(cid:2)(cid:28)(cid:3,Unknown,23056.0
Unknown,Unknown,11,Unknown,Unknown,Unknown,Unknown,cid:3)(cid:5)(cid:14)(cid:70)(cid:12)(cid:11)(cid:4)(cid:14)(cid:11)(cid:48)(cid:48)(cid:7)(cid:5)(cid:3)(cid:9)(cid:2)(cid:12)(cid:11)(cid:4)(cid:14)(cid:11)(cid:48)(cid:48)(cid:7)(cid:5)(cid:3)(cid:9)(cid:2)(cid:28)(cid:3,Unknown,23067.0
Unknown,Unknown,8,Unknown,Unknown,Unknown,Unknown,cid:3)(cid:5)(cid:14)(cid:70)(cid:12)(cid:11)(cid:4)(cid:14)(cid:11)(cid:48)(cid:48)(cid:7)(cid:5)(cid:3)(cid:9)(cid:2)(cid:12)(cid:11)(cid:4)(cid:14)(cid:11)(cid:48)(cid:48)(cid:7)(cid:5)(cid:3)(cid:9)(cid:2)(cid:28)(cid:3,Unknown,23075.0
Unknown,Unknown,2,Unknown,Unknown,Unknown,Unknown,cid:3)(cid:5)(cid:14)(cid:70)(cid:12)(cid:11)(cid:4)(cid:14)(cid:11)(cid:48)(cid:48)(cid:7)(cid:5)(cid:3)(cid:9)(cid:2)(cid:12)(cid:11)(cid:4)(cid:14)(cid:11)(cid:48)(cid:48)(cid:7)(cid:5)(cid:3)(cid:9)(cid:2)(cid:28)(cid:3,Unknown,23077.0
Unknown,Unknown,9,Unknown,Unknown,Unknown,Unknown,cid:3)(cid:5)(cid:14)(cid:70)(cid:12)(cid:11)(cid:4)(cid:14)(cid:11)(cid:48)(cid:48)(cid:7)(cid:5)(cid:3)(cid:9)(cid:2)(cid:12)(cid:11)(cid:4)(cid:14)(cid:11)(cid:48)(cid:48)(cid:7)(cid:5)(cid:3)(cid:9)(cid:2)(cid:28)(cid:3,Unknown,23086.0
Unknown,Unknown,5,Unknown,Unknown,Unknown,Unknown,cid:3)(cid:5)(cid:14)(cid:70)(cid:12)(cid:11)(cid:4)(cid:14)(cid:11)(cid:48)(cid:48)(cid:7)(cid:5)(cid:3)(cid:9)(cid:2)(cid:12)(cid:11)(cid:4)(cid:14)(cid:11)(cid:48)(cid:48)(cid:7)(cid:5)(cid:3)(cid:9)(cid:2)(cid:28)(cid:3,Unknown,23091.0
Unknown,Unknown,39,Unknown,Unknown,Unknown,Unknown,cid:3)(cid:5)(cid:14)(cid:70)(cid:12)(cid:11)(cid:4)(cid:14)(cid:11)(cid:48)(cid:48)(cid:7)(cid:5)(cid:3)(cid:9)(cid:2)(cid:12)(cid:11)(cid:4)(cid:14)(cid:11)(cid:48)(cid:48)(cid:7)(cid:5)(cid:3)(cid:9)(cid:2)(cid:28)(cid:3,Unknown,23130.0
Unknown,Unknown,10,Unknown,Unknown,Unknown,Unknown,cid:3)(cid:5)(cid:14)(cid:70)(cid:12)(cid:11)(cid:4)(cid:14)(cid:11)(cid:48)(cid:48)(cid:7)(cid:5)(cid:3)(cid:9)(cid:2)(cid:12)(cid:11)(cid:4)(cid:14)(cid:11)(cid:48)(cid:48)(cid:7)(cid:5)(cid:3)(cid:9)(cid:2)(cid:28)(cid:3,Unknown,23140.0
Unknown,Unknown,15,Unknown,Unknown,Unknown,Unknown,cid:3)(cid:5)(cid:14)(cid:70)(cid:12)(cid:11)(cid:4)(cid:14)(cid:11)(cid:48)(cid:48)(cid:7)(cid:5)(cid:3)(cid:9)(cid:2)(cid:12)(cid:11)(cid:4)(cid:14)(cid:11)(cid:48)(cid:48)(cid:7)(cid:5)(cid:3)(cid:9)(cid:2)(cid:28)(cid:3,Unknown,23155.0
Unknown,Unknown,9,Unknown,Unknown,Unknown,Unknown,cid:3)(cid:5)(cid:14)(cid:70)(cid:12)(cid:11)(cid:4)(cid:14)(cid:11)(cid:48)(cid:48)(cid:7)(cid:5)(cid:3)(cid:9)(cid:2)(cid:12)(cid:11)(cid:4)(cid:14)(cid:11)(cid:48)(cid:48)(cid:7)(cid:5)(cid:3)(cid:9)(cid:2)(cid:28)(cid:3,Unknown,23164.0
Unknown,Unknown,11,Unknown,Unknown,Unknown,Unknown,cid:3)(cid:5)(cid:14)(cid:70)(cid:12)(cid:11)(cid:4)(cid:14)(cid:11)(cid:48)(cid:48)(cid:7)(cid:5)(cid:3)(cid:9)(cid:2)(cid:12)(cid:11)(cid:4)(cid:14)(cid:11)(cid:48)(cid:48)(cid:7)(cid:5)(cid:3)(cid:9)(cid:2)(cid:28)(cid:3,Unknown,23175.0
Unknown,Unknown,3,Unknown,Unknown,Unknown,Unknown,cid:3)(cid:5)(cid:14)(cid:70)(cid:12)(cid:11)(cid:4)(cid:14)(cid:11)(cid:48)(cid:48)(cid:7)(cid:5)(cid:3)(cid:9)(cid:2)(cid:12)(cid:11)(cid:4)(cid:14)(cid:11)(cid:48)(cid:48)(cid:7)(cid:5)(cid:3)(cid:9)(cid:2)(cid:28)(cid:3,Unknown,23178.0
Unknown,Unknown,10,Unknown,Unknown,Unknown,Unknown,cid:3)(cid:5)(cid:14)(cid:70)(cid:12)(cid:11)(cid:4)(cid:14)(cid:11)(cid:48)(cid:48)(cid:7)(cid:5)(cid:3)(cid:9)(cid:2)(cid:12)(cid:11)(cid:4)(cid:14)(cid:11)(cid:48)(cid:48)(cid:7)(cid:5)(cid:3)(cid:9)(cid:2)(cid:28)(cid:3,Unknown,23188.0
Unknown,Unknown,9,Unknown,Unknown,Unknown,Unknown,cid:3)(cid:5)(cid:14)(cid:70)(cid:12)(cid:11)(cid:4)(cid:14)(cid:11)(cid:48)(cid:48)(cid:7)(cid:5)(cid:3)(cid:9)(cid:2)(cid:12)(cid:11)(cid:4)(cid:14)(cid:11)(cid:48)(cid:48)(cid:7)(cid:5)(cid:3)(cid:9)(cid:2)(cid:28)(cid:3,Unknown,23197.0
Unknown,Unknown,2,Unknown,Unknown,Unknown,Unknown,cid:3)(cid:5)(cid:14)(cid:70)(cid:12)(cid:11)(cid:4)(cid:14)(cid:11)(cid:48)(cid:48)(cid:7)(cid:5)(cid:3)(cid:9)(cid:2)(cid:12)(cid:11)(cid:4)(cid:14)(cid:11)(cid:48)(cid:48)(cid:7)(cid:5)(cid:3)(cid:9)(cid:2)(cid:28)(cid:3,Unknown,23199.0
Unknown,Unknown,28,Unknown,Unknown,Unknown,Unknown,cid:3)(cid:5)(cid:14)(cid:70)(cid:12)(cid:11)(cid:4)(cid:14)(cid:11)(cid:48)(cid:48)(cid:7)(cid:5)(cid:3)(cid:9)(cid:2)(cid:12)(cid:11)(cid:4)(cid:14)(cid:11)(cid:48)(cid:48)(cid:7)(cid:5)(cid:3)(cid:9)(cid:2)(cid:28)(cid:3,Unknown,23227.0
Unknown,Unknown,3,Unknown,Unknown,Unknown,Unknown,cid:3)(cid:5)(cid:14)(cid:70)(cid:12)(cid:11)(cid:4)(cid:14)(cid:11)(cid:48)(cid:48)(cid:7)(cid:5)(cid:3)(cid:9)(cid:2)(cid:12)(cid:11)(cid:4)(cid:14)(cid:11)(cid:48)(cid:48)(cid:7)(cid:5)(cid:3)(cid:9)(cid:2)(cid:28)(cid:3,Unknown,23230.0
Unknown,Unknown,15,Unknown,Unknown,Unknown,Unknown,cid:3)(cid:5)(cid:14)(cid:70)(cid:12)(cid:11)(cid:4)(cid:14)(cid:11)(cid:48)(cid:48)(cid:7)(cid:5)(cid:3)(cid:9)(cid:2)(cid:12)(cid:11)(cid:4)(cid:14)(cid:11)(cid:48)(cid:48)(cid:7)(cid:5)(cid:3)(cid:9)(cid:2)(cid:28)(cid:3,Unknown,23245.0
Unknown,Unknown,2,Unknown,Unknown,Unknown,Unknown,cid:3)(cid:5)(cid:14)(cid:70)(cid:12)(cid:11)(cid:4)(cid:14)(cid:11)(cid:48)(cid:48)(cid:7)(cid:5)(cid:3)(cid:9)(cid:2)(cid:12)(cid:11)(cid:4)(cid:14)(cid:11)(cid:48)(cid:48)(cid:7)(cid:5)(cid:3)(cid:9)(cid:2)(cid:28)(cid:3,Unknown,23247.0
Unknown,Unknown,1,Unknown,Unknown,Unknown,Unknown,cid:3)(cid:5)(cid:14)(cid:70)(cid:12)(cid:11)(cid:4)(cid:14)(cid:11)(cid:48)(cid:48)(cid:7)(cid:5)(cid:3)(cid:9)(cid:2)(cid:12)(cid:11)(cid:4)(cid:14)(cid:11)(cid:48)(cid:48)(cid:7)(cid:5)(cid:3)(cid:9)(cid:2)(cid:28)(cid:3,Unknown,23248.0
Unknown,Unknown,33,Unknown,Unknown,Unknown,Unknown,cid:3)(cid:5)(cid:14)(cid:70)(cid:12)(cid:11)(cid:4)(cid:14)(cid:11)(cid:48)(cid:48)(cid:7)(cid:5)(cid:3)(cid:9)(cid:2)(cid:12)(cid:11)(cid:4)(cid:14)(cid:11)(cid:48)(cid:48)(cid:7)(cid:5)(cid:3)(cid:9)(cid:2)(cid:28)(cid:3,Unknown,23281.0
Unknown,Unknown,19,Unknown,Unknown,Unknown,Unknown,cid:3)(cid:5)(cid:14)(cid:70)(cid:12)(cid:11)(cid:4)(cid:14)(cid:11)(cid:48)(cid:48)(cid:7)(cid:5)(cid:3)(cid:9)(cid:2)(cid:12)(cid:11)(cid:4)(cid:14)(cid:11)(cid:48)(cid:48)(cid:7)(cid:5)(cid:3)(cid:9)(cid:2)(cid:28)(cid:3,Unknown,23300.0
Unknown,Unknown,1,Unknown,Unknown,Unknown,Unknown,cid:3)(cid:5)(cid:14)(cid:70)(cid:12)(cid:11)(cid:4)(cid:14)(cid:11)(cid:48)(cid:48)(cid:7)(cid:5)(cid:3)(cid:9)(cid:2)(cid:12)(cid:11)(cid:4)(cid:14)(cid:11)(cid:48)(cid:48)(cid:7)(cid:5)(cid:3)(cid:9)(cid:2)(cid:28)(cid:3,Unknown,23301.0
Unknown,Unknown,18,Unknown,Unknown,Unknown,Unknown,cid:3)(cid:5)(cid:14)(cid:70)(cid:12)(cid:11)(cid:4)(cid:14)(cid:11)(cid:48)(cid:48)(cid:7)(cid:5)(cid:3)(cid:9)(cid:2)(cid:12)(cid:11)(cid:4)(cid:14)(cid:11)(cid:48)(cid:48)(cid:7)(cid:5)(cid:3)(cid:9)(cid:2)(cid:28)(cid:3,Unknown,23319.0
Unknown,Unknown,2,Unknown,Unknown,Unknown,Unknown,cid:3)(cid:5)(cid:14)(cid:70)(cid:12)(cid:11)(cid:4)(cid:14)(cid:11)(cid:48)(cid:48)(cid:7)(cid:5)(cid:3)(cid:9)(cid:2)(cid:12)(cid:11)(cid:4)(cid:14)(cid:11)(cid:48)(cid:48)(cid:7)(cid:5)(cid:3)(cid:9)(cid:2)(cid:28)(cid:3,Unknown,23321.0
Unknown,Unknown,44,Unknown,Unknown,Unknown,Unknown,cid:3)(cid:5)(cid:14)(cid:70)(cid:12)(cid:11)(cid:4)(cid:14)(cid:11)(cid:48)(cid:48)(cid:7)(cid:5)(cid:3)(cid:9)(cid:2)(cid:12)(cid:11)(cid:4)(cid:14)(cid:11)(cid:48)(cid:48)(cid:7)(cid:5)(cid:3)(cid:9)(cid:2)(cid:28)(cid:3,Unknown,23365.0
Unknown,Unknown,12,Unknown,Unknown,Unknown,Unknown,cid:3)(cid:5)(cid:14)(cid:70)(cid:12)(cid:11)(cid:4)(cid:14)(cid:11)(cid:48)(cid:48)(cid:7)(cid:5)(cid:3)(cid:9)(cid:2)(cid:12)(cid:11)(cid:4)(cid:14)(cid:11)(cid:48)(cid:48)(cid:7)(cid:5)(cid:3)(cid:9)(cid:2)(cid:28)(cid:3,Unknown,23377.0
Unknown,Unknown,29,Unknown,Unknown,Unknown,Unknown,cid:3)(cid:5)(cid:14)(cid:70)(cid:12)(cid:11)(cid:4)(cid:14)(cid:11)(cid:48)(cid:48)(cid:7)(cid:5)(cid:3)(cid:9)(cid:2)(cid:12)(cid:11)(cid:4)(cid:14)(cid:11)(cid:48)(cid:48)(cid:7)(cid:5)(cid:3)(cid:9)(cid:2)(cid:28)(cid:3,Unknown,23406.0
Unknown,Unknown,26,Unknown,Unknown,Unknown,Unknown,cid:3)(cid:5)(cid:14)(cid:70)(cid:12)(cid:11)(cid:4)(cid:14)(cid:11)(cid:48)(cid:48)(cid:7)(cid:5)(cid:3)(cid:9)(cid:2)(cid:12)(cid:11)(cid:4)(cid:14)(cid:11)(cid:48)(cid:48)(cid:7)(cid:5)(cid:3)(cid:9)(cid:2)(cid:28)(cid:3,Unknown,23432.0
Unknown,Unknown,41,Unknown,Unknown,Unknown,Unknown,cid:3)(cid:5)(cid:14)(cid:70)(cid:12)(cid:11)(cid:4)(cid:14)(cid:11)(cid:48)(cid:48)(cid:7)(cid:5)(cid:3)(cid:9)(cid:2)(cid:12)(cid:11)(cid:4)(cid:14)(cid:11)(cid:48)(cid:48)(cid:7)(cid:5)(cid:3)(cid:9)(cid:2)(cid:28)(cid:3,Unknown,23473.0
Unknown,Unknown,25,Unknown,Unknown,Unknown,Unknown,cid:3)(cid:5)(cid:14)(cid:70)(cid:12)(cid:11)(cid:4)(cid:14)(cid:11)(cid:48)(cid:48)(cid:7)(cid:5)(cid:3)(cid:9)(cid:2)(cid:12)(cid:11)(cid:4)(cid:14)(cid:11)(cid:48)(cid:48)(cid:7)(cid:5)(cid:3)(cid:9)(cid:2)(cid:28)(cid:3,Unknown,23498.0
Unknown,Unknown,2,Unknown,Unknown,Unknown,Unknown,cid:3)(cid:5)(cid:14)(cid:70)(cid:12)(cid:11)(cid:4)(cid:14)(cid:11)(cid:48)(cid:48)(cid:7)(cid:5)(cid:3)(cid:9)(cid:2)(cid:12)(cid:11)(cid:4)(cid:14)(cid:11)(cid:48)(cid:48)(cid:7)(cid:5)(cid:3)(cid:9)(cid:2)(cid:28)(cid:3,Unknown,23500.0
Unknown,Unknown,58,Unknown,Unknown,Unknown,Unknown,cid:3)(cid:5)(cid:14)(cid:70)(cid:12)(cid:11)(cid:4)(cid:14)(cid:11)(cid:48)(cid:48)(cid:7)(cid:5)(cid:3)(cid:9)(cid:2)(cid:12)(cid:11)(cid:4)(cid:14)(cid:11)(cid:48)(cid:48)(cid:7)(cid:5)(cid:3)(cid:9)(cid:2)(cid:28)(cid:3,Unknown,23558.0
Unknown,Unknown,58,Unknown,Unknown,Unknown,Unknown,cid:3)(cid:5)(cid:14)(cid:70)(cid:12)(cid:11)(cid:4)(cid:14)(cid:11)(cid:48)(cid:48)(cid:7)(cid:5)(cid:3)(cid:9)(cid:2)(cid:12)(cid:11)(cid:4)(cid:14)(cid:11)(cid:48)(cid:48)(cid:7)(cid:5)(cid:3)(cid:9)(cid:2)(cid:28)(cid:3,Unknown,23616.0
Unknown,Unknown,18,Unknown,Unknown,Unknown,Unknown,cid:3)(cid:5)(cid:14)(cid:70)(cid:12)(cid:11)(cid:4)(cid:14)(cid:11)(cid:48)(cid:48)(cid:7)(cid:5)(cid:3)(cid:9)(cid:2)(cid:12)(cid:11)(cid:4)(cid:14)(cid:11)(cid:48)(cid:48)(cid:7)(cid:5)(cid:3)(cid:9)(cid:2)(cid:28)(cid:3,Unknown,23634.0
Unknown,Unknown,1,Unknown,Unknown,Unknown,Unknown,cid:3)(cid:5)(cid:14)(cid:70)(cid:12)(cid:11)(cid:4)(cid:14)(cid:11)(cid:48)(cid:48)(cid:7)(cid:5)(cid:3)(cid:9)(cid:2)(cid:12)(cid:11)(cid:4)(cid:14)(cid:11)(cid:48)(cid:48)(cid:7)(cid:5)(cid:3)(cid:9)(cid:2)(cid:28)(cid:3,Unknown,23635.0
Unknown,Unknown,1,Unknown,Unknown,Unknown,Unknown,cid:3)(cid:5)(cid:14)(cid:70)(cid:12)(cid:11)(cid:4)(cid:14)(cid:11)(cid:48)(cid:48)(cid:7)(cid:5)(cid:3)(cid:9)(cid:2)(cid:12)(cid:11)(cid:4)(cid:14)(cid:11)(cid:48)(cid:48)(cid:7)(cid:5)(cid:3)(cid:9)(cid:2)(cid:28)(cid:3,Unknown,23636.0
Unknown,Unknown,37,Unknown,Unknown,Unknown,Unknown,cid:3)(cid:5)(cid:14)(cid:70)(cid:12)(cid:11)(cid:4)(cid:14)(cid:11)(cid:48)(cid:48)(cid:7)(cid:5)(cid:3)(cid:9)(cid:2)(cid:12)(cid:11)(cid:4)(cid:14)(cid:11)(cid:48)(cid:48)(cid:7)(cid:5)(cid:3)(cid:9)(cid:2)(cid:28)(cid:3,Unknown,23673.0
Unknown,Unknown,1,Unknown,Unknown,Unknown,Unknown,cid:3)(cid:5)(cid:14)(cid:70)(cid:12)(cid:11)(cid:4)(cid:14)(cid:11)(cid:48)(cid:48)(cid:7)(cid:5)(cid:3)(cid:9)(cid:2)(cid:12)(cid:11)(cid:4)(cid:14)(cid:11)(cid:48)(cid:48)(cid:7)(cid:5)(cid:3)(cid:9)(cid:2)(cid:28)(cid:3,Unknown,23674.0
Unknown,Unknown,18,Unknown,Unknown,Unknown,Unknown,cid:3)(cid:5)(cid:14)(cid:70)(cid:12)(cid:11)(cid:4)(cid:14)(cid:11)(cid:48)(cid:48)(cid:7)(cid:5)(cid:3)(cid:9)(cid:2)(cid:12)(cid:11)(cid:4)(cid:14)(cid:11)(cid:48)(cid:48)(cid:7)(cid:5)(cid:3)(cid:9)(cid:2)(cid:28)(cid:3,Unknown,23692.0
Unknown,Unknown,45,Unknown,Unknown,Unknown,Unknown,cid:3)(cid:5)(cid:14)(cid:70)(cid:12)(cid:11)(cid:4)(cid:14)(cid:11)(cid:48)(cid:48)(cid:7)(cid:5)(cid:3)(cid:9)(cid:2)(cid:12)(cid:11)(cid:4)(cid:14)(cid:11)(cid:48)(cid:48)(cid:7)(cid:5)(cid:3)(cid:9)(cid:2)(cid:28)(cid:3,Unknown,23737.0
Unknown,Unknown,18,Unknown,Unknown,Unknown,Unknown,cid:3)(cid:5)(cid:14)(cid:70)(cid:12)(cid:11)(cid:4)(cid:14)(cid:11)(cid:48)(cid:48)(cid:7)(cid:5)(cid:3)(cid:9)(cid:2)(cid:12)(cid:11)(cid:4)(cid:14)(cid:11)(cid:48)(cid:48)(cid:7)(cid:5)(cid:3)(cid:9)(cid:2)(cid:28)(cid:3,Unknown,23755.0
Unknown,Unknown,16,Unknown,Unknown,Unknown,Unknown,cid:3)(cid:5)(cid:14)(cid:70)(cid:12)(cid:11)(cid:4)(cid:14)(cid:11)(cid:48)(cid:48)(cid:7)(cid:5)(cid:3)(cid:9)(cid:2)(cid:12)(cid:11)(cid:4)(cid:14)(cid:11)(cid:48)(cid:48)(cid:7)(cid:5)(cid:3)(cid:9)(cid:2)(cid:28)(cid:3,Unknown,23771.0
Unknown,Unknown,14,Unknown,Unknown,Unknown,Unknown,cid:3)(cid:5)(cid:14)(cid:70)(cid:12)(cid:11)(cid:4)(cid:14)(cid:11)(cid:48)(cid:48)(cid:7)(cid:5)(cid:3)(cid:9)(cid:2)(cid:12)(cid:11)(cid:4)(cid:14)(cid:11)(cid:48)(cid:48)(cid:7)(cid:5)(cid:3)(cid:9)(cid:2)(cid:28)(cid:3,Unknown,23785.0
Unknown,Unknown,46,Unknown,Unknown,Unknown,Unknown,cid:3)(cid:5)(cid:14)(cid:70)(cid:12)(cid:11)(cid:4)(cid:14)(cid:11)(cid:48)(cid:48)(cid:7)(cid:5)(cid:3)(cid:9)(cid:2)(cid:12)(cid:11)(cid:4)(cid:14)(cid:11)(cid:48)(cid:48)(cid:7)(cid:5)(cid:3)(cid:9)(cid:2)(cid:28)(cid:3,Unknown,23831.0
Unknown,Unknown,2,Unknown,Unknown,Unknown,Unknown,cid:3)(cid:5)(cid:14)(cid:70)(cid:12)(cid:11)(cid:4)(cid:14)(cid:11)(cid:48)(cid:48)(cid:7)(cid:5)(cid:3)(cid:9)(cid:2)(cid:12)(cid:11)(cid:4)(cid:14)(cid:11)(cid:48)(cid:48)(cid:7)(cid:5)(cid:3)(cid:9)(cid:2)(cid:28)(cid:3,Unknown,23833.0
Unknown,Unknown,39,Unknown,Unknown,Unknown,Unknown,cid:3)(cid:5)(cid:14)(cid:70)(cid:12)(cid:11)(cid:4)(cid:14)(cid:11)(cid:48)(cid:48)(cid:7)(cid:5)(cid:3)(cid:9)(cid:2)(cid:12)(cid:11)(cid:4)(cid:14)(cid:11)(cid:48)(cid:48)(cid:7)(cid:5)(cid:3)(cid:9)(cid:2)(cid:28)(cid:3,Unknown,23872.0
Unknown,Unknown,11,Unknown,Unknown,Unknown,Unknown,cid:3)(cid:5)(cid:14)(cid:70)(cid:12)(cid:11)(cid:4)(cid:14)(cid:11)(cid:48)(cid:48)(cid:7)(cid:5)(cid:3)(cid:9)(cid:2)(cid:12)(cid:11)(cid:4)(cid:14)(cid:11)(cid:48)(cid:48)(cid:7)(cid:5)(cid:3)(cid:9)(cid:2)(cid:28)(cid:3,Unknown,23883.0
Unknown,Unknown,9,Unknown,Unknown,Unknown,Unknown,cid:3)(cid:5)(cid:14)(cid:70)(cid:12)(cid:11)(cid:4)(cid:14)(cid:11)(cid:48)(cid:48)(cid:7)(cid:5)(cid:3)(cid:9)(cid:2)(cid:12)(cid:11)(cid:4)(cid:14)(cid:11)(cid:48)(cid:48)(cid:7)(cid:5)(cid:3)(cid:9)(cid:2)(cid:28)(cid:3,Unknown,23892.0
Unknown,Unknown,10,Unknown,Unknown,Unknown,Unknown,cid:3)(cid:5)(cid:14)(cid:70)(cid:12)(cid:11)(cid:4)(cid:14)(cid:11)(cid:48)(cid:48)(cid:7)(cid:5)(cid:3)(cid:9)(cid:2)(cid:12)(cid:11)(cid:4)(cid:14)(cid:11)(cid:48)(cid:48)(cid:7)(cid:5)(cid:3)(cid:9)(cid:2)(cid:28)(cid:3,Unknown,23902.0
Unknown,Unknown,5,Unknown,Unknown,Unknown,Unknown,cid:3)(cid:5)(cid:14)(cid:70)(cid:12)(cid:11)(cid:4)(cid:14)(cid:11)(cid:48)(cid:48)(cid:7)(cid:5)(cid:3)(cid:9)(cid:2)(cid:12)(cid:11)(cid:4)(cid:14)(cid:11)(cid:48)(cid:48)(cid:7)(cid:5)(cid:3)(cid:9)(cid:2)(cid:28)(cid:3,Unknown,23907.0
Unknown,Unknown,2,Unknown,Unknown,Unknown,Unknown,cid:3)(cid:5)(cid:14)(cid:70)(cid:12)(cid:11)(cid:4)(cid:14)(cid:11)(cid:48)(cid:48)(cid:7)(cid:5)(cid:3)(cid:9)(cid:2)(cid:12)(cid:11)(cid:4)(cid:14)(cid:11)(cid:48)(cid:48)(cid:7)(cid:5)(cid:3)(cid:9)(cid:2)(cid:28)(cid:3,Unknown,23909.0
Unknown,Unknown,14,Unknown,Unknown,Unknown,Unknown,cid:3)(cid:5)(cid:14)(cid:70)(cid:12)(cid:11)(cid:4)(cid:14)(cid:11)(cid:48)(cid:48)(cid:7)(cid:5)(cid:3)(cid:9)(cid:2)(cid:12)(cid:11)(cid:4)(cid:14)(cid:11)(cid:48)(cid:48)(cid:7)(cid:5)(cid:3)(cid:9)(cid:2)(cid:28)(cid:3,Unknown,23923.0
Unknown,Unknown,16,Unknown,Unknown,Unknown,Unknown,cid:3)(cid:5)(cid:14)(cid:70)(cid:12)(cid:11)(cid:4)(cid:14)(cid:11)(cid:48)(cid:48)(cid:7)(cid:5)(cid:3)(cid:9)(cid:2)(cid:12)(cid:11)(cid:4)(cid:14)(cid:11)(cid:48)(cid:48)(cid:7)(cid:5)(cid:3)(cid:9)(cid:2)(cid:28)(cid:3,Unknown,23939.0
Unknown,Unknown,16,Unknown,Unknown,Unknown,Unknown,cid:3)(cid:5)(cid:14)(cid:70)(cid:12)(cid:11)(cid:4)(cid:14)(cid:11)(cid:48)(cid:48)(cid:7)(cid:5)(cid:3)(cid:9)(cid:2)(cid:12)(cid:11)(cid:4)(cid:14)(cid:11)(cid:48)(cid:48)(cid:7)(cid:5)(cid:3)(cid:9)(cid:2)(cid:28)(cid:3,Unknown,23955.0
Unknown,Unknown,17,Unknown,Unknown,Unknown,Unknown,cid:3)(cid:5)(cid:14)(cid:70)(cid:12)(cid:11)(cid:4)(cid:14)(cid:11)(cid:48)(cid:48)(cid:7)(cid:5)(cid:3)(cid:9)(cid:2)(cid:12)(cid:11)(cid:4)(cid:14)(cid:11)(cid:48)(cid:48)(cid:7)(cid:5)(cid:3)(cid:9)(cid:2)(cid:28)(cid:3,Unknown,23972.0
Unknown,Unknown,37,Unknown,Unknown,Unknown,Unknown,cid:3)(cid:5)(cid:14)(cid:70)(cid:12)(cid:11)(cid:4)(cid:14)(cid:11)(cid:48)(cid:48)(cid:7)(cid:5)(cid:3)(cid:9)(cid:2)(cid:12)(cid:11)(cid:4)(cid:14)(cid:11)(cid:48)(cid:48)(cid:7)(cid:5)(cid:3)(cid:9)(cid:2)(cid:28)(cid:3,Unknown,24009.0
Unknown,Unknown,17,Unknown,Unknown,Unknown,Unknown,cid:3)(cid:5)(cid:14)(cid:70)(cid:12)(cid:11)(cid:4)(cid:14)(cid:11)(cid:48)(cid:48)(cid:7)(cid:5)(cid:3)(cid:9)(cid:2)(cid:12)(cid:11)(cid:4)(cid:14)(cid:11)(cid:48)(cid:48)(cid:7)(cid:5)(cid:3)(cid:9)(cid:2)(cid:28)(cid:3,Unknown,24026.0
Unknown,Unknown,18,Unknown,Unknown,Unknown,Unknown,cid:3)(cid:5)(cid:14)(cid:70)(cid:12)(cid:11)(cid:4)(cid:14)(cid:11)(cid:48)(cid:48)(cid:7)(cid:5)(cid:3)(cid:9)(cid:2)(cid:12)(cid:11)(cid:4)(cid:14)(cid:11)(cid:48)(cid:48)(cid:7)(cid:5)(cid:3)(cid:9)(cid:2)(cid:28)(cid:3,Unknown,24044.0
Unknown,Unknown,2,Unknown,Unknown,Unknown,Unknown,cid:3)(cid:5)(cid:14)(cid:70)(cid:12)(cid:11)(cid:4)(cid:14)(cid:11)(cid:48)(cid:48)(cid:7)(cid:5)(cid:3)(cid:9)(cid:2)(cid:12)(cid:11)(cid:4)(cid:14)(cid:11)(cid:48)(cid:48)(cid:7)(cid:5)(cid:3)(cid:9)(cid:2)(cid:28)(cid:3,Unknown,24046.0
Unknown,Unknown,12,Unknown,Unknown,Unknown,Unknown,cid:3)(cid:5)(cid:14)(cid:70)(cid:12)(cid:11)(cid:4)(cid:14)(cid:11)(cid:48)(cid:48)(cid:7)(cid:5)(cid:3)(cid:9)(cid:2)(cid:12)(cid:11)(cid:4)(cid:14)(cid:11)(cid:48)(cid:48)(cid:7)(cid:5)(cid:3)(cid:9)(cid:2)(cid:28)(cid:3,Unknown,24058.0
Unknown,Unknown,11,Unknown,Unknown,Unknown,Unknown,cid:3)(cid:5)(cid:14)(cid:70)(cid:12)(cid:11)(cid:4)(cid:14)(cid:11)(cid:48)(cid:48)(cid:7)(cid:5)(cid:3)(cid:9)(cid:2)(cid:12)(cid:11)(cid:4)(cid:14)(cid:11)(cid:48)(cid:48)(cid:7)(cid:5)(cid:3)(cid:9)(cid:2)(cid:28)(cid:3,Unknown,24069.0
Unknown,Unknown,4,Unknown,Unknown,Unknown,Unknown,cid:3)(cid:5)(cid:14)(cid:70)(cid:12)(cid:11)(cid:4)(cid:14)(cid:11)(cid:48)(cid:48)(cid:7)(cid:5)(cid:3)(cid:9)(cid:2)(cid:12)(cid:11)(cid:4)(cid:14)(cid:11)(cid:48)(cid:48)(cid:7)(cid:5)(cid:3)(cid:9)(cid:2)(cid:28)(cid:3,Unknown,24073.0
Unknown,Unknown,14,Unknown,Unknown,Unknown,Unknown,cid:3)(cid:5)(cid:14)(cid:70)(cid:12)(cid:11)(cid:4)(cid:14)(cid:11)(cid:48)(cid:48)(cid:7)(cid:5)(cid:3)(cid:9)(cid:2)(cid:12)(cid:11)(cid:4)(cid:14)(cid:11)(cid:48)(cid:48)(cid:7)(cid:5)(cid:3)(cid:9)(cid:2)(cid:28)(cid:3,Unknown,24087.0
Unknown,Unknown,11,Unknown,Unknown,Unknown,Unknown,cid:3)(cid:5)(cid:14)(cid:70)(cid:12)(cid:11)(cid:4)(cid:14)(cid:11)(cid:48)(cid:48)(cid:7)(cid:5)(cid:3)(cid:9)(cid:2)(cid:12)(cid:11)(cid:4)(cid:14)(cid:11)(cid:48)(cid:48)(cid:7)(cid:5)(cid:3)(cid:9)(cid:2)(cid:28)(cid:3,Unknown,24098.0
Unknown,Unknown,48,Unknown,Unknown,Unknown,Unknown,cid:3)(cid:5)(cid:14)(cid:70)(cid:12)(cid:11)(cid:4)(cid:14)(cid:11)(cid:48)(cid:48)(cid:7)(cid:5)(cid:3)(cid:9)(cid:2)(cid:12)(cid:11)(cid:4)(cid:14)(cid:11)(cid:48)(cid:48)(cid:7)(cid:5)(cid:3)(cid:9)(cid:2)(cid:28)(cid:3,Unknown,24146.0
Unknown,Unknown,48,Unknown,Unknown,Unknown,Unknown,cid:3)(cid:5)(cid:14)(cid:70)(cid:12)(cid:11)(cid:4)(cid:14)(cid:11)(cid:48)(cid:48)(cid:7)(cid:5)(cid:3)(cid:9)(cid:2)(cid:12)(cid:11)(cid:4)(cid:14)(cid:11)(cid:48)(cid:48)(cid:7)(cid:5)(cid:3)(cid:9)(cid:2)(cid:28)(cid:3,Unknown,24194.0
Unknown,Unknown,7,Unknown,Unknown,Unknown,Unknown,cid:3)(cid:5)(cid:14)(cid:70)(cid:12)(cid:11)(cid:4)(cid:14)(cid:11)(cid:48)(cid:48)(cid:7)(cid:5)(cid:3)(cid:9)(cid:2)(cid:12)(cid:11)(cid:4)(cid:14)(cid:11)(cid:48)(cid:48)(cid:7)(cid:5)(cid:3)(cid:9)(cid:2)(cid:28)(cid:3,Unknown,24201.0
Unknown,Unknown,5,Unknown,Unknown,Unknown,Unknown,cid:3)(cid:5)(cid:14)(cid:70)(cid:12)(cid:11)(cid:4)(cid:14)(cid:11)(cid:48)(cid:48)(cid:7)(cid:5)(cid:3)(cid:9)(cid:2)(cid:12)(cid:11)(cid:4)(cid:14)(cid:11)(cid:48)(cid:48)(cid:7)(cid:5)(cid:3)(cid:9)(cid:2)(cid:28)(cid:3,Unknown,24206.0
Unknown,Unknown,3,Unknown,Unknown,Unknown,Unknown,cid:3)(cid:5)(cid:14)(cid:70)(cid:12)(cid:11)(cid:4)(cid:14)(cid:11)(cid:48)(cid:48)(cid:7)(cid:5)(cid:3)(cid:9)(cid:2)(cid:12)(cid:11)(cid:4)(cid:14)(cid:11)(cid:48)(cid:48)(cid:7)(cid:5)(cid:3)(cid:9)(cid:2)(cid:28)(cid:3,Unknown,24209.0
Unknown,Unknown,9,Unknown,Unknown,Unknown,Unknown,cid:3)(cid:5)(cid:14)(cid:70)(cid:12)(cid:11)(cid:4)(cid:14)(cid:11)(cid:48)(cid:48)(cid:7)(cid:5)(cid:3)(cid:9)(cid:2)(cid:12)(cid:11)(cid:4)(cid:14)(cid:11)(cid:48)(cid:48)(cid:7)(cid:5)(cid:3)(cid:9)(cid:2)(cid:28)(cid:3,Unknown,24218.0
Unknown,Unknown,2,Unknown,Unknown,Unknown,Unknown,cid:3)(cid:5)(cid:14)(cid:70)(cid:12)(cid:11)(cid:4)(cid:14)(cid:11)(cid:48)(cid:48)(cid:7)(cid:5)(cid:3)(cid:9)(cid:2)(cid:12)(cid:11)(cid:4)(cid:14)(cid:11)(cid:48)(cid:48)(cid:7)(cid:5)(cid:3)(cid:9)(cid:2)(cid:28)(cid:3,Unknown,24220.0
Unknown,Unknown,28,Unknown,Unknown,Unknown,Unknown,cid:3)(cid:5)(cid:14)(cid:70)(cid:12)(cid:11)(cid:4)(cid:14)(cid:11)(cid:48)(cid:48)(cid:7)(cid:5)(cid:3)(cid:9)(cid:2)(cid:12)(cid:11)(cid:4)(cid:14)(cid:11)(cid:48)(cid:48)(cid:7)(cid:5)(cid:3)(cid:9)(cid:2)(cid:28)(cid:3,Unknown,24248.0
Unknown,Unknown,3,Unknown,Unknown,Unknown,Unknown,cid:3)(cid:5)(cid:14)(cid:70)(cid:12)(cid:11)(cid:4)(cid:14)(cid:11)(cid:48)(cid:48)(cid:7)(cid:5)(cid:3)(cid:9)(cid:2)(cid:12)(cid:11)(cid:4)(cid:14)(cid:11)(cid:48)(cid:48)(cid:7)(cid:5)(cid:3)(cid:9)(cid:2)(cid:28)(cid:3,Unknown,24251.0
Unknown,Unknown,15,Unknown,Unknown,Unknown,Unknown,cid:3)(cid:5)(cid:14)(cid:70)(cid:12)(cid:11)(cid:4)(cid:14)(cid:11)(cid:48)(cid:48)(cid:7)(cid:5)(cid:3)(cid:9)(cid:2)(cid:12)(cid:11)(cid:4)(cid:14)(cid:11)(cid:48)(cid:48)(cid:7)(cid:5)(cid:3)(cid:9)(cid:2)(cid:28)(cid:3,Unknown,24266.0
Unknown,Unknown,2,Unknown,Unknown,Unknown,Unknown,cid:3)(cid:5)(cid:14)(cid:70)(cid:12)(cid:11)(cid:4)(cid:14)(cid:11)(cid:48)(cid:48)(cid:7)(cid:5)(cid:3)(cid:9)(cid:2)(cid:12)(cid:11)(cid:4)(cid:14)(cid:11)(cid:48)(cid:48)(cid:7)(cid:5)(cid:3)(cid:9)(cid:2)(cid:28)(cid:3,Unknown,24268.0
Unknown,Unknown,36,Unknown,Unknown,Unknown,Unknown,cid:3)(cid:5)(cid:14)(cid:70)(cid:12)(cid:11)(cid:4)(cid:14)(cid:11)(cid:48)(cid:48)(cid:7)(cid:5)(cid:3)(cid:9)(cid:2)(cid:12)(cid:11)(cid:4)(cid:14)(cid:11)(cid:48)(cid:48)(cid:7)(cid:5)(cid:3)(cid:9)(cid:2)(cid:28)(cid:3,Unknown,24304.0
Unknown,Unknown,19,Unknown,Unknown,Unknown,Unknown,cid:3)(cid:5)(cid:14)(cid:70)(cid:12)(cid:11)(cid:4)(cid:14)(cid:11)(cid:48)(cid:48)(cid:7)(cid:5)(cid:3)(cid:9)(cid:2)(cid:12)(cid:11)(cid:4)(cid:14)(cid:11)(cid:48)(cid:48)(cid:7)(cid:5)(cid:3)(cid:9)(cid:2)(cid:28)(cid:3,Unknown,24323.0
Unknown,Unknown,1,Unknown,Unknown,Unknown,Unknown,cid:3)(cid:5)(cid:14)(cid:70)(cid:12)(cid:11)(cid:4)(cid:14)(cid:11)(cid:48)(cid:48)(cid:7)(cid:5)(cid:3)(cid:9)(cid:2)(cid:12)(cid:11)(cid:4)(cid:14)(cid:11)(cid:48)(cid:48)(cid:7)(cid:5)(cid:3)(cid:9)(cid:2)(cid:28)(cid:3,Unknown,24324.0
Unknown,Unknown,18,Unknown,Unknown,Unknown,Unknown,cid:3)(cid:5)(cid:14)(cid:70)(cid:12)(cid:11)(cid:4)(cid:14)(cid:11)(cid:48)(cid:48)(cid:7)(cid:5)(cid:3)(cid:9)(cid:2)(cid:12)(cid:11)(cid:4)(cid:14)(cid:11)(cid:48)(cid:48)(cid:7)(cid:5)(cid:3)(cid:9)(cid:2)(cid:28)(cid:3,Unknown,24342.0
Unknown,Unknown,2,Unknown,Unknown,Unknown,Unknown,cid:3)(cid:5)(cid:14)(cid:70)(cid:12)(cid:11)(cid:4)(cid:14)(cid:11)(cid:48)(cid:48)(cid:7)(cid:5)(cid:3)(cid:9)(cid:2)(cid:12)(cid:11)(cid:4)(cid:14)(cid:11)(cid:48)(cid:48)(cid:7)(cid:5)(cid:3)(cid:9)(cid:2)(cid:28)(cid:3,Unknown,24344.0
Unknown,Unknown,44,Unknown,Unknown,Unknown,Unknown,cid:3)(cid:5)(cid:14)(cid:70)(cid:12)(cid:11)(cid:4)(cid:14)(cid:11)(cid:48)(cid:48)(cid:7)(cid:5)(cid:3)(cid:9)(cid:2)(cid:12)(cid:11)(cid:4)(cid:14)(cid:11)(cid:48)(cid:48)(cid:7)(cid:5)(cid:3)(cid:9)(cid:2)(cid:28)(cid:3,Unknown,24388.0
Unknown,Unknown,12,Unknown,Unknown,Unknown,Unknown,cid:3)(cid:5)(cid:14)(cid:70)(cid:12)(cid:11)(cid:4)(cid:14)(cid:11)(cid:48)(cid:48)(cid:7)(cid:5)(cid:3)(cid:9)(cid:2)(cid:12)(cid:11)(cid:4)(cid:14)(cid:11)(cid:48)(cid:48)(cid:7)(cid:5)(cid:3)(cid:9)(cid:2)(cid:28)(cid:3,Unknown,24400.0
Unknown,Unknown,29,Unknown,Unknown,Unknown,Unknown,cid:3)(cid:5)(cid:14)(cid:70)(cid:12)(cid:11)(cid:4)(cid:14)(cid:11)(cid:48)(cid:48)(cid:7)(cid:5)(cid:3)(cid:9)(cid:2)(cid:12)(cid:11)(cid:4)(cid:14)(cid:11)(cid:48)(cid:48)(cid:7)(cid:5)(cid:3)(cid:9)(cid:2)(cid:28)(cid:3,Unknown,24429.0
Unknown,Unknown,26,Unknown,Unknown,Unknown,Unknown,cid:3)(cid:5)(cid:14)(cid:70)(cid:12)(cid:11)(cid:4)(cid:14)(cid:11)(cid:48)(cid:48)(cid:7)(cid:5)(cid:3)(cid:9)(cid:2)(cid:12)(cid:11)(cid:4)(cid:14)(cid:11)(cid:48)(cid:48)(cid:7)(cid:5)(cid:3)(cid:9)(cid:2)(cid:28)(cid:3,Unknown,24455.0
Unknown,Unknown,41,Unknown,Unknown,Unknown,Unknown,cid:3)(cid:5)(cid:14)(cid:70)(cid:12)(cid:11)(cid:4)(cid:14)(cid:11)(cid:48)(cid:48)(cid:7)(cid:5)(cid:3)(cid:9)(cid:2)(cid:12)(cid:11)(cid:4)(cid:14)(cid:11)(cid:48)(cid:48)(cid:7)(cid:5)(cid:3)(cid:9)(cid:2)(cid:28)(cid:3,Unknown,24496.0
Unknown,Unknown,25,Unknown,Unknown,Unknown,Unknown,cid:3)(cid:5)(cid:14)(cid:70)(cid:12)(cid:11)(cid:4)(cid:14)(cid:11)(cid:48)(cid:48)(cid:7)(cid:5)(cid:3)(cid:9)(cid:2)(cid:12)(cid:11)(cid:4)(cid:14)(cid:11)(cid:48)(cid:48)(cid:7)(cid:5)(cid:3)(cid:9)(cid:2)(cid:28)(cid:3,Unknown,24521.0
Unknown,Unknown,2,Unknown,Unknown,Unknown,Unknown,cid:3)(cid:5)(cid:14)(cid:70)(cid:12)(cid:11)(cid:4)(cid:14)(cid:11)(cid:48)(cid:48)(cid:7)(cid:5)(cid:3)(cid:9)(cid:2)(cid:12)(cid:11)(cid:4)(cid:14)(cid:11)(cid:48)(cid:48)(cid:7)(cid:5)(cid:3)(cid:9)(cid:2)(cid:28)(cid:3,Unknown,24523.0
Unknown,Unknown,58,Unknown,Unknown,Unknown,Unknown,cid:3)(cid:5)(cid:14)(cid:70)(cid:12)(cid:11)(cid:4)(cid:14)(cid:11)(cid:48)(cid:48)(cid:7)(cid:5)(cid:3)(cid:9)(cid:2)(cid:12)(cid:11)(cid:4)(cid:14)(cid:11)(cid:48)(cid:48)(cid:7)(cid:5)(cid:3)(cid:9)(cid:2)(cid:28)(cid:3,Unknown,24581.0
Unknown,Unknown,58,Unknown,Unknown,Unknown,Unknown,cid:3)(cid:5)(cid:14)(cid:70)(cid:12)(cid:11)(cid:4)(cid:14)(cid:11)(cid:48)(cid:48)(cid:7)(cid:5)(cid:3)(cid:9)(cid:2)(cid:12)(cid:11)(cid:4)(cid:14)(cid:11)(cid:48)(cid:48)(cid:7)(cid:5)(cid:3)(cid:9)(cid:2)(cid:28)(cid:3,Unknown,24639.0
Unknown,Unknown,37,Unknown,Unknown,Unknown,Unknown,cid:3)(cid:5)(cid:14)(cid:70)(cid:12)(cid:11)(cid:4)(cid:14)(cid:11)(cid:48)(cid:48)(cid:7)(cid:5)(cid:3)(cid:9)(cid:2)(cid:12)(cid:11)(cid:4)(cid:14)(cid:11)(cid:48)(cid:48)(cid:7)(cid:5)(cid:3)(cid:9)(cid:2)(cid:28)(cid:3,Unknown,24676.0
Unknown,Unknown,16,Unknown,Unknown,Unknown,Unknown,cid:3)(cid:5)(cid:14)(cid:70)(cid:12)(cid:11)(cid:4)(cid:14)(cid:11)(cid:48)(cid:48)(cid:7)(cid:5)(cid:3)(cid:9)(cid:2)(cid:12)(cid:11)(cid:4)(cid:14)(cid:11)(cid:48)(cid:48)(cid:7)(cid:5)(cid:3)(cid:9)(cid:2)(cid:28)(cid:3,Unknown,24692.0
Unknown,Unknown,34,Unknown,Unknown,Unknown,Unknown,cid:3)(cid:5)(cid:14)(cid:70)(cid:12)(cid:11)(cid:4)(cid:14)(cid:11)(cid:48)(cid:48)(cid:7)(cid:5)(cid:3)(cid:9)(cid:2)(cid:12)(cid:11)(cid:4)(cid:14)(cid:11)(cid:48)(cid:48)(cid:7)(cid:5)(cid:3)(cid:9)(cid:2)(cid:28)(cid:3,Unknown,24726.0
Unknown,Unknown,33,Unknown,Unknown,Unknown,Unknown,cid:3)(cid:5)(cid:14)(cid:70)(cid:12)(cid:11)(cid:4)(cid:14)(cid:11)(cid:48)(cid:48)(cid:7)(cid:5)(cid:3)(cid:9)(cid:2)(cid:12)(cid:11)(cid:4)(cid:14)(cid:11)(cid:48)(cid:48)(cid:7)(cid:5)(cid:3)(cid:9)(cid:2)(cid:28)(cid:3,Unknown,24759.0
Unknown,Unknown,1,Unknown,Unknown,Unknown,Unknown,cid:3)(cid:5)(cid:14)(cid:70)(cid:12)(cid:11)(cid:4)(cid:14)(cid:11)(cid:48)(cid:48)(cid:7)(cid:5)(cid:3)(cid:9)(cid:2)(cid:12)(cid:11)(cid:4)(cid:14)(cid:11)(cid:48)(cid:48)(cid:7)(cid:5)(cid:3)(cid:9)(cid:2)(cid:28)(cid:3,Unknown,24760.0
Unknown,Unknown,17,Unknown,Unknown,Unknown,Unknown,cid:3)(cid:5)(cid:14)(cid:70)(cid:12)(cid:11)(cid:4)(cid:14)(cid:11)(cid:48)(cid:48)(cid:7)(cid:5)(cid:3)(cid:9)(cid:2)(cid:12)(cid:11)(cid:4)(cid:14)(cid:11)(cid:48)(cid:48)(cid:7)(cid:5)(cid:3)(cid:9)(cid:2)(cid:28)(cid:3,Unknown,24777.0
Unknown,Unknown,45,Unknown,Unknown,Unknown,Unknown,cid:3)(cid:5)(cid:14)(cid:70)(cid:12)(cid:11)(cid:4)(cid:14)(cid:11)(cid:48)(cid:48)(cid:7)(cid:5)(cid:3)(cid:9)(cid:2)(cid:12)(cid:11)(cid:4)(cid:14)(cid:11)(cid:48)(cid:48)(cid:7)(cid:5)(cid:3)(cid:9)(cid:2)(cid:28)(cid:3,Unknown,24822.0
Unknown,Unknown,18,Unknown,Unknown,Unknown,Unknown,cid:3)(cid:5)(cid:14)(cid:70)(cid:12)(cid:11)(cid:4)(cid:14)(cid:11)(cid:48)(cid:48)(cid:7)(cid:5)(cid:3)(cid:9)(cid:2)(cid:12)(cid:11)(cid:4)(cid:14)(cid:11)(cid:48)(cid:48)(cid:7)(cid:5)(cid:3)(cid:9)(cid:2)(cid:28)(cid:3,Unknown,24840.0
Unknown,Unknown,16,Unknown,Unknown,Unknown,Unknown,cid:3)(cid:5)(cid:14)(cid:70)(cid:12)(cid:11)(cid:4)(cid:14)(cid:11)(cid:48)(cid:48)(cid:7)(cid:5)(cid:3)(cid:9)(cid:2)(cid:12)(cid:11)(cid:4)(cid:14)(cid:11)(cid:48)(cid:48)(cid:7)(cid:5)(cid:3)(cid:9)(cid:2)(cid:28)(cid:3,Unknown,24856.0
Unknown,Unknown,9,Unknown,Unknown,Unknown,Unknown,cid:3)(cid:5)(cid:14)(cid:70)(cid:12)(cid:11)(cid:4)(cid:14)(cid:11)(cid:48)(cid:48)(cid:7)(cid:5)(cid:3)(cid:9)(cid:2)(cid:12)(cid:11)(cid:4)(cid:14)(cid:11)(cid:48)(cid:48)(cid:7)(cid:5)(cid:3)(cid:9)(cid:2)(cid:28)(cid:3,Unknown,24865.0
Unknown,Unknown,46,Unknown,Unknown,Unknown,Unknown,cid:3)(cid:5)(cid:14)(cid:70)(cid:12)(cid:11)(cid:4)(cid:14)(cid:11)(cid:48)(cid:48)(cid:7)(cid:5)(cid:3)(cid:9)(cid:2)(cid:12)(cid:11)(cid:4)(cid:14)(cid:11)(cid:48)(cid:48)(cid:7)(cid:5)(cid:3)(cid:9)(cid:2)(cid:28)(cid:3,Unknown,24911.0
Unknown,Unknown,8,Unknown,Unknown,Unknown,Unknown,cid:3)(cid:5)(cid:14)(cid:70)(cid:12)(cid:11)(cid:4)(cid:14)(cid:11)(cid:48)(cid:48)(cid:7)(cid:5)(cid:3)(cid:9)(cid:2)(cid:12)(cid:11)(cid:4)(cid:14)(cid:11)(cid:48)(cid:48)(cid:7)(cid:5)(cid:3)(cid:9)(cid:2)(cid:28)(cid:3,Unknown,24919.0
Unknown,Unknown,5,Unknown,Unknown,Unknown,Unknown,cid:3)(cid:5)(cid:14)(cid:70)(cid:12)(cid:11)(cid:4)(cid:14)(cid:11)(cid:48)(cid:48)(cid:7)(cid:5)(cid:3)(cid:9)(cid:2)(cid:12)(cid:11)(cid:4)(cid:14)(cid:11)(cid:48)(cid:48)(cid:7)(cid:5)(cid:3)(cid:9)(cid:2)(cid:28)(cid:3,Unknown,24924.0
Unknown,Unknown,28,Unknown,Unknown,Unknown,Unknown,cid:3)(cid:5)(cid:14)(cid:70)(cid:12)(cid:11)(cid:4)(cid:14)(cid:11)(cid:48)(cid:48)(cid:7)(cid:5)(cid:3)(cid:9)(cid:2)(cid:12)(cid:11)(cid:4)(cid:14)(cid:11)(cid:48)(cid:48)(cid:7)(cid:5)(cid:3)(cid:9)(cid:2)(cid:28)(cid:3,Unknown,24952.0
Unknown,Unknown,2,Unknown,Unknown,Unknown,Unknown,cid:3)(cid:5)(cid:14)(cid:70)(cid:12)(cid:11)(cid:4)(cid:14)(cid:11)(cid:48)(cid:48)(cid:7)(cid:5)(cid:3)(cid:9)(cid:2)(cid:12)(cid:11)(cid:4)(cid:14)(cid:11)(cid:48)(cid:48)(cid:7)(cid:5)(cid:3)(cid:9)(cid:2)(cid:28)(cid:3,Unknown,24954.0
Unknown,Unknown,9,Unknown,Unknown,Unknown,Unknown,cid:3)(cid:5)(cid:14)(cid:70)(cid:12)(cid:11)(cid:4)(cid:14)(cid:11)(cid:48)(cid:48)(cid:7)(cid:5)(cid:3)(cid:9)(cid:2)(cid:12)(cid:11)(cid:4)(cid:14)(cid:11)(cid:48)(cid:48)(cid:7)(cid:5)(cid:3)(cid:9)(cid:2)(cid:28)(cid:3,Unknown,24963.0
Unknown,Unknown,5,Unknown,Unknown,Unknown,Unknown,cid:3)(cid:5)(cid:14)(cid:70)(cid:12)(cid:11)(cid:4)(cid:14)(cid:11)(cid:48)(cid:48)(cid:7)(cid:5)(cid:3)(cid:9)(cid:2)(cid:12)(cid:11)(cid:4)(cid:14)(cid:11)(cid:48)(cid:48)(cid:7)(cid:5)(cid:3)(cid:9)(cid:2)(cid:28)(cid:3,Unknown,24968.0
Unknown,Unknown,8,Unknown,Unknown,Unknown,Unknown,cid:3)(cid:5)(cid:14)(cid:70)(cid:12)(cid:11)(cid:4)(cid:14)(cid:11)(cid:48)(cid:48)(cid:7)(cid:5)(cid:3)(cid:9)(cid:2)(cid:12)(cid:11)(cid:4)(cid:14)(cid:11)(cid:48)(cid:48)(cid:7)(cid:5)(cid:3)(cid:9)(cid:2)(cid:28)(cid:3,Unknown,24976.0
Unknown,Unknown,14,Unknown,Unknown,Unknown,Unknown,cid:3)(cid:5)(cid:14)(cid:70)(cid:12)(cid:11)(cid:4)(cid:14)(cid:11)(cid:48)(cid:48)(cid:7)(cid:5)(cid:3)(cid:9)(cid:2)(cid:12)(cid:11)(cid:4)(cid:14)(cid:11)(cid:48)(cid:48)(cid:7)(cid:5)(cid:3)(cid:9)(cid:2)(cid:28)(cid:3,Unknown,24990.0
Unknown,Unknown,7,Unknown,Unknown,Unknown,Unknown,cid:3)(cid:5)(cid:14)(cid:70)(cid:12)(cid:11)(cid:4)(cid:14)(cid:11)(cid:48)(cid:48)(cid:7)(cid:5)(cid:3)(cid:9)(cid:2)(cid:12)(cid:11)(cid:4)(cid:14)(cid:11)(cid:48)(cid:48)(cid:7)(cid:5)(cid:3)(cid:9)(cid:2)(cid:28)(cid:3,Unknown,24997.0
Unknown,Unknown,9,Unknown,Unknown,Unknown,Unknown,cid:3)(cid:5)(cid:14)(cid:70)(cid:12)(cid:11)(cid:4)(cid:14)(cid:11)(cid:48)(cid:48)(cid:7)(cid:5)(cid:3)(cid:9)(cid:2)(cid:12)(cid:11)(cid:4)(cid:14)(cid:11)(cid:48)(cid:48)(cid:7)(cid:5)(cid:3)(cid:9)(cid:2)(cid:28)(cid:3,Unknown,25006.0
Unknown,Unknown,2,Unknown,Unknown,Unknown,Unknown,cid:3)(cid:5)(cid:14)(cid:70)(cid:12)(cid:11)(cid:4)(cid:14)(cid:11)(cid:48)(cid:48)(cid:7)(cid:5)(cid:3)(cid:9)(cid:2)(cid:12)(cid:11)(cid:4)(cid:14)(cid:11)(cid:48)(cid:48)(cid:7)(cid:5)(cid:3)(cid:9)(cid:2)(cid:28)(cid:3,Unknown,25008.0
Unknown,Unknown,28,Unknown,Unknown,Unknown,Unknown,cid:3)(cid:5)(cid:14)(cid:70)(cid:12)(cid:11)(cid:4)(cid:14)(cid:11)(cid:48)(cid:48)(cid:7)(cid:5)(cid:3)(cid:9)(cid:2)(cid:12)(cid:11)(cid:4)(cid:14)(cid:11)(cid:48)(cid:48)(cid:7)(cid:5)(cid:3)(cid:9)(cid:2)(cid:28)(cid:3,Unknown,25036.0
Unknown,Unknown,3,Unknown,Unknown,Unknown,Unknown,cid:3)(cid:5)(cid:14)(cid:70)(cid:12)(cid:11)(cid:4)(cid:14)(cid:11)(cid:48)(cid:48)(cid:7)(cid:5)(cid:3)(cid:9)(cid:2)(cid:12)(cid:11)(cid:4)(cid:14)(cid:11)(cid:48)(cid:48)(cid:7)(cid:5)(cid:3)(cid:9)(cid:2)(cid:28)(cid:3,Unknown,25039.0
Unknown,Unknown,15,Unknown,Unknown,Unknown,Unknown,cid:3)(cid:5)(cid:14)(cid:70)(cid:12)(cid:11)(cid:4)(cid:14)(cid:11)(cid:48)(cid:48)(cid:7)(cid:5)(cid:3)(cid:9)(cid:2)(cid:12)(cid:11)(cid:4)(cid:14)(cid:11)(cid:48)(cid:48)(cid:7)(cid:5)(cid:3)(cid:9)(cid:2)(cid:28)(cid:3,Unknown,25054.0
Unknown,Unknown,2,Unknown,Unknown,Unknown,Unknown,cid:3)(cid:5)(cid:14)(cid:70)(cid:12)(cid:11)(cid:4)(cid:14)(cid:11)(cid:48)(cid:48)(cid:7)(cid:5)(cid:3)(cid:9)(cid:2)(cid:12)(cid:11)(cid:4)(cid:14)(cid:11)(cid:48)(cid:48)(cid:7)(cid:5)(cid:3)(cid:9)(cid:2)(cid:28)(cid:3,Unknown,25056.0
Unknown,Unknown,1,Unknown,Unknown,Unknown,Unknown,cid:3)(cid:5)(cid:14)(cid:70)(cid:12)(cid:11)(cid:4)(cid:14)(cid:11)(cid:48)(cid:48)(cid:7)(cid:5)(cid:3)(cid:9)(cid:2)(cid:12)(cid:11)(cid:4)(cid:14)(cid:11)(cid:48)(cid:48)(cid:7)(cid:5)(cid:3)(cid:9)(cid:2)(cid:28)(cid:3,Unknown,25057.0
Unknown,Unknown,19,Unknown,Unknown,Unknown,Unknown,cid:3)(cid:5)(cid:14)(cid:70)(cid:12)(cid:11)(cid:4)(cid:14)(cid:11)(cid:48)(cid:48)(cid:7)(cid:5)(cid:3)(cid:9)(cid:2)(cid:12)(cid:11)(cid:4)(cid:14)(cid:11)(cid:48)(cid:48)(cid:7)(cid:5)(cid:3)(cid:9)(cid:2)(cid:28)(cid:3,Unknown,25076.0
Unknown,Unknown,37,Unknown,Unknown,Unknown,Unknown,cid:3)(cid:5)(cid:14)(cid:70)(cid:12)(cid:11)(cid:4)(cid:14)(cid:11)(cid:48)(cid:48)(cid:7)(cid:5)(cid:3)(cid:9)(cid:2)(cid:12)(cid:11)(cid:4)(cid:14)(cid:11)(cid:48)(cid:48)(cid:7)(cid:5)(cid:3)(cid:9)(cid:2)(cid:28)(cid:3,Unknown,25113.0
Unknown,Unknown,18,Unknown,Unknown,Unknown,Unknown,cid:3)(cid:5)(cid:14)(cid:70)(cid:12)(cid:11)(cid:4)(cid:14)(cid:11)(cid:48)(cid:48)(cid:7)(cid:5)(cid:3)(cid:9)(cid:2)(cid:12)(cid:11)(cid:4)(cid:14)(cid:11)(cid:48)(cid:48)(cid:7)(cid:5)(cid:3)(cid:9)(cid:2)(cid:28)(cid:3,Unknown,25131.0
Unknown,Unknown,2,Unknown,Unknown,Unknown,Unknown,cid:3)(cid:5)(cid:14)(cid:70)(cid:12)(cid:11)(cid:4)(cid:14)(cid:11)(cid:48)(cid:48)(cid:7)(cid:5)(cid:3)(cid:9)(cid:2)(cid:12)(cid:11)(cid:4)(cid:14)(cid:11)(cid:48)(cid:48)(cid:7)(cid:5)(cid:3)(cid:9)(cid:2)(cid:28)(cid:3,Unknown,25133.0
Unknown,Unknown,44,Unknown,Unknown,Unknown,Unknown,cid:3)(cid:5)(cid:14)(cid:70)(cid:12)(cid:11)(cid:4)(cid:14)(cid:11)(cid:48)(cid:48)(cid:7)(cid:5)(cid:3)(cid:9)(cid:2)(cid:12)(cid:11)(cid:4)(cid:14)(cid:11)(cid:48)(cid:48)(cid:7)(cid:5)(cid:3)(cid:9)(cid:2)(cid:28)(cid:3,Unknown,25177.0
Unknown,Unknown,12,Unknown,Unknown,Unknown,Unknown,cid:3)(cid:5)(cid:14)(cid:70)(cid:12)(cid:11)(cid:4)(cid:14)(cid:11)(cid:48)(cid:48)(cid:7)(cid:5)(cid:3)(cid:9)(cid:2)(cid:12)(cid:11)(cid:4)(cid:14)(cid:11)(cid:48)(cid:48)(cid:7)(cid:5)(cid:3)(cid:9)(cid:2)(cid:28)(cid:3,Unknown,25189.0
Unknown,Unknown,29,Unknown,Unknown,Unknown,Unknown,cid:3)(cid:5)(cid:14)(cid:70)(cid:12)(cid:11)(cid:4)(cid:14)(cid:11)(cid:48)(cid:48)(cid:7)(cid:5)(cid:3)(cid:9)(cid:2)(cid:12)(cid:11)(cid:4)(cid:14)(cid:11)(cid:48)(cid:48)(cid:7)(cid:5)(cid:3)(cid:9)(cid:2)(cid:28)(cid:3,Unknown,25218.0
Unknown,Unknown,26,Unknown,Unknown,Unknown,Unknown,cid:3)(cid:5)(cid:14)(cid:70)(cid:12)(cid:11)(cid:4)(cid:14)(cid:11)(cid:48)(cid:48)(cid:7)(cid:5)(cid:3)(cid:9)(cid:2)(cid:12)(cid:11)(cid:4)(cid:14)(cid:11)(cid:48)(cid:48)(cid:7)(cid:5)(cid:3)(cid:9)(cid:2)(cid:28)(cid:3,Unknown,25244.0
Unknown,Unknown,41,Unknown,Unknown,Unknown,Unknown,cid:3)(cid:5)(cid:14)(cid:70)(cid:12)(cid:11)(cid:4)(cid:14)(cid:11)(cid:48)(cid:48)(cid:7)(cid:5)(cid:3)(cid:9)(cid:2)(cid:12)(cid:11)(cid:4)(cid:14)(cid:11)(cid:48)(cid:48)(cid:7)(cid:5)(cid:3)(cid:9)(cid:2)(cid:28)(cid:3,Unknown,25285.0
Unknown,Unknown,25,Unknown,Unknown,Unknown,Unknown,cid:3)(cid:5)(cid:14)(cid:70)(cid:12)(cid:11)(cid:4)(cid:14)(cid:11)(cid:48)(cid:48)(cid:7)(cid:5)(cid:3)(cid:9)(cid:2)(cid:12)(cid:11)(cid:4)(cid:14)(cid:11)(cid:48)(cid:48)(cid:7)(cid:5)(cid:3)(cid:9)(cid:2)(cid:28)(cid:3,Unknown,25310.0
Unknown,Unknown,2,Unknown,Unknown,Unknown,Unknown,cid:3)(cid:5)(cid:14)(cid:70)(cid:12)(cid:11)(cid:4)(cid:14)(cid:11)(cid:48)(cid:48)(cid:7)(cid:5)(cid:3)(cid:9)(cid:2)(cid:12)(cid:11)(cid:4)(cid:14)(cid:11)(cid:48)(cid:48)(cid:7)(cid:5)(cid:3)(cid:9)(cid:2)(cid:28)(cid:3,Unknown,25312.0
Unknown,Unknown,58,Unknown,Unknown,Unknown,Unknown,cid:3)(cid:5)(cid:14)(cid:70)(cid:12)(cid:11)(cid:4)(cid:14)(cid:11)(cid:48)(cid:48)(cid:7)(cid:5)(cid:3)(cid:9)(cid:2)(cid:12)(cid:11)(cid:4)(cid:14)(cid:11)(cid:48)(cid:48)(cid:7)(cid:5)(cid:3)(cid:9)(cid:2)(cid:28)(cid:3,Unknown,25370.0
Unknown,Unknown,58,Unknown,Unknown,Unknown,Unknown,cid:3)(cid:5)(cid:14)(cid:70)(cid:12)(cid:11)(cid:4)(cid:14)(cid:11)(cid:48)(cid:48)(cid:7)(cid:5)(cid:3)(cid:9)(cid:2)(cid:12)(cid:11)(cid:4)(cid:14)(cid:11)(cid:48)(cid:48)(cid:7)(cid:5)(cid:3)(cid:9)(cid:2)(cid:28)(cid:3,Unknown,25428.0
Unknown,Unknown,37,Unknown,Unknown,Unknown,Unknown,cid:3)(cid:5)(cid:14)(cid:70)(cid:12)(cid:11)(cid:4)(cid:14)(cid:11)(cid:48)(cid:48)(cid:7)(cid:5)(cid:3)(cid:9)(cid:2)(cid:12)(cid:11)(cid:4)(cid:14)(cid:11)(cid:48)(cid:48)(cid:7)(cid:5)(cid:3)(cid:9)(cid:2)(cid:28)(cid:3,Unknown,25465.0
Unknown,Unknown,16,Unknown,Unknown,Unknown,Unknown,cid:3)(cid:5)(cid:14)(cid:70)(cid:12)(cid:11)(cid:4)(cid:14)(cid:11)(cid:48)(cid:48)(cid:7)(cid:5)(cid:3)(cid:9)(cid:2)(cid:12)(cid:11)(cid:4)(cid:14)(cid:11)(cid:48)(cid:48)(cid:7)(cid:5)(cid:3)(cid:9)(cid:2)(cid:28)(cid:3,Unknown,25481.0
Unknown,Unknown,34,Unknown,Unknown,Unknown,Unknown,cid:3)(cid:5)(cid:14)(cid:70)(cid:12)(cid:11)(cid:4)(cid:14)(cid:11)(cid:48)(cid:48)(cid:7)(cid:5)(cid:3)(cid:9)(cid:2)(cid:12)(cid:11)(cid:4)(cid:14)(cid:11)(cid:48)(cid:48)(cid:7)(cid:5)(cid:3)(cid:9)(cid:2)(cid:28)(cid:3,Unknown,25515.0
Unknown,Unknown,33,Unknown,Unknown,Unknown,Unknown,cid:3)(cid:5)(cid:14)(cid:70)(cid:12)(cid:11)(cid:4)(cid:14)(cid:11)(cid:48)(cid:48)(cid:7)(cid:5)(cid:3)(cid:9)(cid:2)(cid:12)(cid:11)(cid:4)(cid:14)(cid:11)(cid:48)(cid:48)(cid:7)(cid:5)(cid:3)(cid:9)(cid:2)(cid:28)(cid:3,Unknown,25548.0
Unknown,Unknown,1,Unknown,Unknown,Unknown,Unknown,cid:3)(cid:5)(cid:14)(cid:70)(cid:12)(cid:11)(cid:4)(cid:14)(cid:11)(cid:48)(cid:48)(cid:7)(cid:5)(cid:3)(cid:9)(cid:2)(cid:12)(cid:11)(cid:4)(cid:14)(cid:11)(cid:48)(cid:48)(cid:7)(cid:5)(cid:3)(cid:9)(cid:2)(cid:28)(cid:3,Unknown,25549.0
Unknown,Unknown,17,Unknown,Unknown,Unknown,Unknown,cid:3)(cid:5)(cid:14)(cid:70)(cid:12)(cid:11)(cid:4)(cid:14)(cid:11)(cid:48)(cid:48)(cid:7)(cid:5)(cid:3)(cid:9)(cid:2)(cid:12)(cid:11)(cid:4)(cid:14)(cid:11)(cid:48)(cid:48)(cid:7)(cid:5)(cid:3)(cid:9)(cid:2)(cid:28)(cid:3,Unknown,25566.0
Unknown,Unknown,45,Unknown,Unknown,Unknown,Unknown,cid:3)(cid:5)(cid:14)(cid:70)(cid:12)(cid:11)(cid:4)(cid:14)(cid:11)(cid:48)(cid:48)(cid:7)(cid:5)(cid:3)(cid:9)(cid:2)(cid:12)(cid:11)(cid:4)(cid:14)(cid:11)(cid:48)(cid:48)(cid:7)(cid:5)(cid:3)(cid:9)(cid:2)(cid:28)(cid:3,Unknown,25611.0
Unknown,Unknown,18,Unknown,Unknown,Unknown,Unknown,cid:3)(cid:5)(cid:14)(cid:70)(cid:12)(cid:11)(cid:4)(cid:14)(cid:11)(cid:48)(cid:48)(cid:7)(cid:5)(cid:3)(cid:9)(cid:2)(cid:12)(cid:11)(cid:4)(cid:14)(cid:11)(cid:48)(cid:48)(cid:7)(cid:5)(cid:3)(cid:9)(cid:2)(cid:28)(cid:3,Unknown,25629.0
Unknown,Unknown,16,Unknown,Unknown,Unknown,Unknown,cid:3)(cid:5)(cid:14)(cid:70)(cid:12)(cid:11)(cid:4)(cid:14)(cid:11)(cid:48)(cid:48)(cid:7)(cid:5)(cid:3)(cid:9)(cid:2)(cid:12)(cid:11)(cid:4)(cid:14)(cid:11)(cid:48)(cid:48)(cid:7)(cid:5)(cid:3)(cid:9)(cid:2)(cid:28)(cid:3,Unknown,25645.0
Unknown,Unknown,9,Unknown,Unknown,Unknown,Unknown,cid:3)(cid:5)(cid:14)(cid:70)(cid:12)(cid:11)(cid:4)(cid:14)(cid:11)(cid:48)(cid:48)(cid:7)(cid:5)(cid:3)(cid:9)(cid:2)(cid:12)(cid:11)(cid:4)(cid:14)(cid:11)(cid:48)(cid:48)(cid:7)(cid:5)(cid:3)(cid:9)(cid:2)(cid:28)(cid:3,Unknown,25654.0
Unknown,Unknown,46,Unknown,Unknown,Unknown,Unknown,cid:3)(cid:5)(cid:14)(cid:70)(cid:12)(cid:11)(cid:4)(cid:14)(cid:11)(cid:48)(cid:48)(cid:7)(cid:5)(cid:3)(cid:9)(cid:2)(cid:12)(cid:11)(cid:4)(cid:14)(cid:11)(cid:48)(cid:48)(cid:7)(cid:5)(cid:3)(cid:9)(cid:2)(cid:28)(cid:3,Unknown,25700.0
Unknown,Unknown,8,Unknown,Unknown,Unknown,Unknown,cid:3)(cid:5)(cid:14)(cid:70)(cid:12)(cid:11)(cid:4)(cid:14)(cid:11)(cid:48)(cid:48)(cid:7)(cid:5)(cid:3)(cid:9)(cid:2)(cid:12)(cid:11)(cid:4)(cid:14)(cid:11)(cid:48)(cid:48)(cid:7)(cid:5)(cid:3)(cid:9)(cid:2)(cid:28)(cid:3,Unknown,25708.0
Unknown,Unknown,5,Unknown,Unknown,Unknown,Unknown,cid:3)(cid:5)(cid:14)(cid:70)(cid:12)(cid:11)(cid:4)(cid:14)(cid:11)(cid:48)(cid:48)(cid:7)(cid:5)(cid:3)(cid:9)(cid:2)(cid:12)(cid:11)(cid:4)(cid:14)(cid:11)(cid:48)(cid:48)(cid:7)(cid:5)(cid:3)(cid:9)(cid:2)(cid:28)(cid:3,Unknown,25713.0
Unknown,Unknown,28,Unknown,Unknown,Unknown,Unknown,cid:3)(cid:5)(cid:14)(cid:70)(cid:12)(cid:11)(cid:4)(cid:14)(cid:11)(cid:48)(cid:48)(cid:7)(cid:5)(cid:3)(cid:9)(cid:2)(cid:12)(cid:11)(cid:4)(cid:14)(cid:11)(cid:48)(cid:48)(cid:7)(cid:5)(cid:3)(cid:9)(cid:2)(cid:28)(cid:3,Unknown,25741.0
Unknown,Unknown,2,Unknown,Unknown,Unknown,Unknown,cid:3)(cid:5)(cid:14)(cid:70)(cid:12)(cid:11)(cid:4)(cid:14)(cid:11)(cid:48)(cid:48)(cid:7)(cid:5)(cid:3)(cid:9)(cid:2)(cid:12)(cid:11)(cid:4)(cid:14)(cid:11)(cid:48)(cid:48)(cid:7)(cid:5)(cid:3)(cid:9)(cid:2)(cid:28)(cid:3,Unknown,25743.0
Unknown,Unknown,46,Unknown,Unknown,Unknown,Unknown,cid:3)(cid:5)(cid:14)(cid:70)(cid:12)(cid:11)(cid:4)(cid:14)(cid:11)(cid:48)(cid:48)(cid:7)(cid:5)(cid:3)(cid:9)(cid:2)(cid:12)(cid:11)(cid:4)(cid:14)(cid:11)(cid:48)(cid:48)(cid:7)(cid:5)(cid:3)(cid:9)(cid:2)(cid:28)(cid:3,Unknown,25789.0
Unknown,Unknown,4,Unknown,Unknown,Unknown,Unknown,cid:3)(cid:5)(cid:14)(cid:70)(cid:12)(cid:11)(cid:4)(cid:14)(cid:11)(cid:48)(cid:48)(cid:7)(cid:5)(cid:3)(cid:9)(cid:2)(cid:12)(cid:11)(cid:4)(cid:14)(cid:11)(cid:48)(cid:48)(cid:7)(cid:5)(cid:3)(cid:9)(cid:2)(cid:28)(cid:3,Unknown,25793.0
Unknown,Unknown,10,Unknown,Unknown,Unknown,Unknown,cid:3)(cid:5)(cid:14)(cid:70)(cid:12)(cid:11)(cid:4)(cid:14)(cid:11)(cid:48)(cid:48)(cid:7)(cid:5)(cid:3)(cid:9)(cid:2)(cid:12)(cid:11)(cid:4)(cid:14)(cid:11)(cid:48)(cid:48)(cid:7)(cid:5)(cid:3)(cid:9)(cid:2)(cid:28)(cid:3,Unknown,25803.0
Unknown,Unknown,11,Unknown,Unknown,Unknown,Unknown,cid:3)(cid:5)(cid:14)(cid:70)(cid:12)(cid:11)(cid:4)(cid:14)(cid:11)(cid:48)(cid:48)(cid:7)(cid:5)(cid:3)(cid:9)(cid:2)(cid:12)(cid:11)(cid:4)(cid:14)(cid:11)(cid:48)(cid:48)(cid:7)(cid:5)(cid:3)(cid:9)(cid:2)(cid:28)(cid:3,Unknown,25814.0
Unknown,Unknown,3,Unknown,Unknown,Unknown,Unknown,cid:3)(cid:5)(cid:14)(cid:70)(cid:12)(cid:11)(cid:4)(cid:14)(cid:11)(cid:48)(cid:48)(cid:7)(cid:5)(cid:3)(cid:9)(cid:2)(cid:12)(cid:11)(cid:4)(cid:14)(cid:11)(cid:48)(cid:48)(cid:7)(cid:5)(cid:3)(cid:9)(cid:2)(cid:28)(cid:3,Unknown,25817.0
Unknown,Unknown,11,Unknown,Unknown,Unknown,Unknown,cid:3)(cid:5)(cid:14)(cid:70)(cid:12)(cid:11)(cid:4)(cid:14)(cid:11)(cid:48)(cid:48)(cid:7)(cid:5)(cid:3)(cid:9)(cid:2)(cid:12)(cid:11)(cid:4)(cid:14)(cid:11)(cid:48)(cid:48)(cid:7)(cid:5)(cid:3)(cid:9)(cid:2)(cid:28)(cid:3,Unknown,25828.0
Unknown,Unknown,4,Unknown,Unknown,Unknown,Unknown,cid:3)(cid:5)(cid:14)(cid:70)(cid:12)(cid:11)(cid:4)(cid:14)(cid:11)(cid:48)(cid:48)(cid:7)(cid:5)(cid:3)(cid:9)(cid:2)(cid:12)(cid:11)(cid:4)(cid:14)(cid:11)(cid:48)(cid:48)(cid:7)(cid:5)(cid:3)(cid:9)(cid:2)(cid:28)(cid:3,Unknown,25832.0
Unknown,Unknown,10,Unknown,Unknown,Unknown,Unknown,cid:3)(cid:5)(cid:14)(cid:70)(cid:12)(cid:11)(cid:4)(cid:14)(cid:11)(cid:48)(cid:48)(cid:7)(cid:5)(cid:3)(cid:9)(cid:2)(cid:12)(cid:11)(cid:4)(cid:14)(cid:11)(cid:48)(cid:48)(cid:7)(cid:5)(cid:3)(cid:9)(cid:2)(cid:28)(cid:3,Unknown,25842.0
Unknown,Unknown,5,Unknown,Unknown,Unknown,Unknown,cid:3)(cid:5)(cid:14)(cid:70)(cid:12)(cid:11)(cid:4)(cid:14)(cid:11)(cid:48)(cid:48)(cid:7)(cid:5)(cid:3)(cid:9)(cid:2)(cid:12)(cid:11)(cid:4)(cid:14)(cid:11)(cid:48)(cid:48)(cid:7)(cid:5)(cid:3)(cid:9)(cid:2)(cid:28)(cid:3,Unknown,25847.0
Unknown,Unknown,2,Unknown,Unknown,Unknown,Unknown,cid:3)(cid:5)(cid:14)(cid:70)(cid:12)(cid:11)(cid:4)(cid:14)(cid:11)(cid:48)(cid:48)(cid:7)(cid:5)(cid:3)(cid:9)(cid:2)(cid:12)(cid:11)(cid:4)(cid:14)(cid:11)(cid:48)(cid:48)(cid:7)(cid:5)(cid:3)(cid:9)(cid:2)(cid:28)(cid:3,Unknown,25849.0
Unknown,Unknown,9,Unknown,Unknown,Unknown,Unknown,cid:3)(cid:5)(cid:14)(cid:70)(cid:12)(cid:11)(cid:4)(cid:14)(cid:11)(cid:48)(cid:48)(cid:7)(cid:5)(cid:3)(cid:9)(cid:2)(cid:12)(cid:11)(cid:4)(cid:14)(cid:11)(cid:48)(cid:48)(cid:7)(cid:5)(cid:3)(cid:9)(cid:2)(cid:28)(cid:3,Unknown,25858.0
Unknown,Unknown,5,Unknown,Unknown,Unknown,Unknown,cid:3)(cid:5)(cid:14)(cid:70)(cid:12)(cid:11)(cid:4)(cid:14)(cid:11)(cid:48)(cid:48)(cid:7)(cid:5)(cid:3)(cid:9)(cid:2)(cid:12)(cid:11)(cid:4)(cid:14)(cid:11)(cid:48)(cid:48)(cid:7)(cid:5)(cid:3)(cid:9)(cid:2)(cid:28)(cid:3,Unknown,25863.0
Unknown,Unknown,8,Unknown,Unknown,Unknown,Unknown,cid:3)(cid:5)(cid:14)(cid:70)(cid:12)(cid:11)(cid:4)(cid:14)(cid:11)(cid:48)(cid:48)(cid:7)(cid:5)(cid:3)(cid:9)(cid:2)(cid:12)(cid:11)(cid:4)(cid:14)(cid:11)(cid:48)(cid:48)(cid:7)(cid:5)(cid:3)(cid:9)(cid:2)(cid:28)(cid:3,Unknown,25871.0
Unknown,Unknown,14,Unknown,Unknown,Unknown,Unknown,cid:3)(cid:5)(cid:14)(cid:70)(cid:12)(cid:11)(cid:4)(cid:14)(cid:11)(cid:48)(cid:48)(cid:7)(cid:5)(cid:3)(cid:9)(cid:2)(cid:12)(cid:11)(cid:4)(cid:14)(cid:11)(cid:48)(cid:48)(cid:7)(cid:5)(cid:3)(cid:9)(cid:2)(cid:28)(cid:3,Unknown,25885.0
Unknown,Unknown,7,Unknown,Unknown,Unknown,Unknown,cid:3)(cid:5)(cid:14)(cid:70)(cid:12)(cid:11)(cid:4)(cid:14)(cid:11)(cid:48)(cid:48)(cid:7)(cid:5)(cid:3)(cid:9)(cid:2)(cid:12)(cid:11)(cid:4)(cid:14)(cid:11)(cid:48)(cid:48)(cid:7)(cid:5)(cid:3)(cid:9)(cid:2)(cid:28)(cid:3,Unknown,25892.0
Unknown,Unknown,9,Unknown,Unknown,Unknown,Unknown,cid:3)(cid:5)(cid:14)(cid:70)(cid:12)(cid:11)(cid:4)(cid:14)(cid:11)(cid:48)(cid:48)(cid:7)(cid:5)(cid:3)(cid:9)(cid:2)(cid:12)(cid:11)(cid:4)(cid:14)(cid:11)(cid:48)(cid:48)(cid:7)(cid:5)(cid:3)(cid:9)(cid:2)(cid:28)(cid:3,Unknown,25901.0
Unknown,Unknown,2,Unknown,Unknown,Unknown,Unknown,cid:3)(cid:5)(cid:14)(cid:70)(cid:12)(cid:11)(cid:4)(cid:14)(cid:11)(cid:48)(cid:48)(cid:7)(cid:5)(cid:3)(cid:9)(cid:2)(cid:12)(cid:11)(cid:4)(cid:14)(cid:11)(cid:48)(cid:48)(cid:7)(cid:5)(cid:3)(cid:9)(cid:2)(cid:28)(cid:3,Unknown,25903.0
Unknown,Unknown,12,Unknown,Unknown,Unknown,Unknown,cid:3)(cid:5)(cid:14)(cid:70)(cid:12)(cid:11)(cid:4)(cid:14)(cid:11)(cid:48)(cid:48)(cid:7)(cid:5)(cid:3)(cid:9)(cid:2)(cid:12)(cid:11)(cid:4)(cid:14)(cid:11)(cid:48)(cid:48)(cid:7)(cid:5)(cid:3)(cid:9)(cid:2)(cid:28)(cid:3,Unknown,25915.0
Unknown,Unknown,5,Unknown,Unknown,Unknown,Unknown,cid:3)(cid:5)(cid:14)(cid:70)(cid:12)(cid:11)(cid:4)(cid:14)(cid:11)(cid:48)(cid:48)(cid:7)(cid:5)(cid:3)(cid:9)(cid:2)(cid:12)(cid:11)(cid:4)(cid:14)(cid:11)(cid:48)(cid:48)(cid:7)(cid:5)(cid:3)(cid:9)(cid:2)(cid:28)(cid:3,Unknown,25920.0
Unknown,Unknown,50,Unknown,Unknown,Unknown,Unknown,cid:3)(cid:5)(cid:14)(cid:70)(cid:12)(cid:11)(cid:4)(cid:14)(cid:11)(cid:48)(cid:48)(cid:7)(cid:5)(cid:3)(cid:9)(cid:2)(cid:12)(cid:11)(cid:4)(cid:14)(cid:11)(cid:48)(cid:48)(cid:7)(cid:5)(cid:3)(cid:9)(cid:2)(cid:28)(cid:3,Unknown,25970.0
Unknown,Unknown,5,Unknown,Unknown,Unknown,Unknown,cid:3)(cid:5)(cid:14)(cid:70)(cid:12)(cid:11)(cid:4)(cid:14)(cid:11)(cid:48)(cid:48)(cid:7)(cid:5)(cid:3)(cid:9)(cid:2)(cid:12)(cid:11)(cid:4)(cid:14)(cid:11)(cid:48)(cid:48)(cid:7)(cid:5)(cid:3)(cid:9)(cid:2)(cid:28)(cid:3,Unknown,25975.0
Unknown,Unknown,40,Unknown,Unknown,Unknown,Unknown,cid:3)(cid:5)(cid:14)(cid:70)(cid:12)(cid:11)(cid:4)(cid:14)(cid:11)(cid:48)(cid:48)(cid:7)(cid:5)(cid:3)(cid:9)(cid:2)(cid:12)(cid:11)(cid:4)(cid:14)(cid:11)(cid:48)(cid:48)(cid:7)(cid:5)(cid:3)(cid:9)(cid:2)(cid:28)(cid:3,Unknown,26015.0
Unknown,Unknown,2,Unknown,Unknown,Unknown,Unknown,cid:3)(cid:5)(cid:14)(cid:70)(cid:12)(cid:11)(cid:4)(cid:14)(cid:11)(cid:48)(cid:48)(cid:7)(cid:5)(cid:3)(cid:9)(cid:2)(cid:12)(cid:11)(cid:4)(cid:14)(cid:11)(cid:48)(cid:48)(cid:7)(cid:5)(cid:3)(cid:9)(cid:2)(cid:28)(cid:3,Unknown,26017.0
Unknown,Unknown,28,Unknown,Unknown,Unknown,Unknown,cid:3)(cid:5)(cid:14)(cid:70)(cid:12)(cid:11)(cid:4)(cid:14)(cid:11)(cid:48)(cid:48)(cid:7)(cid:5)(cid:3)(cid:9)(cid:2)(cid:12)(cid:11)(cid:4)(cid:14)(cid:11)(cid:48)(cid:48)(cid:7)(cid:5)(cid:3)(cid:9)(cid:2)(cid:28)(cid:3,Unknown,26045.0
Unknown,Unknown,3,Unknown,Unknown,Unknown,Unknown,cid:3)(cid:5)(cid:14)(cid:70)(cid:12)(cid:11)(cid:4)(cid:14)(cid:11)(cid:48)(cid:48)(cid:7)(cid:5)(cid:3)(cid:9)(cid:2)(cid:12)(cid:11)(cid:4)(cid:14)(cid:11)(cid:48)(cid:48)(cid:7)(cid:5)(cid:3)(cid:9)(cid:2)(cid:28)(cid:3,Unknown,26048.0
Unknown,Unknown,15,Unknown,Unknown,Unknown,Unknown,cid:3)(cid:5)(cid:14)(cid:70)(cid:12)(cid:11)(cid:4)(cid:14)(cid:11)(cid:48)(cid:48)(cid:7)(cid:5)(cid:3)(cid:9)(cid:2)(cid:12)(cid:11)(cid:4)(cid:14)(cid:11)(cid:48)(cid:48)(cid:7)(cid:5)(cid:3)(cid:9)(cid:2)(cid:28)(cid:3,Unknown,26063.0
Unknown,Unknown,2,Unknown,Unknown,Unknown,Unknown,cid:3)(cid:5)(cid:14)(cid:70)(cid:12)(cid:11)(cid:4)(cid:14)(cid:11)(cid:48)(cid:48)(cid:7)(cid:5)(cid:3)(cid:9)(cid:2)(cid:12)(cid:11)(cid:4)(cid:14)(cid:11)(cid:48)(cid:48)(cid:7)(cid:5)(cid:3)(cid:9)(cid:2)(cid:28)(cid:3,Unknown,26065.0
Unknown,Unknown,1,Unknown,Unknown,Unknown,Unknown,cid:3)(cid:5)(cid:14)(cid:70)(cid:12)(cid:11)(cid:4)(cid:14)(cid:11)(cid:48)(cid:48)(cid:7)(cid:5)(cid:3)(cid:9)(cid:2)(cid:12)(cid:11)(cid:4)(cid:14)(cid:11)(cid:48)(cid:48)(cid:7)(cid:5)(cid:3)(cid:9)(cid:2)(cid:28)(cid:3,Unknown,26066.0
Unknown,Unknown,19,Unknown,Unknown,Unknown,Unknown,cid:3)(cid:5)(cid:14)(cid:70)(cid:12)(cid:11)(cid:4)(cid:14)(cid:11)(cid:48)(cid:48)(cid:7)(cid:5)(cid:3)(cid:9)(cid:2)(cid:12)(cid:11)(cid:4)(cid:14)(cid:11)(cid:48)(cid:48)(cid:7)(cid:5)(cid:3)(cid:9)(cid:2)(cid:28)(cid:3,Unknown,26085.0
Unknown,Unknown,37,Unknown,Unknown,Unknown,Unknown,cid:3)(cid:5)(cid:14)(cid:70)(cid:12)(cid:11)(cid:4)(cid:14)(cid:11)(cid:48)(cid:48)(cid:7)(cid:5)(cid:3)(cid:9)(cid:2)(cid:12)(cid:11)(cid:4)(cid:14)(cid:11)(cid:48)(cid:48)(cid:7)(cid:5)(cid:3)(cid:9)(cid:2)(cid:28)(cid:3,Unknown,26122.0
Unknown,Unknown,18,Unknown,Unknown,Unknown,Unknown,cid:3)(cid:5)(cid:14)(cid:70)(cid:12)(cid:11)(cid:4)(cid:14)(cid:11)(cid:48)(cid:48)(cid:7)(cid:5)(cid:3)(cid:9)(cid:2)(cid:12)(cid:11)(cid:4)(cid:14)(cid:11)(cid:48)(cid:48)(cid:7)(cid:5)(cid:3)(cid:9)(cid:2)(cid:28)(cid:3,Unknown,26140.0
Unknown,Unknown,2,Unknown,Unknown,Unknown,Unknown,cid:3)(cid:5)(cid:14)(cid:70)(cid:12)(cid:11)(cid:4)(cid:14)(cid:11)(cid:48)(cid:48)(cid:7)(cid:5)(cid:3)(cid:9)(cid:2)(cid:12)(cid:11)(cid:4)(cid:14)(cid:11)(cid:48)(cid:48)(cid:7)(cid:5)(cid:3)(cid:9)(cid:2)(cid:28)(cid:3,Unknown,26142.0
Unknown,Unknown,44,Unknown,Unknown,Unknown,Unknown,cid:3)(cid:5)(cid:14)(cid:70)(cid:12)(cid:11)(cid:4)(cid:14)(cid:11)(cid:48)(cid:48)(cid:7)(cid:5)(cid:3)(cid:9)(cid:2)(cid:12)(cid:11)(cid:4)(cid:14)(cid:11)(cid:48)(cid:48)(cid:7)(cid:5)(cid:3)(cid:9)(cid:2)(cid:28)(cid:3,Unknown,26186.0
Unknown,Unknown,12,Unknown,Unknown,Unknown,Unknown,cid:3)(cid:5)(cid:14)(cid:70)(cid:12)(cid:11)(cid:4)(cid:14)(cid:11)(cid:48)(cid:48)(cid:7)(cid:5)(cid:3)(cid:9)(cid:2)(cid:12)(cid:11)(cid:4)(cid:14)(cid:11)(cid:48)(cid:48)(cid:7)(cid:5)(cid:3)(cid:9)(cid:2)(cid:28)(cid:3,Unknown,26198.0
Unknown,Unknown,29,Unknown,Unknown,Unknown,Unknown,cid:3)(cid:5)(cid:14)(cid:70)(cid:12)(cid:11)(cid:4)(cid:14)(cid:11)(cid:48)(cid:48)(cid:7)(cid:5)(cid:3)(cid:9)(cid:2)(cid:12)(cid:11)(cid:4)(cid:14)(cid:11)(cid:48)(cid:48)(cid:7)(cid:5)(cid:3)(cid:9)(cid:2)(cid:28)(cid:3,Unknown,26227.0
Unknown,Unknown,26,Unknown,Unknown,Unknown,Unknown,cid:3)(cid:5)(cid:14)(cid:70)(cid:12)(cid:11)(cid:4)(cid:14)(cid:11)(cid:48)(cid:48)(cid:7)(cid:5)(cid:3)(cid:9)(cid:2)(cid:12)(cid:11)(cid:4)(cid:14)(cid:11)(cid:48)(cid:48)(cid:7)(cid:5)(cid:3)(cid:9)(cid:2)(cid:28)(cid:3,Unknown,26253.0
Unknown,Unknown,41,Unknown,Unknown,Unknown,Unknown,cid:3)(cid:5)(cid:14)(cid:70)(cid:12)(cid:11)(cid:4)(cid:14)(cid:11)(cid:48)(cid:48)(cid:7)(cid:5)(cid:3)(cid:9)(cid:2)(cid:12)(cid:11)(cid:4)(cid:14)(cid:11)(cid:48)(cid:48)(cid:7)(cid:5)(cid:3)(cid:9)(cid:2)(cid:28)(cid:3,Unknown,26294.0
Unknown,Unknown,25,Unknown,Unknown,Unknown,Unknown,cid:3)(cid:5)(cid:14)(cid:70)(cid:12)(cid:11)(cid:4)(cid:14)(cid:11)(cid:48)(cid:48)(cid:7)(cid:5)(cid:3)(cid:9)(cid:2)(cid:12)(cid:11)(cid:4)(cid:14)(cid:11)(cid:48)(cid:48)(cid:7)(cid:5)(cid:3)(cid:9)(cid:2)(cid:28)(cid:3,Unknown,26319.0
Unknown,Unknown,2,Unknown,Unknown,Unknown,Unknown,cid:3)(cid:5)(cid:14)(cid:70)(cid:12)(cid:11)(cid:4)(cid:14)(cid:11)(cid:48)(cid:48)(cid:7)(cid:5)(cid:3)(cid:9)(cid:2)(cid:12)(cid:11)(cid:4)(cid:14)(cid:11)(cid:48)(cid:48)(cid:7)(cid:5)(cid:3)(cid:9)(cid:2)(cid:28)(cid:3,Unknown,26321.0
Unknown,Unknown,58,Unknown,Unknown,Unknown,Unknown,cid:3)(cid:5)(cid:14)(cid:70)(cid:12)(cid:11)(cid:4)(cid:14)(cid:11)(cid:48)(cid:48)(cid:7)(cid:5)(cid:3)(cid:9)(cid:2)(cid:12)(cid:11)(cid:4)(cid:14)(cid:11)(cid:48)(cid:48)(cid:7)(cid:5)(cid:3)(cid:9)(cid:2)(cid:28)(cid:3,Unknown,26379.0
Unknown,Unknown,58,Unknown,Unknown,Unknown,Unknown,cid:3)(cid:5)(cid:14)(cid:70)(cid:12)(cid:11)(cid:4)(cid:14)(cid:11)(cid:48)(cid:48)(cid:7)(cid:5)(cid:3)(cid:9)(cid:2)(cid:12)(cid:11)(cid:4)(cid:14)(cid:11)(cid:48)(cid:48)(cid:7)(cid:5)(cid:3)(cid:9)(cid:2)(cid:28)(cid:3,Unknown,26437.0
Unknown,Unknown,37,Unknown,Unknown,Unknown,Unknown,cid:3)(cid:5)(cid:14)(cid:70)(cid:12)(cid:11)(cid:4)(cid:14)(cid:11)(cid:48)(cid:48)(cid:7)(cid:5)(cid:3)(cid:9)(cid:2)(cid:12)(cid:11)(cid:4)(cid:14)(cid:11)(cid:48)(cid:48)(cid:7)(cid:5)(cid:3)(cid:9)(cid:2)(cid:28)(cid:3,Unknown,26474.0
Unknown,Unknown,16,Unknown,Unknown,Unknown,Unknown,cid:3)(cid:5)(cid:14)(cid:70)(cid:12)(cid:11)(cid:4)(cid:14)(cid:11)(cid:48)(cid:48)(cid:7)(cid:5)(cid:3)(cid:9)(cid:2)(cid:12)(cid:11)(cid:4)(cid:14)(cid:11)(cid:48)(cid:48)(cid:7)(cid:5)(cid:3)(cid:9)(cid:2)(cid:28)(cid:3,Unknown,26490.0
Unknown,Unknown,34,Unknown,Unknown,Unknown,Unknown,cid:3)(cid:5)(cid:14)(cid:70)(cid:12)(cid:11)(cid:4)(cid:14)(cid:11)(cid:48)(cid:48)(cid:7)(cid:5)(cid:3)(cid:9)(cid:2)(cid:12)(cid:11)(cid:4)(cid:14)(cid:11)(cid:48)(cid:48)(cid:7)(cid:5)(cid:3)(cid:9)(cid:2)(cid:28)(cid:3,Unknown,26524.0
Unknown,Unknown,33,Unknown,Unknown,Unknown,Unknown,cid:3)(cid:5)(cid:14)(cid:70)(cid:12)(cid:11)(cid:4)(cid:14)(cid:11)(cid:48)(cid:48)(cid:7)(cid:5)(cid:3)(cid:9)(cid:2)(cid:12)(cid:11)(cid:4)(cid:14)(cid:11)(cid:48)(cid:48)(cid:7)(cid:5)(cid:3)(cid:9)(cid:2)(cid:28)(cid:3,Unknown,26557.0
Unknown,Unknown,1,Unknown,Unknown,Unknown,Unknown,cid:12)(cid:29)(cid:26)(cid:41)(cid:25)(cid:2)(cid:58)(cid:58)(cid:37)(cid:16)(cid:34)(cid:33,cid:7)(cid:8)(cid:28)(cid:11)(cid:64)(cid:3)(cid:5)(cid:28)(cid:28)(cid:5)(cid:2)(cid:12)(cid:47)(cid:2)(cid:66)(cid:7)(cid:8)(cid:12)(cid:5)(cid:8)(cid:8)(cid:5)(cid:9)(cid:2)(cid:28)(cid:3,1.0
Unknown,Unknown,17,Unknown,Unknown,Unknown,Unknown,cid:12)(cid:29)(cid:26)(cid:41)(cid:25)(cid:2)(cid:58)(cid:58)(cid:37)(cid:16)(cid:34)(cid:33,cid:9)(cid:46)(cid:8)(cid:5)(cid:28)(cid:2)(cid:9)(cid:5)(cid:8)(cid:14)(cid:7)(cid:9)(cid:2)(cid:28)(cid:3,18.0
Unknown,Unknown,45,Unknown,Unknown,Unknown,Unknown,cid:12)(cid:29)(cid:26)(cid:41)(cid:25)(cid:2)(cid:58)(cid:58)(cid:37)(cid:16)(cid:34)(cid:33,cid:9)(cid:46)(cid:8)(cid:5)(cid:28)(cid:2)(cid:9)(cid:5)(cid:8)(cid:14)(cid:7)(cid:9)(cid:2)(cid:28)(cid:3,63.0
Unknown,Unknown,18,Unknown,Unknown,Unknown,Unknown,cid:12)(cid:29)(cid:26)(cid:41)(cid:25)(cid:2)(cid:58)(cid:58)(cid:37)(cid:16)(cid:34)(cid:33,Unknown,81.0
Unknown,Unknown,16,Unknown,Unknown,Unknown,Unknown,cid:12)(cid:29)(cid:26)(cid:41)(cid:25)(cid:2)(cid:58)(cid:58)(cid:37)(cid:16)(cid:34)(cid:33,Unknown,97.0
Unknown,Unknown,11,Unknown,Unknown,Unknown,Unknown,cid:12)(cid:29)(cid:26)(cid:41)(cid:25)(cid:2)(cid:58)(cid:58)(cid:37)(cid:16)(cid:34)(cid:33,Unknown,108.0
Unknown,Unknown,3,Unknown,Unknown,Unknown,Unknown,cid:12)(cid:29)(cid:26)(cid:41)(cid:25)(cid:2)(cid:58)(cid:58)(cid:37)(cid:16)(cid:34)(cid:33,Unknown,111.0
Unknown,Unknown,46,Unknown,Unknown,Unknown,Unknown,cid:12)(cid:29)(cid:26)(cid:41)(cid:25)(cid:2)(cid:58)(cid:58)(cid:37)(cid:16)(cid:34)(cid:33,Unknown,157.0
Unknown,Unknown,8,Unknown,Unknown,Unknown,Unknown,cid:12)(cid:29)(cid:26)(cid:41)(cid:25)(cid:2)(cid:58)(cid:58)(cid:37)(cid:16)(cid:34)(cid:33,Unknown,165.0
Unknown,Unknown,64,Unknown,Unknown,Unknown,Unknown,cid:12)(cid:29)(cid:26)(cid:41)(cid:25)(cid:2)(cid:58)(cid:58)(cid:37)(cid:16)(cid:34)(cid:33,Unknown,229.0
Unknown,Unknown,5,Unknown,Unknown,Unknown,Unknown,cid:12)(cid:29)(cid:26)(cid:41)(cid:25)(cid:2)(cid:58)(cid:58)(cid:37)(cid:16)(cid:34)(cid:33,Unknown,234.0
Unknown,Unknown,2,Unknown,Unknown,Unknown,Unknown,cid:12)(cid:29)(cid:26)(cid:41)(cid:25)(cid:2)(cid:58)(cid:58)(cid:37)(cid:16)(cid:34)(cid:33,Unknown,236.0
Unknown,Unknown,28,Unknown,Unknown,Unknown,Unknown,cid:12)(cid:29)(cid:26)(cid:41)(cid:25)(cid:2)(cid:58)(cid:58)(cid:37)(cid:16)(cid:34)(cid:33,Unknown,264.0
Unknown,Unknown,46,Unknown,Unknown,Unknown,Unknown,cid:12)(cid:29)(cid:26)(cid:41)(cid:25)(cid:2)(cid:58)(cid:58)(cid:37)(cid:16)(cid:34)(cid:33,Unknown,310.0
Unknown,Unknown,12,Unknown,Unknown,Unknown,Unknown,cid:12)(cid:29)(cid:26)(cid:41)(cid:25)(cid:2)(cid:58)(cid:58)(cid:37)(cid:16)(cid:34)(cid:33,Unknown,322.0
Unknown,Unknown,10,Unknown,Unknown,Unknown,Unknown,cid:12)(cid:29)(cid:26)(cid:41)(cid:25)(cid:2)(cid:58)(cid:58)(cid:37)(cid:16)(cid:34)(cid:33,Unknown,332.0
Unknown,Unknown,2,Unknown,Unknown,Unknown,Unknown,cid:12)(cid:29)(cid:26)(cid:41)(cid:25)(cid:2)(cid:58)(cid:58)(cid:37)(cid:16)(cid:34)(cid:33,Unknown,334.0
Unknown,Unknown,16,Unknown,Unknown,Unknown,Unknown,cid:12)(cid:29)(cid:26)(cid:41)(cid:25)(cid:2)(cid:58)(cid:58)(cid:37)(cid:16)(cid:34)(cid:33,Unknown,350.0
Unknown,Unknown,36,Unknown,Unknown,Unknown,Unknown,cid:12)(cid:29)(cid:26)(cid:41)(cid:25)(cid:2)(cid:58)(cid:58)(cid:37)(cid:16)(cid:34)(cid:33,Unknown,386.0
Unknown,Unknown,2,Unknown,Unknown,Unknown,Unknown,cid:12)(cid:29)(cid:26)(cid:41)(cid:25)(cid:2)(cid:58)(cid:58)(cid:37)(cid:16)(cid:34)(cid:33,Unknown,388.0
Unknown,Unknown,39,Unknown,Unknown,Unknown,Unknown,cid:12)(cid:29)(cid:26)(cid:41)(cid:25)(cid:2)(cid:58)(cid:58)(cid:37)(cid:16)(cid:34)(cid:33,Unknown,427.0
Unknown,Unknown,46,Unknown,Unknown,Unknown,Unknown,cid:12)(cid:29)(cid:26)(cid:41)(cid:25)(cid:2)(cid:58)(cid:58)(cid:37)(cid:16)(cid:34)(cid:33,Unknown,473.0
Unknown,Unknown,3,Unknown,Unknown,Unknown,Unknown,cid:12)(cid:29)(cid:26)(cid:41)(cid:25)(cid:2)(cid:58)(cid:58)(cid:37)(cid:16)(cid:34)(cid:33,Unknown,476.0
Unknown,Unknown,7,Unknown,Unknown,Unknown,Unknown,cid:12)(cid:29)(cid:26)(cid:41)(cid:25)(cid:2)(cid:58)(cid:58)(cid:37)(cid:16)(cid:34)(cid:33,Unknown,483.0
Unknown,Unknown,9,Unknown,Unknown,Unknown,Unknown,cid:12)(cid:29)(cid:26)(cid:41)(cid:25)(cid:2)(cid:58)(cid:58)(cid:37)(cid:16)(cid:34)(cid:33,Unknown,492.0
Unknown,Unknown,2,Unknown,Unknown,Unknown,Unknown,cid:12)(cid:29)(cid:26)(cid:41)(cid:25)(cid:2)(cid:58)(cid:58)(cid:37)(cid:16)(cid:34)(cid:33,Unknown,494.0
Unknown,Unknown,28,Unknown,Unknown,Unknown,Unknown,cid:12)(cid:29)(cid:26)(cid:41)(cid:25)(cid:2)(cid:58)(cid:58)(cid:37)(cid:16)(cid:34)(cid:33,Unknown,522.0
Unknown,Unknown,3,Unknown,Unknown,Unknown,Unknown,cid:12)(cid:29)(cid:26)(cid:41)(cid:25)(cid:2)(cid:58)(cid:58)(cid:37)(cid:16)(cid:34)(cid:33,Unknown,525.0
Unknown,Unknown,15,Unknown,Unknown,Unknown,Unknown,cid:12)(cid:29)(cid:26)(cid:41)(cid:25)(cid:2)(cid:58)(cid:58)(cid:37)(cid:16)(cid:34)(cid:33,Unknown,540.0
Unknown,Unknown,2,Unknown,Unknown,Unknown,Unknown,cid:12)(cid:29)(cid:26)(cid:41)(cid:25)(cid:2)(cid:58)(cid:58)(cid:37)(cid:16)(cid:34)(cid:33,Unknown,542.0
Unknown,Unknown,32,Unknown,Unknown,Unknown,Unknown,cid:12)(cid:29)(cid:26)(cid:41)(cid:25)(cid:2)(cid:58)(cid:58)(cid:37)(cid:16)(cid:34)(cid:33,Unknown,574.0
Unknown,Unknown,36,Unknown,Unknown,Unknown,Unknown,cid:12)(cid:29)(cid:26)(cid:41)(cid:25)(cid:2)(cid:58)(cid:58)(cid:37)(cid:16)(cid:34)(cid:33,Unknown,610.0
Unknown,Unknown,19,Unknown,Unknown,Unknown,Unknown,cid:12)(cid:29)(cid:26)(cid:41)(cid:25)(cid:2)(cid:58)(cid:58)(cid:37)(cid:16)(cid:34)(cid:33,Unknown,629.0
Unknown,Unknown,33,Unknown,Unknown,Unknown,Unknown,cid:12)(cid:29)(cid:26)(cid:41)(cid:25)(cid:2)(cid:58)(cid:58)(cid:37)(cid:16)(cid:34)(cid:33,Unknown,662.0
Unknown,Unknown,33,Unknown,Unknown,Unknown,Unknown,cid:12)(cid:29)(cid:26)(cid:41)(cid:25)(cid:2)(cid:58)(cid:58)(cid:37)(cid:16)(cid:34)(cid:33,Unknown,695.0
Unknown,Unknown,2,Unknown,Unknown,Unknown,Unknown,cid:12)(cid:29)(cid:26)(cid:41)(cid:25)(cid:2)(cid:58)(cid:58)(cid:37)(cid:16)(cid:34)(cid:33,Unknown,697.0
Unknown,Unknown,44,Unknown,Unknown,Unknown,Unknown,cid:12)(cid:29)(cid:26)(cid:41)(cid:25)(cid:2)(cid:58)(cid:58)(cid:37)(cid:16)(cid:34)(cid:33,Unknown,741.0
Unknown,Unknown,12,Unknown,Unknown,Unknown,Unknown,cid:12)(cid:29)(cid:26)(cid:41)(cid:25)(cid:2)(cid:58)(cid:58)(cid:37)(cid:16)(cid:34)(cid:33,Unknown,753.0
Unknown,Unknown,29,Unknown,Unknown,Unknown,Unknown,cid:12)(cid:29)(cid:26)(cid:41)(cid:25)(cid:2)(cid:58)(cid:58)(cid:37)(cid:16)(cid:34)(cid:33,Unknown,782.0
Unknown,Unknown,26,Unknown,Unknown,Unknown,Unknown,cid:12)(cid:29)(cid:26)(cid:41)(cid:25)(cid:2)(cid:58)(cid:58)(cid:37)(cid:16)(cid:34)(cid:33,Unknown,808.0
Unknown,Unknown,41,Unknown,Unknown,Unknown,Unknown,cid:12)(cid:29)(cid:26)(cid:41)(cid:25)(cid:2)(cid:58)(cid:58)(cid:37)(cid:16)(cid:34)(cid:33,Unknown,849.0
Unknown,Unknown,25,Unknown,Unknown,Unknown,Unknown,cid:12)(cid:29)(cid:26)(cid:41)(cid:25)(cid:2)(cid:58)(cid:58)(cid:37)(cid:16)(cid:34)(cid:33,Unknown,874.0
Unknown,Unknown,2,Unknown,Unknown,Unknown,Unknown,cid:12)(cid:29)(cid:26)(cid:41)(cid:25)(cid:2)(cid:58)(cid:58)(cid:37)(cid:16)(cid:34)(cid:33,Unknown,876.0
Unknown,Unknown,58,Unknown,Unknown,Unknown,Unknown,cid:12)(cid:29)(cid:26)(cid:41)(cid:25)(cid:2)(cid:58)(cid:58)(cid:37)(cid:16)(cid:34)(cid:33,Unknown,934.0
Unknown,Unknown,58,Unknown,Unknown,Unknown,Unknown,cid:12)(cid:29)(cid:26)(cid:41)(cid:25)(cid:2)(cid:58)(cid:58)(cid:37)(cid:16)(cid:34)(cid:33,Unknown,992.0
Unknown,Unknown,37,Unknown,Unknown,Unknown,Unknown,cid:12)(cid:29)(cid:26)(cid:41)(cid:25)(cid:2)(cid:58)(cid:58)(cid:37)(cid:16)(cid:34)(cid:33,Unknown,1029.0
Unknown,Unknown,16,Unknown,Unknown,Unknown,Unknown,cid:12)(cid:29)(cid:26)(cid:41)(cid:25)(cid:2)(cid:58)(cid:58)(cid:37)(cid:16)(cid:34)(cid:33,Unknown,1045.0
Unknown,Unknown,34,Unknown,Unknown,Unknown,Unknown,cid:12)(cid:29)(cid:26)(cid:41)(cid:25)(cid:2)(cid:58)(cid:58)(cid:37)(cid:16)(cid:34)(cid:33,Unknown,1079.0
Unknown,Unknown,33,Unknown,Unknown,Unknown,Unknown,cid:12)(cid:29)(cid:26)(cid:41)(cid:25)(cid:2)(cid:58)(cid:58)(cid:37)(cid:16)(cid:34)(cid:33,Unknown,1112.0
Unknown,Unknown,1,Unknown,Unknown,Unknown,Unknown,cid:12)(cid:29)(cid:26)(cid:41)(cid:25)(cid:2)(cid:58)(cid:58)(cid:37)(cid:16)(cid:34)(cid:33,Unknown,1113.0
Unknown,Unknown,1,Unknown,Unknown,Unknown,Unknown,cid:12)(cid:29)(cid:26)(cid:41)(cid:25)(cid:2)(cid:58)(cid:58)(cid:37)(cid:16)(cid:34)(cid:33,Unknown,1114.0
Unknown,Unknown,45,Unknown,Unknown,Unknown,Unknown,cid:12)(cid:29)(cid:26)(cid:41)(cid:25)(cid:2)(cid:58)(cid:58)(cid:37)(cid:16)(cid:34)(cid:33,Unknown,1159.0
Unknown,Unknown,18,Unknown,Unknown,Unknown,Unknown,cid:12)(cid:29)(cid:26)(cid:41)(cid:25)(cid:2)(cid:58)(cid:58)(cid:37)(cid:16)(cid:34)(cid:33,Unknown,1177.0
Unknown,Unknown,16,Unknown,Unknown,Unknown,Unknown,cid:12)(cid:29)(cid:26)(cid:41)(cid:25)(cid:2)(cid:58)(cid:58)(cid:37)(cid:16)(cid:34)(cid:33,Unknown,1193.0
Unknown,Unknown,14,Unknown,Unknown,Unknown,Unknown,cid:12)(cid:29)(cid:26)(cid:41)(cid:25)(cid:2)(cid:58)(cid:58)(cid:37)(cid:16)(cid:34)(cid:33,Unknown,1207.0
Unknown,Unknown,5,Unknown,Unknown,Unknown,Unknown,cid:12)(cid:29)(cid:26)(cid:41)(cid:25)(cid:2)(cid:58)(cid:58)(cid:37)(cid:16)(cid:34)(cid:33,Unknown,1212.0
Unknown,Unknown,47,Unknown,Unknown,Unknown,Unknown,cid:12)(cid:29)(cid:26)(cid:41)(cid:25)(cid:2)(cid:58)(cid:58)(cid:37)(cid:16)(cid:34)(cid:33,Unknown,1259.0
Unknown,Unknown,5,Unknown,Unknown,Unknown,Unknown,cid:12)(cid:29)(cid:26)(cid:41)(cid:25)(cid:2)(cid:58)(cid:58)(cid:37)(cid:16)(cid:34)(cid:33,Unknown,1264.0
Unknown,Unknown,5,Unknown,Unknown,Unknown,Unknown,cid:12)(cid:29)(cid:26)(cid:41)(cid:25)(cid:2)(cid:58)(cid:58)(cid:37)(cid:16)(cid:34)(cid:33,Unknown,1269.0
Unknown,Unknown,43,Unknown,Unknown,Unknown,Unknown,cid:12)(cid:29)(cid:26)(cid:41)(cid:25)(cid:2)(cid:58)(cid:58)(cid:37)(cid:16)(cid:34)(cid:33,Unknown,1312.0
Unknown,Unknown,2,Unknown,Unknown,Unknown,Unknown,cid:12)(cid:29)(cid:26)(cid:41)(cid:25)(cid:2)(cid:58)(cid:58)(cid:37)(cid:16)(cid:34)(cid:33,Unknown,1314.0
Unknown,Unknown,36,Unknown,Unknown,Unknown,Unknown,cid:12)(cid:29)(cid:26)(cid:41)(cid:25)(cid:2)(cid:58)(cid:58)(cid:37)(cid:16)(cid:34)(cid:33,Unknown,1350.0
Unknown,Unknown,35,Unknown,Unknown,Unknown,Unknown,cid:12)(cid:29)(cid:26)(cid:41)(cid:25)(cid:2)(cid:58)(cid:58)(cid:37)(cid:16)(cid:34)(cid:33,Unknown,1385.0
Unknown,Unknown,18,Unknown,Unknown,Unknown,Unknown,cid:12)(cid:29)(cid:26)(cid:41)(cid:25)(cid:2)(cid:58)(cid:58)(cid:37)(cid:16)(cid:34)(cid:33,Unknown,1403.0
Unknown,Unknown,19,Unknown,Unknown,Unknown,Unknown,cid:12)(cid:29)(cid:26)(cid:41)(cid:25)(cid:2)(cid:58)(cid:58)(cid:37)(cid:16)(cid:34)(cid:33,Unknown,1422.0
Unknown,Unknown,18,Unknown,Unknown,Unknown,Unknown,cid:12)(cid:29)(cid:26)(cid:41)(cid:25)(cid:2)(cid:58)(cid:58)(cid:37)(cid:16)(cid:34)(cid:33,Unknown,1440.0
Unknown,Unknown,18,Unknown,Unknown,Unknown,Unknown,cid:12)(cid:29)(cid:26)(cid:41)(cid:25)(cid:2)(cid:58)(cid:58)(cid:37)(cid:16)(cid:34)(cid:33,Unknown,1458.0
Unknown,Unknown,2,Unknown,Unknown,Unknown,Unknown,cid:12)(cid:29)(cid:26)(cid:41)(cid:25)(cid:2)(cid:58)(cid:58)(cid:37)(cid:16)(cid:34)(cid:33,Unknown,1460.0
Unknown,Unknown,44,Unknown,Unknown,Unknown,Unknown,cid:12)(cid:29)(cid:26)(cid:41)(cid:25)(cid:2)(cid:58)(cid:58)(cid:37)(cid:16)(cid:34)(cid:33,Unknown,1504.0
Unknown,Unknown,50,Unknown,Unknown,Unknown,Unknown,cid:12)(cid:29)(cid:26)(cid:41)(cid:25)(cid:2)(cid:58)(cid:58)(cid:37)(cid:16)(cid:34)(cid:33,Unknown,1554.0
Unknown,Unknown,42,Unknown,Unknown,Unknown,Unknown,cid:12)(cid:29)(cid:26)(cid:41)(cid:25)(cid:2)(cid:58)(cid:58)(cid:37)(cid:16)(cid:34)(cid:33,Unknown,1596.0
Unknown,Unknown,51,Unknown,Unknown,Unknown,Unknown,cid:12)(cid:29)(cid:26)(cid:41)(cid:25)(cid:2)(cid:58)(cid:58)(cid:37)(cid:16)(cid:34)(cid:33,Unknown,1647.0
Unknown,Unknown,52,Unknown,Unknown,Unknown,Unknown,cid:12)(cid:29)(cid:26)(cid:41)(cid:25)(cid:2)(cid:58)(cid:58)(cid:37)(cid:16)(cid:34)(cid:33,Unknown,1699.0
Unknown,Unknown,41,Unknown,Unknown,Unknown,Unknown,cid:12)(cid:29)(cid:26)(cid:41)(cid:25)(cid:2)(cid:58)(cid:58)(cid:37)(cid:16)(cid:34)(cid:33,Unknown,1740.0
Unknown,Unknown,2,Unknown,Unknown,Unknown,Unknown,cid:12)(cid:29)(cid:26)(cid:41)(cid:25)(cid:2)(cid:58)(cid:58)(cid:37)(cid:16)(cid:34)(cid:33,Unknown,1742.0
Unknown,Unknown,53,Unknown,Unknown,Unknown,Unknown,cid:12)(cid:29)(cid:26)(cid:41)(cid:25)(cid:2)(cid:58)(cid:58)(cid:37)(cid:16)(cid:34)(cid:33,Unknown,1795.0
Unknown,Unknown,25,Unknown,Unknown,Unknown,Unknown,cid:12)(cid:29)(cid:26)(cid:41)(cid:25)(cid:2)(cid:58)(cid:58)(cid:37)(cid:16)(cid:34)(cid:33,Unknown,1820.0
Unknown,Unknown,2,Unknown,Unknown,Unknown,Unknown,cid:12)(cid:29)(cid:26)(cid:41)(cid:25)(cid:2)(cid:58)(cid:58)(cid:37)(cid:16)(cid:34)(cid:33,Unknown,1822.0
Unknown,Unknown,31,Unknown,Unknown,Unknown,Unknown,cid:12)(cid:29)(cid:26)(cid:41)(cid:25)(cid:2)(cid:58)(cid:58)(cid:37)(cid:16)(cid:34)(cid:33,Unknown,1853.0
Unknown,Unknown,54,Unknown,Unknown,Unknown,Unknown,cid:12)(cid:29)(cid:26)(cid:41)(cid:25)(cid:2)(cid:58)(cid:58)(cid:37)(cid:16)(cid:34)(cid:33,Unknown,1907.0
Unknown,Unknown,55,Unknown,Unknown,Unknown,Unknown,cid:12)(cid:29)(cid:26)(cid:41)(cid:25)(cid:2)(cid:58)(cid:58)(cid:37)(cid:16)(cid:34)(cid:33,Unknown,1962.0
Unknown,Unknown,56,Unknown,Unknown,Unknown,Unknown,cid:12)(cid:29)(cid:26)(cid:41)(cid:25)(cid:2)(cid:58)(cid:58)(cid:37)(cid:16)(cid:34)(cid:33,Unknown,2018.0
Unknown,Unknown,21,Unknown,Unknown,Unknown,Unknown,cid:12)(cid:29)(cid:26)(cid:41)(cid:25)(cid:2)(cid:58)(cid:58)(cid:37)(cid:16)(cid:34)(cid:33,Unknown,2039.0
Unknown,Unknown,25,Unknown,Unknown,Unknown,Unknown,cid:12)(cid:29)(cid:26)(cid:41)(cid:25)(cid:2)(cid:58)(cid:58)(cid:37)(cid:16)(cid:34)(cid:33,Unknown,2064.0
Unknown,Unknown,1,Unknown,Unknown,Unknown,Unknown,cid:12)(cid:29)(cid:26)(cid:41)(cid:25)(cid:2)(cid:58)(cid:58)(cid:37)(cid:16)(cid:34)(cid:33,Unknown,2065.0
Unknown,Unknown,1,Unknown,Unknown,Unknown,Unknown,cid:12)(cid:29)(cid:26)(cid:41)(cid:25)(cid:2)(cid:58)(cid:58)(cid:37)(cid:16)(cid:34)(cid:33,Unknown,2066.0
Unknown,Unknown,45,Unknown,Unknown,Unknown,Unknown,cid:12)(cid:29)(cid:26)(cid:41)(cid:25)(cid:2)(cid:58)(cid:58)(cid:37)(cid:16)(cid:34)(cid:33,Unknown,2111.0
Unknown,Unknown,18,Unknown,Unknown,Unknown,Unknown,cid:12)(cid:29)(cid:26)(cid:41)(cid:25)(cid:2)(cid:58)(cid:58)(cid:37)(cid:16)(cid:34)(cid:33,Unknown,2129.0
Unknown,Unknown,16,Unknown,Unknown,Unknown,Unknown,cid:12)(cid:29)(cid:26)(cid:41)(cid:25)(cid:2)(cid:58)(cid:58)(cid:37)(cid:16)(cid:34)(cid:33,Unknown,2145.0
Unknown,Unknown,50,Unknown,Unknown,Unknown,Unknown,cid:12)(cid:29)(cid:26)(cid:41)(cid:25)(cid:2)(cid:58)(cid:58)(cid:37)(cid:16)(cid:34)(cid:33,Unknown,2195.0
Unknown,Unknown,46,Unknown,Unknown,Unknown,Unknown,cid:12)(cid:29)(cid:26)(cid:41)(cid:25)(cid:2)(cid:58)(cid:58)(cid:37)(cid:16)(cid:34)(cid:33,Unknown,2241.0
Unknown,Unknown,4,Unknown,Unknown,Unknown,Unknown,cid:12)(cid:29)(cid:26)(cid:41)(cid:25)(cid:2)(cid:58)(cid:58)(cid:37)(cid:16)(cid:34)(cid:33,Unknown,2245.0
Unknown,Unknown,64,Unknown,Unknown,Unknown,Unknown,cid:12)(cid:29)(cid:26)(cid:41)(cid:25)(cid:2)(cid:58)(cid:58)(cid:37)(cid:16)(cid:34)(cid:33,Unknown,2309.0
Unknown,Unknown,8,Unknown,Unknown,Unknown,Unknown,cid:12)(cid:29)(cid:26)(cid:41)(cid:25)(cid:2)(cid:58)(cid:58)(cid:37)(cid:16)(cid:34)(cid:33,Unknown,2317.0
Unknown,Unknown,49,Unknown,Unknown,Unknown,Unknown,cid:12)(cid:29)(cid:26)(cid:41)(cid:25)(cid:2)(cid:58)(cid:58)(cid:37)(cid:16)(cid:34)(cid:33,Unknown,2366.0
Unknown,Unknown,2,Unknown,Unknown,Unknown,Unknown,cid:12)(cid:29)(cid:26)(cid:41)(cid:25)(cid:2)(cid:58)(cid:58)(cid:37)(cid:16)(cid:34)(cid:33,Unknown,2368.0
Unknown,Unknown,72,Unknown,Unknown,Unknown,Unknown,cid:12)(cid:29)(cid:26)(cid:41)(cid:25)(cid:2)(cid:58)(cid:58)(cid:37)(cid:16)(cid:34)(cid:33,Unknown,2440.0
Unknown,Unknown,46,Unknown,Unknown,Unknown,Unknown,cid:12)(cid:29)(cid:26)(cid:41)(cid:25)(cid:2)(cid:58)(cid:58)(cid:37)(cid:16)(cid:34)(cid:33,Unknown,2486.0
Unknown,Unknown,12,Unknown,Unknown,Unknown,Unknown,cid:12)(cid:29)(cid:26)(cid:41)(cid:25)(cid:2)(cid:58)(cid:58)(cid:37)(cid:16)(cid:34)(cid:33,Unknown,2498.0
Unknown,Unknown,38,Unknown,Unknown,Unknown,Unknown,cid:12)(cid:29)(cid:26)(cid:41)(cid:25)(cid:2)(cid:58)(cid:58)(cid:37)(cid:16)(cid:34)(cid:33,Unknown,2536.0
Unknown,Unknown,4,Unknown,Unknown,Unknown,Unknown,cid:12)(cid:29)(cid:26)(cid:41)(cid:25)(cid:2)(cid:58)(cid:58)(cid:37)(cid:16)(cid:34)(cid:33,Unknown,2540.0
Unknown,Unknown,5,Unknown,Unknown,Unknown,Unknown,cid:12)(cid:29)(cid:26)(cid:41)(cid:25)(cid:2)(cid:58)(cid:58)(cid:37)(cid:16)(cid:34)(cid:33,Unknown,2545.0
Unknown,Unknown,14,Unknown,Unknown,Unknown,Unknown,cid:12)(cid:29)(cid:26)(cid:41)(cid:25)(cid:2)(cid:58)(cid:58)(cid:37)(cid:16)(cid:34)(cid:33,Unknown,2559.0
Unknown,Unknown,7,Unknown,Unknown,Unknown,Unknown,cid:12)(cid:29)(cid:26)(cid:41)(cid:25)(cid:2)(cid:58)(cid:58)(cid:37)(cid:16)(cid:34)(cid:33,Unknown,2566.0
Unknown,Unknown,8,Unknown,Unknown,Unknown,Unknown,cid:12)(cid:29)(cid:26)(cid:41)(cid:25)(cid:2)(cid:58)(cid:58)(cid:37)(cid:16)(cid:34)(cid:33,Unknown,2574.0
Unknown,Unknown,5,Unknown,Unknown,Unknown,Unknown,cid:12)(cid:29)(cid:26)(cid:41)(cid:25)(cid:2)(cid:58)(cid:58)(cid:37)(cid:16)(cid:34)(cid:33,Unknown,2579.0
Unknown,Unknown,43,Unknown,Unknown,Unknown,Unknown,cid:12)(cid:29)(cid:26)(cid:41)(cid:25)(cid:2)(cid:58)(cid:58)(cid:37)(cid:16)(cid:34)(cid:33,Unknown,2622.0
Unknown,Unknown,2,Unknown,Unknown,Unknown,Unknown,cid:12)(cid:29)(cid:26)(cid:41)(cid:25)(cid:2)(cid:58)(cid:58)(cid:37)(cid:16)(cid:34)(cid:33,Unknown,2624.0
Unknown,Unknown,1,Unknown,Unknown,Unknown,Unknown,cid:12)(cid:29)(cid:26)(cid:41)(cid:25)(cid:2)(cid:58)(cid:58)(cid:37)(cid:16)(cid:34)(cid:33,Unknown,2625.0
Unknown,Unknown,32,Unknown,Unknown,Unknown,Unknown,cid:12)(cid:29)(cid:26)(cid:41)(cid:25)(cid:2)(cid:58)(cid:58)(cid:37)(cid:16)(cid:34)(cid:33,Unknown,2657.0
Unknown,Unknown,18,Unknown,Unknown,Unknown,Unknown,cid:12)(cid:29)(cid:26)(cid:41)(cid:25)(cid:2)(cid:58)(cid:58)(cid:37)(cid:16)(cid:34)(cid:33,Unknown,2675.0
Unknown,Unknown,19,Unknown,Unknown,Unknown,Unknown,cid:12)(cid:29)(cid:26)(cid:41)(cid:25)(cid:2)(cid:58)(cid:58)(cid:37)(cid:16)(cid:34)(cid:33,Unknown,2694.0
Unknown,Unknown,18,Unknown,Unknown,Unknown,Unknown,cid:12)(cid:29)(cid:26)(cid:41)(cid:25)(cid:2)(cid:58)(cid:58)(cid:37)(cid:16)(cid:34)(cid:33,Unknown,2712.0
Unknown,Unknown,18,Unknown,Unknown,Unknown,Unknown,cid:12)(cid:29)(cid:26)(cid:41)(cid:25)(cid:2)(cid:58)(cid:58)(cid:37)(cid:16)(cid:34)(cid:33,Unknown,2730.0
Unknown,Unknown,2,Unknown,Unknown,Unknown,Unknown,cid:12)(cid:29)(cid:26)(cid:41)(cid:25)(cid:2)(cid:58)(cid:58)(cid:37)(cid:16)(cid:34)(cid:33,Unknown,2732.0
Unknown,Unknown,44,Unknown,Unknown,Unknown,Unknown,cid:12)(cid:29)(cid:26)(cid:41)(cid:25)(cid:2)(cid:58)(cid:58)(cid:37)(cid:16)(cid:34)(cid:33,Unknown,2776.0
Unknown,Unknown,50,Unknown,Unknown,Unknown,Unknown,cid:12)(cid:29)(cid:26)(cid:41)(cid:25)(cid:2)(cid:58)(cid:58)(cid:37)(cid:16)(cid:34)(cid:33,Unknown,2826.0
Unknown,Unknown,42,Unknown,Unknown,Unknown,Unknown,cid:12)(cid:29)(cid:26)(cid:41)(cid:25)(cid:2)(cid:58)(cid:58)(cid:37)(cid:16)(cid:34)(cid:33,Unknown,2868.0
Unknown,Unknown,51,Unknown,Unknown,Unknown,Unknown,cid:12)(cid:29)(cid:26)(cid:41)(cid:25)(cid:2)(cid:58)(cid:58)(cid:37)(cid:16)(cid:34)(cid:33,Unknown,2919.0
Unknown,Unknown,52,Unknown,Unknown,Unknown,Unknown,cid:12)(cid:29)(cid:26)(cid:41)(cid:25)(cid:2)(cid:58)(cid:58)(cid:37)(cid:16)(cid:34)(cid:33,Unknown,2971.0
Unknown,Unknown,41,Unknown,Unknown,Unknown,Unknown,cid:12)(cid:29)(cid:26)(cid:41)(cid:25)(cid:2)(cid:58)(cid:58)(cid:37)(cid:16)(cid:34)(cid:33,Unknown,3012.0
Unknown,Unknown,2,Unknown,Unknown,Unknown,Unknown,cid:12)(cid:29)(cid:26)(cid:41)(cid:25)(cid:2)(cid:58)(cid:58)(cid:37)(cid:16)(cid:34)(cid:33,Unknown,3014.0
Unknown,Unknown,53,Unknown,Unknown,Unknown,Unknown,cid:12)(cid:29)(cid:26)(cid:41)(cid:25)(cid:2)(cid:58)(cid:58)(cid:37)(cid:16)(cid:34)(cid:33,Unknown,3067.0
Unknown,Unknown,25,Unknown,Unknown,Unknown,Unknown,cid:12)(cid:29)(cid:26)(cid:41)(cid:25)(cid:2)(cid:58)(cid:58)(cid:37)(cid:16)(cid:34)(cid:33,Unknown,3092.0
Unknown,Unknown,2,Unknown,Unknown,Unknown,Unknown,cid:12)(cid:29)(cid:26)(cid:41)(cid:25)(cid:2)(cid:58)(cid:58)(cid:37)(cid:16)(cid:34)(cid:33,Unknown,3094.0
Unknown,Unknown,31,Unknown,Unknown,Unknown,Unknown,cid:12)(cid:29)(cid:26)(cid:41)(cid:25)(cid:2)(cid:58)(cid:58)(cid:37)(cid:16)(cid:34)(cid:33,Unknown,3125.0
Unknown,Unknown,54,Unknown,Unknown,Unknown,Unknown,cid:12)(cid:29)(cid:26)(cid:41)(cid:25)(cid:2)(cid:58)(cid:58)(cid:37)(cid:16)(cid:34)(cid:33,Unknown,3179.0
Unknown,Unknown,55,Unknown,Unknown,Unknown,Unknown,cid:12)(cid:29)(cid:26)(cid:41)(cid:25)(cid:2)(cid:58)(cid:58)(cid:37)(cid:16)(cid:34)(cid:33,Unknown,3234.0
Unknown,Unknown,56,Unknown,Unknown,Unknown,Unknown,cid:12)(cid:29)(cid:26)(cid:41)(cid:25)(cid:2)(cid:58)(cid:58)(cid:37)(cid:16)(cid:34)(cid:33,Unknown,3290.0
Unknown,Unknown,21,Unknown,Unknown,Unknown,Unknown,cid:12)(cid:29)(cid:26)(cid:41)(cid:25)(cid:2)(cid:58)(cid:58)(cid:37)(cid:16)(cid:34)(cid:33,Unknown,3311.0
Unknown,Unknown,25,Unknown,Unknown,Unknown,Unknown,cid:12)(cid:29)(cid:26)(cid:41)(cid:25)(cid:2)(cid:58)(cid:58)(cid:37)(cid:16)(cid:34)(cid:33,Unknown,3336.0
Unknown,Unknown,1,Unknown,Unknown,Unknown,Unknown,cid:12)(cid:29)(cid:26)(cid:41)(cid:25)(cid:2)(cid:58)(cid:58)(cid:37)(cid:16)(cid:34)(cid:33,Unknown,3337.0
Unknown,Unknown,1,Unknown,Unknown,Unknown,Unknown,cid:12)(cid:29)(cid:26)(cid:41)(cid:25)(cid:2)(cid:58)(cid:58)(cid:37)(cid:16)(cid:34)(cid:33,Unknown,3338.0
Unknown,Unknown,45,Unknown,Unknown,Unknown,Unknown,cid:12)(cid:29)(cid:26)(cid:41)(cid:25)(cid:2)(cid:58)(cid:58)(cid:37)(cid:16)(cid:34)(cid:33,Unknown,3383.0
Unknown,Unknown,18,Unknown,Unknown,Unknown,Unknown,cid:12)(cid:29)(cid:26)(cid:41)(cid:25)(cid:2)(cid:58)(cid:58)(cid:37)(cid:16)(cid:34)(cid:33,Unknown,3401.0
Unknown,Unknown,16,Unknown,Unknown,Unknown,Unknown,cid:12)(cid:29)(cid:26)(cid:41)(cid:25)(cid:2)(cid:58)(cid:58)(cid:37)(cid:16)(cid:34)(cid:33,Unknown,3417.0
Unknown,Unknown,50,Unknown,Unknown,Unknown,Unknown,cid:12)(cid:29)(cid:26)(cid:41)(cid:25)(cid:2)(cid:58)(cid:58)(cid:37)(cid:16)(cid:34)(cid:33,Unknown,3467.0
Unknown,Unknown,46,Unknown,Unknown,Unknown,Unknown,cid:12)(cid:29)(cid:26)(cid:41)(cid:25)(cid:2)(cid:58)(cid:58)(cid:37)(cid:16)(cid:34)(cid:33,Unknown,3513.0
Unknown,Unknown,4,Unknown,Unknown,Unknown,Unknown,cid:12)(cid:29)(cid:26)(cid:41)(cid:25)(cid:2)(cid:58)(cid:58)(cid:37)(cid:16)(cid:34)(cid:33,Unknown,3517.0
Unknown,Unknown,64,Unknown,Unknown,Unknown,Unknown,cid:12)(cid:29)(cid:26)(cid:41)(cid:25)(cid:2)(cid:58)(cid:58)(cid:37)(cid:16)(cid:34)(cid:33,Unknown,3581.0
Unknown,Unknown,8,Unknown,Unknown,Unknown,Unknown,cid:12)(cid:29)(cid:26)(cid:41)(cid:25)(cid:2)(cid:58)(cid:58)(cid:37)(cid:16)(cid:34)(cid:33,Unknown,3589.0
Unknown,Unknown,49,Unknown,Unknown,Unknown,Unknown,cid:12)(cid:29)(cid:26)(cid:41)(cid:25)(cid:2)(cid:58)(cid:58)(cid:37)(cid:16)(cid:34)(cid:33,Unknown,3638.0
Unknown,Unknown,43,Unknown,Unknown,Unknown,Unknown,cid:12)(cid:29)(cid:26)(cid:41)(cid:25)(cid:2)(cid:58)(cid:58)(cid:37)(cid:16)(cid:34)(cid:33,Unknown,3681.0
Unknown,Unknown,2,Unknown,Unknown,Unknown,Unknown,cid:12)(cid:29)(cid:26)(cid:41)(cid:25)(cid:2)(cid:58)(cid:58)(cid:37)(cid:16)(cid:34)(cid:33,Unknown,3683.0
Unknown,Unknown,1,Unknown,Unknown,Unknown,Unknown,cid:12)(cid:29)(cid:26)(cid:41)(cid:25)(cid:2)(cid:58)(cid:58)(cid:37)(cid:16)(cid:34)(cid:33,Unknown,3684.0
Unknown,Unknown,32,Unknown,Unknown,Unknown,Unknown,cid:12)(cid:29)(cid:26)(cid:41)(cid:25)(cid:2)(cid:58)(cid:58)(cid:37)(cid:16)(cid:34)(cid:33,Unknown,3716.0
Unknown,Unknown,18,Unknown,Unknown,Unknown,Unknown,cid:12)(cid:29)(cid:26)(cid:41)(cid:25)(cid:2)(cid:58)(cid:58)(cid:37)(cid:16)(cid:34)(cid:33,Unknown,3734.0
Unknown,Unknown,19,Unknown,Unknown,Unknown,Unknown,cid:12)(cid:29)(cid:26)(cid:41)(cid:25)(cid:2)(cid:58)(cid:58)(cid:37)(cid:16)(cid:34)(cid:33,Unknown,3753.0
Unknown,Unknown,18,Unknown,Unknown,Unknown,Unknown,cid:12)(cid:29)(cid:26)(cid:41)(cid:25)(cid:2)(cid:58)(cid:58)(cid:37)(cid:16)(cid:34)(cid:33,Unknown,3771.0
Unknown,Unknown,18,Unknown,Unknown,Unknown,Unknown,cid:12)(cid:29)(cid:26)(cid:41)(cid:25)(cid:2)(cid:58)(cid:58)(cid:37)(cid:16)(cid:34)(cid:33,Unknown,3789.0
Unknown,Unknown,2,Unknown,Unknown,Unknown,Unknown,cid:12)(cid:29)(cid:26)(cid:41)(cid:25)(cid:2)(cid:58)(cid:58)(cid:37)(cid:16)(cid:34)(cid:33,Unknown,3791.0
Unknown,Unknown,44,Unknown,Unknown,Unknown,Unknown,cid:12)(cid:29)(cid:26)(cid:41)(cid:25)(cid:2)(cid:58)(cid:58)(cid:37)(cid:16)(cid:34)(cid:33,Unknown,3835.0
Unknown,Unknown,50,Unknown,Unknown,Unknown,Unknown,cid:12)(cid:29)(cid:26)(cid:41)(cid:25)(cid:2)(cid:58)(cid:58)(cid:37)(cid:16)(cid:34)(cid:33,Unknown,3885.0
Unknown,Unknown,42,Unknown,Unknown,Unknown,Unknown,cid:12)(cid:29)(cid:26)(cid:41)(cid:25)(cid:2)(cid:58)(cid:58)(cid:37)(cid:16)(cid:34)(cid:33,Unknown,3927.0
Unknown,Unknown,51,Unknown,Unknown,Unknown,Unknown,cid:12)(cid:29)(cid:26)(cid:41)(cid:25)(cid:2)(cid:58)(cid:58)(cid:37)(cid:16)(cid:34)(cid:33,Unknown,3978.0
Unknown,Unknown,52,Unknown,Unknown,Unknown,Unknown,cid:12)(cid:29)(cid:26)(cid:41)(cid:25)(cid:2)(cid:58)(cid:58)(cid:37)(cid:16)(cid:34)(cid:33,Unknown,4030.0
Unknown,Unknown,41,Unknown,Unknown,Unknown,Unknown,cid:12)(cid:29)(cid:26)(cid:41)(cid:25)(cid:2)(cid:58)(cid:58)(cid:37)(cid:16)(cid:34)(cid:33,Unknown,4071.0
Unknown,Unknown,2,Unknown,Unknown,Unknown,Unknown,cid:12)(cid:29)(cid:26)(cid:41)(cid:25)(cid:2)(cid:58)(cid:58)(cid:37)(cid:16)(cid:34)(cid:33,Unknown,4073.0
Unknown,Unknown,53,Unknown,Unknown,Unknown,Unknown,cid:12)(cid:29)(cid:26)(cid:41)(cid:25)(cid:2)(cid:58)(cid:58)(cid:37)(cid:16)(cid:34)(cid:33,Unknown,4126.0
Unknown,Unknown,25,Unknown,Unknown,Unknown,Unknown,cid:12)(cid:29)(cid:26)(cid:41)(cid:25)(cid:2)(cid:58)(cid:58)(cid:37)(cid:16)(cid:34)(cid:33,Unknown,4151.0
Unknown,Unknown,2,Unknown,Unknown,Unknown,Unknown,cid:12)(cid:29)(cid:26)(cid:41)(cid:25)(cid:2)(cid:58)(cid:58)(cid:37)(cid:16)(cid:34)(cid:33,Unknown,4153.0
Unknown,Unknown,31,Unknown,Unknown,Unknown,Unknown,cid:12)(cid:29)(cid:26)(cid:41)(cid:25)(cid:2)(cid:58)(cid:58)(cid:37)(cid:16)(cid:34)(cid:33,Unknown,4184.0
Unknown,Unknown,54,Unknown,Unknown,Unknown,Unknown,cid:12)(cid:29)(cid:26)(cid:41)(cid:25)(cid:2)(cid:58)(cid:58)(cid:37)(cid:16)(cid:34)(cid:33,Unknown,4238.0
Unknown,Unknown,55,Unknown,Unknown,Unknown,Unknown,cid:12)(cid:29)(cid:26)(cid:41)(cid:25)(cid:2)(cid:58)(cid:58)(cid:37)(cid:16)(cid:34)(cid:33,Unknown,4293.0
Unknown,Unknown,56,Unknown,Unknown,Unknown,Unknown,cid:12)(cid:29)(cid:26)(cid:41)(cid:25)(cid:2)(cid:58)(cid:58)(cid:37)(cid:16)(cid:34)(cid:33,Unknown,4349.0
Unknown,Unknown,21,Unknown,Unknown,Unknown,Unknown,cid:12)(cid:29)(cid:26)(cid:41)(cid:25)(cid:2)(cid:58)(cid:58)(cid:37)(cid:16)(cid:34)(cid:33,Unknown,4370.0
Unknown,Unknown,25,Unknown,Unknown,Unknown,Unknown,cid:12)(cid:29)(cid:26)(cid:41)(cid:25)(cid:2)(cid:58)(cid:58)(cid:37)(cid:16)(cid:34)(cid:33,Unknown,4395.0
Unknown,Unknown,1,Unknown,Unknown,Unknown,Unknown,cid:12)(cid:29)(cid:26)(cid:41)(cid:25)(cid:2)(cid:58)(cid:58)(cid:37)(cid:16)(cid:34)(cid:33,Unknown,4396.0
Unknown,Unknown,1,Unknown,Unknown,Unknown,Unknown,cid:12)(cid:29)(cid:26)(cid:41)(cid:25)(cid:2)(cid:58)(cid:58)(cid:37)(cid:16)(cid:34)(cid:33,Unknown,4397.0
Unknown,Unknown,45,Unknown,Unknown,Unknown,Unknown,cid:12)(cid:29)(cid:26)(cid:41)(cid:25)(cid:2)(cid:58)(cid:58)(cid:37)(cid:16)(cid:34)(cid:33,Unknown,4442.0
Unknown,Unknown,18,Unknown,Unknown,Unknown,Unknown,cid:12)(cid:29)(cid:26)(cid:41)(cid:25)(cid:2)(cid:58)(cid:58)(cid:37)(cid:16)(cid:34)(cid:33,Unknown,4460.0
Unknown,Unknown,16,Unknown,Unknown,Unknown,Unknown,cid:12)(cid:29)(cid:26)(cid:41)(cid:25)(cid:2)(cid:58)(cid:58)(cid:37)(cid:16)(cid:34)(cid:33,Unknown,4476.0
Unknown,Unknown,38,Unknown,Unknown,Unknown,Unknown,cid:12)(cid:29)(cid:26)(cid:41)(cid:25)(cid:2)(cid:58)(cid:58)(cid:37)(cid:16)(cid:34)(cid:33,Unknown,4514.0
Unknown,Unknown,20,Unknown,Unknown,Unknown,Unknown,cid:12)(cid:29)(cid:26)(cid:41)(cid:25)(cid:2)(cid:58)(cid:58)(cid:37)(cid:16)(cid:34)(cid:33,Unknown,4534.0
Unknown,Unknown,30,Unknown,Unknown,Unknown,Unknown,cid:12)(cid:29)(cid:26)(cid:41)(cid:25)(cid:2)(cid:58)(cid:58)(cid:37)(cid:16)(cid:34)(cid:33,Unknown,4564.0
Unknown,Unknown,41,Unknown,Unknown,Unknown,Unknown,cid:12)(cid:29)(cid:26)(cid:41)(cid:25)(cid:2)(cid:58)(cid:58)(cid:37)(cid:16)(cid:34)(cid:33,Unknown,4605.0
Unknown,Unknown,20,Unknown,Unknown,Unknown,Unknown,cid:12)(cid:29)(cid:26)(cid:41)(cid:25)(cid:2)(cid:58)(cid:58)(cid:37)(cid:16)(cid:34)(cid:33,Unknown,4625.0
Unknown,Unknown,15,Unknown,Unknown,Unknown,Unknown,cid:12)(cid:29)(cid:26)(cid:41)(cid:25)(cid:2)(cid:58)(cid:58)(cid:37)(cid:16)(cid:34)(cid:33,Unknown,4640.0
Unknown,Unknown,2,Unknown,Unknown,Unknown,Unknown,cid:12)(cid:29)(cid:26)(cid:41)(cid:25)(cid:2)(cid:58)(cid:58)(cid:37)(cid:16)(cid:34)(cid:33,Unknown,4642.0
Unknown,Unknown,1,Unknown,Unknown,Unknown,Unknown,cid:12)(cid:29)(cid:26)(cid:41)(cid:25)(cid:2)(cid:58)(cid:58)(cid:37)(cid:16)(cid:34)(cid:33,Unknown,4643.0
Unknown,Unknown,19,Unknown,Unknown,Unknown,Unknown,cid:12)(cid:29)(cid:26)(cid:41)(cid:25)(cid:2)(cid:58)(cid:58)(cid:37)(cid:16)(cid:34)(cid:33,Unknown,4662.0
Unknown,Unknown,36,Unknown,Unknown,Unknown,Unknown,cid:12)(cid:29)(cid:26)(cid:41)(cid:25)(cid:2)(cid:58)(cid:58)(cid:37)(cid:16)(cid:34)(cid:33,Unknown,4698.0
Unknown,Unknown,18,Unknown,Unknown,Unknown,Unknown,cid:12)(cid:29)(cid:26)(cid:41)(cid:25)(cid:2)(cid:58)(cid:58)(cid:37)(cid:16)(cid:34)(cid:33,Unknown,4716.0
Unknown,Unknown,2,Unknown,Unknown,Unknown,Unknown,cid:12)(cid:29)(cid:26)(cid:41)(cid:25)(cid:2)(cid:58)(cid:58)(cid:37)(cid:16)(cid:34)(cid:33,Unknown,4718.0
Unknown,Unknown,44,Unknown,Unknown,Unknown,Unknown,cid:12)(cid:29)(cid:26)(cid:41)(cid:25)(cid:2)(cid:58)(cid:58)(cid:37)(cid:16)(cid:34)(cid:33,Unknown,4762.0
Unknown,Unknown,46,Unknown,Unknown,Unknown,Unknown,cid:12)(cid:29)(cid:26)(cid:41)(cid:25)(cid:2)(cid:58)(cid:58)(cid:37)(cid:16)(cid:34)(cid:33,Unknown,4808.0
Unknown,Unknown,57,Unknown,Unknown,Unknown,Unknown,cid:12)(cid:29)(cid:26)(cid:41)(cid:25)(cid:2)(cid:58)(cid:58)(cid:37)(cid:16)(cid:34)(cid:33,Unknown,4865.0
Unknown,Unknown,20,Unknown,Unknown,Unknown,Unknown,cid:12)(cid:29)(cid:26)(cid:41)(cid:25)(cid:2)(cid:58)(cid:58)(cid:37)(cid:16)(cid:34)(cid:33,Unknown,4885.0
Unknown,Unknown,30,Unknown,Unknown,Unknown,Unknown,cid:12)(cid:29)(cid:26)(cid:41)(cid:25)(cid:2)(cid:58)(cid:58)(cid:37)(cid:16)(cid:34)(cid:33,Unknown,4915.0
Unknown,Unknown,30,Unknown,Unknown,Unknown,Unknown,cid:12)(cid:29)(cid:26)(cid:41)(cid:25)(cid:2)(cid:58)(cid:58)(cid:37)(cid:16)(cid:34)(cid:33,Unknown,4945.0
Unknown,Unknown,25,Unknown,Unknown,Unknown,Unknown,cid:12)(cid:29)(cid:26)(cid:41)(cid:25)(cid:2)(cid:58)(cid:58)(cid:37)(cid:16)(cid:34)(cid:33,Unknown,4970.0
Unknown,Unknown,23,Unknown,Unknown,Unknown,Unknown,cid:12)(cid:29)(cid:26)(cid:41)(cid:25)(cid:2)(cid:58)(cid:58)(cid:37)(cid:16)(cid:34)(cid:33,Unknown,4993.0
Unknown,Unknown,25,Unknown,Unknown,Unknown,Unknown,cid:12)(cid:29)(cid:26)(cid:41)(cid:25)(cid:2)(cid:58)(cid:58)(cid:37)(cid:16)(cid:34)(cid:33,Unknown,5018.0
Unknown,Unknown,30,Unknown,Unknown,Unknown,Unknown,cid:12)(cid:29)(cid:26)(cid:41)(cid:25)(cid:2)(cid:58)(cid:58)(cid:37)(cid:16)(cid:34)(cid:33,Unknown,5048.0
Unknown,Unknown,41,Unknown,Unknown,Unknown,Unknown,cid:12)(cid:29)(cid:26)(cid:41)(cid:25)(cid:2)(cid:58)(cid:58)(cid:37)(cid:16)(cid:34)(cid:33,Unknown,5089.0
Unknown,Unknown,2,Unknown,Unknown,Unknown,Unknown,cid:12)(cid:29)(cid:26)(cid:41)(cid:25)(cid:2)(cid:58)(cid:58)(cid:37)(cid:16)(cid:34)(cid:33,Unknown,5091.0
Unknown,Unknown,45,Unknown,Unknown,Unknown,Unknown,cid:12)(cid:29)(cid:26)(cid:41)(cid:25)(cid:2)(cid:58)(cid:58)(cid:37)(cid:16)(cid:34)(cid:33,Unknown,5136.0
Unknown,Unknown,2,Unknown,Unknown,Unknown,Unknown,cid:12)(cid:29)(cid:26)(cid:41)(cid:25)(cid:2)(cid:58)(cid:58)(cid:37)(cid:16)(cid:34)(cid:33,Unknown,5138.0
Unknown,Unknown,28,Unknown,Unknown,Unknown,Unknown,cid:12)(cid:29)(cid:26)(cid:41)(cid:25)(cid:2)(cid:58)(cid:58)(cid:37)(cid:16)(cid:34)(cid:33,Unknown,5166.0
Unknown,Unknown,26,Unknown,Unknown,Unknown,Unknown,cid:12)(cid:29)(cid:26)(cid:41)(cid:25)(cid:2)(cid:58)(cid:58)(cid:37)(cid:16)(cid:34)(cid:33,Unknown,5192.0
Unknown,Unknown,29,Unknown,Unknown,Unknown,Unknown,cid:12)(cid:29)(cid:26)(cid:41)(cid:25)(cid:2)(cid:58)(cid:58)(cid:37)(cid:16)(cid:34)(cid:33,Unknown,5221.0
Unknown,Unknown,24,Unknown,Unknown,Unknown,Unknown,cid:12)(cid:29)(cid:26)(cid:41)(cid:25)(cid:2)(cid:58)(cid:58)(cid:37)(cid:16)(cid:34)(cid:33,Unknown,5245.0
Unknown,Unknown,27,Unknown,Unknown,Unknown,Unknown,cid:12)(cid:29)(cid:26)(cid:41)(cid:25)(cid:2)(cid:58)(cid:58)(cid:37)(cid:16)(cid:34)(cid:33,Unknown,5272.0
Unknown,Unknown,2,Unknown,Unknown,Unknown,Unknown,cid:12)(cid:29)(cid:26)(cid:41)(cid:25)(cid:2)(cid:58)(cid:58)(cid:37)(cid:16)(cid:34)(cid:33,Unknown,5274.0
Unknown,Unknown,29,Unknown,Unknown,Unknown,Unknown,cid:12)(cid:29)(cid:26)(cid:41)(cid:25)(cid:2)(cid:58)(cid:58)(cid:37)(cid:16)(cid:34)(cid:33,Unknown,5303.0
Unknown,Unknown,53,Unknown,Unknown,Unknown,Unknown,cid:12)(cid:29)(cid:26)(cid:41)(cid:25)(cid:2)(cid:58)(cid:58)(cid:37)(cid:16)(cid:34)(cid:33,Unknown,5356.0
Unknown,Unknown,53,Unknown,Unknown,Unknown,Unknown,cid:12)(cid:29)(cid:26)(cid:41)(cid:25)(cid:2)(cid:58)(cid:58)(cid:37)(cid:16)(cid:34)(cid:33,Unknown,5409.0
Unknown,Unknown,24,Unknown,Unknown,Unknown,Unknown,cid:12)(cid:29)(cid:26)(cid:41)(cid:25)(cid:2)(cid:58)(cid:58)(cid:37)(cid:16)(cid:34)(cid:33,Unknown,5433.0
Unknown,Unknown,41,Unknown,Unknown,Unknown,Unknown,cid:12)(cid:29)(cid:26)(cid:41)(cid:25)(cid:2)(cid:58)(cid:58)(cid:37)(cid:16)(cid:34)(cid:33,Unknown,5474.0
Unknown,Unknown,24,Unknown,Unknown,Unknown,Unknown,cid:12)(cid:29)(cid:26)(cid:41)(cid:25)(cid:2)(cid:58)(cid:58)(cid:37)(cid:16)(cid:34)(cid:33,Unknown,5498.0
Unknown,Unknown,20,Unknown,Unknown,Unknown,Unknown,cid:12)(cid:29)(cid:26)(cid:41)(cid:25)(cid:2)(cid:58)(cid:58)(cid:37)(cid:16)(cid:34)(cid:33,Unknown,5518.0
Unknown,Unknown,30,Unknown,Unknown,Unknown,Unknown,cid:12)(cid:29)(cid:26)(cid:41)(cid:25)(cid:2)(cid:58)(cid:58)(cid:37)(cid:16)(cid:34)(cid:33,Unknown,5548.0
Unknown,Unknown,30,Unknown,Unknown,Unknown,Unknown,cid:12)(cid:29)(cid:26)(cid:41)(cid:25)(cid:2)(cid:58)(cid:58)(cid:37)(cid:16)(cid:34)(cid:33,Unknown,5578.0
Unknown,Unknown,25,Unknown,Unknown,Unknown,Unknown,cid:12)(cid:29)(cid:26)(cid:41)(cid:25)(cid:2)(cid:58)(cid:58)(cid:37)(cid:16)(cid:34)(cid:33,Unknown,5603.0
Unknown,Unknown,22,Unknown,Unknown,Unknown,Unknown,cid:12)(cid:29)(cid:26)(cid:41)(cid:25)(cid:2)(cid:58)(cid:58)(cid:37)(cid:16)(cid:34)(cid:33,Unknown,5625.0
Unknown,Unknown,27,Unknown,Unknown,Unknown,Unknown,cid:12)(cid:29)(cid:26)(cid:41)(cid:25)(cid:2)(cid:58)(cid:58)(cid:37)(cid:16)(cid:34)(cid:33,Unknown,5652.0
Unknown,Unknown,1,Unknown,Unknown,Unknown,Unknown,cid:12)(cid:29)(cid:26)(cid:41)(cid:25)(cid:2)(cid:58)(cid:58)(cid:37)(cid:16)(cid:34)(cid:33,Unknown,5653.0
Unknown,Unknown,1,Unknown,Unknown,Unknown,Unknown,cid:12)(cid:29)(cid:26)(cid:41)(cid:25)(cid:2)(cid:58)(cid:58)(cid:37)(cid:16)(cid:34)(cid:33,Unknown,5654.0
Unknown,Unknown,45,Unknown,Unknown,Unknown,Unknown,cid:12)(cid:29)(cid:26)(cid:41)(cid:25)(cid:2)(cid:58)(cid:58)(cid:37)(cid:16)(cid:34)(cid:33,Unknown,5699.0
Unknown,Unknown,18,Unknown,Unknown,Unknown,Unknown,cid:12)(cid:29)(cid:26)(cid:41)(cid:25)(cid:2)(cid:58)(cid:58)(cid:37)(cid:16)(cid:34)(cid:33,Unknown,5717.0
Unknown,Unknown,16,Unknown,Unknown,Unknown,Unknown,cid:12)(cid:29)(cid:26)(cid:41)(cid:25)(cid:2)(cid:58)(cid:58)(cid:37)(cid:16)(cid:34)(cid:33,Unknown,5733.0
Unknown,Unknown,38,Unknown,Unknown,Unknown,Unknown,cid:12)(cid:29)(cid:26)(cid:41)(cid:25)(cid:2)(cid:58)(cid:58)(cid:37)(cid:16)(cid:34)(cid:33,Unknown,5771.0
Unknown,Unknown,20,Unknown,Unknown,Unknown,Unknown,cid:12)(cid:29)(cid:26)(cid:41)(cid:25)(cid:2)(cid:58)(cid:58)(cid:37)(cid:16)(cid:34)(cid:33,Unknown,5791.0
Unknown,Unknown,30,Unknown,Unknown,Unknown,Unknown,cid:12)(cid:29)(cid:26)(cid:41)(cid:25)(cid:2)(cid:58)(cid:58)(cid:37)(cid:16)(cid:34)(cid:33,Unknown,5821.0
Unknown,Unknown,41,Unknown,Unknown,Unknown,Unknown,cid:12)(cid:29)(cid:26)(cid:41)(cid:25)(cid:2)(cid:58)(cid:58)(cid:37)(cid:16)(cid:34)(cid:33,Unknown,5862.0
Unknown,Unknown,20,Unknown,Unknown,Unknown,Unknown,cid:12)(cid:29)(cid:26)(cid:41)(cid:25)(cid:2)(cid:58)(cid:58)(cid:37)(cid:16)(cid:34)(cid:33,Unknown,5882.0
Unknown,Unknown,15,Unknown,Unknown,Unknown,Unknown,cid:12)(cid:29)(cid:26)(cid:41)(cid:25)(cid:2)(cid:58)(cid:58)(cid:37)(cid:16)(cid:34)(cid:33,Unknown,5897.0
Unknown,Unknown,2,Unknown,Unknown,Unknown,Unknown,cid:12)(cid:29)(cid:26)(cid:41)(cid:25)(cid:2)(cid:58)(cid:58)(cid:37)(cid:16)(cid:34)(cid:33,Unknown,5899.0
Unknown,Unknown,1,Unknown,Unknown,Unknown,Unknown,cid:12)(cid:29)(cid:26)(cid:41)(cid:25)(cid:2)(cid:58)(cid:58)(cid:37)(cid:16)(cid:34)(cid:33,Unknown,5900.0
Unknown,Unknown,19,Unknown,Unknown,Unknown,Unknown,cid:12)(cid:29)(cid:26)(cid:41)(cid:25)(cid:2)(cid:58)(cid:58)(cid:37)(cid:16)(cid:34)(cid:33,Unknown,5919.0
Unknown,Unknown,36,Unknown,Unknown,Unknown,Unknown,cid:12)(cid:29)(cid:26)(cid:41)(cid:25)(cid:2)(cid:58)(cid:58)(cid:37)(cid:16)(cid:34)(cid:33,Unknown,5955.0
Unknown,Unknown,18,Unknown,Unknown,Unknown,Unknown,cid:12)(cid:29)(cid:26)(cid:41)(cid:25)(cid:2)(cid:58)(cid:58)(cid:37)(cid:16)(cid:34)(cid:33,Unknown,5973.0
Unknown,Unknown,2,Unknown,Unknown,Unknown,Unknown,cid:12)(cid:29)(cid:26)(cid:41)(cid:25)(cid:2)(cid:58)(cid:58)(cid:37)(cid:16)(cid:34)(cid:33,Unknown,5975.0
Unknown,Unknown,44,Unknown,Unknown,Unknown,Unknown,cid:12)(cid:29)(cid:26)(cid:41)(cid:25)(cid:2)(cid:58)(cid:58)(cid:37)(cid:16)(cid:34)(cid:33,Unknown,6019.0
Unknown,Unknown,46,Unknown,Unknown,Unknown,Unknown,cid:12)(cid:29)(cid:26)(cid:41)(cid:25)(cid:2)(cid:58)(cid:58)(cid:37)(cid:16)(cid:34)(cid:33,Unknown,6065.0
Unknown,Unknown,57,Unknown,Unknown,Unknown,Unknown,cid:12)(cid:29)(cid:26)(cid:41)(cid:25)(cid:2)(cid:58)(cid:58)(cid:37)(cid:16)(cid:34)(cid:33,Unknown,6122.0
Unknown,Unknown,20,Unknown,Unknown,Unknown,Unknown,cid:12)(cid:29)(cid:26)(cid:41)(cid:25)(cid:2)(cid:58)(cid:58)(cid:37)(cid:16)(cid:34)(cid:33,Unknown,6142.0
Unknown,Unknown,30,Unknown,Unknown,Unknown,Unknown,cid:12)(cid:29)(cid:26)(cid:41)(cid:25)(cid:2)(cid:58)(cid:58)(cid:37)(cid:16)(cid:34)(cid:33,Unknown,6172.0
Unknown,Unknown,30,Unknown,Unknown,Unknown,Unknown,cid:12)(cid:29)(cid:26)(cid:41)(cid:25)(cid:2)(cid:58)(cid:58)(cid:37)(cid:16)(cid:34)(cid:33,Unknown,6202.0
Unknown,Unknown,25,Unknown,Unknown,Unknown,Unknown,cid:12)(cid:29)(cid:26)(cid:41)(cid:25)(cid:2)(cid:58)(cid:58)(cid:37)(cid:16)(cid:34)(cid:33,Unknown,6227.0
Unknown,Unknown,23,Unknown,Unknown,Unknown,Unknown,cid:12)(cid:29)(cid:26)(cid:41)(cid:25)(cid:2)(cid:58)(cid:58)(cid:37)(cid:16)(cid:34)(cid:33,Unknown,6250.0
Unknown,Unknown,25,Unknown,Unknown,Unknown,Unknown,cid:12)(cid:29)(cid:26)(cid:41)(cid:25)(cid:2)(cid:58)(cid:58)(cid:37)(cid:16)(cid:34)(cid:33,Unknown,6275.0
Unknown,Unknown,30,Unknown,Unknown,Unknown,Unknown,cid:12)(cid:29)(cid:26)(cid:41)(cid:25)(cid:2)(cid:58)(cid:58)(cid:37)(cid:16)(cid:34)(cid:33,Unknown,6305.0
Unknown,Unknown,41,Unknown,Unknown,Unknown,Unknown,cid:12)(cid:29)(cid:26)(cid:41)(cid:25)(cid:2)(cid:58)(cid:58)(cid:37)(cid:16)(cid:34)(cid:33,Unknown,6346.0
Unknown,Unknown,2,Unknown,Unknown,Unknown,Unknown,cid:12)(cid:29)(cid:26)(cid:41)(cid:25)(cid:2)(cid:58)(cid:58)(cid:37)(cid:16)(cid:34)(cid:33,Unknown,6348.0
Unknown,Unknown,45,Unknown,Unknown,Unknown,Unknown,cid:12)(cid:29)(cid:26)(cid:41)(cid:25)(cid:2)(cid:58)(cid:58)(cid:37)(cid:16)(cid:34)(cid:33,Unknown,6393.0
Unknown,Unknown,2,Unknown,Unknown,Unknown,Unknown,cid:12)(cid:29)(cid:26)(cid:41)(cid:25)(cid:2)(cid:58)(cid:58)(cid:37)(cid:16)(cid:34)(cid:33,Unknown,6395.0
Unknown,Unknown,28,Unknown,Unknown,Unknown,Unknown,cid:12)(cid:29)(cid:26)(cid:41)(cid:25)(cid:2)(cid:58)(cid:58)(cid:37)(cid:16)(cid:34)(cid:33,Unknown,6423.0
Unknown,Unknown,26,Unknown,Unknown,Unknown,Unknown,cid:12)(cid:29)(cid:26)(cid:41)(cid:25)(cid:2)(cid:58)(cid:58)(cid:37)(cid:16)(cid:34)(cid:33,Unknown,6449.0
Unknown,Unknown,29,Unknown,Unknown,Unknown,Unknown,cid:12)(cid:29)(cid:26)(cid:41)(cid:25)(cid:2)(cid:58)(cid:58)(cid:37)(cid:16)(cid:34)(cid:33,Unknown,6478.0
Unknown,Unknown,24,Unknown,Unknown,Unknown,Unknown,cid:12)(cid:29)(cid:26)(cid:41)(cid:25)(cid:2)(cid:58)(cid:58)(cid:37)(cid:16)(cid:34)(cid:33,Unknown,6502.0
Unknown,Unknown,27,Unknown,Unknown,Unknown,Unknown,cid:12)(cid:29)(cid:26)(cid:41)(cid:25)(cid:2)(cid:58)(cid:58)(cid:37)(cid:16)(cid:34)(cid:33,Unknown,6529.0
Unknown,Unknown,2,Unknown,Unknown,Unknown,Unknown,cid:12)(cid:29)(cid:26)(cid:41)(cid:25)(cid:2)(cid:58)(cid:58)(cid:37)(cid:16)(cid:34)(cid:33,Unknown,6531.0
Unknown,Unknown,29,Unknown,Unknown,Unknown,Unknown,cid:12)(cid:29)(cid:26)(cid:41)(cid:25)(cid:2)(cid:58)(cid:58)(cid:37)(cid:16)(cid:34)(cid:33,Unknown,6560.0
Unknown,Unknown,53,Unknown,Unknown,Unknown,Unknown,cid:12)(cid:29)(cid:26)(cid:41)(cid:25)(cid:2)(cid:58)(cid:58)(cid:37)(cid:16)(cid:34)(cid:33,Unknown,6613.0
Unknown,Unknown,53,Unknown,Unknown,Unknown,Unknown,cid:12)(cid:29)(cid:26)(cid:41)(cid:25)(cid:2)(cid:58)(cid:58)(cid:37)(cid:16)(cid:34)(cid:33,Unknown,6666.0
Unknown,Unknown,24,Unknown,Unknown,Unknown,Unknown,cid:12)(cid:29)(cid:26)(cid:41)(cid:25)(cid:2)(cid:58)(cid:58)(cid:37)(cid:16)(cid:34)(cid:33,Unknown,6690.0
Unknown,Unknown,41,Unknown,Unknown,Unknown,Unknown,cid:12)(cid:29)(cid:26)(cid:41)(cid:25)(cid:2)(cid:58)(cid:58)(cid:37)(cid:16)(cid:34)(cid:33,Unknown,6731.0
Unknown,Unknown,24,Unknown,Unknown,Unknown,Unknown,cid:12)(cid:29)(cid:26)(cid:41)(cid:25)(cid:2)(cid:58)(cid:58)(cid:37)(cid:16)(cid:34)(cid:33,Unknown,6755.0
Unknown,Unknown,20,Unknown,Unknown,Unknown,Unknown,cid:12)(cid:29)(cid:26)(cid:41)(cid:25)(cid:2)(cid:58)(cid:58)(cid:37)(cid:16)(cid:34)(cid:33,Unknown,6775.0
Unknown,Unknown,30,Unknown,Unknown,Unknown,Unknown,cid:12)(cid:29)(cid:26)(cid:41)(cid:25)(cid:2)(cid:58)(cid:58)(cid:37)(cid:16)(cid:34)(cid:33,Unknown,6805.0
Unknown,Unknown,30,Unknown,Unknown,Unknown,Unknown,cid:12)(cid:29)(cid:26)(cid:41)(cid:25)(cid:2)(cid:58)(cid:58)(cid:37)(cid:16)(cid:34)(cid:33,Unknown,6835.0
Unknown,Unknown,25,Unknown,Unknown,Unknown,Unknown,cid:12)(cid:29)(cid:26)(cid:41)(cid:25)(cid:2)(cid:58)(cid:58)(cid:37)(cid:16)(cid:34)(cid:33,Unknown,6860.0
Unknown,Unknown,22,Unknown,Unknown,Unknown,Unknown,cid:12)(cid:29)(cid:26)(cid:41)(cid:25)(cid:2)(cid:58)(cid:58)(cid:37)(cid:16)(cid:34)(cid:33,Unknown,6882.0
Unknown,Unknown,27,Unknown,Unknown,Unknown,Unknown,cid:12)(cid:29)(cid:26)(cid:41)(cid:25)(cid:2)(cid:58)(cid:58)(cid:37)(cid:16)(cid:34)(cid:33,Unknown,6909.0
Unknown,Unknown,1,Unknown,Unknown,Unknown,Unknown,cid:12)(cid:29)(cid:26)(cid:41)(cid:25)(cid:2)(cid:58)(cid:58)(cid:37)(cid:16)(cid:34)(cid:33,Unknown,6910.0
Unknown,Unknown,1,Unknown,Unknown,Unknown,Unknown,cid:12)(cid:29)(cid:26)(cid:41)(cid:25)(cid:2)(cid:58)(cid:58)(cid:37)(cid:16)(cid:34)(cid:33,Unknown,6911.0
Unknown,Unknown,45,Unknown,Unknown,Unknown,Unknown,cid:12)(cid:29)(cid:26)(cid:41)(cid:25)(cid:2)(cid:58)(cid:58)(cid:37)(cid:16)(cid:34)(cid:33,Unknown,6956.0
Unknown,Unknown,18,Unknown,Unknown,Unknown,Unknown,cid:12)(cid:29)(cid:26)(cid:41)(cid:25)(cid:2)(cid:58)(cid:58)(cid:37)(cid:16)(cid:34)(cid:33,Unknown,6974.0
Unknown,Unknown,16,Unknown,Unknown,Unknown,Unknown,cid:12)(cid:29)(cid:26)(cid:41)(cid:25)(cid:2)(cid:58)(cid:58)(cid:37)(cid:16)(cid:34)(cid:33,Unknown,6990.0
Unknown,Unknown,38,Unknown,Unknown,Unknown,Unknown,cid:12)(cid:29)(cid:26)(cid:41)(cid:25)(cid:2)(cid:58)(cid:58)(cid:37)(cid:16)(cid:34)(cid:33,Unknown,7028.0
Unknown,Unknown,20,Unknown,Unknown,Unknown,Unknown,cid:12)(cid:29)(cid:26)(cid:41)(cid:25)(cid:2)(cid:58)(cid:58)(cid:37)(cid:16)(cid:34)(cid:33,Unknown,7048.0
Unknown,Unknown,30,Unknown,Unknown,Unknown,Unknown,cid:12)(cid:29)(cid:26)(cid:41)(cid:25)(cid:2)(cid:58)(cid:58)(cid:37)(cid:16)(cid:34)(cid:33,Unknown,7078.0
Unknown,Unknown,41,Unknown,Unknown,Unknown,Unknown,cid:12)(cid:29)(cid:26)(cid:41)(cid:25)(cid:2)(cid:58)(cid:58)(cid:37)(cid:16)(cid:34)(cid:33,Unknown,7119.0
Unknown,Unknown,20,Unknown,Unknown,Unknown,Unknown,cid:12)(cid:29)(cid:26)(cid:41)(cid:25)(cid:2)(cid:58)(cid:58)(cid:37)(cid:16)(cid:34)(cid:33,Unknown,7139.0
Unknown,Unknown,15,Unknown,Unknown,Unknown,Unknown,cid:12)(cid:29)(cid:26)(cid:41)(cid:25)(cid:2)(cid:58)(cid:58)(cid:37)(cid:16)(cid:34)(cid:33,Unknown,7154.0
Unknown,Unknown,2,Unknown,Unknown,Unknown,Unknown,cid:12)(cid:29)(cid:26)(cid:41)(cid:25)(cid:2)(cid:58)(cid:58)(cid:37)(cid:16)(cid:34)(cid:33,Unknown,7156.0
Unknown,Unknown,1,Unknown,Unknown,Unknown,Unknown,cid:12)(cid:29)(cid:26)(cid:41)(cid:25)(cid:2)(cid:58)(cid:58)(cid:37)(cid:16)(cid:34)(cid:33,Unknown,7157.0
Unknown,Unknown,19,Unknown,Unknown,Unknown,Unknown,cid:12)(cid:29)(cid:26)(cid:41)(cid:25)(cid:2)(cid:58)(cid:58)(cid:37)(cid:16)(cid:34)(cid:33,Unknown,7176.0
Unknown,Unknown,36,Unknown,Unknown,Unknown,Unknown,cid:12)(cid:29)(cid:26)(cid:41)(cid:25)(cid:2)(cid:58)(cid:58)(cid:37)(cid:16)(cid:34)(cid:33,Unknown,7212.0
Unknown,Unknown,18,Unknown,Unknown,Unknown,Unknown,cid:12)(cid:29)(cid:26)(cid:41)(cid:25)(cid:2)(cid:58)(cid:58)(cid:37)(cid:16)(cid:34)(cid:33,Unknown,7230.0
Unknown,Unknown,2,Unknown,Unknown,Unknown,Unknown,cid:12)(cid:29)(cid:26)(cid:41)(cid:25)(cid:2)(cid:58)(cid:58)(cid:37)(cid:16)(cid:34)(cid:33,Unknown,7232.0
Unknown,Unknown,44,Unknown,Unknown,Unknown,Unknown,cid:12)(cid:29)(cid:26)(cid:41)(cid:25)(cid:2)(cid:58)(cid:58)(cid:37)(cid:16)(cid:34)(cid:33,Unknown,7276.0
Unknown,Unknown,46,Unknown,Unknown,Unknown,Unknown,cid:12)(cid:29)(cid:26)(cid:41)(cid:25)(cid:2)(cid:58)(cid:58)(cid:37)(cid:16)(cid:34)(cid:33,Unknown,7322.0
Unknown,Unknown,57,Unknown,Unknown,Unknown,Unknown,cid:12)(cid:29)(cid:26)(cid:41)(cid:25)(cid:2)(cid:58)(cid:58)(cid:37)(cid:16)(cid:34)(cid:33,Unknown,7379.0
Unknown,Unknown,20,Unknown,Unknown,Unknown,Unknown,cid:12)(cid:29)(cid:26)(cid:41)(cid:25)(cid:2)(cid:58)(cid:58)(cid:37)(cid:16)(cid:34)(cid:33,Unknown,7399.0
Unknown,Unknown,30,Unknown,Unknown,Unknown,Unknown,cid:12)(cid:29)(cid:26)(cid:41)(cid:25)(cid:2)(cid:58)(cid:58)(cid:37)(cid:16)(cid:34)(cid:33,Unknown,7429.0
Unknown,Unknown,30,Unknown,Unknown,Unknown,Unknown,cid:12)(cid:29)(cid:26)(cid:41)(cid:25)(cid:2)(cid:58)(cid:58)(cid:37)(cid:16)(cid:34)(cid:33,Unknown,7459.0
Unknown,Unknown,25,Unknown,Unknown,Unknown,Unknown,cid:12)(cid:29)(cid:26)(cid:41)(cid:25)(cid:2)(cid:58)(cid:58)(cid:37)(cid:16)(cid:34)(cid:33,Unknown,7484.0
Unknown,Unknown,23,Unknown,Unknown,Unknown,Unknown,cid:12)(cid:29)(cid:26)(cid:41)(cid:25)(cid:2)(cid:58)(cid:58)(cid:37)(cid:16)(cid:34)(cid:33,Unknown,7507.0
Unknown,Unknown,25,Unknown,Unknown,Unknown,Unknown,cid:12)(cid:29)(cid:26)(cid:41)(cid:25)(cid:2)(cid:58)(cid:58)(cid:37)(cid:16)(cid:34)(cid:33,Unknown,7532.0
Unknown,Unknown,30,Unknown,Unknown,Unknown,Unknown,cid:12)(cid:29)(cid:26)(cid:41)(cid:25)(cid:2)(cid:58)(cid:58)(cid:37)(cid:16)(cid:34)(cid:33,Unknown,7562.0
Unknown,Unknown,41,Unknown,Unknown,Unknown,Unknown,cid:12)(cid:29)(cid:26)(cid:41)(cid:25)(cid:2)(cid:58)(cid:58)(cid:37)(cid:16)(cid:34)(cid:33,Unknown,7603.0
Unknown,Unknown,2,Unknown,Unknown,Unknown,Unknown,cid:12)(cid:29)(cid:26)(cid:41)(cid:25)(cid:2)(cid:58)(cid:58)(cid:37)(cid:16)(cid:34)(cid:33,Unknown,7605.0
Unknown,Unknown,45,Unknown,Unknown,Unknown,Unknown,cid:12)(cid:29)(cid:26)(cid:41)(cid:25)(cid:2)(cid:58)(cid:58)(cid:37)(cid:16)(cid:34)(cid:33,Unknown,7650.0
Unknown,Unknown,2,Unknown,Unknown,Unknown,Unknown,cid:12)(cid:29)(cid:26)(cid:41)(cid:25)(cid:2)(cid:58)(cid:58)(cid:37)(cid:16)(cid:34)(cid:33,Unknown,7652.0
Unknown,Unknown,28,Unknown,Unknown,Unknown,Unknown,cid:12)(cid:29)(cid:26)(cid:41)(cid:25)(cid:2)(cid:58)(cid:58)(cid:37)(cid:16)(cid:34)(cid:33,Unknown,7680.0
Unknown,Unknown,26,Unknown,Unknown,Unknown,Unknown,cid:12)(cid:29)(cid:26)(cid:41)(cid:25)(cid:2)(cid:58)(cid:58)(cid:37)(cid:16)(cid:34)(cid:33,Unknown,7706.0
Unknown,Unknown,29,Unknown,Unknown,Unknown,Unknown,cid:12)(cid:29)(cid:26)(cid:41)(cid:25)(cid:2)(cid:58)(cid:58)(cid:37)(cid:16)(cid:34)(cid:33,Unknown,7735.0
Unknown,Unknown,24,Unknown,Unknown,Unknown,Unknown,cid:12)(cid:29)(cid:26)(cid:41)(cid:25)(cid:2)(cid:58)(cid:58)(cid:37)(cid:16)(cid:34)(cid:33,Unknown,7759.0
Unknown,Unknown,27,Unknown,Unknown,Unknown,Unknown,cid:12)(cid:29)(cid:26)(cid:41)(cid:25)(cid:2)(cid:58)(cid:58)(cid:37)(cid:16)(cid:34)(cid:33,Unknown,7786.0
Unknown,Unknown,2,Unknown,Unknown,Unknown,Unknown,cid:12)(cid:29)(cid:26)(cid:41)(cid:25)(cid:2)(cid:58)(cid:58)(cid:37)(cid:16)(cid:34)(cid:33,Unknown,7788.0
Unknown,Unknown,29,Unknown,Unknown,Unknown,Unknown,cid:12)(cid:29)(cid:26)(cid:41)(cid:25)(cid:2)(cid:58)(cid:58)(cid:37)(cid:16)(cid:34)(cid:33,Unknown,7817.0
Unknown,Unknown,53,Unknown,Unknown,Unknown,Unknown,cid:12)(cid:29)(cid:26)(cid:41)(cid:25)(cid:2)(cid:58)(cid:58)(cid:37)(cid:16)(cid:34)(cid:33,Unknown,7870.0
Unknown,Unknown,53,Unknown,Unknown,Unknown,Unknown,cid:12)(cid:29)(cid:26)(cid:41)(cid:25)(cid:2)(cid:58)(cid:58)(cid:37)(cid:16)(cid:34)(cid:33,Unknown,7923.0
Unknown,Unknown,24,Unknown,Unknown,Unknown,Unknown,cid:12)(cid:29)(cid:26)(cid:41)(cid:25)(cid:2)(cid:58)(cid:58)(cid:37)(cid:16)(cid:34)(cid:33,Unknown,7947.0
Unknown,Unknown,41,Unknown,Unknown,Unknown,Unknown,cid:12)(cid:29)(cid:26)(cid:41)(cid:25)(cid:2)(cid:58)(cid:58)(cid:37)(cid:16)(cid:34)(cid:33,Unknown,7988.0
Unknown,Unknown,24,Unknown,Unknown,Unknown,Unknown,cid:12)(cid:29)(cid:26)(cid:41)(cid:25)(cid:2)(cid:58)(cid:58)(cid:37)(cid:16)(cid:34)(cid:33,Unknown,8012.0
Unknown,Unknown,20,Unknown,Unknown,Unknown,Unknown,cid:12)(cid:29)(cid:26)(cid:41)(cid:25)(cid:2)(cid:58)(cid:58)(cid:37)(cid:16)(cid:34)(cid:33,Unknown,8032.0
Unknown,Unknown,30,Unknown,Unknown,Unknown,Unknown,cid:12)(cid:29)(cid:26)(cid:41)(cid:25)(cid:2)(cid:58)(cid:58)(cid:37)(cid:16)(cid:34)(cid:33,Unknown,8062.0
Unknown,Unknown,30,Unknown,Unknown,Unknown,Unknown,cid:12)(cid:29)(cid:26)(cid:41)(cid:25)(cid:2)(cid:58)(cid:58)(cid:37)(cid:16)(cid:34)(cid:33,Unknown,8092.0
Unknown,Unknown,25,Unknown,Unknown,Unknown,Unknown,cid:12)(cid:29)(cid:26)(cid:41)(cid:25)(cid:2)(cid:58)(cid:58)(cid:37)(cid:16)(cid:34)(cid:33,Unknown,8117.0
Unknown,Unknown,22,Unknown,Unknown,Unknown,Unknown,cid:12)(cid:29)(cid:26)(cid:41)(cid:25)(cid:2)(cid:58)(cid:58)(cid:37)(cid:16)(cid:34)(cid:33,Unknown,8139.0
Unknown,Unknown,27,Unknown,Unknown,Unknown,Unknown,cid:12)(cid:29)(cid:26)(cid:41)(cid:25)(cid:2)(cid:58)(cid:58)(cid:37)(cid:16)(cid:34)(cid:33,Unknown,8166.0
Unknown,Unknown,1,Unknown,Unknown,Unknown,Unknown,cid:12)(cid:29)(cid:26)(cid:41)(cid:25)(cid:2)(cid:58)(cid:58)(cid:37)(cid:16)(cid:34)(cid:33,Unknown,8167.0
Unknown,Unknown,37,Unknown,Unknown,Unknown,Unknown,cid:12)(cid:29)(cid:26)(cid:41)(cid:25)(cid:2)(cid:58)(cid:58)(cid:37)(cid:16)(cid:34)(cid:33,Unknown,8204.0
Unknown,Unknown,45,Unknown,Unknown,Unknown,Unknown,cid:12)(cid:29)(cid:26)(cid:41)(cid:25)(cid:2)(cid:58)(cid:58)(cid:37)(cid:16)(cid:34)(cid:33,Unknown,8249.0
Unknown,Unknown,18,Unknown,Unknown,Unknown,Unknown,cid:12)(cid:29)(cid:26)(cid:41)(cid:25)(cid:2)(cid:58)(cid:58)(cid:37)(cid:16)(cid:34)(cid:33,Unknown,8267.0
Unknown,Unknown,16,Unknown,Unknown,Unknown,Unknown,cid:12)(cid:29)(cid:26)(cid:41)(cid:25)(cid:2)(cid:58)(cid:58)(cid:37)(cid:16)(cid:34)(cid:33,Unknown,8283.0
Unknown,Unknown,7,Unknown,Unknown,Unknown,Unknown,cid:12)(cid:29)(cid:26)(cid:41)(cid:25)(cid:2)(cid:58)(cid:58)(cid:37)(cid:16)(cid:34)(cid:33,Unknown,8290.0
Unknown,Unknown,8,Unknown,Unknown,Unknown,Unknown,cid:12)(cid:29)(cid:26)(cid:41)(cid:25)(cid:2)(cid:58)(cid:58)(cid:37)(cid:16)(cid:34)(cid:33,Unknown,8298.0
Unknown,Unknown,28,Unknown,Unknown,Unknown,Unknown,cid:12)(cid:29)(cid:26)(cid:41)(cid:25)(cid:2)(cid:58)(cid:58)(cid:37)(cid:16)(cid:34)(cid:33,Unknown,8326.0
Unknown,Unknown,11,Unknown,Unknown,Unknown,Unknown,cid:12)(cid:29)(cid:26)(cid:41)(cid:25)(cid:2)(cid:58)(cid:58)(cid:37)(cid:16)(cid:34)(cid:33,Unknown,8337.0
Unknown,Unknown,64,Unknown,Unknown,Unknown,Unknown,cid:12)(cid:29)(cid:26)(cid:41)(cid:25)(cid:2)(cid:58)(cid:58)(cid:37)(cid:16)(cid:34)(cid:33,Unknown,8401.0
Unknown,Unknown,3,Unknown,Unknown,Unknown,Unknown,cid:12)(cid:29)(cid:26)(cid:41)(cid:25)(cid:2)(cid:58)(cid:58)(cid:37)(cid:16)(cid:34)(cid:33,Unknown,8404.0
Unknown,Unknown,5,Unknown,Unknown,Unknown,Unknown,cid:12)(cid:29)(cid:26)(cid:41)(cid:25)(cid:2)(cid:58)(cid:58)(cid:37)(cid:16)(cid:34)(cid:33,Unknown,8409.0
Unknown,Unknown,28,Unknown,Unknown,Unknown,Unknown,cid:12)(cid:29)(cid:26)(cid:41)(cid:25)(cid:2)(cid:58)(cid:58)(cid:37)(cid:16)(cid:34)(cid:33,Unknown,8437.0
Unknown,Unknown,28,Unknown,Unknown,Unknown,Unknown,cid:12)(cid:29)(cid:26)(cid:41)(cid:25)(cid:2)(cid:58)(cid:58)(cid:37)(cid:16)(cid:34)(cid:33,Unknown,8465.0
Unknown,Unknown,5,Unknown,Unknown,Unknown,Unknown,cid:12)(cid:29)(cid:26)(cid:41)(cid:25)(cid:2)(cid:58)(cid:58)(cid:37)(cid:16)(cid:34)(cid:33,Unknown,8470.0
Unknown,Unknown,2,Unknown,Unknown,Unknown,Unknown,cid:12)(cid:29)(cid:26)(cid:41)(cid:25)(cid:2)(cid:58)(cid:58)(cid:37)(cid:16)(cid:34)(cid:33,Unknown,8472.0
Unknown,Unknown,12,Unknown,Unknown,Unknown,Unknown,cid:12)(cid:29)(cid:26)(cid:41)(cid:25)(cid:2)(cid:58)(cid:58)(cid:37)(cid:16)(cid:34)(cid:33,Unknown,8484.0
Unknown,Unknown,47,Unknown,Unknown,Unknown,Unknown,cid:12)(cid:29)(cid:26)(cid:41)(cid:25)(cid:2)(cid:58)(cid:58)(cid:37)(cid:16)(cid:34)(cid:33,Unknown,8531.0
Unknown,Unknown,2,Unknown,Unknown,Unknown,Unknown,cid:12)(cid:29)(cid:26)(cid:41)(cid:25)(cid:2)(cid:58)(cid:58)(cid:37)(cid:16)(cid:34)(cid:33,Unknown,8533.0
Unknown,Unknown,66,Unknown,Unknown,Unknown,Unknown,cid:12)(cid:29)(cid:26)(cid:41)(cid:25)(cid:2)(cid:58)(cid:58)(cid:37)(cid:16)(cid:34)(cid:33,Unknown,8599.0
Unknown,Unknown,7,Unknown,Unknown,Unknown,Unknown,cid:12)(cid:29)(cid:26)(cid:41)(cid:25)(cid:2)(cid:58)(cid:58)(cid:37)(cid:16)(cid:34)(cid:33,Unknown,8606.0
Unknown,Unknown,8,Unknown,Unknown,Unknown,Unknown,cid:12)(cid:29)(cid:26)(cid:41)(cid:25)(cid:2)(cid:58)(cid:58)(cid:37)(cid:16)(cid:34)(cid:33,Unknown,8614.0
Unknown,Unknown,12,Unknown,Unknown,Unknown,Unknown,cid:12)(cid:29)(cid:26)(cid:41)(cid:25)(cid:2)(cid:58)(cid:58)(cid:37)(cid:16)(cid:34)(cid:33,Unknown,8626.0
Unknown,Unknown,5,Unknown,Unknown,Unknown,Unknown,cid:12)(cid:29)(cid:26)(cid:41)(cid:25)(cid:2)(cid:58)(cid:58)(cid:37)(cid:16)(cid:34)(cid:33,Unknown,8631.0
Unknown,Unknown,8,Unknown,Unknown,Unknown,Unknown,cid:12)(cid:29)(cid:26)(cid:41)(cid:25)(cid:2)(cid:58)(cid:58)(cid:37)(cid:16)(cid:34)(cid:33,Unknown,8639.0
Unknown,Unknown,8,Unknown,Unknown,Unknown,Unknown,cid:12)(cid:29)(cid:26)(cid:41)(cid:25)(cid:2)(cid:58)(cid:58)(cid:37)(cid:16)(cid:34)(cid:33,Unknown,8647.0
Unknown,Unknown,5,Unknown,Unknown,Unknown,Unknown,cid:12)(cid:29)(cid:26)(cid:41)(cid:25)(cid:2)(cid:58)(cid:58)(cid:37)(cid:16)(cid:34)(cid:33,Unknown,8652.0
Unknown,Unknown,9,Unknown,Unknown,Unknown,Unknown,cid:12)(cid:29)(cid:26)(cid:41)(cid:25)(cid:2)(cid:58)(cid:58)(cid:37)(cid:16)(cid:34)(cid:33,Unknown,8661.0
Unknown,Unknown,2,Unknown,Unknown,Unknown,Unknown,cid:12)(cid:29)(cid:26)(cid:41)(cid:25)(cid:2)(cid:58)(cid:58)(cid:37)(cid:16)(cid:34)(cid:33,Unknown,8663.0
Unknown,Unknown,28,Unknown,Unknown,Unknown,Unknown,cid:12)(cid:29)(cid:26)(cid:41)(cid:25)(cid:2)(cid:58)(cid:58)(cid:37)(cid:16)(cid:34)(cid:33,Unknown,8691.0
Unknown,Unknown,3,Unknown,Unknown,Unknown,Unknown,cid:12)(cid:29)(cid:26)(cid:41)(cid:25)(cid:2)(cid:58)(cid:58)(cid:37)(cid:16)(cid:34)(cid:33,Unknown,8694.0
Unknown,Unknown,15,Unknown,Unknown,Unknown,Unknown,cid:12)(cid:29)(cid:26)(cid:41)(cid:25)(cid:2)(cid:58)(cid:58)(cid:37)(cid:16)(cid:34)(cid:33,Unknown,8709.0
Unknown,Unknown,2,Unknown,Unknown,Unknown,Unknown,cid:12)(cid:29)(cid:26)(cid:41)(cid:25)(cid:2)(cid:58)(cid:58)(cid:37)(cid:16)(cid:34)(cid:33,Unknown,8711.0
Unknown,Unknown,37,Unknown,Unknown,Unknown,Unknown,cid:12)(cid:29)(cid:26)(cid:41)(cid:25)(cid:2)(cid:58)(cid:58)(cid:37)(cid:16)(cid:34)(cid:33,Unknown,8748.0
Unknown,Unknown,19,Unknown,Unknown,Unknown,Unknown,cid:12)(cid:29)(cid:26)(cid:41)(cid:25)(cid:2)(cid:58)(cid:58)(cid:37)(cid:16)(cid:34)(cid:33,Unknown,8767.0
Unknown,Unknown,37,Unknown,Unknown,Unknown,Unknown,cid:12)(cid:29)(cid:26)(cid:41)(cid:25)(cid:2)(cid:58)(cid:58)(cid:37)(cid:16)(cid:34)(cid:33,Unknown,8804.0
Unknown,Unknown,16,Unknown,Unknown,Unknown,Unknown,cid:12)(cid:29)(cid:26)(cid:41)(cid:25)(cid:2)(cid:58)(cid:58)(cid:37)(cid:16)(cid:34)(cid:33,Unknown,8820.0
Unknown,Unknown,2,Unknown,Unknown,Unknown,Unknown,cid:12)(cid:29)(cid:26)(cid:41)(cid:25)(cid:2)(cid:58)(cid:58)(cid:37)(cid:16)(cid:34)(cid:33,Unknown,8822.0
Unknown,Unknown,44,Unknown,Unknown,Unknown,Unknown,cid:12)(cid:29)(cid:26)(cid:41)(cid:25)(cid:2)(cid:58)(cid:58)(cid:37)(cid:16)(cid:34)(cid:33,Unknown,8866.0
Unknown,Unknown,12,Unknown,Unknown,Unknown,Unknown,cid:12)(cid:29)(cid:26)(cid:41)(cid:25)(cid:2)(cid:58)(cid:58)(cid:37)(cid:16)(cid:34)(cid:33,Unknown,8878.0
Unknown,Unknown,29,Unknown,Unknown,Unknown,Unknown,cid:12)(cid:29)(cid:26)(cid:41)(cid:25)(cid:2)(cid:58)(cid:58)(cid:37)(cid:16)(cid:34)(cid:33,Unknown,8907.0
Unknown,Unknown,26,Unknown,Unknown,Unknown,Unknown,cid:12)(cid:29)(cid:26)(cid:41)(cid:25)(cid:2)(cid:58)(cid:58)(cid:37)(cid:16)(cid:34)(cid:33,Unknown,8933.0
Unknown,Unknown,41,Unknown,Unknown,Unknown,Unknown,cid:12)(cid:29)(cid:26)(cid:41)(cid:25)(cid:2)(cid:58)(cid:58)(cid:37)(cid:16)(cid:34)(cid:33,Unknown,8974.0
Unknown,Unknown,25,Unknown,Unknown,Unknown,Unknown,cid:12)(cid:29)(cid:26)(cid:41)(cid:25)(cid:2)(cid:58)(cid:58)(cid:37)(cid:16)(cid:34)(cid:33,Unknown,8999.0
Unknown,Unknown,2,Unknown,Unknown,Unknown,Unknown,cid:12)(cid:29)(cid:26)(cid:41)(cid:25)(cid:2)(cid:58)(cid:58)(cid:37)(cid:16)(cid:34)(cid:33,Unknown,9001.0
Unknown,Unknown,58,Unknown,Unknown,Unknown,Unknown,cid:12)(cid:29)(cid:26)(cid:41)(cid:25)(cid:2)(cid:58)(cid:58)(cid:37)(cid:16)(cid:34)(cid:33,Unknown,9059.0
Unknown,Unknown,58,Unknown,Unknown,Unknown,Unknown,cid:12)(cid:29)(cid:26)(cid:41)(cid:25)(cid:2)(cid:58)(cid:58)(cid:37)(cid:16)(cid:34)(cid:33,Unknown,9117.0
Unknown,Unknown,37,Unknown,Unknown,Unknown,Unknown,cid:12)(cid:29)(cid:26)(cid:41)(cid:25)(cid:2)(cid:58)(cid:58)(cid:37)(cid:16)(cid:34)(cid:33,Unknown,9154.0
Unknown,Unknown,16,Unknown,Unknown,Unknown,Unknown,cid:12)(cid:29)(cid:26)(cid:41)(cid:25)(cid:2)(cid:58)(cid:58)(cid:37)(cid:16)(cid:34)(cid:33,Unknown,9170.0
Unknown,Unknown,34,Unknown,Unknown,Unknown,Unknown,cid:12)(cid:29)(cid:26)(cid:41)(cid:25)(cid:2)(cid:58)(cid:58)(cid:37)(cid:16)(cid:34)(cid:33,Unknown,9204.0
Unknown,Unknown,33,Unknown,Unknown,Unknown,Unknown,cid:12)(cid:29)(cid:26)(cid:41)(cid:25)(cid:2)(cid:58)(cid:58)(cid:37)(cid:16)(cid:34)(cid:33,Unknown,9237.0
Unknown,Unknown,1,Unknown,Unknown,Unknown,Unknown,cid:12)(cid:29)(cid:26)(cid:41)(cid:25)(cid:2)(cid:58)(cid:58)(cid:37)(cid:16)(cid:34)(cid:33,Unknown,9238.0
Unknown,Unknown,37,Unknown,Unknown,Unknown,Unknown,cid:12)(cid:29)(cid:26)(cid:41)(cid:25)(cid:2)(cid:58)(cid:58)(cid:37)(cid:16)(cid:34)(cid:33,Unknown,9275.0
Unknown,Unknown,45,Unknown,Unknown,Unknown,Unknown,cid:12)(cid:29)(cid:26)(cid:41)(cid:25)(cid:2)(cid:58)(cid:58)(cid:37)(cid:16)(cid:34)(cid:33,Unknown,9320.0
Unknown,Unknown,18,Unknown,Unknown,Unknown,Unknown,cid:12)(cid:29)(cid:26)(cid:41)(cid:25)(cid:2)(cid:58)(cid:58)(cid:37)(cid:16)(cid:34)(cid:33,Unknown,9338.0
Unknown,Unknown,16,Unknown,Unknown,Unknown,Unknown,cid:12)(cid:29)(cid:26)(cid:41)(cid:25)(cid:2)(cid:58)(cid:58)(cid:37)(cid:16)(cid:34)(cid:33,Unknown,9354.0
Unknown,Unknown,71,Unknown,Unknown,Unknown,Unknown,cid:12)(cid:29)(cid:26)(cid:41)(cid:25)(cid:2)(cid:58)(cid:58)(cid:37)(cid:16)(cid:34)(cid:33,Unknown,9425.0
Unknown,Unknown,29,Unknown,Unknown,Unknown,Unknown,cid:12)(cid:29)(cid:26)(cid:41)(cid:25)(cid:2)(cid:58)(cid:58)(cid:37)(cid:16)(cid:34)(cid:33,Unknown,9454.0
Unknown,Unknown,22,Unknown,Unknown,Unknown,Unknown,cid:12)(cid:29)(cid:26)(cid:41)(cid:25)(cid:2)(cid:58)(cid:58)(cid:37)(cid:16)(cid:34)(cid:33,Unknown,9476.0
Unknown,Unknown,29,Unknown,Unknown,Unknown,Unknown,cid:12)(cid:29)(cid:26)(cid:41)(cid:25)(cid:2)(cid:58)(cid:58)(cid:37)(cid:16)(cid:34)(cid:33,Unknown,9505.0
Unknown,Unknown,30,Unknown,Unknown,Unknown,Unknown,cid:12)(cid:29)(cid:26)(cid:41)(cid:25)(cid:2)(cid:58)(cid:58)(cid:37)(cid:16)(cid:34)(cid:33,Unknown,9535.0
Unknown,Unknown,53,Unknown,Unknown,Unknown,Unknown,cid:12)(cid:29)(cid:26)(cid:41)(cid:25)(cid:2)(cid:58)(cid:58)(cid:37)(cid:16)(cid:34)(cid:33,Unknown,9588.0
Unknown,Unknown,20,Unknown,Unknown,Unknown,Unknown,cid:12)(cid:29)(cid:26)(cid:41)(cid:25)(cid:2)(cid:58)(cid:58)(cid:37)(cid:16)(cid:34)(cid:33,Unknown,9608.0
Unknown,Unknown,2,Unknown,Unknown,Unknown,Unknown,cid:12)(cid:29)(cid:26)(cid:41)(cid:25)(cid:2)(cid:58)(cid:58)(cid:37)(cid:16)(cid:34)(cid:33,Unknown,9610.0
Unknown,Unknown,39,Unknown,Unknown,Unknown,Unknown,cid:12)(cid:29)(cid:26)(cid:41)(cid:25)(cid:2)(cid:58)(cid:58)(cid:37)(cid:16)(cid:34)(cid:33,Unknown,9649.0
Unknown,Unknown,29,Unknown,Unknown,Unknown,Unknown,cid:12)(cid:29)(cid:26)(cid:41)(cid:25)(cid:2)(cid:58)(cid:58)(cid:37)(cid:16)(cid:34)(cid:33,Unknown,9678.0
Unknown,Unknown,59,Unknown,Unknown,Unknown,Unknown,cid:12)(cid:29)(cid:26)(cid:41)(cid:25)(cid:2)(cid:58)(cid:58)(cid:37)(cid:16)(cid:34)(cid:33,Unknown,9737.0
Unknown,Unknown,23,Unknown,Unknown,Unknown,Unknown,cid:12)(cid:29)(cid:26)(cid:41)(cid:25)(cid:2)(cid:58)(cid:58)(cid:37)(cid:16)(cid:34)(cid:33,Unknown,9760.0
Unknown,Unknown,25,Unknown,Unknown,Unknown,Unknown,cid:12)(cid:29)(cid:26)(cid:41)(cid:25)(cid:2)(cid:58)(cid:58)(cid:37)(cid:16)(cid:34)(cid:33,Unknown,9785.0
Unknown,Unknown,30,Unknown,Unknown,Unknown,Unknown,cid:12)(cid:29)(cid:26)(cid:41)(cid:25)(cid:2)(cid:58)(cid:58)(cid:37)(cid:16)(cid:34)(cid:33,Unknown,9815.0
Unknown,Unknown,41,Unknown,Unknown,Unknown,Unknown,cid:12)(cid:29)(cid:26)(cid:41)(cid:25)(cid:2)(cid:58)(cid:58)(cid:37)(cid:16)(cid:34)(cid:33,Unknown,9856.0
Unknown,Unknown,27,Unknown,Unknown,Unknown,Unknown,cid:12)(cid:29)(cid:26)(cid:41)(cid:25)(cid:2)(cid:58)(cid:58)(cid:37)(cid:16)(cid:34)(cid:33,Unknown,9883.0
Unknown,Unknown,2,Unknown,Unknown,Unknown,Unknown,cid:12)(cid:29)(cid:26)(cid:41)(cid:25)(cid:2)(cid:58)(cid:58)(cid:37)(cid:16)(cid:34)(cid:33,Unknown,9885.0
Unknown,Unknown,47,Unknown,Unknown,Unknown,Unknown,cid:12)(cid:29)(cid:26)(cid:41)(cid:25)(cid:2)(cid:58)(cid:58)(cid:37)(cid:16)(cid:34)(cid:33,Unknown,9932.0
Unknown,Unknown,25,Unknown,Unknown,Unknown,Unknown,cid:12)(cid:29)(cid:26)(cid:41)(cid:25)(cid:2)(cid:58)(cid:58)(cid:37)(cid:16)(cid:34)(cid:33,Unknown,9957.0
Unknown,Unknown,26,Unknown,Unknown,Unknown,Unknown,cid:12)(cid:29)(cid:26)(cid:41)(cid:25)(cid:2)(cid:58)(cid:58)(cid:37)(cid:16)(cid:34)(cid:33,Unknown,9983.0
Unknown,Unknown,22,Unknown,Unknown,Unknown,Unknown,cid:12)(cid:29)(cid:26)(cid:41)(cid:25)(cid:2)(cid:58)(cid:58)(cid:37)(cid:16)(cid:34)(cid:33,Unknown,10005.0
Unknown,Unknown,24,Unknown,Unknown,Unknown,Unknown,cid:12)(cid:29)(cid:26)(cid:41)(cid:25)(cid:2)(cid:58)(cid:58)(cid:37)(cid:16)(cid:34)(cid:33,Unknown,10029.0
Unknown,Unknown,30,Unknown,Unknown,Unknown,Unknown,cid:12)(cid:29)(cid:26)(cid:41)(cid:25)(cid:2)(cid:58)(cid:58)(cid:37)(cid:16)(cid:34)(cid:33,Unknown,10059.0
Unknown,Unknown,2,Unknown,Unknown,Unknown,Unknown,cid:12)(cid:29)(cid:26)(cid:41)(cid:25)(cid:2)(cid:58)(cid:58)(cid:37)(cid:16)(cid:34)(cid:33,Unknown,10061.0
Unknown,Unknown,50,Unknown,Unknown,Unknown,Unknown,cid:12)(cid:29)(cid:26)(cid:41)(cid:25)(cid:2)(cid:58)(cid:58)(cid:37)(cid:16)(cid:34)(cid:33,Unknown,10111.0
Unknown,Unknown,5,Unknown,Unknown,Unknown,Unknown,cid:12)(cid:29)(cid:26)(cid:41)(cid:25)(cid:2)(cid:58)(cid:58)(cid:37)(cid:16)(cid:34)(cid:33,Unknown,10116.0
Unknown,Unknown,15,Unknown,Unknown,Unknown,Unknown,cid:12)(cid:29)(cid:26)(cid:41)(cid:25)(cid:2)(cid:58)(cid:58)(cid:37)(cid:16)(cid:34)(cid:33,Unknown,10131.0
Unknown,Unknown,2,Unknown,Unknown,Unknown,Unknown,cid:12)(cid:29)(cid:26)(cid:41)(cid:25)(cid:2)(cid:58)(cid:58)(cid:37)(cid:16)(cid:34)(cid:33,Unknown,10133.0
Unknown,Unknown,32,Unknown,Unknown,Unknown,Unknown,cid:12)(cid:29)(cid:26)(cid:41)(cid:25)(cid:2)(cid:58)(cid:58)(cid:37)(cid:16)(cid:34)(cid:33,Unknown,10165.0
Unknown,Unknown,36,Unknown,Unknown,Unknown,Unknown,cid:12)(cid:29)(cid:26)(cid:41)(cid:25)(cid:2)(cid:58)(cid:58)(cid:37)(cid:16)(cid:34)(cid:33,Unknown,10201.0
Unknown,Unknown,19,Unknown,Unknown,Unknown,Unknown,cid:12)(cid:29)(cid:26)(cid:41)(cid:25)(cid:2)(cid:58)(cid:58)(cid:37)(cid:16)(cid:34)(cid:33,Unknown,10220.0
Unknown,Unknown,33,Unknown,Unknown,Unknown,Unknown,cid:12)(cid:29)(cid:26)(cid:41)(cid:25)(cid:2)(cid:58)(cid:58)(cid:37)(cid:16)(cid:34)(cid:33,Unknown,10253.0
Unknown,Unknown,34,Unknown,Unknown,Unknown,Unknown,cid:12)(cid:29)(cid:26)(cid:41)(cid:25)(cid:2)(cid:58)(cid:58)(cid:37)(cid:16)(cid:34)(cid:33,Unknown,10287.0
Unknown,Unknown,2,Unknown,Unknown,Unknown,Unknown,cid:12)(cid:29)(cid:26)(cid:41)(cid:25)(cid:2)(cid:58)(cid:58)(cid:37)(cid:16)(cid:34)(cid:33,Unknown,10289.0
Unknown,Unknown,44,Unknown,Unknown,Unknown,Unknown,cid:12)(cid:29)(cid:26)(cid:41)(cid:25)(cid:2)(cid:58)(cid:58)(cid:37)(cid:16)(cid:34)(cid:33,Unknown,10333.0
Unknown,Unknown,12,Unknown,Unknown,Unknown,Unknown,cid:12)(cid:29)(cid:26)(cid:41)(cid:25)(cid:2)(cid:58)(cid:58)(cid:37)(cid:16)(cid:34)(cid:33,Unknown,10345.0
Unknown,Unknown,29,Unknown,Unknown,Unknown,Unknown,cid:12)(cid:29)(cid:26)(cid:41)(cid:25)(cid:2)(cid:58)(cid:58)(cid:37)(cid:16)(cid:34)(cid:33,Unknown,10374.0
Unknown,Unknown,26,Unknown,Unknown,Unknown,Unknown,cid:12)(cid:29)(cid:26)(cid:41)(cid:25)(cid:2)(cid:58)(cid:58)(cid:37)(cid:16)(cid:34)(cid:33,Unknown,10400.0
Unknown,Unknown,41,Unknown,Unknown,Unknown,Unknown,cid:12)(cid:29)(cid:26)(cid:41)(cid:25)(cid:2)(cid:58)(cid:58)(cid:37)(cid:16)(cid:34)(cid:33,Unknown,10441.0
Unknown,Unknown,25,Unknown,Unknown,Unknown,Unknown,cid:12)(cid:29)(cid:26)(cid:41)(cid:25)(cid:2)(cid:58)(cid:58)(cid:37)(cid:16)(cid:34)(cid:33,Unknown,10466.0
Unknown,Unknown,2,Unknown,Unknown,Unknown,Unknown,cid:12)(cid:29)(cid:26)(cid:41)(cid:25)(cid:2)(cid:58)(cid:58)(cid:37)(cid:16)(cid:34)(cid:33,Unknown,10468.0
Unknown,Unknown,58,Unknown,Unknown,Unknown,Unknown,cid:12)(cid:29)(cid:26)(cid:41)(cid:25)(cid:2)(cid:58)(cid:58)(cid:37)(cid:16)(cid:34)(cid:33,Unknown,10526.0
Unknown,Unknown,58,Unknown,Unknown,Unknown,Unknown,cid:12)(cid:29)(cid:26)(cid:41)(cid:25)(cid:2)(cid:58)(cid:58)(cid:37)(cid:16)(cid:34)(cid:33,Unknown,10584.0
Unknown,Unknown,37,Unknown,Unknown,Unknown,Unknown,cid:12)(cid:29)(cid:26)(cid:41)(cid:25)(cid:2)(cid:58)(cid:58)(cid:37)(cid:16)(cid:34)(cid:33,Unknown,10621.0
Unknown,Unknown,16,Unknown,Unknown,Unknown,Unknown,cid:12)(cid:29)(cid:26)(cid:41)(cid:25)(cid:2)(cid:58)(cid:58)(cid:37)(cid:16)(cid:34)(cid:33,Unknown,10637.0
Unknown,Unknown,34,Unknown,Unknown,Unknown,Unknown,cid:12)(cid:29)(cid:26)(cid:41)(cid:25)(cid:2)(cid:58)(cid:58)(cid:37)(cid:16)(cid:34)(cid:33,Unknown,10671.0
Unknown,Unknown,33,Unknown,Unknown,Unknown,Unknown,cid:12)(cid:29)(cid:26)(cid:41)(cid:25)(cid:2)(cid:58)(cid:58)(cid:37)(cid:16)(cid:34)(cid:33,Unknown,10704.0
Unknown,Unknown,1,Unknown,Unknown,Unknown,Unknown,cid:12)(cid:29)(cid:26)(cid:41)(cid:25)(cid:2)(cid:58)(cid:58)(cid:37)(cid:16)(cid:34)(cid:33,Unknown,10705.0
Unknown,Unknown,37,Unknown,Unknown,Unknown,Unknown,cid:12)(cid:29)(cid:26)(cid:41)(cid:25)(cid:2)(cid:58)(cid:58)(cid:37)(cid:16)(cid:34)(cid:33,Unknown,10742.0
Unknown,Unknown,45,Unknown,Unknown,Unknown,Unknown,cid:12)(cid:29)(cid:26)(cid:41)(cid:25)(cid:2)(cid:58)(cid:58)(cid:37)(cid:16)(cid:34)(cid:33,Unknown,10787.0
Unknown,Unknown,18,Unknown,Unknown,Unknown,Unknown,cid:12)(cid:29)(cid:26)(cid:41)(cid:25)(cid:2)(cid:58)(cid:58)(cid:37)(cid:16)(cid:34)(cid:33,Unknown,10805.0
Unknown,Unknown,16,Unknown,Unknown,Unknown,Unknown,cid:12)(cid:29)(cid:26)(cid:41)(cid:25)(cid:2)(cid:58)(cid:58)(cid:37)(cid:16)(cid:34)(cid:33,Unknown,10821.0
Unknown,Unknown,9,Unknown,Unknown,Unknown,Unknown,cid:12)(cid:29)(cid:26)(cid:41)(cid:25)(cid:2)(cid:58)(cid:58)(cid:37)(cid:16)(cid:34)(cid:33,Unknown,10830.0
Unknown,Unknown,46,Unknown,Unknown,Unknown,Unknown,cid:12)(cid:29)(cid:26)(cid:41)(cid:25)(cid:2)(cid:58)(cid:58)(cid:37)(cid:16)(cid:34)(cid:33,Unknown,10876.0
Unknown,Unknown,3,Unknown,Unknown,Unknown,Unknown,cid:12)(cid:29)(cid:26)(cid:41)(cid:25)(cid:2)(cid:58)(cid:58)(cid:37)(cid:16)(cid:34)(cid:33,Unknown,10879.0
Unknown,Unknown,14,Unknown,Unknown,Unknown,Unknown,cid:12)(cid:29)(cid:26)(cid:41)(cid:25)(cid:2)(cid:58)(cid:58)(cid:37)(cid:16)(cid:34)(cid:33,Unknown,10893.0
Unknown,Unknown,2,Unknown,Unknown,Unknown,Unknown,cid:12)(cid:29)(cid:26)(cid:41)(cid:25)(cid:2)(cid:58)(cid:58)(cid:37)(cid:16)(cid:34)(cid:33,Unknown,10895.0
Unknown,Unknown,65,Unknown,Unknown,Unknown,Unknown,cid:12)(cid:29)(cid:26)(cid:41)(cid:25)(cid:2)(cid:58)(cid:58)(cid:37)(cid:16)(cid:34)(cid:33,Unknown,10960.0
Unknown,Unknown,39,Unknown,Unknown,Unknown,Unknown,cid:12)(cid:29)(cid:26)(cid:41)(cid:25)(cid:2)(cid:58)(cid:58)(cid:37)(cid:16)(cid:34)(cid:33,Unknown,10999.0
Unknown,Unknown,46,Unknown,Unknown,Unknown,Unknown,cid:12)(cid:29)(cid:26)(cid:41)(cid:25)(cid:2)(cid:58)(cid:58)(cid:37)(cid:16)(cid:34)(cid:33,Unknown,11045.0
Unknown,Unknown,2,Unknown,Unknown,Unknown,Unknown,cid:12)(cid:29)(cid:26)(cid:41)(cid:25)(cid:2)(cid:58)(cid:58)(cid:37)(cid:16)(cid:34)(cid:33,Unknown,11047.0
Unknown,Unknown,48,Unknown,Unknown,Unknown,Unknown,cid:12)(cid:29)(cid:26)(cid:41)(cid:25)(cid:2)(cid:58)(cid:58)(cid:37)(cid:16)(cid:34)(cid:33,Unknown,11095.0
Unknown,Unknown,46,Unknown,Unknown,Unknown,Unknown,cid:12)(cid:29)(cid:26)(cid:41)(cid:25)(cid:2)(cid:58)(cid:58)(cid:37)(cid:16)(cid:34)(cid:33,Unknown,11141.0
Unknown,Unknown,3,Unknown,Unknown,Unknown,Unknown,cid:12)(cid:29)(cid:26)(cid:41)(cid:25)(cid:2)(cid:58)(cid:58)(cid:37)(cid:16)(cid:34)(cid:33,Unknown,11144.0
Unknown,Unknown,65,Unknown,Unknown,Unknown,Unknown,cid:12)(cid:29)(cid:26)(cid:41)(cid:25)(cid:2)(cid:58)(cid:58)(cid:37)(cid:16)(cid:34)(cid:33,Unknown,11209.0
Unknown,Unknown,5,Unknown,Unknown,Unknown,Unknown,cid:12)(cid:29)(cid:26)(cid:41)(cid:25)(cid:2)(cid:58)(cid:58)(cid:37)(cid:16)(cid:34)(cid:33,Unknown,11214.0
Unknown,Unknown,10,Unknown,Unknown,Unknown,Unknown,cid:12)(cid:29)(cid:26)(cid:41)(cid:25)(cid:2)(cid:58)(cid:58)(cid:37)(cid:16)(cid:34)(cid:33,Unknown,11224.0
Unknown,Unknown,2,Unknown,Unknown,Unknown,Unknown,cid:12)(cid:29)(cid:26)(cid:41)(cid:25)(cid:2)(cid:58)(cid:58)(cid:37)(cid:16)(cid:34)(cid:33,Unknown,11226.0
Unknown,Unknown,12,Unknown,Unknown,Unknown,Unknown,cid:12)(cid:29)(cid:26)(cid:41)(cid:25)(cid:2)(cid:58)(cid:58)(cid:37)(cid:16)(cid:34)(cid:33,Unknown,11238.0
Unknown,Unknown,11,Unknown,Unknown,Unknown,Unknown,cid:12)(cid:29)(cid:26)(cid:41)(cid:25)(cid:2)(cid:58)(cid:58)(cid:37)(cid:16)(cid:34)(cid:33,Unknown,11249.0
Unknown,Unknown,4,Unknown,Unknown,Unknown,Unknown,cid:12)(cid:29)(cid:26)(cid:41)(cid:25)(cid:2)(cid:58)(cid:58)(cid:37)(cid:16)(cid:34)(cid:33,Unknown,11253.0
Unknown,Unknown,14,Unknown,Unknown,Unknown,Unknown,cid:12)(cid:29)(cid:26)(cid:41)(cid:25)(cid:2)(cid:58)(cid:58)(cid:37)(cid:16)(cid:34)(cid:33,Unknown,11267.0
Unknown,Unknown,11,Unknown,Unknown,Unknown,Unknown,cid:12)(cid:29)(cid:26)(cid:41)(cid:25)(cid:2)(cid:58)(cid:58)(cid:37)(cid:16)(cid:34)(cid:33,Unknown,11278.0
Unknown,Unknown,48,Unknown,Unknown,Unknown,Unknown,cid:12)(cid:29)(cid:26)(cid:41)(cid:25)(cid:2)(cid:58)(cid:58)(cid:37)(cid:16)(cid:34)(cid:33,Unknown,11326.0
Unknown,Unknown,48,Unknown,Unknown,Unknown,Unknown,cid:12)(cid:29)(cid:26)(cid:41)(cid:25)(cid:2)(cid:58)(cid:58)(cid:37)(cid:16)(cid:34)(cid:33,Unknown,11374.0
Unknown,Unknown,7,Unknown,Unknown,Unknown,Unknown,cid:12)(cid:29)(cid:26)(cid:41)(cid:25)(cid:2)(cid:58)(cid:58)(cid:37)(cid:16)(cid:34)(cid:33,Unknown,11381.0
Unknown,Unknown,5,Unknown,Unknown,Unknown,Unknown,cid:12)(cid:29)(cid:26)(cid:41)(cid:25)(cid:2)(cid:58)(cid:58)(cid:37)(cid:16)(cid:34)(cid:33,Unknown,11386.0
Unknown,Unknown,3,Unknown,Unknown,Unknown,Unknown,cid:12)(cid:29)(cid:26)(cid:41)(cid:25)(cid:2)(cid:58)(cid:58)(cid:37)(cid:16)(cid:34)(cid:33,Unknown,11389.0
Unknown,Unknown,9,Unknown,Unknown,Unknown,Unknown,cid:12)(cid:29)(cid:26)(cid:41)(cid:25)(cid:2)(cid:58)(cid:58)(cid:37)(cid:16)(cid:34)(cid:33,Unknown,11398.0
Unknown,Unknown,2,Unknown,Unknown,Unknown,Unknown,cid:12)(cid:29)(cid:26)(cid:41)(cid:25)(cid:2)(cid:58)(cid:58)(cid:37)(cid:16)(cid:34)(cid:33,Unknown,11400.0
Unknown,Unknown,28,Unknown,Unknown,Unknown,Unknown,cid:12)(cid:29)(cid:26)(cid:41)(cid:25)(cid:2)(cid:58)(cid:58)(cid:37)(cid:16)(cid:34)(cid:33,Unknown,11428.0
Unknown,Unknown,3,Unknown,Unknown,Unknown,Unknown,cid:12)(cid:29)(cid:26)(cid:41)(cid:25)(cid:2)(cid:58)(cid:58)(cid:37)(cid:16)(cid:34)(cid:33,Unknown,11431.0
Unknown,Unknown,15,Unknown,Unknown,Unknown,Unknown,cid:12)(cid:29)(cid:26)(cid:41)(cid:25)(cid:2)(cid:58)(cid:58)(cid:37)(cid:16)(cid:34)(cid:33,Unknown,11446.0
Unknown,Unknown,2,Unknown,Unknown,Unknown,Unknown,cid:12)(cid:29)(cid:26)(cid:41)(cid:25)(cid:2)(cid:58)(cid:58)(cid:37)(cid:16)(cid:34)(cid:33,Unknown,11448.0
Unknown,Unknown,1,Unknown,Unknown,Unknown,Unknown,cid:12)(cid:29)(cid:26)(cid:41)(cid:25)(cid:2)(cid:58)(cid:58)(cid:37)(cid:16)(cid:34)(cid:33,Unknown,11449.0
Unknown,Unknown,1,Unknown,Unknown,Unknown,Unknown,cid:12)(cid:29)(cid:26)(cid:41)(cid:25)(cid:2)(cid:58)(cid:58)(cid:37)(cid:16)(cid:34)(cid:33,Unknown,11450.0
Unknown,Unknown,19,Unknown,Unknown,Unknown,Unknown,cid:12)(cid:29)(cid:26)(cid:41)(cid:25)(cid:2)(cid:58)(cid:58)(cid:37)(cid:16)(cid:34)(cid:33,Unknown,11469.0
Unknown,Unknown,33,Unknown,Unknown,Unknown,Unknown,cid:12)(cid:29)(cid:26)(cid:41)(cid:25)(cid:2)(cid:58)(cid:58)(cid:37)(cid:16)(cid:34)(cid:33,Unknown,11502.0
Unknown,Unknown,32,Unknown,Unknown,Unknown,Unknown,cid:12)(cid:29)(cid:26)(cid:41)(cid:25)(cid:2)(cid:58)(cid:58)(cid:37)(cid:16)(cid:34)(cid:33,Unknown,11534.0
Unknown,Unknown,2,Unknown,Unknown,Unknown,Unknown,cid:12)(cid:29)(cid:26)(cid:41)(cid:25)(cid:2)(cid:58)(cid:58)(cid:37)(cid:16)(cid:34)(cid:33,Unknown,11536.0
Unknown,Unknown,44,Unknown,Unknown,Unknown,Unknown,cid:12)(cid:29)(cid:26)(cid:41)(cid:25)(cid:2)(cid:58)(cid:58)(cid:37)(cid:16)(cid:34)(cid:33,Unknown,11580.0
Unknown,Unknown,12,Unknown,Unknown,Unknown,Unknown,cid:12)(cid:29)(cid:26)(cid:41)(cid:25)(cid:2)(cid:58)(cid:58)(cid:37)(cid:16)(cid:34)(cid:33,Unknown,11592.0
Unknown,Unknown,29,Unknown,Unknown,Unknown,Unknown,cid:12)(cid:29)(cid:26)(cid:41)(cid:25)(cid:2)(cid:58)(cid:58)(cid:37)(cid:16)(cid:34)(cid:33,Unknown,11621.0
Unknown,Unknown,26,Unknown,Unknown,Unknown,Unknown,cid:12)(cid:29)(cid:26)(cid:41)(cid:25)(cid:2)(cid:58)(cid:58)(cid:37)(cid:16)(cid:34)(cid:33,Unknown,11647.0
Unknown,Unknown,41,Unknown,Unknown,Unknown,Unknown,cid:12)(cid:29)(cid:26)(cid:41)(cid:25)(cid:2)(cid:58)(cid:58)(cid:37)(cid:16)(cid:34)(cid:33,Unknown,11688.0
Unknown,Unknown,25,Unknown,Unknown,Unknown,Unknown,cid:12)(cid:29)(cid:26)(cid:41)(cid:25)(cid:2)(cid:58)(cid:58)(cid:37)(cid:16)(cid:34)(cid:33,Unknown,11713.0
Unknown,Unknown,2,Unknown,Unknown,Unknown,Unknown,cid:12)(cid:29)(cid:26)(cid:41)(cid:25)(cid:2)(cid:58)(cid:58)(cid:37)(cid:16)(cid:34)(cid:33,Unknown,11715.0
Unknown,Unknown,58,Unknown,Unknown,Unknown,Unknown,cid:12)(cid:29)(cid:26)(cid:41)(cid:25)(cid:2)(cid:58)(cid:58)(cid:37)(cid:16)(cid:34)(cid:33,Unknown,11773.0
Unknown,Unknown,58,Unknown,Unknown,Unknown,Unknown,cid:12)(cid:29)(cid:26)(cid:41)(cid:25)(cid:2)(cid:58)(cid:58)(cid:37)(cid:16)(cid:34)(cid:33,Unknown,11831.0
Unknown,Unknown,37,Unknown,Unknown,Unknown,Unknown,cid:12)(cid:29)(cid:26)(cid:41)(cid:25)(cid:2)(cid:58)(cid:58)(cid:37)(cid:16)(cid:34)(cid:33,Unknown,11868.0
Unknown,Unknown,16,Unknown,Unknown,Unknown,Unknown,cid:12)(cid:29)(cid:26)(cid:41)(cid:25)(cid:2)(cid:58)(cid:58)(cid:37)(cid:16)(cid:34)(cid:33,Unknown,11884.0
Unknown,Unknown,34,Unknown,Unknown,Unknown,Unknown,cid:12)(cid:29)(cid:26)(cid:41)(cid:25)(cid:2)(cid:58)(cid:58)(cid:37)(cid:16)(cid:34)(cid:33,Unknown,11918.0
Unknown,Unknown,33,Unknown,Unknown,Unknown,Unknown,cid:12)(cid:29)(cid:26)(cid:41)(cid:25)(cid:2)(cid:58)(cid:58)(cid:37)(cid:16)(cid:34)(cid:33,Unknown,11951.0
Unknown,Unknown,1,Unknown,Unknown,Unknown,Unknown,cid:12)(cid:29)(cid:26)(cid:41)(cid:25)(cid:2)(cid:58)(cid:58)(cid:37)(cid:16)(cid:34)(cid:33,Unknown,11952.0
Unknown,Unknown,36,Unknown,Unknown,Unknown,Unknown,cid:12)(cid:29)(cid:26)(cid:41)(cid:25)(cid:2)(cid:58)(cid:58)(cid:37)(cid:16)(cid:34)(cid:33,Unknown,11988.0
Unknown,Unknown,45,Unknown,Unknown,Unknown,Unknown,cid:12)(cid:29)(cid:26)(cid:41)(cid:25)(cid:2)(cid:58)(cid:58)(cid:37)(cid:16)(cid:34)(cid:33,Unknown,12033.0
Unknown,Unknown,18,Unknown,Unknown,Unknown,Unknown,cid:12)(cid:29)(cid:26)(cid:41)(cid:25)(cid:2)(cid:58)(cid:58)(cid:37)(cid:16)(cid:34)(cid:33,Unknown,12051.0
Unknown,Unknown,16,Unknown,Unknown,Unknown,Unknown,cid:12)(cid:29)(cid:26)(cid:41)(cid:25)(cid:2)(cid:58)(cid:58)(cid:37)(cid:16)(cid:34)(cid:33,Unknown,12067.0
Unknown,Unknown,10,Unknown,Unknown,Unknown,Unknown,cid:12)(cid:29)(cid:26)(cid:41)(cid:25)(cid:2)(cid:58)(cid:58)(cid:37)(cid:16)(cid:34)(cid:33,Unknown,12077.0
Unknown,Unknown,11,Unknown,Unknown,Unknown,Unknown,cid:12)(cid:29)(cid:26)(cid:41)(cid:25)(cid:2)(cid:58)(cid:58)(cid:37)(cid:16)(cid:34)(cid:33,Unknown,12088.0
Unknown,Unknown,10,Unknown,Unknown,Unknown,Unknown,cid:12)(cid:29)(cid:26)(cid:41)(cid:25)(cid:2)(cid:58)(cid:58)(cid:37)(cid:16)(cid:34)(cid:33,Unknown,12098.0
Unknown,Unknown,46,Unknown,Unknown,Unknown,Unknown,cid:12)(cid:29)(cid:26)(cid:41)(cid:25)(cid:2)(cid:58)(cid:58)(cid:37)(cid:16)(cid:34)(cid:33,Unknown,12144.0
Unknown,Unknown,14,Unknown,Unknown,Unknown,Unknown,cid:12)(cid:29)(cid:26)(cid:41)(cid:25)(cid:2)(cid:58)(cid:58)(cid:37)(cid:16)(cid:34)(cid:33,Unknown,12158.0
Unknown,Unknown,2,Unknown,Unknown,Unknown,Unknown,cid:12)(cid:29)(cid:26)(cid:41)(cid:25)(cid:2)(cid:58)(cid:58)(cid:37)(cid:16)(cid:34)(cid:33,Unknown,12160.0
Unknown,Unknown,12,Unknown,Unknown,Unknown,Unknown,cid:12)(cid:29)(cid:26)(cid:41)(cid:25)(cid:2)(cid:58)(cid:58)(cid:37)(cid:16)(cid:34)(cid:33,Unknown,12172.0
Unknown,Unknown,11,Unknown,Unknown,Unknown,Unknown,cid:12)(cid:29)(cid:26)(cid:41)(cid:25)(cid:2)(cid:58)(cid:58)(cid:37)(cid:16)(cid:34)(cid:33,Unknown,12183.0
Unknown,Unknown,4,Unknown,Unknown,Unknown,Unknown,cid:12)(cid:29)(cid:26)(cid:41)(cid:25)(cid:2)(cid:58)(cid:58)(cid:37)(cid:16)(cid:34)(cid:33,Unknown,12187.0
Unknown,Unknown,14,Unknown,Unknown,Unknown,Unknown,cid:12)(cid:29)(cid:26)(cid:41)(cid:25)(cid:2)(cid:58)(cid:58)(cid:37)(cid:16)(cid:34)(cid:33,Unknown,12201.0
Unknown,Unknown,11,Unknown,Unknown,Unknown,Unknown,cid:12)(cid:29)(cid:26)(cid:41)(cid:25)(cid:2)(cid:58)(cid:58)(cid:37)(cid:16)(cid:34)(cid:33,Unknown,12212.0
Unknown,Unknown,48,Unknown,Unknown,Unknown,Unknown,cid:12)(cid:29)(cid:26)(cid:41)(cid:25)(cid:2)(cid:58)(cid:58)(cid:37)(cid:16)(cid:34)(cid:33,Unknown,12260.0
Unknown,Unknown,48,Unknown,Unknown,Unknown,Unknown,cid:12)(cid:29)(cid:26)(cid:41)(cid:25)(cid:2)(cid:58)(cid:58)(cid:37)(cid:16)(cid:34)(cid:33,Unknown,12308.0
Unknown,Unknown,7,Unknown,Unknown,Unknown,Unknown,cid:12)(cid:29)(cid:26)(cid:41)(cid:25)(cid:2)(cid:58)(cid:58)(cid:37)(cid:16)(cid:34)(cid:33,Unknown,12315.0
Unknown,Unknown,5,Unknown,Unknown,Unknown,Unknown,cid:12)(cid:29)(cid:26)(cid:41)(cid:25)(cid:2)(cid:58)(cid:58)(cid:37)(cid:16)(cid:34)(cid:33,Unknown,12320.0
Unknown,Unknown,3,Unknown,Unknown,Unknown,Unknown,cid:12)(cid:29)(cid:26)(cid:41)(cid:25)(cid:2)(cid:58)(cid:58)(cid:37)(cid:16)(cid:34)(cid:33,Unknown,12323.0
Unknown,Unknown,9,Unknown,Unknown,Unknown,Unknown,cid:12)(cid:29)(cid:26)(cid:41)(cid:25)(cid:2)(cid:58)(cid:58)(cid:37)(cid:16)(cid:34)(cid:33,Unknown,12332.0
Unknown,Unknown,2,Unknown,Unknown,Unknown,Unknown,cid:12)(cid:29)(cid:26)(cid:41)(cid:25)(cid:2)(cid:58)(cid:58)(cid:37)(cid:16)(cid:34)(cid:33,Unknown,12334.0
Unknown,Unknown,28,Unknown,Unknown,Unknown,Unknown,cid:12)(cid:29)(cid:26)(cid:41)(cid:25)(cid:2)(cid:58)(cid:58)(cid:37)(cid:16)(cid:34)(cid:33,Unknown,12362.0
Unknown,Unknown,3,Unknown,Unknown,Unknown,Unknown,cid:12)(cid:29)(cid:26)(cid:41)(cid:25)(cid:2)(cid:58)(cid:58)(cid:37)(cid:16)(cid:34)(cid:33,Unknown,12365.0
Unknown,Unknown,15,Unknown,Unknown,Unknown,Unknown,cid:12)(cid:29)(cid:26)(cid:41)(cid:25)(cid:2)(cid:58)(cid:58)(cid:37)(cid:16)(cid:34)(cid:33,Unknown,12380.0
Unknown,Unknown,2,Unknown,Unknown,Unknown,Unknown,cid:12)(cid:29)(cid:26)(cid:41)(cid:25)(cid:2)(cid:58)(cid:58)(cid:37)(cid:16)(cid:34)(cid:33,Unknown,12382.0
Unknown,Unknown,34,Unknown,Unknown,Unknown,Unknown,cid:12)(cid:29)(cid:26)(cid:41)(cid:25)(cid:2)(cid:58)(cid:58)(cid:37)(cid:16)(cid:34)(cid:33,Unknown,12416.0
Unknown,Unknown,36,Unknown,Unknown,Unknown,Unknown,cid:12)(cid:29)(cid:26)(cid:41)(cid:25)(cid:2)(cid:58)(cid:58)(cid:37)(cid:16)(cid:34)(cid:33,Unknown,12452.0
Unknown,Unknown,19,Unknown,Unknown,Unknown,Unknown,cid:12)(cid:29)(cid:26)(cid:41)(cid:25)(cid:2)(cid:58)(cid:58)(cid:37)(cid:16)(cid:34)(cid:33,Unknown,12471.0
Unknown,Unknown,32,Unknown,Unknown,Unknown,Unknown,cid:12)(cid:29)(cid:26)(cid:41)(cid:25)(cid:2)(cid:58)(cid:58)(cid:37)(cid:16)(cid:34)(cid:33,Unknown,12503.0
Unknown,Unknown,1,Unknown,Unknown,Unknown,Unknown,cid:12)(cid:29)(cid:26)(cid:41)(cid:25)(cid:2)(cid:58)(cid:58)(cid:37)(cid:16)(cid:34)(cid:33,Unknown,12504.0
Unknown,Unknown,2,Unknown,Unknown,Unknown,Unknown,cid:12)(cid:29)(cid:26)(cid:41)(cid:25)(cid:2)(cid:58)(cid:58)(cid:37)(cid:16)(cid:34)(cid:33,Unknown,12506.0
Unknown,Unknown,44,Unknown,Unknown,Unknown,Unknown,cid:12)(cid:29)(cid:26)(cid:41)(cid:25)(cid:2)(cid:58)(cid:58)(cid:37)(cid:16)(cid:34)(cid:33,Unknown,12550.0
Unknown,Unknown,12,Unknown,Unknown,Unknown,Unknown,cid:12)(cid:29)(cid:26)(cid:41)(cid:25)(cid:2)(cid:58)(cid:58)(cid:37)(cid:16)(cid:34)(cid:33,Unknown,12562.0
Unknown,Unknown,29,Unknown,Unknown,Unknown,Unknown,cid:12)(cid:29)(cid:26)(cid:41)(cid:25)(cid:2)(cid:58)(cid:58)(cid:37)(cid:16)(cid:34)(cid:33,Unknown,12591.0
Unknown,Unknown,26,Unknown,Unknown,Unknown,Unknown,cid:12)(cid:29)(cid:26)(cid:41)(cid:25)(cid:2)(cid:58)(cid:58)(cid:37)(cid:16)(cid:34)(cid:33,Unknown,12617.0
Unknown,Unknown,41,Unknown,Unknown,Unknown,Unknown,cid:12)(cid:29)(cid:26)(cid:41)(cid:25)(cid:2)(cid:58)(cid:58)(cid:37)(cid:16)(cid:34)(cid:33,Unknown,12658.0
Unknown,Unknown,25,Unknown,Unknown,Unknown,Unknown,cid:12)(cid:29)(cid:26)(cid:41)(cid:25)(cid:2)(cid:58)(cid:58)(cid:37)(cid:16)(cid:34)(cid:33,Unknown,12683.0
Unknown,Unknown,2,Unknown,Unknown,Unknown,Unknown,cid:12)(cid:29)(cid:26)(cid:41)(cid:25)(cid:2)(cid:58)(cid:58)(cid:37)(cid:16)(cid:34)(cid:33,Unknown,12685.0
Unknown,Unknown,58,Unknown,Unknown,Unknown,Unknown,cid:12)(cid:29)(cid:26)(cid:41)(cid:25)(cid:2)(cid:58)(cid:58)(cid:37)(cid:16)(cid:34)(cid:33,Unknown,12743.0
Unknown,Unknown,58,Unknown,Unknown,Unknown,Unknown,cid:12)(cid:29)(cid:26)(cid:41)(cid:25)(cid:2)(cid:58)(cid:58)(cid:37)(cid:16)(cid:34)(cid:33,Unknown,12801.0
Unknown,Unknown,37,Unknown,Unknown,Unknown,Unknown,cid:12)(cid:29)(cid:26)(cid:41)(cid:25)(cid:2)(cid:58)(cid:58)(cid:37)(cid:16)(cid:34)(cid:33,Unknown,12838.0
Unknown,Unknown,16,Unknown,Unknown,Unknown,Unknown,cid:12)(cid:29)(cid:26)(cid:41)(cid:25)(cid:2)(cid:58)(cid:58)(cid:37)(cid:16)(cid:34)(cid:33,Unknown,12854.0
Unknown,Unknown,34,Unknown,Unknown,Unknown,Unknown,cid:12)(cid:29)(cid:26)(cid:41)(cid:25)(cid:2)(cid:58)(cid:58)(cid:37)(cid:16)(cid:34)(cid:33,Unknown,12888.0
Unknown,Unknown,33,Unknown,Unknown,Unknown,Unknown,cid:12)(cid:29)(cid:26)(cid:41)(cid:25)(cid:2)(cid:58)(cid:58)(cid:37)(cid:16)(cid:34)(cid:33,Unknown,12921.0
Unknown,Unknown,1,Unknown,Unknown,Unknown,Unknown,cid:12)(cid:29)(cid:26)(cid:41)(cid:25)(cid:2)(cid:58)(cid:58)(cid:37)(cid:16)(cid:34)(cid:33,Unknown,12922.0
Unknown,Unknown,36,Unknown,Unknown,Unknown,Unknown,cid:12)(cid:29)(cid:26)(cid:41)(cid:25)(cid:2)(cid:58)(cid:58)(cid:37)(cid:16)(cid:34)(cid:33,Unknown,12958.0
Unknown,Unknown,45,Unknown,Unknown,Unknown,Unknown,cid:12)(cid:29)(cid:26)(cid:41)(cid:25)(cid:2)(cid:58)(cid:58)(cid:37)(cid:16)(cid:34)(cid:33,Unknown,13003.0
Unknown,Unknown,18,Unknown,Unknown,Unknown,Unknown,cid:12)(cid:29)(cid:26)(cid:41)(cid:25)(cid:2)(cid:58)(cid:58)(cid:37)(cid:16)(cid:34)(cid:33,Unknown,13021.0
Unknown,Unknown,16,Unknown,Unknown,Unknown,Unknown,cid:12)(cid:29)(cid:26)(cid:41)(cid:25)(cid:2)(cid:58)(cid:58)(cid:37)(cid:16)(cid:34)(cid:33,Unknown,13037.0
Unknown,Unknown,10,Unknown,Unknown,Unknown,Unknown,cid:12)(cid:29)(cid:26)(cid:41)(cid:25)(cid:2)(cid:58)(cid:58)(cid:37)(cid:16)(cid:34)(cid:33,Unknown,13047.0
Unknown,Unknown,11,Unknown,Unknown,Unknown,Unknown,cid:12)(cid:29)(cid:26)(cid:41)(cid:25)(cid:2)(cid:58)(cid:58)(cid:37)(cid:16)(cid:34)(cid:33,Unknown,13058.0
Unknown,Unknown,10,Unknown,Unknown,Unknown,Unknown,cid:12)(cid:29)(cid:26)(cid:41)(cid:25)(cid:2)(cid:58)(cid:58)(cid:37)(cid:16)(cid:34)(cid:33,Unknown,13068.0
Unknown,Unknown,46,Unknown,Unknown,Unknown,Unknown,cid:12)(cid:29)(cid:26)(cid:41)(cid:25)(cid:2)(cid:58)(cid:58)(cid:37)(cid:16)(cid:34)(cid:33,Unknown,13114.0
Unknown,Unknown,14,Unknown,Unknown,Unknown,Unknown,cid:12)(cid:29)(cid:26)(cid:41)(cid:25)(cid:2)(cid:58)(cid:58)(cid:37)(cid:16)(cid:34)(cid:33,Unknown,13128.0
Unknown,Unknown,2,Unknown,Unknown,Unknown,Unknown,cid:12)(cid:29)(cid:26)(cid:41)(cid:25)(cid:2)(cid:58)(cid:58)(cid:37)(cid:16)(cid:34)(cid:33,Unknown,13130.0
Unknown,Unknown,12,Unknown,Unknown,Unknown,Unknown,cid:12)(cid:29)(cid:26)(cid:41)(cid:25)(cid:2)(cid:58)(cid:58)(cid:37)(cid:16)(cid:34)(cid:33,Unknown,13142.0
Unknown,Unknown,11,Unknown,Unknown,Unknown,Unknown,cid:12)(cid:29)(cid:26)(cid:41)(cid:25)(cid:2)(cid:58)(cid:58)(cid:37)(cid:16)(cid:34)(cid:33,Unknown,13153.0
Unknown,Unknown,4,Unknown,Unknown,Unknown,Unknown,cid:12)(cid:29)(cid:26)(cid:41)(cid:25)(cid:2)(cid:58)(cid:58)(cid:37)(cid:16)(cid:34)(cid:33,Unknown,13157.0
Unknown,Unknown,14,Unknown,Unknown,Unknown,Unknown,cid:12)(cid:29)(cid:26)(cid:41)(cid:25)(cid:2)(cid:58)(cid:58)(cid:37)(cid:16)(cid:34)(cid:33,Unknown,13171.0
Unknown,Unknown,11,Unknown,Unknown,Unknown,Unknown,cid:12)(cid:29)(cid:26)(cid:41)(cid:25)(cid:2)(cid:58)(cid:58)(cid:37)(cid:16)(cid:34)(cid:33,Unknown,13182.0
Unknown,Unknown,48,Unknown,Unknown,Unknown,Unknown,cid:12)(cid:29)(cid:26)(cid:41)(cid:25)(cid:2)(cid:58)(cid:58)(cid:37)(cid:16)(cid:34)(cid:33,Unknown,13230.0
Unknown,Unknown,48,Unknown,Unknown,Unknown,Unknown,cid:12)(cid:29)(cid:26)(cid:41)(cid:25)(cid:2)(cid:58)(cid:58)(cid:37)(cid:16)(cid:34)(cid:33,Unknown,13278.0
Unknown,Unknown,7,Unknown,Unknown,Unknown,Unknown,cid:12)(cid:29)(cid:26)(cid:41)(cid:25)(cid:2)(cid:58)(cid:58)(cid:37)(cid:16)(cid:34)(cid:33,Unknown,13285.0
Unknown,Unknown,5,Unknown,Unknown,Unknown,Unknown,cid:12)(cid:29)(cid:26)(cid:41)(cid:25)(cid:2)(cid:58)(cid:58)(cid:37)(cid:16)(cid:34)(cid:33,Unknown,13290.0
Unknown,Unknown,3,Unknown,Unknown,Unknown,Unknown,cid:12)(cid:29)(cid:26)(cid:41)(cid:25)(cid:2)(cid:58)(cid:58)(cid:37)(cid:16)(cid:34)(cid:33,Unknown,13293.0
Unknown,Unknown,9,Unknown,Unknown,Unknown,Unknown,cid:12)(cid:29)(cid:26)(cid:41)(cid:25)(cid:2)(cid:58)(cid:58)(cid:37)(cid:16)(cid:34)(cid:33,Unknown,13302.0
Unknown,Unknown,2,Unknown,Unknown,Unknown,Unknown,cid:12)(cid:29)(cid:26)(cid:41)(cid:25)(cid:2)(cid:58)(cid:58)(cid:37)(cid:16)(cid:34)(cid:33,Unknown,13304.0
Unknown,Unknown,28,Unknown,Unknown,Unknown,Unknown,cid:12)(cid:29)(cid:26)(cid:41)(cid:25)(cid:2)(cid:58)(cid:58)(cid:37)(cid:16)(cid:34)(cid:33,Unknown,13332.0
Unknown,Unknown,3,Unknown,Unknown,Unknown,Unknown,cid:12)(cid:29)(cid:26)(cid:41)(cid:25)(cid:2)(cid:58)(cid:58)(cid:37)(cid:16)(cid:34)(cid:33,Unknown,13335.0
Unknown,Unknown,15,Unknown,Unknown,Unknown,Unknown,cid:12)(cid:29)(cid:26)(cid:41)(cid:25)(cid:2)(cid:58)(cid:58)(cid:37)(cid:16)(cid:34)(cid:33,Unknown,13350.0
Unknown,Unknown,2,Unknown,Unknown,Unknown,Unknown,cid:12)(cid:29)(cid:26)(cid:41)(cid:25)(cid:2)(cid:58)(cid:58)(cid:37)(cid:16)(cid:34)(cid:33,Unknown,13352.0
Unknown,Unknown,34,Unknown,Unknown,Unknown,Unknown,cid:12)(cid:29)(cid:26)(cid:41)(cid:25)(cid:2)(cid:58)(cid:58)(cid:37)(cid:16)(cid:34)(cid:33,Unknown,13386.0
Unknown,Unknown,18,Unknown,Unknown,Unknown,Unknown,cid:12)(cid:29)(cid:26)(cid:41)(cid:25)(cid:2)(cid:58)(cid:58)(cid:37)(cid:16)(cid:34)(cid:33,Unknown,13404.0
Unknown,Unknown,19,Unknown,Unknown,Unknown,Unknown,cid:12)(cid:29)(cid:26)(cid:41)(cid:25)(cid:2)(cid:58)(cid:58)(cid:37)(cid:16)(cid:34)(cid:33,Unknown,13423.0
Unknown,Unknown,18,Unknown,Unknown,Unknown,Unknown,cid:12)(cid:29)(cid:26)(cid:41)(cid:25)(cid:2)(cid:58)(cid:58)(cid:37)(cid:16)(cid:34)(cid:33,Unknown,13441.0
Unknown,Unknown,17,Unknown,Unknown,Unknown,Unknown,cid:12)(cid:29)(cid:26)(cid:41)(cid:25)(cid:2)(cid:58)(cid:58)(cid:37)(cid:16)(cid:34)(cid:33,Unknown,13458.0
Unknown,Unknown,2,Unknown,Unknown,Unknown,Unknown,cid:12)(cid:29)(cid:26)(cid:41)(cid:25)(cid:2)(cid:58)(cid:58)(cid:37)(cid:16)(cid:34)(cid:33,Unknown,13460.0
Unknown,Unknown,44,Unknown,Unknown,Unknown,Unknown,cid:12)(cid:29)(cid:26)(cid:41)(cid:25)(cid:2)(cid:58)(cid:58)(cid:37)(cid:16)(cid:34)(cid:33,Unknown,13504.0
Unknown,Unknown,12,Unknown,Unknown,Unknown,Unknown,cid:12)(cid:29)(cid:26)(cid:41)(cid:25)(cid:2)(cid:58)(cid:58)(cid:37)(cid:16)(cid:34)(cid:33,Unknown,13516.0
Unknown,Unknown,29,Unknown,Unknown,Unknown,Unknown,cid:12)(cid:29)(cid:26)(cid:41)(cid:25)(cid:2)(cid:58)(cid:58)(cid:37)(cid:16)(cid:34)(cid:33,Unknown,13545.0
Unknown,Unknown,26,Unknown,Unknown,Unknown,Unknown,cid:12)(cid:29)(cid:26)(cid:41)(cid:25)(cid:2)(cid:58)(cid:58)(cid:37)(cid:16)(cid:34)(cid:33,Unknown,13571.0
Unknown,Unknown,41,Unknown,Unknown,Unknown,Unknown,cid:12)(cid:29)(cid:26)(cid:41)(cid:25)(cid:2)(cid:58)(cid:58)(cid:37)(cid:16)(cid:34)(cid:33,Unknown,13612.0
Unknown,Unknown,25,Unknown,Unknown,Unknown,Unknown,cid:12)(cid:29)(cid:26)(cid:41)(cid:25)(cid:2)(cid:58)(cid:58)(cid:37)(cid:16)(cid:34)(cid:33,Unknown,13637.0
Unknown,Unknown,2,Unknown,Unknown,Unknown,Unknown,cid:12)(cid:29)(cid:26)(cid:41)(cid:25)(cid:2)(cid:58)(cid:58)(cid:37)(cid:16)(cid:34)(cid:33,Unknown,13639.0
Unknown,Unknown,58,Unknown,Unknown,Unknown,Unknown,cid:12)(cid:29)(cid:26)(cid:41)(cid:25)(cid:2)(cid:58)(cid:58)(cid:37)(cid:16)(cid:34)(cid:33,Unknown,13697.0
Unknown,Unknown,58,Unknown,Unknown,Unknown,Unknown,cid:12)(cid:29)(cid:26)(cid:41)(cid:25)(cid:2)(cid:58)(cid:58)(cid:37)(cid:16)(cid:34)(cid:33,Unknown,13755.0
Unknown,Unknown,18,Unknown,Unknown,Unknown,Unknown,cid:12)(cid:29)(cid:26)(cid:41)(cid:25)(cid:2)(cid:58)(cid:58)(cid:37)(cid:16)(cid:34)(cid:33,Unknown,13773.0
Unknown,Unknown,1,Unknown,Unknown,Unknown,Unknown,cid:12)(cid:29)(cid:26)(cid:41)(cid:25)(cid:2)(cid:58)(cid:58)(cid:37)(cid:16)(cid:34)(cid:33,Unknown,13774.0
Unknown,Unknown,1,Unknown,Unknown,Unknown,Unknown,cid:12)(cid:29)(cid:26)(cid:41)(cid:25)(cid:2)(cid:58)(cid:58)(cid:37)(cid:16)(cid:34)(cid:33,Unknown,13775.0
Unknown,Unknown,37,Unknown,Unknown,Unknown,Unknown,cid:12)(cid:29)(cid:26)(cid:41)(cid:25)(cid:2)(cid:58)(cid:58)(cid:37)(cid:16)(cid:34)(cid:33,Unknown,13812.0
Unknown,Unknown,1,Unknown,Unknown,Unknown,Unknown,cid:12)(cid:29)(cid:26)(cid:41)(cid:25)(cid:2)(cid:58)(cid:58)(cid:37)(cid:16)(cid:34)(cid:33,Unknown,13813.0
Unknown,Unknown,36,Unknown,Unknown,Unknown,Unknown,cid:12)(cid:29)(cid:26)(cid:41)(cid:25)(cid:2)(cid:58)(cid:58)(cid:37)(cid:16)(cid:34)(cid:33,Unknown,13849.0
Unknown,Unknown,45,Unknown,Unknown,Unknown,Unknown,cid:12)(cid:29)(cid:26)(cid:41)(cid:25)(cid:2)(cid:58)(cid:58)(cid:37)(cid:16)(cid:34)(cid:33,Unknown,13894.0
Unknown,Unknown,18,Unknown,Unknown,Unknown,Unknown,cid:12)(cid:29)(cid:26)(cid:41)(cid:25)(cid:2)(cid:58)(cid:58)(cid:37)(cid:16)(cid:34)(cid:33,Unknown,13912.0
Unknown,Unknown,16,Unknown,Unknown,Unknown,Unknown,cid:12)(cid:29)(cid:26)(cid:41)(cid:25)(cid:2)(cid:58)(cid:58)(cid:37)(cid:16)(cid:34)(cid:33,Unknown,13928.0
Unknown,Unknown,39,Unknown,Unknown,Unknown,Unknown,cid:12)(cid:29)(cid:26)(cid:41)(cid:25)(cid:2)(cid:58)(cid:58)(cid:37)(cid:16)(cid:34)(cid:33,Unknown,13967.0
Unknown,Unknown,7,Unknown,Unknown,Unknown,Unknown,cid:12)(cid:29)(cid:26)(cid:41)(cid:25)(cid:2)(cid:58)(cid:58)(cid:37)(cid:16)(cid:34)(cid:33,Unknown,13974.0
Unknown,Unknown,5,Unknown,Unknown,Unknown,Unknown,cid:12)(cid:29)(cid:26)(cid:41)(cid:25)(cid:2)(cid:58)(cid:58)(cid:37)(cid:16)(cid:34)(cid:33,Unknown,13979.0
Unknown,Unknown,12,Unknown,Unknown,Unknown,Unknown,cid:12)(cid:29)(cid:26)(cid:41)(cid:25)(cid:2)(cid:58)(cid:58)(cid:37)(cid:16)(cid:34)(cid:33,Unknown,13991.0
Unknown,Unknown,5,Unknown,Unknown,Unknown,Unknown,cid:12)(cid:29)(cid:26)(cid:41)(cid:25)(cid:2)(cid:58)(cid:58)(cid:37)(cid:16)(cid:34)(cid:33,Unknown,13996.0
Unknown,Unknown,9,Unknown,Unknown,Unknown,Unknown,cid:12)(cid:29)(cid:26)(cid:41)(cid:25)(cid:2)(cid:58)(cid:58)(cid:37)(cid:16)(cid:34)(cid:33,Unknown,14005.0
Unknown,Unknown,2,Unknown,Unknown,Unknown,Unknown,cid:12)(cid:29)(cid:26)(cid:41)(cid:25)(cid:2)(cid:58)(cid:58)(cid:37)(cid:16)(cid:34)(cid:33,Unknown,14007.0
Unknown,Unknown,50,Unknown,Unknown,Unknown,Unknown,cid:12)(cid:29)(cid:26)(cid:41)(cid:25)(cid:2)(cid:58)(cid:58)(cid:37)(cid:16)(cid:34)(cid:33,Unknown,14057.0
Unknown,Unknown,5,Unknown,Unknown,Unknown,Unknown,cid:12)(cid:29)(cid:26)(cid:41)(cid:25)(cid:2)(cid:58)(cid:58)(cid:37)(cid:16)(cid:34)(cid:33,Unknown,14062.0
Unknown,Unknown,10,Unknown,Unknown,Unknown,Unknown,cid:12)(cid:29)(cid:26)(cid:41)(cid:25)(cid:2)(cid:58)(cid:58)(cid:37)(cid:16)(cid:34)(cid:33,Unknown,14072.0
Unknown,Unknown,46,Unknown,Unknown,Unknown,Unknown,cid:12)(cid:29)(cid:26)(cid:41)(cid:25)(cid:2)(cid:58)(cid:58)(cid:37)(cid:16)(cid:34)(cid:33,Unknown,14118.0
Unknown,Unknown,12,Unknown,Unknown,Unknown,Unknown,cid:12)(cid:29)(cid:26)(cid:41)(cid:25)(cid:2)(cid:58)(cid:58)(cid:37)(cid:16)(cid:34)(cid:33,Unknown,14130.0
Unknown,Unknown,13,Unknown,Unknown,Unknown,Unknown,cid:12)(cid:29)(cid:26)(cid:41)(cid:25)(cid:2)(cid:58)(cid:58)(cid:37)(cid:16)(cid:34)(cid:33,Unknown,14143.0
Unknown,Unknown,2,Unknown,Unknown,Unknown,Unknown,cid:12)(cid:29)(cid:26)(cid:41)(cid:25)(cid:2)(cid:58)(cid:58)(cid:37)(cid:16)(cid:34)(cid:33,Unknown,14145.0
Unknown,Unknown,48,Unknown,Unknown,Unknown,Unknown,cid:12)(cid:29)(cid:26)(cid:41)(cid:25)(cid:2)(cid:58)(cid:58)(cid:37)(cid:16)(cid:34)(cid:33,Unknown,14193.0
Unknown,Unknown,11,Unknown,Unknown,Unknown,Unknown,cid:12)(cid:29)(cid:26)(cid:41)(cid:25)(cid:2)(cid:58)(cid:58)(cid:37)(cid:16)(cid:34)(cid:33,Unknown,14204.0
Unknown,Unknown,4,Unknown,Unknown,Unknown,Unknown,cid:12)(cid:29)(cid:26)(cid:41)(cid:25)(cid:2)(cid:58)(cid:58)(cid:37)(cid:16)(cid:34)(cid:33,Unknown,14208.0
Unknown,Unknown,3,Unknown,Unknown,Unknown,Unknown,cid:12)(cid:29)(cid:26)(cid:41)(cid:25)(cid:2)(cid:58)(cid:58)(cid:37)(cid:16)(cid:34)(cid:33,Unknown,14211.0
Unknown,Unknown,11,Unknown,Unknown,Unknown,Unknown,cid:12)(cid:29)(cid:26)(cid:41)(cid:25)(cid:2)(cid:58)(cid:58)(cid:37)(cid:16)(cid:34)(cid:33,Unknown,14222.0
Unknown,Unknown,4,Unknown,Unknown,Unknown,Unknown,cid:12)(cid:29)(cid:26)(cid:41)(cid:25)(cid:2)(cid:58)(cid:58)(cid:37)(cid:16)(cid:34)(cid:33,Unknown,14226.0
Unknown,Unknown,40,Unknown,Unknown,Unknown,Unknown,cid:12)(cid:29)(cid:26)(cid:41)(cid:25)(cid:2)(cid:58)(cid:58)(cid:37)(cid:16)(cid:34)(cid:33,Unknown,14266.0
Unknown,Unknown,2,Unknown,Unknown,Unknown,Unknown,cid:12)(cid:29)(cid:26)(cid:41)(cid:25)(cid:2)(cid:58)(cid:58)(cid:37)(cid:16)(cid:34)(cid:33,Unknown,14268.0
Unknown,Unknown,28,Unknown,Unknown,Unknown,Unknown,cid:12)(cid:29)(cid:26)(cid:41)(cid:25)(cid:2)(cid:58)(cid:58)(cid:37)(cid:16)(cid:34)(cid:33,Unknown,14296.0
Unknown,Unknown,3,Unknown,Unknown,Unknown,Unknown,cid:12)(cid:29)(cid:26)(cid:41)(cid:25)(cid:2)(cid:58)(cid:58)(cid:37)(cid:16)(cid:34)(cid:33,Unknown,14299.0
Unknown,Unknown,15,Unknown,Unknown,Unknown,Unknown,cid:12)(cid:29)(cid:26)(cid:41)(cid:25)(cid:2)(cid:58)(cid:58)(cid:37)(cid:16)(cid:34)(cid:33,Unknown,14314.0
Unknown,Unknown,2,Unknown,Unknown,Unknown,Unknown,cid:12)(cid:29)(cid:26)(cid:41)(cid:25)(cid:2)(cid:58)(cid:58)(cid:37)(cid:16)(cid:34)(cid:33,Unknown,14316.0
Unknown,Unknown,32,Unknown,Unknown,Unknown,Unknown,cid:12)(cid:29)(cid:26)(cid:41)(cid:25)(cid:2)(cid:58)(cid:58)(cid:37)(cid:16)(cid:34)(cid:33,Unknown,14348.0
Unknown,Unknown,36,Unknown,Unknown,Unknown,Unknown,cid:12)(cid:29)(cid:26)(cid:41)(cid:25)(cid:2)(cid:58)(cid:58)(cid:37)(cid:16)(cid:34)(cid:33,Unknown,14384.0
Unknown,Unknown,19,Unknown,Unknown,Unknown,Unknown,cid:12)(cid:29)(cid:26)(cid:41)(cid:25)(cid:2)(cid:58)(cid:58)(cid:37)(cid:16)(cid:34)(cid:33,Unknown,14403.0
Unknown,Unknown,18,Unknown,Unknown,Unknown,Unknown,cid:12)(cid:29)(cid:26)(cid:41)(cid:25)(cid:2)(cid:58)(cid:58)(cid:37)(cid:16)(cid:34)(cid:33,Unknown,14421.0
Unknown,Unknown,18,Unknown,Unknown,Unknown,Unknown,cid:12)(cid:29)(cid:26)(cid:41)(cid:25)(cid:2)(cid:58)(cid:58)(cid:37)(cid:16)(cid:34)(cid:33,Unknown,14439.0
Unknown,Unknown,2,Unknown,Unknown,Unknown,Unknown,cid:12)(cid:29)(cid:26)(cid:41)(cid:25)(cid:2)(cid:58)(cid:58)(cid:37)(cid:16)(cid:34)(cid:33,Unknown,14441.0
Unknown,Unknown,44,Unknown,Unknown,Unknown,Unknown,cid:12)(cid:29)(cid:26)(cid:41)(cid:25)(cid:2)(cid:58)(cid:58)(cid:37)(cid:16)(cid:34)(cid:33,Unknown,14485.0
Unknown,Unknown,12,Unknown,Unknown,Unknown,Unknown,cid:12)(cid:29)(cid:26)(cid:41)(cid:25)(cid:2)(cid:58)(cid:58)(cid:37)(cid:16)(cid:34)(cid:33,Unknown,14497.0
Unknown,Unknown,29,Unknown,Unknown,Unknown,Unknown,cid:12)(cid:29)(cid:26)(cid:41)(cid:25)(cid:2)(cid:58)(cid:58)(cid:37)(cid:16)(cid:34)(cid:33,Unknown,14526.0
Unknown,Unknown,26,Unknown,Unknown,Unknown,Unknown,cid:12)(cid:29)(cid:26)(cid:41)(cid:25)(cid:2)(cid:58)(cid:58)(cid:37)(cid:16)(cid:34)(cid:33,Unknown,14552.0
Unknown,Unknown,41,Unknown,Unknown,Unknown,Unknown,cid:12)(cid:29)(cid:26)(cid:41)(cid:25)(cid:2)(cid:58)(cid:58)(cid:37)(cid:16)(cid:34)(cid:33,Unknown,14593.0
Unknown,Unknown,25,Unknown,Unknown,Unknown,Unknown,cid:12)(cid:29)(cid:26)(cid:41)(cid:25)(cid:2)(cid:58)(cid:58)(cid:37)(cid:16)(cid:34)(cid:33,Unknown,14618.0
Unknown,Unknown,2,Unknown,Unknown,Unknown,Unknown,cid:12)(cid:29)(cid:26)(cid:41)(cid:25)(cid:2)(cid:58)(cid:58)(cid:37)(cid:16)(cid:34)(cid:33,Unknown,14620.0
Unknown,Unknown,58,Unknown,Unknown,Unknown,Unknown,cid:12)(cid:29)(cid:26)(cid:41)(cid:25)(cid:2)(cid:58)(cid:58)(cid:37)(cid:16)(cid:34)(cid:33,Unknown,14678.0
Unknown,Unknown,58,Unknown,Unknown,Unknown,Unknown,cid:12)(cid:29)(cid:26)(cid:41)(cid:25)(cid:2)(cid:58)(cid:58)(cid:37)(cid:16)(cid:34)(cid:33,Unknown,14736.0
Unknown,Unknown,18,Unknown,Unknown,Unknown,Unknown,cid:12)(cid:29)(cid:26)(cid:41)(cid:25)(cid:2)(cid:58)(cid:58)(cid:37)(cid:16)(cid:34)(cid:33,Unknown,14754.0
Unknown,Unknown,1,Unknown,Unknown,Unknown,Unknown,cid:12)(cid:29)(cid:26)(cid:41)(cid:25)(cid:2)(cid:58)(cid:58)(cid:37)(cid:16)(cid:34)(cid:33,Unknown,14755.0
Unknown,Unknown,1,Unknown,Unknown,Unknown,Unknown,cid:12)(cid:29)(cid:26)(cid:41)(cid:25)(cid:2)(cid:58)(cid:58)(cid:37)(cid:16)(cid:34)(cid:33,Unknown,14756.0
Unknown,Unknown,37,Unknown,Unknown,Unknown,Unknown,cid:12)(cid:29)(cid:26)(cid:41)(cid:25)(cid:2)(cid:58)(cid:58)(cid:37)(cid:16)(cid:34)(cid:33,Unknown,14793.0
Unknown,Unknown,1,Unknown,Unknown,Unknown,Unknown,cid:12)(cid:29)(cid:26)(cid:41)(cid:25)(cid:2)(cid:58)(cid:58)(cid:37)(cid:16)(cid:34)(cid:33,Unknown,14794.0
Unknown,Unknown,36,Unknown,Unknown,Unknown,Unknown,cid:12)(cid:29)(cid:26)(cid:41)(cid:25)(cid:2)(cid:58)(cid:58)(cid:37)(cid:16)(cid:34)(cid:33,Unknown,14830.0
Unknown,Unknown,45,Unknown,Unknown,Unknown,Unknown,cid:12)(cid:29)(cid:26)(cid:41)(cid:25)(cid:2)(cid:58)(cid:58)(cid:37)(cid:16)(cid:34)(cid:33,Unknown,14875.0
Unknown,Unknown,18,Unknown,Unknown,Unknown,Unknown,cid:12)(cid:29)(cid:26)(cid:41)(cid:25)(cid:2)(cid:58)(cid:58)(cid:37)(cid:16)(cid:34)(cid:33,Unknown,14893.0
Unknown,Unknown,16,Unknown,Unknown,Unknown,Unknown,cid:12)(cid:29)(cid:26)(cid:41)(cid:25)(cid:2)(cid:58)(cid:58)(cid:37)(cid:16)(cid:34)(cid:33,Unknown,14909.0
Unknown,Unknown,14,Unknown,Unknown,Unknown,Unknown,cid:12)(cid:29)(cid:26)(cid:41)(cid:25)(cid:2)(cid:58)(cid:58)(cid:37)(cid:16)(cid:34)(cid:33,Unknown,14923.0
Unknown,Unknown,5,Unknown,Unknown,Unknown,Unknown,cid:12)(cid:29)(cid:26)(cid:41)(cid:25)(cid:2)(cid:58)(cid:58)(cid:37)(cid:16)(cid:34)(cid:33,Unknown,14928.0
Unknown,Unknown,12,Unknown,Unknown,Unknown,Unknown,cid:12)(cid:29)(cid:26)(cid:41)(cid:25)(cid:2)(cid:58)(cid:58)(cid:37)(cid:16)(cid:34)(cid:33,Unknown,14940.0
Unknown,Unknown,14,Unknown,Unknown,Unknown,Unknown,cid:12)(cid:29)(cid:26)(cid:41)(cid:25)(cid:2)(cid:58)(cid:58)(cid:37)(cid:16)(cid:34)(cid:33,Unknown,14954.0
Unknown,Unknown,5,Unknown,Unknown,Unknown,Unknown,cid:12)(cid:29)(cid:26)(cid:41)(cid:25)(cid:2)(cid:58)(cid:58)(cid:37)(cid:16)(cid:34)(cid:33,Unknown,14959.0
Unknown,Unknown,3,Unknown,Unknown,Unknown,Unknown,cid:12)(cid:29)(cid:26)(cid:41)(cid:25)(cid:2)(cid:58)(cid:58)(cid:37)(cid:16)(cid:34)(cid:33,Unknown,14962.0
Unknown,Unknown,12,Unknown,Unknown,Unknown,Unknown,cid:12)(cid:29)(cid:26)(cid:41)(cid:25)(cid:2)(cid:58)(cid:58)(cid:37)(cid:16)(cid:34)(cid:33,Unknown,14974.0
Unknown,Unknown,2,Unknown,Unknown,Unknown,Unknown,cid:12)(cid:29)(cid:26)(cid:41)(cid:25)(cid:2)(cid:58)(cid:58)(cid:37)(cid:16)(cid:34)(cid:33,Unknown,14976.0
Unknown,Unknown,50,Unknown,Unknown,Unknown,Unknown,cid:12)(cid:29)(cid:26)(cid:41)(cid:25)(cid:2)(cid:58)(cid:58)(cid:37)(cid:16)(cid:34)(cid:33,Unknown,15026.0
Unknown,Unknown,7,Unknown,Unknown,Unknown,Unknown,cid:12)(cid:29)(cid:26)(cid:41)(cid:25)(cid:2)(cid:58)(cid:58)(cid:37)(cid:16)(cid:34)(cid:33,Unknown,15033.0
Unknown,Unknown,9,Unknown,Unknown,Unknown,Unknown,cid:12)(cid:29)(cid:26)(cid:41)(cid:25)(cid:2)(cid:58)(cid:58)(cid:37)(cid:16)(cid:34)(cid:33,Unknown,15042.0
Unknown,Unknown,10,Unknown,Unknown,Unknown,Unknown,cid:12)(cid:29)(cid:26)(cid:41)(cid:25)(cid:2)(cid:58)(cid:58)(cid:37)(cid:16)(cid:34)(cid:33,Unknown,15052.0
Unknown,Unknown,3,Unknown,Unknown,Unknown,Unknown,cid:12)(cid:29)(cid:26)(cid:41)(cid:25)(cid:2)(cid:58)(cid:58)(cid:37)(cid:16)(cid:34)(cid:33,Unknown,15055.0
Unknown,Unknown,2,Unknown,Unknown,Unknown,Unknown,cid:12)(cid:29)(cid:26)(cid:41)(cid:25)(cid:2)(cid:58)(cid:58)(cid:37)(cid:16)(cid:34)(cid:33,Unknown,15057.0
Unknown,Unknown,12,Unknown,Unknown,Unknown,Unknown,cid:12)(cid:29)(cid:26)(cid:41)(cid:25)(cid:2)(cid:58)(cid:58)(cid:37)(cid:16)(cid:34)(cid:33,Unknown,15069.0
Unknown,Unknown,11,Unknown,Unknown,Unknown,Unknown,cid:12)(cid:29)(cid:26)(cid:41)(cid:25)(cid:2)(cid:58)(cid:58)(cid:37)(cid:16)(cid:34)(cid:33,Unknown,15080.0
Unknown,Unknown,4,Unknown,Unknown,Unknown,Unknown,cid:12)(cid:29)(cid:26)(cid:41)(cid:25)(cid:2)(cid:58)(cid:58)(cid:37)(cid:16)(cid:34)(cid:33,Unknown,15084.0
Unknown,Unknown,14,Unknown,Unknown,Unknown,Unknown,cid:12)(cid:29)(cid:26)(cid:41)(cid:25)(cid:2)(cid:58)(cid:58)(cid:37)(cid:16)(cid:34)(cid:33,Unknown,15098.0
Unknown,Unknown,11,Unknown,Unknown,Unknown,Unknown,cid:12)(cid:29)(cid:26)(cid:41)(cid:25)(cid:2)(cid:58)(cid:58)(cid:37)(cid:16)(cid:34)(cid:33,Unknown,15109.0
Unknown,Unknown,48,Unknown,Unknown,Unknown,Unknown,cid:12)(cid:29)(cid:26)(cid:41)(cid:25)(cid:2)(cid:58)(cid:58)(cid:37)(cid:16)(cid:34)(cid:33,Unknown,15157.0
Unknown,Unknown,48,Unknown,Unknown,Unknown,Unknown,cid:12)(cid:29)(cid:26)(cid:41)(cid:25)(cid:2)(cid:58)(cid:58)(cid:37)(cid:16)(cid:34)(cid:33,Unknown,15205.0
Unknown,Unknown,7,Unknown,Unknown,Unknown,Unknown,cid:12)(cid:29)(cid:26)(cid:41)(cid:25)(cid:2)(cid:58)(cid:58)(cid:37)(cid:16)(cid:34)(cid:33,Unknown,15212.0
Unknown,Unknown,5,Unknown,Unknown,Unknown,Unknown,cid:12)(cid:29)(cid:26)(cid:41)(cid:25)(cid:2)(cid:58)(cid:58)(cid:37)(cid:16)(cid:34)(cid:33,Unknown,15217.0
Unknown,Unknown,3,Unknown,Unknown,Unknown,Unknown,cid:12)(cid:29)(cid:26)(cid:41)(cid:25)(cid:2)(cid:58)(cid:58)(cid:37)(cid:16)(cid:34)(cid:33,Unknown,15220.0
Unknown,Unknown,2,Unknown,Unknown,Unknown,Unknown,cid:12)(cid:29)(cid:26)(cid:41)(cid:25)(cid:2)(cid:58)(cid:58)(cid:37)(cid:16)(cid:34)(cid:33,Unknown,15222.0
Unknown,Unknown,28,Unknown,Unknown,Unknown,Unknown,cid:12)(cid:29)(cid:26)(cid:41)(cid:25)(cid:2)(cid:58)(cid:58)(cid:37)(cid:16)(cid:34)(cid:33,Unknown,15250.0
Unknown,Unknown,3,Unknown,Unknown,Unknown,Unknown,cid:12)(cid:29)(cid:26)(cid:41)(cid:25)(cid:2)(cid:58)(cid:58)(cid:37)(cid:16)(cid:34)(cid:33,Unknown,15253.0
Unknown,Unknown,15,Unknown,Unknown,Unknown,Unknown,cid:12)(cid:29)(cid:26)(cid:41)(cid:25)(cid:2)(cid:58)(cid:58)(cid:37)(cid:16)(cid:34)(cid:33,Unknown,15268.0
Unknown,Unknown,2,Unknown,Unknown,Unknown,Unknown,cid:12)(cid:29)(cid:26)(cid:41)(cid:25)(cid:2)(cid:58)(cid:58)(cid:37)(cid:16)(cid:34)(cid:33,Unknown,15270.0
Unknown,Unknown,35,Unknown,Unknown,Unknown,Unknown,cid:12)(cid:29)(cid:26)(cid:41)(cid:25)(cid:2)(cid:58)(cid:58)(cid:37)(cid:16)(cid:34)(cid:33,Unknown,15305.0
Unknown,Unknown,32,Unknown,Unknown,Unknown,Unknown,cid:12)(cid:29)(cid:26)(cid:41)(cid:25)(cid:2)(cid:58)(cid:58)(cid:37)(cid:16)(cid:34)(cid:33,Unknown,15337.0
Unknown,Unknown,19,Unknown,Unknown,Unknown,Unknown,cid:12)(cid:29)(cid:26)(cid:41)(cid:25)(cid:2)(cid:58)(cid:58)(cid:37)(cid:16)(cid:34)(cid:33,Unknown,15356.0
Unknown,Unknown,34,Unknown,Unknown,Unknown,Unknown,cid:12)(cid:29)(cid:26)(cid:41)(cid:25)(cid:2)(cid:58)(cid:58)(cid:37)(cid:16)(cid:34)(cid:33,Unknown,15390.0
Unknown,Unknown,33,Unknown,Unknown,Unknown,Unknown,cid:12)(cid:29)(cid:26)(cid:41)(cid:25)(cid:2)(cid:58)(cid:58)(cid:37)(cid:16)(cid:34)(cid:33,Unknown,15423.0
Unknown,Unknown,2,Unknown,Unknown,Unknown,Unknown,cid:12)(cid:29)(cid:26)(cid:41)(cid:25)(cid:2)(cid:58)(cid:58)(cid:37)(cid:16)(cid:34)(cid:33,Unknown,15425.0
Unknown,Unknown,44,Unknown,Unknown,Unknown,Unknown,cid:12)(cid:29)(cid:26)(cid:41)(cid:25)(cid:2)(cid:58)(cid:58)(cid:37)(cid:16)(cid:34)(cid:33,Unknown,15469.0
Unknown,Unknown,12,Unknown,Unknown,Unknown,Unknown,cid:12)(cid:29)(cid:26)(cid:41)(cid:25)(cid:2)(cid:58)(cid:58)(cid:37)(cid:16)(cid:34)(cid:33,Unknown,15481.0
Unknown,Unknown,29,Unknown,Unknown,Unknown,Unknown,cid:12)(cid:29)(cid:26)(cid:41)(cid:25)(cid:2)(cid:58)(cid:58)(cid:37)(cid:16)(cid:34)(cid:33,Unknown,15510.0
Unknown,Unknown,26,Unknown,Unknown,Unknown,Unknown,cid:12)(cid:29)(cid:26)(cid:41)(cid:25)(cid:2)(cid:58)(cid:58)(cid:37)(cid:16)(cid:34)(cid:33,Unknown,15536.0
Unknown,Unknown,41,Unknown,Unknown,Unknown,Unknown,cid:12)(cid:29)(cid:26)(cid:41)(cid:25)(cid:2)(cid:58)(cid:58)(cid:37)(cid:16)(cid:34)(cid:33,Unknown,15577.0
Unknown,Unknown,25,Unknown,Unknown,Unknown,Unknown,cid:12)(cid:29)(cid:26)(cid:41)(cid:25)(cid:2)(cid:58)(cid:58)(cid:37)(cid:16)(cid:34)(cid:33,Unknown,15602.0
Unknown,Unknown,2,Unknown,Unknown,Unknown,Unknown,cid:12)(cid:29)(cid:26)(cid:41)(cid:25)(cid:2)(cid:58)(cid:58)(cid:37)(cid:16)(cid:34)(cid:33,Unknown,15604.0
Unknown,Unknown,58,Unknown,Unknown,Unknown,Unknown,cid:12)(cid:29)(cid:26)(cid:41)(cid:25)(cid:2)(cid:58)(cid:58)(cid:37)(cid:16)(cid:34)(cid:33,Unknown,15662.0
Unknown,Unknown,58,Unknown,Unknown,Unknown,Unknown,cid:12)(cid:29)(cid:26)(cid:41)(cid:25)(cid:2)(cid:58)(cid:58)(cid:37)(cid:16)(cid:34)(cid:33,Unknown,15720.0
Unknown,Unknown,37,Unknown,Unknown,Unknown,Unknown,cid:12)(cid:29)(cid:26)(cid:41)(cid:25)(cid:2)(cid:58)(cid:58)(cid:37)(cid:16)(cid:34)(cid:33,Unknown,15757.0
Unknown,Unknown,16,Unknown,Unknown,Unknown,Unknown,cid:12)(cid:29)(cid:26)(cid:41)(cid:25)(cid:2)(cid:58)(cid:58)(cid:37)(cid:16)(cid:34)(cid:33,Unknown,15773.0
Unknown,Unknown,34,Unknown,Unknown,Unknown,Unknown,cid:12)(cid:29)(cid:26)(cid:41)(cid:25)(cid:2)(cid:58)(cid:58)(cid:37)(cid:16)(cid:34)(cid:33,Unknown,15807.0
Unknown,Unknown,33,Unknown,Unknown,Unknown,Unknown,cid:12)(cid:29)(cid:26)(cid:41)(cid:25)(cid:2)(cid:58)(cid:58)(cid:37)(cid:16)(cid:34)(cid:33,Unknown,15840.0
Unknown,Unknown,1,Unknown,Unknown,Unknown,Unknown,cid:12)(cid:29)(cid:26)(cid:41)(cid:25)(cid:2)(cid:58)(cid:58)(cid:37)(cid:16)(cid:34)(cid:33,Unknown,15841.0
Unknown,Unknown,36,Unknown,Unknown,Unknown,Unknown,cid:12)(cid:29)(cid:26)(cid:41)(cid:25)(cid:2)(cid:58)(cid:58)(cid:37)(cid:16)(cid:34)(cid:33,Unknown,15877.0
Unknown,Unknown,45,Unknown,Unknown,Unknown,Unknown,cid:12)(cid:29)(cid:26)(cid:41)(cid:25)(cid:2)(cid:58)(cid:58)(cid:37)(cid:16)(cid:34)(cid:33,Unknown,15922.0
Unknown,Unknown,18,Unknown,Unknown,Unknown,Unknown,cid:12)(cid:29)(cid:26)(cid:41)(cid:25)(cid:2)(cid:58)(cid:58)(cid:37)(cid:16)(cid:34)(cid:33,Unknown,15940.0
Unknown,Unknown,16,Unknown,Unknown,Unknown,Unknown,cid:12)(cid:29)(cid:26)(cid:41)(cid:25)(cid:2)(cid:58)(cid:58)(cid:37)(cid:16)(cid:34)(cid:33,Unknown,15956.0
Unknown,Unknown,9,Unknown,Unknown,Unknown,Unknown,cid:12)(cid:29)(cid:26)(cid:41)(cid:25)(cid:2)(cid:58)(cid:58)(cid:37)(cid:16)(cid:34)(cid:33,Unknown,15965.0
Unknown,Unknown,46,Unknown,Unknown,Unknown,Unknown,cid:12)(cid:29)(cid:26)(cid:41)(cid:25)(cid:2)(cid:58)(cid:58)(cid:37)(cid:16)(cid:34)(cid:33,Unknown,16011.0
Unknown,Unknown,3,Unknown,Unknown,Unknown,Unknown,cid:12)(cid:29)(cid:26)(cid:41)(cid:25)(cid:2)(cid:58)(cid:58)(cid:37)(cid:16)(cid:34)(cid:33,Unknown,16014.0
Unknown,Unknown,14,Unknown,Unknown,Unknown,Unknown,cid:12)(cid:29)(cid:26)(cid:41)(cid:25)(cid:2)(cid:58)(cid:58)(cid:37)(cid:16)(cid:34)(cid:33,Unknown,16028.0
Unknown,Unknown,2,Unknown,Unknown,Unknown,Unknown,cid:12)(cid:29)(cid:26)(cid:41)(cid:25)(cid:2)(cid:58)(cid:58)(cid:37)(cid:16)(cid:34)(cid:33,Unknown,16030.0
Unknown,Unknown,65,Unknown,Unknown,Unknown,Unknown,cid:12)(cid:29)(cid:26)(cid:41)(cid:25)(cid:2)(cid:58)(cid:58)(cid:37)(cid:16)(cid:34)(cid:33,Unknown,16095.0
Unknown,Unknown,39,Unknown,Unknown,Unknown,Unknown,cid:12)(cid:29)(cid:26)(cid:41)(cid:25)(cid:2)(cid:58)(cid:58)(cid:37)(cid:16)(cid:34)(cid:33,Unknown,16134.0
Unknown,Unknown,46,Unknown,Unknown,Unknown,Unknown,cid:12)(cid:29)(cid:26)(cid:41)(cid:25)(cid:2)(cid:58)(cid:58)(cid:37)(cid:16)(cid:34)(cid:33,Unknown,16180.0
Unknown,Unknown,2,Unknown,Unknown,Unknown,Unknown,cid:12)(cid:29)(cid:26)(cid:41)(cid:25)(cid:2)(cid:58)(cid:58)(cid:37)(cid:16)(cid:34)(cid:33,Unknown,16182.0
Unknown,Unknown,48,Unknown,Unknown,Unknown,Unknown,cid:12)(cid:29)(cid:26)(cid:41)(cid:25)(cid:2)(cid:58)(cid:58)(cid:37)(cid:16)(cid:34)(cid:33,Unknown,16230.0
Unknown,Unknown,46,Unknown,Unknown,Unknown,Unknown,cid:12)(cid:29)(cid:26)(cid:41)(cid:25)(cid:2)(cid:58)(cid:58)(cid:37)(cid:16)(cid:34)(cid:33,Unknown,16276.0
Unknown,Unknown,3,Unknown,Unknown,Unknown,Unknown,cid:12)(cid:29)(cid:26)(cid:41)(cid:25)(cid:2)(cid:58)(cid:58)(cid:37)(cid:16)(cid:34)(cid:33,Unknown,16279.0
Unknown,Unknown,65,Unknown,Unknown,Unknown,Unknown,cid:12)(cid:29)(cid:26)(cid:41)(cid:25)(cid:2)(cid:58)(cid:58)(cid:37)(cid:16)(cid:34)(cid:33,Unknown,16344.0
Unknown,Unknown,5,Unknown,Unknown,Unknown,Unknown,cid:12)(cid:29)(cid:26)(cid:41)(cid:25)(cid:2)(cid:58)(cid:58)(cid:37)(cid:16)(cid:34)(cid:33,Unknown,16349.0
Unknown,Unknown,10,Unknown,Unknown,Unknown,Unknown,cid:12)(cid:29)(cid:26)(cid:41)(cid:25)(cid:2)(cid:58)(cid:58)(cid:37)(cid:16)(cid:34)(cid:33,Unknown,16359.0
Unknown,Unknown,2,Unknown,Unknown,Unknown,Unknown,cid:12)(cid:29)(cid:26)(cid:41)(cid:25)(cid:2)(cid:58)(cid:58)(cid:37)(cid:16)(cid:34)(cid:33,Unknown,16361.0
Unknown,Unknown,12,Unknown,Unknown,Unknown,Unknown,cid:12)(cid:29)(cid:26)(cid:41)(cid:25)(cid:2)(cid:58)(cid:58)(cid:37)(cid:16)(cid:34)(cid:33,Unknown,16373.0
Unknown,Unknown,11,Unknown,Unknown,Unknown,Unknown,cid:12)(cid:29)(cid:26)(cid:41)(cid:25)(cid:2)(cid:58)(cid:58)(cid:37)(cid:16)(cid:34)(cid:33,Unknown,16384.0
Unknown,Unknown,4,Unknown,Unknown,Unknown,Unknown,cid:12)(cid:29)(cid:26)(cid:41)(cid:25)(cid:2)(cid:58)(cid:58)(cid:37)(cid:16)(cid:34)(cid:33,Unknown,16388.0
Unknown,Unknown,14,Unknown,Unknown,Unknown,Unknown,cid:12)(cid:29)(cid:26)(cid:41)(cid:25)(cid:2)(cid:58)(cid:58)(cid:37)(cid:16)(cid:34)(cid:33,Unknown,16402.0
Unknown,Unknown,11,Unknown,Unknown,Unknown,Unknown,cid:12)(cid:29)(cid:26)(cid:41)(cid:25)(cid:2)(cid:58)(cid:58)(cid:37)(cid:16)(cid:34)(cid:33,Unknown,16413.0
Unknown,Unknown,48,Unknown,Unknown,Unknown,Unknown,cid:12)(cid:29)(cid:26)(cid:41)(cid:25)(cid:2)(cid:58)(cid:58)(cid:37)(cid:16)(cid:34)(cid:33,Unknown,16461.0
Unknown,Unknown,48,Unknown,Unknown,Unknown,Unknown,cid:12)(cid:29)(cid:26)(cid:41)(cid:25)(cid:2)(cid:58)(cid:58)(cid:37)(cid:16)(cid:34)(cid:33,Unknown,16509.0
Unknown,Unknown,7,Unknown,Unknown,Unknown,Unknown,cid:12)(cid:29)(cid:26)(cid:41)(cid:25)(cid:2)(cid:58)(cid:58)(cid:37)(cid:16)(cid:34)(cid:33,Unknown,16516.0
Unknown,Unknown,5,Unknown,Unknown,Unknown,Unknown,cid:12)(cid:29)(cid:26)(cid:41)(cid:25)(cid:2)(cid:58)(cid:58)(cid:37)(cid:16)(cid:34)(cid:33,Unknown,16521.0
Unknown,Unknown,3,Unknown,Unknown,Unknown,Unknown,cid:12)(cid:29)(cid:26)(cid:41)(cid:25)(cid:2)(cid:58)(cid:58)(cid:37)(cid:16)(cid:34)(cid:33,Unknown,16524.0
Unknown,Unknown,9,Unknown,Unknown,Unknown,Unknown,cid:12)(cid:29)(cid:26)(cid:41)(cid:25)(cid:2)(cid:58)(cid:58)(cid:37)(cid:16)(cid:34)(cid:33,Unknown,16533.0
Unknown,Unknown,2,Unknown,Unknown,Unknown,Unknown,cid:12)(cid:29)(cid:26)(cid:41)(cid:25)(cid:2)(cid:58)(cid:58)(cid:37)(cid:16)(cid:34)(cid:33,Unknown,16535.0
Unknown,Unknown,28,Unknown,Unknown,Unknown,Unknown,cid:12)(cid:29)(cid:26)(cid:41)(cid:25)(cid:2)(cid:58)(cid:58)(cid:37)(cid:16)(cid:34)(cid:33,Unknown,16563.0
Unknown,Unknown,3,Unknown,Unknown,Unknown,Unknown,cid:12)(cid:29)(cid:26)(cid:41)(cid:25)(cid:2)(cid:58)(cid:58)(cid:37)(cid:16)(cid:34)(cid:33,Unknown,16566.0
Unknown,Unknown,15,Unknown,Unknown,Unknown,Unknown,cid:12)(cid:29)(cid:26)(cid:41)(cid:25)(cid:2)(cid:58)(cid:58)(cid:37)(cid:16)(cid:34)(cid:33,Unknown,16581.0
Unknown,Unknown,2,Unknown,Unknown,Unknown,Unknown,cid:12)(cid:29)(cid:26)(cid:41)(cid:25)(cid:2)(cid:58)(cid:58)(cid:37)(cid:16)(cid:34)(cid:33,Unknown,16583.0
Unknown,Unknown,1,Unknown,Unknown,Unknown,Unknown,cid:12)(cid:29)(cid:26)(cid:41)(cid:25)(cid:2)(cid:58)(cid:58)(cid:37)(cid:16)(cid:34)(cid:33,Unknown,16584.0
Unknown,Unknown,37,Unknown,Unknown,Unknown,Unknown,cid:12)(cid:29)(cid:26)(cid:41)(cid:25)(cid:2)(cid:58)(cid:58)(cid:37)(cid:16)(cid:34)(cid:33,Unknown,16621.0
Unknown,Unknown,19,Unknown,Unknown,Unknown,Unknown,cid:12)(cid:29)(cid:26)(cid:41)(cid:25)(cid:2)(cid:58)(cid:58)(cid:37)(cid:16)(cid:34)(cid:33,Unknown,16640.0
Unknown,Unknown,32,Unknown,Unknown,Unknown,Unknown,cid:12)(cid:29)(cid:26)(cid:41)(cid:25)(cid:2)(cid:58)(cid:58)(cid:37)(cid:16)(cid:34)(cid:33,Unknown,16672.0
Unknown,Unknown,33,Unknown,Unknown,Unknown,Unknown,cid:12)(cid:29)(cid:26)(cid:41)(cid:25)(cid:2)(cid:58)(cid:58)(cid:37)(cid:16)(cid:34)(cid:33,Unknown,16705.0
Unknown,Unknown,2,Unknown,Unknown,Unknown,Unknown,cid:12)(cid:29)(cid:26)(cid:41)(cid:25)(cid:2)(cid:58)(cid:58)(cid:37)(cid:16)(cid:34)(cid:33,Unknown,16707.0
Unknown,Unknown,44,Unknown,Unknown,Unknown,Unknown,cid:12)(cid:29)(cid:26)(cid:41)(cid:25)(cid:2)(cid:58)(cid:58)(cid:37)(cid:16)(cid:34)(cid:33,Unknown,16751.0
Unknown,Unknown,12,Unknown,Unknown,Unknown,Unknown,cid:12)(cid:29)(cid:26)(cid:41)(cid:25)(cid:2)(cid:58)(cid:58)(cid:37)(cid:16)(cid:34)(cid:33,Unknown,16763.0
Unknown,Unknown,29,Unknown,Unknown,Unknown,Unknown,cid:12)(cid:29)(cid:26)(cid:41)(cid:25)(cid:2)(cid:58)(cid:58)(cid:37)(cid:16)(cid:34)(cid:33,Unknown,16792.0
Unknown,Unknown,26,Unknown,Unknown,Unknown,Unknown,cid:12)(cid:29)(cid:26)(cid:41)(cid:25)(cid:2)(cid:58)(cid:58)(cid:37)(cid:16)(cid:34)(cid:33,Unknown,16818.0
Unknown,Unknown,41,Unknown,Unknown,Unknown,Unknown,cid:12)(cid:29)(cid:26)(cid:41)(cid:25)(cid:2)(cid:58)(cid:58)(cid:37)(cid:16)(cid:34)(cid:33,Unknown,16859.0
Unknown,Unknown,25,Unknown,Unknown,Unknown,Unknown,cid:12)(cid:29)(cid:26)(cid:41)(cid:25)(cid:2)(cid:58)(cid:58)(cid:37)(cid:16)(cid:34)(cid:33,Unknown,16884.0
Unknown,Unknown,2,Unknown,Unknown,Unknown,Unknown,cid:12)(cid:29)(cid:26)(cid:41)(cid:25)(cid:2)(cid:58)(cid:58)(cid:37)(cid:16)(cid:34)(cid:33,Unknown,16886.0
Unknown,Unknown,58,Unknown,Unknown,Unknown,Unknown,cid:12)(cid:29)(cid:26)(cid:41)(cid:25)(cid:2)(cid:58)(cid:58)(cid:37)(cid:16)(cid:34)(cid:33,Unknown,16944.0
Unknown,Unknown,58,Unknown,Unknown,Unknown,Unknown,cid:12)(cid:29)(cid:26)(cid:41)(cid:25)(cid:2)(cid:58)(cid:58)(cid:37)(cid:16)(cid:34)(cid:33,Unknown,17002.0
Unknown,Unknown,37,Unknown,Unknown,Unknown,Unknown,cid:12)(cid:29)(cid:26)(cid:41)(cid:25)(cid:2)(cid:58)(cid:58)(cid:37)(cid:16)(cid:34)(cid:33,Unknown,17039.0
Unknown,Unknown,16,Unknown,Unknown,Unknown,Unknown,cid:12)(cid:29)(cid:26)(cid:41)(cid:25)(cid:2)(cid:58)(cid:58)(cid:37)(cid:16)(cid:34)(cid:33,Unknown,17055.0
Unknown,Unknown,34,Unknown,Unknown,Unknown,Unknown,cid:12)(cid:29)(cid:26)(cid:41)(cid:25)(cid:2)(cid:58)(cid:58)(cid:37)(cid:16)(cid:34)(cid:33,Unknown,17089.0
Unknown,Unknown,33,Unknown,Unknown,Unknown,Unknown,cid:12)(cid:29)(cid:26)(cid:41)(cid:25)(cid:2)(cid:58)(cid:58)(cid:37)(cid:16)(cid:34)(cid:33,Unknown,17122.0
Unknown,Unknown,1,Unknown,Unknown,Unknown,Unknown,cid:12)(cid:29)(cid:26)(cid:41)(cid:25)(cid:2)(cid:58)(cid:58)(cid:37)(cid:16)(cid:34)(cid:33,Unknown,17123.0
Unknown,Unknown,16,Unknown,Unknown,Unknown,Unknown,cid:12)(cid:29)(cid:26)(cid:41)(cid:25)(cid:2)(cid:58)(cid:58)(cid:37)(cid:16)(cid:34)(cid:33,Unknown,17139.0
Unknown,Unknown,45,Unknown,Unknown,Unknown,Unknown,cid:12)(cid:29)(cid:26)(cid:41)(cid:25)(cid:2)(cid:58)(cid:58)(cid:37)(cid:16)(cid:34)(cid:33,Unknown,17184.0
Unknown,Unknown,18,Unknown,Unknown,Unknown,Unknown,cid:12)(cid:29)(cid:26)(cid:41)(cid:25)(cid:2)(cid:58)(cid:58)(cid:37)(cid:16)(cid:34)(cid:33,Unknown,17202.0
Unknown,Unknown,16,Unknown,Unknown,Unknown,Unknown,cid:12)(cid:29)(cid:26)(cid:41)(cid:25)(cid:2)(cid:58)(cid:58)(cid:37)(cid:16)(cid:34)(cid:33,Unknown,17218.0
Unknown,Unknown,39,Unknown,Unknown,Unknown,Unknown,cid:12)(cid:29)(cid:26)(cid:41)(cid:25)(cid:2)(cid:58)(cid:58)(cid:37)(cid:16)(cid:34)(cid:33,Unknown,17257.0
Unknown,Unknown,3,Unknown,Unknown,Unknown,Unknown,cid:12)(cid:29)(cid:26)(cid:41)(cid:25)(cid:2)(cid:58)(cid:58)(cid:37)(cid:16)(cid:34)(cid:33,Unknown,17260.0
Unknown,Unknown,7,Unknown,Unknown,Unknown,Unknown,cid:12)(cid:29)(cid:26)(cid:41)(cid:25)(cid:2)(cid:58)(cid:58)(cid:37)(cid:16)(cid:34)(cid:33,Unknown,17267.0
Unknown,Unknown,48,Unknown,Unknown,Unknown,Unknown,cid:12)(cid:29)(cid:26)(cid:41)(cid:25)(cid:2)(cid:58)(cid:58)(cid:37)(cid:16)(cid:34)(cid:33,Unknown,17315.0
Unknown,Unknown,46,Unknown,Unknown,Unknown,Unknown,cid:12)(cid:29)(cid:26)(cid:41)(cid:25)(cid:2)(cid:58)(cid:58)(cid:37)(cid:16)(cid:34)(cid:33,Unknown,17361.0
Unknown,Unknown,3,Unknown,Unknown,Unknown,Unknown,cid:12)(cid:29)(cid:26)(cid:41)(cid:25)(cid:2)(cid:58)(cid:58)(cid:37)(cid:16)(cid:34)(cid:33,Unknown,17364.0
Unknown,Unknown,65,Unknown,Unknown,Unknown,Unknown,cid:12)(cid:29)(cid:26)(cid:41)(cid:25)(cid:2)(cid:58)(cid:58)(cid:37)(cid:16)(cid:34)(cid:33,Unknown,17429.0
Unknown,Unknown,2,Unknown,Unknown,Unknown,Unknown,cid:12)(cid:29)(cid:26)(cid:41)(cid:25)(cid:2)(cid:58)(cid:58)(cid:37)(cid:16)(cid:34)(cid:33,Unknown,17431.0
Unknown,Unknown,9,Unknown,Unknown,Unknown,Unknown,cid:12)(cid:29)(cid:26)(cid:41)(cid:25)(cid:2)(cid:58)(cid:58)(cid:37)(cid:16)(cid:34)(cid:33,Unknown,17440.0
Unknown,Unknown,5,Unknown,Unknown,Unknown,Unknown,cid:12)(cid:29)(cid:26)(cid:41)(cid:25)(cid:2)(cid:58)(cid:58)(cid:37)(cid:16)(cid:34)(cid:33,Unknown,17445.0
Unknown,Unknown,3,Unknown,Unknown,Unknown,Unknown,cid:12)(cid:29)(cid:26)(cid:41)(cid:25)(cid:2)(cid:58)(cid:58)(cid:37)(cid:16)(cid:34)(cid:33,Unknown,17448.0
Unknown,Unknown,3,Unknown,Unknown,Unknown,Unknown,cid:12)(cid:29)(cid:26)(cid:41)(cid:25)(cid:2)(cid:58)(cid:58)(cid:37)(cid:16)(cid:34)(cid:33,Unknown,17451.0
Unknown,Unknown,7,Unknown,Unknown,Unknown,Unknown,cid:12)(cid:29)(cid:26)(cid:41)(cid:25)(cid:2)(cid:58)(cid:58)(cid:37)(cid:16)(cid:34)(cid:33,Unknown,17458.0
Unknown,Unknown,9,Unknown,Unknown,Unknown,Unknown,cid:12)(cid:29)(cid:26)(cid:41)(cid:25)(cid:2)(cid:58)(cid:58)(cid:37)(cid:16)(cid:34)(cid:33,Unknown,17467.0
Unknown,Unknown,2,Unknown,Unknown,Unknown,Unknown,cid:12)(cid:29)(cid:26)(cid:41)(cid:25)(cid:2)(cid:58)(cid:58)(cid:37)(cid:16)(cid:34)(cid:33,Unknown,17469.0
Unknown,Unknown,9,Unknown,Unknown,Unknown,Unknown,cid:12)(cid:29)(cid:26)(cid:41)(cid:25)(cid:2)(cid:58)(cid:58)(cid:37)(cid:16)(cid:34)(cid:33,Unknown,17478.0
Unknown,Unknown,5,Unknown,Unknown,Unknown,Unknown,cid:12)(cid:29)(cid:26)(cid:41)(cid:25)(cid:2)(cid:58)(cid:58)(cid:37)(cid:16)(cid:34)(cid:33,Unknown,17483.0
Unknown,Unknown,3,Unknown,Unknown,Unknown,Unknown,cid:12)(cid:29)(cid:26)(cid:41)(cid:25)(cid:2)(cid:58)(cid:58)(cid:37)(cid:16)(cid:34)(cid:33,Unknown,17486.0
Unknown,Unknown,3,Unknown,Unknown,Unknown,Unknown,cid:12)(cid:29)(cid:26)(cid:41)(cid:25)(cid:2)(cid:58)(cid:58)(cid:37)(cid:16)(cid:34)(cid:33,Unknown,17489.0
Unknown,Unknown,7,Unknown,Unknown,Unknown,Unknown,cid:12)(cid:29)(cid:26)(cid:41)(cid:25)(cid:2)(cid:58)(cid:58)(cid:37)(cid:16)(cid:34)(cid:33,Unknown,17496.0
Unknown,Unknown,9,Unknown,Unknown,Unknown,Unknown,cid:12)(cid:29)(cid:26)(cid:41)(cid:25)(cid:2)(cid:58)(cid:58)(cid:37)(cid:16)(cid:34)(cid:33,Unknown,17505.0
Unknown,Unknown,2,Unknown,Unknown,Unknown,Unknown,cid:12)(cid:29)(cid:26)(cid:41)(cid:25)(cid:2)(cid:58)(cid:58)(cid:37)(cid:16)(cid:34)(cid:33,Unknown,17507.0
Unknown,Unknown,28,Unknown,Unknown,Unknown,Unknown,cid:12)(cid:29)(cid:26)(cid:41)(cid:25)(cid:2)(cid:58)(cid:58)(cid:37)(cid:16)(cid:34)(cid:33,Unknown,17535.0
Unknown,Unknown,3,Unknown,Unknown,Unknown,Unknown,cid:12)(cid:29)(cid:26)(cid:41)(cid:25)(cid:2)(cid:58)(cid:58)(cid:37)(cid:16)(cid:34)(cid:33,Unknown,17538.0
Unknown,Unknown,15,Unknown,Unknown,Unknown,Unknown,cid:12)(cid:29)(cid:26)(cid:41)(cid:25)(cid:2)(cid:58)(cid:58)(cid:37)(cid:16)(cid:34)(cid:33,Unknown,17553.0
Unknown,Unknown,2,Unknown,Unknown,Unknown,Unknown,cid:12)(cid:29)(cid:26)(cid:41)(cid:25)(cid:2)(cid:58)(cid:58)(cid:37)(cid:16)(cid:34)(cid:33,Unknown,17555.0
Unknown,Unknown,17,Unknown,Unknown,Unknown,Unknown,cid:12)(cid:29)(cid:26)(cid:41)(cid:25)(cid:2)(cid:58)(cid:58)(cid:37)(cid:16)(cid:34)(cid:33,Unknown,17572.0
Unknown,Unknown,18,Unknown,Unknown,Unknown,Unknown,cid:12)(cid:29)(cid:26)(cid:41)(cid:25)(cid:2)(cid:58)(cid:58)(cid:37)(cid:16)(cid:34)(cid:33,Unknown,17590.0
Unknown,Unknown,18,Unknown,Unknown,Unknown,Unknown,cid:12)(cid:29)(cid:26)(cid:41)(cid:25)(cid:2)(cid:58)(cid:58)(cid:37)(cid:16)(cid:34)(cid:33,Unknown,17608.0
Unknown,Unknown,19,Unknown,Unknown,Unknown,Unknown,cid:12)(cid:29)(cid:26)(cid:41)(cid:25)(cid:2)(cid:58)(cid:58)(cid:37)(cid:16)(cid:34)(cid:33,Unknown,17627.0
Unknown,Unknown,18,Unknown,Unknown,Unknown,Unknown,cid:12)(cid:29)(cid:26)(cid:41)(cid:25)(cid:2)(cid:58)(cid:58)(cid:37)(cid:16)(cid:34)(cid:33,Unknown,17645.0
Unknown,Unknown,18,Unknown,Unknown,Unknown,Unknown,cid:12)(cid:29)(cid:26)(cid:41)(cid:25)(cid:2)(cid:58)(cid:58)(cid:37)(cid:16)(cid:34)(cid:33,Unknown,17663.0
Unknown,Unknown,2,Unknown,Unknown,Unknown,Unknown,cid:12)(cid:29)(cid:26)(cid:41)(cid:25)(cid:2)(cid:58)(cid:58)(cid:37)(cid:16)(cid:34)(cid:33,Unknown,17665.0
Unknown,Unknown,44,Unknown,Unknown,Unknown,Unknown,cid:12)(cid:29)(cid:26)(cid:41)(cid:25)(cid:2)(cid:58)(cid:58)(cid:37)(cid:16)(cid:34)(cid:33,Unknown,17709.0
Unknown,Unknown,12,Unknown,Unknown,Unknown,Unknown,cid:12)(cid:29)(cid:26)(cid:41)(cid:25)(cid:2)(cid:58)(cid:58)(cid:37)(cid:16)(cid:34)(cid:33,Unknown,17721.0
Unknown,Unknown,29,Unknown,Unknown,Unknown,Unknown,cid:12)(cid:29)(cid:26)(cid:41)(cid:25)(cid:2)(cid:58)(cid:58)(cid:37)(cid:16)(cid:34)(cid:33,Unknown,17750.0
Unknown,Unknown,26,Unknown,Unknown,Unknown,Unknown,cid:12)(cid:29)(cid:26)(cid:41)(cid:25)(cid:2)(cid:58)(cid:58)(cid:37)(cid:16)(cid:34)(cid:33,Unknown,17776.0
Unknown,Unknown,41,Unknown,Unknown,Unknown,Unknown,cid:12)(cid:29)(cid:26)(cid:41)(cid:25)(cid:2)(cid:58)(cid:58)(cid:37)(cid:16)(cid:34)(cid:33,Unknown,17817.0
Unknown,Unknown,25,Unknown,Unknown,Unknown,Unknown,cid:12)(cid:29)(cid:26)(cid:41)(cid:25)(cid:2)(cid:58)(cid:58)(cid:37)(cid:16)(cid:34)(cid:33,Unknown,17842.0
Unknown,Unknown,2,Unknown,Unknown,Unknown,Unknown,cid:12)(cid:29)(cid:26)(cid:41)(cid:25)(cid:2)(cid:58)(cid:58)(cid:37)(cid:16)(cid:34)(cid:33,Unknown,17844.0
Unknown,Unknown,58,Unknown,Unknown,Unknown,Unknown,cid:12)(cid:29)(cid:26)(cid:41)(cid:25)(cid:2)(cid:58)(cid:58)(cid:37)(cid:16)(cid:34)(cid:33,Unknown,17902.0
Unknown,Unknown,58,Unknown,Unknown,Unknown,Unknown,cid:12)(cid:29)(cid:26)(cid:41)(cid:25)(cid:2)(cid:58)(cid:58)(cid:37)(cid:16)(cid:34)(cid:33,Unknown,17960.0
Unknown,Unknown,37,Unknown,Unknown,Unknown,Unknown,cid:12)(cid:29)(cid:26)(cid:41)(cid:25)(cid:2)(cid:58)(cid:58)(cid:37)(cid:16)(cid:34)(cid:33,Unknown,17997.0
Unknown,Unknown,16,Unknown,Unknown,Unknown,Unknown,cid:12)(cid:29)(cid:26)(cid:41)(cid:25)(cid:2)(cid:58)(cid:58)(cid:37)(cid:16)(cid:34)(cid:33,Unknown,18013.0
Unknown,Unknown,34,Unknown,Unknown,Unknown,Unknown,cid:12)(cid:29)(cid:26)(cid:41)(cid:25)(cid:2)(cid:58)(cid:58)(cid:37)(cid:16)(cid:34)(cid:33,Unknown,18047.0
Unknown,Unknown,33,Unknown,Unknown,Unknown,Unknown,cid:12)(cid:29)(cid:26)(cid:41)(cid:25)(cid:2)(cid:58)(cid:58)(cid:37)(cid:16)(cid:34)(cid:33,Unknown,18080.0
Unknown,Unknown,1,Unknown,Unknown,Unknown,Unknown,cid:12)(cid:29)(cid:26)(cid:41)(cid:25)(cid:2)(cid:58)(cid:58)(cid:37)(cid:16)(cid:34)(cid:33,Unknown,18081.0
Unknown,Unknown,16,Unknown,Unknown,Unknown,Unknown,cid:12)(cid:29)(cid:26)(cid:41)(cid:25)(cid:2)(cid:58)(cid:58)(cid:37)(cid:16)(cid:34)(cid:33,Unknown,18097.0
Unknown,Unknown,45,Unknown,Unknown,Unknown,Unknown,cid:12)(cid:29)(cid:26)(cid:41)(cid:25)(cid:2)(cid:58)(cid:58)(cid:37)(cid:16)(cid:34)(cid:33,Unknown,18142.0
Unknown,Unknown,18,Unknown,Unknown,Unknown,Unknown,cid:12)(cid:29)(cid:26)(cid:41)(cid:25)(cid:2)(cid:58)(cid:58)(cid:37)(cid:16)(cid:34)(cid:33,Unknown,18160.0
Unknown,Unknown,16,Unknown,Unknown,Unknown,Unknown,cid:12)(cid:29)(cid:26)(cid:41)(cid:25)(cid:2)(cid:58)(cid:58)(cid:37)(cid:16)(cid:34)(cid:33,Unknown,18176.0
Unknown,Unknown,47,Unknown,Unknown,Unknown,Unknown,cid:12)(cid:29)(cid:26)(cid:41)(cid:25)(cid:2)(cid:58)(cid:58)(cid:37)(cid:16)(cid:34)(cid:33,Unknown,18223.0
Unknown,Unknown,11,Unknown,Unknown,Unknown,Unknown,cid:12)(cid:29)(cid:26)(cid:41)(cid:25)(cid:2)(cid:58)(cid:58)(cid:37)(cid:16)(cid:34)(cid:33,Unknown,18234.0
Unknown,Unknown,4,Unknown,Unknown,Unknown,Unknown,cid:12)(cid:29)(cid:26)(cid:41)(cid:25)(cid:2)(cid:58)(cid:58)(cid:37)(cid:16)(cid:34)(cid:33,Unknown,18238.0
Unknown,Unknown,49,Unknown,Unknown,Unknown,Unknown,cid:12)(cid:29)(cid:26)(cid:41)(cid:25)(cid:2)(cid:58)(cid:58)(cid:37)(cid:16)(cid:34)(cid:33,Unknown,18287.0
Unknown,Unknown,64,Unknown,Unknown,Unknown,Unknown,cid:12)(cid:29)(cid:26)(cid:41)(cid:25)(cid:2)(cid:58)(cid:58)(cid:37)(cid:16)(cid:34)(cid:33,Unknown,18351.0
Unknown,Unknown,10,Unknown,Unknown,Unknown,Unknown,cid:12)(cid:29)(cid:26)(cid:41)(cid:25)(cid:2)(cid:58)(cid:58)(cid:37)(cid:16)(cid:34)(cid:33,Unknown,18361.0
Unknown,Unknown,5,Unknown,Unknown,Unknown,Unknown,cid:12)(cid:29)(cid:26)(cid:41)(cid:25)(cid:2)(cid:58)(cid:58)(cid:37)(cid:16)(cid:34)(cid:33,Unknown,18366.0
Unknown,Unknown,14,Unknown,Unknown,Unknown,Unknown,cid:12)(cid:29)(cid:26)(cid:41)(cid:25)(cid:2)(cid:58)(cid:58)(cid:37)(cid:16)(cid:34)(cid:33,Unknown,18380.0
Unknown,Unknown,2,Unknown,Unknown,Unknown,Unknown,cid:12)(cid:29)(cid:26)(cid:41)(cid:25)(cid:2)(cid:58)(cid:58)(cid:37)(cid:16)(cid:34)(cid:33,Unknown,18382.0
Unknown,Unknown,9,Unknown,Unknown,Unknown,Unknown,cid:12)(cid:29)(cid:26)(cid:41)(cid:25)(cid:2)(cid:58)(cid:58)(cid:37)(cid:16)(cid:34)(cid:33,Unknown,18391.0
Unknown,Unknown,66,Unknown,Unknown,Unknown,Unknown,cid:12)(cid:29)(cid:26)(cid:41)(cid:25)(cid:2)(cid:58)(cid:58)(cid:37)(cid:16)(cid:34)(cid:33,Unknown,18457.0
Unknown,Unknown,7,Unknown,Unknown,Unknown,Unknown,cid:12)(cid:29)(cid:26)(cid:41)(cid:25)(cid:2)(cid:58)(cid:58)(cid:37)(cid:16)(cid:34)(cid:33,Unknown,18464.0
Unknown,Unknown,2,Unknown,Unknown,Unknown,Unknown,cid:12)(cid:29)(cid:26)(cid:41)(cid:25)(cid:2)(cid:58)(cid:58)(cid:37)(cid:16)(cid:34)(cid:33,Unknown,18466.0
Unknown,Unknown,48,Unknown,Unknown,Unknown,Unknown,cid:12)(cid:29)(cid:26)(cid:41)(cid:25)(cid:2)(cid:58)(cid:58)(cid:37)(cid:16)(cid:34)(cid:33,Unknown,18514.0
Unknown,Unknown,5,Unknown,Unknown,Unknown,Unknown,cid:12)(cid:29)(cid:26)(cid:41)(cid:25)(cid:2)(cid:58)(cid:58)(cid:37)(cid:16)(cid:34)(cid:33,Unknown,18519.0
Unknown,Unknown,4,Unknown,Unknown,Unknown,Unknown,cid:12)(cid:29)(cid:26)(cid:41)(cid:25)(cid:2)(cid:58)(cid:58)(cid:37)(cid:16)(cid:34)(cid:33,Unknown,18523.0
Unknown,Unknown,50,Unknown,Unknown,Unknown,Unknown,cid:12)(cid:29)(cid:26)(cid:41)(cid:25)(cid:2)(cid:58)(cid:58)(cid:37)(cid:16)(cid:34)(cid:33,Unknown,18573.0
Unknown,Unknown,11,Unknown,Unknown,Unknown,Unknown,cid:12)(cid:29)(cid:26)(cid:41)(cid:25)(cid:2)(cid:58)(cid:58)(cid:37)(cid:16)(cid:34)(cid:33,Unknown,18584.0
Unknown,Unknown,8,Unknown,Unknown,Unknown,Unknown,cid:12)(cid:29)(cid:26)(cid:41)(cid:25)(cid:2)(cid:58)(cid:58)(cid:37)(cid:16)(cid:34)(cid:33,Unknown,18592.0
Unknown,Unknown,2,Unknown,Unknown,Unknown,Unknown,cid:12)(cid:29)(cid:26)(cid:41)(cid:25)(cid:2)(cid:58)(cid:58)(cid:37)(cid:16)(cid:34)(cid:33,Unknown,18594.0
Unknown,Unknown,14,Unknown,Unknown,Unknown,Unknown,cid:12)(cid:29)(cid:26)(cid:41)(cid:25)(cid:2)(cid:58)(cid:58)(cid:37)(cid:16)(cid:34)(cid:33,Unknown,18608.0
Unknown,Unknown,46,Unknown,Unknown,Unknown,Unknown,cid:12)(cid:29)(cid:26)(cid:41)(cid:25)(cid:2)(cid:58)(cid:58)(cid:37)(cid:16)(cid:34)(cid:33,Unknown,18654.0
Unknown,Unknown,2,Unknown,Unknown,Unknown,Unknown,cid:12)(cid:29)(cid:26)(cid:41)(cid:25)(cid:2)(cid:58)(cid:58)(cid:37)(cid:16)(cid:34)(cid:33,Unknown,18656.0
Unknown,Unknown,28,Unknown,Unknown,Unknown,Unknown,cid:12)(cid:29)(cid:26)(cid:41)(cid:25)(cid:2)(cid:58)(cid:58)(cid:37)(cid:16)(cid:34)(cid:33,Unknown,18684.0
Unknown,Unknown,11,Unknown,Unknown,Unknown,Unknown,cid:12)(cid:29)(cid:26)(cid:41)(cid:25)(cid:2)(cid:58)(cid:58)(cid:37)(cid:16)(cid:34)(cid:33,Unknown,18695.0
Unknown,Unknown,3,Unknown,Unknown,Unknown,Unknown,cid:12)(cid:29)(cid:26)(cid:41)(cid:25)(cid:2)(cid:58)(cid:58)(cid:37)(cid:16)(cid:34)(cid:33,Unknown,18698.0
Unknown,Unknown,2,Unknown,Unknown,Unknown,Unknown,cid:12)(cid:29)(cid:26)(cid:41)(cid:25)(cid:2)(cid:58)(cid:58)(cid:37)(cid:16)(cid:34)(cid:33,Unknown,18700.0
Unknown,Unknown,28,Unknown,Unknown,Unknown,Unknown,cid:12)(cid:29)(cid:26)(cid:41)(cid:25)(cid:2)(cid:58)(cid:58)(cid:37)(cid:16)(cid:34)(cid:33,Unknown,18728.0
Unknown,Unknown,3,Unknown,Unknown,Unknown,Unknown,cid:12)(cid:29)(cid:26)(cid:41)(cid:25)(cid:2)(cid:58)(cid:58)(cid:37)(cid:16)(cid:34)(cid:33,Unknown,18731.0
Unknown,Unknown,15,Unknown,Unknown,Unknown,Unknown,cid:12)(cid:29)(cid:26)(cid:41)(cid:25)(cid:2)(cid:58)(cid:58)(cid:37)(cid:16)(cid:34)(cid:33,Unknown,18746.0
Unknown,Unknown,2,Unknown,Unknown,Unknown,Unknown,cid:12)(cid:29)(cid:26)(cid:41)(cid:25)(cid:2)(cid:58)(cid:58)(cid:37)(cid:16)(cid:34)(cid:33,Unknown,18748.0
Unknown,Unknown,37,Unknown,Unknown,Unknown,Unknown,cid:12)(cid:29)(cid:26)(cid:41)(cid:25)(cid:2)(cid:58)(cid:58)(cid:37)(cid:16)(cid:34)(cid:33,Unknown,18785.0
Unknown,Unknown,33,Unknown,Unknown,Unknown,Unknown,cid:12)(cid:29)(cid:26)(cid:41)(cid:25)(cid:2)(cid:58)(cid:58)(cid:37)(cid:16)(cid:34)(cid:33,Unknown,18818.0
Unknown,Unknown,19,Unknown,Unknown,Unknown,Unknown,cid:12)(cid:29)(cid:26)(cid:41)(cid:25)(cid:2)(cid:58)(cid:58)(cid:37)(cid:16)(cid:34)(cid:33,Unknown,18837.0
Unknown,Unknown,33,Unknown,Unknown,Unknown,Unknown,cid:12)(cid:29)(cid:26)(cid:41)(cid:25)(cid:2)(cid:58)(cid:58)(cid:37)(cid:16)(cid:34)(cid:33,Unknown,18870.0
Unknown,Unknown,33,Unknown,Unknown,Unknown,Unknown,cid:12)(cid:29)(cid:26)(cid:41)(cid:25)(cid:2)(cid:58)(cid:58)(cid:37)(cid:16)(cid:34)(cid:33,Unknown,18903.0
Unknown,Unknown,2,Unknown,Unknown,Unknown,Unknown,cid:12)(cid:29)(cid:26)(cid:41)(cid:25)(cid:2)(cid:58)(cid:58)(cid:37)(cid:16)(cid:34)(cid:33,Unknown,18905.0
Unknown,Unknown,44,Unknown,Unknown,Unknown,Unknown,cid:12)(cid:29)(cid:26)(cid:41)(cid:25)(cid:2)(cid:58)(cid:58)(cid:37)(cid:16)(cid:34)(cid:33,Unknown,18949.0
Unknown,Unknown,12,Unknown,Unknown,Unknown,Unknown,cid:12)(cid:29)(cid:26)(cid:41)(cid:25)(cid:2)(cid:58)(cid:58)(cid:37)(cid:16)(cid:34)(cid:33,Unknown,18961.0
Unknown,Unknown,29,Unknown,Unknown,Unknown,Unknown,cid:12)(cid:29)(cid:26)(cid:41)(cid:25)(cid:2)(cid:58)(cid:58)(cid:37)(cid:16)(cid:34)(cid:33,Unknown,18990.0
Unknown,Unknown,26,Unknown,Unknown,Unknown,Unknown,cid:12)(cid:29)(cid:26)(cid:41)(cid:25)(cid:2)(cid:58)(cid:58)(cid:37)(cid:16)(cid:34)(cid:33,Unknown,19016.0
Unknown,Unknown,41,Unknown,Unknown,Unknown,Unknown,cid:12)(cid:29)(cid:26)(cid:41)(cid:25)(cid:2)(cid:58)(cid:58)(cid:37)(cid:16)(cid:34)(cid:33,Unknown,19057.0
Unknown,Unknown,25,Unknown,Unknown,Unknown,Unknown,cid:12)(cid:29)(cid:26)(cid:41)(cid:25)(cid:2)(cid:58)(cid:58)(cid:37)(cid:16)(cid:34)(cid:33,Unknown,19082.0
Unknown,Unknown,2,Unknown,Unknown,Unknown,Unknown,cid:12)(cid:29)(cid:26)(cid:41)(cid:25)(cid:2)(cid:58)(cid:58)(cid:37)(cid:16)(cid:34)(cid:33,Unknown,19084.0
Unknown,Unknown,58,Unknown,Unknown,Unknown,Unknown,cid:12)(cid:29)(cid:26)(cid:41)(cid:25)(cid:2)(cid:58)(cid:58)(cid:37)(cid:16)(cid:34)(cid:33,Unknown,19142.0
Unknown,Unknown,58,Unknown,Unknown,Unknown,Unknown,cid:12)(cid:29)(cid:26)(cid:41)(cid:25)(cid:2)(cid:58)(cid:58)(cid:37)(cid:16)(cid:34)(cid:33,Unknown,19200.0
Unknown,Unknown,37,Unknown,Unknown,Unknown,Unknown,cid:12)(cid:29)(cid:26)(cid:41)(cid:25)(cid:2)(cid:58)(cid:58)(cid:37)(cid:16)(cid:34)(cid:33,Unknown,19237.0
Unknown,Unknown,16,Unknown,Unknown,Unknown,Unknown,cid:12)(cid:29)(cid:26)(cid:41)(cid:25)(cid:2)(cid:58)(cid:58)(cid:37)(cid:16)(cid:34)(cid:33,Unknown,19253.0
Unknown,Unknown,34,Unknown,Unknown,Unknown,Unknown,cid:12)(cid:29)(cid:26)(cid:41)(cid:25)(cid:2)(cid:58)(cid:58)(cid:37)(cid:16)(cid:34)(cid:33,Unknown,19287.0
Unknown,Unknown,33,Unknown,Unknown,Unknown,Unknown,cid:12)(cid:29)(cid:26)(cid:41)(cid:25)(cid:2)(cid:58)(cid:58)(cid:37)(cid:16)(cid:34)(cid:33,Unknown,19320.0
Unknown,Unknown,1,Unknown,Unknown,Unknown,Unknown,cid:12)(cid:29)(cid:26)(cid:41)(cid:25)(cid:2)(cid:58)(cid:58)(cid:37)(cid:16)(cid:34)(cid:33,Unknown,19321.0
Unknown,Unknown,16,Unknown,Unknown,Unknown,Unknown,cid:12)(cid:29)(cid:26)(cid:41)(cid:25)(cid:2)(cid:58)(cid:58)(cid:37)(cid:16)(cid:34)(cid:33,Unknown,19337.0
Unknown,Unknown,45,Unknown,Unknown,Unknown,Unknown,cid:12)(cid:29)(cid:26)(cid:41)(cid:25)(cid:2)(cid:58)(cid:58)(cid:37)(cid:16)(cid:34)(cid:33,Unknown,19382.0
Unknown,Unknown,18,Unknown,Unknown,Unknown,Unknown,cid:12)(cid:29)(cid:26)(cid:41)(cid:25)(cid:2)(cid:58)(cid:58)(cid:37)(cid:16)(cid:34)(cid:33,Unknown,19400.0
Unknown,Unknown,16,Unknown,Unknown,Unknown,Unknown,cid:12)(cid:29)(cid:26)(cid:41)(cid:25)(cid:2)(cid:58)(cid:58)(cid:37)(cid:16)(cid:34)(cid:33,Unknown,19416.0
Unknown,Unknown,47,Unknown,Unknown,Unknown,Unknown,cid:12)(cid:29)(cid:26)(cid:41)(cid:25)(cid:2)(cid:58)(cid:58)(cid:37)(cid:16)(cid:34)(cid:33,Unknown,19463.0
Unknown,Unknown,11,Unknown,Unknown,Unknown,Unknown,cid:12)(cid:29)(cid:26)(cid:41)(cid:25)(cid:2)(cid:58)(cid:58)(cid:37)(cid:16)(cid:34)(cid:33,Unknown,19474.0
Unknown,Unknown,4,Unknown,Unknown,Unknown,Unknown,cid:12)(cid:29)(cid:26)(cid:41)(cid:25)(cid:2)(cid:58)(cid:58)(cid:37)(cid:16)(cid:34)(cid:33,Unknown,19478.0
Unknown,Unknown,49,Unknown,Unknown,Unknown,Unknown,cid:12)(cid:29)(cid:26)(cid:41)(cid:25)(cid:2)(cid:58)(cid:58)(cid:37)(cid:16)(cid:34)(cid:33,Unknown,19527.0
Unknown,Unknown,64,Unknown,Unknown,Unknown,Unknown,cid:12)(cid:29)(cid:26)(cid:41)(cid:25)(cid:2)(cid:58)(cid:58)(cid:37)(cid:16)(cid:34)(cid:33,Unknown,19591.0
Unknown,Unknown,10,Unknown,Unknown,Unknown,Unknown,cid:12)(cid:29)(cid:26)(cid:41)(cid:25)(cid:2)(cid:58)(cid:58)(cid:37)(cid:16)(cid:34)(cid:33,Unknown,19601.0
Unknown,Unknown,5,Unknown,Unknown,Unknown,Unknown,cid:12)(cid:29)(cid:26)(cid:41)(cid:25)(cid:2)(cid:58)(cid:58)(cid:37)(cid:16)(cid:34)(cid:33,Unknown,19606.0
Unknown,Unknown,14,Unknown,Unknown,Unknown,Unknown,cid:12)(cid:29)(cid:26)(cid:41)(cid:25)(cid:2)(cid:58)(cid:58)(cid:37)(cid:16)(cid:34)(cid:33,Unknown,19620.0
Unknown,Unknown,2,Unknown,Unknown,Unknown,Unknown,cid:12)(cid:29)(cid:26)(cid:41)(cid:25)(cid:2)(cid:58)(cid:58)(cid:37)(cid:16)(cid:34)(cid:33,Unknown,19622.0
Unknown,Unknown,9,Unknown,Unknown,Unknown,Unknown,cid:12)(cid:29)(cid:26)(cid:41)(cid:25)(cid:2)(cid:58)(cid:58)(cid:37)(cid:16)(cid:34)(cid:33,Unknown,19631.0
Unknown,Unknown,66,Unknown,Unknown,Unknown,Unknown,cid:12)(cid:29)(cid:26)(cid:41)(cid:25)(cid:2)(cid:58)(cid:58)(cid:37)(cid:16)(cid:34)(cid:33,Unknown,19697.0
Unknown,Unknown,7,Unknown,Unknown,Unknown,Unknown,cid:12)(cid:29)(cid:26)(cid:41)(cid:25)(cid:2)(cid:58)(cid:58)(cid:37)(cid:16)(cid:34)(cid:33,Unknown,19704.0
Unknown,Unknown,2,Unknown,Unknown,Unknown,Unknown,cid:12)(cid:29)(cid:26)(cid:41)(cid:25)(cid:2)(cid:58)(cid:58)(cid:37)(cid:16)(cid:34)(cid:33,Unknown,19706.0
Unknown,Unknown,48,Unknown,Unknown,Unknown,Unknown,cid:12)(cid:29)(cid:26)(cid:41)(cid:25)(cid:2)(cid:58)(cid:58)(cid:37)(cid:16)(cid:34)(cid:33,Unknown,19754.0
Unknown,Unknown,5,Unknown,Unknown,Unknown,Unknown,cid:12)(cid:29)(cid:26)(cid:41)(cid:25)(cid:2)(cid:58)(cid:58)(cid:37)(cid:16)(cid:34)(cid:33,Unknown,19759.0
Unknown,Unknown,4,Unknown,Unknown,Unknown,Unknown,cid:12)(cid:29)(cid:26)(cid:41)(cid:25)(cid:2)(cid:58)(cid:58)(cid:37)(cid:16)(cid:34)(cid:33,Unknown,19763.0
Unknown,Unknown,50,Unknown,Unknown,Unknown,Unknown,cid:12)(cid:29)(cid:26)(cid:41)(cid:25)(cid:2)(cid:58)(cid:58)(cid:37)(cid:16)(cid:34)(cid:33,Unknown,19813.0
Unknown,Unknown,11,Unknown,Unknown,Unknown,Unknown,cid:12)(cid:29)(cid:26)(cid:41)(cid:25)(cid:2)(cid:58)(cid:58)(cid:37)(cid:16)(cid:34)(cid:33,Unknown,19824.0
Unknown,Unknown,8,Unknown,Unknown,Unknown,Unknown,cid:12)(cid:29)(cid:26)(cid:41)(cid:25)(cid:2)(cid:58)(cid:58)(cid:37)(cid:16)(cid:34)(cid:33,Unknown,19832.0
Unknown,Unknown,2,Unknown,Unknown,Unknown,Unknown,cid:12)(cid:29)(cid:26)(cid:41)(cid:25)(cid:2)(cid:58)(cid:58)(cid:37)(cid:16)(cid:34)(cid:33,Unknown,19834.0
Unknown,Unknown,14,Unknown,Unknown,Unknown,Unknown,cid:12)(cid:29)(cid:26)(cid:41)(cid:25)(cid:2)(cid:58)(cid:58)(cid:37)(cid:16)(cid:34)(cid:33,Unknown,19848.0
Unknown,Unknown,46,Unknown,Unknown,Unknown,Unknown,cid:12)(cid:29)(cid:26)(cid:41)(cid:25)(cid:2)(cid:58)(cid:58)(cid:37)(cid:16)(cid:34)(cid:33,Unknown,19894.0
Unknown,Unknown,2,Unknown,Unknown,Unknown,Unknown,cid:12)(cid:29)(cid:26)(cid:41)(cid:25)(cid:2)(cid:58)(cid:58)(cid:37)(cid:16)(cid:34)(cid:33,Unknown,19896.0
Unknown,Unknown,28,Unknown,Unknown,Unknown,Unknown,cid:12)(cid:29)(cid:26)(cid:41)(cid:25)(cid:2)(cid:58)(cid:58)(cid:37)(cid:16)(cid:34)(cid:33,Unknown,19924.0
Unknown,Unknown,11,Unknown,Unknown,Unknown,Unknown,cid:12)(cid:29)(cid:26)(cid:41)(cid:25)(cid:2)(cid:58)(cid:58)(cid:37)(cid:16)(cid:34)(cid:33,Unknown,19935.0
Unknown,Unknown,3,Unknown,Unknown,Unknown,Unknown,cid:12)(cid:29)(cid:26)(cid:41)(cid:25)(cid:2)(cid:58)(cid:58)(cid:37)(cid:16)(cid:34)(cid:33,Unknown,19938.0
Unknown,Unknown,2,Unknown,Unknown,Unknown,Unknown,cid:12)(cid:29)(cid:26)(cid:41)(cid:25)(cid:2)(cid:58)(cid:58)(cid:37)(cid:16)(cid:34)(cid:33,Unknown,19940.0
Unknown,Unknown,28,Unknown,Unknown,Unknown,Unknown,cid:12)(cid:29)(cid:26)(cid:41)(cid:25)(cid:2)(cid:58)(cid:58)(cid:37)(cid:16)(cid:34)(cid:33,Unknown,19968.0
Unknown,Unknown,3,Unknown,Unknown,Unknown,Unknown,cid:12)(cid:29)(cid:26)(cid:41)(cid:25)(cid:2)(cid:58)(cid:58)(cid:37)(cid:16)(cid:34)(cid:33,Unknown,19971.0
Unknown,Unknown,15,Unknown,Unknown,Unknown,Unknown,cid:12)(cid:29)(cid:26)(cid:41)(cid:25)(cid:2)(cid:58)(cid:58)(cid:37)(cid:16)(cid:34)(cid:33,Unknown,19986.0
Unknown,Unknown,2,Unknown,Unknown,Unknown,Unknown,cid:12)(cid:29)(cid:26)(cid:41)(cid:25)(cid:2)(cid:58)(cid:58)(cid:37)(cid:16)(cid:34)(cid:33,Unknown,19988.0
Unknown,Unknown,16,Unknown,Unknown,Unknown,Unknown,cid:12)(cid:29)(cid:26)(cid:41)(cid:25)(cid:2)(cid:58)(cid:58)(cid:37)(cid:16)(cid:34)(cid:33,Unknown,20004.0
Unknown,Unknown,18,Unknown,Unknown,Unknown,Unknown,cid:12)(cid:29)(cid:26)(cid:41)(cid:25)(cid:2)(cid:58)(cid:58)(cid:37)(cid:16)(cid:34)(cid:33,Unknown,20022.0
Unknown,Unknown,19,Unknown,Unknown,Unknown,Unknown,cid:12)(cid:29)(cid:26)(cid:41)(cid:25)(cid:2)(cid:58)(cid:58)(cid:37)(cid:16)(cid:34)(cid:33,Unknown,20041.0
Unknown,Unknown,33,Unknown,Unknown,Unknown,Unknown,cid:12)(cid:29)(cid:26)(cid:41)(cid:25)(cid:2)(cid:58)(cid:58)(cid:37)(cid:16)(cid:34)(cid:33,Unknown,20074.0
Unknown,Unknown,33,Unknown,Unknown,Unknown,Unknown,cid:12)(cid:29)(cid:26)(cid:41)(cid:25)(cid:2)(cid:58)(cid:58)(cid:37)(cid:16)(cid:34)(cid:33,Unknown,20107.0
Unknown,Unknown,2,Unknown,Unknown,Unknown,Unknown,cid:12)(cid:29)(cid:26)(cid:41)(cid:25)(cid:2)(cid:58)(cid:58)(cid:37)(cid:16)(cid:34)(cid:33,Unknown,20109.0
Unknown,Unknown,44,Unknown,Unknown,Unknown,Unknown,cid:12)(cid:29)(cid:26)(cid:41)(cid:25)(cid:2)(cid:58)(cid:58)(cid:37)(cid:16)(cid:34)(cid:33,Unknown,20153.0
Unknown,Unknown,12,Unknown,Unknown,Unknown,Unknown,cid:12)(cid:29)(cid:26)(cid:41)(cid:25)(cid:2)(cid:58)(cid:58)(cid:37)(cid:16)(cid:34)(cid:33,Unknown,20165.0
Unknown,Unknown,29,Unknown,Unknown,Unknown,Unknown,cid:12)(cid:29)(cid:26)(cid:41)(cid:25)(cid:2)(cid:58)(cid:58)(cid:37)(cid:16)(cid:34)(cid:33,Unknown,20194.0
Unknown,Unknown,26,Unknown,Unknown,Unknown,Unknown,cid:12)(cid:29)(cid:26)(cid:41)(cid:25)(cid:2)(cid:58)(cid:58)(cid:37)(cid:16)(cid:34)(cid:33,Unknown,20220.0
Unknown,Unknown,41,Unknown,Unknown,Unknown,Unknown,cid:12)(cid:29)(cid:26)(cid:41)(cid:25)(cid:2)(cid:58)(cid:58)(cid:37)(cid:16)(cid:34)(cid:33,Unknown,20261.0
Unknown,Unknown,25,Unknown,Unknown,Unknown,Unknown,cid:12)(cid:29)(cid:26)(cid:41)(cid:25)(cid:2)(cid:58)(cid:58)(cid:37)(cid:16)(cid:34)(cid:33,Unknown,20286.0
Unknown,Unknown,2,Unknown,Unknown,Unknown,Unknown,cid:12)(cid:29)(cid:26)(cid:41)(cid:25)(cid:2)(cid:58)(cid:58)(cid:37)(cid:16)(cid:34)(cid:33,Unknown,20288.0
Unknown,Unknown,58,Unknown,Unknown,Unknown,Unknown,cid:12)(cid:29)(cid:26)(cid:41)(cid:25)(cid:2)(cid:58)(cid:58)(cid:37)(cid:16)(cid:34)(cid:33,Unknown,20346.0
Unknown,Unknown,58,Unknown,Unknown,Unknown,Unknown,cid:12)(cid:29)(cid:26)(cid:41)(cid:25)(cid:2)(cid:58)(cid:58)(cid:37)(cid:16)(cid:34)(cid:33,Unknown,20404.0
Unknown,Unknown,37,Unknown,Unknown,Unknown,Unknown,cid:12)(cid:29)(cid:26)(cid:41)(cid:25)(cid:2)(cid:58)(cid:58)(cid:37)(cid:16)(cid:34)(cid:33,Unknown,20441.0
Unknown,Unknown,16,Unknown,Unknown,Unknown,Unknown,cid:12)(cid:29)(cid:26)(cid:41)(cid:25)(cid:2)(cid:58)(cid:58)(cid:37)(cid:16)(cid:34)(cid:33,Unknown,20457.0
Unknown,Unknown,34,Unknown,Unknown,Unknown,Unknown,cid:12)(cid:29)(cid:26)(cid:41)(cid:25)(cid:2)(cid:58)(cid:58)(cid:37)(cid:16)(cid:34)(cid:33,Unknown,20491.0
Unknown,Unknown,33,Unknown,Unknown,Unknown,Unknown,cid:12)(cid:29)(cid:26)(cid:41)(cid:25)(cid:2)(cid:58)(cid:58)(cid:37)(cid:16)(cid:34)(cid:33,Unknown,20524.0
Unknown,Unknown,1,Unknown,Unknown,Unknown,Unknown,cid:12)(cid:29)(cid:26)(cid:41)(cid:25)(cid:2)(cid:58)(cid:58)(cid:37)(cid:16)(cid:34)(cid:33,Unknown,20525.0
Unknown,Unknown,16,Unknown,Unknown,Unknown,Unknown,cid:12)(cid:29)(cid:26)(cid:41)(cid:25)(cid:2)(cid:58)(cid:58)(cid:37)(cid:16)(cid:34)(cid:33,Unknown,20541.0
Unknown,Unknown,45,Unknown,Unknown,Unknown,Unknown,cid:12)(cid:29)(cid:26)(cid:41)(cid:25)(cid:2)(cid:58)(cid:58)(cid:37)(cid:16)(cid:34)(cid:33,Unknown,20586.0
Unknown,Unknown,18,Unknown,Unknown,Unknown,Unknown,cid:12)(cid:29)(cid:26)(cid:41)(cid:25)(cid:2)(cid:58)(cid:58)(cid:37)(cid:16)(cid:34)(cid:33,Unknown,20604.0
Unknown,Unknown,16,Unknown,Unknown,Unknown,Unknown,cid:12)(cid:29)(cid:26)(cid:41)(cid:25)(cid:2)(cid:58)(cid:58)(cid:37)(cid:16)(cid:34)(cid:33,Unknown,20620.0
Unknown,Unknown,47,Unknown,Unknown,Unknown,Unknown,cid:12)(cid:29)(cid:26)(cid:41)(cid:25)(cid:2)(cid:58)(cid:58)(cid:37)(cid:16)(cid:34)(cid:33,Unknown,20667.0
Unknown,Unknown,11,Unknown,Unknown,Unknown,Unknown,cid:12)(cid:29)(cid:26)(cid:41)(cid:25)(cid:2)(cid:58)(cid:58)(cid:37)(cid:16)(cid:34)(cid:33,Unknown,20678.0
Unknown,Unknown,4,Unknown,Unknown,Unknown,Unknown,cid:12)(cid:29)(cid:26)(cid:41)(cid:25)(cid:2)(cid:58)(cid:58)(cid:37)(cid:16)(cid:34)(cid:33,Unknown,20682.0
Unknown,Unknown,49,Unknown,Unknown,Unknown,Unknown,cid:12)(cid:29)(cid:26)(cid:41)(cid:25)(cid:2)(cid:58)(cid:58)(cid:37)(cid:16)(cid:34)(cid:33,Unknown,20731.0
Unknown,Unknown,64,Unknown,Unknown,Unknown,Unknown,cid:12)(cid:29)(cid:26)(cid:41)(cid:25)(cid:2)(cid:58)(cid:58)(cid:37)(cid:16)(cid:34)(cid:33,Unknown,20795.0
Unknown,Unknown,10,Unknown,Unknown,Unknown,Unknown,cid:12)(cid:29)(cid:26)(cid:41)(cid:25)(cid:2)(cid:58)(cid:58)(cid:37)(cid:16)(cid:34)(cid:33,Unknown,20805.0
Unknown,Unknown,5,Unknown,Unknown,Unknown,Unknown,cid:12)(cid:29)(cid:26)(cid:41)(cid:25)(cid:2)(cid:58)(cid:58)(cid:37)(cid:16)(cid:34)(cid:33,Unknown,20810.0
Unknown,Unknown,14,Unknown,Unknown,Unknown,Unknown,cid:12)(cid:29)(cid:26)(cid:41)(cid:25)(cid:2)(cid:58)(cid:58)(cid:37)(cid:16)(cid:34)(cid:33,Unknown,20824.0
Unknown,Unknown,2,Unknown,Unknown,Unknown,Unknown,cid:12)(cid:29)(cid:26)(cid:41)(cid:25)(cid:2)(cid:58)(cid:58)(cid:37)(cid:16)(cid:34)(cid:33,Unknown,20826.0
Unknown,Unknown,9,Unknown,Unknown,Unknown,Unknown,cid:12)(cid:29)(cid:26)(cid:41)(cid:25)(cid:2)(cid:58)(cid:58)(cid:37)(cid:16)(cid:34)(cid:33,Unknown,20835.0
Unknown,Unknown,66,Unknown,Unknown,Unknown,Unknown,cid:12)(cid:29)(cid:26)(cid:41)(cid:25)(cid:2)(cid:58)(cid:58)(cid:37)(cid:16)(cid:34)(cid:33,Unknown,20901.0
Unknown,Unknown,7,Unknown,Unknown,Unknown,Unknown,cid:12)(cid:29)(cid:26)(cid:41)(cid:25)(cid:2)(cid:58)(cid:58)(cid:37)(cid:16)(cid:34)(cid:33,Unknown,20908.0
Unknown,Unknown,2,Unknown,Unknown,Unknown,Unknown,cid:12)(cid:29)(cid:26)(cid:41)(cid:25)(cid:2)(cid:58)(cid:58)(cid:37)(cid:16)(cid:34)(cid:33,Unknown,20910.0
Unknown,Unknown,48,Unknown,Unknown,Unknown,Unknown,cid:12)(cid:29)(cid:26)(cid:41)(cid:25)(cid:2)(cid:58)(cid:58)(cid:37)(cid:16)(cid:34)(cid:33,Unknown,20958.0
Unknown,Unknown,5,Unknown,Unknown,Unknown,Unknown,cid:12)(cid:29)(cid:26)(cid:41)(cid:25)(cid:2)(cid:58)(cid:58)(cid:37)(cid:16)(cid:34)(cid:33,Unknown,20963.0
Unknown,Unknown,4,Unknown,Unknown,Unknown,Unknown,cid:12)(cid:29)(cid:26)(cid:41)(cid:25)(cid:2)(cid:58)(cid:58)(cid:37)(cid:16)(cid:34)(cid:33,Unknown,20967.0
Unknown,Unknown,50,Unknown,Unknown,Unknown,Unknown,cid:12)(cid:29)(cid:26)(cid:41)(cid:25)(cid:2)(cid:58)(cid:58)(cid:37)(cid:16)(cid:34)(cid:33,Unknown,21017.0
Unknown,Unknown,11,Unknown,Unknown,Unknown,Unknown,cid:12)(cid:29)(cid:26)(cid:41)(cid:25)(cid:2)(cid:58)(cid:58)(cid:37)(cid:16)(cid:34)(cid:33,Unknown,21028.0
Unknown,Unknown,8,Unknown,Unknown,Unknown,Unknown,cid:12)(cid:29)(cid:26)(cid:41)(cid:25)(cid:2)(cid:58)(cid:58)(cid:37)(cid:16)(cid:34)(cid:33,Unknown,21036.0
Unknown,Unknown,2,Unknown,Unknown,Unknown,Unknown,cid:12)(cid:29)(cid:26)(cid:41)(cid:25)(cid:2)(cid:58)(cid:58)(cid:37)(cid:16)(cid:34)(cid:33,Unknown,21038.0
Unknown,Unknown,14,Unknown,Unknown,Unknown,Unknown,cid:12)(cid:29)(cid:26)(cid:41)(cid:25)(cid:2)(cid:58)(cid:58)(cid:37)(cid:16)(cid:34)(cid:33,Unknown,21052.0
Unknown,Unknown,46,Unknown,Unknown,Unknown,Unknown,cid:12)(cid:29)(cid:26)(cid:41)(cid:25)(cid:2)(cid:58)(cid:58)(cid:37)(cid:16)(cid:34)(cid:33,Unknown,21098.0
Unknown,Unknown,2,Unknown,Unknown,Unknown,Unknown,cid:12)(cid:29)(cid:26)(cid:41)(cid:25)(cid:2)(cid:58)(cid:58)(cid:37)(cid:16)(cid:34)(cid:33,Unknown,21100.0
Unknown,Unknown,28,Unknown,Unknown,Unknown,Unknown,cid:12)(cid:29)(cid:26)(cid:41)(cid:25)(cid:2)(cid:58)(cid:58)(cid:37)(cid:16)(cid:34)(cid:33,Unknown,21128.0
Unknown,Unknown,11,Unknown,Unknown,Unknown,Unknown,cid:12)(cid:29)(cid:26)(cid:41)(cid:25)(cid:2)(cid:58)(cid:58)(cid:37)(cid:16)(cid:34)(cid:33,Unknown,21139.0
Unknown,Unknown,3,Unknown,Unknown,Unknown,Unknown,cid:12)(cid:29)(cid:26)(cid:41)(cid:25)(cid:2)(cid:58)(cid:58)(cid:37)(cid:16)(cid:34)(cid:33,Unknown,21142.0
Unknown,Unknown,2,Unknown,Unknown,Unknown,Unknown,cid:12)(cid:29)(cid:26)(cid:41)(cid:25)(cid:2)(cid:58)(cid:58)(cid:37)(cid:16)(cid:34)(cid:33,Unknown,21144.0
Unknown,Unknown,28,Unknown,Unknown,Unknown,Unknown,cid:12)(cid:29)(cid:26)(cid:41)(cid:25)(cid:2)(cid:58)(cid:58)(cid:37)(cid:16)(cid:34)(cid:33,Unknown,21172.0
Unknown,Unknown,3,Unknown,Unknown,Unknown,Unknown,cid:12)(cid:29)(cid:26)(cid:41)(cid:25)(cid:2)(cid:58)(cid:58)(cid:37)(cid:16)(cid:34)(cid:33,Unknown,21175.0
Unknown,Unknown,15,Unknown,Unknown,Unknown,Unknown,cid:12)(cid:29)(cid:26)(cid:41)(cid:25)(cid:2)(cid:58)(cid:58)(cid:37)(cid:16)(cid:34)(cid:33,Unknown,21190.0
Unknown,Unknown,2,Unknown,Unknown,Unknown,Unknown,cid:12)(cid:29)(cid:26)(cid:41)(cid:25)(cid:2)(cid:58)(cid:58)(cid:37)(cid:16)(cid:34)(cid:33,Unknown,21192.0
Unknown,Unknown,35,Unknown,Unknown,Unknown,Unknown,cid:12)(cid:29)(cid:26)(cid:41)(cid:25)(cid:2)(cid:58)(cid:58)(cid:37)(cid:16)(cid:34)(cid:33,Unknown,21227.0
Unknown,Unknown,37,Unknown,Unknown,Unknown,Unknown,cid:12)(cid:29)(cid:26)(cid:41)(cid:25)(cid:2)(cid:58)(cid:58)(cid:37)(cid:16)(cid:34)(cid:33,Unknown,21264.0
Unknown,Unknown,19,Unknown,Unknown,Unknown,Unknown,cid:12)(cid:29)(cid:26)(cid:41)(cid:25)(cid:2)(cid:58)(cid:58)(cid:37)(cid:16)(cid:34)(cid:33,Unknown,21283.0
Unknown,Unknown,1,Unknown,Unknown,Unknown,Unknown,cid:12)(cid:29)(cid:26)(cid:41)(cid:25)(cid:2)(cid:58)(cid:58)(cid:37)(cid:16)(cid:34)(cid:33,Unknown,21284.0
Unknown,Unknown,18,Unknown,Unknown,Unknown,Unknown,cid:12)(cid:29)(cid:26)(cid:41)(cid:25)(cid:2)(cid:58)(cid:58)(cid:37)(cid:16)(cid:34)(cid:33,Unknown,21302.0
Unknown,Unknown,2,Unknown,Unknown,Unknown,Unknown,cid:12)(cid:29)(cid:26)(cid:41)(cid:25)(cid:2)(cid:58)(cid:58)(cid:37)(cid:16)(cid:34)(cid:33,Unknown,21304.0
Unknown,Unknown,44,Unknown,Unknown,Unknown,Unknown,cid:12)(cid:29)(cid:26)(cid:41)(cid:25)(cid:2)(cid:58)(cid:58)(cid:37)(cid:16)(cid:34)(cid:33,Unknown,21348.0
Unknown,Unknown,12,Unknown,Unknown,Unknown,Unknown,cid:12)(cid:29)(cid:26)(cid:41)(cid:25)(cid:2)(cid:58)(cid:58)(cid:37)(cid:16)(cid:34)(cid:33,Unknown,21360.0
Unknown,Unknown,29,Unknown,Unknown,Unknown,Unknown,cid:12)(cid:29)(cid:26)(cid:41)(cid:25)(cid:2)(cid:58)(cid:58)(cid:37)(cid:16)(cid:34)(cid:33,Unknown,21389.0
Unknown,Unknown,26,Unknown,Unknown,Unknown,Unknown,cid:12)(cid:29)(cid:26)(cid:41)(cid:25)(cid:2)(cid:58)(cid:58)(cid:37)(cid:16)(cid:34)(cid:33,Unknown,21415.0
Unknown,Unknown,41,Unknown,Unknown,Unknown,Unknown,cid:12)(cid:29)(cid:26)(cid:41)(cid:25)(cid:2)(cid:58)(cid:58)(cid:37)(cid:16)(cid:34)(cid:33,Unknown,21456.0
Unknown,Unknown,25,Unknown,Unknown,Unknown,Unknown,cid:12)(cid:29)(cid:26)(cid:41)(cid:25)(cid:2)(cid:58)(cid:58)(cid:37)(cid:16)(cid:34)(cid:33,Unknown,21481.0
Unknown,Unknown,2,Unknown,Unknown,Unknown,Unknown,cid:12)(cid:29)(cid:26)(cid:41)(cid:25)(cid:2)(cid:58)(cid:58)(cid:37)(cid:16)(cid:34)(cid:33,Unknown,21483.0
Unknown,Unknown,58,Unknown,Unknown,Unknown,Unknown,cid:12)(cid:29)(cid:26)(cid:41)(cid:25)(cid:2)(cid:58)(cid:58)(cid:37)(cid:16)(cid:34)(cid:33,Unknown,21541.0
Unknown,Unknown,58,Unknown,Unknown,Unknown,Unknown,cid:12)(cid:29)(cid:26)(cid:41)(cid:25)(cid:2)(cid:58)(cid:58)(cid:37)(cid:16)(cid:34)(cid:33,Unknown,21599.0
Unknown,Unknown,37,Unknown,Unknown,Unknown,Unknown,cid:12)(cid:29)(cid:26)(cid:41)(cid:25)(cid:2)(cid:58)(cid:58)(cid:37)(cid:16)(cid:34)(cid:33,Unknown,21636.0
Unknown,Unknown,16,Unknown,Unknown,Unknown,Unknown,cid:12)(cid:29)(cid:26)(cid:41)(cid:25)(cid:2)(cid:58)(cid:58)(cid:37)(cid:16)(cid:34)(cid:33,Unknown,21652.0
Unknown,Unknown,34,Unknown,Unknown,Unknown,Unknown,cid:12)(cid:29)(cid:26)(cid:41)(cid:25)(cid:2)(cid:58)(cid:58)(cid:37)(cid:16)(cid:34)(cid:33,Unknown,21686.0
Unknown,Unknown,33,Unknown,Unknown,Unknown,Unknown,cid:12)(cid:29)(cid:26)(cid:41)(cid:25)(cid:2)(cid:58)(cid:58)(cid:37)(cid:16)(cid:34)(cid:33,Unknown,21719.0
Unknown,Unknown,1,Unknown,Unknown,Unknown,Unknown,cid:12)(cid:29)(cid:26)(cid:41)(cid:25)(cid:2)(cid:58)(cid:58)(cid:37)(cid:16)(cid:34)(cid:33,Unknown,21720.0
Unknown,Unknown,16,Unknown,Unknown,Unknown,Unknown,cid:12)(cid:29)(cid:26)(cid:41)(cid:25)(cid:2)(cid:58)(cid:58)(cid:37)(cid:16)(cid:34)(cid:33,Unknown,21736.0
Unknown,Unknown,45,Unknown,Unknown,Unknown,Unknown,cid:12)(cid:29)(cid:26)(cid:41)(cid:25)(cid:2)(cid:58)(cid:58)(cid:37)(cid:16)(cid:34)(cid:33,Unknown,21781.0
Unknown,Unknown,18,Unknown,Unknown,Unknown,Unknown,cid:12)(cid:29)(cid:26)(cid:41)(cid:25)(cid:2)(cid:58)(cid:58)(cid:37)(cid:16)(cid:34)(cid:33,Unknown,21799.0
Unknown,Unknown,16,Unknown,Unknown,Unknown,Unknown,cid:12)(cid:29)(cid:26)(cid:41)(cid:25)(cid:2)(cid:58)(cid:58)(cid:37)(cid:16)(cid:34)(cid:33,Unknown,21815.0
Unknown,Unknown,14,Unknown,Unknown,Unknown,Unknown,cid:12)(cid:29)(cid:26)(cid:41)(cid:25)(cid:2)(cid:58)(cid:58)(cid:37)(cid:16)(cid:34)(cid:33,Unknown,21829.0
Unknown,Unknown,5,Unknown,Unknown,Unknown,Unknown,cid:12)(cid:29)(cid:26)(cid:41)(cid:25)(cid:2)(cid:58)(cid:58)(cid:37)(cid:16)(cid:34)(cid:33,Unknown,21834.0
Unknown,Unknown,12,Unknown,Unknown,Unknown,Unknown,cid:12)(cid:29)(cid:26)(cid:41)(cid:25)(cid:2)(cid:58)(cid:58)(cid:37)(cid:16)(cid:34)(cid:33,Unknown,21846.0
Unknown,Unknown,14,Unknown,Unknown,Unknown,Unknown,cid:12)(cid:29)(cid:26)(cid:41)(cid:25)(cid:2)(cid:58)(cid:58)(cid:37)(cid:16)(cid:34)(cid:33,Unknown,21860.0
Unknown,Unknown,5,Unknown,Unknown,Unknown,Unknown,cid:12)(cid:29)(cid:26)(cid:41)(cid:25)(cid:2)(cid:58)(cid:58)(cid:37)(cid:16)(cid:34)(cid:33,Unknown,21865.0
Unknown,Unknown,3,Unknown,Unknown,Unknown,Unknown,cid:12)(cid:29)(cid:26)(cid:41)(cid:25)(cid:2)(cid:58)(cid:58)(cid:37)(cid:16)(cid:34)(cid:33,Unknown,21868.0
Unknown,Unknown,12,Unknown,Unknown,Unknown,Unknown,cid:12)(cid:29)(cid:26)(cid:41)(cid:25)(cid:2)(cid:58)(cid:58)(cid:37)(cid:16)(cid:34)(cid:33,Unknown,21880.0
Unknown,Unknown,2,Unknown,Unknown,Unknown,Unknown,cid:12)(cid:29)(cid:26)(cid:41)(cid:25)(cid:2)(cid:58)(cid:58)(cid:37)(cid:16)(cid:34)(cid:33,Unknown,21882.0
Unknown,Unknown,50,Unknown,Unknown,Unknown,Unknown,cid:12)(cid:29)(cid:26)(cid:41)(cid:25)(cid:2)(cid:58)(cid:58)(cid:37)(cid:16)(cid:34)(cid:33,Unknown,21932.0
Unknown,Unknown,7,Unknown,Unknown,Unknown,Unknown,cid:12)(cid:29)(cid:26)(cid:41)(cid:25)(cid:2)(cid:58)(cid:58)(cid:37)(cid:16)(cid:34)(cid:33,Unknown,21939.0
Unknown,Unknown,9,Unknown,Unknown,Unknown,Unknown,cid:12)(cid:29)(cid:26)(cid:41)(cid:25)(cid:2)(cid:58)(cid:58)(cid:37)(cid:16)(cid:34)(cid:33,Unknown,21948.0
Unknown,Unknown,10,Unknown,Unknown,Unknown,Unknown,cid:12)(cid:29)(cid:26)(cid:41)(cid:25)(cid:2)(cid:58)(cid:58)(cid:37)(cid:16)(cid:34)(cid:33,Unknown,21958.0
Unknown,Unknown,3,Unknown,Unknown,Unknown,Unknown,cid:12)(cid:29)(cid:26)(cid:41)(cid:25)(cid:2)(cid:58)(cid:58)(cid:37)(cid:16)(cid:34)(cid:33,Unknown,21961.0
Unknown,Unknown,2,Unknown,Unknown,Unknown,Unknown,cid:12)(cid:29)(cid:26)(cid:41)(cid:25)(cid:2)(cid:58)(cid:58)(cid:37)(cid:16)(cid:34)(cid:33,Unknown,21963.0
Unknown,Unknown,12,Unknown,Unknown,Unknown,Unknown,cid:12)(cid:29)(cid:26)(cid:41)(cid:25)(cid:2)(cid:58)(cid:58)(cid:37)(cid:16)(cid:34)(cid:33,Unknown,21975.0
Unknown,Unknown,11,Unknown,Unknown,Unknown,Unknown,cid:12)(cid:29)(cid:26)(cid:41)(cid:25)(cid:2)(cid:58)(cid:58)(cid:37)(cid:16)(cid:34)(cid:33,Unknown,21986.0
Unknown,Unknown,4,Unknown,Unknown,Unknown,Unknown,cid:12)(cid:29)(cid:26)(cid:41)(cid:25)(cid:2)(cid:58)(cid:58)(cid:37)(cid:16)(cid:34)(cid:33,Unknown,21990.0
Unknown,Unknown,14,Unknown,Unknown,Unknown,Unknown,cid:12)(cid:29)(cid:26)(cid:41)(cid:25)(cid:2)(cid:58)(cid:58)(cid:37)(cid:16)(cid:34)(cid:33,Unknown,22004.0
Unknown,Unknown,11,Unknown,Unknown,Unknown,Unknown,cid:12)(cid:29)(cid:26)(cid:41)(cid:25)(cid:2)(cid:58)(cid:58)(cid:37)(cid:16)(cid:34)(cid:33,Unknown,22015.0
Unknown,Unknown,48,Unknown,Unknown,Unknown,Unknown,cid:12)(cid:29)(cid:26)(cid:41)(cid:25)(cid:2)(cid:58)(cid:58)(cid:37)(cid:16)(cid:34)(cid:33,Unknown,22063.0
Unknown,Unknown,48,Unknown,Unknown,Unknown,Unknown,cid:12)(cid:29)(cid:26)(cid:41)(cid:25)(cid:2)(cid:58)(cid:58)(cid:37)(cid:16)(cid:34)(cid:33,Unknown,22111.0
Unknown,Unknown,7,Unknown,Unknown,Unknown,Unknown,cid:12)(cid:29)(cid:26)(cid:41)(cid:25)(cid:2)(cid:58)(cid:58)(cid:37)(cid:16)(cid:34)(cid:33,Unknown,22118.0
Unknown,Unknown,5,Unknown,Unknown,Unknown,Unknown,cid:12)(cid:29)(cid:26)(cid:41)(cid:25)(cid:2)(cid:58)(cid:58)(cid:37)(cid:16)(cid:34)(cid:33,Unknown,22123.0
Unknown,Unknown,3,Unknown,Unknown,Unknown,Unknown,cid:12)(cid:29)(cid:26)(cid:41)(cid:25)(cid:2)(cid:58)(cid:58)(cid:37)(cid:16)(cid:34)(cid:33,Unknown,22126.0
Unknown,Unknown,2,Unknown,Unknown,Unknown,Unknown,cid:12)(cid:29)(cid:26)(cid:41)(cid:25)(cid:2)(cid:58)(cid:58)(cid:37)(cid:16)(cid:34)(cid:33,Unknown,22128.0
Unknown,Unknown,28,Unknown,Unknown,Unknown,Unknown,cid:12)(cid:29)(cid:26)(cid:41)(cid:25)(cid:2)(cid:58)(cid:58)(cid:37)(cid:16)(cid:34)(cid:33,Unknown,22156.0
Unknown,Unknown,3,Unknown,Unknown,Unknown,Unknown,cid:12)(cid:29)(cid:26)(cid:41)(cid:25)(cid:2)(cid:58)(cid:58)(cid:37)(cid:16)(cid:34)(cid:33,Unknown,22159.0
Unknown,Unknown,15,Unknown,Unknown,Unknown,Unknown,cid:12)(cid:29)(cid:26)(cid:41)(cid:25)(cid:2)(cid:58)(cid:58)(cid:37)(cid:16)(cid:34)(cid:33,Unknown,22174.0
Unknown,Unknown,2,Unknown,Unknown,Unknown,Unknown,cid:12)(cid:29)(cid:26)(cid:41)(cid:25)(cid:2)(cid:58)(cid:58)(cid:37)(cid:16)(cid:34)(cid:33,Unknown,22176.0
Unknown,Unknown,17,Unknown,Unknown,Unknown,Unknown,cid:12)(cid:29)(cid:26)(cid:41)(cid:25)(cid:2)(cid:58)(cid:58)(cid:37)(cid:16)(cid:34)(cid:33,Unknown,22193.0
Unknown,Unknown,18,Unknown,Unknown,Unknown,Unknown,cid:12)(cid:29)(cid:26)(cid:41)(cid:25)(cid:2)(cid:58)(cid:58)(cid:37)(cid:16)(cid:34)(cid:33,Unknown,22211.0
Unknown,Unknown,18,Unknown,Unknown,Unknown,Unknown,cid:12)(cid:29)(cid:26)(cid:41)(cid:25)(cid:2)(cid:58)(cid:58)(cid:37)(cid:16)(cid:34)(cid:33,Unknown,22229.0
Unknown,Unknown,19,Unknown,Unknown,Unknown,Unknown,cid:12)(cid:29)(cid:26)(cid:41)(cid:25)(cid:2)(cid:58)(cid:58)(cid:37)(cid:16)(cid:34)(cid:33,Unknown,22248.0
Unknown,Unknown,18,Unknown,Unknown,Unknown,Unknown,cid:12)(cid:29)(cid:26)(cid:41)(cid:25)(cid:2)(cid:58)(cid:58)(cid:37)(cid:16)(cid:34)(cid:33,Unknown,22266.0
Unknown,Unknown,18,Unknown,Unknown,Unknown,Unknown,cid:12)(cid:29)(cid:26)(cid:41)(cid:25)(cid:2)(cid:58)(cid:58)(cid:37)(cid:16)(cid:34)(cid:33,Unknown,22284.0
Unknown,Unknown,2,Unknown,Unknown,Unknown,Unknown,cid:12)(cid:29)(cid:26)(cid:41)(cid:25)(cid:2)(cid:58)(cid:58)(cid:37)(cid:16)(cid:34)(cid:33,Unknown,22286.0
Unknown,Unknown,44,Unknown,Unknown,Unknown,Unknown,cid:12)(cid:29)(cid:26)(cid:41)(cid:25)(cid:2)(cid:58)(cid:58)(cid:37)(cid:16)(cid:34)(cid:33,Unknown,22330.0
Unknown,Unknown,12,Unknown,Unknown,Unknown,Unknown,cid:12)(cid:29)(cid:26)(cid:41)(cid:25)(cid:2)(cid:58)(cid:58)(cid:37)(cid:16)(cid:34)(cid:33,Unknown,22342.0
Unknown,Unknown,29,Unknown,Unknown,Unknown,Unknown,cid:12)(cid:29)(cid:26)(cid:41)(cid:25)(cid:2)(cid:58)(cid:58)(cid:37)(cid:16)(cid:34)(cid:33,Unknown,22371.0
Unknown,Unknown,26,Unknown,Unknown,Unknown,Unknown,cid:12)(cid:29)(cid:26)(cid:41)(cid:25)(cid:2)(cid:58)(cid:58)(cid:37)(cid:16)(cid:34)(cid:33,Unknown,22397.0
Unknown,Unknown,41,Unknown,Unknown,Unknown,Unknown,cid:12)(cid:29)(cid:26)(cid:41)(cid:25)(cid:2)(cid:58)(cid:58)(cid:37)(cid:16)(cid:34)(cid:33,Unknown,22438.0
Unknown,Unknown,25,Unknown,Unknown,Unknown,Unknown,cid:12)(cid:29)(cid:26)(cid:41)(cid:25)(cid:2)(cid:58)(cid:58)(cid:37)(cid:16)(cid:34)(cid:33,Unknown,22463.0
Unknown,Unknown,2,Unknown,Unknown,Unknown,Unknown,cid:12)(cid:29)(cid:26)(cid:41)(cid:25)(cid:2)(cid:58)(cid:58)(cid:37)(cid:16)(cid:34)(cid:33,Unknown,22465.0
Unknown,Unknown,58,Unknown,Unknown,Unknown,Unknown,cid:12)(cid:29)(cid:26)(cid:41)(cid:25)(cid:2)(cid:58)(cid:58)(cid:37)(cid:16)(cid:34)(cid:33,Unknown,22523.0
Unknown,Unknown,58,Unknown,Unknown,Unknown,Unknown,cid:12)(cid:29)(cid:26)(cid:41)(cid:25)(cid:2)(cid:58)(cid:58)(cid:37)(cid:16)(cid:34)(cid:33,Unknown,22581.0
Unknown,Unknown,18,Unknown,Unknown,Unknown,Unknown,cid:12)(cid:29)(cid:26)(cid:41)(cid:25)(cid:2)(cid:58)(cid:58)(cid:37)(cid:16)(cid:34)(cid:33,Unknown,22599.0
Unknown,Unknown,1,Unknown,Unknown,Unknown,Unknown,cid:12)(cid:29)(cid:26)(cid:41)(cid:25)(cid:2)(cid:58)(cid:58)(cid:37)(cid:16)(cid:34)(cid:33,Unknown,22600.0
Unknown,Unknown,1,Unknown,Unknown,Unknown,Unknown,cid:12)(cid:29)(cid:26)(cid:41)(cid:25)(cid:2)(cid:58)(cid:58)(cid:37)(cid:16)(cid:34)(cid:33,Unknown,22601.0
Unknown,Unknown,37,Unknown,Unknown,Unknown,Unknown,cid:12)(cid:29)(cid:26)(cid:41)(cid:25)(cid:2)(cid:58)(cid:58)(cid:37)(cid:16)(cid:34)(cid:33,Unknown,22638.0
Unknown,Unknown,1,Unknown,Unknown,Unknown,Unknown,cid:12)(cid:29)(cid:26)(cid:41)(cid:25)(cid:2)(cid:58)(cid:58)(cid:37)(cid:16)(cid:34)(cid:33,Unknown,22639.0
Unknown,Unknown,16,Unknown,Unknown,Unknown,Unknown,cid:12)(cid:29)(cid:26)(cid:41)(cid:25)(cid:2)(cid:58)(cid:58)(cid:37)(cid:16)(cid:34)(cid:33,Unknown,22655.0
Unknown,Unknown,45,Unknown,Unknown,Unknown,Unknown,cid:12)(cid:29)(cid:26)(cid:41)(cid:25)(cid:2)(cid:58)(cid:58)(cid:37)(cid:16)(cid:34)(cid:33,Unknown,22700.0
Unknown,Unknown,18,Unknown,Unknown,Unknown,Unknown,cid:12)(cid:29)(cid:26)(cid:41)(cid:25)(cid:2)(cid:58)(cid:58)(cid:37)(cid:16)(cid:34)(cid:33,Unknown,22718.0
Unknown,Unknown,16,Unknown,Unknown,Unknown,Unknown,cid:12)(cid:29)(cid:26)(cid:41)(cid:25)(cid:2)(cid:58)(cid:58)(cid:37)(cid:16)(cid:34)(cid:33,Unknown,22734.0
Unknown,Unknown,14,Unknown,Unknown,Unknown,Unknown,cid:12)(cid:29)(cid:26)(cid:41)(cid:25)(cid:2)(cid:58)(cid:58)(cid:37)(cid:16)(cid:34)(cid:33,Unknown,22748.0
Unknown,Unknown,5,Unknown,Unknown,Unknown,Unknown,cid:12)(cid:29)(cid:26)(cid:41)(cid:25)(cid:2)(cid:58)(cid:58)(cid:37)(cid:16)(cid:34)(cid:33,Unknown,22753.0
Unknown,Unknown,12,Unknown,Unknown,Unknown,Unknown,cid:12)(cid:29)(cid:26)(cid:41)(cid:25)(cid:2)(cid:58)(cid:58)(cid:37)(cid:16)(cid:34)(cid:33,Unknown,22765.0
Unknown,Unknown,14,Unknown,Unknown,Unknown,Unknown,cid:12)(cid:29)(cid:26)(cid:41)(cid:25)(cid:2)(cid:58)(cid:58)(cid:37)(cid:16)(cid:34)(cid:33,Unknown,22779.0
Unknown,Unknown,5,Unknown,Unknown,Unknown,Unknown,cid:12)(cid:29)(cid:26)(cid:41)(cid:25)(cid:2)(cid:58)(cid:58)(cid:37)(cid:16)(cid:34)(cid:33,Unknown,22784.0
Unknown,Unknown,3,Unknown,Unknown,Unknown,Unknown,cid:12)(cid:29)(cid:26)(cid:41)(cid:25)(cid:2)(cid:58)(cid:58)(cid:37)(cid:16)(cid:34)(cid:33,Unknown,22787.0
Unknown,Unknown,12,Unknown,Unknown,Unknown,Unknown,cid:12)(cid:29)(cid:26)(cid:41)(cid:25)(cid:2)(cid:58)(cid:58)(cid:37)(cid:16)(cid:34)(cid:33,Unknown,22799.0
Unknown,Unknown,2,Unknown,Unknown,Unknown,Unknown,cid:12)(cid:29)(cid:26)(cid:41)(cid:25)(cid:2)(cid:58)(cid:58)(cid:37)(cid:16)(cid:34)(cid:33,Unknown,22801.0
Unknown,Unknown,50,Unknown,Unknown,Unknown,Unknown,cid:12)(cid:29)(cid:26)(cid:41)(cid:25)(cid:2)(cid:58)(cid:58)(cid:37)(cid:16)(cid:34)(cid:33,Unknown,22851.0
Unknown,Unknown,7,Unknown,Unknown,Unknown,Unknown,cid:12)(cid:29)(cid:26)(cid:41)(cid:25)(cid:2)(cid:58)(cid:58)(cid:37)(cid:16)(cid:34)(cid:33,Unknown,22858.0
Unknown,Unknown,9,Unknown,Unknown,Unknown,Unknown,cid:12)(cid:29)(cid:26)(cid:41)(cid:25)(cid:2)(cid:58)(cid:58)(cid:37)(cid:16)(cid:34)(cid:33,Unknown,22867.0
Unknown,Unknown,10,Unknown,Unknown,Unknown,Unknown,cid:12)(cid:29)(cid:26)(cid:41)(cid:25)(cid:2)(cid:58)(cid:58)(cid:37)(cid:16)(cid:34)(cid:33,Unknown,22877.0
Unknown,Unknown,3,Unknown,Unknown,Unknown,Unknown,cid:12)(cid:29)(cid:26)(cid:41)(cid:25)(cid:2)(cid:58)(cid:58)(cid:37)(cid:16)(cid:34)(cid:33,Unknown,22880.0
Unknown,Unknown,2,Unknown,Unknown,Unknown,Unknown,cid:12)(cid:29)(cid:26)(cid:41)(cid:25)(cid:2)(cid:58)(cid:58)(cid:37)(cid:16)(cid:34)(cid:33,Unknown,22882.0
Unknown,Unknown,12,Unknown,Unknown,Unknown,Unknown,cid:12)(cid:29)(cid:26)(cid:41)(cid:25)(cid:2)(cid:58)(cid:58)(cid:37)(cid:16)(cid:34)(cid:33,Unknown,22894.0
Unknown,Unknown,11,Unknown,Unknown,Unknown,Unknown,cid:12)(cid:29)(cid:26)(cid:41)(cid:25)(cid:2)(cid:58)(cid:58)(cid:37)(cid:16)(cid:34)(cid:33,Unknown,22905.0
Unknown,Unknown,4,Unknown,Unknown,Unknown,Unknown,cid:12)(cid:29)(cid:26)(cid:41)(cid:25)(cid:2)(cid:58)(cid:58)(cid:37)(cid:16)(cid:34)(cid:33,Unknown,22909.0
Unknown,Unknown,14,Unknown,Unknown,Unknown,Unknown,cid:12)(cid:29)(cid:26)(cid:41)(cid:25)(cid:2)(cid:58)(cid:58)(cid:37)(cid:16)(cid:34)(cid:33,Unknown,22923.0
Unknown,Unknown,11,Unknown,Unknown,Unknown,Unknown,cid:12)(cid:29)(cid:26)(cid:41)(cid:25)(cid:2)(cid:58)(cid:58)(cid:37)(cid:16)(cid:34)(cid:33,Unknown,22934.0
Unknown,Unknown,48,Unknown,Unknown,Unknown,Unknown,cid:12)(cid:29)(cid:26)(cid:41)(cid:25)(cid:2)(cid:58)(cid:58)(cid:37)(cid:16)(cid:34)(cid:33,Unknown,22982.0
Unknown,Unknown,48,Unknown,Unknown,Unknown,Unknown,cid:12)(cid:29)(cid:26)(cid:41)(cid:25)(cid:2)(cid:58)(cid:58)(cid:37)(cid:16)(cid:34)(cid:33,Unknown,23030.0
Unknown,Unknown,7,Unknown,Unknown,Unknown,Unknown,cid:12)(cid:29)(cid:26)(cid:41)(cid:25)(cid:2)(cid:58)(cid:58)(cid:37)(cid:16)(cid:34)(cid:33,Unknown,23037.0
Unknown,Unknown,5,Unknown,Unknown,Unknown,Unknown,cid:12)(cid:29)(cid:26)(cid:41)(cid:25)(cid:2)(cid:58)(cid:58)(cid:37)(cid:16)(cid:34)(cid:33,Unknown,23042.0
Unknown,Unknown,3,Unknown,Unknown,Unknown,Unknown,cid:12)(cid:29)(cid:26)(cid:41)(cid:25)(cid:2)(cid:58)(cid:58)(cid:37)(cid:16)(cid:34)(cid:33,Unknown,23045.0
Unknown,Unknown,2,Unknown,Unknown,Unknown,Unknown,cid:12)(cid:29)(cid:26)(cid:41)(cid:25)(cid:2)(cid:58)(cid:58)(cid:37)(cid:16)(cid:34)(cid:33,Unknown,23047.0
Unknown,Unknown,28,Unknown,Unknown,Unknown,Unknown,cid:12)(cid:29)(cid:26)(cid:41)(cid:25)(cid:2)(cid:58)(cid:58)(cid:37)(cid:16)(cid:34)(cid:33,Unknown,23075.0
Unknown,Unknown,3,Unknown,Unknown,Unknown,Unknown,cid:12)(cid:29)(cid:26)(cid:41)(cid:25)(cid:2)(cid:58)(cid:58)(cid:37)(cid:16)(cid:34)(cid:33,Unknown,23078.0
Unknown,Unknown,15,Unknown,Unknown,Unknown,Unknown,cid:12)(cid:29)(cid:26)(cid:41)(cid:25)(cid:2)(cid:58)(cid:58)(cid:37)(cid:16)(cid:34)(cid:33,Unknown,23093.0
Unknown,Unknown,2,Unknown,Unknown,Unknown,Unknown,cid:12)(cid:29)(cid:26)(cid:41)(cid:25)(cid:2)(cid:58)(cid:58)(cid:37)(cid:16)(cid:34)(cid:33,Unknown,23095.0
Unknown,Unknown,17,Unknown,Unknown,Unknown,Unknown,cid:12)(cid:29)(cid:26)(cid:41)(cid:25)(cid:2)(cid:58)(cid:58)(cid:37)(cid:16)(cid:34)(cid:33,Unknown,23112.0
Unknown,Unknown,37,Unknown,Unknown,Unknown,Unknown,cid:12)(cid:29)(cid:26)(cid:41)(cid:25)(cid:2)(cid:58)(cid:58)(cid:37)(cid:16)(cid:34)(cid:33,Unknown,23149.0
Unknown,Unknown,36,Unknown,Unknown,Unknown,Unknown,cid:12)(cid:29)(cid:26)(cid:41)(cid:25)(cid:2)(cid:58)(cid:58)(cid:37)(cid:16)(cid:34)(cid:33,Unknown,23185.0
Unknown,Unknown,19,Unknown,Unknown,Unknown,Unknown,cid:12)(cid:29)(cid:26)(cid:41)(cid:25)(cid:2)(cid:58)(cid:58)(cid:37)(cid:16)(cid:34)(cid:33,Unknown,23204.0
Unknown,Unknown,36,Unknown,Unknown,Unknown,Unknown,cid:12)(cid:29)(cid:26)(cid:41)(cid:25)(cid:2)(cid:58)(cid:58)(cid:37)(cid:16)(cid:34)(cid:33,Unknown,23240.0
Unknown,Unknown,18,Unknown,Unknown,Unknown,Unknown,cid:12)(cid:29)(cid:26)(cid:41)(cid:25)(cid:2)(cid:58)(cid:58)(cid:37)(cid:16)(cid:34)(cid:33,Unknown,23258.0
Unknown,Unknown,2,Unknown,Unknown,Unknown,Unknown,cid:12)(cid:29)(cid:26)(cid:41)(cid:25)(cid:2)(cid:58)(cid:58)(cid:37)(cid:16)(cid:34)(cid:33,Unknown,23260.0
Unknown,Unknown,44,Unknown,Unknown,Unknown,Unknown,cid:12)(cid:29)(cid:26)(cid:41)(cid:25)(cid:2)(cid:58)(cid:58)(cid:37)(cid:16)(cid:34)(cid:33,Unknown,23304.0
Unknown,Unknown,12,Unknown,Unknown,Unknown,Unknown,cid:12)(cid:29)(cid:26)(cid:41)(cid:25)(cid:2)(cid:58)(cid:58)(cid:37)(cid:16)(cid:34)(cid:33,Unknown,23316.0
Unknown,Unknown,29,Unknown,Unknown,Unknown,Unknown,cid:12)(cid:29)(cid:26)(cid:41)(cid:25)(cid:2)(cid:58)(cid:58)(cid:37)(cid:16)(cid:34)(cid:33,Unknown,23345.0
Unknown,Unknown,26,Unknown,Unknown,Unknown,Unknown,cid:12)(cid:29)(cid:26)(cid:41)(cid:25)(cid:2)(cid:58)(cid:58)(cid:37)(cid:16)(cid:34)(cid:33,Unknown,23371.0
Unknown,Unknown,41,Unknown,Unknown,Unknown,Unknown,cid:12)(cid:29)(cid:26)(cid:41)(cid:25)(cid:2)(cid:58)(cid:58)(cid:37)(cid:16)(cid:34)(cid:33,Unknown,23412.0
Unknown,Unknown,25,Unknown,Unknown,Unknown,Unknown,cid:12)(cid:29)(cid:26)(cid:41)(cid:25)(cid:2)(cid:58)(cid:58)(cid:37)(cid:16)(cid:34)(cid:33,Unknown,23437.0
Unknown,Unknown,2,Unknown,Unknown,Unknown,Unknown,cid:12)(cid:29)(cid:26)(cid:41)(cid:25)(cid:2)(cid:58)(cid:58)(cid:37)(cid:16)(cid:34)(cid:33,Unknown,23439.0
Unknown,Unknown,58,Unknown,Unknown,Unknown,Unknown,cid:12)(cid:29)(cid:26)(cid:41)(cid:25)(cid:2)(cid:58)(cid:58)(cid:37)(cid:16)(cid:34)(cid:33,Unknown,23497.0
Unknown,Unknown,58,Unknown,Unknown,Unknown,Unknown,cid:12)(cid:29)(cid:26)(cid:41)(cid:25)(cid:2)(cid:58)(cid:58)(cid:37)(cid:16)(cid:34)(cid:33,Unknown,23555.0
Unknown,Unknown,37,Unknown,Unknown,Unknown,Unknown,cid:12)(cid:29)(cid:26)(cid:41)(cid:25)(cid:2)(cid:58)(cid:58)(cid:37)(cid:16)(cid:34)(cid:33,Unknown,23592.0
Unknown,Unknown,16,Unknown,Unknown,Unknown,Unknown,cid:12)(cid:29)(cid:26)(cid:41)(cid:25)(cid:2)(cid:58)(cid:58)(cid:37)(cid:16)(cid:34)(cid:33,Unknown,23608.0
Unknown,Unknown,34,Unknown,Unknown,Unknown,Unknown,cid:12)(cid:29)(cid:26)(cid:41)(cid:25)(cid:2)(cid:58)(cid:58)(cid:37)(cid:16)(cid:34)(cid:33,Unknown,23642.0
Unknown,Unknown,33,Unknown,Unknown,Unknown,Unknown,cid:12)(cid:29)(cid:26)(cid:41)(cid:25)(cid:2)(cid:58)(cid:58)(cid:37)(cid:16)(cid:34)(cid:33,Unknown,23675.0
Unknown,Unknown,1,Unknown,Unknown,Unknown,Unknown,cid:12)(cid:29)(cid:26)(cid:41)(cid:25)(cid:2)(cid:58)(cid:58)(cid:37)(cid:16)(cid:34)(cid:33,Unknown,23676.0
Unknown,Unknown,16,Unknown,Unknown,Unknown,Unknown,cid:12)(cid:29)(cid:26)(cid:41)(cid:25)(cid:2)(cid:58)(cid:58)(cid:37)(cid:16)(cid:34)(cid:33,Unknown,23692.0
Unknown,Unknown,45,Unknown,Unknown,Unknown,Unknown,cid:12)(cid:29)(cid:26)(cid:41)(cid:25)(cid:2)(cid:58)(cid:58)(cid:37)(cid:16)(cid:34)(cid:33,Unknown,23737.0
Unknown,Unknown,18,Unknown,Unknown,Unknown,Unknown,cid:12)(cid:29)(cid:26)(cid:41)(cid:25)(cid:2)(cid:58)(cid:58)(cid:37)(cid:16)(cid:34)(cid:33,Unknown,23755.0
Unknown,Unknown,16,Unknown,Unknown,Unknown,Unknown,cid:12)(cid:29)(cid:26)(cid:41)(cid:25)(cid:2)(cid:58)(cid:58)(cid:37)(cid:16)(cid:34)(cid:33,Unknown,23771.0
Unknown,Unknown,65,Unknown,Unknown,Unknown,Unknown,cid:12)(cid:29)(cid:26)(cid:41)(cid:25)(cid:2)(cid:58)(cid:58)(cid:37)(cid:16)(cid:34)(cid:33,Unknown,23836.0
Unknown,Unknown,28,Unknown,Unknown,Unknown,Unknown,cid:12)(cid:29)(cid:26)(cid:41)(cid:25)(cid:2)(cid:58)(cid:58)(cid:37)(cid:16)(cid:34)(cid:33,Unknown,23864.0
Unknown,Unknown,12,Unknown,Unknown,Unknown,Unknown,cid:12)(cid:29)(cid:26)(cid:41)(cid:25)(cid:2)(cid:58)(cid:58)(cid:37)(cid:16)(cid:34)(cid:33,Unknown,23876.0
Unknown,Unknown,2,Unknown,Unknown,Unknown,Unknown,cid:12)(cid:29)(cid:26)(cid:41)(cid:25)(cid:2)(cid:58)(cid:58)(cid:37)(cid:16)(cid:34)(cid:33,Unknown,23878.0
Unknown,Unknown,48,Unknown,Unknown,Unknown,Unknown,cid:12)(cid:29)(cid:26)(cid:41)(cid:25)(cid:2)(cid:58)(cid:58)(cid:37)(cid:16)(cid:34)(cid:33,Unknown,23926.0
Unknown,Unknown,5,Unknown,Unknown,Unknown,Unknown,cid:12)(cid:29)(cid:26)(cid:41)(cid:25)(cid:2)(cid:58)(cid:58)(cid:37)(cid:16)(cid:34)(cid:33,Unknown,23931.0
Unknown,Unknown,46,Unknown,Unknown,Unknown,Unknown,cid:12)(cid:29)(cid:26)(cid:41)(cid:25)(cid:2)(cid:58)(cid:58)(cid:37)(cid:16)(cid:34)(cid:33,Unknown,23977.0
Unknown,Unknown,4,Unknown,Unknown,Unknown,Unknown,cid:12)(cid:29)(cid:26)(cid:41)(cid:25)(cid:2)(cid:58)(cid:58)(cid:37)(cid:16)(cid:34)(cid:33,Unknown,23981.0
Unknown,Unknown,40,Unknown,Unknown,Unknown,Unknown,cid:12)(cid:29)(cid:26)(cid:41)(cid:25)(cid:2)(cid:58)(cid:58)(cid:37)(cid:16)(cid:34)(cid:33,Unknown,24021.0
Unknown,Unknown,2,Unknown,Unknown,Unknown,Unknown,cid:12)(cid:29)(cid:26)(cid:41)(cid:25)(cid:2)(cid:58)(cid:58)(cid:37)(cid:16)(cid:34)(cid:33,Unknown,24023.0
Unknown,Unknown,48,Unknown,Unknown,Unknown,Unknown,cid:12)(cid:29)(cid:26)(cid:41)(cid:25)(cid:2)(cid:58)(cid:58)(cid:37)(cid:16)(cid:34)(cid:33,Unknown,24071.0
Unknown,Unknown,5,Unknown,Unknown,Unknown,Unknown,cid:12)(cid:29)(cid:26)(cid:41)(cid:25)(cid:2)(cid:58)(cid:58)(cid:37)(cid:16)(cid:34)(cid:33,Unknown,24076.0
Unknown,Unknown,46,Unknown,Unknown,Unknown,Unknown,cid:12)(cid:29)(cid:26)(cid:41)(cid:25)(cid:2)(cid:58)(cid:58)(cid:37)(cid:16)(cid:34)(cid:33,Unknown,24122.0
Unknown,Unknown,4,Unknown,Unknown,Unknown,Unknown,cid:12)(cid:29)(cid:26)(cid:41)(cid:25)(cid:2)(cid:58)(cid:58)(cid:37)(cid:16)(cid:34)(cid:33,Unknown,24126.0
Unknown,Unknown,40,Unknown,Unknown,Unknown,Unknown,cid:12)(cid:29)(cid:26)(cid:41)(cid:25)(cid:2)(cid:58)(cid:58)(cid:37)(cid:16)(cid:34)(cid:33,Unknown,24166.0
Unknown,Unknown,2,Unknown,Unknown,Unknown,Unknown,cid:12)(cid:29)(cid:26)(cid:41)(cid:25)(cid:2)(cid:58)(cid:58)(cid:37)(cid:16)(cid:34)(cid:33,Unknown,24168.0
Unknown,Unknown,28,Unknown,Unknown,Unknown,Unknown,cid:12)(cid:29)(cid:26)(cid:41)(cid:25)(cid:2)(cid:58)(cid:58)(cid:37)(cid:16)(cid:34)(cid:33,Unknown,24196.0
Unknown,Unknown,3,Unknown,Unknown,Unknown,Unknown,cid:12)(cid:29)(cid:26)(cid:41)(cid:25)(cid:2)(cid:58)(cid:58)(cid:37)(cid:16)(cid:34)(cid:33,Unknown,24199.0
Unknown,Unknown,15,Unknown,Unknown,Unknown,Unknown,cid:12)(cid:29)(cid:26)(cid:41)(cid:25)(cid:2)(cid:58)(cid:58)(cid:37)(cid:16)(cid:34)(cid:33,Unknown,24214.0
Unknown,Unknown,2,Unknown,Unknown,Unknown,Unknown,cid:12)(cid:29)(cid:26)(cid:41)(cid:25)(cid:2)(cid:58)(cid:58)(cid:37)(cid:16)(cid:34)(cid:33,Unknown,24216.0
Unknown,Unknown,17,Unknown,Unknown,Unknown,Unknown,cid:12)(cid:29)(cid:26)(cid:41)(cid:25)(cid:2)(cid:58)(cid:58)(cid:37)(cid:16)(cid:34)(cid:33,Unknown,24233.0
Unknown,Unknown,18,Unknown,Unknown,Unknown,Unknown,cid:12)(cid:29)(cid:26)(cid:41)(cid:25)(cid:2)(cid:58)(cid:58)(cid:37)(cid:16)(cid:34)(cid:33,Unknown,24251.0
Unknown,Unknown,33,Unknown,Unknown,Unknown,Unknown,cid:12)(cid:29)(cid:26)(cid:41)(cid:25)(cid:2)(cid:58)(cid:58)(cid:37)(cid:16)(cid:34)(cid:33,Unknown,24284.0
Unknown,Unknown,19,Unknown,Unknown,Unknown,Unknown,cid:12)(cid:29)(cid:26)(cid:41)(cid:25)(cid:2)(cid:58)(cid:58)(cid:37)(cid:16)(cid:34)(cid:33,Unknown,24303.0
Unknown,Unknown,32,Unknown,Unknown,Unknown,Unknown,cid:12)(cid:29)(cid:26)(cid:41)(cid:25)(cid:2)(cid:58)(cid:58)(cid:37)(cid:16)(cid:34)(cid:33,Unknown,24335.0
Unknown,Unknown,18,Unknown,Unknown,Unknown,Unknown,cid:12)(cid:29)(cid:26)(cid:41)(cid:25)(cid:2)(cid:58)(cid:58)(cid:37)(cid:16)(cid:34)(cid:33,Unknown,24353.0
Unknown,Unknown,2,Unknown,Unknown,Unknown,Unknown,cid:12)(cid:29)(cid:26)(cid:41)(cid:25)(cid:2)(cid:58)(cid:58)(cid:37)(cid:16)(cid:34)(cid:33,Unknown,24355.0
Unknown,Unknown,44,Unknown,Unknown,Unknown,Unknown,cid:12)(cid:29)(cid:26)(cid:41)(cid:25)(cid:2)(cid:58)(cid:58)(cid:37)(cid:16)(cid:34)(cid:33,Unknown,24399.0
Unknown,Unknown,12,Unknown,Unknown,Unknown,Unknown,cid:12)(cid:29)(cid:26)(cid:41)(cid:25)(cid:2)(cid:58)(cid:58)(cid:37)(cid:16)(cid:34)(cid:33,Unknown,24411.0
Unknown,Unknown,29,Unknown,Unknown,Unknown,Unknown,cid:12)(cid:29)(cid:26)(cid:41)(cid:25)(cid:2)(cid:58)(cid:58)(cid:37)(cid:16)(cid:34)(cid:33,Unknown,24440.0
Unknown,Unknown,26,Unknown,Unknown,Unknown,Unknown,cid:12)(cid:29)(cid:26)(cid:41)(cid:25)(cid:2)(cid:58)(cid:58)(cid:37)(cid:16)(cid:34)(cid:33,Unknown,24466.0
Unknown,Unknown,41,Unknown,Unknown,Unknown,Unknown,cid:12)(cid:29)(cid:26)(cid:41)(cid:25)(cid:2)(cid:58)(cid:58)(cid:37)(cid:16)(cid:34)(cid:33,Unknown,24507.0
Unknown,Unknown,25,Unknown,Unknown,Unknown,Unknown,cid:12)(cid:29)(cid:26)(cid:41)(cid:25)(cid:2)(cid:58)(cid:58)(cid:37)(cid:16)(cid:34)(cid:33,Unknown,24532.0
Unknown,Unknown,2,Unknown,Unknown,Unknown,Unknown,cid:12)(cid:29)(cid:26)(cid:41)(cid:25)(cid:2)(cid:58)(cid:58)(cid:37)(cid:16)(cid:34)(cid:33,Unknown,24534.0
Unknown,Unknown,58,Unknown,Unknown,Unknown,Unknown,cid:12)(cid:29)(cid:26)(cid:41)(cid:25)(cid:2)(cid:58)(cid:58)(cid:37)(cid:16)(cid:34)(cid:33,Unknown,24592.0
Unknown,Unknown,58,Unknown,Unknown,Unknown,Unknown,cid:12)(cid:29)(cid:26)(cid:41)(cid:25)(cid:2)(cid:58)(cid:58)(cid:37)(cid:16)(cid:34)(cid:33,Unknown,24650.0
Unknown,Unknown,37,Unknown,Unknown,Unknown,Unknown,cid:12)(cid:29)(cid:26)(cid:41)(cid:25)(cid:2)(cid:58)(cid:58)(cid:37)(cid:16)(cid:34)(cid:33,Unknown,24687.0
Unknown,Unknown,16,Unknown,Unknown,Unknown,Unknown,cid:12)(cid:29)(cid:26)(cid:41)(cid:25)(cid:2)(cid:58)(cid:58)(cid:37)(cid:16)(cid:34)(cid:33,Unknown,24703.0
Unknown,Unknown,34,Unknown,Unknown,Unknown,Unknown,cid:12)(cid:29)(cid:26)(cid:41)(cid:25)(cid:2)(cid:58)(cid:58)(cid:37)(cid:16)(cid:34)(cid:33,Unknown,24737.0
Unknown,Unknown,33,Unknown,Unknown,Unknown,Unknown,cid:12)(cid:29)(cid:26)(cid:41)(cid:25)(cid:2)(cid:58)(cid:58)(cid:37)(cid:16)(cid:34)(cid:33,Unknown,24770.0
Unknown,Unknown,1,Unknown,Unknown,Unknown,Unknown,cid:12)(cid:29)(cid:26)(cid:41)(cid:25)(cid:2)(cid:58)(cid:58)(cid:37)(cid:16)(cid:34)(cid:33,Unknown,24771.0
Unknown,Unknown,35,Unknown,Unknown,Unknown,Unknown,cid:12)(cid:29)(cid:26)(cid:41)(cid:25)(cid:2)(cid:58)(cid:58)(cid:37)(cid:16)(cid:34)(cid:33,Unknown,24806.0
Unknown,Unknown,45,Unknown,Unknown,Unknown,Unknown,cid:12)(cid:29)(cid:26)(cid:41)(cid:25)(cid:2)(cid:58)(cid:58)(cid:37)(cid:16)(cid:34)(cid:33,Unknown,24851.0
Unknown,Unknown,18,Unknown,Unknown,Unknown,Unknown,cid:12)(cid:29)(cid:26)(cid:41)(cid:25)(cid:2)(cid:58)(cid:58)(cid:37)(cid:16)(cid:34)(cid:33,Unknown,24869.0
Unknown,Unknown,16,Unknown,Unknown,Unknown,Unknown,cid:12)(cid:29)(cid:26)(cid:41)(cid:25)(cid:2)(cid:58)(cid:58)(cid:37)(cid:16)(cid:34)(cid:33,Unknown,24885.0
Unknown,Unknown,9,Unknown,Unknown,Unknown,Unknown,cid:12)(cid:29)(cid:26)(cid:41)(cid:25)(cid:2)(cid:58)(cid:58)(cid:37)(cid:16)(cid:34)(cid:33,Unknown,24894.0
Unknown,Unknown,46,Unknown,Unknown,Unknown,Unknown,cid:12)(cid:29)(cid:26)(cid:41)(cid:25)(cid:2)(cid:58)(cid:58)(cid:37)(cid:16)(cid:34)(cid:33,Unknown,24940.0
Unknown,Unknown,8,Unknown,Unknown,Unknown,Unknown,cid:12)(cid:29)(cid:26)(cid:41)(cid:25)(cid:2)(cid:58)(cid:58)(cid:37)(cid:16)(cid:34)(cid:33,Unknown,24948.0
Unknown,Unknown,5,Unknown,Unknown,Unknown,Unknown,cid:12)(cid:29)(cid:26)(cid:41)(cid:25)(cid:2)(cid:58)(cid:58)(cid:37)(cid:16)(cid:34)(cid:33,Unknown,24953.0
Unknown,Unknown,28,Unknown,Unknown,Unknown,Unknown,cid:12)(cid:29)(cid:26)(cid:41)(cid:25)(cid:2)(cid:58)(cid:58)(cid:37)(cid:16)(cid:34)(cid:33,Unknown,24981.0
Unknown,Unknown,2,Unknown,Unknown,Unknown,Unknown,cid:12)(cid:29)(cid:26)(cid:41)(cid:25)(cid:2)(cid:58)(cid:58)(cid:37)(cid:16)(cid:34)(cid:33,Unknown,24983.0
Unknown,Unknown,9,Unknown,Unknown,Unknown,Unknown,cid:12)(cid:29)(cid:26)(cid:41)(cid:25)(cid:2)(cid:58)(cid:58)(cid:37)(cid:16)(cid:34)(cid:33,Unknown,24992.0
Unknown,Unknown,5,Unknown,Unknown,Unknown,Unknown,cid:12)(cid:29)(cid:26)(cid:41)(cid:25)(cid:2)(cid:58)(cid:58)(cid:37)(cid:16)(cid:34)(cid:33,Unknown,24997.0
Unknown,Unknown,8,Unknown,Unknown,Unknown,Unknown,cid:12)(cid:29)(cid:26)(cid:41)(cid:25)(cid:2)(cid:58)(cid:58)(cid:37)(cid:16)(cid:34)(cid:33,Unknown,25005.0
Unknown,Unknown,14,Unknown,Unknown,Unknown,Unknown,cid:12)(cid:29)(cid:26)(cid:41)(cid:25)(cid:2)(cid:58)(cid:58)(cid:37)(cid:16)(cid:34)(cid:33,Unknown,25019.0
Unknown,Unknown,7,Unknown,Unknown,Unknown,Unknown,cid:12)(cid:29)(cid:26)(cid:41)(cid:25)(cid:2)(cid:58)(cid:58)(cid:37)(cid:16)(cid:34)(cid:33,Unknown,25026.0
Unknown,Unknown,9,Unknown,Unknown,Unknown,Unknown,cid:12)(cid:29)(cid:26)(cid:41)(cid:25)(cid:2)(cid:58)(cid:58)(cid:37)(cid:16)(cid:34)(cid:33,Unknown,25035.0
Unknown,Unknown,2,Unknown,Unknown,Unknown,Unknown,cid:12)(cid:29)(cid:26)(cid:41)(cid:25)(cid:2)(cid:58)(cid:58)(cid:37)(cid:16)(cid:34)(cid:33,Unknown,25037.0
Unknown,Unknown,28,Unknown,Unknown,Unknown,Unknown,cid:12)(cid:29)(cid:26)(cid:41)(cid:25)(cid:2)(cid:58)(cid:58)(cid:37)(cid:16)(cid:34)(cid:33,Unknown,25065.0
Unknown,Unknown,3,Unknown,Unknown,Unknown,Unknown,cid:12)(cid:29)(cid:26)(cid:41)(cid:25)(cid:2)(cid:58)(cid:58)(cid:37)(cid:16)(cid:34)(cid:33,Unknown,25068.0
Unknown,Unknown,15,Unknown,Unknown,Unknown,Unknown,cid:12)(cid:29)(cid:26)(cid:41)(cid:25)(cid:2)(cid:58)(cid:58)(cid:37)(cid:16)(cid:34)(cid:33,Unknown,25083.0
Unknown,Unknown,2,Unknown,Unknown,Unknown,Unknown,cid:12)(cid:29)(cid:26)(cid:41)(cid:25)(cid:2)(cid:58)(cid:58)(cid:37)(cid:16)(cid:34)(cid:33,Unknown,25085.0
Unknown,Unknown,1,Unknown,Unknown,Unknown,Unknown,cid:12)(cid:29)(cid:26)(cid:41)(cid:25)(cid:2)(cid:58)(cid:58)(cid:37)(cid:16)(cid:34)(cid:33,Unknown,25086.0
Unknown,Unknown,19,Unknown,Unknown,Unknown,Unknown,cid:12)(cid:29)(cid:26)(cid:41)(cid:25)(cid:2)(cid:58)(cid:58)(cid:37)(cid:16)(cid:34)(cid:33,Unknown,25105.0
Unknown,Unknown,37,Unknown,Unknown,Unknown,Unknown,cid:12)(cid:29)(cid:26)(cid:41)(cid:25)(cid:2)(cid:58)(cid:58)(cid:37)(cid:16)(cid:34)(cid:33,Unknown,25142.0
Unknown,Unknown,18,Unknown,Unknown,Unknown,Unknown,cid:12)(cid:29)(cid:26)(cid:41)(cid:25)(cid:2)(cid:58)(cid:58)(cid:37)(cid:16)(cid:34)(cid:33,Unknown,25160.0
Unknown,Unknown,2,Unknown,Unknown,Unknown,Unknown,cid:12)(cid:29)(cid:26)(cid:41)(cid:25)(cid:2)(cid:58)(cid:58)(cid:37)(cid:16)(cid:34)(cid:33,Unknown,25162.0
Unknown,Unknown,44,Unknown,Unknown,Unknown,Unknown,cid:12)(cid:29)(cid:26)(cid:41)(cid:25)(cid:2)(cid:58)(cid:58)(cid:37)(cid:16)(cid:34)(cid:33,Unknown,25206.0
Unknown,Unknown,12,Unknown,Unknown,Unknown,Unknown,cid:12)(cid:29)(cid:26)(cid:41)(cid:25)(cid:2)(cid:58)(cid:58)(cid:37)(cid:16)(cid:34)(cid:33,Unknown,25218.0
Unknown,Unknown,29,Unknown,Unknown,Unknown,Unknown,cid:12)(cid:29)(cid:26)(cid:41)(cid:25)(cid:2)(cid:58)(cid:58)(cid:37)(cid:16)(cid:34)(cid:33,Unknown,25247.0
Unknown,Unknown,26,Unknown,Unknown,Unknown,Unknown,cid:12)(cid:29)(cid:26)(cid:41)(cid:25)(cid:2)(cid:58)(cid:58)(cid:37)(cid:16)(cid:34)(cid:33,Unknown,25273.0
Unknown,Unknown,41,Unknown,Unknown,Unknown,Unknown,cid:12)(cid:29)(cid:26)(cid:41)(cid:25)(cid:2)(cid:58)(cid:58)(cid:37)(cid:16)(cid:34)(cid:33,Unknown,25314.0
Unknown,Unknown,25,Unknown,Unknown,Unknown,Unknown,cid:12)(cid:29)(cid:26)(cid:41)(cid:25)(cid:2)(cid:58)(cid:58)(cid:37)(cid:16)(cid:34)(cid:33,Unknown,25339.0
Unknown,Unknown,2,Unknown,Unknown,Unknown,Unknown,cid:12)(cid:29)(cid:26)(cid:41)(cid:25)(cid:2)(cid:58)(cid:58)(cid:37)(cid:16)(cid:34)(cid:33,Unknown,25341.0
Unknown,Unknown,58,Unknown,Unknown,Unknown,Unknown,cid:12)(cid:29)(cid:26)(cid:41)(cid:25)(cid:2)(cid:58)(cid:58)(cid:37)(cid:16)(cid:34)(cid:33,Unknown,25399.0
Unknown,Unknown,58,Unknown,Unknown,Unknown,Unknown,cid:12)(cid:29)(cid:26)(cid:41)(cid:25)(cid:2)(cid:58)(cid:58)(cid:37)(cid:16)(cid:34)(cid:33,Unknown,25457.0
Unknown,Unknown,37,Unknown,Unknown,Unknown,Unknown,cid:12)(cid:29)(cid:26)(cid:41)(cid:25)(cid:2)(cid:58)(cid:58)(cid:37)(cid:16)(cid:34)(cid:33,Unknown,25494.0
Unknown,Unknown,16,Unknown,Unknown,Unknown,Unknown,cid:12)(cid:29)(cid:26)(cid:41)(cid:25)(cid:2)(cid:58)(cid:58)(cid:37)(cid:16)(cid:34)(cid:33,Unknown,25510.0
Unknown,Unknown,34,Unknown,Unknown,Unknown,Unknown,cid:12)(cid:29)(cid:26)(cid:41)(cid:25)(cid:2)(cid:58)(cid:58)(cid:37)(cid:16)(cid:34)(cid:33,Unknown,25544.0
Unknown,Unknown,33,Unknown,Unknown,Unknown,Unknown,cid:12)(cid:29)(cid:26)(cid:41)(cid:25)(cid:2)(cid:58)(cid:58)(cid:37)(cid:16)(cid:34)(cid:33,Unknown,25577.0
Unknown,Unknown,1,Unknown,Unknown,Unknown,Unknown,cid:12)(cid:29)(cid:26)(cid:41)(cid:25)(cid:2)(cid:58)(cid:58)(cid:37)(cid:16)(cid:34)(cid:33,Unknown,25578.0
Unknown,Unknown,35,Unknown,Unknown,Unknown,Unknown,cid:12)(cid:29)(cid:26)(cid:41)(cid:25)(cid:2)(cid:58)(cid:58)(cid:37)(cid:16)(cid:34)(cid:33,Unknown,25613.0
Unknown,Unknown,45,Unknown,Unknown,Unknown,Unknown,cid:12)(cid:29)(cid:26)(cid:41)(cid:25)(cid:2)(cid:58)(cid:58)(cid:37)(cid:16)(cid:34)(cid:33,Unknown,25658.0
Unknown,Unknown,18,Unknown,Unknown,Unknown,Unknown,cid:12)(cid:29)(cid:26)(cid:41)(cid:25)(cid:2)(cid:58)(cid:58)(cid:37)(cid:16)(cid:34)(cid:33,Unknown,25676.0
Unknown,Unknown,16,Unknown,Unknown,Unknown,Unknown,cid:12)(cid:29)(cid:26)(cid:41)(cid:25)(cid:2)(cid:58)(cid:58)(cid:37)(cid:16)(cid:34)(cid:33,Unknown,25692.0
Unknown,Unknown,9,Unknown,Unknown,Unknown,Unknown,cid:12)(cid:29)(cid:26)(cid:41)(cid:25)(cid:2)(cid:58)(cid:58)(cid:37)(cid:16)(cid:34)(cid:33,Unknown,25701.0
Unknown,Unknown,46,Unknown,Unknown,Unknown,Unknown,cid:12)(cid:29)(cid:26)(cid:41)(cid:25)(cid:2)(cid:58)(cid:58)(cid:37)(cid:16)(cid:34)(cid:33,Unknown,25747.0
Unknown,Unknown,8,Unknown,Unknown,Unknown,Unknown,cid:12)(cid:29)(cid:26)(cid:41)(cid:25)(cid:2)(cid:58)(cid:58)(cid:37)(cid:16)(cid:34)(cid:33,Unknown,25755.0
Unknown,Unknown,5,Unknown,Unknown,Unknown,Unknown,cid:12)(cid:29)(cid:26)(cid:41)(cid:25)(cid:2)(cid:58)(cid:58)(cid:37)(cid:16)(cid:34)(cid:33,Unknown,25760.0
Unknown,Unknown,28,Unknown,Unknown,Unknown,Unknown,cid:12)(cid:29)(cid:26)(cid:41)(cid:25)(cid:2)(cid:58)(cid:58)(cid:37)(cid:16)(cid:34)(cid:33,Unknown,25788.0
Unknown,Unknown,2,Unknown,Unknown,Unknown,Unknown,cid:12)(cid:29)(cid:26)(cid:41)(cid:25)(cid:2)(cid:58)(cid:58)(cid:37)(cid:16)(cid:34)(cid:33,Unknown,25790.0
Unknown,Unknown,9,Unknown,Unknown,Unknown,Unknown,cid:12)(cid:29)(cid:26)(cid:41)(cid:25)(cid:2)(cid:58)(cid:58)(cid:37)(cid:16)(cid:34)(cid:33,Unknown,25799.0
Unknown,Unknown,5,Unknown,Unknown,Unknown,Unknown,cid:12)(cid:29)(cid:26)(cid:41)(cid:25)(cid:2)(cid:58)(cid:58)(cid:37)(cid:16)(cid:34)(cid:33,Unknown,25804.0
Unknown,Unknown,8,Unknown,Unknown,Unknown,Unknown,cid:12)(cid:29)(cid:26)(cid:41)(cid:25)(cid:2)(cid:58)(cid:58)(cid:37)(cid:16)(cid:34)(cid:33,Unknown,25812.0
Unknown,Unknown,14,Unknown,Unknown,Unknown,Unknown,cid:12)(cid:29)(cid:26)(cid:41)(cid:25)(cid:2)(cid:58)(cid:58)(cid:37)(cid:16)(cid:34)(cid:33,Unknown,25826.0
Unknown,Unknown,7,Unknown,Unknown,Unknown,Unknown,cid:12)(cid:29)(cid:26)(cid:41)(cid:25)(cid:2)(cid:58)(cid:58)(cid:37)(cid:16)(cid:34)(cid:33,Unknown,25833.0
Unknown,Unknown,9,Unknown,Unknown,Unknown,Unknown,cid:12)(cid:29)(cid:26)(cid:41)(cid:25)(cid:2)(cid:58)(cid:58)(cid:37)(cid:16)(cid:34)(cid:33,Unknown,25842.0
Unknown,Unknown,2,Unknown,Unknown,Unknown,Unknown,cid:12)(cid:29)(cid:26)(cid:41)(cid:25)(cid:2)(cid:58)(cid:58)(cid:37)(cid:16)(cid:34)(cid:33,Unknown,25844.0
Unknown,Unknown,28,Unknown,Unknown,Unknown,Unknown,cid:12)(cid:29)(cid:26)(cid:41)(cid:25)(cid:2)(cid:58)(cid:58)(cid:37)(cid:16)(cid:34)(cid:33,Unknown,25872.0
Unknown,Unknown,3,Unknown,Unknown,Unknown,Unknown,cid:12)(cid:29)(cid:26)(cid:41)(cid:25)(cid:2)(cid:58)(cid:58)(cid:37)(cid:16)(cid:34)(cid:33,Unknown,25875.0
Unknown,Unknown,15,Unknown,Unknown,Unknown,Unknown,cid:12)(cid:29)(cid:26)(cid:41)(cid:25)(cid:2)(cid:58)(cid:58)(cid:37)(cid:16)(cid:34)(cid:33,Unknown,25890.0
Unknown,Unknown,2,Unknown,Unknown,Unknown,Unknown,cid:12)(cid:29)(cid:26)(cid:41)(cid:25)(cid:2)(cid:58)(cid:58)(cid:37)(cid:16)(cid:34)(cid:33,Unknown,25892.0
Unknown,Unknown,1,Unknown,Unknown,Unknown,Unknown,cid:12)(cid:29)(cid:26)(cid:41)(cid:25)(cid:2)(cid:58)(cid:58)(cid:37)(cid:16)(cid:34)(cid:33,Unknown,25893.0
Unknown,Unknown,19,Unknown,Unknown,Unknown,Unknown,cid:12)(cid:29)(cid:26)(cid:41)(cid:25)(cid:2)(cid:58)(cid:58)(cid:37)(cid:16)(cid:34)(cid:33,Unknown,25912.0
Unknown,Unknown,37,Unknown,Unknown,Unknown,Unknown,cid:12)(cid:29)(cid:26)(cid:41)(cid:25)(cid:2)(cid:58)(cid:58)(cid:37)(cid:16)(cid:34)(cid:33,Unknown,25949.0
Unknown,Unknown,18,Unknown,Unknown,Unknown,Unknown,cid:12)(cid:29)(cid:26)(cid:41)(cid:25)(cid:2)(cid:58)(cid:58)(cid:37)(cid:16)(cid:34)(cid:33,Unknown,25967.0
Unknown,Unknown,2,Unknown,Unknown,Unknown,Unknown,cid:12)(cid:29)(cid:26)(cid:41)(cid:25)(cid:2)(cid:58)(cid:58)(cid:37)(cid:16)(cid:34)(cid:33,Unknown,25969.0
Unknown,Unknown,44,Unknown,Unknown,Unknown,Unknown,cid:12)(cid:29)(cid:26)(cid:41)(cid:25)(cid:2)(cid:58)(cid:58)(cid:37)(cid:16)(cid:34)(cid:33,Unknown,26013.0
Unknown,Unknown,12,Unknown,Unknown,Unknown,Unknown,cid:12)(cid:29)(cid:26)(cid:41)(cid:25)(cid:2)(cid:58)(cid:58)(cid:37)(cid:16)(cid:34)(cid:33,Unknown,26025.0
Unknown,Unknown,29,Unknown,Unknown,Unknown,Unknown,cid:12)(cid:29)(cid:26)(cid:41)(cid:25)(cid:2)(cid:58)(cid:58)(cid:37)(cid:16)(cid:34)(cid:33,Unknown,26054.0
Unknown,Unknown,26,Unknown,Unknown,Unknown,Unknown,cid:12)(cid:29)(cid:26)(cid:41)(cid:25)(cid:2)(cid:58)(cid:58)(cid:37)(cid:16)(cid:34)(cid:33,Unknown,26080.0
Unknown,Unknown,41,Unknown,Unknown,Unknown,Unknown,cid:12)(cid:29)(cid:26)(cid:41)(cid:25)(cid:2)(cid:58)(cid:58)(cid:37)(cid:16)(cid:34)(cid:33,Unknown,26121.0
Unknown,Unknown,25,Unknown,Unknown,Unknown,Unknown,cid:12)(cid:29)(cid:26)(cid:41)(cid:25)(cid:2)(cid:58)(cid:58)(cid:37)(cid:16)(cid:34)(cid:33,Unknown,26146.0
Unknown,Unknown,2,Unknown,Unknown,Unknown,Unknown,cid:12)(cid:29)(cid:26)(cid:41)(cid:25)(cid:2)(cid:58)(cid:58)(cid:37)(cid:16)(cid:34)(cid:33,Unknown,26148.0
Unknown,Unknown,58,Unknown,Unknown,Unknown,Unknown,cid:12)(cid:29)(cid:26)(cid:41)(cid:25)(cid:2)(cid:58)(cid:58)(cid:37)(cid:16)(cid:34)(cid:33,Unknown,26206.0
Unknown,Unknown,58,Unknown,Unknown,Unknown,Unknown,cid:12)(cid:29)(cid:26)(cid:41)(cid:25)(cid:2)(cid:58)(cid:58)(cid:37)(cid:16)(cid:34)(cid:33,Unknown,26264.0
Unknown,Unknown,37,Unknown,Unknown,Unknown,Unknown,cid:12)(cid:29)(cid:26)(cid:41)(cid:25)(cid:2)(cid:58)(cid:58)(cid:37)(cid:16)(cid:34)(cid:33,Unknown,26301.0
Unknown,Unknown,16,Unknown,Unknown,Unknown,Unknown,cid:12)(cid:29)(cid:26)(cid:41)(cid:25)(cid:2)(cid:58)(cid:58)(cid:37)(cid:16)(cid:34)(cid:33,Unknown,26317.0
Unknown,Unknown,34,Unknown,Unknown,Unknown,Unknown,cid:12)(cid:29)(cid:26)(cid:41)(cid:25)(cid:2)(cid:58)(cid:58)(cid:37)(cid:16)(cid:34)(cid:33,Unknown,26351.0
Unknown,Unknown,33,Unknown,Unknown,Unknown,Unknown,cid:12)(cid:29)(cid:26)(cid:41)(cid:25)(cid:2)(cid:58)(cid:58)(cid:37)(cid:16)(cid:34)(cid:33,Unknown,26384.0
Unknown,Unknown,1,Unknown,Unknown,Unknown,Unknown,cid:50)(cid:5)(cid:14)(cid:7)(cid:12)(cid:5)(cid:9)(cid:2)(cid:16)(cid:16)(cid:2)(cid:12)(cid:11)(cid:4)(cid:14)(cid:11)(cid:48)(cid:48)(cid:7)(cid:5)(cid:3)(cid:9)(cid:2)(cid:28)(cid:3,Unknown,1.0
Unknown,Unknown,33,Unknown,Unknown,Unknown,Unknown,cid:50)(cid:5)(cid:14)(cid:7)(cid:12)(cid:5)(cid:9)(cid:2)(cid:16)(cid:16)(cid:2)(cid:12)(cid:11)(cid:4)(cid:14)(cid:11)(cid:48)(cid:48)(cid:7)(cid:5)(cid:3)(cid:9)(cid:2)(cid:28)(cid:3,Unknown,34.0
Unknown,Unknown,45,Unknown,Unknown,Unknown,Unknown,cid:50)(cid:5)(cid:14)(cid:7)(cid:12)(cid:5)(cid:9)(cid:2)(cid:16)(cid:16)(cid:2)(cid:12)(cid:11)(cid:4)(cid:14)(cid:11)(cid:48)(cid:48)(cid:7)(cid:5)(cid:3)(cid:9)(cid:2)(cid:28)(cid:3,Unknown,79.0
Unknown,Unknown,18,Unknown,Unknown,Unknown,Unknown,cid:50)(cid:5)(cid:14)(cid:7)(cid:12)(cid:5)(cid:9)(cid:2)(cid:16)(cid:16)(cid:2)(cid:12)(cid:11)(cid:4)(cid:14)(cid:11)(cid:48)(cid:48)(cid:7)(cid:5)(cid:3)(cid:9)(cid:2)(cid:28)(cid:3,Unknown,97.0
Unknown,Unknown,16,Unknown,Unknown,Unknown,Unknown,cid:50)(cid:5)(cid:14)(cid:7)(cid:12)(cid:5)(cid:9)(cid:2)(cid:16)(cid:16)(cid:2)(cid:12)(cid:11)(cid:4)(cid:14)(cid:11)(cid:48)(cid:48)(cid:7)(cid:5)(cid:3)(cid:9)(cid:2)(cid:28)(cid:3,Unknown,113.0
Unknown,Unknown,50,Unknown,Unknown,Unknown,Unknown,cid:50)(cid:5)(cid:14)(cid:7)(cid:12)(cid:5)(cid:9)(cid:2)(cid:16)(cid:16)(cid:2)(cid:12)(cid:11)(cid:4)(cid:14)(cid:11)(cid:48)(cid:48)(cid:7)(cid:5)(cid:3)(cid:9)(cid:2)(cid:28)(cid:3,Unknown,163.0
Unknown,Unknown,5,Unknown,Unknown,Unknown,Unknown,cid:50)(cid:5)(cid:14)(cid:7)(cid:12)(cid:5)(cid:9)(cid:2)(cid:16)(cid:16)(cid:2)(cid:12)(cid:11)(cid:4)(cid:14)(cid:11)(cid:48)(cid:48)(cid:7)(cid:5)(cid:3)(cid:9)(cid:2)(cid:28)(cid:3,Unknown,168.0
Unknown,Unknown,14,Unknown,Unknown,Unknown,Unknown,cid:50)(cid:5)(cid:14)(cid:7)(cid:12)(cid:5)(cid:9)(cid:2)(cid:16)(cid:16)(cid:2)(cid:12)(cid:11)(cid:4)(cid:14)(cid:11)(cid:48)(cid:48)(cid:7)(cid:5)(cid:3)(cid:9)(cid:2)(cid:28)(cid:3,Unknown,182.0
Unknown,Unknown,7,Unknown,Unknown,Unknown,Unknown,cid:50)(cid:5)(cid:14)(cid:7)(cid:12)(cid:5)(cid:9)(cid:2)(cid:16)(cid:16)(cid:2)(cid:12)(cid:11)(cid:4)(cid:14)(cid:11)(cid:48)(cid:48)(cid:7)(cid:5)(cid:3)(cid:9)(cid:2)(cid:28)(cid:3,Unknown,189.0
Unknown,Unknown,12,Unknown,Unknown,Unknown,Unknown,cid:50)(cid:5)(cid:14)(cid:7)(cid:12)(cid:5)(cid:9)(cid:2)(cid:16)(cid:16)(cid:2)(cid:12)(cid:11)(cid:4)(cid:14)(cid:11)(cid:48)(cid:48)(cid:7)(cid:5)(cid:3)(cid:9)(cid:2)(cid:28)(cid:3,Unknown,201.0
Unknown,Unknown,5,Unknown,Unknown,Unknown,Unknown,cid:50)(cid:5)(cid:14)(cid:7)(cid:12)(cid:5)(cid:9)(cid:2)(cid:16)(cid:16)(cid:2)(cid:12)(cid:11)(cid:4)(cid:14)(cid:11)(cid:48)(cid:48)(cid:7)(cid:5)(cid:3)(cid:9)(cid:2)(cid:28)(cid:3,Unknown,206.0
Unknown,Unknown,9,Unknown,Unknown,Unknown,Unknown,cid:50)(cid:5)(cid:14)(cid:7)(cid:12)(cid:5)(cid:9)(cid:2)(cid:16)(cid:16)(cid:2)(cid:12)(cid:11)(cid:4)(cid:14)(cid:11)(cid:48)(cid:48)(cid:7)(cid:5)(cid:3)(cid:9)(cid:2)(cid:28)(cid:3,Unknown,215.0
Unknown,Unknown,2,Unknown,Unknown,Unknown,Unknown,cid:50)(cid:5)(cid:14)(cid:7)(cid:12)(cid:5)(cid:9)(cid:2)(cid:16)(cid:16)(cid:2)(cid:12)(cid:11)(cid:4)(cid:14)(cid:11)(cid:48)(cid:48)(cid:7)(cid:5)(cid:3)(cid:9)(cid:2)(cid:28)(cid:3,Unknown,217.0
Unknown,Unknown,16,Unknown,Unknown,Unknown,Unknown,cid:50)(cid:5)(cid:14)(cid:7)(cid:12)(cid:5)(cid:9)(cid:2)(cid:16)(cid:16)(cid:2)(cid:12)(cid:11)(cid:4)(cid:14)(cid:11)(cid:48)(cid:48)(cid:7)(cid:5)(cid:3)(cid:9)(cid:2)(cid:28)(cid:3,Unknown,233.0
Unknown,Unknown,16,Unknown,Unknown,Unknown,Unknown,cid:50)(cid:5)(cid:14)(cid:7)(cid:12)(cid:5)(cid:9)(cid:2)(cid:16)(cid:16)(cid:2)(cid:12)(cid:11)(cid:4)(cid:14)(cid:11)(cid:48)(cid:48)(cid:7)(cid:5)(cid:3)(cid:9)(cid:2)(cid:28)(cid:3,Unknown,249.0
Unknown,Unknown,2,Unknown,Unknown,Unknown,Unknown,cid:50)(cid:5)(cid:14)(cid:7)(cid:12)(cid:5)(cid:9)(cid:2)(cid:16)(cid:16)(cid:2)(cid:12)(cid:11)(cid:4)(cid:14)(cid:11)(cid:48)(cid:48)(cid:7)(cid:5)(cid:3)(cid:9)(cid:2)(cid:28)(cid:3,Unknown,251.0
Unknown,Unknown,12,Unknown,Unknown,Unknown,Unknown,cid:50)(cid:5)(cid:14)(cid:7)(cid:12)(cid:5)(cid:9)(cid:2)(cid:16)(cid:16)(cid:2)(cid:12)(cid:11)(cid:4)(cid:14)(cid:11)(cid:48)(cid:48)(cid:7)(cid:5)(cid:3)(cid:9)(cid:2)(cid:28)(cid:3,Unknown,263.0
Unknown,Unknown,11,Unknown,Unknown,Unknown,Unknown,cid:50)(cid:5)(cid:14)(cid:7)(cid:12)(cid:5)(cid:9)(cid:2)(cid:16)(cid:16)(cid:2)(cid:12)(cid:11)(cid:4)(cid:14)(cid:11)(cid:48)(cid:48)(cid:7)(cid:5)(cid:3)(cid:9)(cid:2)(cid:28)(cid:3,Unknown,274.0
Unknown,Unknown,4,Unknown,Unknown,Unknown,Unknown,cid:50)(cid:5)(cid:14)(cid:7)(cid:12)(cid:5)(cid:9)(cid:2)(cid:16)(cid:16)(cid:2)(cid:12)(cid:11)(cid:4)(cid:14)(cid:11)(cid:48)(cid:48)(cid:7)(cid:5)(cid:3)(cid:9)(cid:2)(cid:28)(cid:3,Unknown,278.0
Unknown,Unknown,14,Unknown,Unknown,Unknown,Unknown,cid:50)(cid:5)(cid:14)(cid:7)(cid:12)(cid:5)(cid:9)(cid:2)(cid:16)(cid:16)(cid:2)(cid:12)(cid:11)(cid:4)(cid:14)(cid:11)(cid:48)(cid:48)(cid:7)(cid:5)(cid:3)(cid:9)(cid:2)(cid:28)(cid:3,Unknown,292.0
Unknown,Unknown,11,Unknown,Unknown,Unknown,Unknown,cid:50)(cid:5)(cid:14)(cid:7)(cid:12)(cid:5)(cid:9)(cid:2)(cid:16)(cid:16)(cid:2)(cid:12)(cid:11)(cid:4)(cid:14)(cid:11)(cid:48)(cid:48)(cid:7)(cid:5)(cid:3)(cid:9)(cid:2)(cid:28)(cid:3,Unknown,303.0
Unknown,Unknown,48,Unknown,Unknown,Unknown,Unknown,cid:50)(cid:5)(cid:14)(cid:7)(cid:12)(cid:5)(cid:9)(cid:2)(cid:16)(cid:16)(cid:2)(cid:12)(cid:11)(cid:4)(cid:14)(cid:11)(cid:48)(cid:48)(cid:7)(cid:5)(cid:3)(cid:9)(cid:2)(cid:28)(cid:3,Unknown,351.0
Unknown,Unknown,48,Unknown,Unknown,Unknown,Unknown,cid:50)(cid:5)(cid:14)(cid:7)(cid:12)(cid:5)(cid:9)(cid:2)(cid:16)(cid:16)(cid:2)(cid:12)(cid:11)(cid:4)(cid:14)(cid:11)(cid:48)(cid:48)(cid:7)(cid:5)(cid:3)(cid:9)(cid:2)(cid:28)(cid:3,Unknown,399.0
Unknown,Unknown,7,Unknown,Unknown,Unknown,Unknown,cid:50)(cid:5)(cid:14)(cid:7)(cid:12)(cid:5)(cid:9)(cid:2)(cid:16)(cid:16)(cid:2)(cid:12)(cid:11)(cid:4)(cid:14)(cid:11)(cid:48)(cid:48)(cid:7)(cid:5)(cid:3)(cid:9)(cid:2)(cid:28)(cid:3,Unknown,406.0
Unknown,Unknown,5,Unknown,Unknown,Unknown,Unknown,cid:50)(cid:5)(cid:14)(cid:7)(cid:12)(cid:5)(cid:9)(cid:2)(cid:16)(cid:16)(cid:2)(cid:12)(cid:11)(cid:4)(cid:14)(cid:11)(cid:48)(cid:48)(cid:7)(cid:5)(cid:3)(cid:9)(cid:2)(cid:28)(cid:3,Unknown,411.0
Unknown,Unknown,3,Unknown,Unknown,Unknown,Unknown,cid:50)(cid:5)(cid:14)(cid:7)(cid:12)(cid:5)(cid:9)(cid:2)(cid:16)(cid:16)(cid:2)(cid:12)(cid:11)(cid:4)(cid:14)(cid:11)(cid:48)(cid:48)(cid:7)(cid:5)(cid:3)(cid:9)(cid:2)(cid:28)(cid:3,Unknown,414.0
Unknown,Unknown,9,Unknown,Unknown,Unknown,Unknown,cid:50)(cid:5)(cid:14)(cid:7)(cid:12)(cid:5)(cid:9)(cid:2)(cid:16)(cid:16)(cid:2)(cid:12)(cid:11)(cid:4)(cid:14)(cid:11)(cid:48)(cid:48)(cid:7)(cid:5)(cid:3)(cid:9)(cid:2)(cid:28)(cid:3,Unknown,423.0
Unknown,Unknown,2,Unknown,Unknown,Unknown,Unknown,cid:50)(cid:5)(cid:14)(cid:7)(cid:12)(cid:5)(cid:9)(cid:2)(cid:16)(cid:16)(cid:2)(cid:12)(cid:11)(cid:4)(cid:14)(cid:11)(cid:48)(cid:48)(cid:7)(cid:5)(cid:3)(cid:9)(cid:2)(cid:28)(cid:3,Unknown,425.0
Unknown,Unknown,28,Unknown,Unknown,Unknown,Unknown,cid:50)(cid:5)(cid:14)(cid:7)(cid:12)(cid:5)(cid:9)(cid:2)(cid:16)(cid:16)(cid:2)(cid:12)(cid:11)(cid:4)(cid:14)(cid:11)(cid:48)(cid:48)(cid:7)(cid:5)(cid:3)(cid:9)(cid:2)(cid:28)(cid:3,Unknown,453.0
Unknown,Unknown,3,Unknown,Unknown,Unknown,Unknown,cid:50)(cid:5)(cid:14)(cid:7)(cid:12)(cid:5)(cid:9)(cid:2)(cid:16)(cid:16)(cid:2)(cid:12)(cid:11)(cid:4)(cid:14)(cid:11)(cid:48)(cid:48)(cid:7)(cid:5)(cid:3)(cid:9)(cid:2)(cid:28)(cid:3,Unknown,456.0
Unknown,Unknown,15,Unknown,Unknown,Unknown,Unknown,cid:50)(cid:5)(cid:14)(cid:7)(cid:12)(cid:5)(cid:9)(cid:2)(cid:16)(cid:16)(cid:2)(cid:12)(cid:11)(cid:4)(cid:14)(cid:11)(cid:48)(cid:48)(cid:7)(cid:5)(cid:3)(cid:9)(cid:2)(cid:28)(cid:3,Unknown,471.0
Unknown,Unknown,2,Unknown,Unknown,Unknown,Unknown,cid:50)(cid:5)(cid:14)(cid:7)(cid:12)(cid:5)(cid:9)(cid:2)(cid:16)(cid:16)(cid:2)(cid:12)(cid:11)(cid:4)(cid:14)(cid:11)(cid:48)(cid:48)(cid:7)(cid:5)(cid:3)(cid:9)(cid:2)(cid:28)(cid:3,Unknown,473.0
Unknown,Unknown,17,Unknown,Unknown,Unknown,Unknown,cid:50)(cid:5)(cid:14)(cid:7)(cid:12)(cid:5)(cid:9)(cid:2)(cid:16)(cid:16)(cid:2)(cid:12)(cid:11)(cid:4)(cid:14)(cid:11)(cid:48)(cid:48)(cid:7)(cid:5)(cid:3)(cid:9)(cid:2)(cid:28)(cid:3,Unknown,490.0
Unknown,Unknown,17,Unknown,Unknown,Unknown,Unknown,cid:50)(cid:5)(cid:14)(cid:7)(cid:12)(cid:5)(cid:9)(cid:2)(cid:16)(cid:16)(cid:2)(cid:12)(cid:11)(cid:4)(cid:14)(cid:11)(cid:48)(cid:48)(cid:7)(cid:5)(cid:3)(cid:9)(cid:2)(cid:28)(cid:3,Unknown,507.0
Unknown,Unknown,19,Unknown,Unknown,Unknown,Unknown,cid:50)(cid:5)(cid:14)(cid:7)(cid:12)(cid:5)(cid:9)(cid:2)(cid:16)(cid:16)(cid:2)(cid:12)(cid:11)(cid:4)(cid:14)(cid:11)(cid:48)(cid:48)(cid:7)(cid:5)(cid:3)(cid:9)(cid:2)(cid:28)(cid:3,Unknown,526.0
Unknown,Unknown,34,Unknown,Unknown,Unknown,Unknown,cid:50)(cid:5)(cid:14)(cid:7)(cid:12)(cid:5)(cid:9)(cid:2)(cid:16)(cid:16)(cid:2)(cid:12)(cid:11)(cid:4)(cid:14)(cid:11)(cid:48)(cid:48)(cid:7)(cid:5)(cid:3)(cid:9)(cid:2)(cid:28)(cid:3,Unknown,560.0
Unknown,Unknown,18,Unknown,Unknown,Unknown,Unknown,cid:50)(cid:5)(cid:14)(cid:7)(cid:12)(cid:5)(cid:9)(cid:2)(cid:16)(cid:16)(cid:2)(cid:12)(cid:11)(cid:4)(cid:14)(cid:11)(cid:48)(cid:48)(cid:7)(cid:5)(cid:3)(cid:9)(cid:2)(cid:28)(cid:3,Unknown,578.0
Unknown,Unknown,2,Unknown,Unknown,Unknown,Unknown,cid:50)(cid:5)(cid:14)(cid:7)(cid:12)(cid:5)(cid:9)(cid:2)(cid:16)(cid:16)(cid:2)(cid:12)(cid:11)(cid:4)(cid:14)(cid:11)(cid:48)(cid:48)(cid:7)(cid:5)(cid:3)(cid:9)(cid:2)(cid:28)(cid:3,Unknown,580.0
Unknown,Unknown,44,Unknown,Unknown,Unknown,Unknown,cid:50)(cid:5)(cid:14)(cid:7)(cid:12)(cid:5)(cid:9)(cid:2)(cid:16)(cid:16)(cid:2)(cid:12)(cid:11)(cid:4)(cid:14)(cid:11)(cid:48)(cid:48)(cid:7)(cid:5)(cid:3)(cid:9)(cid:2)(cid:28)(cid:3,Unknown,624.0
Unknown,Unknown,12,Unknown,Unknown,Unknown,Unknown,cid:50)(cid:5)(cid:14)(cid:7)(cid:12)(cid:5)(cid:9)(cid:2)(cid:16)(cid:16)(cid:2)(cid:12)(cid:11)(cid:4)(cid:14)(cid:11)(cid:48)(cid:48)(cid:7)(cid:5)(cid:3)(cid:9)(cid:2)(cid:28)(cid:3,Unknown,636.0
Unknown,Unknown,29,Unknown,Unknown,Unknown,Unknown,cid:50)(cid:5)(cid:14)(cid:7)(cid:12)(cid:5)(cid:9)(cid:2)(cid:16)(cid:16)(cid:2)(cid:12)(cid:11)(cid:4)(cid:14)(cid:11)(cid:48)(cid:48)(cid:7)(cid:5)(cid:3)(cid:9)(cid:2)(cid:28)(cid:3,Unknown,665.0
Unknown,Unknown,26,Unknown,Unknown,Unknown,Unknown,cid:50)(cid:5)(cid:14)(cid:7)(cid:12)(cid:5)(cid:9)(cid:2)(cid:16)(cid:16)(cid:2)(cid:12)(cid:11)(cid:4)(cid:14)(cid:11)(cid:48)(cid:48)(cid:7)(cid:5)(cid:3)(cid:9)(cid:2)(cid:28)(cid:3,Unknown,691.0
Unknown,Unknown,41,Unknown,Unknown,Unknown,Unknown,cid:50)(cid:5)(cid:14)(cid:7)(cid:12)(cid:5)(cid:9)(cid:2)(cid:16)(cid:16)(cid:2)(cid:12)(cid:11)(cid:4)(cid:14)(cid:11)(cid:48)(cid:48)(cid:7)(cid:5)(cid:3)(cid:9)(cid:2)(cid:28)(cid:3,Unknown,732.0
Unknown,Unknown,25,Unknown,Unknown,Unknown,Unknown,cid:50)(cid:5)(cid:14)(cid:7)(cid:12)(cid:5)(cid:9)(cid:2)(cid:16)(cid:16)(cid:2)(cid:12)(cid:11)(cid:4)(cid:14)(cid:11)(cid:48)(cid:48)(cid:7)(cid:5)(cid:3)(cid:9)(cid:2)(cid:28)(cid:3,Unknown,757.0
Unknown,Unknown,2,Unknown,Unknown,Unknown,Unknown,cid:50)(cid:5)(cid:14)(cid:7)(cid:12)(cid:5)(cid:9)(cid:2)(cid:16)(cid:16)(cid:2)(cid:12)(cid:11)(cid:4)(cid:14)(cid:11)(cid:48)(cid:48)(cid:7)(cid:5)(cid:3)(cid:9)(cid:2)(cid:28)(cid:3,Unknown,759.0
Unknown,Unknown,58,Unknown,Unknown,Unknown,Unknown,cid:50)(cid:5)(cid:14)(cid:7)(cid:12)(cid:5)(cid:9)(cid:2)(cid:16)(cid:16)(cid:2)(cid:12)(cid:11)(cid:4)(cid:14)(cid:11)(cid:48)(cid:48)(cid:7)(cid:5)(cid:3)(cid:9)(cid:2)(cid:28)(cid:3,Unknown,817.0
Unknown,Unknown,58,Unknown,Unknown,Unknown,Unknown,cid:50)(cid:5)(cid:14)(cid:7)(cid:12)(cid:5)(cid:9)(cid:2)(cid:16)(cid:16)(cid:2)(cid:12)(cid:11)(cid:4)(cid:14)(cid:11)(cid:48)(cid:48)(cid:7)(cid:5)(cid:3)(cid:9)(cid:2)(cid:28)(cid:3,Unknown,875.0
Unknown,Unknown,18,Unknown,Unknown,Unknown,Unknown,cid:50)(cid:5)(cid:14)(cid:7)(cid:12)(cid:5)(cid:9)(cid:2)(cid:16)(cid:16)(cid:2)(cid:12)(cid:11)(cid:4)(cid:14)(cid:11)(cid:48)(cid:48)(cid:7)(cid:5)(cid:3)(cid:9)(cid:2)(cid:28)(cid:3,Unknown,893.0
Unknown,Unknown,1,Unknown,Unknown,Unknown,Unknown,cid:50)(cid:5)(cid:14)(cid:7)(cid:12)(cid:5)(cid:9)(cid:2)(cid:16)(cid:16)(cid:2)(cid:12)(cid:11)(cid:4)(cid:14)(cid:11)(cid:48)(cid:48)(cid:7)(cid:5)(cid:3)(cid:9)(cid:2)(cid:28)(cid:3,Unknown,894.0
Unknown,Unknown,1,Unknown,Unknown,Unknown,Unknown,cid:50)(cid:5)(cid:14)(cid:7)(cid:12)(cid:5)(cid:9)(cid:2)(cid:16)(cid:16)(cid:2)(cid:12)(cid:11)(cid:4)(cid:14)(cid:11)(cid:48)(cid:48)(cid:7)(cid:5)(cid:3)(cid:9)(cid:2)(cid:28)(cid:3,Unknown,895.0
Unknown,Unknown,37,Unknown,Unknown,Unknown,Unknown,cid:50)(cid:5)(cid:14)(cid:7)(cid:12)(cid:5)(cid:9)(cid:2)(cid:16)(cid:16)(cid:2)(cid:12)(cid:11)(cid:4)(cid:14)(cid:11)(cid:48)(cid:48)(cid:7)(cid:5)(cid:3)(cid:9)(cid:2)(cid:28)(cid:3,Unknown,932.0
Unknown,Unknown,37,Unknown,Unknown,Unknown,Unknown,cid:50)(cid:5)(cid:14)(cid:7)(cid:12)(cid:5)(cid:9)(cid:2)(cid:16)(cid:16)(cid:2)(cid:12)(cid:11)(cid:4)(cid:14)(cid:11)(cid:48)(cid:48)(cid:7)(cid:5)(cid:3)(cid:9)(cid:2)(cid:28)(cid:3,Unknown,969.0
Unknown,Unknown,18,Unknown,Unknown,Unknown,Unknown,cid:50)(cid:5)(cid:14)(cid:7)(cid:12)(cid:5)(cid:9)(cid:2)(cid:16)(cid:16)(cid:2)(cid:12)(cid:11)(cid:4)(cid:14)(cid:11)(cid:48)(cid:48)(cid:7)(cid:5)(cid:3)(cid:9)(cid:2)(cid:28)(cid:3,Unknown,987.0
Unknown,Unknown,45,Unknown,Unknown,Unknown,Unknown,cid:50)(cid:5)(cid:14)(cid:7)(cid:12)(cid:5)(cid:9)(cid:2)(cid:16)(cid:16)(cid:2)(cid:12)(cid:11)(cid:4)(cid:14)(cid:11)(cid:48)(cid:48)(cid:7)(cid:5)(cid:3)(cid:9)(cid:2)(cid:28)(cid:3,Unknown,1032.0
Unknown,Unknown,18,Unknown,Unknown,Unknown,Unknown,cid:50)(cid:5)(cid:14)(cid:7)(cid:12)(cid:5)(cid:9)(cid:2)(cid:16)(cid:16)(cid:2)(cid:12)(cid:11)(cid:4)(cid:14)(cid:11)(cid:48)(cid:48)(cid:7)(cid:5)(cid:3)(cid:9)(cid:2)(cid:28)(cid:3,Unknown,1050.0
Unknown,Unknown,16,Unknown,Unknown,Unknown,Unknown,cid:50)(cid:5)(cid:14)(cid:7)(cid:12)(cid:5)(cid:9)(cid:2)(cid:16)(cid:16)(cid:2)(cid:12)(cid:11)(cid:4)(cid:14)(cid:11)(cid:48)(cid:48)(cid:7)(cid:5)(cid:3)(cid:9)(cid:2)(cid:28)(cid:3,Unknown,1066.0
Unknown,Unknown,12,Unknown,Unknown,Unknown,Unknown,cid:50)(cid:5)(cid:14)(cid:7)(cid:12)(cid:5)(cid:9)(cid:2)(cid:16)(cid:16)(cid:2)(cid:12)(cid:11)(cid:4)(cid:14)(cid:11)(cid:48)(cid:48)(cid:7)(cid:5)(cid:3)(cid:9)(cid:2)(cid:28)(cid:3,Unknown,1078.0
Unknown,Unknown,46,Unknown,Unknown,Unknown,Unknown,cid:50)(cid:5)(cid:14)(cid:7)(cid:12)(cid:5)(cid:9)(cid:2)(cid:16)(cid:16)(cid:2)(cid:12)(cid:11)(cid:4)(cid:14)(cid:11)(cid:48)(cid:48)(cid:7)(cid:5)(cid:3)(cid:9)(cid:2)(cid:28)(cid:3,Unknown,1124.0
Unknown,Unknown,3,Unknown,Unknown,Unknown,Unknown,cid:50)(cid:5)(cid:14)(cid:7)(cid:12)(cid:5)(cid:9)(cid:2)(cid:16)(cid:16)(cid:2)(cid:12)(cid:11)(cid:4)(cid:14)(cid:11)(cid:48)(cid:48)(cid:7)(cid:5)(cid:3)(cid:9)(cid:2)(cid:28)(cid:3,Unknown,1127.0
Unknown,Unknown,3,Unknown,Unknown,Unknown,Unknown,cid:50)(cid:5)(cid:14)(cid:7)(cid:12)(cid:5)(cid:9)(cid:2)(cid:16)(cid:16)(cid:2)(cid:12)(cid:11)(cid:4)(cid:14)(cid:11)(cid:48)(cid:48)(cid:7)(cid:5)(cid:3)(cid:9)(cid:2)(cid:28)(cid:3,Unknown,1130.0
Unknown,Unknown,5,Unknown,Unknown,Unknown,Unknown,cid:50)(cid:5)(cid:14)(cid:7)(cid:12)(cid:5)(cid:9)(cid:2)(cid:16)(cid:16)(cid:2)(cid:12)(cid:11)(cid:4)(cid:14)(cid:11)(cid:48)(cid:48)(cid:7)(cid:5)(cid:3)(cid:9)(cid:2)(cid:28)(cid:3,Unknown,1135.0
Unknown,Unknown,28,Unknown,Unknown,Unknown,Unknown,cid:50)(cid:5)(cid:14)(cid:7)(cid:12)(cid:5)(cid:9)(cid:2)(cid:16)(cid:16)(cid:2)(cid:12)(cid:11)(cid:4)(cid:14)(cid:11)(cid:48)(cid:48)(cid:7)(cid:5)(cid:3)(cid:9)(cid:2)(cid:28)(cid:3,Unknown,1163.0
Unknown,Unknown,11,Unknown,Unknown,Unknown,Unknown,cid:50)(cid:5)(cid:14)(cid:7)(cid:12)(cid:5)(cid:9)(cid:2)(cid:16)(cid:16)(cid:2)(cid:12)(cid:11)(cid:4)(cid:14)(cid:11)(cid:48)(cid:48)(cid:7)(cid:5)(cid:3)(cid:9)(cid:2)(cid:28)(cid:3,Unknown,1174.0
Unknown,Unknown,4,Unknown,Unknown,Unknown,Unknown,cid:50)(cid:5)(cid:14)(cid:7)(cid:12)(cid:5)(cid:9)(cid:2)(cid:16)(cid:16)(cid:2)(cid:12)(cid:11)(cid:4)(cid:14)(cid:11)(cid:48)(cid:48)(cid:7)(cid:5)(cid:3)(cid:9)(cid:2)(cid:28)(cid:3,Unknown,1178.0
Unknown,Unknown,3,Unknown,Unknown,Unknown,Unknown,cid:50)(cid:5)(cid:14)(cid:7)(cid:12)(cid:5)(cid:9)(cid:2)(cid:16)(cid:16)(cid:2)(cid:12)(cid:11)(cid:4)(cid:14)(cid:11)(cid:48)(cid:48)(cid:7)(cid:5)(cid:3)(cid:9)(cid:2)(cid:28)(cid:3,Unknown,1181.0
Unknown,Unknown,2,Unknown,Unknown,Unknown,Unknown,cid:50)(cid:5)(cid:14)(cid:7)(cid:12)(cid:5)(cid:9)(cid:2)(cid:16)(cid:16)(cid:2)(cid:12)(cid:11)(cid:4)(cid:14)(cid:11)(cid:48)(cid:48)(cid:7)(cid:5)(cid:3)(cid:9)(cid:2)(cid:28)(cid:3,Unknown,1183.0
Unknown,Unknown,48,Unknown,Unknown,Unknown,Unknown,cid:50)(cid:5)(cid:14)(cid:7)(cid:12)(cid:5)(cid:9)(cid:2)(cid:16)(cid:16)(cid:2)(cid:12)(cid:11)(cid:4)(cid:14)(cid:11)(cid:48)(cid:48)(cid:7)(cid:5)(cid:3)(cid:9)(cid:2)(cid:28)(cid:3,Unknown,1231.0
Unknown,Unknown,46,Unknown,Unknown,Unknown,Unknown,cid:50)(cid:5)(cid:14)(cid:7)(cid:12)(cid:5)(cid:9)(cid:2)(cid:16)(cid:16)(cid:2)(cid:12)(cid:11)(cid:4)(cid:14)(cid:11)(cid:48)(cid:48)(cid:7)(cid:5)(cid:3)(cid:9)(cid:2)(cid:28)(cid:3,Unknown,1277.0
Unknown,Unknown,3,Unknown,Unknown,Unknown,Unknown,cid:50)(cid:5)(cid:14)(cid:7)(cid:12)(cid:5)(cid:9)(cid:2)(cid:16)(cid:16)(cid:2)(cid:12)(cid:11)(cid:4)(cid:14)(cid:11)(cid:48)(cid:48)(cid:7)(cid:5)(cid:3)(cid:9)(cid:2)(cid:28)(cid:3,Unknown,1280.0
Unknown,Unknown,65,Unknown,Unknown,Unknown,Unknown,cid:50)(cid:5)(cid:14)(cid:7)(cid:12)(cid:5)(cid:9)(cid:2)(cid:16)(cid:16)(cid:2)(cid:12)(cid:11)(cid:4)(cid:14)(cid:11)(cid:48)(cid:48)(cid:7)(cid:5)(cid:3)(cid:9)(cid:2)(cid:28)(cid:3,Unknown,1345.0
Unknown,Unknown,5,Unknown,Unknown,Unknown,Unknown,cid:50)(cid:5)(cid:14)(cid:7)(cid:12)(cid:5)(cid:9)(cid:2)(cid:16)(cid:16)(cid:2)(cid:12)(cid:11)(cid:4)(cid:14)(cid:11)(cid:48)(cid:48)(cid:7)(cid:5)(cid:3)(cid:9)(cid:2)(cid:28)(cid:3,Unknown,1350.0
Unknown,Unknown,2,Unknown,Unknown,Unknown,Unknown,cid:50)(cid:5)(cid:14)(cid:7)(cid:12)(cid:5)(cid:9)(cid:2)(cid:16)(cid:16)(cid:2)(cid:12)(cid:11)(cid:4)(cid:14)(cid:11)(cid:48)(cid:48)(cid:7)(cid:5)(cid:3)(cid:9)(cid:2)(cid:28)(cid:3,Unknown,1352.0
Unknown,Unknown,3,Unknown,Unknown,Unknown,Unknown,cid:50)(cid:5)(cid:14)(cid:7)(cid:12)(cid:5)(cid:9)(cid:2)(cid:16)(cid:16)(cid:2)(cid:12)(cid:11)(cid:4)(cid:14)(cid:11)(cid:48)(cid:48)(cid:7)(cid:5)(cid:3)(cid:9)(cid:2)(cid:28)(cid:3,Unknown,1355.0
Unknown,Unknown,5,Unknown,Unknown,Unknown,Unknown,cid:50)(cid:5)(cid:14)(cid:7)(cid:12)(cid:5)(cid:9)(cid:2)(cid:16)(cid:16)(cid:2)(cid:12)(cid:11)(cid:4)(cid:14)(cid:11)(cid:48)(cid:48)(cid:7)(cid:5)(cid:3)(cid:9)(cid:2)(cid:28)(cid:3,Unknown,1360.0
Unknown,Unknown,47,Unknown,Unknown,Unknown,Unknown,cid:50)(cid:5)(cid:14)(cid:7)(cid:12)(cid:5)(cid:9)(cid:2)(cid:16)(cid:16)(cid:2)(cid:12)(cid:11)(cid:4)(cid:14)(cid:11)(cid:48)(cid:48)(cid:7)(cid:5)(cid:3)(cid:9)(cid:2)(cid:28)(cid:3,Unknown,1407.0
Unknown,Unknown,46,Unknown,Unknown,Unknown,Unknown,cid:50)(cid:5)(cid:14)(cid:7)(cid:12)(cid:5)(cid:9)(cid:2)(cid:16)(cid:16)(cid:2)(cid:12)(cid:11)(cid:4)(cid:14)(cid:11)(cid:48)(cid:48)(cid:7)(cid:5)(cid:3)(cid:9)(cid:2)(cid:28)(cid:3,Unknown,1453.0
Unknown,Unknown,7,Unknown,Unknown,Unknown,Unknown,cid:50)(cid:5)(cid:14)(cid:7)(cid:12)(cid:5)(cid:9)(cid:2)(cid:16)(cid:16)(cid:2)(cid:12)(cid:11)(cid:4)(cid:14)(cid:11)(cid:48)(cid:48)(cid:7)(cid:5)(cid:3)(cid:9)(cid:2)(cid:28)(cid:3,Unknown,1460.0
Unknown,Unknown,9,Unknown,Unknown,Unknown,Unknown,cid:50)(cid:5)(cid:14)(cid:7)(cid:12)(cid:5)(cid:9)(cid:2)(cid:16)(cid:16)(cid:2)(cid:12)(cid:11)(cid:4)(cid:14)(cid:11)(cid:48)(cid:48)(cid:7)(cid:5)(cid:3)(cid:9)(cid:2)(cid:28)(cid:3,Unknown,1469.0
Unknown,Unknown,2,Unknown,Unknown,Unknown,Unknown,cid:50)(cid:5)(cid:14)(cid:7)(cid:12)(cid:5)(cid:9)(cid:2)(cid:16)(cid:16)(cid:2)(cid:12)(cid:11)(cid:4)(cid:14)(cid:11)(cid:48)(cid:48)(cid:7)(cid:5)(cid:3)(cid:9)(cid:2)(cid:28)(cid:3,Unknown,1471.0
Unknown,Unknown,28,Unknown,Unknown,Unknown,Unknown,cid:50)(cid:5)(cid:14)(cid:7)(cid:12)(cid:5)(cid:9)(cid:2)(cid:16)(cid:16)(cid:2)(cid:12)(cid:11)(cid:4)(cid:14)(cid:11)(cid:48)(cid:48)(cid:7)(cid:5)(cid:3)(cid:9)(cid:2)(cid:28)(cid:3,Unknown,1499.0
Unknown,Unknown,3,Unknown,Unknown,Unknown,Unknown,cid:50)(cid:5)(cid:14)(cid:7)(cid:12)(cid:5)(cid:9)(cid:2)(cid:16)(cid:16)(cid:2)(cid:12)(cid:11)(cid:4)(cid:14)(cid:11)(cid:48)(cid:48)(cid:7)(cid:5)(cid:3)(cid:9)(cid:2)(cid:28)(cid:3,Unknown,1502.0
Unknown,Unknown,15,Unknown,Unknown,Unknown,Unknown,cid:50)(cid:5)(cid:14)(cid:7)(cid:12)(cid:5)(cid:9)(cid:2)(cid:16)(cid:16)(cid:2)(cid:12)(cid:11)(cid:4)(cid:14)(cid:11)(cid:48)(cid:48)(cid:7)(cid:5)(cid:3)(cid:9)(cid:2)(cid:28)(cid:3,Unknown,1517.0
Unknown,Unknown,2,Unknown,Unknown,Unknown,Unknown,cid:50)(cid:5)(cid:14)(cid:7)(cid:12)(cid:5)(cid:9)(cid:2)(cid:16)(cid:16)(cid:2)(cid:12)(cid:11)(cid:4)(cid:14)(cid:11)(cid:48)(cid:48)(cid:7)(cid:5)(cid:3)(cid:9)(cid:2)(cid:28)(cid:3,Unknown,1519.0
Unknown,Unknown,17,Unknown,Unknown,Unknown,Unknown,cid:50)(cid:5)(cid:14)(cid:7)(cid:12)(cid:5)(cid:9)(cid:2)(cid:16)(cid:16)(cid:2)(cid:12)(cid:11)(cid:4)(cid:14)(cid:11)(cid:48)(cid:48)(cid:7)(cid:5)(cid:3)(cid:9)(cid:2)(cid:28)(cid:3,Unknown,1536.0
Unknown,Unknown,32,Unknown,Unknown,Unknown,Unknown,cid:50)(cid:5)(cid:14)(cid:7)(cid:12)(cid:5)(cid:9)(cid:2)(cid:16)(cid:16)(cid:2)(cid:12)(cid:11)(cid:4)(cid:14)(cid:11)(cid:48)(cid:48)(cid:7)(cid:5)(cid:3)(cid:9)(cid:2)(cid:28)(cid:3,Unknown,1568.0
Unknown,Unknown,19,Unknown,Unknown,Unknown,Unknown,cid:50)(cid:5)(cid:14)(cid:7)(cid:12)(cid:5)(cid:9)(cid:2)(cid:16)(cid:16)(cid:2)(cid:12)(cid:11)(cid:4)(cid:14)(cid:11)(cid:48)(cid:48)(cid:7)(cid:5)(cid:3)(cid:9)(cid:2)(cid:28)(cid:3,Unknown,1587.0
Unknown,Unknown,18,Unknown,Unknown,Unknown,Unknown,cid:50)(cid:5)(cid:14)(cid:7)(cid:12)(cid:5)(cid:9)(cid:2)(cid:16)(cid:16)(cid:2)(cid:12)(cid:11)(cid:4)(cid:14)(cid:11)(cid:48)(cid:48)(cid:7)(cid:5)(cid:3)(cid:9)(cid:2)(cid:28)(cid:3,Unknown,1605.0
Unknown,Unknown,18,Unknown,Unknown,Unknown,Unknown,cid:50)(cid:5)(cid:14)(cid:7)(cid:12)(cid:5)(cid:9)(cid:2)(cid:16)(cid:16)(cid:2)(cid:12)(cid:11)(cid:4)(cid:14)(cid:11)(cid:48)(cid:48)(cid:7)(cid:5)(cid:3)(cid:9)(cid:2)(cid:28)(cid:3,Unknown,1623.0
Unknown,Unknown,2,Unknown,Unknown,Unknown,Unknown,cid:50)(cid:5)(cid:14)(cid:7)(cid:12)(cid:5)(cid:9)(cid:2)(cid:16)(cid:16)(cid:2)(cid:12)(cid:11)(cid:4)(cid:14)(cid:11)(cid:48)(cid:48)(cid:7)(cid:5)(cid:3)(cid:9)(cid:2)(cid:28)(cid:3,Unknown,1625.0
Unknown,Unknown,44,Unknown,Unknown,Unknown,Unknown,cid:50)(cid:5)(cid:14)(cid:7)(cid:12)(cid:5)(cid:9)(cid:2)(cid:16)(cid:16)(cid:2)(cid:12)(cid:11)(cid:4)(cid:14)(cid:11)(cid:48)(cid:48)(cid:7)(cid:5)(cid:3)(cid:9)(cid:2)(cid:28)(cid:3,Unknown,1669.0
Unknown,Unknown,12,Unknown,Unknown,Unknown,Unknown,cid:50)(cid:5)(cid:14)(cid:7)(cid:12)(cid:5)(cid:9)(cid:2)(cid:16)(cid:16)(cid:2)(cid:12)(cid:11)(cid:4)(cid:14)(cid:11)(cid:48)(cid:48)(cid:7)(cid:5)(cid:3)(cid:9)(cid:2)(cid:28)(cid:3,Unknown,1681.0
Unknown,Unknown,29,Unknown,Unknown,Unknown,Unknown,cid:50)(cid:5)(cid:14)(cid:7)(cid:12)(cid:5)(cid:9)(cid:2)(cid:16)(cid:16)(cid:2)(cid:12)(cid:11)(cid:4)(cid:14)(cid:11)(cid:48)(cid:48)(cid:7)(cid:5)(cid:3)(cid:9)(cid:2)(cid:28)(cid:3,Unknown,1710.0
Unknown,Unknown,26,Unknown,Unknown,Unknown,Unknown,cid:50)(cid:5)(cid:14)(cid:7)(cid:12)(cid:5)(cid:9)(cid:2)(cid:16)(cid:16)(cid:2)(cid:12)(cid:11)(cid:4)(cid:14)(cid:11)(cid:48)(cid:48)(cid:7)(cid:5)(cid:3)(cid:9)(cid:2)(cid:28)(cid:3,Unknown,1736.0
Unknown,Unknown,41,Unknown,Unknown,Unknown,Unknown,cid:50)(cid:5)(cid:14)(cid:7)(cid:12)(cid:5)(cid:9)(cid:2)(cid:16)(cid:16)(cid:2)(cid:12)(cid:11)(cid:4)(cid:14)(cid:11)(cid:48)(cid:48)(cid:7)(cid:5)(cid:3)(cid:9)(cid:2)(cid:28)(cid:3,Unknown,1777.0
Unknown,Unknown,25,Unknown,Unknown,Unknown,Unknown,cid:50)(cid:5)(cid:14)(cid:7)(cid:12)(cid:5)(cid:9)(cid:2)(cid:16)(cid:16)(cid:2)(cid:12)(cid:11)(cid:4)(cid:14)(cid:11)(cid:48)(cid:48)(cid:7)(cid:5)(cid:3)(cid:9)(cid:2)(cid:28)(cid:3,Unknown,1802.0
Unknown,Unknown,2,Unknown,Unknown,Unknown,Unknown,cid:50)(cid:5)(cid:14)(cid:7)(cid:12)(cid:5)(cid:9)(cid:2)(cid:16)(cid:16)(cid:2)(cid:12)(cid:11)(cid:4)(cid:14)(cid:11)(cid:48)(cid:48)(cid:7)(cid:5)(cid:3)(cid:9)(cid:2)(cid:28)(cid:3,Unknown,1804.0
Unknown,Unknown,58,Unknown,Unknown,Unknown,Unknown,cid:50)(cid:5)(cid:14)(cid:7)(cid:12)(cid:5)(cid:9)(cid:2)(cid:16)(cid:16)(cid:2)(cid:12)(cid:11)(cid:4)(cid:14)(cid:11)(cid:48)(cid:48)(cid:7)(cid:5)(cid:3)(cid:9)(cid:2)(cid:28)(cid:3,Unknown,1862.0
Unknown,Unknown,58,Unknown,Unknown,Unknown,Unknown,cid:50)(cid:5)(cid:14)(cid:7)(cid:12)(cid:5)(cid:9)(cid:2)(cid:16)(cid:16)(cid:2)(cid:12)(cid:11)(cid:4)(cid:14)(cid:11)(cid:48)(cid:48)(cid:7)(cid:5)(cid:3)(cid:9)(cid:2)(cid:28)(cid:3,Unknown,1920.0
Unknown,Unknown,18,Unknown,Unknown,Unknown,Unknown,cid:50)(cid:5)(cid:14)(cid:7)(cid:12)(cid:5)(cid:9)(cid:2)(cid:16)(cid:16)(cid:2)(cid:12)(cid:11)(cid:4)(cid:14)(cid:11)(cid:48)(cid:48)(cid:7)(cid:5)(cid:3)(cid:9)(cid:2)(cid:28)(cid:3,Unknown,1938.0
Unknown,Unknown,1,Unknown,Unknown,Unknown,Unknown,cid:50)(cid:5)(cid:14)(cid:7)(cid:12)(cid:5)(cid:9)(cid:2)(cid:16)(cid:16)(cid:2)(cid:12)(cid:11)(cid:4)(cid:14)(cid:11)(cid:48)(cid:48)(cid:7)(cid:5)(cid:3)(cid:9)(cid:2)(cid:28)(cid:3,Unknown,1939.0
Unknown,Unknown,1,Unknown,Unknown,Unknown,Unknown,cid:50)(cid:5)(cid:14)(cid:7)(cid:12)(cid:5)(cid:9)(cid:2)(cid:16)(cid:16)(cid:2)(cid:12)(cid:11)(cid:4)(cid:14)(cid:11)(cid:48)(cid:48)(cid:7)(cid:5)(cid:3)(cid:9)(cid:2)(cid:28)(cid:3,Unknown,1940.0
Unknown,Unknown,37,Unknown,Unknown,Unknown,Unknown,cid:50)(cid:5)(cid:14)(cid:7)(cid:12)(cid:5)(cid:9)(cid:2)(cid:16)(cid:16)(cid:2)(cid:12)(cid:11)(cid:4)(cid:14)(cid:11)(cid:48)(cid:48)(cid:7)(cid:5)(cid:3)(cid:9)(cid:2)(cid:28)(cid:3,Unknown,1977.0
Unknown,Unknown,37,Unknown,Unknown,Unknown,Unknown,cid:50)(cid:5)(cid:14)(cid:7)(cid:12)(cid:5)(cid:9)(cid:2)(cid:16)(cid:16)(cid:2)(cid:12)(cid:11)(cid:4)(cid:14)(cid:11)(cid:48)(cid:48)(cid:7)(cid:5)(cid:3)(cid:9)(cid:2)(cid:28)(cid:3,Unknown,2014.0
Unknown,Unknown,18,Unknown,Unknown,Unknown,Unknown,cid:50)(cid:5)(cid:14)(cid:7)(cid:12)(cid:5)(cid:9)(cid:2)(cid:16)(cid:16)(cid:2)(cid:12)(cid:11)(cid:4)(cid:14)(cid:11)(cid:48)(cid:48)(cid:7)(cid:5)(cid:3)(cid:9)(cid:2)(cid:28)(cid:3,Unknown,2032.0
Unknown,Unknown,45,Unknown,Unknown,Unknown,Unknown,cid:50)(cid:5)(cid:14)(cid:7)(cid:12)(cid:5)(cid:9)(cid:2)(cid:16)(cid:16)(cid:2)(cid:12)(cid:11)(cid:4)(cid:14)(cid:11)(cid:48)(cid:48)(cid:7)(cid:5)(cid:3)(cid:9)(cid:2)(cid:28)(cid:3,Unknown,2077.0
Unknown,Unknown,18,Unknown,Unknown,Unknown,Unknown,cid:50)(cid:5)(cid:14)(cid:7)(cid:12)(cid:5)(cid:9)(cid:2)(cid:16)(cid:16)(cid:2)(cid:12)(cid:11)(cid:4)(cid:14)(cid:11)(cid:48)(cid:48)(cid:7)(cid:5)(cid:3)(cid:9)(cid:2)(cid:28)(cid:3,Unknown,2095.0
Unknown,Unknown,16,Unknown,Unknown,Unknown,Unknown,cid:50)(cid:5)(cid:14)(cid:7)(cid:12)(cid:5)(cid:9)(cid:2)(cid:16)(cid:16)(cid:2)(cid:12)(cid:11)(cid:4)(cid:14)(cid:11)(cid:48)(cid:48)(cid:7)(cid:5)(cid:3)(cid:9)(cid:2)(cid:28)(cid:3,Unknown,2111.0
Unknown,Unknown,14,Unknown,Unknown,Unknown,Unknown,cid:50)(cid:5)(cid:14)(cid:7)(cid:12)(cid:5)(cid:9)(cid:2)(cid:16)(cid:16)(cid:2)(cid:12)(cid:11)(cid:4)(cid:14)(cid:11)(cid:48)(cid:48)(cid:7)(cid:5)(cid:3)(cid:9)(cid:2)(cid:28)(cid:3,Unknown,2125.0
Unknown,Unknown,7,Unknown,Unknown,Unknown,Unknown,cid:50)(cid:5)(cid:14)(cid:7)(cid:12)(cid:5)(cid:9)(cid:2)(cid:16)(cid:16)(cid:2)(cid:12)(cid:11)(cid:4)(cid:14)(cid:11)(cid:48)(cid:48)(cid:7)(cid:5)(cid:3)(cid:9)(cid:2)(cid:28)(cid:3,Unknown,2132.0
Unknown,Unknown,14,Unknown,Unknown,Unknown,Unknown,cid:50)(cid:5)(cid:14)(cid:7)(cid:12)(cid:5)(cid:9)(cid:2)(cid:16)(cid:16)(cid:2)(cid:12)(cid:11)(cid:4)(cid:14)(cid:11)(cid:48)(cid:48)(cid:7)(cid:5)(cid:3)(cid:9)(cid:2)(cid:28)(cid:3,Unknown,2146.0
Unknown,Unknown,46,Unknown,Unknown,Unknown,Unknown,cid:50)(cid:5)(cid:14)(cid:7)(cid:12)(cid:5)(cid:9)(cid:2)(cid:16)(cid:16)(cid:2)(cid:12)(cid:11)(cid:4)(cid:14)(cid:11)(cid:48)(cid:48)(cid:7)(cid:5)(cid:3)(cid:9)(cid:2)(cid:28)(cid:3,Unknown,2192.0
Unknown,Unknown,9,Unknown,Unknown,Unknown,Unknown,cid:50)(cid:5)(cid:14)(cid:7)(cid:12)(cid:5)(cid:9)(cid:2)(cid:16)(cid:16)(cid:2)(cid:12)(cid:11)(cid:4)(cid:14)(cid:11)(cid:48)(cid:48)(cid:7)(cid:5)(cid:3)(cid:9)(cid:2)(cid:28)(cid:3,Unknown,2201.0
Unknown,Unknown,2,Unknown,Unknown,Unknown,Unknown,cid:50)(cid:5)(cid:14)(cid:7)(cid:12)(cid:5)(cid:9)(cid:2)(cid:16)(cid:16)(cid:2)(cid:12)(cid:11)(cid:4)(cid:14)(cid:11)(cid:48)(cid:48)(cid:7)(cid:5)(cid:3)(cid:9)(cid:2)(cid:28)(cid:3,Unknown,2203.0
Unknown,Unknown,48,Unknown,Unknown,Unknown,Unknown,cid:50)(cid:5)(cid:14)(cid:7)(cid:12)(cid:5)(cid:9)(cid:2)(cid:16)(cid:16)(cid:2)(cid:12)(cid:11)(cid:4)(cid:14)(cid:11)(cid:48)(cid:48)(cid:7)(cid:5)(cid:3)(cid:9)(cid:2)(cid:28)(cid:3,Unknown,2251.0
Unknown,Unknown,46,Unknown,Unknown,Unknown,Unknown,cid:50)(cid:5)(cid:14)(cid:7)(cid:12)(cid:5)(cid:9)(cid:2)(cid:16)(cid:16)(cid:2)(cid:12)(cid:11)(cid:4)(cid:14)(cid:11)(cid:48)(cid:48)(cid:7)(cid:5)(cid:3)(cid:9)(cid:2)(cid:28)(cid:3,Unknown,2297.0
Unknown,Unknown,3,Unknown,Unknown,Unknown,Unknown,cid:50)(cid:5)(cid:14)(cid:7)(cid:12)(cid:5)(cid:9)(cid:2)(cid:16)(cid:16)(cid:2)(cid:12)(cid:11)(cid:4)(cid:14)(cid:11)(cid:48)(cid:48)(cid:7)(cid:5)(cid:3)(cid:9)(cid:2)(cid:28)(cid:3,Unknown,2300.0
Unknown,Unknown,65,Unknown,Unknown,Unknown,Unknown,cid:50)(cid:5)(cid:14)(cid:7)(cid:12)(cid:5)(cid:9)(cid:2)(cid:16)(cid:16)(cid:2)(cid:12)(cid:11)(cid:4)(cid:14)(cid:11)(cid:48)(cid:48)(cid:7)(cid:5)(cid:3)(cid:9)(cid:2)(cid:28)(cid:3,Unknown,2365.0
Unknown,Unknown,5,Unknown,Unknown,Unknown,Unknown,cid:50)(cid:5)(cid:14)(cid:7)(cid:12)(cid:5)(cid:9)(cid:2)(cid:16)(cid:16)(cid:2)(cid:12)(cid:11)(cid:4)(cid:14)(cid:11)(cid:48)(cid:48)(cid:7)(cid:5)(cid:3)(cid:9)(cid:2)(cid:28)(cid:3,Unknown,2370.0
Unknown,Unknown,10,Unknown,Unknown,Unknown,Unknown,cid:50)(cid:5)(cid:14)(cid:7)(cid:12)(cid:5)(cid:9)(cid:2)(cid:16)(cid:16)(cid:2)(cid:12)(cid:11)(cid:4)(cid:14)(cid:11)(cid:48)(cid:48)(cid:7)(cid:5)(cid:3)(cid:9)(cid:2)(cid:28)(cid:3,Unknown,2380.0
Unknown,Unknown,2,Unknown,Unknown,Unknown,Unknown,cid:50)(cid:5)(cid:14)(cid:7)(cid:12)(cid:5)(cid:9)(cid:2)(cid:16)(cid:16)(cid:2)(cid:12)(cid:11)(cid:4)(cid:14)(cid:11)(cid:48)(cid:48)(cid:7)(cid:5)(cid:3)(cid:9)(cid:2)(cid:28)(cid:3,Unknown,2382.0
Unknown,Unknown,39,Unknown,Unknown,Unknown,Unknown,cid:50)(cid:5)(cid:14)(cid:7)(cid:12)(cid:5)(cid:9)(cid:2)(cid:16)(cid:16)(cid:2)(cid:12)(cid:11)(cid:4)(cid:14)(cid:11)(cid:48)(cid:48)(cid:7)(cid:5)(cid:3)(cid:9)(cid:2)(cid:28)(cid:3,Unknown,2421.0
Unknown,Unknown,11,Unknown,Unknown,Unknown,Unknown,cid:50)(cid:5)(cid:14)(cid:7)(cid:12)(cid:5)(cid:9)(cid:2)(cid:16)(cid:16)(cid:2)(cid:12)(cid:11)(cid:4)(cid:14)(cid:11)(cid:48)(cid:48)(cid:7)(cid:5)(cid:3)(cid:9)(cid:2)(cid:28)(cid:3,Unknown,2432.0
Unknown,Unknown,7,Unknown,Unknown,Unknown,Unknown,cid:50)(cid:5)(cid:14)(cid:7)(cid:12)(cid:5)(cid:9)(cid:2)(cid:16)(cid:16)(cid:2)(cid:12)(cid:11)(cid:4)(cid:14)(cid:11)(cid:48)(cid:48)(cid:7)(cid:5)(cid:3)(cid:9)(cid:2)(cid:28)(cid:3,Unknown,2439.0
Unknown,Unknown,64,Unknown,Unknown,Unknown,Unknown,cid:50)(cid:5)(cid:14)(cid:7)(cid:12)(cid:5)(cid:9)(cid:2)(cid:16)(cid:16)(cid:2)(cid:12)(cid:11)(cid:4)(cid:14)(cid:11)(cid:48)(cid:48)(cid:7)(cid:5)(cid:3)(cid:9)(cid:2)(cid:28)(cid:3,Unknown,2503.0
Unknown,Unknown,8,Unknown,Unknown,Unknown,Unknown,cid:50)(cid:5)(cid:14)(cid:7)(cid:12)(cid:5)(cid:9)(cid:2)(cid:16)(cid:16)(cid:2)(cid:12)(cid:11)(cid:4)(cid:14)(cid:11)(cid:48)(cid:48)(cid:7)(cid:5)(cid:3)(cid:9)(cid:2)(cid:28)(cid:3,Unknown,2511.0
Unknown,Unknown,49,Unknown,Unknown,Unknown,Unknown,cid:50)(cid:5)(cid:14)(cid:7)(cid:12)(cid:5)(cid:9)(cid:2)(cid:16)(cid:16)(cid:2)(cid:12)(cid:11)(cid:4)(cid:14)(cid:11)(cid:48)(cid:48)(cid:7)(cid:5)(cid:3)(cid:9)(cid:2)(cid:28)(cid:3,Unknown,2560.0
Unknown,Unknown,2,Unknown,Unknown,Unknown,Unknown,cid:50)(cid:5)(cid:14)(cid:7)(cid:12)(cid:5)(cid:9)(cid:2)(cid:16)(cid:16)(cid:2)(cid:12)(cid:11)(cid:4)(cid:14)(cid:11)(cid:48)(cid:48)(cid:7)(cid:5)(cid:3)(cid:9)(cid:2)(cid:28)(cid:3,Unknown,2562.0
Unknown,Unknown,28,Unknown,Unknown,Unknown,Unknown,cid:50)(cid:5)(cid:14)(cid:7)(cid:12)(cid:5)(cid:9)(cid:2)(cid:16)(cid:16)(cid:2)(cid:12)(cid:11)(cid:4)(cid:14)(cid:11)(cid:48)(cid:48)(cid:7)(cid:5)(cid:3)(cid:9)(cid:2)(cid:28)(cid:3,Unknown,2590.0
Unknown,Unknown,3,Unknown,Unknown,Unknown,Unknown,cid:50)(cid:5)(cid:14)(cid:7)(cid:12)(cid:5)(cid:9)(cid:2)(cid:16)(cid:16)(cid:2)(cid:12)(cid:11)(cid:4)(cid:14)(cid:11)(cid:48)(cid:48)(cid:7)(cid:5)(cid:3)(cid:9)(cid:2)(cid:28)(cid:3,Unknown,2593.0
Unknown,Unknown,15,Unknown,Unknown,Unknown,Unknown,cid:50)(cid:5)(cid:14)(cid:7)(cid:12)(cid:5)(cid:9)(cid:2)(cid:16)(cid:16)(cid:2)(cid:12)(cid:11)(cid:4)(cid:14)(cid:11)(cid:48)(cid:48)(cid:7)(cid:5)(cid:3)(cid:9)(cid:2)(cid:28)(cid:3,Unknown,2608.0
Unknown,Unknown,2,Unknown,Unknown,Unknown,Unknown,cid:50)(cid:5)(cid:14)(cid:7)(cid:12)(cid:5)(cid:9)(cid:2)(cid:16)(cid:16)(cid:2)(cid:12)(cid:11)(cid:4)(cid:14)(cid:11)(cid:48)(cid:48)(cid:7)(cid:5)(cid:3)(cid:9)(cid:2)(cid:28)(cid:3,Unknown,2610.0
Unknown,Unknown,36,Unknown,Unknown,Unknown,Unknown,cid:50)(cid:5)(cid:14)(cid:7)(cid:12)(cid:5)(cid:9)(cid:2)(cid:16)(cid:16)(cid:2)(cid:12)(cid:11)(cid:4)(cid:14)(cid:11)(cid:48)(cid:48)(cid:7)(cid:5)(cid:3)(cid:9)(cid:2)(cid:28)(cid:3,Unknown,2646.0
Unknown,Unknown,34,Unknown,Unknown,Unknown,Unknown,cid:50)(cid:5)(cid:14)(cid:7)(cid:12)(cid:5)(cid:9)(cid:2)(cid:16)(cid:16)(cid:2)(cid:12)(cid:11)(cid:4)(cid:14)(cid:11)(cid:48)(cid:48)(cid:7)(cid:5)(cid:3)(cid:9)(cid:2)(cid:28)(cid:3,Unknown,2680.0
Unknown,Unknown,19,Unknown,Unknown,Unknown,Unknown,cid:50)(cid:5)(cid:14)(cid:7)(cid:12)(cid:5)(cid:9)(cid:2)(cid:16)(cid:16)(cid:2)(cid:12)(cid:11)(cid:4)(cid:14)(cid:11)(cid:48)(cid:48)(cid:7)(cid:5)(cid:3)(cid:9)(cid:2)(cid:28)(cid:3,Unknown,2699.0
Unknown,Unknown,37,Unknown,Unknown,Unknown,Unknown,cid:50)(cid:5)(cid:14)(cid:7)(cid:12)(cid:5)(cid:9)(cid:2)(cid:16)(cid:16)(cid:2)(cid:12)(cid:11)(cid:4)(cid:14)(cid:11)(cid:48)(cid:48)(cid:7)(cid:5)(cid:3)(cid:9)(cid:2)(cid:28)(cid:3,Unknown,2736.0
Unknown,Unknown,1,Unknown,Unknown,Unknown,Unknown,cid:50)(cid:5)(cid:14)(cid:7)(cid:12)(cid:5)(cid:9)(cid:2)(cid:16)(cid:16)(cid:2)(cid:12)(cid:11)(cid:4)(cid:14)(cid:11)(cid:48)(cid:48)(cid:7)(cid:5)(cid:3)(cid:9)(cid:2)(cid:28)(cid:3,Unknown,2737.0
Unknown,Unknown,2,Unknown,Unknown,Unknown,Unknown,cid:50)(cid:5)(cid:14)(cid:7)(cid:12)(cid:5)(cid:9)(cid:2)(cid:16)(cid:16)(cid:2)(cid:12)(cid:11)(cid:4)(cid:14)(cid:11)(cid:48)(cid:48)(cid:7)(cid:5)(cid:3)(cid:9)(cid:2)(cid:28)(cid:3,Unknown,2739.0
Unknown,Unknown,44,Unknown,Unknown,Unknown,Unknown,cid:50)(cid:5)(cid:14)(cid:7)(cid:12)(cid:5)(cid:9)(cid:2)(cid:16)(cid:16)(cid:2)(cid:12)(cid:11)(cid:4)(cid:14)(cid:11)(cid:48)(cid:48)(cid:7)(cid:5)(cid:3)(cid:9)(cid:2)(cid:28)(cid:3,Unknown,2783.0
Unknown,Unknown,12,Unknown,Unknown,Unknown,Unknown,cid:50)(cid:5)(cid:14)(cid:7)(cid:12)(cid:5)(cid:9)(cid:2)(cid:16)(cid:16)(cid:2)(cid:12)(cid:11)(cid:4)(cid:14)(cid:11)(cid:48)(cid:48)(cid:7)(cid:5)(cid:3)(cid:9)(cid:2)(cid:28)(cid:3,Unknown,2795.0
Unknown,Unknown,29,Unknown,Unknown,Unknown,Unknown,cid:50)(cid:5)(cid:14)(cid:7)(cid:12)(cid:5)(cid:9)(cid:2)(cid:16)(cid:16)(cid:2)(cid:12)(cid:11)(cid:4)(cid:14)(cid:11)(cid:48)(cid:48)(cid:7)(cid:5)(cid:3)(cid:9)(cid:2)(cid:28)(cid:3,Unknown,2824.0
Unknown,Unknown,26,Unknown,Unknown,Unknown,Unknown,cid:50)(cid:5)(cid:14)(cid:7)(cid:12)(cid:5)(cid:9)(cid:2)(cid:16)(cid:16)(cid:2)(cid:12)(cid:11)(cid:4)(cid:14)(cid:11)(cid:48)(cid:48)(cid:7)(cid:5)(cid:3)(cid:9)(cid:2)(cid:28)(cid:3,Unknown,2850.0
Unknown,Unknown,41,Unknown,Unknown,Unknown,Unknown,cid:50)(cid:5)(cid:14)(cid:7)(cid:12)(cid:5)(cid:9)(cid:2)(cid:16)(cid:16)(cid:2)(cid:12)(cid:11)(cid:4)(cid:14)(cid:11)(cid:48)(cid:48)(cid:7)(cid:5)(cid:3)(cid:9)(cid:2)(cid:28)(cid:3,Unknown,2891.0
Unknown,Unknown,25,Unknown,Unknown,Unknown,Unknown,cid:50)(cid:5)(cid:14)(cid:7)(cid:12)(cid:5)(cid:9)(cid:2)(cid:16)(cid:16)(cid:2)(cid:12)(cid:11)(cid:4)(cid:14)(cid:11)(cid:48)(cid:48)(cid:7)(cid:5)(cid:3)(cid:9)(cid:2)(cid:28)(cid:3,Unknown,2916.0
Unknown,Unknown,2,Unknown,Unknown,Unknown,Unknown,cid:50)(cid:5)(cid:14)(cid:7)(cid:12)(cid:5)(cid:9)(cid:2)(cid:16)(cid:16)(cid:2)(cid:12)(cid:11)(cid:4)(cid:14)(cid:11)(cid:48)(cid:48)(cid:7)(cid:5)(cid:3)(cid:9)(cid:2)(cid:28)(cid:3,Unknown,2918.0
Unknown,Unknown,58,Unknown,Unknown,Unknown,Unknown,cid:50)(cid:5)(cid:14)(cid:7)(cid:12)(cid:5)(cid:9)(cid:2)(cid:16)(cid:16)(cid:2)(cid:12)(cid:11)(cid:4)(cid:14)(cid:11)(cid:48)(cid:48)(cid:7)(cid:5)(cid:3)(cid:9)(cid:2)(cid:28)(cid:3,Unknown,2976.0
Unknown,Unknown,58,Unknown,Unknown,Unknown,Unknown,cid:50)(cid:5)(cid:14)(cid:7)(cid:12)(cid:5)(cid:9)(cid:2)(cid:16)(cid:16)(cid:2)(cid:12)(cid:11)(cid:4)(cid:14)(cid:11)(cid:48)(cid:48)(cid:7)(cid:5)(cid:3)(cid:9)(cid:2)(cid:28)(cid:3,Unknown,3034.0
Unknown,Unknown,18,Unknown,Unknown,Unknown,Unknown,cid:50)(cid:5)(cid:14)(cid:7)(cid:12)(cid:5)(cid:9)(cid:2)(cid:16)(cid:16)(cid:2)(cid:12)(cid:11)(cid:4)(cid:14)(cid:11)(cid:48)(cid:48)(cid:7)(cid:5)(cid:3)(cid:9)(cid:2)(cid:28)(cid:3,Unknown,3052.0
Unknown,Unknown,1,Unknown,Unknown,Unknown,Unknown,cid:50)(cid:5)(cid:14)(cid:7)(cid:12)(cid:5)(cid:9)(cid:2)(cid:16)(cid:16)(cid:2)(cid:12)(cid:11)(cid:4)(cid:14)(cid:11)(cid:48)(cid:48)(cid:7)(cid:5)(cid:3)(cid:9)(cid:2)(cid:28)(cid:3,Unknown,3053.0
Unknown,Unknown,1,Unknown,Unknown,Unknown,Unknown,cid:50)(cid:5)(cid:14)(cid:7)(cid:12)(cid:5)(cid:9)(cid:2)(cid:16)(cid:16)(cid:2)(cid:12)(cid:11)(cid:4)(cid:14)(cid:11)(cid:48)(cid:48)(cid:7)(cid:5)(cid:3)(cid:9)(cid:2)(cid:28)(cid:3,Unknown,3054.0
Unknown,Unknown,37,Unknown,Unknown,Unknown,Unknown,cid:50)(cid:5)(cid:14)(cid:7)(cid:12)(cid:5)(cid:9)(cid:2)(cid:16)(cid:16)(cid:2)(cid:12)(cid:11)(cid:4)(cid:14)(cid:11)(cid:48)(cid:48)(cid:7)(cid:5)(cid:3)(cid:9)(cid:2)(cid:28)(cid:3,Unknown,3091.0
Unknown,Unknown,37,Unknown,Unknown,Unknown,Unknown,cid:50)(cid:5)(cid:14)(cid:7)(cid:12)(cid:5)(cid:9)(cid:2)(cid:16)(cid:16)(cid:2)(cid:12)(cid:11)(cid:4)(cid:14)(cid:11)(cid:48)(cid:48)(cid:7)(cid:5)(cid:3)(cid:9)(cid:2)(cid:28)(cid:3,Unknown,3128.0
Unknown,Unknown,18,Unknown,Unknown,Unknown,Unknown,cid:50)(cid:5)(cid:14)(cid:7)(cid:12)(cid:5)(cid:9)(cid:2)(cid:16)(cid:16)(cid:2)(cid:12)(cid:11)(cid:4)(cid:14)(cid:11)(cid:48)(cid:48)(cid:7)(cid:5)(cid:3)(cid:9)(cid:2)(cid:28)(cid:3,Unknown,3146.0
Unknown,Unknown,45,Unknown,Unknown,Unknown,Unknown,cid:50)(cid:5)(cid:14)(cid:7)(cid:12)(cid:5)(cid:9)(cid:2)(cid:16)(cid:16)(cid:2)(cid:12)(cid:11)(cid:4)(cid:14)(cid:11)(cid:48)(cid:48)(cid:7)(cid:5)(cid:3)(cid:9)(cid:2)(cid:28)(cid:3,Unknown,3191.0
Unknown,Unknown,18,Unknown,Unknown,Unknown,Unknown,cid:50)(cid:5)(cid:14)(cid:7)(cid:12)(cid:5)(cid:9)(cid:2)(cid:16)(cid:16)(cid:2)(cid:12)(cid:11)(cid:4)(cid:14)(cid:11)(cid:48)(cid:48)(cid:7)(cid:5)(cid:3)(cid:9)(cid:2)(cid:28)(cid:3,Unknown,3209.0
Unknown,Unknown,16,Unknown,Unknown,Unknown,Unknown,cid:50)(cid:5)(cid:14)(cid:7)(cid:12)(cid:5)(cid:9)(cid:2)(cid:16)(cid:16)(cid:2)(cid:12)(cid:11)(cid:4)(cid:14)(cid:11)(cid:48)(cid:48)(cid:7)(cid:5)(cid:3)(cid:9)(cid:2)(cid:28)(cid:3,Unknown,3225.0
Unknown,Unknown,12,Unknown,Unknown,Unknown,Unknown,cid:50)(cid:5)(cid:14)(cid:7)(cid:12)(cid:5)(cid:9)(cid:2)(cid:16)(cid:16)(cid:2)(cid:12)(cid:11)(cid:4)(cid:14)(cid:11)(cid:48)(cid:48)(cid:7)(cid:5)(cid:3)(cid:9)(cid:2)(cid:28)(cid:3,Unknown,3237.0
Unknown,Unknown,46,Unknown,Unknown,Unknown,Unknown,cid:50)(cid:5)(cid:14)(cid:7)(cid:12)(cid:5)(cid:9)(cid:2)(cid:16)(cid:16)(cid:2)(cid:12)(cid:11)(cid:4)(cid:14)(cid:11)(cid:48)(cid:48)(cid:7)(cid:5)(cid:3)(cid:9)(cid:2)(cid:28)(cid:3,Unknown,3283.0
Unknown,Unknown,28,Unknown,Unknown,Unknown,Unknown,cid:50)(cid:5)(cid:14)(cid:7)(cid:12)(cid:5)(cid:9)(cid:2)(cid:16)(cid:16)(cid:2)(cid:12)(cid:11)(cid:4)(cid:14)(cid:11)(cid:48)(cid:48)(cid:7)(cid:5)(cid:3)(cid:9)(cid:2)(cid:28)(cid:3,Unknown,3311.0
Unknown,Unknown,5,Unknown,Unknown,Unknown,Unknown,cid:50)(cid:5)(cid:14)(cid:7)(cid:12)(cid:5)(cid:9)(cid:2)(cid:16)(cid:16)(cid:2)(cid:12)(cid:11)(cid:4)(cid:14)(cid:11)(cid:48)(cid:48)(cid:7)(cid:5)(cid:3)(cid:9)(cid:2)(cid:28)(cid:3,Unknown,3316.0
Unknown,Unknown,2,Unknown,Unknown,Unknown,Unknown,cid:50)(cid:5)(cid:14)(cid:7)(cid:12)(cid:5)(cid:9)(cid:2)(cid:16)(cid:16)(cid:2)(cid:12)(cid:11)(cid:4)(cid:14)(cid:11)(cid:48)(cid:48)(cid:7)(cid:5)(cid:3)(cid:9)(cid:2)(cid:28)(cid:3,Unknown,3318.0
Unknown,Unknown,50,Unknown,Unknown,Unknown,Unknown,cid:50)(cid:5)(cid:14)(cid:7)(cid:12)(cid:5)(cid:9)(cid:2)(cid:16)(cid:16)(cid:2)(cid:12)(cid:11)(cid:4)(cid:14)(cid:11)(cid:48)(cid:48)(cid:7)(cid:5)(cid:3)(cid:9)(cid:2)(cid:28)(cid:3,Unknown,3368.0
Unknown,Unknown,5,Unknown,Unknown,Unknown,Unknown,cid:50)(cid:5)(cid:14)(cid:7)(cid:12)(cid:5)(cid:9)(cid:2)(cid:16)(cid:16)(cid:2)(cid:12)(cid:11)(cid:4)(cid:14)(cid:11)(cid:48)(cid:48)(cid:7)(cid:5)(cid:3)(cid:9)(cid:2)(cid:28)(cid:3,Unknown,3373.0
Unknown,Unknown,2,Unknown,Unknown,Unknown,Unknown,cid:50)(cid:5)(cid:14)(cid:7)(cid:12)(cid:5)(cid:9)(cid:2)(cid:16)(cid:16)(cid:2)(cid:12)(cid:11)(cid:4)(cid:14)(cid:11)(cid:48)(cid:48)(cid:7)(cid:5)(cid:3)(cid:9)(cid:2)(cid:28)(cid:3,Unknown,3375.0
Unknown,Unknown,14,Unknown,Unknown,Unknown,Unknown,cid:50)(cid:5)(cid:14)(cid:7)(cid:12)(cid:5)(cid:9)(cid:2)(cid:16)(cid:16)(cid:2)(cid:12)(cid:11)(cid:4)(cid:14)(cid:11)(cid:48)(cid:48)(cid:7)(cid:5)(cid:3)(cid:9)(cid:2)(cid:28)(cid:3,Unknown,3389.0
Unknown,Unknown,69,Unknown,Unknown,Unknown,Unknown,cid:50)(cid:5)(cid:14)(cid:7)(cid:12)(cid:5)(cid:9)(cid:2)(cid:16)(cid:16)(cid:2)(cid:12)(cid:11)(cid:4)(cid:14)(cid:11)(cid:48)(cid:48)(cid:7)(cid:5)(cid:3)(cid:9)(cid:2)(cid:28)(cid:3,Unknown,3458.0
Unknown,Unknown,5,Unknown,Unknown,Unknown,Unknown,cid:50)(cid:5)(cid:14)(cid:7)(cid:12)(cid:5)(cid:9)(cid:2)(cid:16)(cid:16)(cid:2)(cid:12)(cid:11)(cid:4)(cid:14)(cid:11)(cid:48)(cid:48)(cid:7)(cid:5)(cid:3)(cid:9)(cid:2)(cid:28)(cid:3,Unknown,3463.0
Unknown,Unknown,12,Unknown,Unknown,Unknown,Unknown,cid:50)(cid:5)(cid:14)(cid:7)(cid:12)(cid:5)(cid:9)(cid:2)(cid:16)(cid:16)(cid:2)(cid:12)(cid:11)(cid:4)(cid:14)(cid:11)(cid:48)(cid:48)(cid:7)(cid:5)(cid:3)(cid:9)(cid:2)(cid:28)(cid:3,Unknown,3475.0
Unknown,Unknown,4,Unknown,Unknown,Unknown,Unknown,cid:50)(cid:5)(cid:14)(cid:7)(cid:12)(cid:5)(cid:9)(cid:2)(cid:16)(cid:16)(cid:2)(cid:12)(cid:11)(cid:4)(cid:14)(cid:11)(cid:48)(cid:48)(cid:7)(cid:5)(cid:3)(cid:9)(cid:2)(cid:28)(cid:3,Unknown,3479.0
Unknown,Unknown,2,Unknown,Unknown,Unknown,Unknown,cid:50)(cid:5)(cid:14)(cid:7)(cid:12)(cid:5)(cid:9)(cid:2)(cid:16)(cid:16)(cid:2)(cid:12)(cid:11)(cid:4)(cid:14)(cid:11)(cid:48)(cid:48)(cid:7)(cid:5)(cid:3)(cid:9)(cid:2)(cid:28)(cid:3,Unknown,3481.0
Unknown,Unknown,14,Unknown,Unknown,Unknown,Unknown,cid:50)(cid:5)(cid:14)(cid:7)(cid:12)(cid:5)(cid:9)(cid:2)(cid:16)(cid:16)(cid:2)(cid:12)(cid:11)(cid:4)(cid:14)(cid:11)(cid:48)(cid:48)(cid:7)(cid:5)(cid:3)(cid:9)(cid:2)(cid:28)(cid:3,Unknown,3495.0
Unknown,Unknown,46,Unknown,Unknown,Unknown,Unknown,cid:50)(cid:5)(cid:14)(cid:7)(cid:12)(cid:5)(cid:9)(cid:2)(cid:16)(cid:16)(cid:2)(cid:12)(cid:11)(cid:4)(cid:14)(cid:11)(cid:48)(cid:48)(cid:7)(cid:5)(cid:3)(cid:9)(cid:2)(cid:28)(cid:3,Unknown,3541.0
Unknown,Unknown,2,Unknown,Unknown,Unknown,Unknown,cid:50)(cid:5)(cid:14)(cid:7)(cid:12)(cid:5)(cid:9)(cid:2)(cid:16)(cid:16)(cid:2)(cid:12)(cid:11)(cid:4)(cid:14)(cid:11)(cid:48)(cid:48)(cid:7)(cid:5)(cid:3)(cid:9)(cid:2)(cid:28)(cid:3,Unknown,3543.0
Unknown,Unknown,28,Unknown,Unknown,Unknown,Unknown,cid:50)(cid:5)(cid:14)(cid:7)(cid:12)(cid:5)(cid:9)(cid:2)(cid:16)(cid:16)(cid:2)(cid:12)(cid:11)(cid:4)(cid:14)(cid:11)(cid:48)(cid:48)(cid:7)(cid:5)(cid:3)(cid:9)(cid:2)(cid:28)(cid:3,Unknown,3571.0
Unknown,Unknown,5,Unknown,Unknown,Unknown,Unknown,cid:50)(cid:5)(cid:14)(cid:7)(cid:12)(cid:5)(cid:9)(cid:2)(cid:16)(cid:16)(cid:2)(cid:12)(cid:11)(cid:4)(cid:14)(cid:11)(cid:48)(cid:48)(cid:7)(cid:5)(cid:3)(cid:9)(cid:2)(cid:28)(cid:3,Unknown,3576.0
Unknown,Unknown,3,Unknown,Unknown,Unknown,Unknown,cid:50)(cid:5)(cid:14)(cid:7)(cid:12)(cid:5)(cid:9)(cid:2)(cid:16)(cid:16)(cid:2)(cid:12)(cid:11)(cid:4)(cid:14)(cid:11)(cid:48)(cid:48)(cid:7)(cid:5)(cid:3)(cid:9)(cid:2)(cid:28)(cid:3,Unknown,3579.0
Unknown,Unknown,10,Unknown,Unknown,Unknown,Unknown,cid:50)(cid:5)(cid:14)(cid:7)(cid:12)(cid:5)(cid:9)(cid:2)(cid:16)(cid:16)(cid:2)(cid:12)(cid:11)(cid:4)(cid:14)(cid:11)(cid:48)(cid:48)(cid:7)(cid:5)(cid:3)(cid:9)(cid:2)(cid:28)(cid:3,Unknown,3589.0
Unknown,Unknown,5,Unknown,Unknown,Unknown,Unknown,cid:50)(cid:5)(cid:14)(cid:7)(cid:12)(cid:5)(cid:9)(cid:2)(cid:16)(cid:16)(cid:2)(cid:12)(cid:11)(cid:4)(cid:14)(cid:11)(cid:48)(cid:48)(cid:7)(cid:5)(cid:3)(cid:9)(cid:2)(cid:28)(cid:3,Unknown,3594.0
Unknown,Unknown,2,Unknown,Unknown,Unknown,Unknown,cid:50)(cid:5)(cid:14)(cid:7)(cid:12)(cid:5)(cid:9)(cid:2)(cid:16)(cid:16)(cid:2)(cid:12)(cid:11)(cid:4)(cid:14)(cid:11)(cid:48)(cid:48)(cid:7)(cid:5)(cid:3)(cid:9)(cid:2)(cid:28)(cid:3,Unknown,3596.0
Unknown,Unknown,64,Unknown,Unknown,Unknown,Unknown,cid:50)(cid:5)(cid:14)(cid:7)(cid:12)(cid:5)(cid:9)(cid:2)(cid:16)(cid:16)(cid:2)(cid:12)(cid:11)(cid:4)(cid:14)(cid:11)(cid:48)(cid:48)(cid:7)(cid:5)(cid:3)(cid:9)(cid:2)(cid:28)(cid:3,Unknown,3660.0
Unknown,Unknown,46,Unknown,Unknown,Unknown,Unknown,cid:50)(cid:5)(cid:14)(cid:7)(cid:12)(cid:5)(cid:9)(cid:2)(cid:16)(cid:16)(cid:2)(cid:12)(cid:11)(cid:4)(cid:14)(cid:11)(cid:48)(cid:48)(cid:7)(cid:5)(cid:3)(cid:9)(cid:2)(cid:28)(cid:3,Unknown,3706.0
Unknown,Unknown,4,Unknown,Unknown,Unknown,Unknown,cid:50)(cid:5)(cid:14)(cid:7)(cid:12)(cid:5)(cid:9)(cid:2)(cid:16)(cid:16)(cid:2)(cid:12)(cid:11)(cid:4)(cid:14)(cid:11)(cid:48)(cid:48)(cid:7)(cid:5)(cid:3)(cid:9)(cid:2)(cid:28)(cid:3,Unknown,3710.0
Unknown,Unknown,12,Unknown,Unknown,Unknown,Unknown,cid:50)(cid:5)(cid:14)(cid:7)(cid:12)(cid:5)(cid:9)(cid:2)(cid:16)(cid:16)(cid:2)(cid:12)(cid:11)(cid:4)(cid:14)(cid:11)(cid:48)(cid:48)(cid:7)(cid:5)(cid:3)(cid:9)(cid:2)(cid:28)(cid:3,Unknown,3722.0
Unknown,Unknown,2,Unknown,Unknown,Unknown,Unknown,cid:50)(cid:5)(cid:14)(cid:7)(cid:12)(cid:5)(cid:9)(cid:2)(cid:16)(cid:16)(cid:2)(cid:12)(cid:11)(cid:4)(cid:14)(cid:11)(cid:48)(cid:48)(cid:7)(cid:5)(cid:3)(cid:9)(cid:2)(cid:28)(cid:3,Unknown,3724.0
Unknown,Unknown,28,Unknown,Unknown,Unknown,Unknown,cid:50)(cid:5)(cid:14)(cid:7)(cid:12)(cid:5)(cid:9)(cid:2)(cid:16)(cid:16)(cid:2)(cid:12)(cid:11)(cid:4)(cid:14)(cid:11)(cid:48)(cid:48)(cid:7)(cid:5)(cid:3)(cid:9)(cid:2)(cid:28)(cid:3,Unknown,3752.0
Unknown,Unknown,3,Unknown,Unknown,Unknown,Unknown,cid:50)(cid:5)(cid:14)(cid:7)(cid:12)(cid:5)(cid:9)(cid:2)(cid:16)(cid:16)(cid:2)(cid:12)(cid:11)(cid:4)(cid:14)(cid:11)(cid:48)(cid:48)(cid:7)(cid:5)(cid:3)(cid:9)(cid:2)(cid:28)(cid:3,Unknown,3755.0
Unknown,Unknown,15,Unknown,Unknown,Unknown,Unknown,cid:50)(cid:5)(cid:14)(cid:7)(cid:12)(cid:5)(cid:9)(cid:2)(cid:16)(cid:16)(cid:2)(cid:12)(cid:11)(cid:4)(cid:14)(cid:11)(cid:48)(cid:48)(cid:7)(cid:5)(cid:3)(cid:9)(cid:2)(cid:28)(cid:3,Unknown,3770.0
Unknown,Unknown,2,Unknown,Unknown,Unknown,Unknown,cid:50)(cid:5)(cid:14)(cid:7)(cid:12)(cid:5)(cid:9)(cid:2)(cid:16)(cid:16)(cid:2)(cid:12)(cid:11)(cid:4)(cid:14)(cid:11)(cid:48)(cid:48)(cid:7)(cid:5)(cid:3)(cid:9)(cid:2)(cid:28)(cid:3,Unknown,3772.0
Unknown,Unknown,37,Unknown,Unknown,Unknown,Unknown,cid:50)(cid:5)(cid:14)(cid:7)(cid:12)(cid:5)(cid:9)(cid:2)(cid:16)(cid:16)(cid:2)(cid:12)(cid:11)(cid:4)(cid:14)(cid:11)(cid:48)(cid:48)(cid:7)(cid:5)(cid:3)(cid:9)(cid:2)(cid:28)(cid:3,Unknown,3809.0
Unknown,Unknown,18,Unknown,Unknown,Unknown,Unknown,cid:50)(cid:5)(cid:14)(cid:7)(cid:12)(cid:5)(cid:9)(cid:2)(cid:16)(cid:16)(cid:2)(cid:12)(cid:11)(cid:4)(cid:14)(cid:11)(cid:48)(cid:48)(cid:7)(cid:5)(cid:3)(cid:9)(cid:2)(cid:28)(cid:3,Unknown,3827.0
Unknown,Unknown,19,Unknown,Unknown,Unknown,Unknown,cid:50)(cid:5)(cid:14)(cid:7)(cid:12)(cid:5)(cid:9)(cid:2)(cid:16)(cid:16)(cid:2)(cid:12)(cid:11)(cid:4)(cid:14)(cid:11)(cid:48)(cid:48)(cid:7)(cid:5)(cid:3)(cid:9)(cid:2)(cid:28)(cid:3,Unknown,3846.0
Unknown,Unknown,34,Unknown,Unknown,Unknown,Unknown,cid:50)(cid:5)(cid:14)(cid:7)(cid:12)(cid:5)(cid:9)(cid:2)(cid:16)(cid:16)(cid:2)(cid:12)(cid:11)(cid:4)(cid:14)(cid:11)(cid:48)(cid:48)(cid:7)(cid:5)(cid:3)(cid:9)(cid:2)(cid:28)(cid:3,Unknown,3880.0
Unknown,Unknown,18,Unknown,Unknown,Unknown,Unknown,cid:50)(cid:5)(cid:14)(cid:7)(cid:12)(cid:5)(cid:9)(cid:2)(cid:16)(cid:16)(cid:2)(cid:12)(cid:11)(cid:4)(cid:14)(cid:11)(cid:48)(cid:48)(cid:7)(cid:5)(cid:3)(cid:9)(cid:2)(cid:28)(cid:3,Unknown,3898.0
Unknown,Unknown,2,Unknown,Unknown,Unknown,Unknown,cid:50)(cid:5)(cid:14)(cid:7)(cid:12)(cid:5)(cid:9)(cid:2)(cid:16)(cid:16)(cid:2)(cid:12)(cid:11)(cid:4)(cid:14)(cid:11)(cid:48)(cid:48)(cid:7)(cid:5)(cid:3)(cid:9)(cid:2)(cid:28)(cid:3,Unknown,3900.0
Unknown,Unknown,44,Unknown,Unknown,Unknown,Unknown,cid:50)(cid:5)(cid:14)(cid:7)(cid:12)(cid:5)(cid:9)(cid:2)(cid:16)(cid:16)(cid:2)(cid:12)(cid:11)(cid:4)(cid:14)(cid:11)(cid:48)(cid:48)(cid:7)(cid:5)(cid:3)(cid:9)(cid:2)(cid:28)(cid:3,Unknown,3944.0
Unknown,Unknown,12,Unknown,Unknown,Unknown,Unknown,cid:50)(cid:5)(cid:14)(cid:7)(cid:12)(cid:5)(cid:9)(cid:2)(cid:16)(cid:16)(cid:2)(cid:12)(cid:11)(cid:4)(cid:14)(cid:11)(cid:48)(cid:48)(cid:7)(cid:5)(cid:3)(cid:9)(cid:2)(cid:28)(cid:3,Unknown,3956.0
Unknown,Unknown,29,Unknown,Unknown,Unknown,Unknown,cid:50)(cid:5)(cid:14)(cid:7)(cid:12)(cid:5)(cid:9)(cid:2)(cid:16)(cid:16)(cid:2)(cid:12)(cid:11)(cid:4)(cid:14)(cid:11)(cid:48)(cid:48)(cid:7)(cid:5)(cid:3)(cid:9)(cid:2)(cid:28)(cid:3,Unknown,3985.0
Unknown,Unknown,26,Unknown,Unknown,Unknown,Unknown,cid:50)(cid:5)(cid:14)(cid:7)(cid:12)(cid:5)(cid:9)(cid:2)(cid:16)(cid:16)(cid:2)(cid:12)(cid:11)(cid:4)(cid:14)(cid:11)(cid:48)(cid:48)(cid:7)(cid:5)(cid:3)(cid:9)(cid:2)(cid:28)(cid:3,Unknown,4011.0
Unknown,Unknown,41,Unknown,Unknown,Unknown,Unknown,cid:50)(cid:5)(cid:14)(cid:7)(cid:12)(cid:5)(cid:9)(cid:2)(cid:16)(cid:16)(cid:2)(cid:12)(cid:11)(cid:4)(cid:14)(cid:11)(cid:48)(cid:48)(cid:7)(cid:5)(cid:3)(cid:9)(cid:2)(cid:28)(cid:3,Unknown,4052.0
Unknown,Unknown,25,Unknown,Unknown,Unknown,Unknown,cid:50)(cid:5)(cid:14)(cid:7)(cid:12)(cid:5)(cid:9)(cid:2)(cid:16)(cid:16)(cid:2)(cid:12)(cid:11)(cid:4)(cid:14)(cid:11)(cid:48)(cid:48)(cid:7)(cid:5)(cid:3)(cid:9)(cid:2)(cid:28)(cid:3,Unknown,4077.0
Unknown,Unknown,2,Unknown,Unknown,Unknown,Unknown,cid:50)(cid:5)(cid:14)(cid:7)(cid:12)(cid:5)(cid:9)(cid:2)(cid:16)(cid:16)(cid:2)(cid:12)(cid:11)(cid:4)(cid:14)(cid:11)(cid:48)(cid:48)(cid:7)(cid:5)(cid:3)(cid:9)(cid:2)(cid:28)(cid:3,Unknown,4079.0
Unknown,Unknown,58,Unknown,Unknown,Unknown,Unknown,cid:50)(cid:5)(cid:14)(cid:7)(cid:12)(cid:5)(cid:9)(cid:2)(cid:16)(cid:16)(cid:2)(cid:12)(cid:11)(cid:4)(cid:14)(cid:11)(cid:48)(cid:48)(cid:7)(cid:5)(cid:3)(cid:9)(cid:2)(cid:28)(cid:3,Unknown,4137.0
Unknown,Unknown,58,Unknown,Unknown,Unknown,Unknown,cid:50)(cid:5)(cid:14)(cid:7)(cid:12)(cid:5)(cid:9)(cid:2)(cid:16)(cid:16)(cid:2)(cid:12)(cid:11)(cid:4)(cid:14)(cid:11)(cid:48)(cid:48)(cid:7)(cid:5)(cid:3)(cid:9)(cid:2)(cid:28)(cid:3,Unknown,4195.0
Unknown,Unknown,18,Unknown,Unknown,Unknown,Unknown,cid:50)(cid:5)(cid:14)(cid:7)(cid:12)(cid:5)(cid:9)(cid:2)(cid:16)(cid:16)(cid:2)(cid:12)(cid:11)(cid:4)(cid:14)(cid:11)(cid:48)(cid:48)(cid:7)(cid:5)(cid:3)(cid:9)(cid:2)(cid:28)(cid:3,Unknown,4213.0
Unknown,Unknown,1,Unknown,Unknown,Unknown,Unknown,cid:50)(cid:5)(cid:14)(cid:7)(cid:12)(cid:5)(cid:9)(cid:2)(cid:16)(cid:16)(cid:2)(cid:12)(cid:11)(cid:4)(cid:14)(cid:11)(cid:48)(cid:48)(cid:7)(cid:5)(cid:3)(cid:9)(cid:2)(cid:28)(cid:3,Unknown,4214.0
Unknown,Unknown,1,Unknown,Unknown,Unknown,Unknown,cid:50)(cid:5)(cid:14)(cid:7)(cid:12)(cid:5)(cid:9)(cid:2)(cid:16)(cid:16)(cid:2)(cid:12)(cid:11)(cid:4)(cid:14)(cid:11)(cid:48)(cid:48)(cid:7)(cid:5)(cid:3)(cid:9)(cid:2)(cid:28)(cid:3,Unknown,4215.0
Unknown,Unknown,37,Unknown,Unknown,Unknown,Unknown,cid:50)(cid:5)(cid:14)(cid:7)(cid:12)(cid:5)(cid:9)(cid:2)(cid:16)(cid:16)(cid:2)(cid:12)(cid:11)(cid:4)(cid:14)(cid:11)(cid:48)(cid:48)(cid:7)(cid:5)(cid:3)(cid:9)(cid:2)(cid:28)(cid:3,Unknown,4252.0
Unknown,Unknown,37,Unknown,Unknown,Unknown,Unknown,cid:50)(cid:5)(cid:14)(cid:7)(cid:12)(cid:5)(cid:9)(cid:2)(cid:16)(cid:16)(cid:2)(cid:12)(cid:11)(cid:4)(cid:14)(cid:11)(cid:48)(cid:48)(cid:7)(cid:5)(cid:3)(cid:9)(cid:2)(cid:28)(cid:3,Unknown,4289.0
Unknown,Unknown,18,Unknown,Unknown,Unknown,Unknown,cid:50)(cid:5)(cid:14)(cid:7)(cid:12)(cid:5)(cid:9)(cid:2)(cid:16)(cid:16)(cid:2)(cid:12)(cid:11)(cid:4)(cid:14)(cid:11)(cid:48)(cid:48)(cid:7)(cid:5)(cid:3)(cid:9)(cid:2)(cid:28)(cid:3,Unknown,4307.0
Unknown,Unknown,45,Unknown,Unknown,Unknown,Unknown,cid:50)(cid:5)(cid:14)(cid:7)(cid:12)(cid:5)(cid:9)(cid:2)(cid:16)(cid:16)(cid:2)(cid:12)(cid:11)(cid:4)(cid:14)(cid:11)(cid:48)(cid:48)(cid:7)(cid:5)(cid:3)(cid:9)(cid:2)(cid:28)(cid:3,Unknown,4352.0
Unknown,Unknown,18,Unknown,Unknown,Unknown,Unknown,cid:50)(cid:5)(cid:14)(cid:7)(cid:12)(cid:5)(cid:9)(cid:2)(cid:16)(cid:16)(cid:2)(cid:12)(cid:11)(cid:4)(cid:14)(cid:11)(cid:48)(cid:48)(cid:7)(cid:5)(cid:3)(cid:9)(cid:2)(cid:28)(cid:3,Unknown,4370.0
Unknown,Unknown,16,Unknown,Unknown,Unknown,Unknown,cid:50)(cid:5)(cid:14)(cid:7)(cid:12)(cid:5)(cid:9)(cid:2)(cid:16)(cid:16)(cid:2)(cid:12)(cid:11)(cid:4)(cid:14)(cid:11)(cid:48)(cid:48)(cid:7)(cid:5)(cid:3)(cid:9)(cid:2)(cid:28)(cid:3,Unknown,4386.0
Unknown,Unknown,10,Unknown,Unknown,Unknown,Unknown,cid:50)(cid:5)(cid:14)(cid:7)(cid:12)(cid:5)(cid:9)(cid:2)(cid:16)(cid:16)(cid:2)(cid:12)(cid:11)(cid:4)(cid:14)(cid:11)(cid:48)(cid:48)(cid:7)(cid:5)(cid:3)(cid:9)(cid:2)(cid:28)(cid:3,Unknown,4396.0
Unknown,Unknown,11,Unknown,Unknown,Unknown,Unknown,cid:50)(cid:5)(cid:14)(cid:7)(cid:12)(cid:5)(cid:9)(cid:2)(cid:16)(cid:16)(cid:2)(cid:12)(cid:11)(cid:4)(cid:14)(cid:11)(cid:48)(cid:48)(cid:7)(cid:5)(cid:3)(cid:9)(cid:2)(cid:28)(cid:3,Unknown,4407.0
Unknown,Unknown,10,Unknown,Unknown,Unknown,Unknown,cid:50)(cid:5)(cid:14)(cid:7)(cid:12)(cid:5)(cid:9)(cid:2)(cid:16)(cid:16)(cid:2)(cid:12)(cid:11)(cid:4)(cid:14)(cid:11)(cid:48)(cid:48)(cid:7)(cid:5)(cid:3)(cid:9)(cid:2)(cid:28)(cid:3,Unknown,4417.0
Unknown,Unknown,46,Unknown,Unknown,Unknown,Unknown,cid:50)(cid:5)(cid:14)(cid:7)(cid:12)(cid:5)(cid:9)(cid:2)(cid:16)(cid:16)(cid:2)(cid:12)(cid:11)(cid:4)(cid:14)(cid:11)(cid:48)(cid:48)(cid:7)(cid:5)(cid:3)(cid:9)(cid:2)(cid:28)(cid:3,Unknown,4463.0
Unknown,Unknown,14,Unknown,Unknown,Unknown,Unknown,cid:50)(cid:5)(cid:14)(cid:7)(cid:12)(cid:5)(cid:9)(cid:2)(cid:16)(cid:16)(cid:2)(cid:12)(cid:11)(cid:4)(cid:14)(cid:11)(cid:48)(cid:48)(cid:7)(cid:5)(cid:3)(cid:9)(cid:2)(cid:28)(cid:3,Unknown,4477.0
Unknown,Unknown,2,Unknown,Unknown,Unknown,Unknown,cid:50)(cid:5)(cid:14)(cid:7)(cid:12)(cid:5)(cid:9)(cid:2)(cid:16)(cid:16)(cid:2)(cid:12)(cid:11)(cid:4)(cid:14)(cid:11)(cid:48)(cid:48)(cid:7)(cid:5)(cid:3)(cid:9)(cid:2)(cid:28)(cid:3,Unknown,4479.0
Unknown,Unknown,12,Unknown,Unknown,Unknown,Unknown,cid:50)(cid:5)(cid:14)(cid:7)(cid:12)(cid:5)(cid:9)(cid:2)(cid:16)(cid:16)(cid:2)(cid:12)(cid:11)(cid:4)(cid:14)(cid:11)(cid:48)(cid:48)(cid:7)(cid:5)(cid:3)(cid:9)(cid:2)(cid:28)(cid:3,Unknown,4491.0
Unknown,Unknown,11,Unknown,Unknown,Unknown,Unknown,cid:50)(cid:5)(cid:14)(cid:7)(cid:12)(cid:5)(cid:9)(cid:2)(cid:16)(cid:16)(cid:2)(cid:12)(cid:11)(cid:4)(cid:14)(cid:11)(cid:48)(cid:48)(cid:7)(cid:5)(cid:3)(cid:9)(cid:2)(cid:28)(cid:3,Unknown,4502.0
Unknown,Unknown,4,Unknown,Unknown,Unknown,Unknown,cid:50)(cid:5)(cid:14)(cid:7)(cid:12)(cid:5)(cid:9)(cid:2)(cid:16)(cid:16)(cid:2)(cid:12)(cid:11)(cid:4)(cid:14)(cid:11)(cid:48)(cid:48)(cid:7)(cid:5)(cid:3)(cid:9)(cid:2)(cid:28)(cid:3,Unknown,4506.0
Unknown,Unknown,14,Unknown,Unknown,Unknown,Unknown,cid:50)(cid:5)(cid:14)(cid:7)(cid:12)(cid:5)(cid:9)(cid:2)(cid:16)(cid:16)(cid:2)(cid:12)(cid:11)(cid:4)(cid:14)(cid:11)(cid:48)(cid:48)(cid:7)(cid:5)(cid:3)(cid:9)(cid:2)(cid:28)(cid:3,Unknown,4520.0
Unknown,Unknown,11,Unknown,Unknown,Unknown,Unknown,cid:50)(cid:5)(cid:14)(cid:7)(cid:12)(cid:5)(cid:9)(cid:2)(cid:16)(cid:16)(cid:2)(cid:12)(cid:11)(cid:4)(cid:14)(cid:11)(cid:48)(cid:48)(cid:7)(cid:5)(cid:3)(cid:9)(cid:2)(cid:28)(cid:3,Unknown,4531.0
Unknown,Unknown,48,Unknown,Unknown,Unknown,Unknown,cid:50)(cid:5)(cid:14)(cid:7)(cid:12)(cid:5)(cid:9)(cid:2)(cid:16)(cid:16)(cid:2)(cid:12)(cid:11)(cid:4)(cid:14)(cid:11)(cid:48)(cid:48)(cid:7)(cid:5)(cid:3)(cid:9)(cid:2)(cid:28)(cid:3,Unknown,4579.0
Unknown,Unknown,48,Unknown,Unknown,Unknown,Unknown,cid:50)(cid:5)(cid:14)(cid:7)(cid:12)(cid:5)(cid:9)(cid:2)(cid:16)(cid:16)(cid:2)(cid:12)(cid:11)(cid:4)(cid:14)(cid:11)(cid:48)(cid:48)(cid:7)(cid:5)(cid:3)(cid:9)(cid:2)(cid:28)(cid:3,Unknown,4627.0
Unknown,Unknown,7,Unknown,Unknown,Unknown,Unknown,cid:50)(cid:5)(cid:14)(cid:7)(cid:12)(cid:5)(cid:9)(cid:2)(cid:16)(cid:16)(cid:2)(cid:12)(cid:11)(cid:4)(cid:14)(cid:11)(cid:48)(cid:48)(cid:7)(cid:5)(cid:3)(cid:9)(cid:2)(cid:28)(cid:3,Unknown,4634.0
Unknown,Unknown,5,Unknown,Unknown,Unknown,Unknown,cid:50)(cid:5)(cid:14)(cid:7)(cid:12)(cid:5)(cid:9)(cid:2)(cid:16)(cid:16)(cid:2)(cid:12)(cid:11)(cid:4)(cid:14)(cid:11)(cid:48)(cid:48)(cid:7)(cid:5)(cid:3)(cid:9)(cid:2)(cid:28)(cid:3,Unknown,4639.0
Unknown,Unknown,3,Unknown,Unknown,Unknown,Unknown,cid:50)(cid:5)(cid:14)(cid:7)(cid:12)(cid:5)(cid:9)(cid:2)(cid:16)(cid:16)(cid:2)(cid:12)(cid:11)(cid:4)(cid:14)(cid:11)(cid:48)(cid:48)(cid:7)(cid:5)(cid:3)(cid:9)(cid:2)(cid:28)(cid:3,Unknown,4642.0
Unknown,Unknown,9,Unknown,Unknown,Unknown,Unknown,cid:50)(cid:5)(cid:14)(cid:7)(cid:12)(cid:5)(cid:9)(cid:2)(cid:16)(cid:16)(cid:2)(cid:12)(cid:11)(cid:4)(cid:14)(cid:11)(cid:48)(cid:48)(cid:7)(cid:5)(cid:3)(cid:9)(cid:2)(cid:28)(cid:3,Unknown,4651.0
Unknown,Unknown,2,Unknown,Unknown,Unknown,Unknown,cid:50)(cid:5)(cid:14)(cid:7)(cid:12)(cid:5)(cid:9)(cid:2)(cid:16)(cid:16)(cid:2)(cid:12)(cid:11)(cid:4)(cid:14)(cid:11)(cid:48)(cid:48)(cid:7)(cid:5)(cid:3)(cid:9)(cid:2)(cid:28)(cid:3,Unknown,4653.0
Unknown,Unknown,28,Unknown,Unknown,Unknown,Unknown,cid:50)(cid:5)(cid:14)(cid:7)(cid:12)(cid:5)(cid:9)(cid:2)(cid:16)(cid:16)(cid:2)(cid:12)(cid:11)(cid:4)(cid:14)(cid:11)(cid:48)(cid:48)(cid:7)(cid:5)(cid:3)(cid:9)(cid:2)(cid:28)(cid:3,Unknown,4681.0
Unknown,Unknown,3,Unknown,Unknown,Unknown,Unknown,cid:50)(cid:5)(cid:14)(cid:7)(cid:12)(cid:5)(cid:9)(cid:2)(cid:16)(cid:16)(cid:2)(cid:12)(cid:11)(cid:4)(cid:14)(cid:11)(cid:48)(cid:48)(cid:7)(cid:5)(cid:3)(cid:9)(cid:2)(cid:28)(cid:3,Unknown,4684.0
Unknown,Unknown,15,Unknown,Unknown,Unknown,Unknown,cid:50)(cid:5)(cid:14)(cid:7)(cid:12)(cid:5)(cid:9)(cid:2)(cid:16)(cid:16)(cid:2)(cid:12)(cid:11)(cid:4)(cid:14)(cid:11)(cid:48)(cid:48)(cid:7)(cid:5)(cid:3)(cid:9)(cid:2)(cid:28)(cid:3,Unknown,4699.0
Unknown,Unknown,2,Unknown,Unknown,Unknown,Unknown,cid:50)(cid:5)(cid:14)(cid:7)(cid:12)(cid:5)(cid:9)(cid:2)(cid:16)(cid:16)(cid:2)(cid:12)(cid:11)(cid:4)(cid:14)(cid:11)(cid:48)(cid:48)(cid:7)(cid:5)(cid:3)(cid:9)(cid:2)(cid:28)(cid:3,Unknown,4701.0
Unknown,Unknown,36,Unknown,Unknown,Unknown,Unknown,cid:50)(cid:5)(cid:14)(cid:7)(cid:12)(cid:5)(cid:9)(cid:2)(cid:16)(cid:16)(cid:2)(cid:12)(cid:11)(cid:4)(cid:14)(cid:11)(cid:48)(cid:48)(cid:7)(cid:5)(cid:3)(cid:9)(cid:2)(cid:28)(cid:3,Unknown,4737.0
Unknown,Unknown,18,Unknown,Unknown,Unknown,Unknown,cid:50)(cid:5)(cid:14)(cid:7)(cid:12)(cid:5)(cid:9)(cid:2)(cid:16)(cid:16)(cid:2)(cid:12)(cid:11)(cid:4)(cid:14)(cid:11)(cid:48)(cid:48)(cid:7)(cid:5)(cid:3)(cid:9)(cid:2)(cid:28)(cid:3,Unknown,4755.0
Unknown,Unknown,19,Unknown,Unknown,Unknown,Unknown,cid:50)(cid:5)(cid:14)(cid:7)(cid:12)(cid:5)(cid:9)(cid:2)(cid:16)(cid:16)(cid:2)(cid:12)(cid:11)(cid:4)(cid:14)(cid:11)(cid:48)(cid:48)(cid:7)(cid:5)(cid:3)(cid:9)(cid:2)(cid:28)(cid:3,Unknown,4774.0
Unknown,Unknown,18,Unknown,Unknown,Unknown,Unknown,cid:50)(cid:5)(cid:14)(cid:7)(cid:12)(cid:5)(cid:9)(cid:2)(cid:16)(cid:16)(cid:2)(cid:12)(cid:11)(cid:4)(cid:14)(cid:11)(cid:48)(cid:48)(cid:7)(cid:5)(cid:3)(cid:9)(cid:2)(cid:28)(cid:3,Unknown,4792.0
Unknown,Unknown,1,Unknown,Unknown,Unknown,Unknown,cid:50)(cid:5)(cid:14)(cid:7)(cid:12)(cid:5)(cid:9)(cid:2)(cid:16)(cid:16)(cid:2)(cid:12)(cid:11)(cid:4)(cid:14)(cid:11)(cid:48)(cid:48)(cid:7)(cid:5)(cid:3)(cid:9)(cid:2)(cid:28)(cid:3,Unknown,4793.0
Unknown,Unknown,2,Unknown,Unknown,Unknown,Unknown,cid:50)(cid:5)(cid:14)(cid:7)(cid:12)(cid:5)(cid:9)(cid:2)(cid:16)(cid:16)(cid:2)(cid:12)(cid:11)(cid:4)(cid:14)(cid:11)(cid:48)(cid:48)(cid:7)(cid:5)(cid:3)(cid:9)(cid:2)(cid:28)(cid:3,Unknown,4795.0
Unknown,Unknown,44,Unknown,Unknown,Unknown,Unknown,cid:50)(cid:5)(cid:14)(cid:7)(cid:12)(cid:5)(cid:9)(cid:2)(cid:16)(cid:16)(cid:2)(cid:12)(cid:11)(cid:4)(cid:14)(cid:11)(cid:48)(cid:48)(cid:7)(cid:5)(cid:3)(cid:9)(cid:2)(cid:28)(cid:3,Unknown,4839.0
Unknown,Unknown,12,Unknown,Unknown,Unknown,Unknown,cid:50)(cid:5)(cid:14)(cid:7)(cid:12)(cid:5)(cid:9)(cid:2)(cid:16)(cid:16)(cid:2)(cid:12)(cid:11)(cid:4)(cid:14)(cid:11)(cid:48)(cid:48)(cid:7)(cid:5)(cid:3)(cid:9)(cid:2)(cid:28)(cid:3,Unknown,4851.0
Unknown,Unknown,29,Unknown,Unknown,Unknown,Unknown,cid:50)(cid:5)(cid:14)(cid:7)(cid:12)(cid:5)(cid:9)(cid:2)(cid:16)(cid:16)(cid:2)(cid:12)(cid:11)(cid:4)(cid:14)(cid:11)(cid:48)(cid:48)(cid:7)(cid:5)(cid:3)(cid:9)(cid:2)(cid:28)(cid:3,Unknown,4880.0
Unknown,Unknown,26,Unknown,Unknown,Unknown,Unknown,cid:50)(cid:5)(cid:14)(cid:7)(cid:12)(cid:5)(cid:9)(cid:2)(cid:16)(cid:16)(cid:2)(cid:12)(cid:11)(cid:4)(cid:14)(cid:11)(cid:48)(cid:48)(cid:7)(cid:5)(cid:3)(cid:9)(cid:2)(cid:28)(cid:3,Unknown,4906.0
Unknown,Unknown,41,Unknown,Unknown,Unknown,Unknown,cid:50)(cid:5)(cid:14)(cid:7)(cid:12)(cid:5)(cid:9)(cid:2)(cid:16)(cid:16)(cid:2)(cid:12)(cid:11)(cid:4)(cid:14)(cid:11)(cid:48)(cid:48)(cid:7)(cid:5)(cid:3)(cid:9)(cid:2)(cid:28)(cid:3,Unknown,4947.0
Unknown,Unknown,25,Unknown,Unknown,Unknown,Unknown,cid:50)(cid:5)(cid:14)(cid:7)(cid:12)(cid:5)(cid:9)(cid:2)(cid:16)(cid:16)(cid:2)(cid:12)(cid:11)(cid:4)(cid:14)(cid:11)(cid:48)(cid:48)(cid:7)(cid:5)(cid:3)(cid:9)(cid:2)(cid:28)(cid:3,Unknown,4972.0
Unknown,Unknown,2,Unknown,Unknown,Unknown,Unknown,cid:50)(cid:5)(cid:14)(cid:7)(cid:12)(cid:5)(cid:9)(cid:2)(cid:16)(cid:16)(cid:2)(cid:12)(cid:11)(cid:4)(cid:14)(cid:11)(cid:48)(cid:48)(cid:7)(cid:5)(cid:3)(cid:9)(cid:2)(cid:28)(cid:3,Unknown,4974.0
Unknown,Unknown,58,Unknown,Unknown,Unknown,Unknown,cid:50)(cid:5)(cid:14)(cid:7)(cid:12)(cid:5)(cid:9)(cid:2)(cid:16)(cid:16)(cid:2)(cid:12)(cid:11)(cid:4)(cid:14)(cid:11)(cid:48)(cid:48)(cid:7)(cid:5)(cid:3)(cid:9)(cid:2)(cid:28)(cid:3,Unknown,5032.0
Unknown,Unknown,58,Unknown,Unknown,Unknown,Unknown,cid:50)(cid:5)(cid:14)(cid:7)(cid:12)(cid:5)(cid:9)(cid:2)(cid:16)(cid:16)(cid:2)(cid:12)(cid:11)(cid:4)(cid:14)(cid:11)(cid:48)(cid:48)(cid:7)(cid:5)(cid:3)(cid:9)(cid:2)(cid:28)(cid:3,Unknown,5090.0
Unknown,Unknown,18,Unknown,Unknown,Unknown,Unknown,cid:50)(cid:5)(cid:14)(cid:7)(cid:12)(cid:5)(cid:9)(cid:2)(cid:16)(cid:16)(cid:2)(cid:12)(cid:11)(cid:4)(cid:14)(cid:11)(cid:48)(cid:48)(cid:7)(cid:5)(cid:3)(cid:9)(cid:2)(cid:28)(cid:3,Unknown,5108.0
Unknown,Unknown,1,Unknown,Unknown,Unknown,Unknown,cid:50)(cid:5)(cid:14)(cid:7)(cid:12)(cid:5)(cid:9)(cid:2)(cid:16)(cid:16)(cid:2)(cid:12)(cid:11)(cid:4)(cid:14)(cid:11)(cid:48)(cid:48)(cid:7)(cid:5)(cid:3)(cid:9)(cid:2)(cid:28)(cid:3,Unknown,5109.0
Unknown,Unknown,1,Unknown,Unknown,Unknown,Unknown,cid:50)(cid:5)(cid:14)(cid:7)(cid:12)(cid:5)(cid:9)(cid:2)(cid:16)(cid:16)(cid:2)(cid:12)(cid:11)(cid:4)(cid:14)(cid:11)(cid:48)(cid:48)(cid:7)(cid:5)(cid:3)(cid:9)(cid:2)(cid:28)(cid:3,Unknown,5110.0
Unknown,Unknown,37,Unknown,Unknown,Unknown,Unknown,cid:50)(cid:5)(cid:14)(cid:7)(cid:12)(cid:5)(cid:9)(cid:2)(cid:16)(cid:16)(cid:2)(cid:12)(cid:11)(cid:4)(cid:14)(cid:11)(cid:48)(cid:48)(cid:7)(cid:5)(cid:3)(cid:9)(cid:2)(cid:28)(cid:3,Unknown,5147.0
Unknown,Unknown,37,Unknown,Unknown,Unknown,Unknown,cid:50)(cid:5)(cid:14)(cid:7)(cid:12)(cid:5)(cid:9)(cid:2)(cid:16)(cid:16)(cid:2)(cid:12)(cid:11)(cid:4)(cid:14)(cid:11)(cid:48)(cid:48)(cid:7)(cid:5)(cid:3)(cid:9)(cid:2)(cid:28)(cid:3,Unknown,5184.0
Unknown,Unknown,17,Unknown,Unknown,Unknown,Unknown,cid:50)(cid:5)(cid:14)(cid:7)(cid:12)(cid:5)(cid:9)(cid:2)(cid:16)(cid:16)(cid:2)(cid:12)(cid:11)(cid:4)(cid:14)(cid:11)(cid:48)(cid:48)(cid:7)(cid:5)(cid:3)(cid:9)(cid:2)(cid:28)(cid:3,Unknown,5201.0
Unknown,Unknown,45,Unknown,Unknown,Unknown,Unknown,cid:50)(cid:5)(cid:14)(cid:7)(cid:12)(cid:5)(cid:9)(cid:2)(cid:16)(cid:16)(cid:2)(cid:12)(cid:11)(cid:4)(cid:14)(cid:11)(cid:48)(cid:48)(cid:7)(cid:5)(cid:3)(cid:9)(cid:2)(cid:28)(cid:3,Unknown,5246.0
Unknown,Unknown,18,Unknown,Unknown,Unknown,Unknown,cid:50)(cid:5)(cid:14)(cid:7)(cid:12)(cid:5)(cid:9)(cid:2)(cid:16)(cid:16)(cid:2)(cid:12)(cid:11)(cid:4)(cid:14)(cid:11)(cid:48)(cid:48)(cid:7)(cid:5)(cid:3)(cid:9)(cid:2)(cid:28)(cid:3,Unknown,5264.0
Unknown,Unknown,16,Unknown,Unknown,Unknown,Unknown,cid:50)(cid:5)(cid:14)(cid:7)(cid:12)(cid:5)(cid:9)(cid:2)(cid:16)(cid:16)(cid:2)(cid:12)(cid:11)(cid:4)(cid:14)(cid:11)(cid:48)(cid:48)(cid:7)(cid:5)(cid:3)(cid:9)(cid:2)(cid:28)(cid:3,Unknown,5280.0
Unknown,Unknown,10,Unknown,Unknown,Unknown,Unknown,cid:50)(cid:5)(cid:14)(cid:7)(cid:12)(cid:5)(cid:9)(cid:2)(cid:16)(cid:16)(cid:2)(cid:12)(cid:11)(cid:4)(cid:14)(cid:11)(cid:48)(cid:48)(cid:7)(cid:5)(cid:3)(cid:9)(cid:2)(cid:28)(cid:3,Unknown,5290.0
Unknown,Unknown,11,Unknown,Unknown,Unknown,Unknown,cid:50)(cid:5)(cid:14)(cid:7)(cid:12)(cid:5)(cid:9)(cid:2)(cid:16)(cid:16)(cid:2)(cid:12)(cid:11)(cid:4)(cid:14)(cid:11)(cid:48)(cid:48)(cid:7)(cid:5)(cid:3)(cid:9)(cid:2)(cid:28)(cid:3,Unknown,5301.0
Unknown,Unknown,10,Unknown,Unknown,Unknown,Unknown,cid:50)(cid:5)(cid:14)(cid:7)(cid:12)(cid:5)(cid:9)(cid:2)(cid:16)(cid:16)(cid:2)(cid:12)(cid:11)(cid:4)(cid:14)(cid:11)(cid:48)(cid:48)(cid:7)(cid:5)(cid:3)(cid:9)(cid:2)(cid:28)(cid:3,Unknown,5311.0
Unknown,Unknown,46,Unknown,Unknown,Unknown,Unknown,cid:50)(cid:5)(cid:14)(cid:7)(cid:12)(cid:5)(cid:9)(cid:2)(cid:16)(cid:16)(cid:2)(cid:12)(cid:11)(cid:4)(cid:14)(cid:11)(cid:48)(cid:48)(cid:7)(cid:5)(cid:3)(cid:9)(cid:2)(cid:28)(cid:3,Unknown,5357.0
Unknown,Unknown,14,Unknown,Unknown,Unknown,Unknown,cid:50)(cid:5)(cid:14)(cid:7)(cid:12)(cid:5)(cid:9)(cid:2)(cid:16)(cid:16)(cid:2)(cid:12)(cid:11)(cid:4)(cid:14)(cid:11)(cid:48)(cid:48)(cid:7)(cid:5)(cid:3)(cid:9)(cid:2)(cid:28)(cid:3,Unknown,5371.0
Unknown,Unknown,2,Unknown,Unknown,Unknown,Unknown,cid:50)(cid:5)(cid:14)(cid:7)(cid:12)(cid:5)(cid:9)(cid:2)(cid:16)(cid:16)(cid:2)(cid:12)(cid:11)(cid:4)(cid:14)(cid:11)(cid:48)(cid:48)(cid:7)(cid:5)(cid:3)(cid:9)(cid:2)(cid:28)(cid:3,Unknown,5373.0
Unknown,Unknown,12,Unknown,Unknown,Unknown,Unknown,cid:50)(cid:5)(cid:14)(cid:7)(cid:12)(cid:5)(cid:9)(cid:2)(cid:16)(cid:16)(cid:2)(cid:12)(cid:11)(cid:4)(cid:14)(cid:11)(cid:48)(cid:48)(cid:7)(cid:5)(cid:3)(cid:9)(cid:2)(cid:28)(cid:3,Unknown,5385.0
Unknown,Unknown,11,Unknown,Unknown,Unknown,Unknown,cid:50)(cid:5)(cid:14)(cid:7)(cid:12)(cid:5)(cid:9)(cid:2)(cid:16)(cid:16)(cid:2)(cid:12)(cid:11)(cid:4)(cid:14)(cid:11)(cid:48)(cid:48)(cid:7)(cid:5)(cid:3)(cid:9)(cid:2)(cid:28)(cid:3,Unknown,5396.0
Unknown,Unknown,4,Unknown,Unknown,Unknown,Unknown,cid:50)(cid:5)(cid:14)(cid:7)(cid:12)(cid:5)(cid:9)(cid:2)(cid:16)(cid:16)(cid:2)(cid:12)(cid:11)(cid:4)(cid:14)(cid:11)(cid:48)(cid:48)(cid:7)(cid:5)(cid:3)(cid:9)(cid:2)(cid:28)(cid:3,Unknown,5400.0
Unknown,Unknown,14,Unknown,Unknown,Unknown,Unknown,cid:50)(cid:5)(cid:14)(cid:7)(cid:12)(cid:5)(cid:9)(cid:2)(cid:16)(cid:16)(cid:2)(cid:12)(cid:11)(cid:4)(cid:14)(cid:11)(cid:48)(cid:48)(cid:7)(cid:5)(cid:3)(cid:9)(cid:2)(cid:28)(cid:3,Unknown,5414.0
Unknown,Unknown,11,Unknown,Unknown,Unknown,Unknown,cid:50)(cid:5)(cid:14)(cid:7)(cid:12)(cid:5)(cid:9)(cid:2)(cid:16)(cid:16)(cid:2)(cid:12)(cid:11)(cid:4)(cid:14)(cid:11)(cid:48)(cid:48)(cid:7)(cid:5)(cid:3)(cid:9)(cid:2)(cid:28)(cid:3,Unknown,5425.0
Unknown,Unknown,48,Unknown,Unknown,Unknown,Unknown,cid:50)(cid:5)(cid:14)(cid:7)(cid:12)(cid:5)(cid:9)(cid:2)(cid:16)(cid:16)(cid:2)(cid:12)(cid:11)(cid:4)(cid:14)(cid:11)(cid:48)(cid:48)(cid:7)(cid:5)(cid:3)(cid:9)(cid:2)(cid:28)(cid:3,Unknown,5473.0
Unknown,Unknown,48,Unknown,Unknown,Unknown,Unknown,cid:50)(cid:5)(cid:14)(cid:7)(cid:12)(cid:5)(cid:9)(cid:2)(cid:16)(cid:16)(cid:2)(cid:12)(cid:11)(cid:4)(cid:14)(cid:11)(cid:48)(cid:48)(cid:7)(cid:5)(cid:3)(cid:9)(cid:2)(cid:28)(cid:3,Unknown,5521.0
Unknown,Unknown,7,Unknown,Unknown,Unknown,Unknown,cid:50)(cid:5)(cid:14)(cid:7)(cid:12)(cid:5)(cid:9)(cid:2)(cid:16)(cid:16)(cid:2)(cid:12)(cid:11)(cid:4)(cid:14)(cid:11)(cid:48)(cid:48)(cid:7)(cid:5)(cid:3)(cid:9)(cid:2)(cid:28)(cid:3,Unknown,5528.0
Unknown,Unknown,5,Unknown,Unknown,Unknown,Unknown,cid:50)(cid:5)(cid:14)(cid:7)(cid:12)(cid:5)(cid:9)(cid:2)(cid:16)(cid:16)(cid:2)(cid:12)(cid:11)(cid:4)(cid:14)(cid:11)(cid:48)(cid:48)(cid:7)(cid:5)(cid:3)(cid:9)(cid:2)(cid:28)(cid:3,Unknown,5533.0
Unknown,Unknown,3,Unknown,Unknown,Unknown,Unknown,cid:50)(cid:5)(cid:14)(cid:7)(cid:12)(cid:5)(cid:9)(cid:2)(cid:16)(cid:16)(cid:2)(cid:12)(cid:11)(cid:4)(cid:14)(cid:11)(cid:48)(cid:48)(cid:7)(cid:5)(cid:3)(cid:9)(cid:2)(cid:28)(cid:3,Unknown,5536.0
Unknown,Unknown,9,Unknown,Unknown,Unknown,Unknown,cid:50)(cid:5)(cid:14)(cid:7)(cid:12)(cid:5)(cid:9)(cid:2)(cid:16)(cid:16)(cid:2)(cid:12)(cid:11)(cid:4)(cid:14)(cid:11)(cid:48)(cid:48)(cid:7)(cid:5)(cid:3)(cid:9)(cid:2)(cid:28)(cid:3,Unknown,5545.0
Unknown,Unknown,2,Unknown,Unknown,Unknown,Unknown,cid:50)(cid:5)(cid:14)(cid:7)(cid:12)(cid:5)(cid:9)(cid:2)(cid:16)(cid:16)(cid:2)(cid:12)(cid:11)(cid:4)(cid:14)(cid:11)(cid:48)(cid:48)(cid:7)(cid:5)(cid:3)(cid:9)(cid:2)(cid:28)(cid:3,Unknown,5547.0
Unknown,Unknown,28,Unknown,Unknown,Unknown,Unknown,cid:50)(cid:5)(cid:14)(cid:7)(cid:12)(cid:5)(cid:9)(cid:2)(cid:16)(cid:16)(cid:2)(cid:12)(cid:11)(cid:4)(cid:14)(cid:11)(cid:48)(cid:48)(cid:7)(cid:5)(cid:3)(cid:9)(cid:2)(cid:28)(cid:3,Unknown,5575.0
Unknown,Unknown,3,Unknown,Unknown,Unknown,Unknown,cid:50)(cid:5)(cid:14)(cid:7)(cid:12)(cid:5)(cid:9)(cid:2)(cid:16)(cid:16)(cid:2)(cid:12)(cid:11)(cid:4)(cid:14)(cid:11)(cid:48)(cid:48)(cid:7)(cid:5)(cid:3)(cid:9)(cid:2)(cid:28)(cid:3,Unknown,5578.0
Unknown,Unknown,15,Unknown,Unknown,Unknown,Unknown,cid:50)(cid:5)(cid:14)(cid:7)(cid:12)(cid:5)(cid:9)(cid:2)(cid:16)(cid:16)(cid:2)(cid:12)(cid:11)(cid:4)(cid:14)(cid:11)(cid:48)(cid:48)(cid:7)(cid:5)(cid:3)(cid:9)(cid:2)(cid:28)(cid:3,Unknown,5593.0
Unknown,Unknown,2,Unknown,Unknown,Unknown,Unknown,cid:50)(cid:5)(cid:14)(cid:7)(cid:12)(cid:5)(cid:9)(cid:2)(cid:16)(cid:16)(cid:2)(cid:12)(cid:11)(cid:4)(cid:14)(cid:11)(cid:48)(cid:48)(cid:7)(cid:5)(cid:3)(cid:9)(cid:2)(cid:28)(cid:3,Unknown,5595.0
Unknown,Unknown,34,Unknown,Unknown,Unknown,Unknown,cid:50)(cid:5)(cid:14)(cid:7)(cid:12)(cid:5)(cid:9)(cid:2)(cid:16)(cid:16)(cid:2)(cid:12)(cid:11)(cid:4)(cid:14)(cid:11)(cid:48)(cid:48)(cid:7)(cid:5)(cid:3)(cid:9)(cid:2)(cid:28)(cid:3,Unknown,5629.0
Unknown,Unknown,18,Unknown,Unknown,Unknown,Unknown,cid:50)(cid:5)(cid:14)(cid:7)(cid:12)(cid:5)(cid:9)(cid:2)(cid:16)(cid:16)(cid:2)(cid:12)(cid:11)(cid:4)(cid:14)(cid:11)(cid:48)(cid:48)(cid:7)(cid:5)(cid:3)(cid:9)(cid:2)(cid:28)(cid:3,Unknown,5647.0
Unknown,Unknown,19,Unknown,Unknown,Unknown,Unknown,cid:50)(cid:5)(cid:14)(cid:7)(cid:12)(cid:5)(cid:9)(cid:2)(cid:16)(cid:16)(cid:2)(cid:12)(cid:11)(cid:4)(cid:14)(cid:11)(cid:48)(cid:48)(cid:7)(cid:5)(cid:3)(cid:9)(cid:2)(cid:28)(cid:3,Unknown,5666.0
Unknown,Unknown,18,Unknown,Unknown,Unknown,Unknown,cid:50)(cid:5)(cid:14)(cid:7)(cid:12)(cid:5)(cid:9)(cid:2)(cid:16)(cid:16)(cid:2)(cid:12)(cid:11)(cid:4)(cid:14)(cid:11)(cid:48)(cid:48)(cid:7)(cid:5)(cid:3)(cid:9)(cid:2)(cid:28)(cid:3,Unknown,5684.0
Unknown,Unknown,17,Unknown,Unknown,Unknown,Unknown,cid:50)(cid:5)(cid:14)(cid:7)(cid:12)(cid:5)(cid:9)(cid:2)(cid:16)(cid:16)(cid:2)(cid:12)(cid:11)(cid:4)(cid:14)(cid:11)(cid:48)(cid:48)(cid:7)(cid:5)(cid:3)(cid:9)(cid:2)(cid:28)(cid:3,Unknown,5701.0
Unknown,Unknown,2,Unknown,Unknown,Unknown,Unknown,cid:50)(cid:5)(cid:14)(cid:7)(cid:12)(cid:5)(cid:9)(cid:2)(cid:16)(cid:16)(cid:2)(cid:12)(cid:11)(cid:4)(cid:14)(cid:11)(cid:48)(cid:48)(cid:7)(cid:5)(cid:3)(cid:9)(cid:2)(cid:28)(cid:3,Unknown,5703.0
Unknown,Unknown,44,Unknown,Unknown,Unknown,Unknown,cid:50)(cid:5)(cid:14)(cid:7)(cid:12)(cid:5)(cid:9)(cid:2)(cid:16)(cid:16)(cid:2)(cid:12)(cid:11)(cid:4)(cid:14)(cid:11)(cid:48)(cid:48)(cid:7)(cid:5)(cid:3)(cid:9)(cid:2)(cid:28)(cid:3,Unknown,5747.0
Unknown,Unknown,12,Unknown,Unknown,Unknown,Unknown,cid:50)(cid:5)(cid:14)(cid:7)(cid:12)(cid:5)(cid:9)(cid:2)(cid:16)(cid:16)(cid:2)(cid:12)(cid:11)(cid:4)(cid:14)(cid:11)(cid:48)(cid:48)(cid:7)(cid:5)(cid:3)(cid:9)(cid:2)(cid:28)(cid:3,Unknown,5759.0
Unknown,Unknown,29,Unknown,Unknown,Unknown,Unknown,cid:50)(cid:5)(cid:14)(cid:7)(cid:12)(cid:5)(cid:9)(cid:2)(cid:16)(cid:16)(cid:2)(cid:12)(cid:11)(cid:4)(cid:14)(cid:11)(cid:48)(cid:48)(cid:7)(cid:5)(cid:3)(cid:9)(cid:2)(cid:28)(cid:3,Unknown,5788.0
Unknown,Unknown,26,Unknown,Unknown,Unknown,Unknown,cid:50)(cid:5)(cid:14)(cid:7)(cid:12)(cid:5)(cid:9)(cid:2)(cid:16)(cid:16)(cid:2)(cid:12)(cid:11)(cid:4)(cid:14)(cid:11)(cid:48)(cid:48)(cid:7)(cid:5)(cid:3)(cid:9)(cid:2)(cid:28)(cid:3,Unknown,5814.0
Unknown,Unknown,41,Unknown,Unknown,Unknown,Unknown,cid:50)(cid:5)(cid:14)(cid:7)(cid:12)(cid:5)(cid:9)(cid:2)(cid:16)(cid:16)(cid:2)(cid:12)(cid:11)(cid:4)(cid:14)(cid:11)(cid:48)(cid:48)(cid:7)(cid:5)(cid:3)(cid:9)(cid:2)(cid:28)(cid:3,Unknown,5855.0
Unknown,Unknown,25,Unknown,Unknown,Unknown,Unknown,cid:50)(cid:5)(cid:14)(cid:7)(cid:12)(cid:5)(cid:9)(cid:2)(cid:16)(cid:16)(cid:2)(cid:12)(cid:11)(cid:4)(cid:14)(cid:11)(cid:48)(cid:48)(cid:7)(cid:5)(cid:3)(cid:9)(cid:2)(cid:28)(cid:3,Unknown,5880.0
Unknown,Unknown,2,Unknown,Unknown,Unknown,Unknown,cid:50)(cid:5)(cid:14)(cid:7)(cid:12)(cid:5)(cid:9)(cid:2)(cid:16)(cid:16)(cid:2)(cid:12)(cid:11)(cid:4)(cid:14)(cid:11)(cid:48)(cid:48)(cid:7)(cid:5)(cid:3)(cid:9)(cid:2)(cid:28)(cid:3,Unknown,5882.0
Unknown,Unknown,58,Unknown,Unknown,Unknown,Unknown,cid:50)(cid:5)(cid:14)(cid:7)(cid:12)(cid:5)(cid:9)(cid:2)(cid:16)(cid:16)(cid:2)(cid:12)(cid:11)(cid:4)(cid:14)(cid:11)(cid:48)(cid:48)(cid:7)(cid:5)(cid:3)(cid:9)(cid:2)(cid:28)(cid:3,Unknown,5940.0
Unknown,Unknown,58,Unknown,Unknown,Unknown,Unknown,cid:50)(cid:5)(cid:14)(cid:7)(cid:12)(cid:5)(cid:9)(cid:2)(cid:16)(cid:16)(cid:2)(cid:12)(cid:11)(cid:4)(cid:14)(cid:11)(cid:48)(cid:48)(cid:7)(cid:5)(cid:3)(cid:9)(cid:2)(cid:28)(cid:3,Unknown,5998.0
Unknown,Unknown,37,Unknown,Unknown,Unknown,Unknown,cid:50)(cid:5)(cid:14)(cid:7)(cid:12)(cid:5)(cid:9)(cid:2)(cid:16)(cid:16)(cid:2)(cid:12)(cid:11)(cid:4)(cid:14)(cid:11)(cid:48)(cid:48)(cid:7)(cid:5)(cid:3)(cid:9)(cid:2)(cid:28)(cid:3,Unknown,6035.0
Unknown,Unknown,16,Unknown,Unknown,Unknown,Unknown,cid:50)(cid:5)(cid:14)(cid:7)(cid:12)(cid:5)(cid:9)(cid:2)(cid:16)(cid:16)(cid:2)(cid:12)(cid:11)(cid:4)(cid:14)(cid:11)(cid:48)(cid:48)(cid:7)(cid:5)(cid:3)(cid:9)(cid:2)(cid:28)(cid:3,Unknown,6051.0
Unknown,Unknown,34,Unknown,Unknown,Unknown,Unknown,cid:50)(cid:5)(cid:14)(cid:7)(cid:12)(cid:5)(cid:9)(cid:2)(cid:16)(cid:16)(cid:2)(cid:12)(cid:11)(cid:4)(cid:14)(cid:11)(cid:48)(cid:48)(cid:7)(cid:5)(cid:3)(cid:9)(cid:2)(cid:28)(cid:3,Unknown,6085.0
Unknown,Unknown,33,Unknown,Unknown,Unknown,Unknown,cid:50)(cid:5)(cid:14)(cid:7)(cid:12)(cid:5)(cid:9)(cid:2)(cid:16)(cid:16)(cid:2)(cid:12)(cid:11)(cid:4)(cid:14)(cid:11)(cid:48)(cid:48)(cid:7)(cid:5)(cid:3)(cid:9)(cid:2)(cid:28)(cid:3,Unknown,6118.0
01/06/2021,Unknown,04,Unknown,Unknown,Unknown,Unknown,INTERMARCHE,MC DONALD'S COULOMMIER,4.0
30/06/2021,Unknown,06,Unknown,Unknown,Unknown,Unknown,INTERMARCHE,CAFE DE,10.0
Unknown,Unknown,"42,65",Unknown,Unknown,Unknown,Unknown,INTERMARCHE,FRANCE,4275.0
Unknown,Unknown,04,Unknown,Unknown,Unknown,Unknown,INTERMARCHE,ETABUISSEMENTS TONY,4279.0
Unknown,Unknown,06,Unknown,Unknown,Unknown,Unknown,INTERMARCHE,lahaye,4285.0
Unknown,Unknown,"48,80",Unknown,Unknown,Unknown,Unknown,INTERMARCHE,TEMPLIERS,9165.0
Unknown,Unknown,04,Unknown,Unknown,Unknown,Unknown,INTERMARCHE,SAGEB PKG,9169.0
Unknown,Unknown,06,Unknown,Unknown,Unknown,Unknown,INTERMARCHE,VEDE,9175.0
Unknown,Unknown,"9,76",Unknown,Unknown,Unknown,Unknown,INTERMARCHE,CAFE DE,10151.0
Unknown,Unknown,05,Unknown,Unknown,Unknown,Unknown,INTERMARCHE,Gaucher,10156.0
Unknown,Unknown,06,Unknown,Unknown,Unknown,Unknown,INTERMARCHE,EG BP SUBWAY BONDY,10162.0
Unknown,Unknown,"1,80",Unknown,Unknown,Unknown,Unknown,INTERMARCHE,bini,10342.0
Unknown,Unknown,05,Unknown,Unknown,Unknown,Unknown,INTERMARCHE,TEMPLIERS,10347.0
Unknown,Unknown,06,Unknown,Unknown,Unknown,Unknown,INTERMARCHE,CAFE DE,10353.0
Unknown,Unknown,"50,01",Unknown,Unknown,Unknown,Unknown,INTERMARCHE,ECU LA FERTE,15354.0
Unknown,Unknown,07,Unknown,Unknown,Unknown,Unknown,INTERMARCHE,EGB,15361.0
Unknown,Unknown,06,Unknown,Unknown,Unknown,Unknown,INTERMARCHE,Unknown,15367.0
Unknown,Unknown,302,Unknown,Unknown,Unknown,Unknown,INTERMARCHE,Unknown,15669.0
Unknown,Unknown,"58 902,21",Unknown,Unknown,Unknown,Unknown,INTERMARCHE,Unknown,5905890.0
Unknown,Unknown,07,Unknown,Unknown,Unknown,Unknown,INTERMARCHE,Unknown,5905897.0
Unknown,Unknown,06,Unknown,Unknown,Unknown,Unknown,INTERMARCHE,Unknown,5905903.0
Unknown,Unknown,"28 760,00",Unknown,Unknown,Unknown,Unknown,INTERMARCHE,Unknown,8781903.0
Unknown,Unknown,07,Unknown,Unknown,Unknown,Unknown,INTERMARCHE,Unknown,8781910.0
Unknown,Unknown,06,Unknown,Unknown,Unknown,Unknown,INTERMARCHE,Unknown,8781916.0
Unknown,Unknown,"20,30",Unknown,Unknown,Unknown,Unknown,INTERMARCHE,Unknown,8783946.0
Unknown,Unknown,07,Unknown,Unknown,Unknown,Unknown,INTERMARCHE,Unknown,8783953.0
Unknown,Unknown,06,Unknown,Unknown,Unknown,Unknown,INTERMARCHE,Unknown,8783959.0
Unknown,Unknown,"41,35",Unknown,Unknown,Unknown,Unknown,INTERMARCHE,Unknown,8788094.0
Unknown,Unknown,07,Unknown,Unknown,Unknown,Unknown,INTERMARCHE,Unknown,8788101.0
Unknown,Unknown,06,Unknown,Unknown,Unknown,Unknown,INTERMARCHE,Unknown,8788107.0
Unknown,Unknown,"38,50",Unknown,Unknown,Unknown,Unknown,INTERMARCHE,Unknown,8791957.0
Unknown,Unknown,07,Unknown,Unknown,Unknown,Unknown,INTERMARCHE,Unknown,8791964.0
Unknown,Unknown,06,Unknown,Unknown,Unknown,Unknown,INTERMARCHE,Unknown,8791970.0
Unknown,Unknown,"28,79",Unknown,Unknown,Unknown,Unknown,INTERMARCHE,Unknown,8794849.0
Unknown,Unknown,07,Unknown,Unknown,Unknown,Unknown,INTERMARCHE,Unknown,8794856.0
Unknown,Unknown,06,Unknown,Unknown,Unknown,Unknown,INTERMARCHE,Unknown,8794862.0
Unknown,Unknown,"2,00",Unknown,Unknown,Unknown,Unknown,INTERMARCHE,Unknown,8795062.0
Unknown,Unknown,07,Unknown,Unknown,Unknown,Unknown,INTERMARCHE,Unknown,8795069.0
Unknown,Unknown,06,Unknown,Unknown,Unknown,Unknown,INTERMARCHE,Unknown,8795075.0
Unknown,Unknown,"23,90",Unknown,Unknown,Unknown,Unknown,INTERMARCHE,Unknown,8797465.0
Unknown,Unknown,07,Unknown,Unknown,Unknown,Unknown,INTERMARCHE,Unknown,8797472.0
Unknown,Unknown,06,Unknown,Unknown,Unknown,Unknown,INTERMARCHE,Unknown,8797478.0
Unknown,Unknown,"12,10",Unknown,Unknown,Unknown,Unknown,INTERMARCHE,Unknown,8798688.0
Unknown,Unknown,08,Unknown,Unknown,Unknown,Unknown,INTERMARCHE,Unknown,8798696.0
Unknown,Unknown,06,Unknown,Unknown,Unknown,Unknown,INTERMARCHE,Unknown,8798702.0
Unknown,Unknown,"38,40",Unknown,Unknown,Unknown,Unknown,INTERMARCHE,Unknown,8802542.0
Unknown,Unknown,08,Unknown,Unknown,Unknown,Unknown,INTERMARCHE,Unknown,8802550.0
Unknown,Unknown,06,Unknown,Unknown,Unknown,Unknown,INTERMARCHE,Unknown,8802556.0
Unknown,Unknown,"8,77",Unknown,Unknown,Unknown,Unknown,INTERMARCHE,Unknown,8803433.0
Unknown,Unknown,08,Unknown,Unknown,Unknown,Unknown,INTERMARCHE,Unknown,8803441.0
Unknown,Unknown,06,Unknown,Unknown,Unknown,Unknown,INTERMARCHE,Unknown,8803447.0
Unknown,Unknown,"96,74",Unknown,Unknown,Unknown,Unknown,INTERMARCHE,Unknown,8813121.0
Unknown,Unknown,08,Unknown,Unknown,Unknown,Unknown,INTERMARCHE,Unknown,8813129.0
Unknown,Unknown,06,Unknown,Unknown,Unknown,Unknown,INTERMARCHE,Unknown,8813135.0
Unknown,Unknown,"11,20",Unknown,Unknown,Unknown,Unknown,INTERMARCHE,Unknown,8814255.0
Unknown,Unknown,08,Unknown,Unknown,Unknown,Unknown,INTERMARCHE,Unknown,8814263.0
Unknown,Unknown,06,Unknown,Unknown,Unknown,Unknown,INTERMARCHE,Unknown,8814269.0
Unknown,Unknown,"3,80",Unknown,Unknown,Unknown,Unknown,INTERMARCHE,Unknown,8814649.0
Unknown,Unknown,08,Unknown,Unknown,Unknown,Unknown,INTERMARCHE,Unknown,8814657.0
Unknown,Unknown,06,Unknown,Unknown,Unknown,Unknown,INTERMARCHE,Unknown,8814663.0
Unknown,Unknown,"60,28",Unknown,Unknown,Unknown,Unknown,INTERMARCHE,Unknown,8820691.0
Unknown,Unknown,09,Unknown,Unknown,Unknown,Unknown,INTERMARCHE,Unknown,8820700.0
Unknown,Unknown,06,Unknown,Unknown,Unknown,Unknown,INTERMARCHE,Unknown,8820706.0
Unknown,Unknown,"10 000,00",Unknown,Unknown,Unknown,Unknown,INTERMARCHE,Unknown,9820706.0
Unknown,Unknown,09,Unknown,Unknown,Unknown,Unknown,INTERMARCHE,Unknown,9820715.0
Unknown,Unknown,06,Unknown,Unknown,Unknown,Unknown,INTERMARCHE,Unknown,9820721.0
Unknown,Unknown,"13,20",Unknown,Unknown,Unknown,Unknown,INTERMARCHE,Unknown,9822041.0
Unknown,Unknown,09,Unknown,Unknown,Unknown,Unknown,INTERMARCHE,Unknown,9822050.0
Unknown,Unknown,06,Unknown,Unknown,Unknown,Unknown,INTERMARCHE,Unknown,9822056.0
Unknown,Unknown,"25,30",Unknown,Unknown,Unknown,Unknown,INTERMARCHE,Unknown,9824586.0
Unknown,Unknown,09,Unknown,Unknown,Unknown,Unknown,INTERMARCHE,Unknown,9824595.0
Unknown,Unknown,06,Unknown,Unknown,Unknown,Unknown,INTERMARCHE,Unknown,9824601.0
Unknown,Unknown,"25,05",Unknown,Unknown,Unknown,Unknown,INTERMARCHE,Unknown,9827106.0
Unknown,Unknown,09,Unknown,Unknown,Unknown,Unknown,INTERMARCHE,Unknown,9827115.0
Unknown,Unknown,06,Unknown,Unknown,Unknown,Unknown,INTERMARCHE,Unknown,9827121.0
Unknown,Unknown,"100,00",Unknown,Unknown,Unknown,Unknown,INTERMARCHE,Unknown,9837121.0
Unknown,Unknown,01,Unknown,Unknown,Unknown,Unknown,INTERMARCHE,Unknown,9837122.0
Unknown,Unknown,06,Unknown,Unknown,Unknown,Unknown,INTERMARCHE,Unknown,9837128.0
Unknown,Unknown,30,Unknown,Unknown,Unknown,Unknown,INTERMARCHE,Unknown,9837158.0
Unknown,Unknown,06,Unknown,Unknown,Unknown,Unknown,INTERMARCHE,Unknown,9837164.0
Unknown,Unknown,205,Unknown,Unknown,Unknown,Unknown,INTERMARCHE,Unknown,9837369.0
Unknown,Unknown,2,Unknown,Unknown,Unknown,Unknown,INTERMARCHE,Unknown,9837371.0
Unknown,Unknown,5,Unknown,Unknown,Unknown,Unknown,INTERMARCHE,Unknown,9837376.0
01/06/2021,Unknown,09,Unknown,Unknown,POS,Unknown,Coulommiers FR,SARL KPA MARKET COULOMMIERS FR,9.0
30/06/2021,Unknown,06,Unknown,Unknown,POS,Unknown,Coulommiers FR,P072205253,15.0
Unknown,Unknown,"31,73",Unknown,Unknown,POS,Unknown,Coulommiers FR,SANEF AUTOROUTE,3188.0
Unknown,Unknown,10,Unknown,Unknown,POS,Unknown,Coulommiers FR,LECLERC,3198.0
Unknown,Unknown,06,Unknown,Unknown,POS,Unknown,Coulommiers FR,COULOMMIERS FR,3204.0
Unknown,Unknown,"66,98",Unknown,Unknown,POS,Unknown,Coulommiers FR,COULOMMIERS FR,9902.0
Unknown,Unknown,10,Unknown,Unknown,POS,Unknown,Coulommiers FR,SARL KPA MARKET,9912.0
Unknown,Unknown,06,Unknown,Unknown,POS,Unknown,Coulommiers FR,CAFE DE,9918.0
Unknown,Unknown,15,Unknown,Unknown,POS,Unknown,Coulommiers FR,ECU LA FERTE,9933.0
Unknown,Unknown,00,Unknown,Unknown,POS,Unknown,Coulommiers FR,LECLERC,9933.0
Unknown,Unknown,11,Unknown,Unknown,POS,Unknown,Coulommiers FR,MR BRICOLAGE COULOMMIERS,9944.0
Unknown,Unknown,06,Unknown,Unknown,POS,Unknown,Coulommiers FR,LA POSTE 779240,9950.0
Unknown,Unknown,"111,35",Unknown,Unknown,POS,Unknown,Coulommiers FR,EGB,21085.0
Unknown,Unknown,11,Unknown,Unknown,POS,Unknown,Coulommiers FR,Unknown,21096.0
Unknown,Unknown,06,Unknown,Unknown,POS,Unknown,Coulommiers FR,Unknown,21102.0
Unknown,Unknown,"44,17",Unknown,Unknown,POS,Unknown,Coulommiers FR,Unknown,25519.0
Unknown,Unknown,11,Unknown,Unknown,POS,Unknown,Coulommiers FR,Unknown,25530.0
Unknown,Unknown,06,Unknown,Unknown,POS,Unknown,Coulommiers FR,Unknown,25536.0
Unknown,Unknown,"30,50",Unknown,Unknown,POS,Unknown,Coulommiers FR,Unknown,28586.0
Unknown,Unknown,11,Unknown,Unknown,POS,Unknown,Coulommiers FR,Unknown,28597.0
Unknown,Unknown,06,Unknown,Unknown,POS,Unknown,Coulommiers FR,Unknown,28603.0
Unknown,Unknown,"2,30",Unknown,Unknown,POS,Unknown,Coulommiers FR,Unknown,28833.0
Unknown,Unknown,12,Unknown,Unknown,POS,Unknown,Coulommiers FR,Unknown,28845.0
Unknown,Unknown,06,Unknown,Unknown,POS,Unknown,Coulommiers FR,Unknown,28851.0
Unknown,Unknown,"50,01",Unknown,Unknown,POS,Unknown,Coulommiers FR,Unknown,33852.0
Unknown,Unknown,12,Unknown,Unknown,POS,Unknown,Coulommiers FR,Unknown,33864.0
Unknown,Unknown,06,Unknown,Unknown,POS,Unknown,Coulommiers FR,Unknown,33870.0
Unknown,Unknown,"2,30",Unknown,Unknown,POS,Unknown,Coulommiers FR,Unknown,34100.0
Unknown,Unknown,12,Unknown,Unknown,POS,Unknown,Coulommiers FR,Unknown,34112.0
Unknown,Unknown,06,Unknown,Unknown,POS,Unknown,Coulommiers FR,Unknown,34118.0
Unknown,Unknown,"66,51",Unknown,Unknown,POS,Unknown,Coulommiers FR,Unknown,40769.0
Unknown,Unknown,12,Unknown,Unknown,POS,Unknown,Coulommiers FR,Unknown,40781.0
Unknown,Unknown,06,Unknown,Unknown,POS,Unknown,Coulommiers FR,Unknown,40787.0
Unknown,Unknown,"198,68",Unknown,Unknown,POS,Unknown,Coulommiers FR,Unknown,60655.0
Unknown,Unknown,12,Unknown,Unknown,POS,Unknown,Coulommiers FR,Unknown,60667.0
Unknown,Unknown,06,Unknown,Unknown,POS,Unknown,Coulommiers FR,Unknown,60673.0
Unknown,Unknown,"108,10",Unknown,Unknown,POS,Unknown,Coulommiers FR,Unknown,71483.0
Unknown,Unknown,12,Unknown,Unknown,POS,Unknown,Coulommiers FR,Unknown,71495.0
Unknown,Unknown,06,Unknown,Unknown,POS,Unknown,Coulommiers FR,Unknown,71501.0
Unknown,Unknown,"139,60",Unknown,Unknown,POS,Unknown,Coulommiers FR,Unknown,85461.0
Unknown,Unknown,12,Unknown,Unknown,POS,Unknown,Coulommiers FR,Unknown,85473.0
Unknown,Unknown,06,Unknown,Unknown,POS,Unknown,Coulommiers FR,Unknown,85479.0
Unknown,Unknown,"69,31",Unknown,Unknown,POS,Unknown,Coulommiers FR,Unknown,92410.0
Unknown,Unknown,12,Unknown,Unknown,POS,Unknown,Coulommiers FR,Unknown,92422.0
Unknown,Unknown,06,Unknown,Unknown,POS,Unknown,Coulommiers FR,Unknown,92428.0
Unknown,Unknown,"28,10",Unknown,Unknown,POS,Unknown,Coulommiers FR,Unknown,95238.0
Unknown,Unknown,12,Unknown,Unknown,POS,Unknown,Coulommiers FR,Unknown,95250.0
Unknown,Unknown,06,Unknown,Unknown,POS,Unknown,Coulommiers FR,Unknown,95256.0
Unknown,Unknown,"199,00",Unknown,Unknown,POS,Unknown,Coulommiers FR,Unknown,115156.0
Unknown,Unknown,13,Unknown,Unknown,POS,Unknown,Coulommiers FR,Unknown,115169.0
Unknown,Unknown,06,Unknown,Unknown,POS,Unknown,Coulommiers FR,Unknown,115175.0
Unknown,Unknown,"84,10",Unknown,Unknown,POS,Unknown,Coulommiers FR,Unknown,123585.0
Unknown,Unknown,13,Unknown,Unknown,POS,Unknown,Coulommiers FR,Unknown,123598.0
Unknown,Unknown,06,Unknown,Unknown,POS,Unknown,Coulommiers FR,Unknown,123604.0
Unknown,Unknown,"86,85",Unknown,Unknown,POS,Unknown,Coulommiers FR,Unknown,132289.0
Unknown,Unknown,14,Unknown,Unknown,POS,Unknown,Coulommiers FR,Unknown,132303.0
Unknown,Unknown,06,Unknown,Unknown,POS,Unknown,Coulommiers FR,Unknown,132309.0
Unknown,Unknown,"21,00",Unknown,Unknown,POS,Unknown,Coulommiers FR,Unknown,134409.0
Unknown,Unknown,14,Unknown,Unknown,POS,Unknown,Coulommiers FR,Unknown,134423.0
Unknown,Unknown,06,Unknown,Unknown,POS,Unknown,Coulommiers FR,Unknown,134429.0
Unknown,Unknown,"82,50",Unknown,Unknown,POS,Unknown,Coulommiers FR,Unknown,142679.0
Unknown,Unknown,14,Unknown,Unknown,POS,Unknown,Coulommiers FR,Unknown,142693.0
Unknown,Unknown,06,Unknown,Unknown,POS,Unknown,Coulommiers FR,Unknown,142699.0
Unknown,Unknown,"50,00",Unknown,Unknown,POS,Unknown,Coulommiers FR,Unknown,147699.0
Unknown,Unknown,15,Unknown,Unknown,POS,Unknown,Coulommiers FR,Unknown,147714.0
Unknown,Unknown,06,Unknown,Unknown,POS,Unknown,Coulommiers FR,Unknown,147720.0
Unknown,Unknown,"136,60",Unknown,Unknown,POS,Unknown,Coulommiers FR,Unknown,161380.0
Unknown,Unknown,15,Unknown,Unknown,POS,Unknown,Coulommiers FR,Unknown,161395.0
Unknown,Unknown,06,Unknown,Unknown,POS,Unknown,Coulommiers FR,Unknown,161401.0
Unknown,Unknown,"425,00",Unknown,Unknown,POS,Unknown,Coulommiers FR,Unknown,203901.0
Unknown,Unknown,15,Unknown,Unknown,POS,Unknown,Coulommiers FR,Unknown,203916.0
Unknown,Unknown,06,Unknown,Unknown,POS,Unknown,Coulommiers FR,Unknown,203922.0
Unknown,Unknown,"5,55",Unknown,Unknown,POS,Unknown,Coulommiers FR,Unknown,204477.0
Unknown,Unknown,01,Unknown,Unknown,POS,Unknown,Coulommiers FR,Unknown,204478.0
Unknown,Unknown,06,Unknown,Unknown,POS,Unknown,Coulommiers FR,Unknown,204484.0
Unknown,Unknown,30,Unknown,Unknown,POS,Unknown,Coulommiers FR,Unknown,204514.0
Unknown,Unknown,06,Unknown,Unknown,POS,Unknown,Coulommiers FR,Unknown,204520.0
Unknown,Unknown,205,Unknown,Unknown,POS,Unknown,Coulommiers FR,Unknown,204725.0
Unknown,Unknown,3,Unknown,Unknown,POS,Unknown,Coulommiers FR,Unknown,204728.0
Unknown,Unknown,5,Unknown,Unknown,POS,Unknown,Coulommiers FR,Unknown,204733.0
Unknown,Unknown,1,Unknown,Unknown,Unknown,Unknown,Banque Inconnue,cid:22)(cid:23)(cid:24,1.0
Unknown,Unknown,2,Unknown,Unknown,Unknown,Unknown,Banque Inconnue,cid:25)(cid:24)(cid:26)(cid:27)(cid:28)(cid:2)(cid:28)(cid:3)(cid:16)(cid:32)(cid:2)(cid:17)(cid:32)(cid:33)(cid:34)(cid:2)(cid:35)(cid:18)(cid:18)(cid:18)(cid:2)(cid:18)(cid:17)(cid:33)(cid:35)(cid:2)(cid:17)(cid:1)(cid:36)(cid:37)(cid:2)(cid:33)(cid:35)(cid:33)(cid:1)(cid:2)(cid:1)(cid:18)(cid:34,3.0
Unknown,Unknown,3,Unknown,Unknown,Unknown,Unknown,Banque Inconnue,cid:24)(cid:25)(cid:29)(cid:28)(cid:2)(cid:38)(cid:8)(cid:10)(cid:11)(cid:28)(cid:3)(cid:39)(cid:17)(cid:40)(cid:40)(cid:40,6.0
Unknown,Unknown,2,Unknown,Unknown,Unknown,Unknown,Banque Inconnue,Unknown,8.0
Unknown,Unknown,4,Unknown,Unknown,Unknown,Unknown,Banque Inconnue,Unknown,12.0
Unknown,Unknown,5,Unknown,Unknown,Unknown,Unknown,Banque Inconnue,Unknown,17.0
Unknown,Unknown,6,Unknown,Unknown,Unknown,Unknown,Banque Inconnue,Unknown,23.0
Unknown,Unknown,7,Unknown,Unknown,Unknown,Unknown,Banque Inconnue,Unknown,30.0
Unknown,Unknown,8,Unknown,Unknown,Unknown,Unknown,Banque Inconnue,Unknown,38.0
Unknown,Unknown,9,Unknown,Unknown,Unknown,Unknown,Banque Inconnue,Unknown,47.0
Unknown,Unknown,10,Unknown,Unknown,Unknown,Unknown,Banque Inconnue,Unknown,57.0
Unknown,Unknown,11,Unknown,Unknown,Unknown,Unknown,Banque Inconnue,Unknown,68.0
Unknown,Unknown,9,Unknown,Unknown,Unknown,Unknown,Banque Inconnue,Unknown,77.0
Unknown,Unknown,12,Unknown,Unknown,Unknown,Unknown,Banque Inconnue,Unknown,89.0
Unknown,Unknown,13,Unknown,Unknown,Unknown,Unknown,Banque Inconnue,Unknown,102.0
Unknown,Unknown,2,Unknown,Unknown,Unknown,Unknown,Banque Inconnue,Unknown,104.0
Unknown,Unknown,6,Unknown,Unknown,Unknown,Unknown,Banque Inconnue,Unknown,110.0
Unknown,Unknown,14,Unknown,Unknown,Unknown,Unknown,Banque Inconnue,Unknown,124.0
Unknown,Unknown,15,Unknown,Unknown,Unknown,Unknown,Banque Inconnue,Unknown,139.0
Unknown,Unknown,7,Unknown,Unknown,Unknown,Unknown,Banque Inconnue,Unknown,146.0
Unknown,Unknown,16,Unknown,Unknown,Unknown,Unknown,Banque Inconnue,Unknown,162.0
Unknown,Unknown,17,Unknown,Unknown,Unknown,Unknown,Banque Inconnue,Unknown,179.0
Unknown,Unknown,18,Unknown,Unknown,Unknown,Unknown,Banque Inconnue,Unknown,197.0
Unknown,Unknown,16,Unknown,Unknown,Unknown,Unknown,Banque Inconnue,Unknown,213.0
Unknown,Unknown,19,Unknown,Unknown,Unknown,Unknown,Banque Inconnue,Unknown,232.0
Unknown,Unknown,18,Unknown,Unknown,Unknown,Unknown,Banque Inconnue,Unknown,250.0
Unknown,Unknown,20,Unknown,Unknown,Unknown,Unknown,Banque Inconnue,Unknown,270.0
Unknown,Unknown,16,Unknown,Unknown,Unknown,Unknown,Banque Inconnue,Unknown,286.0
Unknown,Unknown,20,Unknown,Unknown,Unknown,Unknown,Banque Inconnue,Unknown,306.0
Unknown,Unknown,17,Unknown,Unknown,Unknown,Unknown,Banque Inconnue,Unknown,323.0
Unknown,Unknown,7,Unknown,Unknown,Unknown,Unknown,Banque Inconnue,Unknown,330.0
Unknown,Unknown,9,Unknown,Unknown,Unknown,Unknown,Banque Inconnue,Unknown,339.0
Unknown,Unknown,15,Unknown,Unknown,Unknown,Unknown,Banque Inconnue,Unknown,354.0
Unknown,Unknown,7,Unknown,Unknown,Unknown,Unknown,Banque Inconnue,Unknown,361.0
Unknown,Unknown,21,Unknown,Unknown,Unknown,Unknown,Banque Inconnue,Unknown,382.0
Unknown,Unknown,17,Unknown,Unknown,Unknown,Unknown,Banque Inconnue,Unknown,399.0
Unknown,Unknown,18,Unknown,Unknown,Unknown,Unknown,Banque Inconnue,Unknown,417.0
Unknown,Unknown,16,Unknown,Unknown,Unknown,Unknown,Banque Inconnue,Unknown,433.0
Unknown,Unknown,19,Unknown,Unknown,Unknown,Unknown,Banque Inconnue,Unknown,452.0
Unknown,Unknown,18,Unknown,Unknown,Unknown,Unknown,Banque Inconnue,Unknown,470.0
Unknown,Unknown,20,Unknown,Unknown,Unknown,Unknown,Banque Inconnue,Unknown,490.0
Unknown,Unknown,16,Unknown,Unknown,Unknown,Unknown,Banque Inconnue,Unknown,506.0
Unknown,Unknown,20,Unknown,Unknown,Unknown,Unknown,Banque Inconnue,Unknown,526.0
Unknown,Unknown,17,Unknown,Unknown,Unknown,Unknown,Banque Inconnue,Unknown,543.0
Unknown,Unknown,22,Unknown,Unknown,Unknown,Unknown,Banque Inconnue,Unknown,565.0
Unknown,Unknown,23,Unknown,Unknown,Unknown,Unknown,Banque Inconnue,Unknown,588.0
Unknown,Unknown,24,Unknown,Unknown,Unknown,Unknown,Banque Inconnue,Unknown,612.0
Unknown,Unknown,30,Unknown,Unknown,Unknown,Unknown,Banque Inconnue,Unknown,642.0
Unknown,Unknown,31,Unknown,Unknown,Unknown,Unknown,Banque Inconnue,Unknown,673.0
Unknown,Unknown,3,Unknown,Unknown,Unknown,Unknown,Banque Inconnue,Unknown,676.0
Unknown,Unknown,32,Unknown,Unknown,Unknown,Unknown,Banque Inconnue,Unknown,708.0
Unknown,Unknown,2,Unknown,Unknown,Unknown,Unknown,Banque Inconnue,Unknown,710.0
Unknown,Unknown,7,Unknown,Unknown,Unknown,Unknown,Banque Inconnue,Unknown,717.0
Unknown,Unknown,9,Unknown,Unknown,Unknown,Unknown,Banque Inconnue,Unknown,726.0
Unknown,Unknown,15,Unknown,Unknown,Unknown,Unknown,Banque Inconnue,Unknown,741.0
Unknown,Unknown,7,Unknown,Unknown,Unknown,Unknown,Banque Inconnue,Unknown,748.0
Unknown,Unknown,16,Unknown,Unknown,Unknown,Unknown,Banque Inconnue,Unknown,764.0
Unknown,Unknown,17,Unknown,Unknown,Unknown,Unknown,Banque Inconnue,Unknown,781.0
Unknown,Unknown,18,Unknown,Unknown,Unknown,Unknown,Banque Inconnue,Unknown,799.0
Unknown,Unknown,16,Unknown,Unknown,Unknown,Unknown,Banque Inconnue,Unknown,815.0
Unknown,Unknown,19,Unknown,Unknown,Unknown,Unknown,Banque Inconnue,Unknown,834.0
Unknown,Unknown,33,Unknown,Unknown,Unknown,Unknown,Banque Inconnue,Unknown,867.0
Unknown,Unknown,7,Unknown,Unknown,Unknown,Unknown,Banque Inconnue,Unknown,874.0
Unknown,Unknown,20,Unknown,Unknown,Unknown,Unknown,Banque Inconnue,Unknown,894.0
Unknown,Unknown,19,Unknown,Unknown,Unknown,Unknown,Banque Inconnue,Unknown,913.0
Unknown,Unknown,34,Unknown,Unknown,Unknown,Unknown,Banque Inconnue,Unknown,947.0
Unknown,Unknown,35,Unknown,Unknown,Unknown,Unknown,Banque Inconnue,Unknown,982.0
Unknown,Unknown,19,Unknown,Unknown,Unknown,Unknown,Banque Inconnue,Unknown,1001.0
Unknown,Unknown,7,Unknown,Unknown,Unknown,Unknown,Banque Inconnue,Unknown,1008.0
Unknown,Unknown,36,Unknown,Unknown,Unknown,Unknown,Banque Inconnue,Unknown,1044.0
Unknown,Unknown,1,Unknown,Unknown,Unknown,Unknown,Banque Inconnue,Unknown,1045.0
Unknown,Unknown,2,Unknown,Unknown,Unknown,Unknown,Banque Inconnue,Unknown,1047.0
Unknown,Unknown,3,Unknown,Unknown,Unknown,Unknown,Banque Inconnue,Unknown,1050.0
Unknown,Unknown,4,Unknown,Unknown,Unknown,Unknown,Banque Inconnue,Unknown,1054.0
Unknown,Unknown,5,Unknown,Unknown,Unknown,Unknown,Banque Inconnue,Unknown,1059.0
Unknown,Unknown,2,Unknown,Unknown,Unknown,Unknown,Banque Inconnue,Unknown,1061.0
Unknown,Unknown,6,Unknown,Unknown,Unknown,Unknown,Banque Inconnue,Unknown,1067.0
Unknown,Unknown,7,Unknown,Unknown,Unknown,Unknown,Banque Inconnue,Unknown,1074.0
Unknown,Unknown,8,Unknown,Unknown,Unknown,Unknown,Banque Inconnue,Unknown,1082.0
Unknown,Unknown,9,Unknown,Unknown,Unknown,Unknown,Banque Inconnue,Unknown,1091.0
Unknown,Unknown,10,Unknown,Unknown,Unknown,Unknown,Banque Inconnue,Unknown,1101.0
Unknown,Unknown,11,Unknown,Unknown,Unknown,Unknown,Banque Inconnue,Unknown,1112.0
Unknown,Unknown,8,Unknown,Unknown,Unknown,Unknown,Banque Inconnue,Unknown,1120.0
Unknown,Unknown,2,Unknown,Unknown,Unknown,Unknown,Banque Inconnue,Unknown,1122.0
Unknown,Unknown,12,Unknown,Unknown,Unknown,Unknown,Banque Inconnue,Unknown,1134.0
Unknown,Unknown,13,Unknown,Unknown,Unknown,Unknown,Banque Inconnue,Unknown,1147.0
Unknown,Unknown,4,Unknown,Unknown,Unknown,Unknown,Banque Inconnue,Unknown,1151.0
Unknown,Unknown,3,Unknown,Unknown,Unknown,Unknown,Banque Inconnue,Unknown,1154.0
Unknown,Unknown,12,Unknown,Unknown,Unknown,Unknown,Banque Inconnue,Unknown,1166.0
Unknown,Unknown,13,Unknown,Unknown,Unknown,Unknown,Banque Inconnue,Unknown,1179.0
Unknown,Unknown,7,Unknown,Unknown,Unknown,Unknown,Banque Inconnue,Unknown,1186.0
Unknown,Unknown,14,Unknown,Unknown,Unknown,Unknown,Banque Inconnue,Unknown,1200.0
Unknown,Unknown,14,Unknown,Unknown,Unknown,Unknown,Banque Inconnue,Unknown,1214.0
Unknown,Unknown,2,Unknown,Unknown,Unknown,Unknown,Banque Inconnue,Unknown,1216.0
Unknown,Unknown,15,Unknown,Unknown,Unknown,Unknown,Banque Inconnue,Unknown,1231.0
Unknown,Unknown,2,Unknown,Unknown,Unknown,Unknown,Banque Inconnue,Unknown,1233.0
Unknown,Unknown,5,Unknown,Unknown,Unknown,Unknown,Banque Inconnue,Unknown,1238.0
Unknown,Unknown,30,Unknown,Unknown,Unknown,Unknown,Banque Inconnue,Unknown,1268.0
Unknown,Unknown,41,Unknown,Unknown,Unknown,Unknown,Banque Inconnue,Unknown,1309.0
Unknown,Unknown,26,Unknown,Unknown,Unknown,Unknown,Banque Inconnue,Unknown,1335.0
Unknown,Unknown,42,Unknown,Unknown,Unknown,Unknown,Banque Inconnue,Unknown,1377.0
Unknown,Unknown,25,Unknown,Unknown,Unknown,Unknown,Banque Inconnue,Unknown,1402.0
Unknown,Unknown,27,Unknown,Unknown,Unknown,Unknown,Banque Inconnue,Unknown,1429.0
Unknown,Unknown,43,Unknown,Unknown,Unknown,Unknown,Banque Inconnue,Unknown,1472.0
Unknown,Unknown,2,Unknown,Unknown,Unknown,Unknown,Banque Inconnue,Unknown,1474.0
Unknown,Unknown,1,Unknown,Unknown,Unknown,Unknown,Banque Inconnue,Unknown,1475.0
Unknown,Unknown,34,Unknown,Unknown,Unknown,Unknown,Banque Inconnue,Unknown,1509.0
Unknown,Unknown,2,Unknown,Unknown,Unknown,Unknown,Banque Inconnue,Unknown,1511.0
Unknown,Unknown,1,Unknown,Unknown,Unknown,Unknown,Banque Inconnue,Unknown,1512.0
Unknown,Unknown,33,Unknown,Unknown,Unknown,Unknown,Banque Inconnue,Unknown,1545.0
Unknown,Unknown,34,Unknown,Unknown,Unknown,Unknown,Banque Inconnue,Unknown,1579.0
Unknown,Unknown,19,Unknown,Unknown,Unknown,Unknown,Banque Inconnue,Unknown,1598.0
Unknown,Unknown,18,Unknown,Unknown,Unknown,Unknown,Banque Inconnue,Unknown,1616.0
Unknown,Unknown,18,Unknown,Unknown,Unknown,Unknown,Banque Inconnue,Unknown,1634.0
Unknown,Unknown,2,Unknown,Unknown,Unknown,Unknown,Banque Inconnue,Unknown,1636.0
Unknown,Unknown,44,Unknown,Unknown,Unknown,Unknown,Banque Inconnue,Unknown,1680.0
Unknown,Unknown,16,Unknown,Unknown,Unknown,Unknown,Banque Inconnue,Unknown,1696.0
Unknown,Unknown,16,Unknown,Unknown,Unknown,Unknown,Banque Inconnue,Unknown,1712.0
Unknown,Unknown,17,Unknown,Unknown,Unknown,Unknown,Banque Inconnue,Unknown,1729.0
Unknown,Unknown,1,Unknown,Unknown,Unknown,Unknown,Banque Inconnue,Unknown,1730.0
Unknown,Unknown,18,Unknown,Unknown,Unknown,Unknown,Banque Inconnue,Unknown,1748.0
Unknown,Unknown,19,Unknown,Unknown,Unknown,Unknown,Banque Inconnue,Unknown,1767.0
Unknown,Unknown,2,Unknown,Unknown,Unknown,Unknown,Banque Inconnue,Unknown,1769.0
Unknown,Unknown,12,Unknown,Unknown,Unknown,Unknown,Banque Inconnue,Unknown,1781.0
Unknown,Unknown,20,Unknown,Unknown,Unknown,Unknown,Banque Inconnue,Unknown,1801.0
Unknown,Unknown,21,Unknown,Unknown,Unknown,Unknown,Banque Inconnue,Unknown,1822.0
Unknown,Unknown,22,Unknown,Unknown,Unknown,Unknown,Banque Inconnue,Unknown,1844.0
Unknown,Unknown,20,Unknown,Unknown,Unknown,Unknown,Banque Inconnue,Unknown,1864.0
Unknown,Unknown,23,Unknown,Unknown,Unknown,Unknown,Banque Inconnue,Unknown,1887.0
Unknown,Unknown,23,Unknown,Unknown,Unknown,Unknown,Banque Inconnue,Unknown,1910.0
Unknown,Unknown,24,Unknown,Unknown,Unknown,Unknown,Banque Inconnue,Unknown,1934.0
Unknown,Unknown,25,Unknown,Unknown,Unknown,Unknown,Banque Inconnue,Unknown,1959.0
Unknown,Unknown,26,Unknown,Unknown,Unknown,Unknown,Banque Inconnue,Unknown,1985.0
Unknown,Unknown,27,Unknown,Unknown,Unknown,Unknown,Banque Inconnue,Unknown,2012.0
Unknown,Unknown,19,Unknown,Unknown,Unknown,Unknown,Banque Inconnue,Unknown,2031.0
Unknown,Unknown,2,Unknown,Unknown,Unknown,Unknown,Banque Inconnue,Unknown,2033.0
Unknown,Unknown,28,Unknown,Unknown,Unknown,Unknown,Banque Inconnue,Unknown,2061.0
Unknown,Unknown,26,Unknown,Unknown,Unknown,Unknown,Banque Inconnue,Unknown,2087.0
Unknown,Unknown,29,Unknown,Unknown,Unknown,Unknown,Banque Inconnue,Unknown,2116.0
Unknown,Unknown,30,Unknown,Unknown,Unknown,Unknown,Banque Inconnue,Unknown,2146.0
Unknown,Unknown,31,Unknown,Unknown,Unknown,Unknown,Banque Inconnue,Unknown,2177.0
Unknown,Unknown,25,Unknown,Unknown,Unknown,Unknown,Banque Inconnue,Unknown,2202.0
Unknown,Unknown,9,Unknown,Unknown,Unknown,Unknown,Banque Inconnue,Unknown,2211.0
Unknown,Unknown,20,Unknown,Unknown,Unknown,Unknown,Banque Inconnue,Unknown,2231.0
Unknown,Unknown,26,Unknown,Unknown,Unknown,Unknown,Banque Inconnue,Unknown,2257.0
Unknown,Unknown,41,Unknown,Unknown,Unknown,Unknown,Banque Inconnue,Unknown,2298.0
Unknown,Unknown,24,Unknown,Unknown,Unknown,Unknown,Banque Inconnue,Unknown,2322.0
Unknown,Unknown,25,Unknown,Unknown,Unknown,Unknown,Banque Inconnue,Unknown,2347.0
Unknown,Unknown,27,Unknown,Unknown,Unknown,Unknown,Banque Inconnue,Unknown,2374.0
Unknown,Unknown,15,Unknown,Unknown,Unknown,Unknown,Banque Inconnue,Unknown,2389.0
Unknown,Unknown,2,Unknown,Unknown,Unknown,Unknown,Banque Inconnue,Unknown,2391.0
Unknown,Unknown,1,Unknown,Unknown,Unknown,Unknown,Banque Inconnue,Unknown,2392.0
Unknown,Unknown,37,Unknown,Unknown,Unknown,Unknown,Banque Inconnue,Unknown,2429.0
Unknown,Unknown,2,Unknown,Unknown,Unknown,Unknown,Banque Inconnue,Unknown,2431.0
Unknown,Unknown,1,Unknown,Unknown,Unknown,Unknown,Banque Inconnue,Unknown,2432.0
Unknown,Unknown,34,Unknown,Unknown,Unknown,Unknown,Banque Inconnue,Unknown,2466.0
Unknown,Unknown,33,Unknown,Unknown,Unknown,Unknown,Banque Inconnue,Unknown,2499.0
Unknown,Unknown,19,Unknown,Unknown,Unknown,Unknown,Banque Inconnue,Unknown,2518.0
Unknown,Unknown,35,Unknown,Unknown,Unknown,Unknown,Banque Inconnue,Unknown,2553.0
Unknown,Unknown,1,Unknown,Unknown,Unknown,Unknown,Banque Inconnue,Unknown,2554.0
Unknown,Unknown,2,Unknown,Unknown,Unknown,Unknown,Banque Inconnue,Unknown,2556.0
Unknown,Unknown,44,Unknown,Unknown,Unknown,Unknown,Banque Inconnue,Unknown,2600.0
Unknown,Unknown,25,Unknown,Unknown,Unknown,Unknown,Banque Inconnue,Unknown,2625.0
Unknown,Unknown,24,Unknown,Unknown,Unknown,Unknown,Banque Inconnue,Unknown,2649.0
Unknown,Unknown,26,Unknown,Unknown,Unknown,Unknown,Banque Inconnue,Unknown,2675.0
Unknown,Unknown,27,Unknown,Unknown,Unknown,Unknown,Banque Inconnue,Unknown,2702.0
Unknown,Unknown,28,Unknown,Unknown,Unknown,Unknown,Banque Inconnue,Unknown,2730.0
Unknown,Unknown,2,Unknown,Unknown,Unknown,Unknown,Banque Inconnue,Unknown,2732.0
Unknown,Unknown,28,Unknown,Unknown,Unknown,Unknown,Banque Inconnue,Unknown,2760.0
Unknown,Unknown,3,Unknown,Unknown,Unknown,Unknown,Banque Inconnue,Unknown,2763.0
Unknown,Unknown,16,Unknown,Unknown,Unknown,Unknown,Banque Inconnue,Unknown,2779.0
Unknown,Unknown,32,Unknown,Unknown,Unknown,Unknown,Banque Inconnue,Unknown,2811.0
Unknown,Unknown,2,Unknown,Unknown,Unknown,Unknown,Banque Inconnue,Unknown,2813.0
Unknown,Unknown,17,Unknown,Unknown,Unknown,Unknown,Banque Inconnue,Unknown,2830.0
Unknown,Unknown,32,Unknown,Unknown,Unknown,Unknown,Banque Inconnue,Unknown,2862.0
Unknown,Unknown,33,Unknown,Unknown,Unknown,Unknown,Banque Inconnue,Unknown,2895.0
Unknown,Unknown,34,Unknown,Unknown,Unknown,Unknown,Banque Inconnue,Unknown,2929.0
Unknown,Unknown,2,Unknown,Unknown,Unknown,Unknown,Banque Inconnue,Unknown,2931.0
Unknown,Unknown,35,Unknown,Unknown,Unknown,Unknown,Banque Inconnue,Unknown,2966.0
Unknown,Unknown,18,Unknown,Unknown,Unknown,Unknown,Banque Inconnue,Unknown,2984.0
Unknown,Unknown,18,Unknown,Unknown,Unknown,Unknown,Banque Inconnue,Unknown,3002.0
Unknown,Unknown,18,Unknown,Unknown,Unknown,Unknown,Banque Inconnue,Unknown,3020.0
Unknown,Unknown,2,Unknown,Unknown,Unknown,Unknown,Banque Inconnue,Unknown,3022.0
Unknown,Unknown,18,Unknown,Unknown,Unknown,Unknown,Banque Inconnue,Unknown,3040.0
Unknown,Unknown,17,Unknown,Unknown,Unknown,Unknown,Banque Inconnue,Unknown,3057.0
Unknown,Unknown,33,Unknown,Unknown,Unknown,Unknown,Banque Inconnue,Unknown,3090.0
Unknown,Unknown,35,Unknown,Unknown,Unknown,Unknown,Banque Inconnue,Unknown,3125.0
Unknown,Unknown,2,Unknown,Unknown,Unknown,Unknown,Banque Inconnue,Unknown,3127.0
Unknown,Unknown,17,Unknown,Unknown,Unknown,Unknown,Banque Inconnue,Unknown,3144.0
Unknown,Unknown,1,Unknown,Unknown,Unknown,Unknown,Banque Inconnue,Unknown,3145.0
Unknown,Unknown,36,Unknown,Unknown,Unknown,Unknown,Banque Inconnue,Unknown,3181.0
Unknown,Unknown,37,Unknown,Unknown,Unknown,Unknown,Banque Inconnue,Unknown,3218.0
Unknown,Unknown,2,Unknown,Unknown,Unknown,Unknown,Banque Inconnue,Unknown,3220.0
Unknown,Unknown,33,Unknown,Unknown,Unknown,Unknown,Banque Inconnue,Unknown,3253.0
Unknown,Unknown,35,Unknown,Unknown,Unknown,Unknown,Banque Inconnue,Unknown,3288.0
Unknown,Unknown,33,Unknown,Unknown,Unknown,Unknown,Banque Inconnue,Unknown,3321.0
Unknown,Unknown,1,Unknown,Unknown,Unknown,Unknown,Banque Inconnue,Unknown,3322.0
Unknown,Unknown,2,Unknown,Unknown,Unknown,Unknown,Banque Inconnue,Unknown,3324.0
Unknown,Unknown,1,Unknown,Unknown,Unknown,Unknown,Banque Inconnue,Unknown,3325.0
Unknown,Unknown,18,Unknown,Unknown,Unknown,Unknown,Banque Inconnue,Unknown,3343.0
Unknown,Unknown,34,Unknown,Unknown,Unknown,Unknown,Banque Inconnue,Unknown,3377.0
Unknown,Unknown,24,Unknown,Unknown,Unknown,Unknown,Banque Inconnue,Unknown,3401.0
Unknown,Unknown,25,Unknown,Unknown,Unknown,Unknown,Banque Inconnue,Unknown,3426.0
Unknown,Unknown,29,Unknown,Unknown,Unknown,Unknown,Banque Inconnue,Unknown,3455.0
Unknown,Unknown,28,Unknown,Unknown,Unknown,Unknown,Banque Inconnue,Unknown,3483.0
Unknown,Unknown,2,Unknown,Unknown,Unknown,Unknown,Banque Inconnue,Unknown,3485.0
Unknown,Unknown,38,Unknown,Unknown,Unknown,Unknown,Banque Inconnue,Unknown,3523.0
Unknown,Unknown,8,Unknown,Unknown,Unknown,Unknown,Banque Inconnue,Unknown,3531.0
Unknown,Unknown,10,Unknown,Unknown,Unknown,Unknown,Banque Inconnue,Unknown,3541.0
Unknown,Unknown,11,Unknown,Unknown,Unknown,Unknown,Banque Inconnue,Unknown,3552.0
Unknown,Unknown,28,Unknown,Unknown,Unknown,Unknown,Banque Inconnue,Unknown,3580.0
Unknown,Unknown,3,Unknown,Unknown,Unknown,Unknown,Banque Inconnue,Unknown,3583.0
Unknown,Unknown,39,Unknown,Unknown,Unknown,Unknown,Banque Inconnue,Unknown,3622.0
Unknown,Unknown,17,Unknown,Unknown,Unknown,Unknown,Banque Inconnue,Unknown,3639.0
Unknown,Unknown,40,Unknown,Unknown,Unknown,Unknown,Banque Inconnue,Unknown,3679.0
Unknown,Unknown,40,Unknown,Unknown,Unknown,Unknown,Banque Inconnue,Unknown,3719.0
Unknown,Unknown,40,Unknown,Unknown,Unknown,Unknown,Banque Inconnue,Unknown,3759.0
Unknown,Unknown,30,Unknown,Unknown,Unknown,Unknown,Banque Inconnue,Unknown,3789.0
Unknown,Unknown,31,Unknown,Unknown,Unknown,Unknown,Banque Inconnue,Unknown,3820.0
Unknown,Unknown,3,Unknown,Unknown,Unknown,Unknown,Banque Inconnue,Unknown,3823.0
Unknown,Unknown,32,Unknown,Unknown,Unknown,Unknown,Banque Inconnue,Unknown,3855.0
Unknown,Unknown,2,Unknown,Unknown,Unknown,Unknown,Banque Inconnue,Unknown,3857.0
Unknown,Unknown,7,Unknown,Unknown,Unknown,Unknown,Banque Inconnue,Unknown,3864.0
Unknown,Unknown,9,Unknown,Unknown,Unknown,Unknown,Banque Inconnue,Unknown,3873.0
Unknown,Unknown,15,Unknown,Unknown,Unknown,Unknown,Banque Inconnue,Unknown,3888.0
Unknown,Unknown,7,Unknown,Unknown,Unknown,Unknown,Banque Inconnue,Unknown,3895.0
Unknown,Unknown,21,Unknown,Unknown,Unknown,Unknown,Banque Inconnue,Unknown,3916.0
Unknown,Unknown,17,Unknown,Unknown,Unknown,Unknown,Banque Inconnue,Unknown,3933.0
Unknown,Unknown,18,Unknown,Unknown,Unknown,Unknown,Banque Inconnue,Unknown,3951.0
Unknown,Unknown,16,Unknown,Unknown,Unknown,Unknown,Banque Inconnue,Unknown,3967.0
Unknown,Unknown,19,Unknown,Unknown,Unknown,Unknown,Banque Inconnue,Unknown,3986.0
Unknown,Unknown,33,Unknown,Unknown,Unknown,Unknown,Banque Inconnue,Unknown,4019.0
Unknown,Unknown,7,Unknown,Unknown,Unknown,Unknown,Banque Inconnue,Unknown,4026.0
Unknown,Unknown,20,Unknown,Unknown,Unknown,Unknown,Banque Inconnue,Unknown,4046.0
Unknown,Unknown,7,Unknown,Unknown,Unknown,Unknown,Banque Inconnue,Unknown,4053.0
Unknown,Unknown,16,Unknown,Unknown,Unknown,Unknown,Banque Inconnue,Unknown,4069.0
Unknown,Unknown,37,Unknown,Unknown,Unknown,Unknown,Banque Inconnue,Unknown,4106.0
Unknown,Unknown,16,Unknown,Unknown,Unknown,Unknown,Banque Inconnue,Unknown,4122.0
Unknown,Unknown,34,Unknown,Unknown,Unknown,Unknown,Banque Inconnue,Unknown,4156.0
Unknown,Unknown,37,Unknown,Unknown,Unknown,Unknown,Banque Inconnue,Unknown,4193.0
Unknown,Unknown,21,Unknown,Unknown,Unknown,Unknown,Banque Inconnue,Unknown,4214.0
Unknown,Unknown,7,Unknown,Unknown,Unknown,Unknown,Banque Inconnue,Unknown,4221.0
Unknown,Unknown,36,Unknown,Unknown,Unknown,Unknown,Banque Inconnue,Unknown,4257.0
Unknown,Unknown,14,Unknown,Unknown,Unknown,Unknown,cid:12)(cid:29)(cid:26)(cid:41)(cid:25)(cid:2)(cid:53)(cid:53)(cid:37)(cid:16)(cid:34)(cid:33,cid:18)(cid:16)(cid:45)(cid:18)(cid:34,14.0
Unknown,Unknown,9,Unknown,Unknown,Unknown,Unknown,cid:12)(cid:29)(cid:26)(cid:41)(cid:25)(cid:2)(cid:53)(cid:53)(cid:37)(cid:16)(cid:34)(cid:33,cid:18)(cid:16)(cid:45)(cid:18)(cid:34,23.0
Unknown,Unknown,38,Unknown,Unknown,Unknown,Unknown,cid:12)(cid:29)(cid:26)(cid:41)(cid:25)(cid:2)(cid:53)(cid:53)(cid:37)(cid:16)(cid:34)(cid:33,cid:18)(cid:35)(cid:45)(cid:18)(cid:34,61.0
Unknown,Unknown,2,Unknown,Unknown,Unknown,Unknown,cid:12)(cid:29)(cid:26)(cid:41)(cid:25)(cid:2)(cid:53)(cid:53)(cid:37)(cid:16)(cid:34)(cid:33,cid:9)(cid:49)(cid:8)(cid:5)(cid:28)(cid:2)(cid:9)(cid:5)(cid:8)(cid:14)(cid:7)(cid:9)(cid:2)(cid:28)(cid:3,63.0
Unknown,Unknown,7,Unknown,Unknown,Unknown,Unknown,cid:12)(cid:29)(cid:26)(cid:41)(cid:25)(cid:2)(cid:53)(cid:53)(cid:37)(cid:16)(cid:34)(cid:33,cid:17)(cid:37)(cid:45)(cid:18)(cid:34,70.0
Unknown,Unknown,32,Unknown,Unknown,Unknown,Unknown,cid:12)(cid:29)(cid:26)(cid:41)(cid:25)(cid:2)(cid:53)(cid:53)(cid:37)(cid:16)(cid:34)(cid:33,cid:17)(cid:16)(cid:45)(cid:18)(cid:34,102.0
Unknown,Unknown,2,Unknown,Unknown,Unknown,Unknown,cid:12)(cid:29)(cid:26)(cid:41)(cid:25)(cid:2)(cid:53)(cid:53)(cid:37)(cid:16)(cid:34)(cid:33,cid:17)(cid:16)(cid:45)(cid:18)(cid:34,104.0
Unknown,Unknown,7,Unknown,Unknown,Unknown,Unknown,cid:12)(cid:29)(cid:26)(cid:41)(cid:25)(cid:2)(cid:53)(cid:53)(cid:37)(cid:16)(cid:34)(cid:33,cid:1)(cid:17)(cid:45)(cid:18)(cid:34,111.0
Unknown,Unknown,4,Unknown,Unknown,Unknown,Unknown,cid:12)(cid:29)(cid:26)(cid:41)(cid:25)(cid:2)(cid:53)(cid:53)(cid:37)(cid:16)(cid:34)(cid:33,cid:9)(cid:49)(cid:8)(cid:5)(cid:28)(cid:2)(cid:9)(cid:5)(cid:8)(cid:14)(cid:7)(cid:9)(cid:2)(cid:28)(cid:3,115.0
Unknown,Unknown,9,Unknown,Unknown,Unknown,Unknown,cid:12)(cid:29)(cid:26)(cid:41)(cid:25)(cid:2)(cid:53)(cid:53)(cid:37)(cid:16)(cid:34)(cid:33,cid:1)(cid:17)(cid:45)(cid:18)(cid:34,124.0
Unknown,Unknown,3,Unknown,Unknown,Unknown,Unknown,cid:12)(cid:29)(cid:26)(cid:41)(cid:25)(cid:2)(cid:53)(cid:53)(cid:37)(cid:16)(cid:34)(cid:33,cid:1)(cid:17)(cid:45)(cid:18)(cid:34,127.0
Unknown,Unknown,2,Unknown,Unknown,Unknown,Unknown,cid:12)(cid:29)(cid:26)(cid:41)(cid:25)(cid:2)(cid:53)(cid:53)(cid:37)(cid:16)(cid:34)(cid:33,cid:9)(cid:49)(cid:8)(cid:5)(cid:28)(cid:2)(cid:9)(cid:5)(cid:8)(cid:14)(cid:7)(cid:9)(cid:2)(cid:28)(cid:3,129.0
Unknown,Unknown,15,Unknown,Unknown,Unknown,Unknown,cid:12)(cid:29)(cid:26)(cid:41)(cid:25)(cid:2)(cid:53)(cid:53)(cid:37)(cid:16)(cid:34)(cid:33,cid:1)(cid:17)(cid:45)(cid:18)(cid:34,144.0
Unknown,Unknown,13,Unknown,Unknown,Unknown,Unknown,cid:12)(cid:29)(cid:26)(cid:41)(cid:25)(cid:2)(cid:53)(cid:53)(cid:37)(cid:16)(cid:34)(cid:33,cid:9)(cid:49)(cid:8)(cid:5)(cid:28)(cid:2)(cid:9)(cid:5)(cid:8)(cid:14)(cid:7)(cid:9)(cid:2)(cid:28)(cid:3,157.0
Unknown,Unknown,39,Unknown,Unknown,Unknown,Unknown,cid:12)(cid:29)(cid:26)(cid:41)(cid:25)(cid:2)(cid:53)(cid:53)(cid:37)(cid:16)(cid:34)(cid:33,cid:1)(cid:17)(cid:45)(cid:18)(cid:34,196.0
Unknown,Unknown,13,Unknown,Unknown,Unknown,Unknown,cid:12)(cid:29)(cid:26)(cid:41)(cid:25)(cid:2)(cid:53)(cid:53)(cid:37)(cid:16)(cid:34)(cid:33,cid:1)(cid:36)(cid:45)(cid:18)(cid:34,209.0
Unknown,Unknown,9,Unknown,Unknown,Unknown,Unknown,cid:12)(cid:29)(cid:26)(cid:41)(cid:25)(cid:2)(cid:53)(cid:53)(cid:37)(cid:16)(cid:34)(cid:33,cid:1)(cid:36)(cid:45)(cid:18)(cid:34,218.0
Unknown,Unknown,10,Unknown,Unknown,Unknown,Unknown,cid:12)(cid:29)(cid:26)(cid:41)(cid:25)(cid:2)(cid:53)(cid:53)(cid:37)(cid:16)(cid:34)(cid:33,cid:12)(cid:13)(cid:14)(cid:2)(cid:14)(cid:49)(cid:63)(cid:49)(cid:46)(cid:5)(cid:9)(cid:2)(cid:47)(cid:11)(cid:7)(cid:9)(cid:9)(cid:65)(cid:2)(cid:14)(cid:5)(cid:2)(cid:12)(cid:13)(cid:49)(cid:2)(cid:28)(cid:3,228.0
Unknown,Unknown,6,Unknown,Unknown,Unknown,Unknown,cid:12)(cid:29)(cid:26)(cid:41)(cid:25)(cid:2)(cid:53)(cid:53)(cid:37)(cid:16)(cid:34)(cid:33,cid:12)(cid:29)(cid:26)(cid:41)(cid:25)(cid:2)(cid:53)(cid:53)(cid:18)(cid:1)(cid:1)(cid:37,234.0
Unknown,Unknown,9,Unknown,Unknown,Unknown,Unknown,cid:12)(cid:29)(cid:26)(cid:41)(cid:25)(cid:2)(cid:53)(cid:53)(cid:37)(cid:16)(cid:34)(cid:33,Unknown,243.0
Unknown,Unknown,11,Unknown,Unknown,Unknown,Unknown,cid:12)(cid:29)(cid:26)(cid:41)(cid:25)(cid:2)(cid:53)(cid:53)(cid:37)(cid:16)(cid:34)(cid:33,Unknown,254.0
Unknown,Unknown,38,Unknown,Unknown,Unknown,Unknown,cid:12)(cid:29)(cid:26)(cid:41)(cid:25)(cid:2)(cid:53)(cid:53)(cid:37)(cid:16)(cid:34)(cid:33,Unknown,292.0
Unknown,Unknown,12,Unknown,Unknown,Unknown,Unknown,cid:12)(cid:29)(cid:26)(cid:41)(cid:25)(cid:2)(cid:53)(cid:53)(cid:37)(cid:16)(cid:34)(cid:33,Unknown,304.0
Unknown,Unknown,31,Unknown,Unknown,Unknown,Unknown,cid:12)(cid:29)(cid:26)(cid:41)(cid:25)(cid:2)(cid:53)(cid:53)(cid:37)(cid:16)(cid:34)(cid:33,Unknown,335.0
Unknown,Unknown,10,Unknown,Unknown,Unknown,Unknown,cid:12)(cid:29)(cid:26)(cid:41)(cid:25)(cid:2)(cid:53)(cid:53)(cid:37)(cid:16)(cid:34)(cid:33,Unknown,345.0
Unknown,Unknown,6,Unknown,Unknown,Unknown,Unknown,cid:12)(cid:29)(cid:26)(cid:41)(cid:25)(cid:2)(cid:53)(cid:53)(cid:37)(cid:16)(cid:34)(cid:33,Unknown,351.0
Unknown,Unknown,14,Unknown,Unknown,Unknown,Unknown,cid:12)(cid:29)(cid:26)(cid:41)(cid:25)(cid:2)(cid:53)(cid:53)(cid:37)(cid:16)(cid:34)(cid:33,Unknown,365.0
Unknown,Unknown,5,Unknown,Unknown,Unknown,Unknown,cid:12)(cid:29)(cid:26)(cid:41)(cid:25)(cid:2)(cid:53)(cid:53)(cid:37)(cid:16)(cid:34)(cid:33,Unknown,370.0
Unknown,Unknown,8,Unknown,Unknown,Unknown,Unknown,cid:12)(cid:29)(cid:26)(cid:41)(cid:25)(cid:2)(cid:53)(cid:53)(cid:37)(cid:16)(cid:34)(cid:33,Unknown,378.0
Unknown,Unknown,12,Unknown,Unknown,Unknown,Unknown,cid:12)(cid:29)(cid:26)(cid:41)(cid:25)(cid:2)(cid:53)(cid:53)(cid:37)(cid:16)(cid:34)(cid:33,Unknown,390.0
Unknown,Unknown,38,Unknown,Unknown,Unknown,Unknown,cid:12)(cid:29)(cid:26)(cid:41)(cid:25)(cid:2)(cid:53)(cid:53)(cid:37)(cid:16)(cid:34)(cid:33,Unknown,428.0
Unknown,Unknown,29,Unknown,Unknown,Unknown,Unknown,cid:12)(cid:29)(cid:26)(cid:41)(cid:25)(cid:2)(cid:53)(cid:53)(cid:37)(cid:16)(cid:34)(cid:33,Unknown,457.0
Unknown,Unknown,13,Unknown,Unknown,Unknown,Unknown,cid:12)(cid:29)(cid:26)(cid:41)(cid:25)(cid:2)(cid:53)(cid:53)(cid:37)(cid:16)(cid:34)(cid:33,Unknown,470.0
Unknown,Unknown,5,Unknown,Unknown,Unknown,Unknown,cid:12)(cid:29)(cid:26)(cid:41)(cid:25)(cid:2)(cid:53)(cid:53)(cid:37)(cid:16)(cid:34)(cid:33,Unknown,475.0
Unknown,Unknown,32,Unknown,Unknown,Unknown,Unknown,cid:12)(cid:29)(cid:26)(cid:41)(cid:25)(cid:2)(cid:53)(cid:53)(cid:37)(cid:16)(cid:34)(cid:33,Unknown,507.0
Unknown,Unknown,12,Unknown,Unknown,Unknown,Unknown,cid:12)(cid:29)(cid:26)(cid:41)(cid:25)(cid:2)(cid:53)(cid:53)(cid:37)(cid:16)(cid:34)(cid:33,Unknown,519.0
Unknown,Unknown,38,Unknown,Unknown,Unknown,Unknown,cid:12)(cid:29)(cid:26)(cid:41)(cid:25)(cid:2)(cid:53)(cid:53)(cid:37)(cid:16)(cid:34)(cid:33,Unknown,557.0
Unknown,Unknown,18,Unknown,Unknown,Unknown,Unknown,cid:12)(cid:29)(cid:26)(cid:41)(cid:25)(cid:2)(cid:53)(cid:53)(cid:37)(cid:16)(cid:34)(cid:33,Unknown,575.0
Unknown,Unknown,16,Unknown,Unknown,Unknown,Unknown,cid:12)(cid:29)(cid:26)(cid:41)(cid:25)(cid:2)(cid:53)(cid:53)(cid:37)(cid:16)(cid:34)(cid:33,Unknown,591.0
Unknown,Unknown,45,Unknown,Unknown,Unknown,Unknown,cid:12)(cid:29)(cid:26)(cid:41)(cid:25)(cid:2)(cid:53)(cid:53)(cid:37)(cid:16)(cid:34)(cid:33,Unknown,636.0
Unknown,Unknown,18,Unknown,Unknown,Unknown,Unknown,cid:12)(cid:29)(cid:26)(cid:41)(cid:25)(cid:2)(cid:53)(cid:53)(cid:37)(cid:16)(cid:34)(cid:33,Unknown,654.0
Unknown,Unknown,34,Unknown,Unknown,Unknown,Unknown,cid:12)(cid:29)(cid:26)(cid:41)(cid:25)(cid:2)(cid:53)(cid:53)(cid:37)(cid:16)(cid:34)(cid:33,Unknown,688.0
Unknown,Unknown,5,Unknown,Unknown,Unknown,Unknown,cid:12)(cid:29)(cid:26)(cid:41)(cid:25)(cid:2)(cid:53)(cid:53)(cid:37)(cid:16)(cid:34)(cid:33,Unknown,693.0
Unknown,Unknown,46,Unknown,Unknown,Unknown,Unknown,cid:12)(cid:29)(cid:26)(cid:41)(cid:25)(cid:2)(cid:53)(cid:53)(cid:37)(cid:16)(cid:34)(cid:33,Unknown,739.0
Unknown,Unknown,2,Unknown,Unknown,Unknown,Unknown,cid:12)(cid:29)(cid:26)(cid:41)(cid:25)(cid:2)(cid:53)(cid:53)(cid:37)(cid:16)(cid:34)(cid:33,Unknown,741.0
Unknown,Unknown,47,Unknown,Unknown,Unknown,Unknown,cid:12)(cid:29)(cid:26)(cid:41)(cid:25)(cid:2)(cid:53)(cid:53)(cid:37)(cid:16)(cid:34)(cid:33,Unknown,788.0
Unknown,Unknown,5,Unknown,Unknown,Unknown,Unknown,cid:12)(cid:29)(cid:26)(cid:41)(cid:25)(cid:2)(cid:53)(cid:53)(cid:37)(cid:16)(cid:34)(cid:33,Unknown,793.0
Unknown,Unknown,8,Unknown,Unknown,Unknown,Unknown,cid:12)(cid:29)(cid:26)(cid:41)(cid:25)(cid:2)(cid:53)(cid:53)(cid:37)(cid:16)(cid:34)(cid:33,Unknown,801.0
Unknown,Unknown,8,Unknown,Unknown,Unknown,Unknown,cid:12)(cid:29)(cid:26)(cid:41)(cid:25)(cid:2)(cid:53)(cid:53)(cid:37)(cid:16)(cid:34)(cid:33,Unknown,809.0
Unknown,Unknown,5,Unknown,Unknown,Unknown,Unknown,cid:12)(cid:29)(cid:26)(cid:41)(cid:25)(cid:2)(cid:53)(cid:53)(cid:37)(cid:16)(cid:34)(cid:33,Unknown,814.0
Unknown,Unknown,9,Unknown,Unknown,Unknown,Unknown,cid:12)(cid:29)(cid:26)(cid:41)(cid:25)(cid:2)(cid:53)(cid:53)(cid:37)(cid:16)(cid:34)(cid:33,Unknown,823.0
Unknown,Unknown,43,Unknown,Unknown,Unknown,Unknown,cid:12)(cid:29)(cid:26)(cid:41)(cid:25)(cid:2)(cid:53)(cid:53)(cid:37)(cid:16)(cid:34)(cid:33,Unknown,866.0
Unknown,Unknown,2,Unknown,Unknown,Unknown,Unknown,cid:12)(cid:29)(cid:26)(cid:41)(cid:25)(cid:2)(cid:53)(cid:53)(cid:37)(cid:16)(cid:34)(cid:33,Unknown,868.0
Unknown,Unknown,34,Unknown,Unknown,Unknown,Unknown,cid:12)(cid:29)(cid:26)(cid:41)(cid:25)(cid:2)(cid:53)(cid:53)(cid:37)(cid:16)(cid:34)(cid:33,Unknown,902.0
Unknown,Unknown,18,Unknown,Unknown,Unknown,Unknown,cid:12)(cid:29)(cid:26)(cid:41)(cid:25)(cid:2)(cid:53)(cid:53)(cid:37)(cid:16)(cid:34)(cid:33,Unknown,920.0
Unknown,Unknown,19,Unknown,Unknown,Unknown,Unknown,cid:12)(cid:29)(cid:26)(cid:41)(cid:25)(cid:2)(cid:53)(cid:53)(cid:37)(cid:16)(cid:34)(cid:33,Unknown,939.0
Unknown,Unknown,18,Unknown,Unknown,Unknown,Unknown,cid:12)(cid:29)(cid:26)(cid:41)(cid:25)(cid:2)(cid:53)(cid:53)(cid:37)(cid:16)(cid:34)(cid:33,Unknown,957.0
Unknown,Unknown,18,Unknown,Unknown,Unknown,Unknown,cid:12)(cid:29)(cid:26)(cid:41)(cid:25)(cid:2)(cid:53)(cid:53)(cid:37)(cid:16)(cid:34)(cid:33,Unknown,975.0
Unknown,Unknown,2,Unknown,Unknown,Unknown,Unknown,cid:12)(cid:29)(cid:26)(cid:41)(cid:25)(cid:2)(cid:53)(cid:53)(cid:37)(cid:16)(cid:34)(cid:33,Unknown,977.0
Unknown,Unknown,44,Unknown,Unknown,Unknown,Unknown,cid:12)(cid:29)(cid:26)(cid:41)(cid:25)(cid:2)(cid:53)(cid:53)(cid:37)(cid:16)(cid:34)(cid:33,Unknown,1021.0
Unknown,Unknown,48,Unknown,Unknown,Unknown,Unknown,cid:12)(cid:29)(cid:26)(cid:41)(cid:25)(cid:2)(cid:53)(cid:53)(cid:37)(cid:16)(cid:34)(cid:33,Unknown,1069.0
Unknown,Unknown,24,Unknown,Unknown,Unknown,Unknown,cid:12)(cid:29)(cid:26)(cid:41)(cid:25)(cid:2)(cid:53)(cid:53)(cid:37)(cid:16)(cid:34)(cid:33,Unknown,1093.0
Unknown,Unknown,26,Unknown,Unknown,Unknown,Unknown,cid:12)(cid:29)(cid:26)(cid:41)(cid:25)(cid:2)(cid:53)(cid:53)(cid:37)(cid:16)(cid:34)(cid:33,Unknown,1119.0
Unknown,Unknown,25,Unknown,Unknown,Unknown,Unknown,cid:12)(cid:29)(cid:26)(cid:41)(cid:25)(cid:2)(cid:53)(cid:53)(cid:37)(cid:16)(cid:34)(cid:33,Unknown,1144.0
Unknown,Unknown,23,Unknown,Unknown,Unknown,Unknown,cid:12)(cid:29)(cid:26)(cid:41)(cid:25)(cid:2)(cid:53)(cid:53)(cid:37)(cid:16)(cid:34)(cid:33,Unknown,1167.0
Unknown,Unknown,25,Unknown,Unknown,Unknown,Unknown,cid:12)(cid:29)(cid:26)(cid:41)(cid:25)(cid:2)(cid:53)(cid:53)(cid:37)(cid:16)(cid:34)(cid:33,Unknown,1192.0
Unknown,Unknown,30,Unknown,Unknown,Unknown,Unknown,cid:12)(cid:29)(cid:26)(cid:41)(cid:25)(cid:2)(cid:53)(cid:53)(cid:37)(cid:16)(cid:34)(cid:33,Unknown,1222.0
Unknown,Unknown,41,Unknown,Unknown,Unknown,Unknown,cid:12)(cid:29)(cid:26)(cid:41)(cid:25)(cid:2)(cid:53)(cid:53)(cid:37)(cid:16)(cid:34)(cid:33,Unknown,1263.0
Unknown,Unknown,18,Unknown,Unknown,Unknown,Unknown,cid:12)(cid:29)(cid:26)(cid:41)(cid:25)(cid:2)(cid:53)(cid:53)(cid:37)(cid:16)(cid:34)(cid:33,Unknown,1281.0
Unknown,Unknown,16,Unknown,Unknown,Unknown,Unknown,cid:12)(cid:29)(cid:26)(cid:41)(cid:25)(cid:2)(cid:53)(cid:53)(cid:37)(cid:16)(cid:34)(cid:33,Unknown,1297.0
Unknown,Unknown,45,Unknown,Unknown,Unknown,Unknown,cid:12)(cid:29)(cid:26)(cid:41)(cid:25)(cid:2)(cid:53)(cid:53)(cid:37)(cid:16)(cid:34)(cid:33,Unknown,1342.0
Unknown,Unknown,18,Unknown,Unknown,Unknown,Unknown,cid:12)(cid:29)(cid:26)(cid:41)(cid:25)(cid:2)(cid:53)(cid:53)(cid:37)(cid:16)(cid:34)(cid:33,Unknown,1360.0
Unknown,Unknown,34,Unknown,Unknown,Unknown,Unknown,cid:12)(cid:29)(cid:26)(cid:41)(cid:25)(cid:2)(cid:53)(cid:53)(cid:37)(cid:16)(cid:34)(cid:33,Unknown,1394.0
Unknown,Unknown,38,Unknown,Unknown,Unknown,Unknown,cid:12)(cid:29)(cid:26)(cid:41)(cid:25)(cid:2)(cid:53)(cid:53)(cid:37)(cid:16)(cid:34)(cid:33,Unknown,1432.0
Unknown,Unknown,20,Unknown,Unknown,Unknown,Unknown,cid:12)(cid:29)(cid:26)(cid:41)(cid:25)(cid:2)(cid:53)(cid:53)(cid:37)(cid:16)(cid:34)(cid:33,Unknown,1452.0
Unknown,Unknown,30,Unknown,Unknown,Unknown,Unknown,cid:12)(cid:29)(cid:26)(cid:41)(cid:25)(cid:2)(cid:53)(cid:53)(cid:37)(cid:16)(cid:34)(cid:33,Unknown,1482.0
Unknown,Unknown,41,Unknown,Unknown,Unknown,Unknown,cid:12)(cid:29)(cid:26)(cid:41)(cid:25)(cid:2)(cid:53)(cid:53)(cid:37)(cid:16)(cid:34)(cid:33,Unknown,1523.0
Unknown,Unknown,20,Unknown,Unknown,Unknown,Unknown,cid:12)(cid:29)(cid:26)(cid:41)(cid:25)(cid:2)(cid:53)(cid:53)(cid:37)(cid:16)(cid:34)(cid:33,Unknown,1543.0
Unknown,Unknown,15,Unknown,Unknown,Unknown,Unknown,cid:12)(cid:29)(cid:26)(cid:41)(cid:25)(cid:2)(cid:53)(cid:53)(cid:37)(cid:16)(cid:34)(cid:33,Unknown,1558.0
Unknown,Unknown,2,Unknown,Unknown,Unknown,Unknown,cid:12)(cid:29)(cid:26)(cid:41)(cid:25)(cid:2)(cid:53)(cid:53)(cid:37)(cid:16)(cid:34)(cid:33,Unknown,1560.0
Unknown,Unknown,36,Unknown,Unknown,Unknown,Unknown,cid:12)(cid:29)(cid:26)(cid:41)(cid:25)(cid:2)(cid:53)(cid:53)(cid:37)(cid:16)(cid:34)(cid:33,Unknown,1596.0
Unknown,Unknown,1,Unknown,Unknown,Unknown,Unknown,cid:12)(cid:29)(cid:26)(cid:41)(cid:25)(cid:2)(cid:53)(cid:53)(cid:37)(cid:16)(cid:34)(cid:33,Unknown,1597.0
Unknown,Unknown,19,Unknown,Unknown,Unknown,Unknown,cid:12)(cid:29)(cid:26)(cid:41)(cid:25)(cid:2)(cid:53)(cid:53)(cid:37)(cid:16)(cid:34)(cid:33,Unknown,1616.0
Unknown,Unknown,18,Unknown,Unknown,Unknown,Unknown,cid:12)(cid:29)(cid:26)(cid:41)(cid:25)(cid:2)(cid:53)(cid:53)(cid:37)(cid:16)(cid:34)(cid:33,Unknown,1634.0
Unknown,Unknown,18,Unknown,Unknown,Unknown,Unknown,cid:12)(cid:29)(cid:26)(cid:41)(cid:25)(cid:2)(cid:53)(cid:53)(cid:37)(cid:16)(cid:34)(cid:33,Unknown,1652.0
Unknown,Unknown,2,Unknown,Unknown,Unknown,Unknown,cid:12)(cid:29)(cid:26)(cid:41)(cid:25)(cid:2)(cid:53)(cid:53)(cid:37)(cid:16)(cid:34)(cid:33,Unknown,1654.0
Unknown,Unknown,44,Unknown,Unknown,Unknown,Unknown,cid:12)(cid:29)(cid:26)(cid:41)(cid:25)(cid:2)(cid:53)(cid:53)(cid:37)(cid:16)(cid:34)(cid:33,Unknown,1698.0
Unknown,Unknown,49,Unknown,Unknown,Unknown,Unknown,cid:12)(cid:29)(cid:26)(cid:41)(cid:25)(cid:2)(cid:53)(cid:53)(cid:37)(cid:16)(cid:34)(cid:33,Unknown,1747.0
Unknown,Unknown,50,Unknown,Unknown,Unknown,Unknown,cid:12)(cid:29)(cid:26)(cid:41)(cid:25)(cid:2)(cid:53)(cid:53)(cid:37)(cid:16)(cid:34)(cid:33,Unknown,1797.0
Unknown,Unknown,20,Unknown,Unknown,Unknown,Unknown,cid:12)(cid:29)(cid:26)(cid:41)(cid:25)(cid:2)(cid:53)(cid:53)(cid:37)(cid:16)(cid:34)(cid:33,Unknown,1817.0
Unknown,Unknown,30,Unknown,Unknown,Unknown,Unknown,cid:12)(cid:29)(cid:26)(cid:41)(cid:25)(cid:2)(cid:53)(cid:53)(cid:37)(cid:16)(cid:34)(cid:33,Unknown,1847.0
Unknown,Unknown,30,Unknown,Unknown,Unknown,Unknown,cid:12)(cid:29)(cid:26)(cid:41)(cid:25)(cid:2)(cid:53)(cid:53)(cid:37)(cid:16)(cid:34)(cid:33,Unknown,1877.0
Unknown,Unknown,25,Unknown,Unknown,Unknown,Unknown,cid:12)(cid:29)(cid:26)(cid:41)(cid:25)(cid:2)(cid:53)(cid:53)(cid:37)(cid:16)(cid:34)(cid:33,Unknown,1902.0
Unknown,Unknown,23,Unknown,Unknown,Unknown,Unknown,cid:12)(cid:29)(cid:26)(cid:41)(cid:25)(cid:2)(cid:53)(cid:53)(cid:37)(cid:16)(cid:34)(cid:33,Unknown,1925.0
Unknown,Unknown,25,Unknown,Unknown,Unknown,Unknown,cid:12)(cid:29)(cid:26)(cid:41)(cid:25)(cid:2)(cid:53)(cid:53)(cid:37)(cid:16)(cid:34)(cid:33,Unknown,1950.0
Unknown,Unknown,30,Unknown,Unknown,Unknown,Unknown,cid:12)(cid:29)(cid:26)(cid:41)(cid:25)(cid:2)(cid:53)(cid:53)(cid:37)(cid:16)(cid:34)(cid:33,Unknown,1980.0
Unknown,Unknown,41,Unknown,Unknown,Unknown,Unknown,cid:12)(cid:29)(cid:26)(cid:41)(cid:25)(cid:2)(cid:53)(cid:53)(cid:37)(cid:16)(cid:34)(cid:33,Unknown,2021.0
Unknown,Unknown,2,Unknown,Unknown,Unknown,Unknown,cid:12)(cid:29)(cid:26)(cid:41)(cid:25)(cid:2)(cid:53)(cid:53)(cid:37)(cid:16)(cid:34)(cid:33,Unknown,2023.0
Unknown,Unknown,45,Unknown,Unknown,Unknown,Unknown,cid:12)(cid:29)(cid:26)(cid:41)(cid:25)(cid:2)(cid:53)(cid:53)(cid:37)(cid:16)(cid:34)(cid:33,Unknown,2068.0
Unknown,Unknown,2,Unknown,Unknown,Unknown,Unknown,cid:12)(cid:29)(cid:26)(cid:41)(cid:25)(cid:2)(cid:53)(cid:53)(cid:37)(cid:16)(cid:34)(cid:33,Unknown,2070.0
Unknown,Unknown,28,Unknown,Unknown,Unknown,Unknown,cid:12)(cid:29)(cid:26)(cid:41)(cid:25)(cid:2)(cid:53)(cid:53)(cid:37)(cid:16)(cid:34)(cid:33,Unknown,2098.0
Unknown,Unknown,26,Unknown,Unknown,Unknown,Unknown,cid:12)(cid:29)(cid:26)(cid:41)(cid:25)(cid:2)(cid:53)(cid:53)(cid:37)(cid:16)(cid:34)(cid:33,Unknown,2124.0
Unknown,Unknown,29,Unknown,Unknown,Unknown,Unknown,cid:12)(cid:29)(cid:26)(cid:41)(cid:25)(cid:2)(cid:53)(cid:53)(cid:37)(cid:16)(cid:34)(cid:33,Unknown,2153.0
Unknown,Unknown,24,Unknown,Unknown,Unknown,Unknown,cid:12)(cid:29)(cid:26)(cid:41)(cid:25)(cid:2)(cid:53)(cid:53)(cid:37)(cid:16)(cid:34)(cid:33,Unknown,2177.0
Unknown,Unknown,27,Unknown,Unknown,Unknown,Unknown,cid:12)(cid:29)(cid:26)(cid:41)(cid:25)(cid:2)(cid:53)(cid:53)(cid:37)(cid:16)(cid:34)(cid:33,Unknown,2204.0
Unknown,Unknown,2,Unknown,Unknown,Unknown,Unknown,cid:12)(cid:29)(cid:26)(cid:41)(cid:25)(cid:2)(cid:53)(cid:53)(cid:37)(cid:16)(cid:34)(cid:33,Unknown,2206.0
Unknown,Unknown,29,Unknown,Unknown,Unknown,Unknown,cid:12)(cid:29)(cid:26)(cid:41)(cid:25)(cid:2)(cid:53)(cid:53)(cid:37)(cid:16)(cid:34)(cid:33,Unknown,2235.0
Unknown,Unknown,51,Unknown,Unknown,Unknown,Unknown,cid:12)(cid:29)(cid:26)(cid:41)(cid:25)(cid:2)(cid:53)(cid:53)(cid:37)(cid:16)(cid:34)(cid:33,Unknown,2286.0
Unknown,Unknown,51,Unknown,Unknown,Unknown,Unknown,cid:12)(cid:29)(cid:26)(cid:41)(cid:25)(cid:2)(cid:53)(cid:53)(cid:37)(cid:16)(cid:34)(cid:33,Unknown,2337.0
Unknown,Unknown,24,Unknown,Unknown,Unknown,Unknown,cid:12)(cid:29)(cid:26)(cid:41)(cid:25)(cid:2)(cid:53)(cid:53)(cid:37)(cid:16)(cid:34)(cid:33,Unknown,2361.0
Unknown,Unknown,41,Unknown,Unknown,Unknown,Unknown,cid:12)(cid:29)(cid:26)(cid:41)(cid:25)(cid:2)(cid:53)(cid:53)(cid:37)(cid:16)(cid:34)(cid:33,Unknown,2402.0
Unknown,Unknown,24,Unknown,Unknown,Unknown,Unknown,cid:12)(cid:29)(cid:26)(cid:41)(cid:25)(cid:2)(cid:53)(cid:53)(cid:37)(cid:16)(cid:34)(cid:33,Unknown,2426.0
Unknown,Unknown,20,Unknown,Unknown,Unknown,Unknown,cid:12)(cid:29)(cid:26)(cid:41)(cid:25)(cid:2)(cid:53)(cid:53)(cid:37)(cid:16)(cid:34)(cid:33,Unknown,2446.0
Unknown,Unknown,30,Unknown,Unknown,Unknown,Unknown,cid:12)(cid:29)(cid:26)(cid:41)(cid:25)(cid:2)(cid:53)(cid:53)(cid:37)(cid:16)(cid:34)(cid:33,Unknown,2476.0
Unknown,Unknown,30,Unknown,Unknown,Unknown,Unknown,cid:12)(cid:29)(cid:26)(cid:41)(cid:25)(cid:2)(cid:53)(cid:53)(cid:37)(cid:16)(cid:34)(cid:33,Unknown,2506.0
Unknown,Unknown,25,Unknown,Unknown,Unknown,Unknown,cid:12)(cid:29)(cid:26)(cid:41)(cid:25)(cid:2)(cid:53)(cid:53)(cid:37)(cid:16)(cid:34)(cid:33,Unknown,2531.0
Unknown,Unknown,22,Unknown,Unknown,Unknown,Unknown,cid:12)(cid:29)(cid:26)(cid:41)(cid:25)(cid:2)(cid:53)(cid:53)(cid:37)(cid:16)(cid:34)(cid:33,Unknown,2553.0
Unknown,Unknown,27,Unknown,Unknown,Unknown,Unknown,cid:12)(cid:29)(cid:26)(cid:41)(cid:25)(cid:2)(cid:53)(cid:53)(cid:37)(cid:16)(cid:34)(cid:33,Unknown,2580.0
Unknown,Unknown,18,Unknown,Unknown,Unknown,Unknown,cid:12)(cid:29)(cid:26)(cid:41)(cid:25)(cid:2)(cid:53)(cid:53)(cid:37)(cid:16)(cid:34)(cid:33,Unknown,2598.0
Unknown,Unknown,35,Unknown,Unknown,Unknown,Unknown,cid:12)(cid:29)(cid:26)(cid:41)(cid:25)(cid:2)(cid:53)(cid:53)(cid:37)(cid:16)(cid:34)(cid:33,Unknown,2633.0
Unknown,Unknown,45,Unknown,Unknown,Unknown,Unknown,cid:12)(cid:29)(cid:26)(cid:41)(cid:25)(cid:2)(cid:53)(cid:53)(cid:37)(cid:16)(cid:34)(cid:33,Unknown,2678.0
Unknown,Unknown,18,Unknown,Unknown,Unknown,Unknown,cid:12)(cid:29)(cid:26)(cid:41)(cid:25)(cid:2)(cid:53)(cid:53)(cid:37)(cid:16)(cid:34)(cid:33,Unknown,2696.0
Unknown,Unknown,34,Unknown,Unknown,Unknown,Unknown,cid:12)(cid:29)(cid:26)(cid:41)(cid:25)(cid:2)(cid:53)(cid:53)(cid:37)(cid:16)(cid:34)(cid:33,Unknown,2730.0
Unknown,Unknown,9,Unknown,Unknown,Unknown,Unknown,cid:12)(cid:29)(cid:26)(cid:41)(cid:25)(cid:2)(cid:53)(cid:53)(cid:37)(cid:16)(cid:34)(cid:33,Unknown,2739.0
Unknown,Unknown,49,Unknown,Unknown,Unknown,Unknown,cid:12)(cid:29)(cid:26)(cid:41)(cid:25)(cid:2)(cid:53)(cid:53)(cid:37)(cid:16)(cid:34)(cid:33,Unknown,2788.0
Unknown,Unknown,8,Unknown,Unknown,Unknown,Unknown,cid:12)(cid:29)(cid:26)(cid:41)(cid:25)(cid:2)(cid:53)(cid:53)(cid:37)(cid:16)(cid:34)(cid:33,Unknown,2796.0
Unknown,Unknown,5,Unknown,Unknown,Unknown,Unknown,cid:12)(cid:29)(cid:26)(cid:41)(cid:25)(cid:2)(cid:53)(cid:53)(cid:37)(cid:16)(cid:34)(cid:33,Unknown,2801.0
Unknown,Unknown,28,Unknown,Unknown,Unknown,Unknown,cid:12)(cid:29)(cid:26)(cid:41)(cid:25)(cid:2)(cid:53)(cid:53)(cid:37)(cid:16)(cid:34)(cid:33,Unknown,2829.0
Unknown,Unknown,2,Unknown,Unknown,Unknown,Unknown,cid:12)(cid:29)(cid:26)(cid:41)(cid:25)(cid:2)(cid:53)(cid:53)(cid:37)(cid:16)(cid:34)(cid:33,Unknown,2831.0
Unknown,Unknown,49,Unknown,Unknown,Unknown,Unknown,cid:12)(cid:29)(cid:26)(cid:41)(cid:25)(cid:2)(cid:53)(cid:53)(cid:37)(cid:16)(cid:34)(cid:33,Unknown,2880.0
Unknown,Unknown,4,Unknown,Unknown,Unknown,Unknown,cid:12)(cid:29)(cid:26)(cid:41)(cid:25)(cid:2)(cid:53)(cid:53)(cid:37)(cid:16)(cid:34)(cid:33,Unknown,2884.0
Unknown,Unknown,10,Unknown,Unknown,Unknown,Unknown,cid:12)(cid:29)(cid:26)(cid:41)(cid:25)(cid:2)(cid:53)(cid:53)(cid:37)(cid:16)(cid:34)(cid:33,Unknown,2894.0
Unknown,Unknown,11,Unknown,Unknown,Unknown,Unknown,cid:12)(cid:29)(cid:26)(cid:41)(cid:25)(cid:2)(cid:53)(cid:53)(cid:37)(cid:16)(cid:34)(cid:33,Unknown,2905.0
Unknown,Unknown,3,Unknown,Unknown,Unknown,Unknown,cid:12)(cid:29)(cid:26)(cid:41)(cid:25)(cid:2)(cid:53)(cid:53)(cid:37)(cid:16)(cid:34)(cid:33,Unknown,2908.0
Unknown,Unknown,11,Unknown,Unknown,Unknown,Unknown,cid:12)(cid:29)(cid:26)(cid:41)(cid:25)(cid:2)(cid:53)(cid:53)(cid:37)(cid:16)(cid:34)(cid:33,Unknown,2919.0
Unknown,Unknown,4,Unknown,Unknown,Unknown,Unknown,cid:12)(cid:29)(cid:26)(cid:41)(cid:25)(cid:2)(cid:53)(cid:53)(cid:37)(cid:16)(cid:34)(cid:33,Unknown,2923.0
Unknown,Unknown,10,Unknown,Unknown,Unknown,Unknown,cid:12)(cid:29)(cid:26)(cid:41)(cid:25)(cid:2)(cid:53)(cid:53)(cid:37)(cid:16)(cid:34)(cid:33,Unknown,2933.0
Unknown,Unknown,5,Unknown,Unknown,Unknown,Unknown,cid:12)(cid:29)(cid:26)(cid:41)(cid:25)(cid:2)(cid:53)(cid:53)(cid:37)(cid:16)(cid:34)(cid:33,Unknown,2938.0
Unknown,Unknown,2,Unknown,Unknown,Unknown,Unknown,cid:12)(cid:29)(cid:26)(cid:41)(cid:25)(cid:2)(cid:53)(cid:53)(cid:37)(cid:16)(cid:34)(cid:33,Unknown,2940.0
Unknown,Unknown,9,Unknown,Unknown,Unknown,Unknown,cid:12)(cid:29)(cid:26)(cid:41)(cid:25)(cid:2)(cid:53)(cid:53)(cid:37)(cid:16)(cid:34)(cid:33,Unknown,2949.0
Unknown,Unknown,5,Unknown,Unknown,Unknown,Unknown,cid:12)(cid:29)(cid:26)(cid:41)(cid:25)(cid:2)(cid:53)(cid:53)(cid:37)(cid:16)(cid:34)(cid:33,Unknown,2954.0
Unknown,Unknown,8,Unknown,Unknown,Unknown,Unknown,cid:12)(cid:29)(cid:26)(cid:41)(cid:25)(cid:2)(cid:53)(cid:53)(cid:37)(cid:16)(cid:34)(cid:33,Unknown,2962.0
Unknown,Unknown,14,Unknown,Unknown,Unknown,Unknown,cid:12)(cid:29)(cid:26)(cid:41)(cid:25)(cid:2)(cid:53)(cid:53)(cid:37)(cid:16)(cid:34)(cid:33,Unknown,2976.0
Unknown,Unknown,7,Unknown,Unknown,Unknown,Unknown,cid:12)(cid:29)(cid:26)(cid:41)(cid:25)(cid:2)(cid:53)(cid:53)(cid:37)(cid:16)(cid:34)(cid:33,Unknown,2983.0
Unknown,Unknown,9,Unknown,Unknown,Unknown,Unknown,cid:12)(cid:29)(cid:26)(cid:41)(cid:25)(cid:2)(cid:53)(cid:53)(cid:37)(cid:16)(cid:34)(cid:33,Unknown,2992.0
Unknown,Unknown,2,Unknown,Unknown,Unknown,Unknown,cid:12)(cid:29)(cid:26)(cid:41)(cid:25)(cid:2)(cid:53)(cid:53)(cid:37)(cid:16)(cid:34)(cid:33,Unknown,2994.0
Unknown,Unknown,12,Unknown,Unknown,Unknown,Unknown,cid:12)(cid:29)(cid:26)(cid:41)(cid:25)(cid:2)(cid:53)(cid:53)(cid:37)(cid:16)(cid:34)(cid:33,Unknown,3006.0
Unknown,Unknown,5,Unknown,Unknown,Unknown,Unknown,cid:12)(cid:29)(cid:26)(cid:41)(cid:25)(cid:2)(cid:53)(cid:53)(cid:37)(cid:16)(cid:34)(cid:33,Unknown,3011.0
Unknown,Unknown,52,Unknown,Unknown,Unknown,Unknown,cid:12)(cid:29)(cid:26)(cid:41)(cid:25)(cid:2)(cid:53)(cid:53)(cid:37)(cid:16)(cid:34)(cid:33,Unknown,3063.0
Unknown,Unknown,5,Unknown,Unknown,Unknown,Unknown,cid:12)(cid:29)(cid:26)(cid:41)(cid:25)(cid:2)(cid:53)(cid:53)(cid:37)(cid:16)(cid:34)(cid:33,Unknown,3068.0
Unknown,Unknown,40,Unknown,Unknown,Unknown,Unknown,cid:12)(cid:29)(cid:26)(cid:41)(cid:25)(cid:2)(cid:53)(cid:53)(cid:37)(cid:16)(cid:34)(cid:33,Unknown,3108.0
Unknown,Unknown,2,Unknown,Unknown,Unknown,Unknown,cid:12)(cid:29)(cid:26)(cid:41)(cid:25)(cid:2)(cid:53)(cid:53)(cid:37)(cid:16)(cid:34)(cid:33,Unknown,3110.0
Unknown,Unknown,28,Unknown,Unknown,Unknown,Unknown,cid:12)(cid:29)(cid:26)(cid:41)(cid:25)(cid:2)(cid:53)(cid:53)(cid:37)(cid:16)(cid:34)(cid:33,Unknown,3138.0
Unknown,Unknown,3,Unknown,Unknown,Unknown,Unknown,cid:12)(cid:29)(cid:26)(cid:41)(cid:25)(cid:2)(cid:53)(cid:53)(cid:37)(cid:16)(cid:34)(cid:33,Unknown,3141.0
Unknown,Unknown,15,Unknown,Unknown,Unknown,Unknown,cid:12)(cid:29)(cid:26)(cid:41)(cid:25)(cid:2)(cid:53)(cid:53)(cid:37)(cid:16)(cid:34)(cid:33,Unknown,3156.0
Unknown,Unknown,2,Unknown,Unknown,Unknown,Unknown,cid:12)(cid:29)(cid:26)(cid:41)(cid:25)(cid:2)(cid:53)(cid:53)(cid:37)(cid:16)(cid:34)(cid:33,Unknown,3158.0
Unknown,Unknown,1,Unknown,Unknown,Unknown,Unknown,cid:12)(cid:29)(cid:26)(cid:41)(cid:25)(cid:2)(cid:53)(cid:53)(cid:37)(cid:16)(cid:34)(cid:33,Unknown,3159.0
Unknown,Unknown,19,Unknown,Unknown,Unknown,Unknown,cid:12)(cid:29)(cid:26)(cid:41)(cid:25)(cid:2)(cid:53)(cid:53)(cid:37)(cid:16)(cid:34)(cid:33,Unknown,3178.0
Unknown,Unknown,37,Unknown,Unknown,Unknown,Unknown,cid:12)(cid:29)(cid:26)(cid:41)(cid:25)(cid:2)(cid:53)(cid:53)(cid:37)(cid:16)(cid:34)(cid:33,Unknown,3215.0
Unknown,Unknown,18,Unknown,Unknown,Unknown,Unknown,cid:12)(cid:29)(cid:26)(cid:41)(cid:25)(cid:2)(cid:53)(cid:53)(cid:37)(cid:16)(cid:34)(cid:33,Unknown,3233.0
Unknown,Unknown,2,Unknown,Unknown,Unknown,Unknown,cid:12)(cid:29)(cid:26)(cid:41)(cid:25)(cid:2)(cid:53)(cid:53)(cid:37)(cid:16)(cid:34)(cid:33,Unknown,3235.0
Unknown,Unknown,44,Unknown,Unknown,Unknown,Unknown,cid:12)(cid:29)(cid:26)(cid:41)(cid:25)(cid:2)(cid:53)(cid:53)(cid:37)(cid:16)(cid:34)(cid:33,Unknown,3279.0
Unknown,Unknown,12,Unknown,Unknown,Unknown,Unknown,cid:12)(cid:29)(cid:26)(cid:41)(cid:25)(cid:2)(cid:53)(cid:53)(cid:37)(cid:16)(cid:34)(cid:33,Unknown,3291.0
Unknown,Unknown,29,Unknown,Unknown,Unknown,Unknown,cid:12)(cid:29)(cid:26)(cid:41)(cid:25)(cid:2)(cid:53)(cid:53)(cid:37)(cid:16)(cid:34)(cid:33,Unknown,3320.0
Unknown,Unknown,26,Unknown,Unknown,Unknown,Unknown,cid:12)(cid:29)(cid:26)(cid:41)(cid:25)(cid:2)(cid:53)(cid:53)(cid:37)(cid:16)(cid:34)(cid:33,Unknown,3346.0
Unknown,Unknown,41,Unknown,Unknown,Unknown,Unknown,cid:12)(cid:29)(cid:26)(cid:41)(cid:25)(cid:2)(cid:53)(cid:53)(cid:37)(cid:16)(cid:34)(cid:33,Unknown,3387.0
Unknown,Unknown,25,Unknown,Unknown,Unknown,Unknown,cid:12)(cid:29)(cid:26)(cid:41)(cid:25)(cid:2)(cid:53)(cid:53)(cid:37)(cid:16)(cid:34)(cid:33,Unknown,3412.0
Unknown,Unknown,2,Unknown,Unknown,Unknown,Unknown,cid:12)(cid:29)(cid:26)(cid:41)(cid:25)(cid:2)(cid:53)(cid:53)(cid:37)(cid:16)(cid:34)(cid:33,Unknown,3414.0
Unknown,Unknown,53,Unknown,Unknown,Unknown,Unknown,cid:12)(cid:29)(cid:26)(cid:41)(cid:25)(cid:2)(cid:53)(cid:53)(cid:37)(cid:16)(cid:34)(cid:33,Unknown,3467.0
Unknown,Unknown,53,Unknown,Unknown,Unknown,Unknown,cid:12)(cid:29)(cid:26)(cid:41)(cid:25)(cid:2)(cid:53)(cid:53)(cid:37)(cid:16)(cid:34)(cid:33,Unknown,3520.0
Unknown,Unknown,37,Unknown,Unknown,Unknown,Unknown,cid:12)(cid:29)(cid:26)(cid:41)(cid:25)(cid:2)(cid:53)(cid:53)(cid:37)(cid:16)(cid:34)(cid:33,Unknown,3557.0
Unknown,Unknown,16,Unknown,Unknown,Unknown,Unknown,cid:12)(cid:29)(cid:26)(cid:41)(cid:25)(cid:2)(cid:53)(cid:53)(cid:37)(cid:16)(cid:34)(cid:33,Unknown,3573.0
Unknown,Unknown,34,Unknown,Unknown,Unknown,Unknown,cid:12)(cid:29)(cid:26)(cid:41)(cid:25)(cid:2)(cid:53)(cid:53)(cid:37)(cid:16)(cid:34)(cid:33,Unknown,3607.0
Unknown,Unknown,33,Unknown,Unknown,Unknown,Unknown,cid:12)(cid:29)(cid:26)(cid:41)(cid:25)(cid:2)(cid:53)(cid:53)(cid:37)(cid:16)(cid:34)(cid:33,Unknown,3640.0
Unknown,Unknown,18,Unknown,Unknown,Unknown,Unknown,cid:12)(cid:29)(cid:26)(cid:41)(cid:25)(cid:2)(cid:53)(cid:53)(cid:37)(cid:16)(cid:34)(cid:33,Unknown,3658.0
Unknown,Unknown,35,Unknown,Unknown,Unknown,Unknown,cid:12)(cid:29)(cid:26)(cid:41)(cid:25)(cid:2)(cid:53)(cid:53)(cid:37)(cid:16)(cid:34)(cid:33,Unknown,3693.0
Unknown,Unknown,45,Unknown,Unknown,Unknown,Unknown,cid:12)(cid:29)(cid:26)(cid:41)(cid:25)(cid:2)(cid:53)(cid:53)(cid:37)(cid:16)(cid:34)(cid:33,Unknown,3738.0
Unknown,Unknown,18,Unknown,Unknown,Unknown,Unknown,cid:12)(cid:29)(cid:26)(cid:41)(cid:25)(cid:2)(cid:53)(cid:53)(cid:37)(cid:16)(cid:34)(cid:33,Unknown,3756.0
Unknown,Unknown,34,Unknown,Unknown,Unknown,Unknown,cid:12)(cid:29)(cid:26)(cid:41)(cid:25)(cid:2)(cid:53)(cid:53)(cid:37)(cid:16)(cid:34)(cid:33,Unknown,3790.0
Unknown,Unknown,9,Unknown,Unknown,Unknown,Unknown,cid:12)(cid:29)(cid:26)(cid:41)(cid:25)(cid:2)(cid:53)(cid:53)(cid:37)(cid:16)(cid:34)(cid:33,Unknown,3799.0
Unknown,Unknown,49,Unknown,Unknown,Unknown,Unknown,cid:12)(cid:29)(cid:26)(cid:41)(cid:25)(cid:2)(cid:53)(cid:53)(cid:37)(cid:16)(cid:34)(cid:33,Unknown,3848.0
Unknown,Unknown,8,Unknown,Unknown,Unknown,Unknown,cid:12)(cid:29)(cid:26)(cid:41)(cid:25)(cid:2)(cid:53)(cid:53)(cid:37)(cid:16)(cid:34)(cid:33,Unknown,3856.0
Unknown,Unknown,5,Unknown,Unknown,Unknown,Unknown,cid:12)(cid:29)(cid:26)(cid:41)(cid:25)(cid:2)(cid:53)(cid:53)(cid:37)(cid:16)(cid:34)(cid:33,Unknown,3861.0
Unknown,Unknown,28,Unknown,Unknown,Unknown,Unknown,cid:12)(cid:29)(cid:26)(cid:41)(cid:25)(cid:2)(cid:53)(cid:53)(cid:37)(cid:16)(cid:34)(cid:33,Unknown,3889.0
Unknown,Unknown,2,Unknown,Unknown,Unknown,Unknown,cid:12)(cid:29)(cid:26)(cid:41)(cid:25)(cid:2)(cid:53)(cid:53)(cid:37)(cid:16)(cid:34)(cid:33,Unknown,3891.0
Unknown,Unknown,9,Unknown,Unknown,Unknown,Unknown,cid:12)(cid:29)(cid:26)(cid:41)(cid:25)(cid:2)(cid:53)(cid:53)(cid:37)(cid:16)(cid:34)(cid:33,Unknown,3900.0
Unknown,Unknown,5,Unknown,Unknown,Unknown,Unknown,cid:12)(cid:29)(cid:26)(cid:41)(cid:25)(cid:2)(cid:53)(cid:53)(cid:37)(cid:16)(cid:34)(cid:33,Unknown,3905.0
Unknown,Unknown,8,Unknown,Unknown,Unknown,Unknown,cid:12)(cid:29)(cid:26)(cid:41)(cid:25)(cid:2)(cid:53)(cid:53)(cid:37)(cid:16)(cid:34)(cid:33,Unknown,3913.0
Unknown,Unknown,14,Unknown,Unknown,Unknown,Unknown,cid:12)(cid:29)(cid:26)(cid:41)(cid:25)(cid:2)(cid:53)(cid:53)(cid:37)(cid:16)(cid:34)(cid:33,Unknown,3927.0
Unknown,Unknown,7,Unknown,Unknown,Unknown,Unknown,cid:12)(cid:29)(cid:26)(cid:41)(cid:25)(cid:2)(cid:53)(cid:53)(cid:37)(cid:16)(cid:34)(cid:33,Unknown,3934.0
Unknown,Unknown,9,Unknown,Unknown,Unknown,Unknown,cid:12)(cid:29)(cid:26)(cid:41)(cid:25)(cid:2)(cid:53)(cid:53)(cid:37)(cid:16)(cid:34)(cid:33,Unknown,3943.0
Unknown,Unknown,2,Unknown,Unknown,Unknown,Unknown,cid:12)(cid:29)(cid:26)(cid:41)(cid:25)(cid:2)(cid:53)(cid:53)(cid:37)(cid:16)(cid:34)(cid:33,Unknown,3945.0
Unknown,Unknown,28,Unknown,Unknown,Unknown,Unknown,cid:12)(cid:29)(cid:26)(cid:41)(cid:25)(cid:2)(cid:53)(cid:53)(cid:37)(cid:16)(cid:34)(cid:33,Unknown,3973.0
Unknown,Unknown,3,Unknown,Unknown,Unknown,Unknown,cid:12)(cid:29)(cid:26)(cid:41)(cid:25)(cid:2)(cid:53)(cid:53)(cid:37)(cid:16)(cid:34)(cid:33,Unknown,3976.0
Unknown,Unknown,15,Unknown,Unknown,Unknown,Unknown,cid:12)(cid:29)(cid:26)(cid:41)(cid:25)(cid:2)(cid:53)(cid:53)(cid:37)(cid:16)(cid:34)(cid:33,Unknown,3991.0
Unknown,Unknown,2,Unknown,Unknown,Unknown,Unknown,cid:12)(cid:29)(cid:26)(cid:41)(cid:25)(cid:2)(cid:53)(cid:53)(cid:37)(cid:16)(cid:34)(cid:33,Unknown,3993.0
Unknown,Unknown,1,Unknown,Unknown,Unknown,Unknown,cid:12)(cid:29)(cid:26)(cid:41)(cid:25)(cid:2)(cid:53)(cid:53)(cid:37)(cid:16)(cid:34)(cid:33,Unknown,3994.0
Unknown,Unknown,19,Unknown,Unknown,Unknown,Unknown,cid:12)(cid:29)(cid:26)(cid:41)(cid:25)(cid:2)(cid:53)(cid:53)(cid:37)(cid:16)(cid:34)(cid:33,Unknown,4013.0
Unknown,Unknown,37,Unknown,Unknown,Unknown,Unknown,cid:12)(cid:29)(cid:26)(cid:41)(cid:25)(cid:2)(cid:53)(cid:53)(cid:37)(cid:16)(cid:34)(cid:33,Unknown,4050.0
Unknown,Unknown,18,Unknown,Unknown,Unknown,Unknown,cid:12)(cid:29)(cid:26)(cid:41)(cid:25)(cid:2)(cid:53)(cid:53)(cid:37)(cid:16)(cid:34)(cid:33,Unknown,4068.0
Unknown,Unknown,2,Unknown,Unknown,Unknown,Unknown,cid:12)(cid:29)(cid:26)(cid:41)(cid:25)(cid:2)(cid:53)(cid:53)(cid:37)(cid:16)(cid:34)(cid:33,Unknown,4070.0
Unknown,Unknown,44,Unknown,Unknown,Unknown,Unknown,cid:12)(cid:29)(cid:26)(cid:41)(cid:25)(cid:2)(cid:53)(cid:53)(cid:37)(cid:16)(cid:34)(cid:33,Unknown,4114.0
Unknown,Unknown,12,Unknown,Unknown,Unknown,Unknown,cid:12)(cid:29)(cid:26)(cid:41)(cid:25)(cid:2)(cid:53)(cid:53)(cid:37)(cid:16)(cid:34)(cid:33,Unknown,4126.0
Unknown,Unknown,29,Unknown,Unknown,Unknown,Unknown,cid:12)(cid:29)(cid:26)(cid:41)(cid:25)(cid:2)(cid:53)(cid:53)(cid:37)(cid:16)(cid:34)(cid:33,Unknown,4155.0
Unknown,Unknown,26,Unknown,Unknown,Unknown,Unknown,cid:12)(cid:29)(cid:26)(cid:41)(cid:25)(cid:2)(cid:53)(cid:53)(cid:37)(cid:16)(cid:34)(cid:33,Unknown,4181.0
Unknown,Unknown,41,Unknown,Unknown,Unknown,Unknown,cid:12)(cid:29)(cid:26)(cid:41)(cid:25)(cid:2)(cid:53)(cid:53)(cid:37)(cid:16)(cid:34)(cid:33,Unknown,4222.0
Unknown,Unknown,25,Unknown,Unknown,Unknown,Unknown,cid:12)(cid:29)(cid:26)(cid:41)(cid:25)(cid:2)(cid:53)(cid:53)(cid:37)(cid:16)(cid:34)(cid:33,Unknown,4247.0
Unknown,Unknown,2,Unknown,Unknown,Unknown,Unknown,cid:12)(cid:29)(cid:26)(cid:41)(cid:25)(cid:2)(cid:53)(cid:53)(cid:37)(cid:16)(cid:34)(cid:33,Unknown,4249.0
Unknown,Unknown,53,Unknown,Unknown,Unknown,Unknown,cid:12)(cid:29)(cid:26)(cid:41)(cid:25)(cid:2)(cid:53)(cid:53)(cid:37)(cid:16)(cid:34)(cid:33,Unknown,4302.0
Unknown,Unknown,53,Unknown,Unknown,Unknown,Unknown,cid:12)(cid:29)(cid:26)(cid:41)(cid:25)(cid:2)(cid:53)(cid:53)(cid:37)(cid:16)(cid:34)(cid:33,Unknown,4355.0
Unknown,Unknown,37,Unknown,Unknown,Unknown,Unknown,cid:12)(cid:29)(cid:26)(cid:41)(cid:25)(cid:2)(cid:53)(cid:53)(cid:37)(cid:16)(cid:34)(cid:33,Unknown,4392.0
Unknown,Unknown,16,Unknown,Unknown,Unknown,Unknown,cid:12)(cid:29)(cid:26)(cid:41)(cid:25)(cid:2)(cid:53)(cid:53)(cid:37)(cid:16)(cid:34)(cid:33,Unknown,4408.0
Unknown,Unknown,34,Unknown,Unknown,Unknown,Unknown,cid:12)(cid:29)(cid:26)(cid:41)(cid:25)(cid:2)(cid:53)(cid:53)(cid:37)(cid:16)(cid:34)(cid:33,Unknown,4442.0
Unknown,Unknown,33,Unknown,Unknown,Unknown,Unknown,cid:12)(cid:29)(cid:26)(cid:41)(cid:25)(cid:2)(cid:53)(cid:53)(cid:37)(cid:16)(cid:34)(cid:33,Unknown,4475.0
Unknown,Unknown,17,Unknown,Unknown,Unknown,Unknown,cid:12)(cid:29)(cid:26)(cid:41)(cid:25)(cid:2)(cid:53)(cid:53)(cid:37)(cid:16)(cid:34)(cid:33,Unknown,4492.0
Unknown,Unknown,37,Unknown,Unknown,Unknown,Unknown,cid:12)(cid:29)(cid:26)(cid:41)(cid:25)(cid:2)(cid:53)(cid:53)(cid:37)(cid:16)(cid:34)(cid:33,Unknown,4529.0
Unknown,Unknown,45,Unknown,Unknown,Unknown,Unknown,cid:12)(cid:29)(cid:26)(cid:41)(cid:25)(cid:2)(cid:53)(cid:53)(cid:37)(cid:16)(cid:34)(cid:33,Unknown,4574.0
Unknown,Unknown,18,Unknown,Unknown,Unknown,Unknown,cid:12)(cid:29)(cid:26)(cid:41)(cid:25)(cid:2)(cid:53)(cid:53)(cid:37)(cid:16)(cid:34)(cid:33,Unknown,4592.0
Unknown,Unknown,34,Unknown,Unknown,Unknown,Unknown,cid:12)(cid:29)(cid:26)(cid:41)(cid:25)(cid:2)(cid:53)(cid:53)(cid:37)(cid:16)(cid:34)(cid:33,Unknown,4626.0
Unknown,Unknown,46,Unknown,Unknown,Unknown,Unknown,cid:12)(cid:29)(cid:26)(cid:41)(cid:25)(cid:2)(cid:53)(cid:53)(cid:37)(cid:16)(cid:34)(cid:33,Unknown,4672.0
Unknown,Unknown,54,Unknown,Unknown,Unknown,Unknown,cid:12)(cid:29)(cid:26)(cid:41)(cid:25)(cid:2)(cid:53)(cid:53)(cid:37)(cid:16)(cid:34)(cid:33,Unknown,4726.0
Unknown,Unknown,3,Unknown,Unknown,Unknown,Unknown,cid:12)(cid:29)(cid:26)(cid:41)(cid:25)(cid:2)(cid:53)(cid:53)(cid:37)(cid:16)(cid:34)(cid:33,Unknown,4729.0
Unknown,Unknown,49,Unknown,Unknown,Unknown,Unknown,cid:12)(cid:29)(cid:26)(cid:41)(cid:25)(cid:2)(cid:53)(cid:53)(cid:37)(cid:16)(cid:34)(cid:33,Unknown,4778.0
Unknown,Unknown,3,Unknown,Unknown,Unknown,Unknown,cid:12)(cid:29)(cid:26)(cid:41)(cid:25)(cid:2)(cid:53)(cid:53)(cid:37)(cid:16)(cid:34)(cid:33,Unknown,4781.0
Unknown,Unknown,52,Unknown,Unknown,Unknown,Unknown,cid:12)(cid:29)(cid:26)(cid:41)(cid:25)(cid:2)(cid:53)(cid:53)(cid:37)(cid:16)(cid:34)(cid:33,Unknown,4833.0
Unknown,Unknown,43,Unknown,Unknown,Unknown,Unknown,cid:12)(cid:29)(cid:26)(cid:41)(cid:25)(cid:2)(cid:53)(cid:53)(cid:37)(cid:16)(cid:34)(cid:33,Unknown,4876.0
Unknown,Unknown,2,Unknown,Unknown,Unknown,Unknown,cid:12)(cid:29)(cid:26)(cid:41)(cid:25)(cid:2)(cid:53)(cid:53)(cid:37)(cid:16)(cid:34)(cid:33,Unknown,4878.0
Unknown,Unknown,1,Unknown,Unknown,Unknown,Unknown,cid:12)(cid:29)(cid:26)(cid:41)(cid:25)(cid:2)(cid:53)(cid:53)(cid:37)(cid:16)(cid:34)(cid:33,Unknown,4879.0
Unknown,Unknown,36,Unknown,Unknown,Unknown,Unknown,cid:12)(cid:29)(cid:26)(cid:41)(cid:25)(cid:2)(cid:53)(cid:53)(cid:37)(cid:16)(cid:34)(cid:33,Unknown,4915.0
Unknown,Unknown,34,Unknown,Unknown,Unknown,Unknown,cid:12)(cid:29)(cid:26)(cid:41)(cid:25)(cid:2)(cid:53)(cid:53)(cid:37)(cid:16)(cid:34)(cid:33,Unknown,4949.0
Unknown,Unknown,19,Unknown,Unknown,Unknown,Unknown,cid:12)(cid:29)(cid:26)(cid:41)(cid:25)(cid:2)(cid:53)(cid:53)(cid:37)(cid:16)(cid:34)(cid:33,Unknown,4968.0
Unknown,Unknown,18,Unknown,Unknown,Unknown,Unknown,cid:12)(cid:29)(cid:26)(cid:41)(cid:25)(cid:2)(cid:53)(cid:53)(cid:37)(cid:16)(cid:34)(cid:33,Unknown,4986.0
Unknown,Unknown,18,Unknown,Unknown,Unknown,Unknown,cid:12)(cid:29)(cid:26)(cid:41)(cid:25)(cid:2)(cid:53)(cid:53)(cid:37)(cid:16)(cid:34)(cid:33,Unknown,5004.0
Unknown,Unknown,2,Unknown,Unknown,Unknown,Unknown,cid:12)(cid:29)(cid:26)(cid:41)(cid:25)(cid:2)(cid:53)(cid:53)(cid:37)(cid:16)(cid:34)(cid:33,Unknown,5006.0
Unknown,Unknown,44,Unknown,Unknown,Unknown,Unknown,cid:12)(cid:29)(cid:26)(cid:41)(cid:25)(cid:2)(cid:53)(cid:53)(cid:37)(cid:16)(cid:34)(cid:33,Unknown,5050.0
Unknown,Unknown,52,Unknown,Unknown,Unknown,Unknown,cid:12)(cid:29)(cid:26)(cid:41)(cid:25)(cid:2)(cid:53)(cid:53)(cid:37)(cid:16)(cid:34)(cid:33,Unknown,5102.0
Unknown,Unknown,42,Unknown,Unknown,Unknown,Unknown,cid:12)(cid:29)(cid:26)(cid:41)(cid:25)(cid:2)(cid:53)(cid:53)(cid:37)(cid:16)(cid:34)(cid:33,Unknown,5144.0
Unknown,Unknown,55,Unknown,Unknown,Unknown,Unknown,cid:12)(cid:29)(cid:26)(cid:41)(cid:25)(cid:2)(cid:53)(cid:53)(cid:37)(cid:16)(cid:34)(cid:33,Unknown,5199.0
Unknown,Unknown,56,Unknown,Unknown,Unknown,Unknown,cid:12)(cid:29)(cid:26)(cid:41)(cid:25)(cid:2)(cid:53)(cid:53)(cid:37)(cid:16)(cid:34)(cid:33,Unknown,5255.0
Unknown,Unknown,41,Unknown,Unknown,Unknown,Unknown,cid:12)(cid:29)(cid:26)(cid:41)(cid:25)(cid:2)(cid:53)(cid:53)(cid:37)(cid:16)(cid:34)(cid:33,Unknown,5296.0
Unknown,Unknown,2,Unknown,Unknown,Unknown,Unknown,cid:12)(cid:29)(cid:26)(cid:41)(cid:25)(cid:2)(cid:53)(cid:53)(cid:37)(cid:16)(cid:34)(cid:33,Unknown,5298.0
Unknown,Unknown,51,Unknown,Unknown,Unknown,Unknown,cid:12)(cid:29)(cid:26)(cid:41)(cid:25)(cid:2)(cid:53)(cid:53)(cid:37)(cid:16)(cid:34)(cid:33,Unknown,5349.0
Unknown,Unknown,25,Unknown,Unknown,Unknown,Unknown,cid:12)(cid:29)(cid:26)(cid:41)(cid:25)(cid:2)(cid:53)(cid:53)(cid:37)(cid:16)(cid:34)(cid:33,Unknown,5374.0
Unknown,Unknown,2,Unknown,Unknown,Unknown,Unknown,cid:12)(cid:29)(cid:26)(cid:41)(cid:25)(cid:2)(cid:53)(cid:53)(cid:37)(cid:16)(cid:34)(cid:33,Unknown,5376.0
Unknown,Unknown,31,Unknown,Unknown,Unknown,Unknown,cid:12)(cid:29)(cid:26)(cid:41)(cid:25)(cid:2)(cid:53)(cid:53)(cid:37)(cid:16)(cid:34)(cid:33,Unknown,5407.0
Unknown,Unknown,57,Unknown,Unknown,Unknown,Unknown,cid:12)(cid:29)(cid:26)(cid:41)(cid:25)(cid:2)(cid:53)(cid:53)(cid:37)(cid:16)(cid:34)(cid:33,Unknown,5464.0
Unknown,Unknown,58,Unknown,Unknown,Unknown,Unknown,cid:12)(cid:29)(cid:26)(cid:41)(cid:25)(cid:2)(cid:53)(cid:53)(cid:37)(cid:16)(cid:34)(cid:33,Unknown,5522.0
Unknown,Unknown,59,Unknown,Unknown,Unknown,Unknown,cid:12)(cid:29)(cid:26)(cid:41)(cid:25)(cid:2)(cid:53)(cid:53)(cid:37)(cid:16)(cid:34)(cid:33,Unknown,5581.0
Unknown,Unknown,21,Unknown,Unknown,Unknown,Unknown,cid:12)(cid:29)(cid:26)(cid:41)(cid:25)(cid:2)(cid:53)(cid:53)(cid:37)(cid:16)(cid:34)(cid:33,Unknown,5602.0
Unknown,Unknown,25,Unknown,Unknown,Unknown,Unknown,cid:12)(cid:29)(cid:26)(cid:41)(cid:25)(cid:2)(cid:53)(cid:53)(cid:37)(cid:16)(cid:34)(cid:33,Unknown,5627.0
Unknown,Unknown,17,Unknown,Unknown,Unknown,Unknown,cid:12)(cid:29)(cid:26)(cid:41)(cid:25)(cid:2)(cid:53)(cid:53)(cid:37)(cid:16)(cid:34)(cid:33,Unknown,5644.0
Unknown,Unknown,37,Unknown,Unknown,Unknown,Unknown,cid:12)(cid:29)(cid:26)(cid:41)(cid:25)(cid:2)(cid:53)(cid:53)(cid:37)(cid:16)(cid:34)(cid:33,Unknown,5681.0
Unknown,Unknown,45,Unknown,Unknown,Unknown,Unknown,cid:12)(cid:29)(cid:26)(cid:41)(cid:25)(cid:2)(cid:53)(cid:53)(cid:37)(cid:16)(cid:34)(cid:33,Unknown,5726.0
Unknown,Unknown,18,Unknown,Unknown,Unknown,Unknown,cid:12)(cid:29)(cid:26)(cid:41)(cid:25)(cid:2)(cid:53)(cid:53)(cid:37)(cid:16)(cid:34)(cid:33,Unknown,5744.0
Unknown,Unknown,34,Unknown,Unknown,Unknown,Unknown,cid:12)(cid:29)(cid:26)(cid:41)(cid:25)(cid:2)(cid:53)(cid:53)(cid:37)(cid:16)(cid:34)(cid:33,Unknown,5778.0
Unknown,Unknown,38,Unknown,Unknown,Unknown,Unknown,cid:12)(cid:29)(cid:26)(cid:41)(cid:25)(cid:2)(cid:53)(cid:53)(cid:37)(cid:16)(cid:34)(cid:33,Unknown,5816.0
Unknown,Unknown,20,Unknown,Unknown,Unknown,Unknown,cid:12)(cid:29)(cid:26)(cid:41)(cid:25)(cid:2)(cid:53)(cid:53)(cid:37)(cid:16)(cid:34)(cid:33,Unknown,5836.0
Unknown,Unknown,30,Unknown,Unknown,Unknown,Unknown,cid:12)(cid:29)(cid:26)(cid:41)(cid:25)(cid:2)(cid:53)(cid:53)(cid:37)(cid:16)(cid:34)(cid:33,Unknown,5866.0
Unknown,Unknown,41,Unknown,Unknown,Unknown,Unknown,cid:12)(cid:29)(cid:26)(cid:41)(cid:25)(cid:2)(cid:53)(cid:53)(cid:37)(cid:16)(cid:34)(cid:33,Unknown,5907.0
Unknown,Unknown,20,Unknown,Unknown,Unknown,Unknown,cid:12)(cid:29)(cid:26)(cid:41)(cid:25)(cid:2)(cid:53)(cid:53)(cid:37)(cid:16)(cid:34)(cid:33,Unknown,5927.0
Unknown,Unknown,15,Unknown,Unknown,Unknown,Unknown,cid:12)(cid:29)(cid:26)(cid:41)(cid:25)(cid:2)(cid:53)(cid:53)(cid:37)(cid:16)(cid:34)(cid:33,Unknown,5942.0
Unknown,Unknown,2,Unknown,Unknown,Unknown,Unknown,cid:12)(cid:29)(cid:26)(cid:41)(cid:25)(cid:2)(cid:53)(cid:53)(cid:37)(cid:16)(cid:34)(cid:33,Unknown,5944.0
Unknown,Unknown,1,Unknown,Unknown,Unknown,Unknown,cid:12)(cid:29)(cid:26)(cid:41)(cid:25)(cid:2)(cid:53)(cid:53)(cid:37)(cid:16)(cid:34)(cid:33,Unknown,5945.0
Unknown,Unknown,19,Unknown,Unknown,Unknown,Unknown,cid:12)(cid:29)(cid:26)(cid:41)(cid:25)(cid:2)(cid:53)(cid:53)(cid:37)(cid:16)(cid:34)(cid:33,Unknown,5964.0
Unknown,Unknown,36,Unknown,Unknown,Unknown,Unknown,cid:12)(cid:29)(cid:26)(cid:41)(cid:25)(cid:2)(cid:53)(cid:53)(cid:37)(cid:16)(cid:34)(cid:33,Unknown,6000.0
Unknown,Unknown,18,Unknown,Unknown,Unknown,Unknown,cid:12)(cid:29)(cid:26)(cid:41)(cid:25)(cid:2)(cid:53)(cid:53)(cid:37)(cid:16)(cid:34)(cid:33,Unknown,6018.0
Unknown,Unknown,2,Unknown,Unknown,Unknown,Unknown,cid:12)(cid:29)(cid:26)(cid:41)(cid:25)(cid:2)(cid:53)(cid:53)(cid:37)(cid:16)(cid:34)(cid:33,Unknown,6020.0
Unknown,Unknown,44,Unknown,Unknown,Unknown,Unknown,cid:12)(cid:29)(cid:26)(cid:41)(cid:25)(cid:2)(cid:53)(cid:53)(cid:37)(cid:16)(cid:34)(cid:33,Unknown,6064.0
Unknown,Unknown,49,Unknown,Unknown,Unknown,Unknown,cid:12)(cid:29)(cid:26)(cid:41)(cid:25)(cid:2)(cid:53)(cid:53)(cid:37)(cid:16)(cid:34)(cid:33,Unknown,6113.0
Unknown,Unknown,50,Unknown,Unknown,Unknown,Unknown,cid:12)(cid:29)(cid:26)(cid:41)(cid:25)(cid:2)(cid:53)(cid:53)(cid:37)(cid:16)(cid:34)(cid:33,Unknown,6163.0
Unknown,Unknown,20,Unknown,Unknown,Unknown,Unknown,cid:12)(cid:29)(cid:26)(cid:41)(cid:25)(cid:2)(cid:53)(cid:53)(cid:37)(cid:16)(cid:34)(cid:33,Unknown,6183.0
Unknown,Unknown,30,Unknown,Unknown,Unknown,Unknown,cid:12)(cid:29)(cid:26)(cid:41)(cid:25)(cid:2)(cid:53)(cid:53)(cid:37)(cid:16)(cid:34)(cid:33,Unknown,6213.0
Unknown,Unknown,30,Unknown,Unknown,Unknown,Unknown,cid:12)(cid:29)(cid:26)(cid:41)(cid:25)(cid:2)(cid:53)(cid:53)(cid:37)(cid:16)(cid:34)(cid:33,Unknown,6243.0
Unknown,Unknown,25,Unknown,Unknown,Unknown,Unknown,cid:12)(cid:29)(cid:26)(cid:41)(cid:25)(cid:2)(cid:53)(cid:53)(cid:37)(cid:16)(cid:34)(cid:33,Unknown,6268.0
Unknown,Unknown,23,Unknown,Unknown,Unknown,Unknown,cid:12)(cid:29)(cid:26)(cid:41)(cid:25)(cid:2)(cid:53)(cid:53)(cid:37)(cid:16)(cid:34)(cid:33,Unknown,6291.0
Unknown,Unknown,25,Unknown,Unknown,Unknown,Unknown,cid:12)(cid:29)(cid:26)(cid:41)(cid:25)(cid:2)(cid:53)(cid:53)(cid:37)(cid:16)(cid:34)(cid:33,Unknown,6316.0
Unknown,Unknown,30,Unknown,Unknown,Unknown,Unknown,cid:12)(cid:29)(cid:26)(cid:41)(cid:25)(cid:2)(cid:53)(cid:53)(cid:37)(cid:16)(cid:34)(cid:33,Unknown,6346.0
Unknown,Unknown,41,Unknown,Unknown,Unknown,Unknown,cid:12)(cid:29)(cid:26)(cid:41)(cid:25)(cid:2)(cid:53)(cid:53)(cid:37)(cid:16)(cid:34)(cid:33,Unknown,6387.0
Unknown,Unknown,2,Unknown,Unknown,Unknown,Unknown,cid:12)(cid:29)(cid:26)(cid:41)(cid:25)(cid:2)(cid:53)(cid:53)(cid:37)(cid:16)(cid:34)(cid:33,Unknown,6389.0
Unknown,Unknown,45,Unknown,Unknown,Unknown,Unknown,cid:12)(cid:29)(cid:26)(cid:41)(cid:25)(cid:2)(cid:53)(cid:53)(cid:37)(cid:16)(cid:34)(cid:33,Unknown,6434.0
Unknown,Unknown,2,Unknown,Unknown,Unknown,Unknown,cid:12)(cid:29)(cid:26)(cid:41)(cid:25)(cid:2)(cid:53)(cid:53)(cid:37)(cid:16)(cid:34)(cid:33,Unknown,6436.0
Unknown,Unknown,28,Unknown,Unknown,Unknown,Unknown,cid:12)(cid:29)(cid:26)(cid:41)(cid:25)(cid:2)(cid:53)(cid:53)(cid:37)(cid:16)(cid:34)(cid:33,Unknown,6464.0
Unknown,Unknown,26,Unknown,Unknown,Unknown,Unknown,cid:12)(cid:29)(cid:26)(cid:41)(cid:25)(cid:2)(cid:53)(cid:53)(cid:37)(cid:16)(cid:34)(cid:33,Unknown,6490.0
Unknown,Unknown,29,Unknown,Unknown,Unknown,Unknown,cid:12)(cid:29)(cid:26)(cid:41)(cid:25)(cid:2)(cid:53)(cid:53)(cid:37)(cid:16)(cid:34)(cid:33,Unknown,6519.0
Unknown,Unknown,24,Unknown,Unknown,Unknown,Unknown,cid:12)(cid:29)(cid:26)(cid:41)(cid:25)(cid:2)(cid:53)(cid:53)(cid:37)(cid:16)(cid:34)(cid:33,Unknown,6543.0
Unknown,Unknown,27,Unknown,Unknown,Unknown,Unknown,cid:12)(cid:29)(cid:26)(cid:41)(cid:25)(cid:2)(cid:53)(cid:53)(cid:37)(cid:16)(cid:34)(cid:33,Unknown,6570.0
Unknown,Unknown,2,Unknown,Unknown,Unknown,Unknown,cid:12)(cid:29)(cid:26)(cid:41)(cid:25)(cid:2)(cid:53)(cid:53)(cid:37)(cid:16)(cid:34)(cid:33,Unknown,6572.0
Unknown,Unknown,29,Unknown,Unknown,Unknown,Unknown,cid:12)(cid:29)(cid:26)(cid:41)(cid:25)(cid:2)(cid:53)(cid:53)(cid:37)(cid:16)(cid:34)(cid:33,Unknown,6601.0
Unknown,Unknown,51,Unknown,Unknown,Unknown,Unknown,cid:12)(cid:29)(cid:26)(cid:41)(cid:25)(cid:2)(cid:53)(cid:53)(cid:37)(cid:16)(cid:34)(cid:33,Unknown,6652.0
Unknown,Unknown,51,Unknown,Unknown,Unknown,Unknown,cid:12)(cid:29)(cid:26)(cid:41)(cid:25)(cid:2)(cid:53)(cid:53)(cid:37)(cid:16)(cid:34)(cid:33,Unknown,6703.0
Unknown,Unknown,24,Unknown,Unknown,Unknown,Unknown,cid:12)(cid:29)(cid:26)(cid:41)(cid:25)(cid:2)(cid:53)(cid:53)(cid:37)(cid:16)(cid:34)(cid:33,Unknown,6727.0
Unknown,Unknown,41,Unknown,Unknown,Unknown,Unknown,cid:12)(cid:29)(cid:26)(cid:41)(cid:25)(cid:2)(cid:53)(cid:53)(cid:37)(cid:16)(cid:34)(cid:33,Unknown,6768.0
Unknown,Unknown,24,Unknown,Unknown,Unknown,Unknown,cid:12)(cid:29)(cid:26)(cid:41)(cid:25)(cid:2)(cid:53)(cid:53)(cid:37)(cid:16)(cid:34)(cid:33,Unknown,6792.0
Unknown,Unknown,20,Unknown,Unknown,Unknown,Unknown,cid:12)(cid:29)(cid:26)(cid:41)(cid:25)(cid:2)(cid:53)(cid:53)(cid:37)(cid:16)(cid:34)(cid:33,Unknown,6812.0
Unknown,Unknown,30,Unknown,Unknown,Unknown,Unknown,cid:12)(cid:29)(cid:26)(cid:41)(cid:25)(cid:2)(cid:53)(cid:53)(cid:37)(cid:16)(cid:34)(cid:33,Unknown,6842.0
Unknown,Unknown,30,Unknown,Unknown,Unknown,Unknown,cid:12)(cid:29)(cid:26)(cid:41)(cid:25)(cid:2)(cid:53)(cid:53)(cid:37)(cid:16)(cid:34)(cid:33,Unknown,6872.0
Unknown,Unknown,25,Unknown,Unknown,Unknown,Unknown,cid:12)(cid:29)(cid:26)(cid:41)(cid:25)(cid:2)(cid:53)(cid:53)(cid:37)(cid:16)(cid:34)(cid:33,Unknown,6897.0
Unknown,Unknown,22,Unknown,Unknown,Unknown,Unknown,cid:12)(cid:29)(cid:26)(cid:41)(cid:25)(cid:2)(cid:53)(cid:53)(cid:37)(cid:16)(cid:34)(cid:33,Unknown,6919.0
Unknown,Unknown,27,Unknown,Unknown,Unknown,Unknown,cid:12)(cid:29)(cid:26)(cid:41)(cid:25)(cid:2)(cid:53)(cid:53)(cid:37)(cid:16)(cid:34)(cid:33,Unknown,6946.0
Unknown,Unknown,17,Unknown,Unknown,Unknown,Unknown,cid:12)(cid:29)(cid:26)(cid:41)(cid:25)(cid:2)(cid:53)(cid:53)(cid:37)(cid:16)(cid:34)(cid:33,Unknown,6963.0
Unknown,Unknown,16,Unknown,Unknown,Unknown,Unknown,cid:12)(cid:29)(cid:26)(cid:41)(cid:25)(cid:2)(cid:53)(cid:53)(cid:37)(cid:16)(cid:34)(cid:33,Unknown,6979.0
Unknown,Unknown,45,Unknown,Unknown,Unknown,Unknown,cid:12)(cid:29)(cid:26)(cid:41)(cid:25)(cid:2)(cid:53)(cid:53)(cid:37)(cid:16)(cid:34)(cid:33,Unknown,7024.0
Unknown,Unknown,18,Unknown,Unknown,Unknown,Unknown,cid:12)(cid:29)(cid:26)(cid:41)(cid:25)(cid:2)(cid:53)(cid:53)(cid:37)(cid:16)(cid:34)(cid:33,Unknown,7042.0
Unknown,Unknown,34,Unknown,Unknown,Unknown,Unknown,cid:12)(cid:29)(cid:26)(cid:41)(cid:25)(cid:2)(cid:53)(cid:53)(cid:37)(cid:16)(cid:34)(cid:33,Unknown,7076.0
Unknown,Unknown,9,Unknown,Unknown,Unknown,Unknown,cid:12)(cid:29)(cid:26)(cid:41)(cid:25)(cid:2)(cid:53)(cid:53)(cid:37)(cid:16)(cid:34)(cid:33,Unknown,7085.0
Unknown,Unknown,13,Unknown,Unknown,Unknown,Unknown,cid:12)(cid:29)(cid:26)(cid:41)(cid:25)(cid:2)(cid:53)(cid:53)(cid:37)(cid:16)(cid:34)(cid:33,Unknown,7098.0
Unknown,Unknown,39,Unknown,Unknown,Unknown,Unknown,cid:12)(cid:29)(cid:26)(cid:41)(cid:25)(cid:2)(cid:53)(cid:53)(cid:37)(cid:16)(cid:34)(cid:33,Unknown,7137.0
Unknown,Unknown,60,Unknown,Unknown,Unknown,Unknown,cid:12)(cid:29)(cid:26)(cid:41)(cid:25)(cid:2)(cid:53)(cid:53)(cid:37)(cid:16)(cid:34)(cid:33,Unknown,7197.0
Unknown,Unknown,2,Unknown,Unknown,Unknown,Unknown,cid:12)(cid:29)(cid:26)(cid:41)(cid:25)(cid:2)(cid:53)(cid:53)(cid:37)(cid:16)(cid:34)(cid:33,Unknown,7199.0
Unknown,Unknown,47,Unknown,Unknown,Unknown,Unknown,cid:12)(cid:29)(cid:26)(cid:41)(cid:25)(cid:2)(cid:53)(cid:53)(cid:37)(cid:16)(cid:34)(cid:33,Unknown,7246.0
Unknown,Unknown,5,Unknown,Unknown,Unknown,Unknown,cid:12)(cid:29)(cid:26)(cid:41)(cid:25)(cid:2)(cid:53)(cid:53)(cid:37)(cid:16)(cid:34)(cid:33,Unknown,7251.0
Unknown,Unknown,60,Unknown,Unknown,Unknown,Unknown,cid:12)(cid:29)(cid:26)(cid:41)(cid:25)(cid:2)(cid:53)(cid:53)(cid:37)(cid:16)(cid:34)(cid:33,Unknown,7311.0
Unknown,Unknown,49,Unknown,Unknown,Unknown,Unknown,cid:12)(cid:29)(cid:26)(cid:41)(cid:25)(cid:2)(cid:53)(cid:53)(cid:37)(cid:16)(cid:34)(cid:33,Unknown,7360.0
Unknown,Unknown,2,Unknown,Unknown,Unknown,Unknown,cid:12)(cid:29)(cid:26)(cid:41)(cid:25)(cid:2)(cid:53)(cid:53)(cid:37)(cid:16)(cid:34)(cid:33,Unknown,7362.0
Unknown,Unknown,10,Unknown,Unknown,Unknown,Unknown,cid:12)(cid:29)(cid:26)(cid:41)(cid:25)(cid:2)(cid:53)(cid:53)(cid:37)(cid:16)(cid:34)(cid:33,Unknown,7372.0
Unknown,Unknown,3,Unknown,Unknown,Unknown,Unknown,cid:12)(cid:29)(cid:26)(cid:41)(cid:25)(cid:2)(cid:53)(cid:53)(cid:37)(cid:16)(cid:34)(cid:33,Unknown,7375.0
Unknown,Unknown,49,Unknown,Unknown,Unknown,Unknown,cid:12)(cid:29)(cid:26)(cid:41)(cid:25)(cid:2)(cid:53)(cid:53)(cid:37)(cid:16)(cid:34)(cid:33,Unknown,7424.0
Unknown,Unknown,52,Unknown,Unknown,Unknown,Unknown,cid:12)(cid:29)(cid:26)(cid:41)(cid:25)(cid:2)(cid:53)(cid:53)(cid:37)(cid:16)(cid:34)(cid:33,Unknown,7476.0
Unknown,Unknown,5,Unknown,Unknown,Unknown,Unknown,cid:12)(cid:29)(cid:26)(cid:41)(cid:25)(cid:2)(cid:53)(cid:53)(cid:37)(cid:16)(cid:34)(cid:33,Unknown,7481.0
Unknown,Unknown,2,Unknown,Unknown,Unknown,Unknown,cid:12)(cid:29)(cid:26)(cid:41)(cid:25)(cid:2)(cid:53)(cid:53)(cid:37)(cid:16)(cid:34)(cid:33,Unknown,7483.0
Unknown,Unknown,39,Unknown,Unknown,Unknown,Unknown,cid:12)(cid:29)(cid:26)(cid:41)(cid:25)(cid:2)(cid:53)(cid:53)(cid:37)(cid:16)(cid:34)(cid:33,Unknown,7522.0
Unknown,Unknown,26,Unknown,Unknown,Unknown,Unknown,cid:12)(cid:29)(cid:26)(cid:41)(cid:25)(cid:2)(cid:53)(cid:53)(cid:37)(cid:16)(cid:34)(cid:33,Unknown,7548.0
Unknown,Unknown,24,Unknown,Unknown,Unknown,Unknown,cid:12)(cid:29)(cid:26)(cid:41)(cid:25)(cid:2)(cid:53)(cid:53)(cid:37)(cid:16)(cid:34)(cid:33,Unknown,7572.0
Unknown,Unknown,27,Unknown,Unknown,Unknown,Unknown,cid:12)(cid:29)(cid:26)(cid:41)(cid:25)(cid:2)(cid:53)(cid:53)(cid:37)(cid:16)(cid:34)(cid:33,Unknown,7599.0
Unknown,Unknown,57,Unknown,Unknown,Unknown,Unknown,cid:12)(cid:29)(cid:26)(cid:41)(cid:25)(cid:2)(cid:53)(cid:53)(cid:37)(cid:16)(cid:34)(cid:33,Unknown,7656.0
Unknown,Unknown,41,Unknown,Unknown,Unknown,Unknown,cid:12)(cid:29)(cid:26)(cid:41)(cid:25)(cid:2)(cid:53)(cid:53)(cid:37)(cid:16)(cid:34)(cid:33,Unknown,7697.0
Unknown,Unknown,24,Unknown,Unknown,Unknown,Unknown,cid:12)(cid:29)(cid:26)(cid:41)(cid:25)(cid:2)(cid:53)(cid:53)(cid:37)(cid:16)(cid:34)(cid:33,Unknown,7721.0
Unknown,Unknown,30,Unknown,Unknown,Unknown,Unknown,cid:12)(cid:29)(cid:26)(cid:41)(cid:25)(cid:2)(cid:53)(cid:53)(cid:37)(cid:16)(cid:34)(cid:33,Unknown,7751.0
Unknown,Unknown,25,Unknown,Unknown,Unknown,Unknown,cid:12)(cid:29)(cid:26)(cid:41)(cid:25)(cid:2)(cid:53)(cid:53)(cid:37)(cid:16)(cid:34)(cid:33,Unknown,7776.0
Unknown,Unknown,2,Unknown,Unknown,Unknown,Unknown,cid:12)(cid:29)(cid:26)(cid:41)(cid:25)(cid:2)(cid:53)(cid:53)(cid:37)(cid:16)(cid:34)(cid:33,Unknown,7778.0
Unknown,Unknown,38,Unknown,Unknown,Unknown,Unknown,cid:12)(cid:29)(cid:26)(cid:41)(cid:25)(cid:2)(cid:53)(cid:53)(cid:37)(cid:16)(cid:34)(cid:33,Unknown,7816.0
Unknown,Unknown,61,Unknown,Unknown,Unknown,Unknown,cid:12)(cid:29)(cid:26)(cid:41)(cid:25)(cid:2)(cid:53)(cid:53)(cid:37)(cid:16)(cid:34)(cid:33,Unknown,7877.0
Unknown,Unknown,15,Unknown,Unknown,Unknown,Unknown,cid:12)(cid:29)(cid:26)(cid:41)(cid:25)(cid:2)(cid:53)(cid:53)(cid:37)(cid:16)(cid:34)(cid:33,Unknown,7892.0
Unknown,Unknown,2,Unknown,Unknown,Unknown,Unknown,cid:12)(cid:29)(cid:26)(cid:41)(cid:25)(cid:2)(cid:53)(cid:53)(cid:37)(cid:16)(cid:34)(cid:33,Unknown,7894.0
Unknown,Unknown,36,Unknown,Unknown,Unknown,Unknown,cid:12)(cid:29)(cid:26)(cid:41)(cid:25)(cid:2)(cid:53)(cid:53)(cid:37)(cid:16)(cid:34)(cid:33,Unknown,7930.0
Unknown,Unknown,17,Unknown,Unknown,Unknown,Unknown,cid:12)(cid:29)(cid:26)(cid:41)(cid:25)(cid:2)(cid:53)(cid:53)(cid:37)(cid:16)(cid:34)(cid:33,Unknown,7947.0
Unknown,Unknown,19,Unknown,Unknown,Unknown,Unknown,cid:12)(cid:29)(cid:26)(cid:41)(cid:25)(cid:2)(cid:53)(cid:53)(cid:37)(cid:16)(cid:34)(cid:33,Unknown,7966.0
Unknown,Unknown,33,Unknown,Unknown,Unknown,Unknown,cid:12)(cid:29)(cid:26)(cid:41)(cid:25)(cid:2)(cid:53)(cid:53)(cid:37)(cid:16)(cid:34)(cid:33,Unknown,7999.0
Unknown,Unknown,35,Unknown,Unknown,Unknown,Unknown,cid:12)(cid:29)(cid:26)(cid:41)(cid:25)(cid:2)(cid:53)(cid:53)(cid:37)(cid:16)(cid:34)(cid:33,Unknown,8034.0
Unknown,Unknown,2,Unknown,Unknown,Unknown,Unknown,cid:12)(cid:29)(cid:26)(cid:41)(cid:25)(cid:2)(cid:53)(cid:53)(cid:37)(cid:16)(cid:34)(cid:33,Unknown,8036.0
Unknown,Unknown,44,Unknown,Unknown,Unknown,Unknown,cid:12)(cid:29)(cid:26)(cid:41)(cid:25)(cid:2)(cid:53)(cid:53)(cid:37)(cid:16)(cid:34)(cid:33,Unknown,8080.0
Unknown,Unknown,12,Unknown,Unknown,Unknown,Unknown,cid:12)(cid:29)(cid:26)(cid:41)(cid:25)(cid:2)(cid:53)(cid:53)(cid:37)(cid:16)(cid:34)(cid:33,Unknown,8092.0
Unknown,Unknown,29,Unknown,Unknown,Unknown,Unknown,cid:12)(cid:29)(cid:26)(cid:41)(cid:25)(cid:2)(cid:53)(cid:53)(cid:37)(cid:16)(cid:34)(cid:33,Unknown,8121.0
Unknown,Unknown,26,Unknown,Unknown,Unknown,Unknown,cid:12)(cid:29)(cid:26)(cid:41)(cid:25)(cid:2)(cid:53)(cid:53)(cid:37)(cid:16)(cid:34)(cid:33,Unknown,8147.0
Unknown,Unknown,41,Unknown,Unknown,Unknown,Unknown,cid:12)(cid:29)(cid:26)(cid:41)(cid:25)(cid:2)(cid:53)(cid:53)(cid:37)(cid:16)(cid:34)(cid:33,Unknown,8188.0
Unknown,Unknown,25,Unknown,Unknown,Unknown,Unknown,cid:12)(cid:29)(cid:26)(cid:41)(cid:25)(cid:2)(cid:53)(cid:53)(cid:37)(cid:16)(cid:34)(cid:33,Unknown,8213.0
Unknown,Unknown,2,Unknown,Unknown,Unknown,Unknown,cid:12)(cid:29)(cid:26)(cid:41)(cid:25)(cid:2)(cid:53)(cid:53)(cid:37)(cid:16)(cid:34)(cid:33,Unknown,8215.0
Unknown,Unknown,53,Unknown,Unknown,Unknown,Unknown,cid:12)(cid:29)(cid:26)(cid:41)(cid:25)(cid:2)(cid:53)(cid:53)(cid:37)(cid:16)(cid:34)(cid:33,Unknown,8268.0
Unknown,Unknown,53,Unknown,Unknown,Unknown,Unknown,cid:12)(cid:29)(cid:26)(cid:41)(cid:25)(cid:2)(cid:53)(cid:53)(cid:37)(cid:16)(cid:34)(cid:33,Unknown,8321.0
Unknown,Unknown,18,Unknown,Unknown,Unknown,Unknown,cid:12)(cid:29)(cid:26)(cid:41)(cid:25)(cid:2)(cid:53)(cid:53)(cid:37)(cid:16)(cid:34)(cid:33,Unknown,8339.0
Unknown,Unknown,1,Unknown,Unknown,Unknown,Unknown,cid:12)(cid:29)(cid:26)(cid:41)(cid:25)(cid:2)(cid:53)(cid:53)(cid:37)(cid:16)(cid:34)(cid:33,Unknown,8340.0
Unknown,Unknown,1,Unknown,Unknown,Unknown,Unknown,cid:12)(cid:29)(cid:26)(cid:41)(cid:25)(cid:2)(cid:53)(cid:53)(cid:37)(cid:16)(cid:34)(cid:33,Unknown,8341.0
Unknown,Unknown,37,Unknown,Unknown,Unknown,Unknown,cid:12)(cid:29)(cid:26)(cid:41)(cid:25)(cid:2)(cid:53)(cid:53)(cid:37)(cid:16)(cid:34)(cid:33,Unknown,8378.0
Unknown,Unknown,17,Unknown,Unknown,Unknown,Unknown,cid:12)(cid:29)(cid:26)(cid:41)(cid:25)(cid:2)(cid:53)(cid:53)(cid:37)(cid:16)(cid:34)(cid:33,Unknown,8395.0
Unknown,Unknown,16,Unknown,Unknown,Unknown,Unknown,cid:12)(cid:29)(cid:26)(cid:41)(cid:25)(cid:2)(cid:53)(cid:53)(cid:37)(cid:16)(cid:34)(cid:33,Unknown,8411.0
Unknown,Unknown,45,Unknown,Unknown,Unknown,Unknown,cid:12)(cid:29)(cid:26)(cid:41)(cid:25)(cid:2)(cid:53)(cid:53)(cid:37)(cid:16)(cid:34)(cid:33,Unknown,8456.0
Unknown,Unknown,18,Unknown,Unknown,Unknown,Unknown,cid:12)(cid:29)(cid:26)(cid:41)(cid:25)(cid:2)(cid:53)(cid:53)(cid:37)(cid:16)(cid:34)(cid:33,Unknown,8474.0
Unknown,Unknown,34,Unknown,Unknown,Unknown,Unknown,cid:12)(cid:29)(cid:26)(cid:41)(cid:25)(cid:2)(cid:53)(cid:53)(cid:37)(cid:16)(cid:34)(cid:33,Unknown,8508.0
Unknown,Unknown,7,Unknown,Unknown,Unknown,Unknown,cid:12)(cid:29)(cid:26)(cid:41)(cid:25)(cid:2)(cid:53)(cid:53)(cid:37)(cid:16)(cid:34)(cid:33,Unknown,8515.0
Unknown,Unknown,39,Unknown,Unknown,Unknown,Unknown,cid:12)(cid:29)(cid:26)(cid:41)(cid:25)(cid:2)(cid:53)(cid:53)(cid:37)(cid:16)(cid:34)(cid:33,Unknown,8554.0
Unknown,Unknown,2,Unknown,Unknown,Unknown,Unknown,cid:12)(cid:29)(cid:26)(cid:41)(cid:25)(cid:2)(cid:53)(cid:53)(cid:37)(cid:16)(cid:34)(cid:33,Unknown,8556.0
Unknown,Unknown,60,Unknown,Unknown,Unknown,Unknown,cid:12)(cid:29)(cid:26)(cid:41)(cid:25)(cid:2)(cid:53)(cid:53)(cid:37)(cid:16)(cid:34)(cid:33,Unknown,8616.0
Unknown,Unknown,11,Unknown,Unknown,Unknown,Unknown,cid:12)(cid:29)(cid:26)(cid:41)(cid:25)(cid:2)(cid:53)(cid:53)(cid:37)(cid:16)(cid:34)(cid:33,Unknown,8627.0
Unknown,Unknown,9,Unknown,Unknown,Unknown,Unknown,cid:12)(cid:29)(cid:26)(cid:41)(cid:25)(cid:2)(cid:53)(cid:53)(cid:37)(cid:16)(cid:34)(cid:33,Unknown,8636.0
Unknown,Unknown,2,Unknown,Unknown,Unknown,Unknown,cid:12)(cid:29)(cid:26)(cid:41)(cid:25)(cid:2)(cid:53)(cid:53)(cid:37)(cid:16)(cid:34)(cid:33,Unknown,8638.0
Unknown,Unknown,9,Unknown,Unknown,Unknown,Unknown,cid:12)(cid:29)(cid:26)(cid:41)(cid:25)(cid:2)(cid:53)(cid:53)(cid:37)(cid:16)(cid:34)(cid:33,Unknown,8647.0
Unknown,Unknown,13,Unknown,Unknown,Unknown,Unknown,cid:12)(cid:29)(cid:26)(cid:41)(cid:25)(cid:2)(cid:53)(cid:53)(cid:37)(cid:16)(cid:34)(cid:33,Unknown,8660.0
Unknown,Unknown,39,Unknown,Unknown,Unknown,Unknown,cid:12)(cid:29)(cid:26)(cid:41)(cid:25)(cid:2)(cid:53)(cid:53)(cid:37)(cid:16)(cid:34)(cid:33,Unknown,8699.0
Unknown,Unknown,60,Unknown,Unknown,Unknown,Unknown,cid:12)(cid:29)(cid:26)(cid:41)(cid:25)(cid:2)(cid:53)(cid:53)(cid:37)(cid:16)(cid:34)(cid:33,Unknown,8759.0
Unknown,Unknown,2,Unknown,Unknown,Unknown,Unknown,cid:12)(cid:29)(cid:26)(cid:41)(cid:25)(cid:2)(cid:53)(cid:53)(cid:37)(cid:16)(cid:34)(cid:33,Unknown,8761.0
Unknown,Unknown,39,Unknown,Unknown,Unknown,Unknown,cid:12)(cid:29)(cid:26)(cid:41)(cid:25)(cid:2)(cid:53)(cid:53)(cid:37)(cid:16)(cid:34)(cid:33,Unknown,8800.0
Unknown,Unknown,3,Unknown,Unknown,Unknown,Unknown,cid:12)(cid:29)(cid:26)(cid:41)(cid:25)(cid:2)(cid:53)(cid:53)(cid:37)(cid:16)(cid:34)(cid:33,Unknown,8803.0
Unknown,Unknown,7,Unknown,Unknown,Unknown,Unknown,cid:12)(cid:29)(cid:26)(cid:41)(cid:25)(cid:2)(cid:53)(cid:53)(cid:37)(cid:16)(cid:34)(cid:33,Unknown,8810.0
Unknown,Unknown,9,Unknown,Unknown,Unknown,Unknown,cid:12)(cid:29)(cid:26)(cid:41)(cid:25)(cid:2)(cid:53)(cid:53)(cid:37)(cid:16)(cid:34)(cid:33,Unknown,8819.0
Unknown,Unknown,13,Unknown,Unknown,Unknown,Unknown,cid:12)(cid:29)(cid:26)(cid:41)(cid:25)(cid:2)(cid:53)(cid:53)(cid:37)(cid:16)(cid:34)(cid:33,Unknown,8832.0
Unknown,Unknown,10,Unknown,Unknown,Unknown,Unknown,cid:12)(cid:29)(cid:26)(cid:41)(cid:25)(cid:2)(cid:53)(cid:53)(cid:37)(cid:16)(cid:34)(cid:33,Unknown,8842.0
Unknown,Unknown,7,Unknown,Unknown,Unknown,Unknown,cid:12)(cid:29)(cid:26)(cid:41)(cid:25)(cid:2)(cid:53)(cid:53)(cid:37)(cid:16)(cid:34)(cid:33,Unknown,8849.0
Unknown,Unknown,8,Unknown,Unknown,Unknown,Unknown,cid:12)(cid:29)(cid:26)(cid:41)(cid:25)(cid:2)(cid:53)(cid:53)(cid:37)(cid:16)(cid:34)(cid:33,Unknown,8857.0
Unknown,Unknown,49,Unknown,Unknown,Unknown,Unknown,cid:12)(cid:29)(cid:26)(cid:41)(cid:25)(cid:2)(cid:53)(cid:53)(cid:37)(cid:16)(cid:34)(cid:33,Unknown,8906.0
Unknown,Unknown,2,Unknown,Unknown,Unknown,Unknown,cid:12)(cid:29)(cid:26)(cid:41)(cid:25)(cid:2)(cid:53)(cid:53)(cid:37)(cid:16)(cid:34)(cid:33,Unknown,8908.0
Unknown,Unknown,38,Unknown,Unknown,Unknown,Unknown,cid:12)(cid:29)(cid:26)(cid:41)(cid:25)(cid:2)(cid:53)(cid:53)(cid:37)(cid:16)(cid:34)(cid:33,Unknown,8946.0
Unknown,Unknown,61,Unknown,Unknown,Unknown,Unknown,cid:12)(cid:29)(cid:26)(cid:41)(cid:25)(cid:2)(cid:53)(cid:53)(cid:37)(cid:16)(cid:34)(cid:33,Unknown,9007.0
Unknown,Unknown,15,Unknown,Unknown,Unknown,Unknown,cid:12)(cid:29)(cid:26)(cid:41)(cid:25)(cid:2)(cid:53)(cid:53)(cid:37)(cid:16)(cid:34)(cid:33,Unknown,9022.0
Unknown,Unknown,2,Unknown,Unknown,Unknown,Unknown,cid:12)(cid:29)(cid:26)(cid:41)(cid:25)(cid:2)(cid:53)(cid:53)(cid:37)(cid:16)(cid:34)(cid:33,Unknown,9024.0
Unknown,Unknown,33,Unknown,Unknown,Unknown,Unknown,cid:12)(cid:29)(cid:26)(cid:41)(cid:25)(cid:2)(cid:53)(cid:53)(cid:37)(cid:16)(cid:34)(cid:33,Unknown,9057.0
Unknown,Unknown,34,Unknown,Unknown,Unknown,Unknown,cid:12)(cid:29)(cid:26)(cid:41)(cid:25)(cid:2)(cid:53)(cid:53)(cid:37)(cid:16)(cid:34)(cid:33,Unknown,9091.0
Unknown,Unknown,19,Unknown,Unknown,Unknown,Unknown,cid:12)(cid:29)(cid:26)(cid:41)(cid:25)(cid:2)(cid:53)(cid:53)(cid:37)(cid:16)(cid:34)(cid:33,Unknown,9110.0
Unknown,Unknown,18,Unknown,Unknown,Unknown,Unknown,cid:12)(cid:29)(cid:26)(cid:41)(cid:25)(cid:2)(cid:53)(cid:53)(cid:37)(cid:16)(cid:34)(cid:33,Unknown,9128.0
Unknown,Unknown,18,Unknown,Unknown,Unknown,Unknown,cid:12)(cid:29)(cid:26)(cid:41)(cid:25)(cid:2)(cid:53)(cid:53)(cid:37)(cid:16)(cid:34)(cid:33,Unknown,9146.0
Unknown,Unknown,2,Unknown,Unknown,Unknown,Unknown,cid:12)(cid:29)(cid:26)(cid:41)(cid:25)(cid:2)(cid:53)(cid:53)(cid:37)(cid:16)(cid:34)(cid:33,Unknown,9148.0
Unknown,Unknown,44,Unknown,Unknown,Unknown,Unknown,cid:12)(cid:29)(cid:26)(cid:41)(cid:25)(cid:2)(cid:53)(cid:53)(cid:37)(cid:16)(cid:34)(cid:33,Unknown,9192.0
Unknown,Unknown,12,Unknown,Unknown,Unknown,Unknown,cid:12)(cid:29)(cid:26)(cid:41)(cid:25)(cid:2)(cid:53)(cid:53)(cid:37)(cid:16)(cid:34)(cid:33,Unknown,9204.0
Unknown,Unknown,29,Unknown,Unknown,Unknown,Unknown,cid:12)(cid:29)(cid:26)(cid:41)(cid:25)(cid:2)(cid:53)(cid:53)(cid:37)(cid:16)(cid:34)(cid:33,Unknown,9233.0
Unknown,Unknown,26,Unknown,Unknown,Unknown,Unknown,cid:12)(cid:29)(cid:26)(cid:41)(cid:25)(cid:2)(cid:53)(cid:53)(cid:37)(cid:16)(cid:34)(cid:33,Unknown,9259.0
Unknown,Unknown,41,Unknown,Unknown,Unknown,Unknown,cid:12)(cid:29)(cid:26)(cid:41)(cid:25)(cid:2)(cid:53)(cid:53)(cid:37)(cid:16)(cid:34)(cid:33,Unknown,9300.0
Unknown,Unknown,25,Unknown,Unknown,Unknown,Unknown,cid:12)(cid:29)(cid:26)(cid:41)(cid:25)(cid:2)(cid:53)(cid:53)(cid:37)(cid:16)(cid:34)(cid:33,Unknown,9325.0
Unknown,Unknown,2,Unknown,Unknown,Unknown,Unknown,cid:12)(cid:29)(cid:26)(cid:41)(cid:25)(cid:2)(cid:53)(cid:53)(cid:37)(cid:16)(cid:34)(cid:33,Unknown,9327.0
Unknown,Unknown,53,Unknown,Unknown,Unknown,Unknown,cid:12)(cid:29)(cid:26)(cid:41)(cid:25)(cid:2)(cid:53)(cid:53)(cid:37)(cid:16)(cid:34)(cid:33,Unknown,9380.0
Unknown,Unknown,53,Unknown,Unknown,Unknown,Unknown,cid:12)(cid:29)(cid:26)(cid:41)(cid:25)(cid:2)(cid:53)(cid:53)(cid:37)(cid:16)(cid:34)(cid:33,Unknown,9433.0
Unknown,Unknown,18,Unknown,Unknown,Unknown,Unknown,cid:12)(cid:29)(cid:26)(cid:41)(cid:25)(cid:2)(cid:53)(cid:53)(cid:37)(cid:16)(cid:34)(cid:33,Unknown,9451.0
Unknown,Unknown,1,Unknown,Unknown,Unknown,Unknown,cid:12)(cid:29)(cid:26)(cid:41)(cid:25)(cid:2)(cid:53)(cid:53)(cid:37)(cid:16)(cid:34)(cid:33,Unknown,9452.0
Unknown,Unknown,1,Unknown,Unknown,Unknown,Unknown,cid:12)(cid:29)(cid:26)(cid:41)(cid:25)(cid:2)(cid:53)(cid:53)(cid:37)(cid:16)(cid:34)(cid:33,Unknown,9453.0
Unknown,Unknown,37,Unknown,Unknown,Unknown,Unknown,cid:12)(cid:29)(cid:26)(cid:41)(cid:25)(cid:2)(cid:53)(cid:53)(cid:37)(cid:16)(cid:34)(cid:33,Unknown,9490.0
Unknown,Unknown,17,Unknown,Unknown,Unknown,Unknown,cid:12)(cid:29)(cid:26)(cid:41)(cid:25)(cid:2)(cid:53)(cid:53)(cid:37)(cid:16)(cid:34)(cid:33,Unknown,9507.0
Unknown,Unknown,33,Unknown,Unknown,Unknown,Unknown,cid:12)(cid:29)(cid:26)(cid:41)(cid:25)(cid:2)(cid:53)(cid:53)(cid:37)(cid:16)(cid:34)(cid:33,Unknown,9540.0
Unknown,Unknown,45,Unknown,Unknown,Unknown,Unknown,cid:12)(cid:29)(cid:26)(cid:41)(cid:25)(cid:2)(cid:53)(cid:53)(cid:37)(cid:16)(cid:34)(cid:33,Unknown,9585.0
Unknown,Unknown,18,Unknown,Unknown,Unknown,Unknown,cid:12)(cid:29)(cid:26)(cid:41)(cid:25)(cid:2)(cid:53)(cid:53)(cid:37)(cid:16)(cid:34)(cid:33,Unknown,9603.0
Unknown,Unknown,34,Unknown,Unknown,Unknown,Unknown,cid:12)(cid:29)(cid:26)(cid:41)(cid:25)(cid:2)(cid:53)(cid:53)(cid:37)(cid:16)(cid:34)(cid:33,Unknown,9637.0
Unknown,Unknown,35,Unknown,Unknown,Unknown,Unknown,cid:12)(cid:29)(cid:26)(cid:41)(cid:25)(cid:2)(cid:53)(cid:53)(cid:37)(cid:16)(cid:34)(cid:33,Unknown,9672.0
Unknown,Unknown,17,Unknown,Unknown,Unknown,Unknown,cid:12)(cid:29)(cid:26)(cid:41)(cid:25)(cid:2)(cid:53)(cid:53)(cid:37)(cid:16)(cid:34)(cid:33,Unknown,9689.0
Unknown,Unknown,18,Unknown,Unknown,Unknown,Unknown,cid:12)(cid:29)(cid:26)(cid:41)(cid:25)(cid:2)(cid:53)(cid:53)(cid:37)(cid:16)(cid:34)(cid:33,Unknown,9707.0
Unknown,Unknown,2,Unknown,Unknown,Unknown,Unknown,cid:12)(cid:29)(cid:26)(cid:41)(cid:25)(cid:2)(cid:53)(cid:53)(cid:37)(cid:16)(cid:34)(cid:33,Unknown,9709.0
Unknown,Unknown,62,Unknown,Unknown,Unknown,Unknown,cid:12)(cid:29)(cid:26)(cid:41)(cid:25)(cid:2)(cid:53)(cid:53)(cid:37)(cid:16)(cid:34)(cid:33,Unknown,9771.0
Unknown,Unknown,49,Unknown,Unknown,Unknown,Unknown,cid:12)(cid:29)(cid:26)(cid:41)(cid:25)(cid:2)(cid:53)(cid:53)(cid:37)(cid:16)(cid:34)(cid:33,Unknown,9820.0
Unknown,Unknown,14,Unknown,Unknown,Unknown,Unknown,cid:12)(cid:29)(cid:26)(cid:41)(cid:25)(cid:2)(cid:53)(cid:53)(cid:37)(cid:16)(cid:34)(cid:33,Unknown,9834.0
Unknown,Unknown,7,Unknown,Unknown,Unknown,Unknown,cid:12)(cid:29)(cid:26)(cid:41)(cid:25)(cid:2)(cid:53)(cid:53)(cid:37)(cid:16)(cid:34)(cid:33,Unknown,9841.0
Unknown,Unknown,2,Unknown,Unknown,Unknown,Unknown,cid:12)(cid:29)(cid:26)(cid:41)(cid:25)(cid:2)(cid:53)(cid:53)(cid:37)(cid:16)(cid:34)(cid:33,Unknown,9843.0
Unknown,Unknown,39,Unknown,Unknown,Unknown,Unknown,cid:12)(cid:29)(cid:26)(cid:41)(cid:25)(cid:2)(cid:53)(cid:53)(cid:37)(cid:16)(cid:34)(cid:33,Unknown,9882.0
Unknown,Unknown,11,Unknown,Unknown,Unknown,Unknown,cid:12)(cid:29)(cid:26)(cid:41)(cid:25)(cid:2)(cid:53)(cid:53)(cid:37)(cid:16)(cid:34)(cid:33,Unknown,9893.0
Unknown,Unknown,61,Unknown,Unknown,Unknown,Unknown,cid:12)(cid:29)(cid:26)(cid:41)(cid:25)(cid:2)(cid:53)(cid:53)(cid:37)(cid:16)(cid:34)(cid:33,Unknown,9954.0
Unknown,Unknown,49,Unknown,Unknown,Unknown,Unknown,cid:12)(cid:29)(cid:26)(cid:41)(cid:25)(cid:2)(cid:53)(cid:53)(cid:37)(cid:16)(cid:34)(cid:33,Unknown,10003.0
Unknown,Unknown,3,Unknown,Unknown,Unknown,Unknown,cid:12)(cid:29)(cid:26)(cid:41)(cid:25)(cid:2)(cid:53)(cid:53)(cid:37)(cid:16)(cid:34)(cid:33,Unknown,10006.0
Unknown,Unknown,5,Unknown,Unknown,Unknown,Unknown,cid:12)(cid:29)(cid:26)(cid:41)(cid:25)(cid:2)(cid:53)(cid:53)(cid:37)(cid:16)(cid:34)(cid:33,Unknown,10011.0
Unknown,Unknown,63,Unknown,Unknown,Unknown,Unknown,cid:12)(cid:29)(cid:26)(cid:41)(cid:25)(cid:2)(cid:53)(cid:53)(cid:37)(cid:16)(cid:34)(cid:33,Unknown,10074.0
Unknown,Unknown,49,Unknown,Unknown,Unknown,Unknown,cid:12)(cid:29)(cid:26)(cid:41)(cid:25)(cid:2)(cid:53)(cid:53)(cid:37)(cid:16)(cid:34)(cid:33,Unknown,10123.0
Unknown,Unknown,12,Unknown,Unknown,Unknown,Unknown,cid:12)(cid:29)(cid:26)(cid:41)(cid:25)(cid:2)(cid:53)(cid:53)(cid:37)(cid:16)(cid:34)(cid:33,Unknown,10135.0
Unknown,Unknown,2,Unknown,Unknown,Unknown,Unknown,cid:12)(cid:29)(cid:26)(cid:41)(cid:25)(cid:2)(cid:53)(cid:53)(cid:37)(cid:16)(cid:34)(cid:33,Unknown,10137.0
Unknown,Unknown,39,Unknown,Unknown,Unknown,Unknown,cid:12)(cid:29)(cid:26)(cid:41)(cid:25)(cid:2)(cid:53)(cid:53)(cid:37)(cid:16)(cid:34)(cid:33,Unknown,10176.0
Unknown,Unknown,11,Unknown,Unknown,Unknown,Unknown,cid:12)(cid:29)(cid:26)(cid:41)(cid:25)(cid:2)(cid:53)(cid:53)(cid:37)(cid:16)(cid:34)(cid:33,Unknown,10187.0
Unknown,Unknown,61,Unknown,Unknown,Unknown,Unknown,cid:12)(cid:29)(cid:26)(cid:41)(cid:25)(cid:2)(cid:53)(cid:53)(cid:37)(cid:16)(cid:34)(cid:33,Unknown,10248.0
Unknown,Unknown,49,Unknown,Unknown,Unknown,Unknown,cid:12)(cid:29)(cid:26)(cid:41)(cid:25)(cid:2)(cid:53)(cid:53)(cid:37)(cid:16)(cid:34)(cid:33,Unknown,10297.0
Unknown,Unknown,3,Unknown,Unknown,Unknown,Unknown,cid:12)(cid:29)(cid:26)(cid:41)(cid:25)(cid:2)(cid:53)(cid:53)(cid:37)(cid:16)(cid:34)(cid:33,Unknown,10300.0
Unknown,Unknown,5,Unknown,Unknown,Unknown,Unknown,cid:12)(cid:29)(cid:26)(cid:41)(cid:25)(cid:2)(cid:53)(cid:53)(cid:37)(cid:16)(cid:34)(cid:33,Unknown,10305.0
Unknown,Unknown,63,Unknown,Unknown,Unknown,Unknown,cid:12)(cid:29)(cid:26)(cid:41)(cid:25)(cid:2)(cid:53)(cid:53)(cid:37)(cid:16)(cid:34)(cid:33,Unknown,10368.0
Unknown,Unknown,49,Unknown,Unknown,Unknown,Unknown,cid:12)(cid:29)(cid:26)(cid:41)(cid:25)(cid:2)(cid:53)(cid:53)(cid:37)(cid:16)(cid:34)(cid:33,Unknown,10417.0
Unknown,Unknown,12,Unknown,Unknown,Unknown,Unknown,cid:12)(cid:29)(cid:26)(cid:41)(cid:25)(cid:2)(cid:53)(cid:53)(cid:37)(cid:16)(cid:34)(cid:33,Unknown,10429.0
Unknown,Unknown,2,Unknown,Unknown,Unknown,Unknown,cid:12)(cid:29)(cid:26)(cid:41)(cid:25)(cid:2)(cid:53)(cid:53)(cid:37)(cid:16)(cid:34)(cid:33,Unknown,10431.0
Unknown,Unknown,3,Unknown,Unknown,Unknown,Unknown,cid:12)(cid:29)(cid:26)(cid:41)(cid:25)(cid:2)(cid:53)(cid:53)(cid:37)(cid:16)(cid:34)(cid:33,Unknown,10434.0
Unknown,Unknown,9,Unknown,Unknown,Unknown,Unknown,cid:12)(cid:29)(cid:26)(cid:41)(cid:25)(cid:2)(cid:53)(cid:53)(cid:37)(cid:16)(cid:34)(cid:33,Unknown,10443.0
Unknown,Unknown,15,Unknown,Unknown,Unknown,Unknown,cid:12)(cid:29)(cid:26)(cid:41)(cid:25)(cid:2)(cid:53)(cid:53)(cid:37)(cid:16)(cid:34)(cid:33,Unknown,10458.0
Unknown,Unknown,2,Unknown,Unknown,Unknown,Unknown,cid:12)(cid:29)(cid:26)(cid:41)(cid:25)(cid:2)(cid:53)(cid:53)(cid:37)(cid:16)(cid:34)(cid:33,Unknown,10460.0
Unknown,Unknown,17,Unknown,Unknown,Unknown,Unknown,cid:12)(cid:29)(cid:26)(cid:41)(cid:25)(cid:2)(cid:53)(cid:53)(cid:37)(cid:16)(cid:34)(cid:33,Unknown,10477.0
Unknown,Unknown,19,Unknown,Unknown,Unknown,Unknown,cid:12)(cid:29)(cid:26)(cid:41)(cid:25)(cid:2)(cid:53)(cid:53)(cid:37)(cid:16)(cid:34)(cid:33,Unknown,10496.0
Unknown,Unknown,16,Unknown,Unknown,Unknown,Unknown,cid:12)(cid:29)(cid:26)(cid:41)(cid:25)(cid:2)(cid:53)(cid:53)(cid:37)(cid:16)(cid:34)(cid:33,Unknown,10512.0
Unknown,Unknown,17,Unknown,Unknown,Unknown,Unknown,cid:12)(cid:29)(cid:26)(cid:41)(cid:25)(cid:2)(cid:53)(cid:53)(cid:37)(cid:16)(cid:34)(cid:33,Unknown,10529.0
Unknown,Unknown,2,Unknown,Unknown,Unknown,Unknown,cid:12)(cid:29)(cid:26)(cid:41)(cid:25)(cid:2)(cid:53)(cid:53)(cid:37)(cid:16)(cid:34)(cid:33,Unknown,10531.0
Unknown,Unknown,44,Unknown,Unknown,Unknown,Unknown,cid:12)(cid:29)(cid:26)(cid:41)(cid:25)(cid:2)(cid:53)(cid:53)(cid:37)(cid:16)(cid:34)(cid:33,Unknown,10575.0
Unknown,Unknown,17,Unknown,Unknown,Unknown,Unknown,cid:12)(cid:29)(cid:26)(cid:41)(cid:25)(cid:2)(cid:53)(cid:53)(cid:37)(cid:16)(cid:34)(cid:33,Unknown,10592.0
Unknown,Unknown,17,Unknown,Unknown,Unknown,Unknown,cid:12)(cid:29)(cid:26)(cid:41)(cid:25)(cid:2)(cid:53)(cid:53)(cid:37)(cid:16)(cid:34)(cid:33,Unknown,10609.0
Unknown,Unknown,32,Unknown,Unknown,Unknown,Unknown,cid:12)(cid:29)(cid:26)(cid:41)(cid:25)(cid:2)(cid:53)(cid:53)(cid:37)(cid:16)(cid:34)(cid:33,Unknown,10641.0
Unknown,Unknown,19,Unknown,Unknown,Unknown,Unknown,cid:12)(cid:29)(cid:26)(cid:41)(cid:25)(cid:2)(cid:53)(cid:53)(cid:37)(cid:16)(cid:34)(cid:33,Unknown,10660.0
Unknown,Unknown,33,Unknown,Unknown,Unknown,Unknown,cid:12)(cid:29)(cid:26)(cid:41)(cid:25)(cid:2)(cid:53)(cid:53)(cid:37)(cid:16)(cid:34)(cid:33,Unknown,10693.0
Unknown,Unknown,34,Unknown,Unknown,Unknown,Unknown,cid:12)(cid:29)(cid:26)(cid:41)(cid:25)(cid:2)(cid:53)(cid:53)(cid:37)(cid:16)(cid:34)(cid:33,Unknown,10727.0
Unknown,Unknown,33,Unknown,Unknown,Unknown,Unknown,cid:12)(cid:29)(cid:26)(cid:41)(cid:25)(cid:2)(cid:53)(cid:53)(cid:37)(cid:16)(cid:34)(cid:33,Unknown,10760.0
Unknown,Unknown,18,Unknown,Unknown,Unknown,Unknown,cid:12)(cid:29)(cid:26)(cid:41)(cid:25)(cid:2)(cid:53)(cid:53)(cid:37)(cid:16)(cid:34)(cid:33,Unknown,10778.0
Unknown,Unknown,32,Unknown,Unknown,Unknown,Unknown,cid:12)(cid:29)(cid:26)(cid:41)(cid:25)(cid:2)(cid:53)(cid:53)(cid:37)(cid:16)(cid:34)(cid:33,Unknown,10810.0
Unknown,Unknown,36,Unknown,Unknown,Unknown,Unknown,cid:12)(cid:29)(cid:26)(cid:41)(cid:25)(cid:2)(cid:53)(cid:53)(cid:37)(cid:16)(cid:34)(cid:33,Unknown,10846.0
Unknown,Unknown,37,Unknown,Unknown,Unknown,Unknown,cid:12)(cid:29)(cid:26)(cid:41)(cid:25)(cid:2)(cid:53)(cid:53)(cid:37)(cid:16)(cid:34)(cid:33,Unknown,10883.0
Unknown,Unknown,1,Unknown,Unknown,Unknown,Unknown,cid:12)(cid:29)(cid:26)(cid:41)(cid:25)(cid:2)(cid:53)(cid:53)(cid:37)(cid:16)(cid:34)(cid:33,Unknown,10884.0
Unknown,Unknown,16,Unknown,Unknown,Unknown,Unknown,cid:12)(cid:29)(cid:26)(cid:41)(cid:25)(cid:2)(cid:53)(cid:53)(cid:37)(cid:16)(cid:34)(cid:33,Unknown,10900.0
Unknown,Unknown,36,Unknown,Unknown,Unknown,Unknown,cid:12)(cid:29)(cid:26)(cid:41)(cid:25)(cid:2)(cid:53)(cid:53)(cid:37)(cid:16)(cid:34)(cid:33,Unknown,10936.0
Unknown,Unknown,35,Unknown,Unknown,Unknown,Unknown,cid:12)(cid:29)(cid:26)(cid:41)(cid:25)(cid:2)(cid:53)(cid:53)(cid:37)(cid:16)(cid:34)(cid:33,Unknown,10971.0
Unknown,Unknown,34,Unknown,Unknown,Unknown,Unknown,cid:12)(cid:29)(cid:26)(cid:41)(cid:25)(cid:2)(cid:53)(cid:53)(cid:37)(cid:16)(cid:34)(cid:33,Unknown,11005.0
Unknown,Unknown,2,Unknown,Unknown,Unknown,Unknown,cid:12)(cid:29)(cid:26)(cid:41)(cid:25)(cid:2)(cid:53)(cid:53)(cid:37)(cid:16)(cid:34)(cid:33,Unknown,11007.0
Unknown,Unknown,1,Unknown,Unknown,Unknown,Unknown,cid:12)(cid:29)(cid:26)(cid:41)(cid:25)(cid:2)(cid:53)(cid:53)(cid:37)(cid:16)(cid:34)(cid:33,Unknown,11008.0
Unknown,Unknown,2,Unknown,Unknown,Unknown,Unknown,cid:12)(cid:29)(cid:26)(cid:41)(cid:25)(cid:2)(cid:53)(cid:53)(cid:37)(cid:16)(cid:34)(cid:33,Unknown,11010.0
Unknown,Unknown,3,Unknown,Unknown,Unknown,Unknown,cid:12)(cid:29)(cid:26)(cid:41)(cid:25)(cid:2)(cid:53)(cid:53)(cid:37)(cid:16)(cid:34)(cid:33,Unknown,11013.0
Unknown,Unknown,2,Unknown,Unknown,Unknown,Unknown,cid:12)(cid:29)(cid:26)(cid:41)(cid:25)(cid:2)(cid:53)(cid:53)(cid:37)(cid:16)(cid:34)(cid:33,Unknown,11015.0
Unknown,Unknown,64,Unknown,Unknown,Unknown,Unknown,cid:12)(cid:29)(cid:26)(cid:41)(cid:25)(cid:2)(cid:53)(cid:53)(cid:37)(cid:16)(cid:34)(cid:33,Unknown,11079.0
Unknown,Unknown,2,Unknown,Unknown,Unknown,Unknown,cid:12)(cid:29)(cid:26)(cid:41)(cid:25)(cid:2)(cid:53)(cid:53)(cid:37)(cid:16)(cid:34)(cid:33,Unknown,11081.0
Unknown,Unknown,17,Unknown,Unknown,Unknown,Unknown,cid:12)(cid:29)(cid:26)(cid:41)(cid:25)(cid:2)(cid:53)(cid:53)(cid:37)(cid:16)(cid:34)(cid:33,Unknown,11098.0
Unknown,Unknown,19,Unknown,Unknown,Unknown,Unknown,cid:12)(cid:29)(cid:26)(cid:41)(cid:25)(cid:2)(cid:53)(cid:53)(cid:37)(cid:16)(cid:34)(cid:33,Unknown,11117.0
Unknown,Unknown,18,Unknown,Unknown,Unknown,Unknown,cid:12)(cid:29)(cid:26)(cid:41)(cid:25)(cid:2)(cid:53)(cid:53)(cid:37)(cid:16)(cid:34)(cid:33,Unknown,11135.0
Unknown,Unknown,18,Unknown,Unknown,Unknown,Unknown,cid:12)(cid:29)(cid:26)(cid:41)(cid:25)(cid:2)(cid:53)(cid:53)(cid:37)(cid:16)(cid:34)(cid:33,Unknown,11153.0
Unknown,Unknown,2,Unknown,Unknown,Unknown,Unknown,cid:12)(cid:29)(cid:26)(cid:41)(cid:25)(cid:2)(cid:53)(cid:53)(cid:37)(cid:16)(cid:34)(cid:33,Unknown,11155.0
Unknown,Unknown,44,Unknown,Unknown,Unknown,Unknown,cid:12)(cid:29)(cid:26)(cid:41)(cid:25)(cid:2)(cid:53)(cid:53)(cid:37)(cid:16)(cid:34)(cid:33,Unknown,11199.0
Unknown,Unknown,15,Unknown,Unknown,Unknown,Unknown,cid:12)(cid:29)(cid:26)(cid:41)(cid:25)(cid:2)(cid:53)(cid:53)(cid:37)(cid:16)(cid:34)(cid:33,Unknown,11214.0
Unknown,Unknown,2,Unknown,Unknown,Unknown,Unknown,cid:12)(cid:29)(cid:26)(cid:41)(cid:25)(cid:2)(cid:53)(cid:53)(cid:37)(cid:16)(cid:34)(cid:33,Unknown,11216.0
Unknown,Unknown,1,Unknown,Unknown,Unknown,Unknown,cid:12)(cid:29)(cid:26)(cid:41)(cid:25)(cid:2)(cid:53)(cid:53)(cid:37)(cid:16)(cid:34)(cid:33,Unknown,11217.0
Unknown,Unknown,18,Unknown,Unknown,Unknown,Unknown,cid:12)(cid:29)(cid:26)(cid:41)(cid:25)(cid:2)(cid:53)(cid:53)(cid:37)(cid:16)(cid:34)(cid:33,Unknown,11235.0
Unknown,Unknown,18,Unknown,Unknown,Unknown,Unknown,cid:12)(cid:29)(cid:26)(cid:41)(cid:25)(cid:2)(cid:53)(cid:53)(cid:37)(cid:16)(cid:34)(cid:33,Unknown,11253.0
Unknown,Unknown,19,Unknown,Unknown,Unknown,Unknown,cid:12)(cid:29)(cid:26)(cid:41)(cid:25)(cid:2)(cid:53)(cid:53)(cid:37)(cid:16)(cid:34)(cid:33,Unknown,11272.0
Unknown,Unknown,18,Unknown,Unknown,Unknown,Unknown,cid:12)(cid:29)(cid:26)(cid:41)(cid:25)(cid:2)(cid:53)(cid:53)(cid:37)(cid:16)(cid:34)(cid:33,Unknown,11290.0
Unknown,Unknown,18,Unknown,Unknown,Unknown,Unknown,cid:12)(cid:29)(cid:26)(cid:41)(cid:25)(cid:2)(cid:53)(cid:53)(cid:37)(cid:16)(cid:34)(cid:33,Unknown,11308.0
Unknown,Unknown,2,Unknown,Unknown,Unknown,Unknown,cid:12)(cid:29)(cid:26)(cid:41)(cid:25)(cid:2)(cid:53)(cid:53)(cid:37)(cid:16)(cid:34)(cid:33,Unknown,11310.0
Unknown,Unknown,1,Unknown,Unknown,Unknown,Unknown,cid:12)(cid:29)(cid:26)(cid:41)(cid:25)(cid:2)(cid:53)(cid:53)(cid:37)(cid:16)(cid:34)(cid:33,Unknown,11311.0
Unknown,Unknown,2,Unknown,Unknown,Unknown,Unknown,cid:12)(cid:29)(cid:26)(cid:41)(cid:25)(cid:2)(cid:53)(cid:53)(cid:37)(cid:16)(cid:34)(cid:33,Unknown,11313.0
Unknown,Unknown,3,Unknown,Unknown,Unknown,Unknown,cid:12)(cid:29)(cid:26)(cid:41)(cid:25)(cid:2)(cid:53)(cid:53)(cid:37)(cid:16)(cid:34)(cid:33,Unknown,11316.0
Unknown,Unknown,12,Unknown,Unknown,Unknown,Unknown,cid:12)(cid:29)(cid:26)(cid:41)(cid:25)(cid:2)(cid:53)(cid:53)(cid:37)(cid:16)(cid:34)(cid:33,Unknown,11328.0
Unknown,Unknown,29,Unknown,Unknown,Unknown,Unknown,cid:12)(cid:29)(cid:26)(cid:41)(cid:25)(cid:2)(cid:53)(cid:53)(cid:37)(cid:16)(cid:34)(cid:33,Unknown,11357.0
Unknown,Unknown,26,Unknown,Unknown,Unknown,Unknown,cid:12)(cid:29)(cid:26)(cid:41)(cid:25)(cid:2)(cid:53)(cid:53)(cid:37)(cid:16)(cid:34)(cid:33,Unknown,11383.0
Unknown,Unknown,41,Unknown,Unknown,Unknown,Unknown,cid:12)(cid:29)(cid:26)(cid:41)(cid:25)(cid:2)(cid:53)(cid:53)(cid:37)(cid:16)(cid:34)(cid:33,Unknown,11424.0
Unknown,Unknown,25,Unknown,Unknown,Unknown,Unknown,cid:12)(cid:29)(cid:26)(cid:41)(cid:25)(cid:2)(cid:53)(cid:53)(cid:37)(cid:16)(cid:34)(cid:33,Unknown,11449.0
Unknown,Unknown,2,Unknown,Unknown,Unknown,Unknown,cid:12)(cid:29)(cid:26)(cid:41)(cid:25)(cid:2)(cid:53)(cid:53)(cid:37)(cid:16)(cid:34)(cid:33,Unknown,11451.0
Unknown,Unknown,53,Unknown,Unknown,Unknown,Unknown,cid:12)(cid:29)(cid:26)(cid:41)(cid:25)(cid:2)(cid:53)(cid:53)(cid:37)(cid:16)(cid:34)(cid:33,Unknown,11504.0
Unknown,Unknown,53,Unknown,Unknown,Unknown,Unknown,cid:12)(cid:29)(cid:26)(cid:41)(cid:25)(cid:2)(cid:53)(cid:53)(cid:37)(cid:16)(cid:34)(cid:33,Unknown,11557.0
Unknown,Unknown,18,Unknown,Unknown,Unknown,Unknown,cid:12)(cid:29)(cid:26)(cid:41)(cid:25)(cid:2)(cid:53)(cid:53)(cid:37)(cid:16)(cid:34)(cid:33,Unknown,11575.0
Unknown,Unknown,1,Unknown,Unknown,Unknown,Unknown,cid:12)(cid:29)(cid:26)(cid:41)(cid:25)(cid:2)(cid:53)(cid:53)(cid:37)(cid:16)(cid:34)(cid:33,Unknown,11576.0
Unknown,Unknown,1,Unknown,Unknown,Unknown,Unknown,cid:12)(cid:29)(cid:26)(cid:41)(cid:25)(cid:2)(cid:53)(cid:53)(cid:37)(cid:16)(cid:34)(cid:33,Unknown,11577.0
Unknown,Unknown,37,Unknown,Unknown,Unknown,Unknown,cid:12)(cid:29)(cid:26)(cid:41)(cid:25)(cid:2)(cid:53)(cid:53)(cid:37)(cid:16)(cid:34)(cid:33,Unknown,11614.0
Unknown,Unknown,1,Unknown,Unknown,Unknown,Unknown,cid:12)(cid:29)(cid:26)(cid:41)(cid:25)(cid:2)(cid:53)(cid:53)(cid:37)(cid:16)(cid:34)(cid:33,Unknown,11615.0
Unknown,Unknown,18,Unknown,Unknown,Unknown,Unknown,cid:12)(cid:29)(cid:26)(cid:41)(cid:25)(cid:2)(cid:53)(cid:53)(cid:37)(cid:16)(cid:34)(cid:33,Unknown,11633.0
Unknown,Unknown,45,Unknown,Unknown,Unknown,Unknown,cid:12)(cid:29)(cid:26)(cid:41)(cid:25)(cid:2)(cid:53)(cid:53)(cid:37)(cid:16)(cid:34)(cid:33,Unknown,11678.0
Unknown,Unknown,18,Unknown,Unknown,Unknown,Unknown,cid:12)(cid:29)(cid:26)(cid:41)(cid:25)(cid:2)(cid:53)(cid:53)(cid:37)(cid:16)(cid:34)(cid:33,Unknown,11696.0
Unknown,Unknown,34,Unknown,Unknown,Unknown,Unknown,cid:12)(cid:29)(cid:26)(cid:41)(cid:25)(cid:2)(cid:53)(cid:53)(cid:37)(cid:16)(cid:34)(cid:33,Unknown,11730.0
Unknown,Unknown,3,Unknown,Unknown,Unknown,Unknown,cid:12)(cid:29)(cid:26)(cid:41)(cid:25)(cid:2)(cid:53)(cid:53)(cid:37)(cid:16)(cid:34)(cid:33,Unknown,11733.0
Unknown,Unknown,5,Unknown,Unknown,Unknown,Unknown,cid:12)(cid:29)(cid:26)(cid:41)(cid:25)(cid:2)(cid:53)(cid:53)(cid:37)(cid:16)(cid:34)(cid:33,Unknown,11738.0
Unknown,Unknown,9,Unknown,Unknown,Unknown,Unknown,cid:12)(cid:29)(cid:26)(cid:41)(cid:25)(cid:2)(cid:53)(cid:53)(cid:37)(cid:16)(cid:34)(cid:33,Unknown,11747.0
Unknown,Unknown,10,Unknown,Unknown,Unknown,Unknown,cid:12)(cid:29)(cid:26)(cid:41)(cid:25)(cid:2)(cid:53)(cid:53)(cid:37)(cid:16)(cid:34)(cid:33,Unknown,11757.0
Unknown,Unknown,49,Unknown,Unknown,Unknown,Unknown,cid:12)(cid:29)(cid:26)(cid:41)(cid:25)(cid:2)(cid:53)(cid:53)(cid:37)(cid:16)(cid:34)(cid:33,Unknown,11806.0
Unknown,Unknown,4,Unknown,Unknown,Unknown,Unknown,cid:12)(cid:29)(cid:26)(cid:41)(cid:25)(cid:2)(cid:53)(cid:53)(cid:37)(cid:16)(cid:34)(cid:33,Unknown,11810.0
Unknown,Unknown,3,Unknown,Unknown,Unknown,Unknown,cid:12)(cid:29)(cid:26)(cid:41)(cid:25)(cid:2)(cid:53)(cid:53)(cid:37)(cid:16)(cid:34)(cid:33,Unknown,11813.0
Unknown,Unknown,49,Unknown,Unknown,Unknown,Unknown,cid:12)(cid:29)(cid:26)(cid:41)(cid:25)(cid:2)(cid:53)(cid:53)(cid:37)(cid:16)(cid:34)(cid:33,Unknown,11862.0
Unknown,Unknown,8,Unknown,Unknown,Unknown,Unknown,cid:12)(cid:29)(cid:26)(cid:41)(cid:25)(cid:2)(cid:53)(cid:53)(cid:37)(cid:16)(cid:34)(cid:33,Unknown,11870.0
Unknown,Unknown,10,Unknown,Unknown,Unknown,Unknown,cid:12)(cid:29)(cid:26)(cid:41)(cid:25)(cid:2)(cid:53)(cid:53)(cid:37)(cid:16)(cid:34)(cid:33,Unknown,11880.0
Unknown,Unknown,2,Unknown,Unknown,Unknown,Unknown,cid:12)(cid:29)(cid:26)(cid:41)(cid:25)(cid:2)(cid:53)(cid:53)(cid:37)(cid:16)(cid:34)(cid:33,Unknown,11882.0
Unknown,Unknown,62,Unknown,Unknown,Unknown,Unknown,cid:12)(cid:29)(cid:26)(cid:41)(cid:25)(cid:2)(cid:53)(cid:53)(cid:37)(cid:16)(cid:34)(cid:33,Unknown,11944.0
Unknown,Unknown,12,Unknown,Unknown,Unknown,Unknown,cid:12)(cid:29)(cid:26)(cid:41)(cid:25)(cid:2)(cid:53)(cid:53)(cid:37)(cid:16)(cid:34)(cid:33,Unknown,11956.0
Unknown,Unknown,2,Unknown,Unknown,Unknown,Unknown,cid:12)(cid:29)(cid:26)(cid:41)(cid:25)(cid:2)(cid:53)(cid:53)(cid:37)(cid:16)(cid:34)(cid:33,Unknown,11958.0
Unknown,Unknown,52,Unknown,Unknown,Unknown,Unknown,cid:12)(cid:29)(cid:26)(cid:41)(cid:25)(cid:2)(cid:53)(cid:53)(cid:37)(cid:16)(cid:34)(cid:33,Unknown,12010.0
Unknown,Unknown,11,Unknown,Unknown,Unknown,Unknown,cid:12)(cid:29)(cid:26)(cid:41)(cid:25)(cid:2)(cid:53)(cid:53)(cid:37)(cid:16)(cid:34)(cid:33,Unknown,12021.0
Unknown,Unknown,2,Unknown,Unknown,Unknown,Unknown,cid:12)(cid:29)(cid:26)(cid:41)(cid:25)(cid:2)(cid:53)(cid:53)(cid:37)(cid:16)(cid:34)(cid:33,Unknown,12023.0
Unknown,Unknown,63,Unknown,Unknown,Unknown,Unknown,cid:12)(cid:29)(cid:26)(cid:41)(cid:25)(cid:2)(cid:53)(cid:53)(cid:37)(cid:16)(cid:34)(cid:33,Unknown,12086.0
Unknown,Unknown,5,Unknown,Unknown,Unknown,Unknown,cid:12)(cid:29)(cid:26)(cid:41)(cid:25)(cid:2)(cid:53)(cid:53)(cid:37)(cid:16)(cid:34)(cid:33,Unknown,12091.0
Unknown,Unknown,3,Unknown,Unknown,Unknown,Unknown,cid:12)(cid:29)(cid:26)(cid:41)(cid:25)(cid:2)(cid:53)(cid:53)(cid:37)(cid:16)(cid:34)(cid:33,Unknown,12094.0
Unknown,Unknown,52,Unknown,Unknown,Unknown,Unknown,cid:12)(cid:29)(cid:26)(cid:41)(cid:25)(cid:2)(cid:53)(cid:53)(cid:37)(cid:16)(cid:34)(cid:33,Unknown,12146.0
Unknown,Unknown,4,Unknown,Unknown,Unknown,Unknown,cid:12)(cid:29)(cid:26)(cid:41)(cid:25)(cid:2)(cid:53)(cid:53)(cid:37)(cid:16)(cid:34)(cid:33,Unknown,12150.0
Unknown,Unknown,8,Unknown,Unknown,Unknown,Unknown,cid:12)(cid:29)(cid:26)(cid:41)(cid:25)(cid:2)(cid:53)(cid:53)(cid:37)(cid:16)(cid:34)(cid:33,Unknown,12158.0
Unknown,Unknown,2,Unknown,Unknown,Unknown,Unknown,cid:12)(cid:29)(cid:26)(cid:41)(cid:25)(cid:2)(cid:53)(cid:53)(cid:37)(cid:16)(cid:34)(cid:33,Unknown,12160.0
Unknown,Unknown,28,Unknown,Unknown,Unknown,Unknown,cid:12)(cid:29)(cid:26)(cid:41)(cid:25)(cid:2)(cid:53)(cid:53)(cid:37)(cid:16)(cid:34)(cid:33,Unknown,12188.0
Unknown,Unknown,3,Unknown,Unknown,Unknown,Unknown,cid:12)(cid:29)(cid:26)(cid:41)(cid:25)(cid:2)(cid:53)(cid:53)(cid:37)(cid:16)(cid:34)(cid:33,Unknown,12191.0
Unknown,Unknown,15,Unknown,Unknown,Unknown,Unknown,cid:12)(cid:29)(cid:26)(cid:41)(cid:25)(cid:2)(cid:53)(cid:53)(cid:37)(cid:16)(cid:34)(cid:33,Unknown,12206.0
Unknown,Unknown,2,Unknown,Unknown,Unknown,Unknown,cid:12)(cid:29)(cid:26)(cid:41)(cid:25)(cid:2)(cid:53)(cid:53)(cid:37)(cid:16)(cid:34)(cid:33,Unknown,12208.0
Unknown,Unknown,37,Unknown,Unknown,Unknown,Unknown,cid:12)(cid:29)(cid:26)(cid:41)(cid:25)(cid:2)(cid:53)(cid:53)(cid:37)(cid:16)(cid:34)(cid:33,Unknown,12245.0
Unknown,Unknown,32,Unknown,Unknown,Unknown,Unknown,cid:12)(cid:29)(cid:26)(cid:41)(cid:25)(cid:2)(cid:53)(cid:53)(cid:37)(cid:16)(cid:34)(cid:33,Unknown,12277.0
Unknown,Unknown,19,Unknown,Unknown,Unknown,Unknown,cid:12)(cid:29)(cid:26)(cid:41)(cid:25)(cid:2)(cid:53)(cid:53)(cid:37)(cid:16)(cid:34)(cid:33,Unknown,12296.0
Unknown,Unknown,18,Unknown,Unknown,Unknown,Unknown,cid:12)(cid:29)(cid:26)(cid:41)(cid:25)(cid:2)(cid:53)(cid:53)(cid:37)(cid:16)(cid:34)(cid:33,Unknown,12314.0
Unknown,Unknown,34,Unknown,Unknown,Unknown,Unknown,cid:12)(cid:29)(cid:26)(cid:41)(cid:25)(cid:2)(cid:53)(cid:53)(cid:37)(cid:16)(cid:34)(cid:33,Unknown,12348.0
Unknown,Unknown,2,Unknown,Unknown,Unknown,Unknown,cid:12)(cid:29)(cid:26)(cid:41)(cid:25)(cid:2)(cid:53)(cid:53)(cid:37)(cid:16)(cid:34)(cid:33,Unknown,12350.0
Unknown,Unknown,44,Unknown,Unknown,Unknown,Unknown,cid:12)(cid:29)(cid:26)(cid:41)(cid:25)(cid:2)(cid:53)(cid:53)(cid:37)(cid:16)(cid:34)(cid:33,Unknown,12394.0
Unknown,Unknown,12,Unknown,Unknown,Unknown,Unknown,cid:12)(cid:29)(cid:26)(cid:41)(cid:25)(cid:2)(cid:53)(cid:53)(cid:37)(cid:16)(cid:34)(cid:33,Unknown,12406.0
Unknown,Unknown,29,Unknown,Unknown,Unknown,Unknown,cid:12)(cid:29)(cid:26)(cid:41)(cid:25)(cid:2)(cid:53)(cid:53)(cid:37)(cid:16)(cid:34)(cid:33,Unknown,12435.0
Unknown,Unknown,26,Unknown,Unknown,Unknown,Unknown,cid:12)(cid:29)(cid:26)(cid:41)(cid:25)(cid:2)(cid:53)(cid:53)(cid:37)(cid:16)(cid:34)(cid:33,Unknown,12461.0
Unknown,Unknown,41,Unknown,Unknown,Unknown,Unknown,cid:12)(cid:29)(cid:26)(cid:41)(cid:25)(cid:2)(cid:53)(cid:53)(cid:37)(cid:16)(cid:34)(cid:33,Unknown,12502.0
Unknown,Unknown,25,Unknown,Unknown,Unknown,Unknown,cid:12)(cid:29)(cid:26)(cid:41)(cid:25)(cid:2)(cid:53)(cid:53)(cid:37)(cid:16)(cid:34)(cid:33,Unknown,12527.0
Unknown,Unknown,2,Unknown,Unknown,Unknown,Unknown,cid:12)(cid:29)(cid:26)(cid:41)(cid:25)(cid:2)(cid:53)(cid:53)(cid:37)(cid:16)(cid:34)(cid:33,Unknown,12529.0
Unknown,Unknown,53,Unknown,Unknown,Unknown,Unknown,cid:12)(cid:29)(cid:26)(cid:41)(cid:25)(cid:2)(cid:53)(cid:53)(cid:37)(cid:16)(cid:34)(cid:33,Unknown,12582.0
Unknown,Unknown,53,Unknown,Unknown,Unknown,Unknown,cid:12)(cid:29)(cid:26)(cid:41)(cid:25)(cid:2)(cid:53)(cid:53)(cid:37)(cid:16)(cid:34)(cid:33,Unknown,12635.0
Unknown,Unknown,18,Unknown,Unknown,Unknown,Unknown,cid:12)(cid:29)(cid:26)(cid:41)(cid:25)(cid:2)(cid:53)(cid:53)(cid:37)(cid:16)(cid:34)(cid:33,Unknown,12653.0
Unknown,Unknown,1,Unknown,Unknown,Unknown,Unknown,cid:12)(cid:29)(cid:26)(cid:41)(cid:25)(cid:2)(cid:53)(cid:53)(cid:37)(cid:16)(cid:34)(cid:33,Unknown,12654.0
Unknown,Unknown,1,Unknown,Unknown,Unknown,Unknown,cid:12)(cid:29)(cid:26)(cid:41)(cid:25)(cid:2)(cid:53)(cid:53)(cid:37)(cid:16)(cid:34)(cid:33,Unknown,12655.0
Unknown,Unknown,37,Unknown,Unknown,Unknown,Unknown,cid:12)(cid:29)(cid:26)(cid:41)(cid:25)(cid:2)(cid:53)(cid:53)(cid:37)(cid:16)(cid:34)(cid:33,Unknown,12692.0
Unknown,Unknown,1,Unknown,Unknown,Unknown,Unknown,cid:12)(cid:29)(cid:26)(cid:41)(cid:25)(cid:2)(cid:53)(cid:53)(cid:37)(cid:16)(cid:34)(cid:33,Unknown,12693.0
Unknown,Unknown,17,Unknown,Unknown,Unknown,Unknown,cid:12)(cid:29)(cid:26)(cid:41)(cid:25)(cid:2)(cid:53)(cid:53)(cid:37)(cid:16)(cid:34)(cid:33,Unknown,12710.0
Unknown,Unknown,45,Unknown,Unknown,Unknown,Unknown,cid:12)(cid:29)(cid:26)(cid:41)(cid:25)(cid:2)(cid:53)(cid:53)(cid:37)(cid:16)(cid:34)(cid:33,Unknown,12755.0
Unknown,Unknown,18,Unknown,Unknown,Unknown,Unknown,cid:12)(cid:29)(cid:26)(cid:41)(cid:25)(cid:2)(cid:53)(cid:53)(cid:37)(cid:16)(cid:34)(cid:33,Unknown,12773.0
Unknown,Unknown,34,Unknown,Unknown,Unknown,Unknown,cid:12)(cid:29)(cid:26)(cid:41)(cid:25)(cid:2)(cid:53)(cid:53)(cid:37)(cid:16)(cid:34)(cid:33,Unknown,12807.0
Unknown,Unknown,9,Unknown,Unknown,Unknown,Unknown,cid:12)(cid:29)(cid:26)(cid:41)(cid:25)(cid:2)(cid:53)(cid:53)(cid:37)(cid:16)(cid:34)(cid:33,Unknown,12816.0
Unknown,Unknown,49,Unknown,Unknown,Unknown,Unknown,cid:12)(cid:29)(cid:26)(cid:41)(cid:25)(cid:2)(cid:53)(cid:53)(cid:37)(cid:16)(cid:34)(cid:33,Unknown,12865.0
Unknown,Unknown,8,Unknown,Unknown,Unknown,Unknown,cid:12)(cid:29)(cid:26)(cid:41)(cid:25)(cid:2)(cid:53)(cid:53)(cid:37)(cid:16)(cid:34)(cid:33,Unknown,12873.0
Unknown,Unknown,5,Unknown,Unknown,Unknown,Unknown,cid:12)(cid:29)(cid:26)(cid:41)(cid:25)(cid:2)(cid:53)(cid:53)(cid:37)(cid:16)(cid:34)(cid:33,Unknown,12878.0
Unknown,Unknown,28,Unknown,Unknown,Unknown,Unknown,cid:12)(cid:29)(cid:26)(cid:41)(cid:25)(cid:2)(cid:53)(cid:53)(cid:37)(cid:16)(cid:34)(cid:33,Unknown,12906.0
Unknown,Unknown,2,Unknown,Unknown,Unknown,Unknown,cid:12)(cid:29)(cid:26)(cid:41)(cid:25)(cid:2)(cid:53)(cid:53)(cid:37)(cid:16)(cid:34)(cid:33,Unknown,12908.0
Unknown,Unknown,9,Unknown,Unknown,Unknown,Unknown,cid:12)(cid:29)(cid:26)(cid:41)(cid:25)(cid:2)(cid:53)(cid:53)(cid:37)(cid:16)(cid:34)(cid:33,Unknown,12917.0
Unknown,Unknown,5,Unknown,Unknown,Unknown,Unknown,cid:12)(cid:29)(cid:26)(cid:41)(cid:25)(cid:2)(cid:53)(cid:53)(cid:37)(cid:16)(cid:34)(cid:33,Unknown,12922.0
Unknown,Unknown,8,Unknown,Unknown,Unknown,Unknown,cid:12)(cid:29)(cid:26)(cid:41)(cid:25)(cid:2)(cid:53)(cid:53)(cid:37)(cid:16)(cid:34)(cid:33,Unknown,12930.0
Unknown,Unknown,14,Unknown,Unknown,Unknown,Unknown,cid:12)(cid:29)(cid:26)(cid:41)(cid:25)(cid:2)(cid:53)(cid:53)(cid:37)(cid:16)(cid:34)(cid:33,Unknown,12944.0
Unknown,Unknown,7,Unknown,Unknown,Unknown,Unknown,cid:12)(cid:29)(cid:26)(cid:41)(cid:25)(cid:2)(cid:53)(cid:53)(cid:37)(cid:16)(cid:34)(cid:33,Unknown,12951.0
Unknown,Unknown,9,Unknown,Unknown,Unknown,Unknown,cid:12)(cid:29)(cid:26)(cid:41)(cid:25)(cid:2)(cid:53)(cid:53)(cid:37)(cid:16)(cid:34)(cid:33,Unknown,12960.0
Unknown,Unknown,2,Unknown,Unknown,Unknown,Unknown,cid:12)(cid:29)(cid:26)(cid:41)(cid:25)(cid:2)(cid:53)(cid:53)(cid:37)(cid:16)(cid:34)(cid:33,Unknown,12962.0
Unknown,Unknown,28,Unknown,Unknown,Unknown,Unknown,cid:12)(cid:29)(cid:26)(cid:41)(cid:25)(cid:2)(cid:53)(cid:53)(cid:37)(cid:16)(cid:34)(cid:33,Unknown,12990.0
Unknown,Unknown,3,Unknown,Unknown,Unknown,Unknown,cid:12)(cid:29)(cid:26)(cid:41)(cid:25)(cid:2)(cid:53)(cid:53)(cid:37)(cid:16)(cid:34)(cid:33,Unknown,12993.0
Unknown,Unknown,15,Unknown,Unknown,Unknown,Unknown,cid:12)(cid:29)(cid:26)(cid:41)(cid:25)(cid:2)(cid:53)(cid:53)(cid:37)(cid:16)(cid:34)(cid:33,Unknown,13008.0
Unknown,Unknown,2,Unknown,Unknown,Unknown,Unknown,cid:12)(cid:29)(cid:26)(cid:41)(cid:25)(cid:2)(cid:53)(cid:53)(cid:37)(cid:16)(cid:34)(cid:33,Unknown,13010.0
Unknown,Unknown,36,Unknown,Unknown,Unknown,Unknown,cid:12)(cid:29)(cid:26)(cid:41)(cid:25)(cid:2)(cid:53)(cid:53)(cid:37)(cid:16)(cid:34)(cid:33,Unknown,13046.0
Unknown,Unknown,19,Unknown,Unknown,Unknown,Unknown,cid:12)(cid:29)(cid:26)(cid:41)(cid:25)(cid:2)(cid:53)(cid:53)(cid:37)(cid:16)(cid:34)(cid:33,Unknown,13065.0
Unknown,Unknown,32,Unknown,Unknown,Unknown,Unknown,cid:12)(cid:29)(cid:26)(cid:41)(cid:25)(cid:2)(cid:53)(cid:53)(cid:37)(cid:16)(cid:34)(cid:33,Unknown,13097.0
Unknown,Unknown,18,Unknown,Unknown,Unknown,Unknown,cid:12)(cid:29)(cid:26)(cid:41)(cid:25)(cid:2)(cid:53)(cid:53)(cid:37)(cid:16)(cid:34)(cid:33,Unknown,13115.0
Unknown,Unknown,2,Unknown,Unknown,Unknown,Unknown,cid:12)(cid:29)(cid:26)(cid:41)(cid:25)(cid:2)(cid:53)(cid:53)(cid:37)(cid:16)(cid:34)(cid:33,Unknown,13117.0
Unknown,Unknown,44,Unknown,Unknown,Unknown,Unknown,cid:12)(cid:29)(cid:26)(cid:41)(cid:25)(cid:2)(cid:53)(cid:53)(cid:37)(cid:16)(cid:34)(cid:33,Unknown,13161.0
Unknown,Unknown,12,Unknown,Unknown,Unknown,Unknown,cid:12)(cid:29)(cid:26)(cid:41)(cid:25)(cid:2)(cid:53)(cid:53)(cid:37)(cid:16)(cid:34)(cid:33,Unknown,13173.0
Unknown,Unknown,29,Unknown,Unknown,Unknown,Unknown,cid:12)(cid:29)(cid:26)(cid:41)(cid:25)(cid:2)(cid:53)(cid:53)(cid:37)(cid:16)(cid:34)(cid:33,Unknown,13202.0
Unknown,Unknown,26,Unknown,Unknown,Unknown,Unknown,cid:12)(cid:29)(cid:26)(cid:41)(cid:25)(cid:2)(cid:53)(cid:53)(cid:37)(cid:16)(cid:34)(cid:33,Unknown,13228.0
Unknown,Unknown,41,Unknown,Unknown,Unknown,Unknown,cid:12)(cid:29)(cid:26)(cid:41)(cid:25)(cid:2)(cid:53)(cid:53)(cid:37)(cid:16)(cid:34)(cid:33,Unknown,13269.0
Unknown,Unknown,25,Unknown,Unknown,Unknown,Unknown,cid:12)(cid:29)(cid:26)(cid:41)(cid:25)(cid:2)(cid:53)(cid:53)(cid:37)(cid:16)(cid:34)(cid:33,Unknown,13294.0
Unknown,Unknown,2,Unknown,Unknown,Unknown,Unknown,cid:12)(cid:29)(cid:26)(cid:41)(cid:25)(cid:2)(cid:53)(cid:53)(cid:37)(cid:16)(cid:34)(cid:33,Unknown,13296.0
Unknown,Unknown,53,Unknown,Unknown,Unknown,Unknown,cid:12)(cid:29)(cid:26)(cid:41)(cid:25)(cid:2)(cid:53)(cid:53)(cid:37)(cid:16)(cid:34)(cid:33,Unknown,13349.0
Unknown,Unknown,53,Unknown,Unknown,Unknown,Unknown,cid:12)(cid:29)(cid:26)(cid:41)(cid:25)(cid:2)(cid:53)(cid:53)(cid:37)(cid:16)(cid:34)(cid:33,Unknown,13402.0
Unknown,Unknown,18,Unknown,Unknown,Unknown,Unknown,cid:12)(cid:29)(cid:26)(cid:41)(cid:25)(cid:2)(cid:53)(cid:53)(cid:37)(cid:16)(cid:34)(cid:33,Unknown,13420.0
Unknown,Unknown,1,Unknown,Unknown,Unknown,Unknown,cid:12)(cid:29)(cid:26)(cid:41)(cid:25)(cid:2)(cid:53)(cid:53)(cid:37)(cid:16)(cid:34)(cid:33,Unknown,13421.0
Unknown,Unknown,1,Unknown,Unknown,Unknown,Unknown,cid:12)(cid:29)(cid:26)(cid:41)(cid:25)(cid:2)(cid:53)(cid:53)(cid:37)(cid:16)(cid:34)(cid:33,Unknown,13422.0
Unknown,Unknown,37,Unknown,Unknown,Unknown,Unknown,cid:12)(cid:29)(cid:26)(cid:41)(cid:25)(cid:2)(cid:53)(cid:53)(cid:37)(cid:16)(cid:34)(cid:33,Unknown,13459.0
Unknown,Unknown,1,Unknown,Unknown,Unknown,Unknown,cid:12)(cid:29)(cid:26)(cid:41)(cid:25)(cid:2)(cid:53)(cid:53)(cid:37)(cid:16)(cid:34)(cid:33,Unknown,13460.0
Unknown,Unknown,17,Unknown,Unknown,Unknown,Unknown,cid:12)(cid:29)(cid:26)(cid:41)(cid:25)(cid:2)(cid:53)(cid:53)(cid:37)(cid:16)(cid:34)(cid:33,Unknown,13477.0
Unknown,Unknown,45,Unknown,Unknown,Unknown,Unknown,cid:12)(cid:29)(cid:26)(cid:41)(cid:25)(cid:2)(cid:53)(cid:53)(cid:37)(cid:16)(cid:34)(cid:33,Unknown,13522.0
Unknown,Unknown,18,Unknown,Unknown,Unknown,Unknown,cid:12)(cid:29)(cid:26)(cid:41)(cid:25)(cid:2)(cid:53)(cid:53)(cid:37)(cid:16)(cid:34)(cid:33,Unknown,13540.0
Unknown,Unknown,34,Unknown,Unknown,Unknown,Unknown,cid:12)(cid:29)(cid:26)(cid:41)(cid:25)(cid:2)(cid:53)(cid:53)(cid:37)(cid:16)(cid:34)(cid:33,Unknown,13574.0
Unknown,Unknown,9,Unknown,Unknown,Unknown,Unknown,cid:12)(cid:29)(cid:26)(cid:41)(cid:25)(cid:2)(cid:53)(cid:53)(cid:37)(cid:16)(cid:34)(cid:33,Unknown,13583.0
Unknown,Unknown,49,Unknown,Unknown,Unknown,Unknown,cid:12)(cid:29)(cid:26)(cid:41)(cid:25)(cid:2)(cid:53)(cid:53)(cid:37)(cid:16)(cid:34)(cid:33,Unknown,13632.0
Unknown,Unknown,8,Unknown,Unknown,Unknown,Unknown,cid:12)(cid:29)(cid:26)(cid:41)(cid:25)(cid:2)(cid:53)(cid:53)(cid:37)(cid:16)(cid:34)(cid:33,Unknown,13640.0
Unknown,Unknown,5,Unknown,Unknown,Unknown,Unknown,cid:12)(cid:29)(cid:26)(cid:41)(cid:25)(cid:2)(cid:53)(cid:53)(cid:37)(cid:16)(cid:34)(cid:33,Unknown,13645.0
Unknown,Unknown,28,Unknown,Unknown,Unknown,Unknown,cid:12)(cid:29)(cid:26)(cid:41)(cid:25)(cid:2)(cid:53)(cid:53)(cid:37)(cid:16)(cid:34)(cid:33,Unknown,13673.0
Unknown,Unknown,2,Unknown,Unknown,Unknown,Unknown,cid:12)(cid:29)(cid:26)(cid:41)(cid:25)(cid:2)(cid:53)(cid:53)(cid:37)(cid:16)(cid:34)(cid:33,Unknown,13675.0
Unknown,Unknown,49,Unknown,Unknown,Unknown,Unknown,cid:12)(cid:29)(cid:26)(cid:41)(cid:25)(cid:2)(cid:53)(cid:53)(cid:37)(cid:16)(cid:34)(cid:33,Unknown,13724.0
Unknown,Unknown,4,Unknown,Unknown,Unknown,Unknown,cid:12)(cid:29)(cid:26)(cid:41)(cid:25)(cid:2)(cid:53)(cid:53)(cid:37)(cid:16)(cid:34)(cid:33,Unknown,13728.0
Unknown,Unknown,10,Unknown,Unknown,Unknown,Unknown,cid:12)(cid:29)(cid:26)(cid:41)(cid:25)(cid:2)(cid:53)(cid:53)(cid:37)(cid:16)(cid:34)(cid:33,Unknown,13738.0
Unknown,Unknown,11,Unknown,Unknown,Unknown,Unknown,cid:12)(cid:29)(cid:26)(cid:41)(cid:25)(cid:2)(cid:53)(cid:53)(cid:37)(cid:16)(cid:34)(cid:33,Unknown,13749.0
Unknown,Unknown,3,Unknown,Unknown,Unknown,Unknown,cid:12)(cid:29)(cid:26)(cid:41)(cid:25)(cid:2)(cid:53)(cid:53)(cid:37)(cid:16)(cid:34)(cid:33,Unknown,13752.0
Unknown,Unknown,11,Unknown,Unknown,Unknown,Unknown,cid:12)(cid:29)(cid:26)(cid:41)(cid:25)(cid:2)(cid:53)(cid:53)(cid:37)(cid:16)(cid:34)(cid:33,Unknown,13763.0
Unknown,Unknown,4,Unknown,Unknown,Unknown,Unknown,cid:12)(cid:29)(cid:26)(cid:41)(cid:25)(cid:2)(cid:53)(cid:53)(cid:37)(cid:16)(cid:34)(cid:33,Unknown,13767.0
Unknown,Unknown,10,Unknown,Unknown,Unknown,Unknown,cid:12)(cid:29)(cid:26)(cid:41)(cid:25)(cid:2)(cid:53)(cid:53)(cid:37)(cid:16)(cid:34)(cid:33,Unknown,13777.0
Unknown,Unknown,5,Unknown,Unknown,Unknown,Unknown,cid:12)(cid:29)(cid:26)(cid:41)(cid:25)(cid:2)(cid:53)(cid:53)(cid:37)(cid:16)(cid:34)(cid:33,Unknown,13782.0
Unknown,Unknown,2,Unknown,Unknown,Unknown,Unknown,cid:12)(cid:29)(cid:26)(cid:41)(cid:25)(cid:2)(cid:53)(cid:53)(cid:37)(cid:16)(cid:34)(cid:33,Unknown,13784.0
Unknown,Unknown,9,Unknown,Unknown,Unknown,Unknown,cid:12)(cid:29)(cid:26)(cid:41)(cid:25)(cid:2)(cid:53)(cid:53)(cid:37)(cid:16)(cid:34)(cid:33,Unknown,13793.0
Unknown,Unknown,5,Unknown,Unknown,Unknown,Unknown,cid:12)(cid:29)(cid:26)(cid:41)(cid:25)(cid:2)(cid:53)(cid:53)(cid:37)(cid:16)(cid:34)(cid:33,Unknown,13798.0
Unknown,Unknown,8,Unknown,Unknown,Unknown,Unknown,cid:12)(cid:29)(cid:26)(cid:41)(cid:25)(cid:2)(cid:53)(cid:53)(cid:37)(cid:16)(cid:34)(cid:33,Unknown,13806.0
Unknown,Unknown,14,Unknown,Unknown,Unknown,Unknown,cid:12)(cid:29)(cid:26)(cid:41)(cid:25)(cid:2)(cid:53)(cid:53)(cid:37)(cid:16)(cid:34)(cid:33,Unknown,13820.0
Unknown,Unknown,7,Unknown,Unknown,Unknown,Unknown,cid:12)(cid:29)(cid:26)(cid:41)(cid:25)(cid:2)(cid:53)(cid:53)(cid:37)(cid:16)(cid:34)(cid:33,Unknown,13827.0
Unknown,Unknown,9,Unknown,Unknown,Unknown,Unknown,cid:12)(cid:29)(cid:26)(cid:41)(cid:25)(cid:2)(cid:53)(cid:53)(cid:37)(cid:16)(cid:34)(cid:33,Unknown,13836.0
Unknown,Unknown,2,Unknown,Unknown,Unknown,Unknown,cid:12)(cid:29)(cid:26)(cid:41)(cid:25)(cid:2)(cid:53)(cid:53)(cid:37)(cid:16)(cid:34)(cid:33,Unknown,13838.0
Unknown,Unknown,12,Unknown,Unknown,Unknown,Unknown,cid:12)(cid:29)(cid:26)(cid:41)(cid:25)(cid:2)(cid:53)(cid:53)(cid:37)(cid:16)(cid:34)(cid:33,Unknown,13850.0
Unknown,Unknown,5,Unknown,Unknown,Unknown,Unknown,cid:12)(cid:29)(cid:26)(cid:41)(cid:25)(cid:2)(cid:53)(cid:53)(cid:37)(cid:16)(cid:34)(cid:33,Unknown,13855.0
Unknown,Unknown,52,Unknown,Unknown,Unknown,Unknown,cid:12)(cid:29)(cid:26)(cid:41)(cid:25)(cid:2)(cid:53)(cid:53)(cid:37)(cid:16)(cid:34)(cid:33,Unknown,13907.0
Unknown,Unknown,5,Unknown,Unknown,Unknown,Unknown,cid:12)(cid:29)(cid:26)(cid:41)(cid:25)(cid:2)(cid:53)(cid:53)(cid:37)(cid:16)(cid:34)(cid:33,Unknown,13912.0
Unknown,Unknown,40,Unknown,Unknown,Unknown,Unknown,cid:12)(cid:29)(cid:26)(cid:41)(cid:25)(cid:2)(cid:53)(cid:53)(cid:37)(cid:16)(cid:34)(cid:33,Unknown,13952.0
Unknown,Unknown,2,Unknown,Unknown,Unknown,Unknown,cid:12)(cid:29)(cid:26)(cid:41)(cid:25)(cid:2)(cid:53)(cid:53)(cid:37)(cid:16)(cid:34)(cid:33,Unknown,13954.0
Unknown,Unknown,28,Unknown,Unknown,Unknown,Unknown,cid:12)(cid:29)(cid:26)(cid:41)(cid:25)(cid:2)(cid:53)(cid:53)(cid:37)(cid:16)(cid:34)(cid:33,Unknown,13982.0
Unknown,Unknown,3,Unknown,Unknown,Unknown,Unknown,cid:12)(cid:29)(cid:26)(cid:41)(cid:25)(cid:2)(cid:53)(cid:53)(cid:37)(cid:16)(cid:34)(cid:33,Unknown,13985.0
Unknown,Unknown,15,Unknown,Unknown,Unknown,Unknown,cid:12)(cid:29)(cid:26)(cid:41)(cid:25)(cid:2)(cid:53)(cid:53)(cid:37)(cid:16)(cid:34)(cid:33,Unknown,14000.0
Unknown,Unknown,2,Unknown,Unknown,Unknown,Unknown,cid:12)(cid:29)(cid:26)(cid:41)(cid:25)(cid:2)(cid:53)(cid:53)(cid:37)(cid:16)(cid:34)(cid:33,Unknown,14002.0
Unknown,Unknown,17,Unknown,Unknown,Unknown,Unknown,cid:12)(cid:29)(cid:26)(cid:41)(cid:25)(cid:2)(cid:53)(cid:53)(cid:37)(cid:16)(cid:34)(cid:33,Unknown,14019.0
Unknown,Unknown,34,Unknown,Unknown,Unknown,Unknown,cid:12)(cid:29)(cid:26)(cid:41)(cid:25)(cid:2)(cid:53)(cid:53)(cid:37)(cid:16)(cid:34)(cid:33,Unknown,14053.0
Unknown,Unknown,19,Unknown,Unknown,Unknown,Unknown,cid:12)(cid:29)(cid:26)(cid:41)(cid:25)(cid:2)(cid:53)(cid:53)(cid:37)(cid:16)(cid:34)(cid:33,Unknown,14072.0
Unknown,Unknown,16,Unknown,Unknown,Unknown,Unknown,cid:12)(cid:29)(cid:26)(cid:41)(cid:25)(cid:2)(cid:53)(cid:53)(cid:37)(cid:16)(cid:34)(cid:33,Unknown,14088.0
Unknown,Unknown,18,Unknown,Unknown,Unknown,Unknown,cid:12)(cid:29)(cid:26)(cid:41)(cid:25)(cid:2)(cid:53)(cid:53)(cid:37)(cid:16)(cid:34)(cid:33,Unknown,14106.0
Unknown,Unknown,2,Unknown,Unknown,Unknown,Unknown,cid:12)(cid:29)(cid:26)(cid:41)(cid:25)(cid:2)(cid:53)(cid:53)(cid:37)(cid:16)(cid:34)(cid:33,Unknown,14108.0
Unknown,Unknown,44,Unknown,Unknown,Unknown,Unknown,cid:12)(cid:29)(cid:26)(cid:41)(cid:25)(cid:2)(cid:53)(cid:53)(cid:37)(cid:16)(cid:34)(cid:33,Unknown,14152.0
Unknown,Unknown,12,Unknown,Unknown,Unknown,Unknown,cid:12)(cid:29)(cid:26)(cid:41)(cid:25)(cid:2)(cid:53)(cid:53)(cid:37)(cid:16)(cid:34)(cid:33,Unknown,14164.0
Unknown,Unknown,29,Unknown,Unknown,Unknown,Unknown,cid:12)(cid:29)(cid:26)(cid:41)(cid:25)(cid:2)(cid:53)(cid:53)(cid:37)(cid:16)(cid:34)(cid:33,Unknown,14193.0
Unknown,Unknown,26,Unknown,Unknown,Unknown,Unknown,cid:12)(cid:29)(cid:26)(cid:41)(cid:25)(cid:2)(cid:53)(cid:53)(cid:37)(cid:16)(cid:34)(cid:33,Unknown,14219.0
Unknown,Unknown,41,Unknown,Unknown,Unknown,Unknown,cid:12)(cid:29)(cid:26)(cid:41)(cid:25)(cid:2)(cid:53)(cid:53)(cid:37)(cid:16)(cid:34)(cid:33,Unknown,14260.0
Unknown,Unknown,25,Unknown,Unknown,Unknown,Unknown,cid:12)(cid:29)(cid:26)(cid:41)(cid:25)(cid:2)(cid:53)(cid:53)(cid:37)(cid:16)(cid:34)(cid:33,Unknown,14285.0
Unknown,Unknown,2,Unknown,Unknown,Unknown,Unknown,cid:12)(cid:29)(cid:26)(cid:41)(cid:25)(cid:2)(cid:53)(cid:53)(cid:37)(cid:16)(cid:34)(cid:33,Unknown,14287.0
Unknown,Unknown,53,Unknown,Unknown,Unknown,Unknown,cid:12)(cid:29)(cid:26)(cid:41)(cid:25)(cid:2)(cid:53)(cid:53)(cid:37)(cid:16)(cid:34)(cid:33,Unknown,14340.0
Unknown,Unknown,53,Unknown,Unknown,Unknown,Unknown,cid:12)(cid:29)(cid:26)(cid:41)(cid:25)(cid:2)(cid:53)(cid:53)(cid:37)(cid:16)(cid:34)(cid:33,Unknown,14393.0
Unknown,Unknown,18,Unknown,Unknown,Unknown,Unknown,cid:12)(cid:29)(cid:26)(cid:41)(cid:25)(cid:2)(cid:53)(cid:53)(cid:37)(cid:16)(cid:34)(cid:33,Unknown,14411.0
Unknown,Unknown,1,Unknown,Unknown,Unknown,Unknown,cid:12)(cid:29)(cid:26)(cid:41)(cid:25)(cid:2)(cid:53)(cid:53)(cid:37)(cid:16)(cid:34)(cid:33,Unknown,14412.0
Unknown,Unknown,1,Unknown,Unknown,Unknown,Unknown,cid:12)(cid:29)(cid:26)(cid:41)(cid:25)(cid:2)(cid:53)(cid:53)(cid:37)(cid:16)(cid:34)(cid:33,Unknown,14413.0
Unknown,Unknown,37,Unknown,Unknown,Unknown,Unknown,cid:12)(cid:29)(cid:26)(cid:41)(cid:25)(cid:2)(cid:53)(cid:53)(cid:37)(cid:16)(cid:34)(cid:33,Unknown,14450.0
Unknown,Unknown,1,Unknown,Unknown,Unknown,Unknown,cid:12)(cid:29)(cid:26)(cid:41)(cid:25)(cid:2)(cid:53)(cid:53)(cid:37)(cid:16)(cid:34)(cid:33,Unknown,14451.0
Unknown,Unknown,17,Unknown,Unknown,Unknown,Unknown,cid:12)(cid:29)(cid:26)(cid:41)(cid:25)(cid:2)(cid:53)(cid:53)(cid:37)(cid:16)(cid:34)(cid:33,Unknown,14468.0
Unknown,Unknown,45,Unknown,Unknown,Unknown,Unknown,cid:12)(cid:29)(cid:26)(cid:41)(cid:25)(cid:2)(cid:53)(cid:53)(cid:37)(cid:16)(cid:34)(cid:33,Unknown,14513.0
Unknown,Unknown,18,Unknown,Unknown,Unknown,Unknown,cid:12)(cid:29)(cid:26)(cid:41)(cid:25)(cid:2)(cid:53)(cid:53)(cid:37)(cid:16)(cid:34)(cid:33,Unknown,14531.0
Unknown,Unknown,34,Unknown,Unknown,Unknown,Unknown,cid:12)(cid:29)(cid:26)(cid:41)(cid:25)(cid:2)(cid:53)(cid:53)(cid:37)(cid:16)(cid:34)(cid:33,Unknown,14565.0
Unknown,Unknown,9,Unknown,Unknown,Unknown,Unknown,cid:12)(cid:29)(cid:26)(cid:41)(cid:25)(cid:2)(cid:53)(cid:53)(cid:37)(cid:16)(cid:34)(cid:33,Unknown,14574.0
Unknown,Unknown,49,Unknown,Unknown,Unknown,Unknown,cid:12)(cid:29)(cid:26)(cid:41)(cid:25)(cid:2)(cid:53)(cid:53)(cid:37)(cid:16)(cid:34)(cid:33,Unknown,14623.0
Unknown,Unknown,8,Unknown,Unknown,Unknown,Unknown,cid:12)(cid:29)(cid:26)(cid:41)(cid:25)(cid:2)(cid:53)(cid:53)(cid:37)(cid:16)(cid:34)(cid:33,Unknown,14631.0
Unknown,Unknown,5,Unknown,Unknown,Unknown,Unknown,cid:12)(cid:29)(cid:26)(cid:41)(cid:25)(cid:2)(cid:53)(cid:53)(cid:37)(cid:16)(cid:34)(cid:33,Unknown,14636.0
Unknown,Unknown,28,Unknown,Unknown,Unknown,Unknown,cid:12)(cid:29)(cid:26)(cid:41)(cid:25)(cid:2)(cid:53)(cid:53)(cid:37)(cid:16)(cid:34)(cid:33,Unknown,14664.0
Unknown,Unknown,2,Unknown,Unknown,Unknown,Unknown,cid:12)(cid:29)(cid:26)(cid:41)(cid:25)(cid:2)(cid:53)(cid:53)(cid:37)(cid:16)(cid:34)(cid:33,Unknown,14666.0
Unknown,Unknown,9,Unknown,Unknown,Unknown,Unknown,cid:12)(cid:29)(cid:26)(cid:41)(cid:25)(cid:2)(cid:53)(cid:53)(cid:37)(cid:16)(cid:34)(cid:33,Unknown,14675.0
Unknown,Unknown,5,Unknown,Unknown,Unknown,Unknown,cid:12)(cid:29)(cid:26)(cid:41)(cid:25)(cid:2)(cid:53)(cid:53)(cid:37)(cid:16)(cid:34)(cid:33,Unknown,14680.0
Unknown,Unknown,8,Unknown,Unknown,Unknown,Unknown,cid:12)(cid:29)(cid:26)(cid:41)(cid:25)(cid:2)(cid:53)(cid:53)(cid:37)(cid:16)(cid:34)(cid:33,Unknown,14688.0
Unknown,Unknown,14,Unknown,Unknown,Unknown,Unknown,cid:12)(cid:29)(cid:26)(cid:41)(cid:25)(cid:2)(cid:53)(cid:53)(cid:37)(cid:16)(cid:34)(cid:33,Unknown,14702.0
Unknown,Unknown,7,Unknown,Unknown,Unknown,Unknown,cid:12)(cid:29)(cid:26)(cid:41)(cid:25)(cid:2)(cid:53)(cid:53)(cid:37)(cid:16)(cid:34)(cid:33,Unknown,14709.0
Unknown,Unknown,9,Unknown,Unknown,Unknown,Unknown,cid:12)(cid:29)(cid:26)(cid:41)(cid:25)(cid:2)(cid:53)(cid:53)(cid:37)(cid:16)(cid:34)(cid:33,Unknown,14718.0
Unknown,Unknown,2,Unknown,Unknown,Unknown,Unknown,cid:12)(cid:29)(cid:26)(cid:41)(cid:25)(cid:2)(cid:53)(cid:53)(cid:37)(cid:16)(cid:34)(cid:33,Unknown,14720.0
Unknown,Unknown,28,Unknown,Unknown,Unknown,Unknown,cid:12)(cid:29)(cid:26)(cid:41)(cid:25)(cid:2)(cid:53)(cid:53)(cid:37)(cid:16)(cid:34)(cid:33,Unknown,14748.0
Unknown,Unknown,3,Unknown,Unknown,Unknown,Unknown,cid:12)(cid:29)(cid:26)(cid:41)(cid:25)(cid:2)(cid:53)(cid:53)(cid:37)(cid:16)(cid:34)(cid:33,Unknown,14751.0
Unknown,Unknown,15,Unknown,Unknown,Unknown,Unknown,cid:12)(cid:29)(cid:26)(cid:41)(cid:25)(cid:2)(cid:53)(cid:53)(cid:37)(cid:16)(cid:34)(cid:33,Unknown,14766.0
Unknown,Unknown,2,Unknown,Unknown,Unknown,Unknown,cid:12)(cid:29)(cid:26)(cid:41)(cid:25)(cid:2)(cid:53)(cid:53)(cid:37)(cid:16)(cid:34)(cid:33,Unknown,14768.0
Unknown,Unknown,33,Unknown,Unknown,Unknown,Unknown,cid:12)(cid:29)(cid:26)(cid:41)(cid:25)(cid:2)(cid:53)(cid:53)(cid:37)(cid:16)(cid:34)(cid:33,Unknown,14801.0
Unknown,Unknown,19,Unknown,Unknown,Unknown,Unknown,cid:12)(cid:29)(cid:26)(cid:41)(cid:25)(cid:2)(cid:53)(cid:53)(cid:37)(cid:16)(cid:34)(cid:33,Unknown,14820.0
Unknown,Unknown,17,Unknown,Unknown,Unknown,Unknown,cid:12)(cid:29)(cid:26)(cid:41)(cid:25)(cid:2)(cid:53)(cid:53)(cid:37)(cid:16)(cid:34)(cid:33,Unknown,14837.0
Unknown,Unknown,18,Unknown,Unknown,Unknown,Unknown,cid:12)(cid:29)(cid:26)(cid:41)(cid:25)(cid:2)(cid:53)(cid:53)(cid:37)(cid:16)(cid:34)(cid:33,Unknown,14855.0
Unknown,Unknown,2,Unknown,Unknown,Unknown,Unknown,cid:12)(cid:29)(cid:26)(cid:41)(cid:25)(cid:2)(cid:53)(cid:53)(cid:37)(cid:16)(cid:34)(cid:33,Unknown,14857.0
Unknown,Unknown,44,Unknown,Unknown,Unknown,Unknown,cid:12)(cid:29)(cid:26)(cid:41)(cid:25)(cid:2)(cid:53)(cid:53)(cid:37)(cid:16)(cid:34)(cid:33,Unknown,14901.0
Unknown,Unknown,12,Unknown,Unknown,Unknown,Unknown,cid:12)(cid:29)(cid:26)(cid:41)(cid:25)(cid:2)(cid:53)(cid:53)(cid:37)(cid:16)(cid:34)(cid:33,Unknown,14913.0
Unknown,Unknown,29,Unknown,Unknown,Unknown,Unknown,cid:12)(cid:29)(cid:26)(cid:41)(cid:25)(cid:2)(cid:53)(cid:53)(cid:37)(cid:16)(cid:34)(cid:33,Unknown,14942.0
Unknown,Unknown,26,Unknown,Unknown,Unknown,Unknown,cid:12)(cid:29)(cid:26)(cid:41)(cid:25)(cid:2)(cid:53)(cid:53)(cid:37)(cid:16)(cid:34)(cid:33,Unknown,14968.0
Unknown,Unknown,41,Unknown,Unknown,Unknown,Unknown,cid:12)(cid:29)(cid:26)(cid:41)(cid:25)(cid:2)(cid:53)(cid:53)(cid:37)(cid:16)(cid:34)(cid:33,Unknown,15009.0
Unknown,Unknown,25,Unknown,Unknown,Unknown,Unknown,cid:12)(cid:29)(cid:26)(cid:41)(cid:25)(cid:2)(cid:53)(cid:53)(cid:37)(cid:16)(cid:34)(cid:33,Unknown,15034.0
Unknown,Unknown,2,Unknown,Unknown,Unknown,Unknown,cid:12)(cid:29)(cid:26)(cid:41)(cid:25)(cid:2)(cid:53)(cid:53)(cid:37)(cid:16)(cid:34)(cid:33,Unknown,15036.0
Unknown,Unknown,53,Unknown,Unknown,Unknown,Unknown,cid:12)(cid:29)(cid:26)(cid:41)(cid:25)(cid:2)(cid:53)(cid:53)(cid:37)(cid:16)(cid:34)(cid:33,Unknown,15089.0
Unknown,Unknown,53,Unknown,Unknown,Unknown,Unknown,cid:12)(cid:29)(cid:26)(cid:41)(cid:25)(cid:2)(cid:53)(cid:53)(cid:37)(cid:16)(cid:34)(cid:33,Unknown,15142.0
Unknown,Unknown,18,Unknown,Unknown,Unknown,Unknown,cid:12)(cid:29)(cid:26)(cid:41)(cid:25)(cid:2)(cid:53)(cid:53)(cid:37)(cid:16)(cid:34)(cid:33,Unknown,15160.0
Unknown,Unknown,1,Unknown,Unknown,Unknown,Unknown,cid:12)(cid:29)(cid:26)(cid:41)(cid:25)(cid:2)(cid:53)(cid:53)(cid:37)(cid:16)(cid:34)(cid:33,Unknown,15161.0
Unknown,Unknown,1,Unknown,Unknown,Unknown,Unknown,cid:12)(cid:29)(cid:26)(cid:41)(cid:25)(cid:2)(cid:53)(cid:53)(cid:37)(cid:16)(cid:34)(cid:33,Unknown,15162.0
Unknown,Unknown,37,Unknown,Unknown,Unknown,Unknown,cid:12)(cid:29)(cid:26)(cid:41)(cid:25)(cid:2)(cid:53)(cid:53)(cid:37)(cid:16)(cid:34)(cid:33,Unknown,15199.0
Unknown,Unknown,1,Unknown,Unknown,Unknown,Unknown,cid:12)(cid:29)(cid:26)(cid:41)(cid:25)(cid:2)(cid:53)(cid:53)(cid:37)(cid:16)(cid:34)(cid:33,Unknown,15200.0
Unknown,Unknown,17,Unknown,Unknown,Unknown,Unknown,cid:12)(cid:29)(cid:26)(cid:41)(cid:25)(cid:2)(cid:53)(cid:53)(cid:37)(cid:16)(cid:34)(cid:33,Unknown,15217.0
Unknown,Unknown,45,Unknown,Unknown,Unknown,Unknown,cid:12)(cid:29)(cid:26)(cid:41)(cid:25)(cid:2)(cid:53)(cid:53)(cid:37)(cid:16)(cid:34)(cid:33,Unknown,15262.0
Unknown,Unknown,18,Unknown,Unknown,Unknown,Unknown,cid:12)(cid:29)(cid:26)(cid:41)(cid:25)(cid:2)(cid:53)(cid:53)(cid:37)(cid:16)(cid:34)(cid:33,Unknown,15280.0
Unknown,Unknown,34,Unknown,Unknown,Unknown,Unknown,cid:12)(cid:29)(cid:26)(cid:41)(cid:25)(cid:2)(cid:53)(cid:53)(cid:37)(cid:16)(cid:34)(cid:33,Unknown,15314.0
Unknown,Unknown,9,Unknown,Unknown,Unknown,Unknown,cid:12)(cid:29)(cid:26)(cid:41)(cid:25)(cid:2)(cid:53)(cid:53)(cid:37)(cid:16)(cid:34)(cid:33,Unknown,15323.0
Unknown,Unknown,49,Unknown,Unknown,Unknown,Unknown,cid:12)(cid:29)(cid:26)(cid:41)(cid:25)(cid:2)(cid:53)(cid:53)(cid:37)(cid:16)(cid:34)(cid:33,Unknown,15372.0
Unknown,Unknown,8,Unknown,Unknown,Unknown,Unknown,cid:12)(cid:29)(cid:26)(cid:41)(cid:25)(cid:2)(cid:53)(cid:53)(cid:37)(cid:16)(cid:34)(cid:33,Unknown,15380.0
Unknown,Unknown,5,Unknown,Unknown,Unknown,Unknown,cid:12)(cid:29)(cid:26)(cid:41)(cid:25)(cid:2)(cid:53)(cid:53)(cid:37)(cid:16)(cid:34)(cid:33,Unknown,15385.0
Unknown,Unknown,28,Unknown,Unknown,Unknown,Unknown,cid:12)(cid:29)(cid:26)(cid:41)(cid:25)(cid:2)(cid:53)(cid:53)(cid:37)(cid:16)(cid:34)(cid:33,Unknown,15413.0
Unknown,Unknown,2,Unknown,Unknown,Unknown,Unknown,cid:12)(cid:29)(cid:26)(cid:41)(cid:25)(cid:2)(cid:53)(cid:53)(cid:37)(cid:16)(cid:34)(cid:33,Unknown,15415.0
Unknown,Unknown,9,Unknown,Unknown,Unknown,Unknown,cid:12)(cid:29)(cid:26)(cid:41)(cid:25)(cid:2)(cid:53)(cid:53)(cid:37)(cid:16)(cid:34)(cid:33,Unknown,15424.0
Unknown,Unknown,5,Unknown,Unknown,Unknown,Unknown,cid:12)(cid:29)(cid:26)(cid:41)(cid:25)(cid:2)(cid:53)(cid:53)(cid:37)(cid:16)(cid:34)(cid:33,Unknown,15429.0
Unknown,Unknown,8,Unknown,Unknown,Unknown,Unknown,cid:12)(cid:29)(cid:26)(cid:41)(cid:25)(cid:2)(cid:53)(cid:53)(cid:37)(cid:16)(cid:34)(cid:33,Unknown,15437.0
Unknown,Unknown,14,Unknown,Unknown,Unknown,Unknown,cid:12)(cid:29)(cid:26)(cid:41)(cid:25)(cid:2)(cid:53)(cid:53)(cid:37)(cid:16)(cid:34)(cid:33,Unknown,15451.0
Unknown,Unknown,7,Unknown,Unknown,Unknown,Unknown,cid:12)(cid:29)(cid:26)(cid:41)(cid:25)(cid:2)(cid:53)(cid:53)(cid:37)(cid:16)(cid:34)(cid:33,Unknown,15458.0
Unknown,Unknown,9,Unknown,Unknown,Unknown,Unknown,cid:12)(cid:29)(cid:26)(cid:41)(cid:25)(cid:2)(cid:53)(cid:53)(cid:37)(cid:16)(cid:34)(cid:33,Unknown,15467.0
Unknown,Unknown,2,Unknown,Unknown,Unknown,Unknown,cid:12)(cid:29)(cid:26)(cid:41)(cid:25)(cid:2)(cid:53)(cid:53)(cid:37)(cid:16)(cid:34)(cid:33,Unknown,15469.0
Unknown,Unknown,28,Unknown,Unknown,Unknown,Unknown,cid:12)(cid:29)(cid:26)(cid:41)(cid:25)(cid:2)(cid:53)(cid:53)(cid:37)(cid:16)(cid:34)(cid:33,Unknown,15497.0
Unknown,Unknown,3,Unknown,Unknown,Unknown,Unknown,cid:12)(cid:29)(cid:26)(cid:41)(cid:25)(cid:2)(cid:53)(cid:53)(cid:37)(cid:16)(cid:34)(cid:33,Unknown,15500.0
Unknown,Unknown,15,Unknown,Unknown,Unknown,Unknown,cid:12)(cid:29)(cid:26)(cid:41)(cid:25)(cid:2)(cid:53)(cid:53)(cid:37)(cid:16)(cid:34)(cid:33,Unknown,15515.0
Unknown,Unknown,2,Unknown,Unknown,Unknown,Unknown,cid:12)(cid:29)(cid:26)(cid:41)(cid:25)(cid:2)(cid:53)(cid:53)(cid:37)(cid:16)(cid:34)(cid:33,Unknown,15517.0
Unknown,Unknown,34,Unknown,Unknown,Unknown,Unknown,cid:12)(cid:29)(cid:26)(cid:41)(cid:25)(cid:2)(cid:53)(cid:53)(cid:37)(cid:16)(cid:34)(cid:33,Unknown,15551.0
Unknown,Unknown,19,Unknown,Unknown,Unknown,Unknown,cid:12)(cid:29)(cid:26)(cid:41)(cid:25)(cid:2)(cid:53)(cid:53)(cid:37)(cid:16)(cid:34)(cid:33,Unknown,15570.0
Unknown,Unknown,1,Unknown,Unknown,Unknown,Unknown,cid:12)(cid:29)(cid:26)(cid:41)(cid:25)(cid:2)(cid:53)(cid:53)(cid:37)(cid:16)(cid:34)(cid:33,Unknown,15571.0
Unknown,Unknown,18,Unknown,Unknown,Unknown,Unknown,cid:12)(cid:29)(cid:26)(cid:41)(cid:25)(cid:2)(cid:53)(cid:53)(cid:37)(cid:16)(cid:34)(cid:33,Unknown,15589.0
Unknown,Unknown,2,Unknown,Unknown,Unknown,Unknown,cid:12)(cid:29)(cid:26)(cid:41)(cid:25)(cid:2)(cid:53)(cid:53)(cid:37)(cid:16)(cid:34)(cid:33,Unknown,15591.0
Unknown,Unknown,44,Unknown,Unknown,Unknown,Unknown,cid:12)(cid:29)(cid:26)(cid:41)(cid:25)(cid:2)(cid:53)(cid:53)(cid:37)(cid:16)(cid:34)(cid:33,Unknown,15635.0
Unknown,Unknown,12,Unknown,Unknown,Unknown,Unknown,cid:12)(cid:29)(cid:26)(cid:41)(cid:25)(cid:2)(cid:53)(cid:53)(cid:37)(cid:16)(cid:34)(cid:33,Unknown,15647.0
Unknown,Unknown,29,Unknown,Unknown,Unknown,Unknown,cid:12)(cid:29)(cid:26)(cid:41)(cid:25)(cid:2)(cid:53)(cid:53)(cid:37)(cid:16)(cid:34)(cid:33,Unknown,15676.0
Unknown,Unknown,26,Unknown,Unknown,Unknown,Unknown,cid:12)(cid:29)(cid:26)(cid:41)(cid:25)(cid:2)(cid:53)(cid:53)(cid:37)(cid:16)(cid:34)(cid:33,Unknown,15702.0
Unknown,Unknown,41,Unknown,Unknown,Unknown,Unknown,cid:12)(cid:29)(cid:26)(cid:41)(cid:25)(cid:2)(cid:53)(cid:53)(cid:37)(cid:16)(cid:34)(cid:33,Unknown,15743.0
Unknown,Unknown,25,Unknown,Unknown,Unknown,Unknown,cid:12)(cid:29)(cid:26)(cid:41)(cid:25)(cid:2)(cid:53)(cid:53)(cid:37)(cid:16)(cid:34)(cid:33,Unknown,15768.0
Unknown,Unknown,2,Unknown,Unknown,Unknown,Unknown,cid:12)(cid:29)(cid:26)(cid:41)(cid:25)(cid:2)(cid:53)(cid:53)(cid:37)(cid:16)(cid:34)(cid:33,Unknown,15770.0
Unknown,Unknown,53,Unknown,Unknown,Unknown,Unknown,cid:12)(cid:29)(cid:26)(cid:41)(cid:25)(cid:2)(cid:53)(cid:53)(cid:37)(cid:16)(cid:34)(cid:33,Unknown,15823.0
Unknown,Unknown,53,Unknown,Unknown,Unknown,Unknown,cid:12)(cid:29)(cid:26)(cid:41)(cid:25)(cid:2)(cid:53)(cid:53)(cid:37)(cid:16)(cid:34)(cid:33,Unknown,15876.0
Unknown,Unknown,18,Unknown,Unknown,Unknown,Unknown,cid:12)(cid:29)(cid:26)(cid:41)(cid:25)(cid:2)(cid:53)(cid:53)(cid:37)(cid:16)(cid:34)(cid:33,Unknown,15894.0
Unknown,Unknown,1,Unknown,Unknown,Unknown,Unknown,cid:12)(cid:29)(cid:26)(cid:41)(cid:25)(cid:2)(cid:53)(cid:53)(cid:37)(cid:16)(cid:34)(cid:33,Unknown,15895.0
Unknown,Unknown,1,Unknown,Unknown,Unknown,Unknown,cid:12)(cid:29)(cid:26)(cid:41)(cid:25)(cid:2)(cid:53)(cid:53)(cid:37)(cid:16)(cid:34)(cid:33,Unknown,15896.0
Unknown,Unknown,37,Unknown,Unknown,Unknown,Unknown,cid:12)(cid:29)(cid:26)(cid:41)(cid:25)(cid:2)(cid:53)(cid:53)(cid:37)(cid:16)(cid:34)(cid:33,Unknown,15933.0
Unknown,Unknown,1,Unknown,Unknown,Unknown,Unknown,cid:12)(cid:29)(cid:26)(cid:41)(cid:25)(cid:2)(cid:53)(cid:53)(cid:37)(cid:16)(cid:34)(cid:33,Unknown,15934.0
Unknown,Unknown,17,Unknown,Unknown,Unknown,Unknown,cid:12)(cid:29)(cid:26)(cid:41)(cid:25)(cid:2)(cid:53)(cid:53)(cid:37)(cid:16)(cid:34)(cid:33,Unknown,15951.0
Unknown,Unknown,45,Unknown,Unknown,Unknown,Unknown,cid:12)(cid:29)(cid:26)(cid:41)(cid:25)(cid:2)(cid:53)(cid:53)(cid:37)(cid:16)(cid:34)(cid:33,Unknown,15996.0
Unknown,Unknown,18,Unknown,Unknown,Unknown,Unknown,cid:12)(cid:29)(cid:26)(cid:41)(cid:25)(cid:2)(cid:53)(cid:53)(cid:37)(cid:16)(cid:34)(cid:33,Unknown,16014.0
Unknown,Unknown,34,Unknown,Unknown,Unknown,Unknown,cid:12)(cid:29)(cid:26)(cid:41)(cid:25)(cid:2)(cid:53)(cid:53)(cid:37)(cid:16)(cid:34)(cid:33,Unknown,16048.0
Unknown,Unknown,10,Unknown,Unknown,Unknown,Unknown,cid:12)(cid:29)(cid:26)(cid:41)(cid:25)(cid:2)(cid:53)(cid:53)(cid:37)(cid:16)(cid:34)(cid:33,Unknown,16058.0
Unknown,Unknown,11,Unknown,Unknown,Unknown,Unknown,cid:12)(cid:29)(cid:26)(cid:41)(cid:25)(cid:2)(cid:53)(cid:53)(cid:37)(cid:16)(cid:34)(cid:33,Unknown,16069.0
Unknown,Unknown,10,Unknown,Unknown,Unknown,Unknown,cid:12)(cid:29)(cid:26)(cid:41)(cid:25)(cid:2)(cid:53)(cid:53)(cid:37)(cid:16)(cid:34)(cid:33,Unknown,16079.0
Unknown,Unknown,49,Unknown,Unknown,Unknown,Unknown,cid:12)(cid:29)(cid:26)(cid:41)(cid:25)(cid:2)(cid:53)(cid:53)(cid:37)(cid:16)(cid:34)(cid:33,Unknown,16128.0
Unknown,Unknown,14,Unknown,Unknown,Unknown,Unknown,cid:12)(cid:29)(cid:26)(cid:41)(cid:25)(cid:2)(cid:53)(cid:53)(cid:37)(cid:16)(cid:34)(cid:33,Unknown,16142.0
Unknown,Unknown,2,Unknown,Unknown,Unknown,Unknown,cid:12)(cid:29)(cid:26)(cid:41)(cid:25)(cid:2)(cid:53)(cid:53)(cid:37)(cid:16)(cid:34)(cid:33,Unknown,16144.0
Unknown,Unknown,12,Unknown,Unknown,Unknown,Unknown,cid:12)(cid:29)(cid:26)(cid:41)(cid:25)(cid:2)(cid:53)(cid:53)(cid:37)(cid:16)(cid:34)(cid:33,Unknown,16156.0
Unknown,Unknown,11,Unknown,Unknown,Unknown,Unknown,cid:12)(cid:29)(cid:26)(cid:41)(cid:25)(cid:2)(cid:53)(cid:53)(cid:37)(cid:16)(cid:34)(cid:33,Unknown,16167.0
Unknown,Unknown,4,Unknown,Unknown,Unknown,Unknown,cid:12)(cid:29)(cid:26)(cid:41)(cid:25)(cid:2)(cid:53)(cid:53)(cid:37)(cid:16)(cid:34)(cid:33,Unknown,16171.0
Unknown,Unknown,14,Unknown,Unknown,Unknown,Unknown,cid:12)(cid:29)(cid:26)(cid:41)(cid:25)(cid:2)(cid:53)(cid:53)(cid:37)(cid:16)(cid:34)(cid:33,Unknown,16185.0
Unknown,Unknown,11,Unknown,Unknown,Unknown,Unknown,cid:12)(cid:29)(cid:26)(cid:41)(cid:25)(cid:2)(cid:53)(cid:53)(cid:37)(cid:16)(cid:34)(cid:33,Unknown,16196.0
Unknown,Unknown,62,Unknown,Unknown,Unknown,Unknown,cid:12)(cid:29)(cid:26)(cid:41)(cid:25)(cid:2)(cid:53)(cid:53)(cid:37)(cid:16)(cid:34)(cid:33,Unknown,16258.0
Unknown,Unknown,62,Unknown,Unknown,Unknown,Unknown,cid:12)(cid:29)(cid:26)(cid:41)(cid:25)(cid:2)(cid:53)(cid:53)(cid:37)(cid:16)(cid:34)(cid:33,Unknown,16320.0
Unknown,Unknown,7,Unknown,Unknown,Unknown,Unknown,cid:12)(cid:29)(cid:26)(cid:41)(cid:25)(cid:2)(cid:53)(cid:53)(cid:37)(cid:16)(cid:34)(cid:33,Unknown,16327.0
Unknown,Unknown,5,Unknown,Unknown,Unknown,Unknown,cid:12)(cid:29)(cid:26)(cid:41)(cid:25)(cid:2)(cid:53)(cid:53)(cid:37)(cid:16)(cid:34)(cid:33,Unknown,16332.0
Unknown,Unknown,3,Unknown,Unknown,Unknown,Unknown,cid:12)(cid:29)(cid:26)(cid:41)(cid:25)(cid:2)(cid:53)(cid:53)(cid:37)(cid:16)(cid:34)(cid:33,Unknown,16335.0
Unknown,Unknown,9,Unknown,Unknown,Unknown,Unknown,cid:12)(cid:29)(cid:26)(cid:41)(cid:25)(cid:2)(cid:53)(cid:53)(cid:37)(cid:16)(cid:34)(cid:33,Unknown,16344.0
Unknown,Unknown,2,Unknown,Unknown,Unknown,Unknown,cid:12)(cid:29)(cid:26)(cid:41)(cid:25)(cid:2)(cid:53)(cid:53)(cid:37)(cid:16)(cid:34)(cid:33,Unknown,16346.0
Unknown,Unknown,28,Unknown,Unknown,Unknown,Unknown,cid:12)(cid:29)(cid:26)(cid:41)(cid:25)(cid:2)(cid:53)(cid:53)(cid:37)(cid:16)(cid:34)(cid:33,Unknown,16374.0
Unknown,Unknown,3,Unknown,Unknown,Unknown,Unknown,cid:12)(cid:29)(cid:26)(cid:41)(cid:25)(cid:2)(cid:53)(cid:53)(cid:37)(cid:16)(cid:34)(cid:33,Unknown,16377.0
Unknown,Unknown,15,Unknown,Unknown,Unknown,Unknown,cid:12)(cid:29)(cid:26)(cid:41)(cid:25)(cid:2)(cid:53)(cid:53)(cid:37)(cid:16)(cid:34)(cid:33,Unknown,16392.0
Unknown,Unknown,2,Unknown,Unknown,Unknown,Unknown,cid:12)(cid:29)(cid:26)(cid:41)(cid:25)(cid:2)(cid:53)(cid:53)(cid:37)(cid:16)(cid:34)(cid:33,Unknown,16394.0
Unknown,Unknown,17,Unknown,Unknown,Unknown,Unknown,cid:12)(cid:29)(cid:26)(cid:41)(cid:25)(cid:2)(cid:53)(cid:53)(cid:37)(cid:16)(cid:34)(cid:33,Unknown,16411.0
Unknown,Unknown,37,Unknown,Unknown,Unknown,Unknown,cid:12)(cid:29)(cid:26)(cid:41)(cid:25)(cid:2)(cid:53)(cid:53)(cid:37)(cid:16)(cid:34)(cid:33,Unknown,16448.0
Unknown,Unknown,19,Unknown,Unknown,Unknown,Unknown,cid:12)(cid:29)(cid:26)(cid:41)(cid:25)(cid:2)(cid:53)(cid:53)(cid:37)(cid:16)(cid:34)(cid:33,Unknown,16467.0
Unknown,Unknown,34,Unknown,Unknown,Unknown,Unknown,cid:12)(cid:29)(cid:26)(cid:41)(cid:25)(cid:2)(cid:53)(cid:53)(cid:37)(cid:16)(cid:34)(cid:33,Unknown,16501.0
Unknown,Unknown,36,Unknown,Unknown,Unknown,Unknown,cid:12)(cid:29)(cid:26)(cid:41)(cid:25)(cid:2)(cid:53)(cid:53)(cid:37)(cid:16)(cid:34)(cid:33,Unknown,16537.0
Unknown,Unknown,2,Unknown,Unknown,Unknown,Unknown,cid:12)(cid:29)(cid:26)(cid:41)(cid:25)(cid:2)(cid:53)(cid:53)(cid:37)(cid:16)(cid:34)(cid:33,Unknown,16539.0
Unknown,Unknown,44,Unknown,Unknown,Unknown,Unknown,cid:12)(cid:29)(cid:26)(cid:41)(cid:25)(cid:2)(cid:53)(cid:53)(cid:37)(cid:16)(cid:34)(cid:33,Unknown,16583.0
Unknown,Unknown,12,Unknown,Unknown,Unknown,Unknown,cid:12)(cid:29)(cid:26)(cid:41)(cid:25)(cid:2)(cid:53)(cid:53)(cid:37)(cid:16)(cid:34)(cid:33,Unknown,16595.0
Unknown,Unknown,29,Unknown,Unknown,Unknown,Unknown,cid:12)(cid:29)(cid:26)(cid:41)(cid:25)(cid:2)(cid:53)(cid:53)(cid:37)(cid:16)(cid:34)(cid:33,Unknown,16624.0
Unknown,Unknown,26,Unknown,Unknown,Unknown,Unknown,cid:12)(cid:29)(cid:26)(cid:41)(cid:25)(cid:2)(cid:53)(cid:53)(cid:37)(cid:16)(cid:34)(cid:33,Unknown,16650.0
Unknown,Unknown,41,Unknown,Unknown,Unknown,Unknown,cid:12)(cid:29)(cid:26)(cid:41)(cid:25)(cid:2)(cid:53)(cid:53)(cid:37)(cid:16)(cid:34)(cid:33,Unknown,16691.0
Unknown,Unknown,25,Unknown,Unknown,Unknown,Unknown,cid:12)(cid:29)(cid:26)(cid:41)(cid:25)(cid:2)(cid:53)(cid:53)(cid:37)(cid:16)(cid:34)(cid:33,Unknown,16716.0
Unknown,Unknown,2,Unknown,Unknown,Unknown,Unknown,cid:12)(cid:29)(cid:26)(cid:41)(cid:25)(cid:2)(cid:53)(cid:53)(cid:37)(cid:16)(cid:34)(cid:33,Unknown,16718.0
Unknown,Unknown,53,Unknown,Unknown,Unknown,Unknown,cid:12)(cid:29)(cid:26)(cid:41)(cid:25)(cid:2)(cid:53)(cid:53)(cid:37)(cid:16)(cid:34)(cid:33,Unknown,16771.0
Unknown,Unknown,53,Unknown,Unknown,Unknown,Unknown,cid:12)(cid:29)(cid:26)(cid:41)(cid:25)(cid:2)(cid:53)(cid:53)(cid:37)(cid:16)(cid:34)(cid:33,Unknown,16824.0
Unknown,Unknown,18,Unknown,Unknown,Unknown,Unknown,cid:12)(cid:29)(cid:26)(cid:41)(cid:25)(cid:2)(cid:53)(cid:53)(cid:37)(cid:16)(cid:34)(cid:33,Unknown,16842.0
Unknown,Unknown,1,Unknown,Unknown,Unknown,Unknown,cid:12)(cid:29)(cid:26)(cid:41)(cid:25)(cid:2)(cid:53)(cid:53)(cid:37)(cid:16)(cid:34)(cid:33,Unknown,16843.0
Unknown,Unknown,1,Unknown,Unknown,Unknown,Unknown,cid:12)(cid:29)(cid:26)(cid:41)(cid:25)(cid:2)(cid:53)(cid:53)(cid:37)(cid:16)(cid:34)(cid:33,Unknown,16844.0
Unknown,Unknown,37,Unknown,Unknown,Unknown,Unknown,cid:12)(cid:29)(cid:26)(cid:41)(cid:25)(cid:2)(cid:53)(cid:53)(cid:37)(cid:16)(cid:34)(cid:33,Unknown,16881.0
Unknown,Unknown,1,Unknown,Unknown,Unknown,Unknown,cid:12)(cid:29)(cid:26)(cid:41)(cid:25)(cid:2)(cid:53)(cid:53)(cid:37)(cid:16)(cid:34)(cid:33,Unknown,16882.0
Unknown,Unknown,36,Unknown,Unknown,Unknown,Unknown,cid:12)(cid:29)(cid:26)(cid:41)(cid:25)(cid:2)(cid:53)(cid:53)(cid:37)(cid:16)(cid:34)(cid:33,Unknown,16918.0
Unknown,Unknown,45,Unknown,Unknown,Unknown,Unknown,cid:12)(cid:29)(cid:26)(cid:41)(cid:25)(cid:2)(cid:53)(cid:53)(cid:37)(cid:16)(cid:34)(cid:33,Unknown,16963.0
Unknown,Unknown,18,Unknown,Unknown,Unknown,Unknown,cid:12)(cid:29)(cid:26)(cid:41)(cid:25)(cid:2)(cid:53)(cid:53)(cid:37)(cid:16)(cid:34)(cid:33,Unknown,16981.0
Unknown,Unknown,34,Unknown,Unknown,Unknown,Unknown,cid:12)(cid:29)(cid:26)(cid:41)(cid:25)(cid:2)(cid:53)(cid:53)(cid:37)(cid:16)(cid:34)(cid:33,Unknown,17015.0
Unknown,Unknown,10,Unknown,Unknown,Unknown,Unknown,cid:12)(cid:29)(cid:26)(cid:41)(cid:25)(cid:2)(cid:53)(cid:53)(cid:37)(cid:16)(cid:34)(cid:33,Unknown,17025.0
Unknown,Unknown,49,Unknown,Unknown,Unknown,Unknown,cid:12)(cid:29)(cid:26)(cid:41)(cid:25)(cid:2)(cid:53)(cid:53)(cid:37)(cid:16)(cid:34)(cid:33,Unknown,17074.0
Unknown,Unknown,47,Unknown,Unknown,Unknown,Unknown,cid:12)(cid:29)(cid:26)(cid:41)(cid:25)(cid:2)(cid:53)(cid:53)(cid:37)(cid:16)(cid:34)(cid:33,Unknown,17121.0
Unknown,Unknown,49,Unknown,Unknown,Unknown,Unknown,cid:12)(cid:29)(cid:26)(cid:41)(cid:25)(cid:2)(cid:53)(cid:53)(cid:37)(cid:16)(cid:34)(cid:33,Unknown,17170.0
Unknown,Unknown,12,Unknown,Unknown,Unknown,Unknown,cid:12)(cid:29)(cid:26)(cid:41)(cid:25)(cid:2)(cid:53)(cid:53)(cid:37)(cid:16)(cid:34)(cid:33,Unknown,17182.0
Unknown,Unknown,2,Unknown,Unknown,Unknown,Unknown,cid:12)(cid:29)(cid:26)(cid:41)(cid:25)(cid:2)(cid:53)(cid:53)(cid:37)(cid:16)(cid:34)(cid:33,Unknown,17184.0
Unknown,Unknown,14,Unknown,Unknown,Unknown,Unknown,cid:12)(cid:29)(cid:26)(cid:41)(cid:25)(cid:2)(cid:53)(cid:53)(cid:37)(cid:16)(cid:34)(cid:33,Unknown,17198.0
Unknown,Unknown,5,Unknown,Unknown,Unknown,Unknown,cid:12)(cid:29)(cid:26)(cid:41)(cid:25)(cid:2)(cid:53)(cid:53)(cid:37)(cid:16)(cid:34)(cid:33,Unknown,17203.0
Unknown,Unknown,2,Unknown,Unknown,Unknown,Unknown,cid:12)(cid:29)(cid:26)(cid:41)(cid:25)(cid:2)(cid:53)(cid:53)(cid:37)(cid:16)(cid:34)(cid:33,Unknown,17205.0
Unknown,Unknown,12,Unknown,Unknown,Unknown,Unknown,cid:12)(cid:29)(cid:26)(cid:41)(cid:25)(cid:2)(cid:53)(cid:53)(cid:37)(cid:16)(cid:34)(cid:33,Unknown,17217.0
Unknown,Unknown,5,Unknown,Unknown,Unknown,Unknown,cid:12)(cid:29)(cid:26)(cid:41)(cid:25)(cid:2)(cid:53)(cid:53)(cid:37)(cid:16)(cid:34)(cid:33,Unknown,17222.0
Unknown,Unknown,14,Unknown,Unknown,Unknown,Unknown,cid:12)(cid:29)(cid:26)(cid:41)(cid:25)(cid:2)(cid:53)(cid:53)(cid:37)(cid:16)(cid:34)(cid:33,Unknown,17236.0
Unknown,Unknown,10,Unknown,Unknown,Unknown,Unknown,cid:12)(cid:29)(cid:26)(cid:41)(cid:25)(cid:2)(cid:53)(cid:53)(cid:37)(cid:16)(cid:34)(cid:33,Unknown,17246.0
Unknown,Unknown,7,Unknown,Unknown,Unknown,Unknown,cid:12)(cid:29)(cid:26)(cid:41)(cid:25)(cid:2)(cid:53)(cid:53)(cid:37)(cid:16)(cid:34)(cid:33,Unknown,17253.0
Unknown,Unknown,12,Unknown,Unknown,Unknown,Unknown,cid:12)(cid:29)(cid:26)(cid:41)(cid:25)(cid:2)(cid:53)(cid:53)(cid:37)(cid:16)(cid:34)(cid:33,Unknown,17265.0
Unknown,Unknown,2,Unknown,Unknown,Unknown,Unknown,cid:12)(cid:29)(cid:26)(cid:41)(cid:25)(cid:2)(cid:53)(cid:53)(cid:37)(cid:16)(cid:34)(cid:33,Unknown,17267.0
Unknown,Unknown,12,Unknown,Unknown,Unknown,Unknown,cid:12)(cid:29)(cid:26)(cid:41)(cid:25)(cid:2)(cid:53)(cid:53)(cid:37)(cid:16)(cid:34)(cid:33,Unknown,17279.0
Unknown,Unknown,11,Unknown,Unknown,Unknown,Unknown,cid:12)(cid:29)(cid:26)(cid:41)(cid:25)(cid:2)(cid:53)(cid:53)(cid:37)(cid:16)(cid:34)(cid:33,Unknown,17290.0
Unknown,Unknown,4,Unknown,Unknown,Unknown,Unknown,cid:12)(cid:29)(cid:26)(cid:41)(cid:25)(cid:2)(cid:53)(cid:53)(cid:37)(cid:16)(cid:34)(cid:33,Unknown,17294.0
Unknown,Unknown,14,Unknown,Unknown,Unknown,Unknown,cid:12)(cid:29)(cid:26)(cid:41)(cid:25)(cid:2)(cid:53)(cid:53)(cid:37)(cid:16)(cid:34)(cid:33,Unknown,17308.0
Unknown,Unknown,11,Unknown,Unknown,Unknown,Unknown,cid:12)(cid:29)(cid:26)(cid:41)(cid:25)(cid:2)(cid:53)(cid:53)(cid:37)(cid:16)(cid:34)(cid:33,Unknown,17319.0
Unknown,Unknown,62,Unknown,Unknown,Unknown,Unknown,cid:12)(cid:29)(cid:26)(cid:41)(cid:25)(cid:2)(cid:53)(cid:53)(cid:37)(cid:16)(cid:34)(cid:33,Unknown,17381.0
Unknown,Unknown,62,Unknown,Unknown,Unknown,Unknown,cid:12)(cid:29)(cid:26)(cid:41)(cid:25)(cid:2)(cid:53)(cid:53)(cid:37)(cid:16)(cid:34)(cid:33,Unknown,17443.0
Unknown,Unknown,7,Unknown,Unknown,Unknown,Unknown,cid:12)(cid:29)(cid:26)(cid:41)(cid:25)(cid:2)(cid:53)(cid:53)(cid:37)(cid:16)(cid:34)(cid:33,Unknown,17450.0
Unknown,Unknown,5,Unknown,Unknown,Unknown,Unknown,cid:12)(cid:29)(cid:26)(cid:41)(cid:25)(cid:2)(cid:53)(cid:53)(cid:37)(cid:16)(cid:34)(cid:33,Unknown,17455.0
Unknown,Unknown,3,Unknown,Unknown,Unknown,Unknown,cid:12)(cid:29)(cid:26)(cid:41)(cid:25)(cid:2)(cid:53)(cid:53)(cid:37)(cid:16)(cid:34)(cid:33,Unknown,17458.0
Unknown,Unknown,9,Unknown,Unknown,Unknown,Unknown,cid:12)(cid:29)(cid:26)(cid:41)(cid:25)(cid:2)(cid:53)(cid:53)(cid:37)(cid:16)(cid:34)(cid:33,Unknown,17467.0
Unknown,Unknown,2,Unknown,Unknown,Unknown,Unknown,cid:12)(cid:29)(cid:26)(cid:41)(cid:25)(cid:2)(cid:53)(cid:53)(cid:37)(cid:16)(cid:34)(cid:33,Unknown,17469.0
Unknown,Unknown,28,Unknown,Unknown,Unknown,Unknown,cid:12)(cid:29)(cid:26)(cid:41)(cid:25)(cid:2)(cid:53)(cid:53)(cid:37)(cid:16)(cid:34)(cid:33,Unknown,17497.0
Unknown,Unknown,3,Unknown,Unknown,Unknown,Unknown,cid:12)(cid:29)(cid:26)(cid:41)(cid:25)(cid:2)(cid:53)(cid:53)(cid:37)(cid:16)(cid:34)(cid:33,Unknown,17500.0
Unknown,Unknown,15,Unknown,Unknown,Unknown,Unknown,cid:12)(cid:29)(cid:26)(cid:41)(cid:25)(cid:2)(cid:53)(cid:53)(cid:37)(cid:16)(cid:34)(cid:33,Unknown,17515.0
Unknown,Unknown,2,Unknown,Unknown,Unknown,Unknown,cid:12)(cid:29)(cid:26)(cid:41)(cid:25)(cid:2)(cid:53)(cid:53)(cid:37)(cid:16)(cid:34)(cid:33,Unknown,17517.0
Unknown,Unknown,33,Unknown,Unknown,Unknown,Unknown,cid:12)(cid:29)(cid:26)(cid:41)(cid:25)(cid:2)(cid:53)(cid:53)(cid:37)(cid:16)(cid:34)(cid:33,Unknown,17550.0
Unknown,Unknown,19,Unknown,Unknown,Unknown,Unknown,cid:12)(cid:29)(cid:26)(cid:41)(cid:25)(cid:2)(cid:53)(cid:53)(cid:37)(cid:16)(cid:34)(cid:33,Unknown,17569.0
Unknown,Unknown,36,Unknown,Unknown,Unknown,Unknown,cid:12)(cid:29)(cid:26)(cid:41)(cid:25)(cid:2)(cid:53)(cid:53)(cid:37)(cid:16)(cid:34)(cid:33,Unknown,17605.0
Unknown,Unknown,18,Unknown,Unknown,Unknown,Unknown,cid:12)(cid:29)(cid:26)(cid:41)(cid:25)(cid:2)(cid:53)(cid:53)(cid:37)(cid:16)(cid:34)(cid:33,Unknown,17623.0
Unknown,Unknown,2,Unknown,Unknown,Unknown,Unknown,cid:12)(cid:29)(cid:26)(cid:41)(cid:25)(cid:2)(cid:53)(cid:53)(cid:37)(cid:16)(cid:34)(cid:33,Unknown,17625.0
Unknown,Unknown,44,Unknown,Unknown,Unknown,Unknown,cid:12)(cid:29)(cid:26)(cid:41)(cid:25)(cid:2)(cid:53)(cid:53)(cid:37)(cid:16)(cid:34)(cid:33,Unknown,17669.0
Unknown,Unknown,12,Unknown,Unknown,Unknown,Unknown,cid:12)(cid:29)(cid:26)(cid:41)(cid:25)(cid:2)(cid:53)(cid:53)(cid:37)(cid:16)(cid:34)(cid:33,Unknown,17681.0
Unknown,Unknown,29,Unknown,Unknown,Unknown,Unknown,cid:12)(cid:29)(cid:26)(cid:41)(cid:25)(cid:2)(cid:53)(cid:53)(cid:37)(cid:16)(cid:34)(cid:33,Unknown,17710.0
Unknown,Unknown,26,Unknown,Unknown,Unknown,Unknown,cid:12)(cid:29)(cid:26)(cid:41)(cid:25)(cid:2)(cid:53)(cid:53)(cid:37)(cid:16)(cid:34)(cid:33,Unknown,17736.0
Unknown,Unknown,41,Unknown,Unknown,Unknown,Unknown,cid:12)(cid:29)(cid:26)(cid:41)(cid:25)(cid:2)(cid:53)(cid:53)(cid:37)(cid:16)(cid:34)(cid:33,Unknown,17777.0
Unknown,Unknown,25,Unknown,Unknown,Unknown,Unknown,cid:12)(cid:29)(cid:26)(cid:41)(cid:25)(cid:2)(cid:53)(cid:53)(cid:37)(cid:16)(cid:34)(cid:33,Unknown,17802.0
Unknown,Unknown,2,Unknown,Unknown,Unknown,Unknown,cid:12)(cid:29)(cid:26)(cid:41)(cid:25)(cid:2)(cid:53)(cid:53)(cid:37)(cid:16)(cid:34)(cid:33,Unknown,17804.0
Unknown,Unknown,53,Unknown,Unknown,Unknown,Unknown,cid:12)(cid:29)(cid:26)(cid:41)(cid:25)(cid:2)(cid:53)(cid:53)(cid:37)(cid:16)(cid:34)(cid:33,Unknown,17857.0
Unknown,Unknown,53,Unknown,Unknown,Unknown,Unknown,cid:12)(cid:29)(cid:26)(cid:41)(cid:25)(cid:2)(cid:53)(cid:53)(cid:37)(cid:16)(cid:34)(cid:33,Unknown,17910.0
Unknown,Unknown,18,Unknown,Unknown,Unknown,Unknown,cid:12)(cid:29)(cid:26)(cid:41)(cid:25)(cid:2)(cid:53)(cid:53)(cid:37)(cid:16)(cid:34)(cid:33,Unknown,17928.0
Unknown,Unknown,1,Unknown,Unknown,Unknown,Unknown,cid:12)(cid:29)(cid:26)(cid:41)(cid:25)(cid:2)(cid:53)(cid:53)(cid:37)(cid:16)(cid:34)(cid:33,Unknown,17929.0
Unknown,Unknown,1,Unknown,Unknown,Unknown,Unknown,cid:12)(cid:29)(cid:26)(cid:41)(cid:25)(cid:2)(cid:53)(cid:53)(cid:37)(cid:16)(cid:34)(cid:33,Unknown,17930.0
Unknown,Unknown,37,Unknown,Unknown,Unknown,Unknown,cid:12)(cid:29)(cid:26)(cid:41)(cid:25)(cid:2)(cid:53)(cid:53)(cid:37)(cid:16)(cid:34)(cid:33,Unknown,17967.0
Unknown,Unknown,1,Unknown,Unknown,Unknown,Unknown,cid:12)(cid:29)(cid:26)(cid:41)(cid:25)(cid:2)(cid:53)(cid:53)(cid:37)(cid:16)(cid:34)(cid:33,Unknown,17968.0
Unknown,Unknown,36,Unknown,Unknown,Unknown,Unknown,cid:12)(cid:29)(cid:26)(cid:41)(cid:25)(cid:2)(cid:53)(cid:53)(cid:37)(cid:16)(cid:34)(cid:33,Unknown,18004.0
Unknown,Unknown,45,Unknown,Unknown,Unknown,Unknown,cid:12)(cid:29)(cid:26)(cid:41)(cid:25)(cid:2)(cid:53)(cid:53)(cid:37)(cid:16)(cid:34)(cid:33,Unknown,18049.0
Unknown,Unknown,18,Unknown,Unknown,Unknown,Unknown,cid:12)(cid:29)(cid:26)(cid:41)(cid:25)(cid:2)(cid:53)(cid:53)(cid:37)(cid:16)(cid:34)(cid:33,Unknown,18067.0
Unknown,Unknown,34,Unknown,Unknown,Unknown,Unknown,cid:12)(cid:29)(cid:26)(cid:41)(cid:25)(cid:2)(cid:53)(cid:53)(cid:37)(cid:16)(cid:34)(cid:33,Unknown,18101.0
Unknown,Unknown,12,Unknown,Unknown,Unknown,Unknown,cid:12)(cid:29)(cid:26)(cid:41)(cid:25)(cid:2)(cid:53)(cid:53)(cid:37)(cid:16)(cid:34)(cid:33,Unknown,18113.0
Unknown,Unknown,13,Unknown,Unknown,Unknown,Unknown,cid:12)(cid:29)(cid:26)(cid:41)(cid:25)(cid:2)(cid:53)(cid:53)(cid:37)(cid:16)(cid:34)(cid:33,Unknown,18126.0
Unknown,Unknown,14,Unknown,Unknown,Unknown,Unknown,cid:12)(cid:29)(cid:26)(cid:41)(cid:25)(cid:2)(cid:53)(cid:53)(cid:37)(cid:16)(cid:34)(cid:33,Unknown,18140.0
Unknown,Unknown,2,Unknown,Unknown,Unknown,Unknown,cid:12)(cid:29)(cid:26)(cid:41)(cid:25)(cid:2)(cid:53)(cid:53)(cid:37)(cid:16)(cid:34)(cid:33,Unknown,18142.0
Unknown,Unknown,14,Unknown,Unknown,Unknown,Unknown,cid:12)(cid:29)(cid:26)(cid:41)(cid:25)(cid:2)(cid:53)(cid:53)(cid:37)(cid:16)(cid:34)(cid:33,Unknown,18156.0
Unknown,Unknown,49,Unknown,Unknown,Unknown,Unknown,cid:12)(cid:29)(cid:26)(cid:41)(cid:25)(cid:2)(cid:53)(cid:53)(cid:37)(cid:16)(cid:34)(cid:33,Unknown,18205.0
Unknown,Unknown,63,Unknown,Unknown,Unknown,Unknown,cid:12)(cid:29)(cid:26)(cid:41)(cid:25)(cid:2)(cid:53)(cid:53)(cid:37)(cid:16)(cid:34)(cid:33,Unknown,18268.0
Unknown,Unknown,49,Unknown,Unknown,Unknown,Unknown,cid:12)(cid:29)(cid:26)(cid:41)(cid:25)(cid:2)(cid:53)(cid:53)(cid:37)(cid:16)(cid:34)(cid:33,Unknown,18317.0
Unknown,Unknown,46,Unknown,Unknown,Unknown,Unknown,cid:12)(cid:29)(cid:26)(cid:41)(cid:25)(cid:2)(cid:53)(cid:53)(cid:37)(cid:16)(cid:34)(cid:33,Unknown,18363.0
Unknown,Unknown,5,Unknown,Unknown,Unknown,Unknown,cid:12)(cid:29)(cid:26)(cid:41)(cid:25)(cid:2)(cid:53)(cid:53)(cid:37)(cid:16)(cid:34)(cid:33,Unknown,18368.0
Unknown,Unknown,9,Unknown,Unknown,Unknown,Unknown,cid:12)(cid:29)(cid:26)(cid:41)(cid:25)(cid:2)(cid:53)(cid:53)(cid:37)(cid:16)(cid:34)(cid:33,Unknown,18377.0
Unknown,Unknown,2,Unknown,Unknown,Unknown,Unknown,cid:12)(cid:29)(cid:26)(cid:41)(cid:25)(cid:2)(cid:53)(cid:53)(cid:37)(cid:16)(cid:34)(cid:33,Unknown,18379.0
Unknown,Unknown,47,Unknown,Unknown,Unknown,Unknown,cid:12)(cid:29)(cid:26)(cid:41)(cid:25)(cid:2)(cid:53)(cid:53)(cid:37)(cid:16)(cid:34)(cid:33,Unknown,18426.0
Unknown,Unknown,11,Unknown,Unknown,Unknown,Unknown,cid:12)(cid:29)(cid:26)(cid:41)(cid:25)(cid:2)(cid:53)(cid:53)(cid:37)(cid:16)(cid:34)(cid:33,Unknown,18437.0
Unknown,Unknown,7,Unknown,Unknown,Unknown,Unknown,cid:12)(cid:29)(cid:26)(cid:41)(cid:25)(cid:2)(cid:53)(cid:53)(cid:37)(cid:16)(cid:34)(cid:33,Unknown,18444.0
Unknown,Unknown,9,Unknown,Unknown,Unknown,Unknown,cid:12)(cid:29)(cid:26)(cid:41)(cid:25)(cid:2)(cid:53)(cid:53)(cid:37)(cid:16)(cid:34)(cid:33,Unknown,18453.0
Unknown,Unknown,9,Unknown,Unknown,Unknown,Unknown,cid:12)(cid:29)(cid:26)(cid:41)(cid:25)(cid:2)(cid:53)(cid:53)(cid:37)(cid:16)(cid:34)(cid:33,Unknown,18462.0
Unknown,Unknown,65,Unknown,Unknown,Unknown,Unknown,cid:12)(cid:29)(cid:26)(cid:41)(cid:25)(cid:2)(cid:53)(cid:53)(cid:37)(cid:16)(cid:34)(cid:33,Unknown,18527.0
Unknown,Unknown,2,Unknown,Unknown,Unknown,Unknown,cid:12)(cid:29)(cid:26)(cid:41)(cid:25)(cid:2)(cid:53)(cid:53)(cid:37)(cid:16)(cid:34)(cid:33,Unknown,18529.0
Unknown,Unknown,14,Unknown,Unknown,Unknown,Unknown,cid:12)(cid:29)(cid:26)(cid:41)(cid:25)(cid:2)(cid:53)(cid:53)(cid:37)(cid:16)(cid:34)(cid:33,Unknown,18543.0
Unknown,Unknown,5,Unknown,Unknown,Unknown,Unknown,cid:12)(cid:29)(cid:26)(cid:41)(cid:25)(cid:2)(cid:53)(cid:53)(cid:37)(cid:16)(cid:34)(cid:33,Unknown,18548.0
Unknown,Unknown,2,Unknown,Unknown,Unknown,Unknown,cid:12)(cid:29)(cid:26)(cid:41)(cid:25)(cid:2)(cid:53)(cid:53)(cid:37)(cid:16)(cid:34)(cid:33,Unknown,18550.0
Unknown,Unknown,12,Unknown,Unknown,Unknown,Unknown,cid:12)(cid:29)(cid:26)(cid:41)(cid:25)(cid:2)(cid:53)(cid:53)(cid:37)(cid:16)(cid:34)(cid:33,Unknown,18562.0
Unknown,Unknown,13,Unknown,Unknown,Unknown,Unknown,cid:12)(cid:29)(cid:26)(cid:41)(cid:25)(cid:2)(cid:53)(cid:53)(cid:37)(cid:16)(cid:34)(cid:33,Unknown,18575.0
Unknown,Unknown,49,Unknown,Unknown,Unknown,Unknown,cid:12)(cid:29)(cid:26)(cid:41)(cid:25)(cid:2)(cid:53)(cid:53)(cid:37)(cid:16)(cid:34)(cid:33,Unknown,18624.0
Unknown,Unknown,2,Unknown,Unknown,Unknown,Unknown,cid:12)(cid:29)(cid:26)(cid:41)(cid:25)(cid:2)(cid:53)(cid:53)(cid:37)(cid:16)(cid:34)(cid:33,Unknown,18626.0
Unknown,Unknown,28,Unknown,Unknown,Unknown,Unknown,cid:12)(cid:29)(cid:26)(cid:41)(cid:25)(cid:2)(cid:53)(cid:53)(cid:37)(cid:16)(cid:34)(cid:33,Unknown,18654.0
Unknown,Unknown,3,Unknown,Unknown,Unknown,Unknown,cid:12)(cid:29)(cid:26)(cid:41)(cid:25)(cid:2)(cid:53)(cid:53)(cid:37)(cid:16)(cid:34)(cid:33,Unknown,18657.0
Unknown,Unknown,15,Unknown,Unknown,Unknown,Unknown,cid:12)(cid:29)(cid:26)(cid:41)(cid:25)(cid:2)(cid:53)(cid:53)(cid:37)(cid:16)(cid:34)(cid:33,Unknown,18672.0
Unknown,Unknown,2,Unknown,Unknown,Unknown,Unknown,cid:12)(cid:29)(cid:26)(cid:41)(cid:25)(cid:2)(cid:53)(cid:53)(cid:37)(cid:16)(cid:34)(cid:33,Unknown,18674.0
Unknown,Unknown,17,Unknown,Unknown,Unknown,Unknown,cid:12)(cid:29)(cid:26)(cid:41)(cid:25)(cid:2)(cid:53)(cid:53)(cid:37)(cid:16)(cid:34)(cid:33,Unknown,18691.0
Unknown,Unknown,18,Unknown,Unknown,Unknown,Unknown,cid:12)(cid:29)(cid:26)(cid:41)(cid:25)(cid:2)(cid:53)(cid:53)(cid:37)(cid:16)(cid:34)(cid:33,Unknown,18709.0
Unknown,Unknown,19,Unknown,Unknown,Unknown,Unknown,cid:12)(cid:29)(cid:26)(cid:41)(cid:25)(cid:2)(cid:53)(cid:53)(cid:37)(cid:16)(cid:34)(cid:33,Unknown,18728.0
Unknown,Unknown,18,Unknown,Unknown,Unknown,Unknown,cid:12)(cid:29)(cid:26)(cid:41)(cid:25)(cid:2)(cid:53)(cid:53)(cid:37)(cid:16)(cid:34)(cid:33,Unknown,18746.0
Unknown,Unknown,18,Unknown,Unknown,Unknown,Unknown,cid:12)(cid:29)(cid:26)(cid:41)(cid:25)(cid:2)(cid:53)(cid:53)(cid:37)(cid:16)(cid:34)(cid:33,Unknown,18764.0
Unknown,Unknown,2,Unknown,Unknown,Unknown,Unknown,cid:12)(cid:29)(cid:26)(cid:41)(cid:25)(cid:2)(cid:53)(cid:53)(cid:37)(cid:16)(cid:34)(cid:33,Unknown,18766.0
Unknown,Unknown,44,Unknown,Unknown,Unknown,Unknown,cid:12)(cid:29)(cid:26)(cid:41)(cid:25)(cid:2)(cid:53)(cid:53)(cid:37)(cid:16)(cid:34)(cid:33,Unknown,18810.0
Unknown,Unknown,12,Unknown,Unknown,Unknown,Unknown,cid:12)(cid:29)(cid:26)(cid:41)(cid:25)(cid:2)(cid:53)(cid:53)(cid:37)(cid:16)(cid:34)(cid:33,Unknown,18822.0
Unknown,Unknown,29,Unknown,Unknown,Unknown,Unknown,cid:12)(cid:29)(cid:26)(cid:41)(cid:25)(cid:2)(cid:53)(cid:53)(cid:37)(cid:16)(cid:34)(cid:33,Unknown,18851.0
Unknown,Unknown,26,Unknown,Unknown,Unknown,Unknown,cid:12)(cid:29)(cid:26)(cid:41)(cid:25)(cid:2)(cid:53)(cid:53)(cid:37)(cid:16)(cid:34)(cid:33,Unknown,18877.0
Unknown,Unknown,41,Unknown,Unknown,Unknown,Unknown,cid:12)(cid:29)(cid:26)(cid:41)(cid:25)(cid:2)(cid:53)(cid:53)(cid:37)(cid:16)(cid:34)(cid:33,Unknown,18918.0
Unknown,Unknown,25,Unknown,Unknown,Unknown,Unknown,cid:12)(cid:29)(cid:26)(cid:41)(cid:25)(cid:2)(cid:53)(cid:53)(cid:37)(cid:16)(cid:34)(cid:33,Unknown,18943.0
Unknown,Unknown,2,Unknown,Unknown,Unknown,Unknown,cid:12)(cid:29)(cid:26)(cid:41)(cid:25)(cid:2)(cid:53)(cid:53)(cid:37)(cid:16)(cid:34)(cid:33,Unknown,18945.0
Unknown,Unknown,53,Unknown,Unknown,Unknown,Unknown,cid:12)(cid:29)(cid:26)(cid:41)(cid:25)(cid:2)(cid:53)(cid:53)(cid:37)(cid:16)(cid:34)(cid:33,Unknown,18998.0
Unknown,Unknown,53,Unknown,Unknown,Unknown,Unknown,cid:12)(cid:29)(cid:26)(cid:41)(cid:25)(cid:2)(cid:53)(cid:53)(cid:37)(cid:16)(cid:34)(cid:33,Unknown,19051.0
Unknown,Unknown,18,Unknown,Unknown,Unknown,Unknown,cid:12)(cid:29)(cid:26)(cid:41)(cid:25)(cid:2)(cid:53)(cid:53)(cid:37)(cid:16)(cid:34)(cid:33,Unknown,19069.0
Unknown,Unknown,1,Unknown,Unknown,Unknown,Unknown,cid:12)(cid:29)(cid:26)(cid:41)(cid:25)(cid:2)(cid:53)(cid:53)(cid:37)(cid:16)(cid:34)(cid:33,Unknown,19070.0
Unknown,Unknown,1,Unknown,Unknown,Unknown,Unknown,cid:12)(cid:29)(cid:26)(cid:41)(cid:25)(cid:2)(cid:53)(cid:53)(cid:37)(cid:16)(cid:34)(cid:33,Unknown,19071.0
Unknown,Unknown,37,Unknown,Unknown,Unknown,Unknown,cid:12)(cid:29)(cid:26)(cid:41)(cid:25)(cid:2)(cid:53)(cid:53)(cid:37)(cid:16)(cid:34)(cid:33,Unknown,19108.0
Unknown,Unknown,1,Unknown,Unknown,Unknown,Unknown,cid:12)(cid:29)(cid:26)(cid:41)(cid:25)(cid:2)(cid:53)(cid:53)(cid:37)(cid:16)(cid:34)(cid:33,cid:1)(cid:34)(cid:45)(cid:18)(cid:34,1.0
Unknown,Unknown,34,Unknown,Unknown,Unknown,Unknown,cid:12)(cid:29)(cid:26)(cid:41)(cid:25)(cid:2)(cid:53)(cid:53)(cid:37)(cid:16)(cid:34)(cid:33,cid:1)(cid:34)(cid:45)(cid:18)(cid:34,35.0
Unknown,Unknown,45,Unknown,Unknown,Unknown,Unknown,cid:12)(cid:29)(cid:26)(cid:41)(cid:25)(cid:2)(cid:53)(cid:53)(cid:37)(cid:16)(cid:34)(cid:33,cid:1)(cid:32)(cid:45)(cid:18)(cid:34,80.0
Unknown,Unknown,18,Unknown,Unknown,Unknown,Unknown,cid:12)(cid:29)(cid:26)(cid:41)(cid:25)(cid:2)(cid:53)(cid:53)(cid:37)(cid:16)(cid:34)(cid:33,cid:1)(cid:32)(cid:45)(cid:18)(cid:34,98.0
Unknown,Unknown,34,Unknown,Unknown,Unknown,Unknown,cid:12)(cid:29)(cid:26)(cid:41)(cid:25)(cid:2)(cid:53)(cid:53)(cid:37)(cid:16)(cid:34)(cid:33,cid:1)(cid:16)(cid:45)(cid:18)(cid:34,132.0
Unknown,Unknown,5,Unknown,Unknown,Unknown,Unknown,cid:12)(cid:29)(cid:26)(cid:41)(cid:25)(cid:2)(cid:53)(cid:53)(cid:37)(cid:16)(cid:34)(cid:33,cid:12)(cid:11)(cid:8)(cid:28)(cid:11)(cid:3)(cid:49)(cid:62)(cid:49)(cid:2)(cid:8)(cid:49)(cid:8)(cid:10)(cid:5)(cid:4)(cid:7)(cid:14)(cid:2)(cid:14)(cid:2)(cid:28)(cid:3,137.0
Unknown,Unknown,10,Unknown,Unknown,Unknown,Unknown,cid:12)(cid:29)(cid:26)(cid:41)(cid:25)(cid:2)(cid:53)(cid:53)(cid:37)(cid:16)(cid:34)(cid:33,cid:1)(cid:16)(cid:45)(cid:18)(cid:34,147.0
Unknown,Unknown,49,Unknown,Unknown,Unknown,Unknown,cid:12)(cid:29)(cid:26)(cid:41)(cid:25)(cid:2)(cid:53)(cid:53)(cid:37)(cid:16)(cid:34)(cid:33,cid:1)(cid:16)(cid:45)(cid:18)(cid:34,196.0
Unknown,Unknown,47,Unknown,Unknown,Unknown,Unknown,cid:12)(cid:29)(cid:26)(cid:41)(cid:25)(cid:2)(cid:53)(cid:53)(cid:37)(cid:16)(cid:34)(cid:33,cid:1)(cid:16)(cid:45)(cid:18)(cid:34,243.0
Unknown,Unknown,14,Unknown,Unknown,Unknown,Unknown,cid:12)(cid:29)(cid:26)(cid:41)(cid:25)(cid:2)(cid:53)(cid:53)(cid:37)(cid:16)(cid:34)(cid:33,cid:9)(cid:49)(cid:8)(cid:5)(cid:28)(cid:2)(cid:9)(cid:5)(cid:8)(cid:14)(cid:7)(cid:9)(cid:2)(cid:28)(cid:3,257.0
Unknown,Unknown,7,Unknown,Unknown,Unknown,Unknown,cid:12)(cid:29)(cid:26)(cid:41)(cid:25)(cid:2)(cid:53)(cid:53)(cid:37)(cid:16)(cid:34)(cid:33,cid:9)(cid:21)(cid:23)(cid:4)(cid:55)(cid:2)(cid:53)(cid:62)(cid:11)(cid:10)(cid:11)(cid:47)(cid:3)(cid:7)(cid:5)(cid:2)(cid:39)(cid:3)(cid:11)(cid:63)(cid:7)(cid:2)(cid:39)(cid:11)(cid:7)(cid:46)(cid:8)(cid:65)(cid:2)(cid:28)(cid:3,264.0
Unknown,Unknown,9,Unknown,Unknown,Unknown,Unknown,cid:12)(cid:29)(cid:26)(cid:41)(cid:25)(cid:2)(cid:53)(cid:53)(cid:37)(cid:16)(cid:34)(cid:33,cid:1)(cid:33)(cid:45)(cid:18)(cid:34,273.0
Unknown,Unknown,9,Unknown,Unknown,Unknown,Unknown,cid:12)(cid:29)(cid:26)(cid:41)(cid:25)(cid:2)(cid:53)(cid:53)(cid:37)(cid:16)(cid:34)(cid:33,cid:1)(cid:33)(cid:45)(cid:18)(cid:34,282.0
Unknown,Unknown,5,Unknown,Unknown,Unknown,Unknown,cid:12)(cid:29)(cid:26)(cid:41)(cid:25)(cid:2)(cid:53)(cid:53)(cid:37)(cid:16)(cid:34)(cid:33,cid:1)(cid:33)(cid:45)(cid:18)(cid:34,287.0
Unknown,Unknown,62,Unknown,Unknown,Unknown,Unknown,cid:12)(cid:29)(cid:26)(cid:41)(cid:25)(cid:2)(cid:53)(cid:53)(cid:37)(cid:16)(cid:34)(cid:33,cid:1)(cid:33)(cid:45)(cid:18)(cid:34,349.0
Unknown,Unknown,5,Unknown,Unknown,Unknown,Unknown,cid:12)(cid:29)(cid:26)(cid:41)(cid:25)(cid:2)(cid:53)(cid:53)(cid:37)(cid:16)(cid:34)(cid:33,cid:1)(cid:33)(cid:45)(cid:18)(cid:34,354.0
Unknown,Unknown,8,Unknown,Unknown,Unknown,Unknown,cid:12)(cid:29)(cid:26)(cid:41)(cid:25)(cid:2)(cid:53)(cid:53)(cid:37)(cid:16)(cid:34)(cid:33,cid:7)(cid:8)(cid:10)(cid:5)(cid:3)(cid:9)(cid:39)(cid:11)(cid:3)(cid:10)(cid:2)(cid:12)(cid:11)(cid:4)(cid:14)(cid:11)(cid:62)(cid:62)(cid:7)(cid:5)(cid:3)(cid:9)(cid:2)(cid:28)(cid:3,362.0
Unknown,Unknown,10,Unknown,Unknown,Unknown,Unknown,cid:12)(cid:29)(cid:26)(cid:41)(cid:25)(cid:2)(cid:53)(cid:53)(cid:37)(cid:16)(cid:34)(cid:33,Unknown,372.0
Unknown,Unknown,9,Unknown,Unknown,Unknown,Unknown,cid:12)(cid:29)(cid:26)(cid:41)(cid:25)(cid:2)(cid:53)(cid:53)(cid:37)(cid:16)(cid:34)(cid:33,Unknown,381.0
Unknown,Unknown,2,Unknown,Unknown,Unknown,Unknown,cid:12)(cid:29)(cid:26)(cid:41)(cid:25)(cid:2)(cid:53)(cid:53)(cid:37)(cid:16)(cid:34)(cid:33,Unknown,383.0
Unknown,Unknown,10,Unknown,Unknown,Unknown,Unknown,cid:12)(cid:29)(cid:26)(cid:41)(cid:25)(cid:2)(cid:53)(cid:53)(cid:37)(cid:16)(cid:34)(cid:33,Unknown,393.0
Unknown,Unknown,11,Unknown,Unknown,Unknown,Unknown,cid:12)(cid:29)(cid:26)(cid:41)(cid:25)(cid:2)(cid:53)(cid:53)(cid:37)(cid:16)(cid:34)(cid:33,Unknown,404.0
Unknown,Unknown,8,Unknown,Unknown,Unknown,Unknown,cid:12)(cid:29)(cid:26)(cid:41)(cid:25)(cid:2)(cid:53)(cid:53)(cid:37)(cid:16)(cid:34)(cid:33,Unknown,412.0
Unknown,Unknown,65,Unknown,Unknown,Unknown,Unknown,cid:12)(cid:29)(cid:26)(cid:41)(cid:25)(cid:2)(cid:53)(cid:53)(cid:37)(cid:16)(cid:34)(cid:33,Unknown,477.0
Unknown,Unknown,2,Unknown,Unknown,Unknown,Unknown,cid:12)(cid:29)(cid:26)(cid:41)(cid:25)(cid:2)(cid:53)(cid:53)(cid:37)(cid:16)(cid:34)(cid:33,Unknown,479.0
Unknown,Unknown,13,Unknown,Unknown,Unknown,Unknown,cid:12)(cid:29)(cid:26)(cid:41)(cid:25)(cid:2)(cid:53)(cid:53)(cid:37)(cid:16)(cid:34)(cid:33,Unknown,492.0
Unknown,Unknown,5,Unknown,Unknown,Unknown,Unknown,cid:12)(cid:29)(cid:26)(cid:41)(cid:25)(cid:2)(cid:53)(cid:53)(cid:37)(cid:16)(cid:34)(cid:33,Unknown,497.0
Unknown,Unknown,8,Unknown,Unknown,Unknown,Unknown,cid:12)(cid:29)(cid:26)(cid:41)(cid:25)(cid:2)(cid:53)(cid:53)(cid:37)(cid:16)(cid:34)(cid:33,Unknown,505.0
Unknown,Unknown,3,Unknown,Unknown,Unknown,Unknown,cid:12)(cid:29)(cid:26)(cid:41)(cid:25)(cid:2)(cid:53)(cid:53)(cid:37)(cid:16)(cid:34)(cid:33,Unknown,508.0
Unknown,Unknown,65,Unknown,Unknown,Unknown,Unknown,cid:12)(cid:29)(cid:26)(cid:41)(cid:25)(cid:2)(cid:53)(cid:53)(cid:37)(cid:16)(cid:34)(cid:33,Unknown,573.0
Unknown,Unknown,43,Unknown,Unknown,Unknown,Unknown,cid:12)(cid:29)(cid:26)(cid:41)(cid:25)(cid:2)(cid:53)(cid:53)(cid:37)(cid:16)(cid:34)(cid:33,Unknown,616.0
Unknown,Unknown,2,Unknown,Unknown,Unknown,Unknown,cid:12)(cid:29)(cid:26)(cid:41)(cid:25)(cid:2)(cid:53)(cid:53)(cid:37)(cid:16)(cid:34)(cid:33,Unknown,618.0
Unknown,Unknown,1,Unknown,Unknown,Unknown,Unknown,cid:12)(cid:29)(cid:26)(cid:41)(cid:25)(cid:2)(cid:53)(cid:53)(cid:37)(cid:16)(cid:34)(cid:33,Unknown,619.0
Unknown,Unknown,34,Unknown,Unknown,Unknown,Unknown,cid:12)(cid:29)(cid:26)(cid:41)(cid:25)(cid:2)(cid:53)(cid:53)(cid:37)(cid:16)(cid:34)(cid:33,Unknown,653.0
Unknown,Unknown,2,Unknown,Unknown,Unknown,Unknown,cid:12)(cid:29)(cid:26)(cid:41)(cid:25)(cid:2)(cid:53)(cid:53)(cid:37)(cid:16)(cid:34)(cid:33,Unknown,655.0
Unknown,Unknown,18,Unknown,Unknown,Unknown,Unknown,cid:12)(cid:29)(cid:26)(cid:41)(cid:25)(cid:2)(cid:53)(cid:53)(cid:37)(cid:16)(cid:34)(cid:33,Unknown,673.0
Unknown,Unknown,18,Unknown,Unknown,Unknown,Unknown,cid:12)(cid:29)(cid:26)(cid:41)(cid:25)(cid:2)(cid:53)(cid:53)(cid:37)(cid:16)(cid:34)(cid:33,Unknown,691.0
Unknown,Unknown,18,Unknown,Unknown,Unknown,Unknown,cid:12)(cid:29)(cid:26)(cid:41)(cid:25)(cid:2)(cid:53)(cid:53)(cid:37)(cid:16)(cid:34)(cid:33,Unknown,709.0
Unknown,Unknown,19,Unknown,Unknown,Unknown,Unknown,cid:12)(cid:29)(cid:26)(cid:41)(cid:25)(cid:2)(cid:53)(cid:53)(cid:37)(cid:16)(cid:34)(cid:33,Unknown,728.0
Unknown,Unknown,18,Unknown,Unknown,Unknown,Unknown,cid:12)(cid:29)(cid:26)(cid:41)(cid:25)(cid:2)(cid:53)(cid:53)(cid:37)(cid:16)(cid:34)(cid:33,Unknown,746.0
Unknown,Unknown,18,Unknown,Unknown,Unknown,Unknown,cid:12)(cid:29)(cid:26)(cid:41)(cid:25)(cid:2)(cid:53)(cid:53)(cid:37)(cid:16)(cid:34)(cid:33,Unknown,764.0
Unknown,Unknown,2,Unknown,Unknown,Unknown,Unknown,cid:12)(cid:29)(cid:26)(cid:41)(cid:25)(cid:2)(cid:53)(cid:53)(cid:37)(cid:16)(cid:34)(cid:33,Unknown,766.0
Unknown,Unknown,44,Unknown,Unknown,Unknown,Unknown,cid:12)(cid:29)(cid:26)(cid:41)(cid:25)(cid:2)(cid:53)(cid:53)(cid:37)(cid:16)(cid:34)(cid:33,Unknown,810.0
Unknown,Unknown,63,Unknown,Unknown,Unknown,Unknown,cid:12)(cid:29)(cid:26)(cid:41)(cid:25)(cid:2)(cid:53)(cid:53)(cid:37)(cid:16)(cid:34)(cid:33,Unknown,873.0
Unknown,Unknown,7,Unknown,Unknown,Unknown,Unknown,cid:12)(cid:29)(cid:26)(cid:41)(cid:25)(cid:2)(cid:53)(cid:53)(cid:37)(cid:16)(cid:34)(cid:33,Unknown,880.0
Unknown,Unknown,3,Unknown,Unknown,Unknown,Unknown,cid:12)(cid:29)(cid:26)(cid:41)(cid:25)(cid:2)(cid:53)(cid:53)(cid:37)(cid:16)(cid:34)(cid:33,Unknown,883.0
Unknown,Unknown,5,Unknown,Unknown,Unknown,Unknown,cid:12)(cid:29)(cid:26)(cid:41)(cid:25)(cid:2)(cid:53)(cid:53)(cid:37)(cid:16)(cid:34)(cid:33,Unknown,888.0
Unknown,Unknown,62,Unknown,Unknown,Unknown,Unknown,cid:12)(cid:29)(cid:26)(cid:41)(cid:25)(cid:2)(cid:53)(cid:53)(cid:37)(cid:16)(cid:34)(cid:33,Unknown,950.0
Unknown,Unknown,5,Unknown,Unknown,Unknown,Unknown,cid:12)(cid:29)(cid:26)(cid:41)(cid:25)(cid:2)(cid:53)(cid:53)(cid:37)(cid:16)(cid:34)(cid:33,Unknown,955.0
Unknown,Unknown,8,Unknown,Unknown,Unknown,Unknown,cid:12)(cid:29)(cid:26)(cid:41)(cid:25)(cid:2)(cid:53)(cid:53)(cid:37)(cid:16)(cid:34)(cid:33,Unknown,963.0
Unknown,Unknown,10,Unknown,Unknown,Unknown,Unknown,cid:12)(cid:29)(cid:26)(cid:41)(cid:25)(cid:2)(cid:53)(cid:53)(cid:37)(cid:16)(cid:34)(cid:33,Unknown,973.0
Unknown,Unknown,2,Unknown,Unknown,Unknown,Unknown,cid:12)(cid:29)(cid:26)(cid:41)(cid:25)(cid:2)(cid:53)(cid:53)(cid:37)(cid:16)(cid:34)(cid:33,Unknown,975.0
Unknown,Unknown,5,Unknown,Unknown,Unknown,Unknown,cid:12)(cid:29)(cid:26)(cid:41)(cid:25)(cid:2)(cid:53)(cid:53)(cid:37)(cid:16)(cid:34)(cid:33,Unknown,980.0
Unknown,Unknown,46,Unknown,Unknown,Unknown,Unknown,cid:12)(cid:29)(cid:26)(cid:41)(cid:25)(cid:2)(cid:53)(cid:53)(cid:37)(cid:16)(cid:34)(cid:33,Unknown,1026.0
Unknown,Unknown,47,Unknown,Unknown,Unknown,Unknown,cid:12)(cid:29)(cid:26)(cid:41)(cid:25)(cid:2)(cid:53)(cid:53)(cid:37)(cid:16)(cid:34)(cid:33,Unknown,1073.0
Unknown,Unknown,1,Unknown,Unknown,Unknown,Unknown,cid:12)(cid:29)(cid:26)(cid:41)(cid:25)(cid:2)(cid:53)(cid:53)(cid:37)(cid:16)(cid:34)(cid:33,Unknown,1074.0
Unknown,Unknown,34,Unknown,Unknown,Unknown,Unknown,cid:12)(cid:29)(cid:26)(cid:41)(cid:25)(cid:2)(cid:53)(cid:53)(cid:37)(cid:16)(cid:34)(cid:33,Unknown,1108.0
Unknown,Unknown,45,Unknown,Unknown,Unknown,Unknown,cid:12)(cid:29)(cid:26)(cid:41)(cid:25)(cid:2)(cid:53)(cid:53)(cid:37)(cid:16)(cid:34)(cid:33,Unknown,1153.0
Unknown,Unknown,18,Unknown,Unknown,Unknown,Unknown,cid:12)(cid:29)(cid:26)(cid:41)(cid:25)(cid:2)(cid:53)(cid:53)(cid:37)(cid:16)(cid:34)(cid:33,Unknown,1171.0
Unknown,Unknown,34,Unknown,Unknown,Unknown,Unknown,cid:12)(cid:29)(cid:26)(cid:41)(cid:25)(cid:2)(cid:53)(cid:53)(cid:37)(cid:16)(cid:34)(cid:33,Unknown,1205.0
Unknown,Unknown,62,Unknown,Unknown,Unknown,Unknown,cid:12)(cid:29)(cid:26)(cid:41)(cid:25)(cid:2)(cid:53)(cid:53)(cid:37)(cid:16)(cid:34)(cid:33,Unknown,1267.0
Unknown,Unknown,12,Unknown,Unknown,Unknown,Unknown,cid:12)(cid:29)(cid:26)(cid:41)(cid:25)(cid:2)(cid:53)(cid:53)(cid:37)(cid:16)(cid:34)(cid:33,Unknown,1279.0
Unknown,Unknown,2,Unknown,Unknown,Unknown,Unknown,cid:12)(cid:29)(cid:26)(cid:41)(cid:25)(cid:2)(cid:53)(cid:53)(cid:37)(cid:16)(cid:34)(cid:33,Unknown,1281.0
Unknown,Unknown,52,Unknown,Unknown,Unknown,Unknown,cid:12)(cid:29)(cid:26)(cid:41)(cid:25)(cid:2)(cid:53)(cid:53)(cid:37)(cid:16)(cid:34)(cid:33,Unknown,1333.0
Unknown,Unknown,11,Unknown,Unknown,Unknown,Unknown,cid:12)(cid:29)(cid:26)(cid:41)(cid:25)(cid:2)(cid:53)(cid:53)(cid:37)(cid:16)(cid:34)(cid:33,Unknown,1344.0
Unknown,Unknown,8,Unknown,Unknown,Unknown,Unknown,cid:12)(cid:29)(cid:26)(cid:41)(cid:25)(cid:2)(cid:53)(cid:53)(cid:37)(cid:16)(cid:34)(cid:33,Unknown,1352.0
Unknown,Unknown,49,Unknown,Unknown,Unknown,Unknown,cid:12)(cid:29)(cid:26)(cid:41)(cid:25)(cid:2)(cid:53)(cid:53)(cid:37)(cid:16)(cid:34)(cid:33,Unknown,1401.0
Unknown,Unknown,14,Unknown,Unknown,Unknown,Unknown,cid:12)(cid:29)(cid:26)(cid:41)(cid:25)(cid:2)(cid:53)(cid:53)(cid:37)(cid:16)(cid:34)(cid:33,Unknown,1415.0
Unknown,Unknown,52,Unknown,Unknown,Unknown,Unknown,cid:12)(cid:29)(cid:26)(cid:41)(cid:25)(cid:2)(cid:53)(cid:53)(cid:37)(cid:16)(cid:34)(cid:33,Unknown,1467.0
Unknown,Unknown,68,Unknown,Unknown,Unknown,Unknown,cid:12)(cid:29)(cid:26)(cid:41)(cid:25)(cid:2)(cid:53)(cid:53)(cid:37)(cid:16)(cid:34)(cid:33,Unknown,1535.0
Unknown,Unknown,9,Unknown,Unknown,Unknown,Unknown,cid:12)(cid:29)(cid:26)(cid:41)(cid:25)(cid:2)(cid:53)(cid:53)(cid:37)(cid:16)(cid:34)(cid:33,Unknown,1544.0
Unknown,Unknown,2,Unknown,Unknown,Unknown,Unknown,cid:12)(cid:29)(cid:26)(cid:41)(cid:25)(cid:2)(cid:53)(cid:53)(cid:37)(cid:16)(cid:34)(cid:33,Unknown,1546.0
Unknown,Unknown,12,Unknown,Unknown,Unknown,Unknown,cid:12)(cid:29)(cid:26)(cid:41)(cid:25)(cid:2)(cid:53)(cid:53)(cid:37)(cid:16)(cid:34)(cid:33,Unknown,1558.0
Unknown,Unknown,11,Unknown,Unknown,Unknown,Unknown,cid:12)(cid:29)(cid:26)(cid:41)(cid:25)(cid:2)(cid:53)(cid:53)(cid:37)(cid:16)(cid:34)(cid:33,Unknown,1569.0
Unknown,Unknown,4,Unknown,Unknown,Unknown,Unknown,cid:12)(cid:29)(cid:26)(cid:41)(cid:25)(cid:2)(cid:53)(cid:53)(cid:37)(cid:16)(cid:34)(cid:33,Unknown,1573.0
Unknown,Unknown,14,Unknown,Unknown,Unknown,Unknown,cid:12)(cid:29)(cid:26)(cid:41)(cid:25)(cid:2)(cid:53)(cid:53)(cid:37)(cid:16)(cid:34)(cid:33,Unknown,1587.0
Unknown,Unknown,11,Unknown,Unknown,Unknown,Unknown,cid:12)(cid:29)(cid:26)(cid:41)(cid:25)(cid:2)(cid:53)(cid:53)(cid:37)(cid:16)(cid:34)(cid:33,Unknown,1598.0
Unknown,Unknown,62,Unknown,Unknown,Unknown,Unknown,cid:12)(cid:29)(cid:26)(cid:41)(cid:25)(cid:2)(cid:53)(cid:53)(cid:37)(cid:16)(cid:34)(cid:33,Unknown,1660.0
Unknown,Unknown,62,Unknown,Unknown,Unknown,Unknown,cid:12)(cid:29)(cid:26)(cid:41)(cid:25)(cid:2)(cid:53)(cid:53)(cid:37)(cid:16)(cid:34)(cid:33,Unknown,1722.0
Unknown,Unknown,7,Unknown,Unknown,Unknown,Unknown,cid:12)(cid:29)(cid:26)(cid:41)(cid:25)(cid:2)(cid:53)(cid:53)(cid:37)(cid:16)(cid:34)(cid:33,Unknown,1729.0
Unknown,Unknown,5,Unknown,Unknown,Unknown,Unknown,cid:12)(cid:29)(cid:26)(cid:41)(cid:25)(cid:2)(cid:53)(cid:53)(cid:37)(cid:16)(cid:34)(cid:33,Unknown,1734.0
Unknown,Unknown,3,Unknown,Unknown,Unknown,Unknown,cid:12)(cid:29)(cid:26)(cid:41)(cid:25)(cid:2)(cid:53)(cid:53)(cid:37)(cid:16)(cid:34)(cid:33,Unknown,1737.0
Unknown,Unknown,2,Unknown,Unknown,Unknown,Unknown,cid:12)(cid:29)(cid:26)(cid:41)(cid:25)(cid:2)(cid:53)(cid:53)(cid:37)(cid:16)(cid:34)(cid:33,Unknown,1739.0
Unknown,Unknown,28,Unknown,Unknown,Unknown,Unknown,cid:12)(cid:29)(cid:26)(cid:41)(cid:25)(cid:2)(cid:53)(cid:53)(cid:37)(cid:16)(cid:34)(cid:33,Unknown,1767.0
Unknown,Unknown,3,Unknown,Unknown,Unknown,Unknown,cid:12)(cid:29)(cid:26)(cid:41)(cid:25)(cid:2)(cid:53)(cid:53)(cid:37)(cid:16)(cid:34)(cid:33,Unknown,1770.0
Unknown,Unknown,15,Unknown,Unknown,Unknown,Unknown,cid:12)(cid:29)(cid:26)(cid:41)(cid:25)(cid:2)(cid:53)(cid:53)(cid:37)(cid:16)(cid:34)(cid:33,Unknown,1785.0
Unknown,Unknown,2,Unknown,Unknown,Unknown,Unknown,cid:12)(cid:29)(cid:26)(cid:41)(cid:25)(cid:2)(cid:53)(cid:53)(cid:37)(cid:16)(cid:34)(cid:33,Unknown,1787.0
Unknown,Unknown,17,Unknown,Unknown,Unknown,Unknown,cid:12)(cid:29)(cid:26)(cid:41)(cid:25)(cid:2)(cid:53)(cid:53)(cid:37)(cid:16)(cid:34)(cid:33,Unknown,1804.0
Unknown,Unknown,36,Unknown,Unknown,Unknown,Unknown,cid:12)(cid:29)(cid:26)(cid:41)(cid:25)(cid:2)(cid:53)(cid:53)(cid:37)(cid:16)(cid:34)(cid:33,Unknown,1840.0
Unknown,Unknown,19,Unknown,Unknown,Unknown,Unknown,cid:12)(cid:29)(cid:26)(cid:41)(cid:25)(cid:2)(cid:53)(cid:53)(cid:37)(cid:16)(cid:34)(cid:33,Unknown,1859.0
Unknown,Unknown,36,Unknown,Unknown,Unknown,Unknown,cid:12)(cid:29)(cid:26)(cid:41)(cid:25)(cid:2)(cid:53)(cid:53)(cid:37)(cid:16)(cid:34)(cid:33,Unknown,1895.0
Unknown,Unknown,18,Unknown,Unknown,Unknown,Unknown,cid:12)(cid:29)(cid:26)(cid:41)(cid:25)(cid:2)(cid:53)(cid:53)(cid:37)(cid:16)(cid:34)(cid:33,Unknown,1913.0
Unknown,Unknown,2,Unknown,Unknown,Unknown,Unknown,cid:12)(cid:29)(cid:26)(cid:41)(cid:25)(cid:2)(cid:53)(cid:53)(cid:37)(cid:16)(cid:34)(cid:33,Unknown,1915.0
Unknown,Unknown,44,Unknown,Unknown,Unknown,Unknown,cid:12)(cid:29)(cid:26)(cid:41)(cid:25)(cid:2)(cid:53)(cid:53)(cid:37)(cid:16)(cid:34)(cid:33,Unknown,1959.0
Unknown,Unknown,12,Unknown,Unknown,Unknown,Unknown,cid:12)(cid:29)(cid:26)(cid:41)(cid:25)(cid:2)(cid:53)(cid:53)(cid:37)(cid:16)(cid:34)(cid:33,Unknown,1971.0
Unknown,Unknown,29,Unknown,Unknown,Unknown,Unknown,cid:12)(cid:29)(cid:26)(cid:41)(cid:25)(cid:2)(cid:53)(cid:53)(cid:37)(cid:16)(cid:34)(cid:33,Unknown,2000.0
Unknown,Unknown,26,Unknown,Unknown,Unknown,Unknown,cid:12)(cid:29)(cid:26)(cid:41)(cid:25)(cid:2)(cid:53)(cid:53)(cid:37)(cid:16)(cid:34)(cid:33,Unknown,2026.0
Unknown,Unknown,41,Unknown,Unknown,Unknown,Unknown,cid:12)(cid:29)(cid:26)(cid:41)(cid:25)(cid:2)(cid:53)(cid:53)(cid:37)(cid:16)(cid:34)(cid:33,Unknown,2067.0
Unknown,Unknown,25,Unknown,Unknown,Unknown,Unknown,cid:12)(cid:29)(cid:26)(cid:41)(cid:25)(cid:2)(cid:53)(cid:53)(cid:37)(cid:16)(cid:34)(cid:33,Unknown,2092.0
Unknown,Unknown,2,Unknown,Unknown,Unknown,Unknown,cid:12)(cid:29)(cid:26)(cid:41)(cid:25)(cid:2)(cid:53)(cid:53)(cid:37)(cid:16)(cid:34)(cid:33,Unknown,2094.0
Unknown,Unknown,53,Unknown,Unknown,Unknown,Unknown,cid:12)(cid:29)(cid:26)(cid:41)(cid:25)(cid:2)(cid:53)(cid:53)(cid:37)(cid:16)(cid:34)(cid:33,Unknown,2147.0
Unknown,Unknown,53,Unknown,Unknown,Unknown,Unknown,cid:12)(cid:29)(cid:26)(cid:41)(cid:25)(cid:2)(cid:53)(cid:53)(cid:37)(cid:16)(cid:34)(cid:33,Unknown,2200.0
Unknown,Unknown,37,Unknown,Unknown,Unknown,Unknown,cid:12)(cid:29)(cid:26)(cid:41)(cid:25)(cid:2)(cid:53)(cid:53)(cid:37)(cid:16)(cid:34)(cid:33,Unknown,2237.0
Unknown,Unknown,16,Unknown,Unknown,Unknown,Unknown,cid:12)(cid:29)(cid:26)(cid:41)(cid:25)(cid:2)(cid:53)(cid:53)(cid:37)(cid:16)(cid:34)(cid:33,Unknown,2253.0
Unknown,Unknown,34,Unknown,Unknown,Unknown,Unknown,cid:12)(cid:29)(cid:26)(cid:41)(cid:25)(cid:2)(cid:53)(cid:53)(cid:37)(cid:16)(cid:34)(cid:33,Unknown,2287.0
Unknown,Unknown,33,Unknown,Unknown,Unknown,Unknown,cid:12)(cid:29)(cid:26)(cid:41)(cid:25)(cid:2)(cid:53)(cid:53)(cid:37)(cid:16)(cid:34)(cid:33,Unknown,2320.0
Unknown,Unknown,1,Unknown,Unknown,Unknown,Unknown,cid:12)(cid:29)(cid:26)(cid:41)(cid:25)(cid:2)(cid:53)(cid:53)(cid:37)(cid:16)(cid:34)(cid:33,Unknown,2321.0
Unknown,Unknown,32,Unknown,Unknown,Unknown,Unknown,cid:12)(cid:29)(cid:26)(cid:41)(cid:25)(cid:2)(cid:53)(cid:53)(cid:37)(cid:16)(cid:34)(cid:33,Unknown,2353.0
Unknown,Unknown,45,Unknown,Unknown,Unknown,Unknown,cid:12)(cid:29)(cid:26)(cid:41)(cid:25)(cid:2)(cid:53)(cid:53)(cid:37)(cid:16)(cid:34)(cid:33,Unknown,2398.0
Unknown,Unknown,18,Unknown,Unknown,Unknown,Unknown,cid:12)(cid:29)(cid:26)(cid:41)(cid:25)(cid:2)(cid:53)(cid:53)(cid:37)(cid:16)(cid:34)(cid:33,Unknown,2416.0
Unknown,Unknown,34,Unknown,Unknown,Unknown,Unknown,cid:12)(cid:29)(cid:26)(cid:41)(cid:25)(cid:2)(cid:53)(cid:53)(cid:37)(cid:16)(cid:34)(cid:33,Unknown,2450.0
Unknown,Unknown,25,Unknown,Unknown,Unknown,Unknown,cid:12)(cid:29)(cid:26)(cid:41)(cid:25)(cid:2)(cid:53)(cid:53)(cid:37)(cid:16)(cid:34)(cid:33,Unknown,2475.0
Unknown,Unknown,21,Unknown,Unknown,Unknown,Unknown,cid:12)(cid:29)(cid:26)(cid:41)(cid:25)(cid:2)(cid:53)(cid:53)(cid:37)(cid:16)(cid:34)(cid:33,Unknown,2496.0
Unknown,Unknown,26,Unknown,Unknown,Unknown,Unknown,cid:12)(cid:29)(cid:26)(cid:41)(cid:25)(cid:2)(cid:53)(cid:53)(cid:37)(cid:16)(cid:34)(cid:33,Unknown,2522.0
Unknown,Unknown,22,Unknown,Unknown,Unknown,Unknown,cid:12)(cid:29)(cid:26)(cid:41)(cid:25)(cid:2)(cid:53)(cid:53)(cid:37)(cid:16)(cid:34)(cid:33,Unknown,2544.0
Unknown,Unknown,2,Unknown,Unknown,Unknown,Unknown,cid:12)(cid:29)(cid:26)(cid:41)(cid:25)(cid:2)(cid:53)(cid:53)(cid:37)(cid:16)(cid:34)(cid:33,Unknown,2546.0
Unknown,Unknown,69,Unknown,Unknown,Unknown,Unknown,cid:12)(cid:29)(cid:26)(cid:41)(cid:25)(cid:2)(cid:53)(cid:53)(cid:37)(cid:16)(cid:34)(cid:33,Unknown,2615.0
Unknown,Unknown,25,Unknown,Unknown,Unknown,Unknown,cid:12)(cid:29)(cid:26)(cid:41)(cid:25)(cid:2)(cid:53)(cid:53)(cid:37)(cid:16)(cid:34)(cid:33,Unknown,2640.0
Unknown,Unknown,70,Unknown,Unknown,Unknown,Unknown,cid:12)(cid:29)(cid:26)(cid:41)(cid:25)(cid:2)(cid:53)(cid:53)(cid:37)(cid:16)(cid:34)(cid:33,Unknown,2710.0
Unknown,Unknown,25,Unknown,Unknown,Unknown,Unknown,cid:12)(cid:29)(cid:26)(cid:41)(cid:25)(cid:2)(cid:53)(cid:53)(cid:37)(cid:16)(cid:34)(cid:33,Unknown,2735.0
Unknown,Unknown,69,Unknown,Unknown,Unknown,Unknown,cid:12)(cid:29)(cid:26)(cid:41)(cid:25)(cid:2)(cid:53)(cid:53)(cid:37)(cid:16)(cid:34)(cid:33,Unknown,2804.0
Unknown,Unknown,25,Unknown,Unknown,Unknown,Unknown,cid:12)(cid:29)(cid:26)(cid:41)(cid:25)(cid:2)(cid:53)(cid:53)(cid:37)(cid:16)(cid:34)(cid:33,Unknown,2829.0
Unknown,Unknown,30,Unknown,Unknown,Unknown,Unknown,cid:12)(cid:29)(cid:26)(cid:41)(cid:25)(cid:2)(cid:53)(cid:53)(cid:37)(cid:16)(cid:34)(cid:33,Unknown,2859.0
Unknown,Unknown,15,Unknown,Unknown,Unknown,Unknown,cid:12)(cid:29)(cid:26)(cid:41)(cid:25)(cid:2)(cid:53)(cid:53)(cid:37)(cid:16)(cid:34)(cid:33,Unknown,2874.0
Unknown,Unknown,2,Unknown,Unknown,Unknown,Unknown,cid:12)(cid:29)(cid:26)(cid:41)(cid:25)(cid:2)(cid:53)(cid:53)(cid:37)(cid:16)(cid:34)(cid:33,Unknown,2876.0
Unknown,Unknown,17,Unknown,Unknown,Unknown,Unknown,cid:12)(cid:29)(cid:26)(cid:41)(cid:25)(cid:2)(cid:53)(cid:53)(cid:37)(cid:16)(cid:34)(cid:33,Unknown,2893.0
Unknown,Unknown,2,Unknown,Unknown,Unknown,Unknown,cid:12)(cid:29)(cid:26)(cid:41)(cid:25)(cid:2)(cid:53)(cid:53)(cid:37)(cid:16)(cid:34)(cid:33,Unknown,2895.0
Unknown,Unknown,18,Unknown,Unknown,Unknown,Unknown,cid:12)(cid:29)(cid:26)(cid:41)(cid:25)(cid:2)(cid:53)(cid:53)(cid:37)(cid:16)(cid:34)(cid:33,Unknown,2913.0
Unknown,Unknown,32,Unknown,Unknown,Unknown,Unknown,cid:12)(cid:29)(cid:26)(cid:41)(cid:25)(cid:2)(cid:53)(cid:53)(cid:37)(cid:16)(cid:34)(cid:33,Unknown,2945.0
Unknown,Unknown,17,Unknown,Unknown,Unknown,Unknown,cid:12)(cid:29)(cid:26)(cid:41)(cid:25)(cid:2)(cid:53)(cid:53)(cid:37)(cid:16)(cid:34)(cid:33,Unknown,2962.0
Unknown,Unknown,19,Unknown,Unknown,Unknown,Unknown,cid:12)(cid:29)(cid:26)(cid:41)(cid:25)(cid:2)(cid:53)(cid:53)(cid:37)(cid:16)(cid:34)(cid:33,Unknown,2981.0
Unknown,Unknown,18,Unknown,Unknown,Unknown,Unknown,cid:12)(cid:29)(cid:26)(cid:41)(cid:25)(cid:2)(cid:53)(cid:53)(cid:37)(cid:16)(cid:34)(cid:33,Unknown,2999.0
Unknown,Unknown,1,Unknown,Unknown,Unknown,Unknown,cid:12)(cid:29)(cid:26)(cid:41)(cid:25)(cid:2)(cid:53)(cid:53)(cid:37)(cid:16)(cid:34)(cid:33,Unknown,3000.0
Unknown,Unknown,2,Unknown,Unknown,Unknown,Unknown,cid:12)(cid:29)(cid:26)(cid:41)(cid:25)(cid:2)(cid:53)(cid:53)(cid:37)(cid:16)(cid:34)(cid:33,Unknown,3002.0
Unknown,Unknown,44,Unknown,Unknown,Unknown,Unknown,cid:12)(cid:29)(cid:26)(cid:41)(cid:25)(cid:2)(cid:53)(cid:53)(cid:37)(cid:16)(cid:34)(cid:33,Unknown,3046.0
Unknown,Unknown,71,Unknown,Unknown,Unknown,Unknown,cid:12)(cid:29)(cid:26)(cid:41)(cid:25)(cid:2)(cid:53)(cid:53)(cid:37)(cid:16)(cid:34)(cid:33,Unknown,3117.0
Unknown,Unknown,29,Unknown,Unknown,Unknown,Unknown,cid:12)(cid:29)(cid:26)(cid:41)(cid:25)(cid:2)(cid:53)(cid:53)(cid:37)(cid:16)(cid:34)(cid:33,Unknown,3146.0
Unknown,Unknown,31,Unknown,Unknown,Unknown,Unknown,cid:12)(cid:29)(cid:26)(cid:41)(cid:25)(cid:2)(cid:53)(cid:53)(cid:37)(cid:16)(cid:34)(cid:33,Unknown,3177.0
Unknown,Unknown,41,Unknown,Unknown,Unknown,Unknown,cid:12)(cid:29)(cid:26)(cid:41)(cid:25)(cid:2)(cid:53)(cid:53)(cid:37)(cid:16)(cid:34)(cid:33,Unknown,3218.0
Unknown,Unknown,21,Unknown,Unknown,Unknown,Unknown,cid:12)(cid:29)(cid:26)(cid:41)(cid:25)(cid:2)(cid:53)(cid:53)(cid:37)(cid:16)(cid:34)(cid:33,Unknown,3239.0
Unknown,Unknown,26,Unknown,Unknown,Unknown,Unknown,cid:12)(cid:29)(cid:26)(cid:41)(cid:25)(cid:2)(cid:53)(cid:53)(cid:37)(cid:16)(cid:34)(cid:33,Unknown,3265.0
Unknown,Unknown,25,Unknown,Unknown,Unknown,Unknown,cid:12)(cid:29)(cid:26)(cid:41)(cid:25)(cid:2)(cid:53)(cid:53)(cid:37)(cid:16)(cid:34)(cid:33,Unknown,3290.0
Unknown,Unknown,2,Unknown,Unknown,Unknown,Unknown,cid:12)(cid:29)(cid:26)(cid:41)(cid:25)(cid:2)(cid:53)(cid:53)(cid:37)(cid:16)(cid:34)(cid:33,Unknown,3292.0
Unknown,Unknown,51,Unknown,Unknown,Unknown,Unknown,cid:12)(cid:29)(cid:26)(cid:41)(cid:25)(cid:2)(cid:53)(cid:53)(cid:37)(cid:16)(cid:34)(cid:33,Unknown,3343.0
Unknown,Unknown,25,Unknown,Unknown,Unknown,Unknown,cid:12)(cid:29)(cid:26)(cid:41)(cid:25)(cid:2)(cid:53)(cid:53)(cid:37)(cid:16)(cid:34)(cid:33,Unknown,3368.0
Unknown,Unknown,50,Unknown,Unknown,Unknown,Unknown,cid:12)(cid:29)(cid:26)(cid:41)(cid:25)(cid:2)(cid:53)(cid:53)(cid:37)(cid:16)(cid:34)(cid:33,Unknown,3418.0
Unknown,Unknown,29,Unknown,Unknown,Unknown,Unknown,cid:12)(cid:29)(cid:26)(cid:41)(cid:25)(cid:2)(cid:53)(cid:53)(cid:37)(cid:16)(cid:34)(cid:33,Unknown,3447.0
Unknown,Unknown,26,Unknown,Unknown,Unknown,Unknown,cid:12)(cid:29)(cid:26)(cid:41)(cid:25)(cid:2)(cid:53)(cid:53)(cid:37)(cid:16)(cid:34)(cid:33,Unknown,3473.0
Unknown,Unknown,51,Unknown,Unknown,Unknown,Unknown,cid:12)(cid:29)(cid:26)(cid:41)(cid:25)(cid:2)(cid:53)(cid:53)(cid:37)(cid:16)(cid:34)(cid:33,Unknown,3524.0
Unknown,Unknown,29,Unknown,Unknown,Unknown,Unknown,cid:12)(cid:29)(cid:26)(cid:41)(cid:25)(cid:2)(cid:53)(cid:53)(cid:37)(cid:16)(cid:34)(cid:33,Unknown,3553.0
Unknown,Unknown,69,Unknown,Unknown,Unknown,Unknown,cid:12)(cid:29)(cid:26)(cid:41)(cid:25)(cid:2)(cid:53)(cid:53)(cid:37)(cid:16)(cid:34)(cid:33,Unknown,3622.0
Unknown,Unknown,25,Unknown,Unknown,Unknown,Unknown,cid:12)(cid:29)(cid:26)(cid:41)(cid:25)(cid:2)(cid:53)(cid:53)(cid:37)(cid:16)(cid:34)(cid:33,Unknown,3647.0
Unknown,Unknown,1,Unknown,Unknown,Unknown,Unknown,cid:12)(cid:29)(cid:26)(cid:41)(cid:25)(cid:2)(cid:53)(cid:53)(cid:37)(cid:16)(cid:34)(cid:33,Unknown,3648.0
Unknown,Unknown,32,Unknown,Unknown,Unknown,Unknown,cid:12)(cid:29)(cid:26)(cid:41)(cid:25)(cid:2)(cid:53)(cid:53)(cid:37)(cid:16)(cid:34)(cid:33,Unknown,3680.0
Unknown,Unknown,45,Unknown,Unknown,Unknown,Unknown,cid:12)(cid:29)(cid:26)(cid:41)(cid:25)(cid:2)(cid:53)(cid:53)(cid:37)(cid:16)(cid:34)(cid:33,Unknown,3725.0
Unknown,Unknown,18,Unknown,Unknown,Unknown,Unknown,cid:12)(cid:29)(cid:26)(cid:41)(cid:25)(cid:2)(cid:53)(cid:53)(cid:37)(cid:16)(cid:34)(cid:33,Unknown,3743.0
Unknown,Unknown,34,Unknown,Unknown,Unknown,Unknown,cid:12)(cid:29)(cid:26)(cid:41)(cid:25)(cid:2)(cid:53)(cid:53)(cid:37)(cid:16)(cid:34)(cid:33,Unknown,3777.0
Unknown,Unknown,14,Unknown,Unknown,Unknown,Unknown,cid:12)(cid:29)(cid:26)(cid:41)(cid:25)(cid:2)(cid:53)(cid:53)(cid:37)(cid:16)(cid:34)(cid:33,Unknown,3791.0
Unknown,Unknown,5,Unknown,Unknown,Unknown,Unknown,cid:12)(cid:29)(cid:26)(cid:41)(cid:25)(cid:2)(cid:53)(cid:53)(cid:37)(cid:16)(cid:34)(cid:33,Unknown,3796.0
Unknown,Unknown,9,Unknown,Unknown,Unknown,Unknown,cid:12)(cid:29)(cid:26)(cid:41)(cid:25)(cid:2)(cid:53)(cid:53)(cid:37)(cid:16)(cid:34)(cid:33,Unknown,3805.0
Unknown,Unknown,2,Unknown,Unknown,Unknown,Unknown,cid:12)(cid:29)(cid:26)(cid:41)(cid:25)(cid:2)(cid:53)(cid:53)(cid:37)(cid:16)(cid:34)(cid:33,Unknown,3807.0
Unknown,Unknown,10,Unknown,Unknown,Unknown,Unknown,cid:12)(cid:29)(cid:26)(cid:41)(cid:25)(cid:2)(cid:53)(cid:53)(cid:37)(cid:16)(cid:34)(cid:33,Unknown,3817.0
Unknown,Unknown,5,Unknown,Unknown,Unknown,Unknown,cid:12)(cid:29)(cid:26)(cid:41)(cid:25)(cid:2)(cid:53)(cid:53)(cid:37)(cid:16)(cid:34)(cid:33,Unknown,3822.0
Unknown,Unknown,62,Unknown,Unknown,Unknown,Unknown,cid:12)(cid:29)(cid:26)(cid:41)(cid:25)(cid:2)(cid:53)(cid:53)(cid:37)(cid:16)(cid:34)(cid:33,Unknown,3884.0
Unknown,Unknown,39,Unknown,Unknown,Unknown,Unknown,cid:12)(cid:29)(cid:26)(cid:41)(cid:25)(cid:2)(cid:53)(cid:53)(cid:37)(cid:16)(cid:34)(cid:33,Unknown,3923.0
Unknown,Unknown,14,Unknown,Unknown,Unknown,Unknown,cid:12)(cid:29)(cid:26)(cid:41)(cid:25)(cid:2)(cid:53)(cid:53)(cid:37)(cid:16)(cid:34)(cid:33,Unknown,3937.0
Unknown,Unknown,7,Unknown,Unknown,Unknown,Unknown,cid:12)(cid:29)(cid:26)(cid:41)(cid:25)(cid:2)(cid:53)(cid:53)(cid:37)(cid:16)(cid:34)(cid:33,Unknown,3944.0
Unknown,Unknown,5,Unknown,Unknown,Unknown,Unknown,cid:12)(cid:29)(cid:26)(cid:41)(cid:25)(cid:2)(cid:53)(cid:53)(cid:37)(cid:16)(cid:34)(cid:33,Unknown,3949.0
Unknown,Unknown,3,Unknown,Unknown,Unknown,Unknown,cid:12)(cid:29)(cid:26)(cid:41)(cid:25)(cid:2)(cid:53)(cid:53)(cid:37)(cid:16)(cid:34)(cid:33,Unknown,3952.0
Unknown,Unknown,9,Unknown,Unknown,Unknown,Unknown,cid:12)(cid:29)(cid:26)(cid:41)(cid:25)(cid:2)(cid:53)(cid:53)(cid:37)(cid:16)(cid:34)(cid:33,Unknown,3961.0
Unknown,Unknown,2,Unknown,Unknown,Unknown,Unknown,cid:12)(cid:29)(cid:26)(cid:41)(cid:25)(cid:2)(cid:53)(cid:53)(cid:37)(cid:16)(cid:34)(cid:33,Unknown,3963.0
Unknown,Unknown,12,Unknown,Unknown,Unknown,Unknown,cid:12)(cid:29)(cid:26)(cid:41)(cid:25)(cid:2)(cid:53)(cid:53)(cid:37)(cid:16)(cid:34)(cid:33,Unknown,3975.0
Unknown,Unknown,11,Unknown,Unknown,Unknown,Unknown,cid:12)(cid:29)(cid:26)(cid:41)(cid:25)(cid:2)(cid:53)(cid:53)(cid:37)(cid:16)(cid:34)(cid:33,Unknown,3986.0
Unknown,Unknown,4,Unknown,Unknown,Unknown,Unknown,cid:12)(cid:29)(cid:26)(cid:41)(cid:25)(cid:2)(cid:53)(cid:53)(cid:37)(cid:16)(cid:34)(cid:33,Unknown,3990.0
Unknown,Unknown,14,Unknown,Unknown,Unknown,Unknown,cid:12)(cid:29)(cid:26)(cid:41)(cid:25)(cid:2)(cid:53)(cid:53)(cid:37)(cid:16)(cid:34)(cid:33,Unknown,4004.0
Unknown,Unknown,11,Unknown,Unknown,Unknown,Unknown,cid:12)(cid:29)(cid:26)(cid:41)(cid:25)(cid:2)(cid:53)(cid:53)(cid:37)(cid:16)(cid:34)(cid:33,Unknown,4015.0
Unknown,Unknown,62,Unknown,Unknown,Unknown,Unknown,cid:12)(cid:29)(cid:26)(cid:41)(cid:25)(cid:2)(cid:53)(cid:53)(cid:37)(cid:16)(cid:34)(cid:33,Unknown,4077.0
Unknown,Unknown,62,Unknown,Unknown,Unknown,Unknown,cid:12)(cid:29)(cid:26)(cid:41)(cid:25)(cid:2)(cid:53)(cid:53)(cid:37)(cid:16)(cid:34)(cid:33,Unknown,4139.0
Unknown,Unknown,7,Unknown,Unknown,Unknown,Unknown,cid:12)(cid:29)(cid:26)(cid:41)(cid:25)(cid:2)(cid:53)(cid:53)(cid:37)(cid:16)(cid:34)(cid:33,Unknown,4146.0
Unknown,Unknown,5,Unknown,Unknown,Unknown,Unknown,cid:12)(cid:29)(cid:26)(cid:41)(cid:25)(cid:2)(cid:53)(cid:53)(cid:37)(cid:16)(cid:34)(cid:33,Unknown,4151.0
Unknown,Unknown,3,Unknown,Unknown,Unknown,Unknown,cid:12)(cid:29)(cid:26)(cid:41)(cid:25)(cid:2)(cid:53)(cid:53)(cid:37)(cid:16)(cid:34)(cid:33,Unknown,4154.0
Unknown,Unknown,2,Unknown,Unknown,Unknown,Unknown,cid:12)(cid:29)(cid:26)(cid:41)(cid:25)(cid:2)(cid:53)(cid:53)(cid:37)(cid:16)(cid:34)(cid:33,Unknown,4156.0
Unknown,Unknown,28,Unknown,Unknown,Unknown,Unknown,cid:12)(cid:29)(cid:26)(cid:41)(cid:25)(cid:2)(cid:53)(cid:53)(cid:37)(cid:16)(cid:34)(cid:33,Unknown,4184.0
Unknown,Unknown,3,Unknown,Unknown,Unknown,Unknown,cid:12)(cid:29)(cid:26)(cid:41)(cid:25)(cid:2)(cid:53)(cid:53)(cid:37)(cid:16)(cid:34)(cid:33,Unknown,4187.0
Unknown,Unknown,15,Unknown,Unknown,Unknown,Unknown,cid:12)(cid:29)(cid:26)(cid:41)(cid:25)(cid:2)(cid:53)(cid:53)(cid:37)(cid:16)(cid:34)(cid:33,Unknown,4202.0
Unknown,Unknown,2,Unknown,Unknown,Unknown,Unknown,cid:12)(cid:29)(cid:26)(cid:41)(cid:25)(cid:2)(cid:53)(cid:53)(cid:37)(cid:16)(cid:34)(cid:33,Unknown,4204.0
Unknown,Unknown,37,Unknown,Unknown,Unknown,Unknown,cid:12)(cid:29)(cid:26)(cid:41)(cid:25)(cid:2)(cid:53)(cid:53)(cid:37)(cid:16)(cid:34)(cid:33,Unknown,4241.0
Unknown,Unknown,19,Unknown,Unknown,Unknown,Unknown,cid:12)(cid:29)(cid:26)(cid:41)(cid:25)(cid:2)(cid:53)(cid:53)(cid:37)(cid:16)(cid:34)(cid:33,Unknown,4260.0
Unknown,Unknown,35,Unknown,Unknown,Unknown,Unknown,cid:12)(cid:29)(cid:26)(cid:41)(cid:25)(cid:2)(cid:53)(cid:53)(cid:37)(cid:16)(cid:34)(cid:33,Unknown,4295.0
Unknown,Unknown,18,Unknown,Unknown,Unknown,Unknown,cid:12)(cid:29)(cid:26)(cid:41)(cid:25)(cid:2)(cid:53)(cid:53)(cid:37)(cid:16)(cid:34)(cid:33,Unknown,4313.0
Unknown,Unknown,2,Unknown,Unknown,Unknown,Unknown,cid:12)(cid:29)(cid:26)(cid:41)(cid:25)(cid:2)(cid:53)(cid:53)(cid:37)(cid:16)(cid:34)(cid:33,Unknown,4315.0
Unknown,Unknown,44,Unknown,Unknown,Unknown,Unknown,cid:12)(cid:29)(cid:26)(cid:41)(cid:25)(cid:2)(cid:53)(cid:53)(cid:37)(cid:16)(cid:34)(cid:33,Unknown,4359.0
Unknown,Unknown,12,Unknown,Unknown,Unknown,Unknown,cid:12)(cid:29)(cid:26)(cid:41)(cid:25)(cid:2)(cid:53)(cid:53)(cid:37)(cid:16)(cid:34)(cid:33,Unknown,4371.0
Unknown,Unknown,29,Unknown,Unknown,Unknown,Unknown,cid:12)(cid:29)(cid:26)(cid:41)(cid:25)(cid:2)(cid:53)(cid:53)(cid:37)(cid:16)(cid:34)(cid:33,Unknown,4400.0
Unknown,Unknown,26,Unknown,Unknown,Unknown,Unknown,cid:12)(cid:29)(cid:26)(cid:41)(cid:25)(cid:2)(cid:53)(cid:53)(cid:37)(cid:16)(cid:34)(cid:33,Unknown,4426.0
Unknown,Unknown,41,Unknown,Unknown,Unknown,Unknown,cid:12)(cid:29)(cid:26)(cid:41)(cid:25)(cid:2)(cid:53)(cid:53)(cid:37)(cid:16)(cid:34)(cid:33,Unknown,4467.0
Unknown,Unknown,25,Unknown,Unknown,Unknown,Unknown,cid:12)(cid:29)(cid:26)(cid:41)(cid:25)(cid:2)(cid:53)(cid:53)(cid:37)(cid:16)(cid:34)(cid:33,Unknown,4492.0
Unknown,Unknown,2,Unknown,Unknown,Unknown,Unknown,cid:12)(cid:29)(cid:26)(cid:41)(cid:25)(cid:2)(cid:53)(cid:53)(cid:37)(cid:16)(cid:34)(cid:33,Unknown,4494.0
Unknown,Unknown,53,Unknown,Unknown,Unknown,Unknown,cid:12)(cid:29)(cid:26)(cid:41)(cid:25)(cid:2)(cid:53)(cid:53)(cid:37)(cid:16)(cid:34)(cid:33,Unknown,4547.0
Unknown,Unknown,53,Unknown,Unknown,Unknown,Unknown,cid:12)(cid:29)(cid:26)(cid:41)(cid:25)(cid:2)(cid:53)(cid:53)(cid:37)(cid:16)(cid:34)(cid:33,Unknown,4600.0
Unknown,Unknown,37,Unknown,Unknown,Unknown,Unknown,cid:12)(cid:29)(cid:26)(cid:41)(cid:25)(cid:2)(cid:53)(cid:53)(cid:37)(cid:16)(cid:34)(cid:33,Unknown,4637.0
Unknown,Unknown,16,Unknown,Unknown,Unknown,Unknown,cid:12)(cid:29)(cid:26)(cid:41)(cid:25)(cid:2)(cid:53)(cid:53)(cid:37)(cid:16)(cid:34)(cid:33,Unknown,4653.0
Unknown,Unknown,34,Unknown,Unknown,Unknown,Unknown,cid:12)(cid:29)(cid:26)(cid:41)(cid:25)(cid:2)(cid:53)(cid:53)(cid:37)(cid:16)(cid:34)(cid:33,Unknown,4687.0
Unknown,Unknown,33,Unknown,Unknown,Unknown,Unknown,cid:12)(cid:29)(cid:26)(cid:41)(cid:25)(cid:2)(cid:53)(cid:53)(cid:37)(cid:16)(cid:34)(cid:33,Unknown,4720.0
Unknown,Unknown,1,Unknown,Unknown,Unknown,Unknown,cid:12)(cid:29)(cid:26)(cid:41)(cid:25)(cid:2)(cid:53)(cid:53)(cid:37)(cid:16)(cid:34)(cid:33,Unknown,4721.0
Unknown,Unknown,32,Unknown,Unknown,Unknown,Unknown,cid:12)(cid:29)(cid:26)(cid:41)(cid:25)(cid:2)(cid:53)(cid:53)(cid:37)(cid:16)(cid:34)(cid:33,Unknown,4753.0
Unknown,Unknown,45,Unknown,Unknown,Unknown,Unknown,cid:12)(cid:29)(cid:26)(cid:41)(cid:25)(cid:2)(cid:53)(cid:53)(cid:37)(cid:16)(cid:34)(cid:33,Unknown,4798.0
Unknown,Unknown,18,Unknown,Unknown,Unknown,Unknown,cid:12)(cid:29)(cid:26)(cid:41)(cid:25)(cid:2)(cid:53)(cid:53)(cid:37)(cid:16)(cid:34)(cid:33,Unknown,4816.0
Unknown,Unknown,34,Unknown,Unknown,Unknown,Unknown,cid:12)(cid:29)(cid:26)(cid:41)(cid:25)(cid:2)(cid:53)(cid:53)(cid:37)(cid:16)(cid:34)(cid:33,Unknown,4850.0
Unknown,Unknown,10,Unknown,Unknown,Unknown,Unknown,cid:12)(cid:29)(cid:26)(cid:41)(cid:25)(cid:2)(cid:53)(cid:53)(cid:37)(cid:16)(cid:34)(cid:33,Unknown,4860.0
Unknown,Unknown,11,Unknown,Unknown,Unknown,Unknown,cid:12)(cid:29)(cid:26)(cid:41)(cid:25)(cid:2)(cid:53)(cid:53)(cid:37)(cid:16)(cid:34)(cid:33,Unknown,4871.0
Unknown,Unknown,10,Unknown,Unknown,Unknown,Unknown,cid:12)(cid:29)(cid:26)(cid:41)(cid:25)(cid:2)(cid:53)(cid:53)(cid:37)(cid:16)(cid:34)(cid:33,Unknown,4881.0
Unknown,Unknown,49,Unknown,Unknown,Unknown,Unknown,cid:12)(cid:29)(cid:26)(cid:41)(cid:25)(cid:2)(cid:53)(cid:53)(cid:37)(cid:16)(cid:34)(cid:33,Unknown,4930.0
Unknown,Unknown,14,Unknown,Unknown,Unknown,Unknown,cid:12)(cid:29)(cid:26)(cid:41)(cid:25)(cid:2)(cid:53)(cid:53)(cid:37)(cid:16)(cid:34)(cid:33,Unknown,4944.0
Unknown,Unknown,2,Unknown,Unknown,Unknown,Unknown,cid:12)(cid:29)(cid:26)(cid:41)(cid:25)(cid:2)(cid:53)(cid:53)(cid:37)(cid:16)(cid:34)(cid:33,Unknown,4946.0
Unknown,Unknown,12,Unknown,Unknown,Unknown,Unknown,cid:12)(cid:29)(cid:26)(cid:41)(cid:25)(cid:2)(cid:53)(cid:53)(cid:37)(cid:16)(cid:34)(cid:33,Unknown,4958.0
Unknown,Unknown,11,Unknown,Unknown,Unknown,Unknown,cid:12)(cid:29)(cid:26)(cid:41)(cid:25)(cid:2)(cid:53)(cid:53)(cid:37)(cid:16)(cid:34)(cid:33,Unknown,4969.0
Unknown,Unknown,4,Unknown,Unknown,Unknown,Unknown,cid:12)(cid:29)(cid:26)(cid:41)(cid:25)(cid:2)(cid:53)(cid:53)(cid:37)(cid:16)(cid:34)(cid:33,Unknown,4973.0
Unknown,Unknown,14,Unknown,Unknown,Unknown,Unknown,cid:12)(cid:29)(cid:26)(cid:41)(cid:25)(cid:2)(cid:53)(cid:53)(cid:37)(cid:16)(cid:34)(cid:33,Unknown,4987.0
Unknown,Unknown,11,Unknown,Unknown,Unknown,Unknown,cid:12)(cid:29)(cid:26)(cid:41)(cid:25)(cid:2)(cid:53)(cid:53)(cid:37)(cid:16)(cid:34)(cid:33,Unknown,4998.0
Unknown,Unknown,62,Unknown,Unknown,Unknown,Unknown,cid:12)(cid:29)(cid:26)(cid:41)(cid:25)(cid:2)(cid:53)(cid:53)(cid:37)(cid:16)(cid:34)(cid:33,Unknown,5060.0
Unknown,Unknown,62,Unknown,Unknown,Unknown,Unknown,cid:12)(cid:29)(cid:26)(cid:41)(cid:25)(cid:2)(cid:53)(cid:53)(cid:37)(cid:16)(cid:34)(cid:33,Unknown,5122.0
Unknown,Unknown,7,Unknown,Unknown,Unknown,Unknown,cid:12)(cid:29)(cid:26)(cid:41)(cid:25)(cid:2)(cid:53)(cid:53)(cid:37)(cid:16)(cid:34)(cid:33,Unknown,5129.0
Unknown,Unknown,5,Unknown,Unknown,Unknown,Unknown,cid:12)(cid:29)(cid:26)(cid:41)(cid:25)(cid:2)(cid:53)(cid:53)(cid:37)(cid:16)(cid:34)(cid:33,Unknown,5134.0
Unknown,Unknown,3,Unknown,Unknown,Unknown,Unknown,cid:12)(cid:29)(cid:26)(cid:41)(cid:25)(cid:2)(cid:53)(cid:53)(cid:37)(cid:16)(cid:34)(cid:33,Unknown,5137.0
Unknown,Unknown,9,Unknown,Unknown,Unknown,Unknown,cid:12)(cid:29)(cid:26)(cid:41)(cid:25)(cid:2)(cid:53)(cid:53)(cid:37)(cid:16)(cid:34)(cid:33,Unknown,5146.0
Unknown,Unknown,2,Unknown,Unknown,Unknown,Unknown,cid:12)(cid:29)(cid:26)(cid:41)(cid:25)(cid:2)(cid:53)(cid:53)(cid:37)(cid:16)(cid:34)(cid:33,Unknown,5148.0
Unknown,Unknown,28,Unknown,Unknown,Unknown,Unknown,cid:12)(cid:29)(cid:26)(cid:41)(cid:25)(cid:2)(cid:53)(cid:53)(cid:37)(cid:16)(cid:34)(cid:33,Unknown,5176.0
Unknown,Unknown,3,Unknown,Unknown,Unknown,Unknown,cid:12)(cid:29)(cid:26)(cid:41)(cid:25)(cid:2)(cid:53)(cid:53)(cid:37)(cid:16)(cid:34)(cid:33,Unknown,5179.0
Unknown,Unknown,15,Unknown,Unknown,Unknown,Unknown,cid:12)(cid:29)(cid:26)(cid:41)(cid:25)(cid:2)(cid:53)(cid:53)(cid:37)(cid:16)(cid:34)(cid:33,Unknown,5194.0
Unknown,Unknown,2,Unknown,Unknown,Unknown,Unknown,cid:12)(cid:29)(cid:26)(cid:41)(cid:25)(cid:2)(cid:53)(cid:53)(cid:37)(cid:16)(cid:34)(cid:33,Unknown,5196.0
Unknown,Unknown,33,Unknown,Unknown,Unknown,Unknown,cid:12)(cid:29)(cid:26)(cid:41)(cid:25)(cid:2)(cid:53)(cid:53)(cid:37)(cid:16)(cid:34)(cid:33,Unknown,5229.0
Unknown,Unknown,36,Unknown,Unknown,Unknown,Unknown,cid:12)(cid:29)(cid:26)(cid:41)(cid:25)(cid:2)(cid:53)(cid:53)(cid:37)(cid:16)(cid:34)(cid:33,Unknown,5265.0
Unknown,Unknown,19,Unknown,Unknown,Unknown,Unknown,cid:12)(cid:29)(cid:26)(cid:41)(cid:25)(cid:2)(cid:53)(cid:53)(cid:37)(cid:16)(cid:34)(cid:33,Unknown,5284.0
Unknown,Unknown,18,Unknown,Unknown,Unknown,Unknown,cid:12)(cid:29)(cid:26)(cid:41)(cid:25)(cid:2)(cid:53)(cid:53)(cid:37)(cid:16)(cid:34)(cid:33,Unknown,5302.0
Unknown,Unknown,18,Unknown,Unknown,Unknown,Unknown,cid:12)(cid:29)(cid:26)(cid:41)(cid:25)(cid:2)(cid:53)(cid:53)(cid:37)(cid:16)(cid:34)(cid:33,Unknown,5320.0
Unknown,Unknown,2,Unknown,Unknown,Unknown,Unknown,cid:12)(cid:29)(cid:26)(cid:41)(cid:25)(cid:2)(cid:53)(cid:53)(cid:37)(cid:16)(cid:34)(cid:33,Unknown,5322.0
Unknown,Unknown,44,Unknown,Unknown,Unknown,Unknown,cid:12)(cid:29)(cid:26)(cid:41)(cid:25)(cid:2)(cid:53)(cid:53)(cid:37)(cid:16)(cid:34)(cid:33,Unknown,5366.0
Unknown,Unknown,12,Unknown,Unknown,Unknown,Unknown,cid:12)(cid:29)(cid:26)(cid:41)(cid:25)(cid:2)(cid:53)(cid:53)(cid:37)(cid:16)(cid:34)(cid:33,Unknown,5378.0
Unknown,Unknown,29,Unknown,Unknown,Unknown,Unknown,cid:12)(cid:29)(cid:26)(cid:41)(cid:25)(cid:2)(cid:53)(cid:53)(cid:37)(cid:16)(cid:34)(cid:33,Unknown,5407.0
Unknown,Unknown,26,Unknown,Unknown,Unknown,Unknown,cid:12)(cid:29)(cid:26)(cid:41)(cid:25)(cid:2)(cid:53)(cid:53)(cid:37)(cid:16)(cid:34)(cid:33,Unknown,5433.0
Unknown,Unknown,41,Unknown,Unknown,Unknown,Unknown,cid:12)(cid:29)(cid:26)(cid:41)(cid:25)(cid:2)(cid:53)(cid:53)(cid:37)(cid:16)(cid:34)(cid:33,Unknown,5474.0
Unknown,Unknown,25,Unknown,Unknown,Unknown,Unknown,cid:12)(cid:29)(cid:26)(cid:41)(cid:25)(cid:2)(cid:53)(cid:53)(cid:37)(cid:16)(cid:34)(cid:33,Unknown,5499.0
Unknown,Unknown,2,Unknown,Unknown,Unknown,Unknown,cid:12)(cid:29)(cid:26)(cid:41)(cid:25)(cid:2)(cid:53)(cid:53)(cid:37)(cid:16)(cid:34)(cid:33,Unknown,5501.0
Unknown,Unknown,53,Unknown,Unknown,Unknown,Unknown,cid:12)(cid:29)(cid:26)(cid:41)(cid:25)(cid:2)(cid:53)(cid:53)(cid:37)(cid:16)(cid:34)(cid:33,Unknown,5554.0
Unknown,Unknown,53,Unknown,Unknown,Unknown,Unknown,cid:12)(cid:29)(cid:26)(cid:41)(cid:25)(cid:2)(cid:53)(cid:53)(cid:37)(cid:16)(cid:34)(cid:33,Unknown,5607.0
Unknown,Unknown,18,Unknown,Unknown,Unknown,Unknown,cid:12)(cid:29)(cid:26)(cid:41)(cid:25)(cid:2)(cid:53)(cid:53)(cid:37)(cid:16)(cid:34)(cid:33,Unknown,5625.0
Unknown,Unknown,1,Unknown,Unknown,Unknown,Unknown,cid:12)(cid:29)(cid:26)(cid:41)(cid:25)(cid:2)(cid:53)(cid:53)(cid:37)(cid:16)(cid:34)(cid:33,Unknown,5626.0
Unknown,Unknown,1,Unknown,Unknown,Unknown,Unknown,cid:12)(cid:29)(cid:26)(cid:41)(cid:25)(cid:2)(cid:53)(cid:53)(cid:37)(cid:16)(cid:34)(cid:33,Unknown,5627.0
Unknown,Unknown,37,Unknown,Unknown,Unknown,Unknown,cid:12)(cid:29)(cid:26)(cid:41)(cid:25)(cid:2)(cid:53)(cid:53)(cid:37)(cid:16)(cid:34)(cid:33,Unknown,5664.0
Unknown,Unknown,1,Unknown,Unknown,Unknown,Unknown,cid:12)(cid:29)(cid:26)(cid:41)(cid:25)(cid:2)(cid:53)(cid:53)(cid:37)(cid:16)(cid:34)(cid:33,Unknown,5665.0
Unknown,Unknown,16,Unknown,Unknown,Unknown,Unknown,cid:12)(cid:29)(cid:26)(cid:41)(cid:25)(cid:2)(cid:53)(cid:53)(cid:37)(cid:16)(cid:34)(cid:33,Unknown,5681.0
Unknown,Unknown,45,Unknown,Unknown,Unknown,Unknown,cid:12)(cid:29)(cid:26)(cid:41)(cid:25)(cid:2)(cid:53)(cid:53)(cid:37)(cid:16)(cid:34)(cid:33,Unknown,5726.0
Unknown,Unknown,18,Unknown,Unknown,Unknown,Unknown,cid:12)(cid:29)(cid:26)(cid:41)(cid:25)(cid:2)(cid:53)(cid:53)(cid:37)(cid:16)(cid:34)(cid:33,Unknown,5744.0
Unknown,Unknown,34,Unknown,Unknown,Unknown,Unknown,cid:12)(cid:29)(cid:26)(cid:41)(cid:25)(cid:2)(cid:53)(cid:53)(cid:37)(cid:16)(cid:34)(cid:33,Unknown,5778.0
Unknown,Unknown,12,Unknown,Unknown,Unknown,Unknown,cid:12)(cid:29)(cid:26)(cid:41)(cid:25)(cid:2)(cid:53)(cid:53)(cid:37)(cid:16)(cid:34)(cid:33,Unknown,5790.0
Unknown,Unknown,11,Unknown,Unknown,Unknown,Unknown,cid:12)(cid:29)(cid:26)(cid:41)(cid:25)(cid:2)(cid:53)(cid:53)(cid:37)(cid:16)(cid:34)(cid:33,Unknown,5801.0
Unknown,Unknown,8,Unknown,Unknown,Unknown,Unknown,cid:12)(cid:29)(cid:26)(cid:41)(cid:25)(cid:2)(cid:53)(cid:53)(cid:37)(cid:16)(cid:34)(cid:33,Unknown,5809.0
Unknown,Unknown,28,Unknown,Unknown,Unknown,Unknown,cid:12)(cid:29)(cid:26)(cid:41)(cid:25)(cid:2)(cid:53)(cid:53)(cid:37)(cid:16)(cid:34)(cid:33,Unknown,5837.0
Unknown,Unknown,11,Unknown,Unknown,Unknown,Unknown,cid:12)(cid:29)(cid:26)(cid:41)(cid:25)(cid:2)(cid:53)(cid:53)(cid:37)(cid:16)(cid:34)(cid:33,Unknown,5848.0
Unknown,Unknown,3,Unknown,Unknown,Unknown,Unknown,cid:12)(cid:29)(cid:26)(cid:41)(cid:25)(cid:2)(cid:53)(cid:53)(cid:37)(cid:16)(cid:34)(cid:33,Unknown,5851.0
Unknown,Unknown,49,Unknown,Unknown,Unknown,Unknown,cid:12)(cid:29)(cid:26)(cid:41)(cid:25)(cid:2)(cid:53)(cid:53)(cid:37)(cid:16)(cid:34)(cid:33,Unknown,5900.0
Unknown,Unknown,62,Unknown,Unknown,Unknown,Unknown,cid:12)(cid:29)(cid:26)(cid:41)(cid:25)(cid:2)(cid:53)(cid:53)(cid:37)(cid:16)(cid:34)(cid:33,Unknown,5962.0
Unknown,Unknown,49,Unknown,Unknown,Unknown,Unknown,cid:12)(cid:29)(cid:26)(cid:41)(cid:25)(cid:2)(cid:53)(cid:53)(cid:37)(cid:16)(cid:34)(cid:33,Unknown,6011.0
Unknown,Unknown,2,Unknown,Unknown,Unknown,Unknown,cid:12)(cid:29)(cid:26)(cid:41)(cid:25)(cid:2)(cid:53)(cid:53)(cid:37)(cid:16)(cid:34)(cid:33,Unknown,6013.0
Unknown,Unknown,8,Unknown,Unknown,Unknown,Unknown,cid:12)(cid:29)(cid:26)(cid:41)(cid:25)(cid:2)(cid:53)(cid:53)(cid:37)(cid:16)(cid:34)(cid:33,Unknown,6021.0
Unknown,Unknown,49,Unknown,Unknown,Unknown,Unknown,cid:12)(cid:29)(cid:26)(cid:41)(cid:25)(cid:2)(cid:53)(cid:53)(cid:37)(cid:16)(cid:34)(cid:33,Unknown,6070.0
Unknown,Unknown,8,Unknown,Unknown,Unknown,Unknown,cid:12)(cid:29)(cid:26)(cid:41)(cid:25)(cid:2)(cid:53)(cid:53)(cid:37)(cid:16)(cid:34)(cid:33,Unknown,6078.0
Unknown,Unknown,10,Unknown,Unknown,Unknown,Unknown,cid:12)(cid:29)(cid:26)(cid:41)(cid:25)(cid:2)(cid:53)(cid:53)(cid:37)(cid:16)(cid:34)(cid:33,Unknown,6088.0
Unknown,Unknown,5,Unknown,Unknown,Unknown,Unknown,cid:12)(cid:29)(cid:26)(cid:41)(cid:25)(cid:2)(cid:53)(cid:53)(cid:37)(cid:16)(cid:34)(cid:33,Unknown,6093.0
Unknown,Unknown,4,Unknown,Unknown,Unknown,Unknown,cid:12)(cid:29)(cid:26)(cid:41)(cid:25)(cid:2)(cid:53)(cid:53)(cid:37)(cid:16)(cid:34)(cid:33,Unknown,6097.0
Unknown,Unknown,7,Unknown,Unknown,Unknown,Unknown,cid:12)(cid:29)(cid:26)(cid:41)(cid:25)(cid:2)(cid:53)(cid:53)(cid:37)(cid:16)(cid:34)(cid:33,Unknown,6104.0
Unknown,Unknown,14,Unknown,Unknown,Unknown,Unknown,cid:12)(cid:29)(cid:26)(cid:41)(cid:25)(cid:2)(cid:53)(cid:53)(cid:37)(cid:16)(cid:34)(cid:33,Unknown,6118.0
Unknown,Unknown,2,Unknown,Unknown,Unknown,Unknown,cid:12)(cid:29)(cid:26)(cid:41)(cid:25)(cid:2)(cid:53)(cid:53)(cid:37)(cid:16)(cid:34)(cid:33,Unknown,6120.0
Unknown,Unknown,14,Unknown,Unknown,Unknown,Unknown,cid:12)(cid:29)(cid:26)(cid:41)(cid:25)(cid:2)(cid:53)(cid:53)(cid:37)(cid:16)(cid:34)(cid:33,Unknown,6134.0
Unknown,Unknown,2,Unknown,Unknown,Unknown,Unknown,cid:12)(cid:29)(cid:26)(cid:41)(cid:25)(cid:2)(cid:53)(cid:53)(cid:37)(cid:16)(cid:34)(cid:33,Unknown,6136.0
Unknown,Unknown,28,Unknown,Unknown,Unknown,Unknown,cid:12)(cid:29)(cid:26)(cid:41)(cid:25)(cid:2)(cid:53)(cid:53)(cid:37)(cid:16)(cid:34)(cid:33,Unknown,6164.0
Unknown,Unknown,3,Unknown,Unknown,Unknown,Unknown,cid:12)(cid:29)(cid:26)(cid:41)(cid:25)(cid:2)(cid:53)(cid:53)(cid:37)(cid:16)(cid:34)(cid:33,Unknown,6167.0
Unknown,Unknown,15,Unknown,Unknown,Unknown,Unknown,cid:12)(cid:29)(cid:26)(cid:41)(cid:25)(cid:2)(cid:53)(cid:53)(cid:37)(cid:16)(cid:34)(cid:33,Unknown,6182.0
Unknown,Unknown,2,Unknown,Unknown,Unknown,Unknown,cid:12)(cid:29)(cid:26)(cid:41)(cid:25)(cid:2)(cid:53)(cid:53)(cid:37)(cid:16)(cid:34)(cid:33,Unknown,6184.0
Unknown,Unknown,34,Unknown,Unknown,Unknown,Unknown,cid:12)(cid:29)(cid:26)(cid:41)(cid:25)(cid:2)(cid:53)(cid:53)(cid:37)(cid:16)(cid:34)(cid:33,Unknown,6218.0
Unknown,Unknown,33,Unknown,Unknown,Unknown,Unknown,cid:12)(cid:29)(cid:26)(cid:41)(cid:25)(cid:2)(cid:53)(cid:53)(cid:37)(cid:16)(cid:34)(cid:33,Unknown,6251.0
Unknown,Unknown,33,Unknown,Unknown,Unknown,Unknown,cid:12)(cid:29)(cid:26)(cid:41)(cid:25)(cid:2)(cid:53)(cid:53)(cid:37)(cid:16)(cid:34)(cid:33,Unknown,6284.0
Unknown,Unknown,19,Unknown,Unknown,Unknown,Unknown,cid:12)(cid:29)(cid:26)(cid:41)(cid:25)(cid:2)(cid:53)(cid:53)(cid:37)(cid:16)(cid:34)(cid:33,Unknown,6303.0
Unknown,Unknown,34,Unknown,Unknown,Unknown,Unknown,cid:12)(cid:29)(cid:26)(cid:41)(cid:25)(cid:2)(cid:53)(cid:53)(cid:37)(cid:16)(cid:34)(cid:33,Unknown,6337.0
Unknown,Unknown,34,Unknown,Unknown,Unknown,Unknown,cid:12)(cid:29)(cid:26)(cid:41)(cid:25)(cid:2)(cid:53)(cid:53)(cid:37)(cid:16)(cid:34)(cid:33,Unknown,6371.0
Unknown,Unknown,2,Unknown,Unknown,Unknown,Unknown,cid:12)(cid:29)(cid:26)(cid:41)(cid:25)(cid:2)(cid:53)(cid:53)(cid:37)(cid:16)(cid:34)(cid:33,Unknown,6373.0
Unknown,Unknown,44,Unknown,Unknown,Unknown,Unknown,cid:12)(cid:29)(cid:26)(cid:41)(cid:25)(cid:2)(cid:53)(cid:53)(cid:37)(cid:16)(cid:34)(cid:33,Unknown,6417.0
Unknown,Unknown,12,Unknown,Unknown,Unknown,Unknown,cid:12)(cid:29)(cid:26)(cid:41)(cid:25)(cid:2)(cid:53)(cid:53)(cid:37)(cid:16)(cid:34)(cid:33,Unknown,6429.0
Unknown,Unknown,29,Unknown,Unknown,Unknown,Unknown,cid:12)(cid:29)(cid:26)(cid:41)(cid:25)(cid:2)(cid:53)(cid:53)(cid:37)(cid:16)(cid:34)(cid:33,Unknown,6458.0
Unknown,Unknown,26,Unknown,Unknown,Unknown,Unknown,cid:12)(cid:29)(cid:26)(cid:41)(cid:25)(cid:2)(cid:53)(cid:53)(cid:37)(cid:16)(cid:34)(cid:33,Unknown,6484.0
Unknown,Unknown,41,Unknown,Unknown,Unknown,Unknown,cid:12)(cid:29)(cid:26)(cid:41)(cid:25)(cid:2)(cid:53)(cid:53)(cid:37)(cid:16)(cid:34)(cid:33,Unknown,6525.0
Unknown,Unknown,25,Unknown,Unknown,Unknown,Unknown,cid:12)(cid:29)(cid:26)(cid:41)(cid:25)(cid:2)(cid:53)(cid:53)(cid:37)(cid:16)(cid:34)(cid:33,Unknown,6550.0
Unknown,Unknown,2,Unknown,Unknown,Unknown,Unknown,cid:12)(cid:29)(cid:26)(cid:41)(cid:25)(cid:2)(cid:53)(cid:53)(cid:37)(cid:16)(cid:34)(cid:33,Unknown,6552.0
Unknown,Unknown,53,Unknown,Unknown,Unknown,Unknown,cid:12)(cid:29)(cid:26)(cid:41)(cid:25)(cid:2)(cid:53)(cid:53)(cid:37)(cid:16)(cid:34)(cid:33,Unknown,6605.0
Unknown,Unknown,53,Unknown,Unknown,Unknown,Unknown,cid:12)(cid:29)(cid:26)(cid:41)(cid:25)(cid:2)(cid:53)(cid:53)(cid:37)(cid:16)(cid:34)(cid:33,Unknown,6658.0
Unknown,Unknown,18,Unknown,Unknown,Unknown,Unknown,cid:12)(cid:29)(cid:26)(cid:41)(cid:25)(cid:2)(cid:53)(cid:53)(cid:37)(cid:16)(cid:34)(cid:33,Unknown,6676.0
Unknown,Unknown,1,Unknown,Unknown,Unknown,Unknown,cid:12)(cid:29)(cid:26)(cid:41)(cid:25)(cid:2)(cid:53)(cid:53)(cid:37)(cid:16)(cid:34)(cid:33,Unknown,6677.0
Unknown,Unknown,1,Unknown,Unknown,Unknown,Unknown,cid:12)(cid:29)(cid:26)(cid:41)(cid:25)(cid:2)(cid:53)(cid:53)(cid:37)(cid:16)(cid:34)(cid:33,Unknown,6678.0
Unknown,Unknown,37,Unknown,Unknown,Unknown,Unknown,cid:12)(cid:29)(cid:26)(cid:41)(cid:25)(cid:2)(cid:53)(cid:53)(cid:37)(cid:16)(cid:34)(cid:33,Unknown,6715.0
Unknown,Unknown,1,Unknown,Unknown,Unknown,Unknown,cid:12)(cid:29)(cid:26)(cid:41)(cid:25)(cid:2)(cid:53)(cid:53)(cid:37)(cid:16)(cid:34)(cid:33,Unknown,6716.0
Unknown,Unknown,16,Unknown,Unknown,Unknown,Unknown,cid:12)(cid:29)(cid:26)(cid:41)(cid:25)(cid:2)(cid:53)(cid:53)(cid:37)(cid:16)(cid:34)(cid:33,Unknown,6732.0
Unknown,Unknown,45,Unknown,Unknown,Unknown,Unknown,cid:12)(cid:29)(cid:26)(cid:41)(cid:25)(cid:2)(cid:53)(cid:53)(cid:37)(cid:16)(cid:34)(cid:33,Unknown,6777.0
Unknown,Unknown,18,Unknown,Unknown,Unknown,Unknown,cid:12)(cid:29)(cid:26)(cid:41)(cid:25)(cid:2)(cid:53)(cid:53)(cid:37)(cid:16)(cid:34)(cid:33,Unknown,6795.0
Unknown,Unknown,34,Unknown,Unknown,Unknown,Unknown,cid:12)(cid:29)(cid:26)(cid:41)(cid:25)(cid:2)(cid:53)(cid:53)(cid:37)(cid:16)(cid:34)(cid:33,Unknown,6829.0
Unknown,Unknown,11,Unknown,Unknown,Unknown,Unknown,cid:12)(cid:29)(cid:26)(cid:41)(cid:25)(cid:2)(cid:53)(cid:53)(cid:37)(cid:16)(cid:34)(cid:33,Unknown,6840.0
Unknown,Unknown,3,Unknown,Unknown,Unknown,Unknown,cid:12)(cid:29)(cid:26)(cid:41)(cid:25)(cid:2)(cid:53)(cid:53)(cid:37)(cid:16)(cid:34)(cid:33,Unknown,6843.0
Unknown,Unknown,49,Unknown,Unknown,Unknown,Unknown,cid:12)(cid:29)(cid:26)(cid:41)(cid:25)(cid:2)(cid:53)(cid:53)(cid:37)(cid:16)(cid:34)(cid:33,Unknown,6892.0
Unknown,Unknown,8,Unknown,Unknown,Unknown,Unknown,cid:12)(cid:29)(cid:26)(cid:41)(cid:25)(cid:2)(cid:53)(cid:53)(cid:37)(cid:16)(cid:34)(cid:33,Unknown,6900.0
Unknown,Unknown,46,Unknown,Unknown,Unknown,Unknown,cid:12)(cid:29)(cid:26)(cid:41)(cid:25)(cid:2)(cid:53)(cid:53)(cid:37)(cid:16)(cid:34)(cid:33,Unknown,6946.0
Unknown,Unknown,5,Unknown,Unknown,Unknown,Unknown,cid:12)(cid:29)(cid:26)(cid:41)(cid:25)(cid:2)(cid:53)(cid:53)(cid:37)(cid:16)(cid:34)(cid:33,Unknown,6951.0
Unknown,Unknown,2,Unknown,Unknown,Unknown,Unknown,cid:12)(cid:29)(cid:26)(cid:41)(cid:25)(cid:2)(cid:53)(cid:53)(cid:37)(cid:16)(cid:34)(cid:33,Unknown,6953.0
Unknown,Unknown,28,Unknown,Unknown,Unknown,Unknown,cid:12)(cid:29)(cid:26)(cid:41)(cid:25)(cid:2)(cid:53)(cid:53)(cid:37)(cid:16)(cid:34)(cid:33,Unknown,6981.0
Unknown,Unknown,49,Unknown,Unknown,Unknown,Unknown,cid:12)(cid:29)(cid:26)(cid:41)(cid:25)(cid:2)(cid:53)(cid:53)(cid:37)(cid:16)(cid:34)(cid:33,Unknown,7030.0
Unknown,Unknown,12,Unknown,Unknown,Unknown,Unknown,cid:12)(cid:29)(cid:26)(cid:41)(cid:25)(cid:2)(cid:53)(cid:53)(cid:37)(cid:16)(cid:34)(cid:33,Unknown,7042.0
Unknown,Unknown,10,Unknown,Unknown,Unknown,Unknown,cid:12)(cid:29)(cid:26)(cid:41)(cid:25)(cid:2)(cid:53)(cid:53)(cid:37)(cid:16)(cid:34)(cid:33,Unknown,7052.0
Unknown,Unknown,2,Unknown,Unknown,Unknown,Unknown,cid:12)(cid:29)(cid:26)(cid:41)(cid:25)(cid:2)(cid:53)(cid:53)(cid:37)(cid:16)(cid:34)(cid:33,Unknown,7054.0
Unknown,Unknown,16,Unknown,Unknown,Unknown,Unknown,cid:12)(cid:29)(cid:26)(cid:41)(cid:25)(cid:2)(cid:53)(cid:53)(cid:37)(cid:16)(cid:34)(cid:33,Unknown,7070.0
Unknown,Unknown,36,Unknown,Unknown,Unknown,Unknown,cid:12)(cid:29)(cid:26)(cid:41)(cid:25)(cid:2)(cid:53)(cid:53)(cid:37)(cid:16)(cid:34)(cid:33,Unknown,7106.0
Unknown,Unknown,2,Unknown,Unknown,Unknown,Unknown,cid:12)(cid:29)(cid:26)(cid:41)(cid:25)(cid:2)(cid:53)(cid:53)(cid:37)(cid:16)(cid:34)(cid:33,Unknown,7108.0
Unknown,Unknown,39,Unknown,Unknown,Unknown,Unknown,cid:12)(cid:29)(cid:26)(cid:41)(cid:25)(cid:2)(cid:53)(cid:53)(cid:37)(cid:16)(cid:34)(cid:33,Unknown,7147.0
Unknown,Unknown,49,Unknown,Unknown,Unknown,Unknown,cid:12)(cid:29)(cid:26)(cid:41)(cid:25)(cid:2)(cid:53)(cid:53)(cid:37)(cid:16)(cid:34)(cid:33,Unknown,7196.0
Unknown,Unknown,3,Unknown,Unknown,Unknown,Unknown,cid:12)(cid:29)(cid:26)(cid:41)(cid:25)(cid:2)(cid:53)(cid:53)(cid:37)(cid:16)(cid:34)(cid:33,Unknown,7199.0
Unknown,Unknown,7,Unknown,Unknown,Unknown,Unknown,cid:12)(cid:29)(cid:26)(cid:41)(cid:25)(cid:2)(cid:53)(cid:53)(cid:37)(cid:16)(cid:34)(cid:33,Unknown,7206.0
Unknown,Unknown,9,Unknown,Unknown,Unknown,Unknown,cid:12)(cid:29)(cid:26)(cid:41)(cid:25)(cid:2)(cid:53)(cid:53)(cid:37)(cid:16)(cid:34)(cid:33,Unknown,7215.0
Unknown,Unknown,2,Unknown,Unknown,Unknown,Unknown,cid:12)(cid:29)(cid:26)(cid:41)(cid:25)(cid:2)(cid:53)(cid:53)(cid:37)(cid:16)(cid:34)(cid:33,Unknown,7217.0
Unknown,Unknown,28,Unknown,Unknown,Unknown,Unknown,cid:12)(cid:29)(cid:26)(cid:41)(cid:25)(cid:2)(cid:53)(cid:53)(cid:37)(cid:16)(cid:34)(cid:33,Unknown,7245.0
Unknown,Unknown,3,Unknown,Unknown,Unknown,Unknown,cid:12)(cid:29)(cid:26)(cid:41)(cid:25)(cid:2)(cid:53)(cid:53)(cid:37)(cid:16)(cid:34)(cid:33,Unknown,7248.0
Unknown,Unknown,15,Unknown,Unknown,Unknown,Unknown,cid:12)(cid:29)(cid:26)(cid:41)(cid:25)(cid:2)(cid:53)(cid:53)(cid:37)(cid:16)(cid:34)(cid:33,Unknown,7263.0
Unknown,Unknown,2,Unknown,Unknown,Unknown,Unknown,cid:12)(cid:29)(cid:26)(cid:41)(cid:25)(cid:2)(cid:53)(cid:53)(cid:37)(cid:16)(cid:34)(cid:33,Unknown,7265.0
Unknown,Unknown,32,Unknown,Unknown,Unknown,Unknown,cid:12)(cid:29)(cid:26)(cid:41)(cid:25)(cid:2)(cid:53)(cid:53)(cid:37)(cid:16)(cid:34)(cid:33,Unknown,7297.0
Unknown,Unknown,36,Unknown,Unknown,Unknown,Unknown,cid:12)(cid:29)(cid:26)(cid:41)(cid:25)(cid:2)(cid:53)(cid:53)(cid:37)(cid:16)(cid:34)(cid:33,Unknown,7333.0
Unknown,Unknown,19,Unknown,Unknown,Unknown,Unknown,cid:12)(cid:29)(cid:26)(cid:41)(cid:25)(cid:2)(cid:53)(cid:53)(cid:37)(cid:16)(cid:34)(cid:33,Unknown,7352.0
Unknown,Unknown,33,Unknown,Unknown,Unknown,Unknown,cid:12)(cid:29)(cid:26)(cid:41)(cid:25)(cid:2)(cid:53)(cid:53)(cid:37)(cid:16)(cid:34)(cid:33,Unknown,7385.0
Unknown,Unknown,33,Unknown,Unknown,Unknown,Unknown,cid:12)(cid:29)(cid:26)(cid:41)(cid:25)(cid:2)(cid:53)(cid:53)(cid:37)(cid:16)(cid:34)(cid:33,Unknown,7418.0
Unknown,Unknown,2,Unknown,Unknown,Unknown,Unknown,cid:12)(cid:29)(cid:26)(cid:41)(cid:25)(cid:2)(cid:53)(cid:53)(cid:37)(cid:16)(cid:34)(cid:33,Unknown,7420.0
Unknown,Unknown,44,Unknown,Unknown,Unknown,Unknown,cid:12)(cid:29)(cid:26)(cid:41)(cid:25)(cid:2)(cid:53)(cid:53)(cid:37)(cid:16)(cid:34)(cid:33,Unknown,7464.0
Unknown,Unknown,12,Unknown,Unknown,Unknown,Unknown,cid:12)(cid:29)(cid:26)(cid:41)(cid:25)(cid:2)(cid:53)(cid:53)(cid:37)(cid:16)(cid:34)(cid:33,Unknown,7476.0
Unknown,Unknown,29,Unknown,Unknown,Unknown,Unknown,cid:12)(cid:29)(cid:26)(cid:41)(cid:25)(cid:2)(cid:53)(cid:53)(cid:37)(cid:16)(cid:34)(cid:33,Unknown,7505.0
Unknown,Unknown,26,Unknown,Unknown,Unknown,Unknown,cid:12)(cid:29)(cid:26)(cid:41)(cid:25)(cid:2)(cid:53)(cid:53)(cid:37)(cid:16)(cid:34)(cid:33,Unknown,7531.0
Unknown,Unknown,41,Unknown,Unknown,Unknown,Unknown,cid:12)(cid:29)(cid:26)(cid:41)(cid:25)(cid:2)(cid:53)(cid:53)(cid:37)(cid:16)(cid:34)(cid:33,Unknown,7572.0
Unknown,Unknown,25,Unknown,Unknown,Unknown,Unknown,cid:12)(cid:29)(cid:26)(cid:41)(cid:25)(cid:2)(cid:53)(cid:53)(cid:37)(cid:16)(cid:34)(cid:33,Unknown,7597.0
Unknown,Unknown,2,Unknown,Unknown,Unknown,Unknown,cid:12)(cid:29)(cid:26)(cid:41)(cid:25)(cid:2)(cid:53)(cid:53)(cid:37)(cid:16)(cid:34)(cid:33,Unknown,7599.0
Unknown,Unknown,53,Unknown,Unknown,Unknown,Unknown,cid:12)(cid:29)(cid:26)(cid:41)(cid:25)(cid:2)(cid:53)(cid:53)(cid:37)(cid:16)(cid:34)(cid:33,Unknown,7652.0
Unknown,Unknown,53,Unknown,Unknown,Unknown,Unknown,cid:12)(cid:29)(cid:26)(cid:41)(cid:25)(cid:2)(cid:53)(cid:53)(cid:37)(cid:16)(cid:34)(cid:33,Unknown,7705.0
Unknown,Unknown,37,Unknown,Unknown,Unknown,Unknown,cid:12)(cid:29)(cid:26)(cid:41)(cid:25)(cid:2)(cid:53)(cid:53)(cid:37)(cid:16)(cid:34)(cid:33,Unknown,7742.0
Unknown,Unknown,16,Unknown,Unknown,Unknown,Unknown,cid:12)(cid:29)(cid:26)(cid:41)(cid:25)(cid:2)(cid:53)(cid:53)(cid:37)(cid:16)(cid:34)(cid:33,Unknown,7758.0
Unknown,Unknown,34,Unknown,Unknown,Unknown,Unknown,cid:12)(cid:29)(cid:26)(cid:41)(cid:25)(cid:2)(cid:53)(cid:53)(cid:37)(cid:16)(cid:34)(cid:33,Unknown,7792.0
Unknown,Unknown,33,Unknown,Unknown,Unknown,Unknown,cid:12)(cid:29)(cid:26)(cid:41)(cid:25)(cid:2)(cid:53)(cid:53)(cid:37)(cid:16)(cid:34)(cid:33,Unknown,7825.0
Unknown,Unknown,1,Unknown,Unknown,Unknown,Unknown,cid:12)(cid:29)(cid:26)(cid:41)(cid:25)(cid:2)(cid:53)(cid:53)(cid:37)(cid:16)(cid:34)(cid:33,Unknown,7826.0
Unknown,Unknown,16,Unknown,Unknown,Unknown,Unknown,cid:12)(cid:29)(cid:26)(cid:41)(cid:25)(cid:2)(cid:53)(cid:53)(cid:37)(cid:16)(cid:34)(cid:33,Unknown,7842.0
Unknown,Unknown,45,Unknown,Unknown,Unknown,Unknown,cid:12)(cid:29)(cid:26)(cid:41)(cid:25)(cid:2)(cid:53)(cid:53)(cid:37)(cid:16)(cid:34)(cid:33,Unknown,7887.0
Unknown,Unknown,18,Unknown,Unknown,Unknown,Unknown,cid:12)(cid:29)(cid:26)(cid:41)(cid:25)(cid:2)(cid:53)(cid:53)(cid:37)(cid:16)(cid:34)(cid:33,Unknown,7905.0
Unknown,Unknown,34,Unknown,Unknown,Unknown,Unknown,cid:12)(cid:29)(cid:26)(cid:41)(cid:25)(cid:2)(cid:53)(cid:53)(cid:37)(cid:16)(cid:34)(cid:33,Unknown,7939.0
Unknown,Unknown,49,Unknown,Unknown,Unknown,Unknown,cid:12)(cid:29)(cid:26)(cid:41)(cid:25)(cid:2)(cid:53)(cid:53)(cid:37)(cid:16)(cid:34)(cid:33,Unknown,7988.0
Unknown,Unknown,52,Unknown,Unknown,Unknown,Unknown,cid:12)(cid:29)(cid:26)(cid:41)(cid:25)(cid:2)(cid:53)(cid:53)(cid:37)(cid:16)(cid:34)(cid:33,Unknown,8040.0
Unknown,Unknown,2,Unknown,Unknown,Unknown,Unknown,cid:12)(cid:29)(cid:26)(cid:41)(cid:25)(cid:2)(cid:53)(cid:53)(cid:37)(cid:16)(cid:34)(cid:33,Unknown,8042.0
Unknown,Unknown,47,Unknown,Unknown,Unknown,Unknown,cid:12)(cid:29)(cid:26)(cid:41)(cid:25)(cid:2)(cid:53)(cid:53)(cid:37)(cid:16)(cid:34)(cid:33,Unknown,8089.0
Unknown,Unknown,39,Unknown,Unknown,Unknown,Unknown,cid:12)(cid:29)(cid:26)(cid:41)(cid:25)(cid:2)(cid:53)(cid:53)(cid:37)(cid:16)(cid:34)(cid:33,Unknown,8128.0
Unknown,Unknown,8,Unknown,Unknown,Unknown,Unknown,cid:12)(cid:29)(cid:26)(cid:41)(cid:25)(cid:2)(cid:53)(cid:53)(cid:37)(cid:16)(cid:34)(cid:33,Unknown,8136.0
Unknown,Unknown,2,Unknown,Unknown,Unknown,Unknown,cid:12)(cid:29)(cid:26)(cid:41)(cid:25)(cid:2)(cid:53)(cid:53)(cid:37)(cid:16)(cid:34)(cid:33,Unknown,8138.0
Unknown,Unknown,12,Unknown,Unknown,Unknown,Unknown,cid:12)(cid:29)(cid:26)(cid:41)(cid:25)(cid:2)(cid:53)(cid:53)(cid:37)(cid:16)(cid:34)(cid:33,Unknown,8150.0
Unknown,Unknown,11,Unknown,Unknown,Unknown,Unknown,cid:12)(cid:29)(cid:26)(cid:41)(cid:25)(cid:2)(cid:53)(cid:53)(cid:37)(cid:16)(cid:34)(cid:33,Unknown,8161.0
Unknown,Unknown,4,Unknown,Unknown,Unknown,Unknown,cid:12)(cid:29)(cid:26)(cid:41)(cid:25)(cid:2)(cid:53)(cid:53)(cid:37)(cid:16)(cid:34)(cid:33,Unknown,8165.0
Unknown,Unknown,14,Unknown,Unknown,Unknown,Unknown,cid:12)(cid:29)(cid:26)(cid:41)(cid:25)(cid:2)(cid:53)(cid:53)(cid:37)(cid:16)(cid:34)(cid:33,Unknown,8179.0
Unknown,Unknown,11,Unknown,Unknown,Unknown,Unknown,cid:12)(cid:29)(cid:26)(cid:41)(cid:25)(cid:2)(cid:53)(cid:53)(cid:37)(cid:16)(cid:34)(cid:33,Unknown,8190.0
Unknown,Unknown,62,Unknown,Unknown,Unknown,Unknown,cid:12)(cid:29)(cid:26)(cid:41)(cid:25)(cid:2)(cid:53)(cid:53)(cid:37)(cid:16)(cid:34)(cid:33,Unknown,8252.0
Unknown,Unknown,62,Unknown,Unknown,Unknown,Unknown,cid:12)(cid:29)(cid:26)(cid:41)(cid:25)(cid:2)(cid:53)(cid:53)(cid:37)(cid:16)(cid:34)(cid:33,Unknown,8314.0
Unknown,Unknown,7,Unknown,Unknown,Unknown,Unknown,cid:12)(cid:29)(cid:26)(cid:41)(cid:25)(cid:2)(cid:53)(cid:53)(cid:37)(cid:16)(cid:34)(cid:33,Unknown,8321.0
Unknown,Unknown,5,Unknown,Unknown,Unknown,Unknown,cid:12)(cid:29)(cid:26)(cid:41)(cid:25)(cid:2)(cid:53)(cid:53)(cid:37)(cid:16)(cid:34)(cid:33,Unknown,8326.0
Unknown,Unknown,3,Unknown,Unknown,Unknown,Unknown,cid:12)(cid:29)(cid:26)(cid:41)(cid:25)(cid:2)(cid:53)(cid:53)(cid:37)(cid:16)(cid:34)(cid:33,Unknown,8329.0
Unknown,Unknown,9,Unknown,Unknown,Unknown,Unknown,cid:12)(cid:29)(cid:26)(cid:41)(cid:25)(cid:2)(cid:53)(cid:53)(cid:37)(cid:16)(cid:34)(cid:33,Unknown,8338.0
Unknown,Unknown,2,Unknown,Unknown,Unknown,Unknown,cid:12)(cid:29)(cid:26)(cid:41)(cid:25)(cid:2)(cid:53)(cid:53)(cid:37)(cid:16)(cid:34)(cid:33,Unknown,8340.0
Unknown,Unknown,28,Unknown,Unknown,Unknown,Unknown,cid:12)(cid:29)(cid:26)(cid:41)(cid:25)(cid:2)(cid:53)(cid:53)(cid:37)(cid:16)(cid:34)(cid:33,Unknown,8368.0
Unknown,Unknown,3,Unknown,Unknown,Unknown,Unknown,cid:12)(cid:29)(cid:26)(cid:41)(cid:25)(cid:2)(cid:53)(cid:53)(cid:37)(cid:16)(cid:34)(cid:33,Unknown,8371.0
Unknown,Unknown,15,Unknown,Unknown,Unknown,Unknown,cid:12)(cid:29)(cid:26)(cid:41)(cid:25)(cid:2)(cid:53)(cid:53)(cid:37)(cid:16)(cid:34)(cid:33,Unknown,8386.0
Unknown,Unknown,2,Unknown,Unknown,Unknown,Unknown,cid:12)(cid:29)(cid:26)(cid:41)(cid:25)(cid:2)(cid:53)(cid:53)(cid:37)(cid:16)(cid:34)(cid:33,Unknown,8388.0
Unknown,Unknown,35,Unknown,Unknown,Unknown,Unknown,cid:12)(cid:29)(cid:26)(cid:41)(cid:25)(cid:2)(cid:53)(cid:53)(cid:37)(cid:16)(cid:34)(cid:33,Unknown,8423.0
Unknown,Unknown,18,Unknown,Unknown,Unknown,Unknown,cid:12)(cid:29)(cid:26)(cid:41)(cid:25)(cid:2)(cid:53)(cid:53)(cid:37)(cid:16)(cid:34)(cid:33,Unknown,8441.0
Unknown,Unknown,19,Unknown,Unknown,Unknown,Unknown,cid:12)(cid:29)(cid:26)(cid:41)(cid:25)(cid:2)(cid:53)(cid:53)(cid:37)(cid:16)(cid:34)(cid:33,Unknown,8460.0
Unknown,Unknown,33,Unknown,Unknown,Unknown,Unknown,cid:12)(cid:29)(cid:26)(cid:41)(cid:25)(cid:2)(cid:53)(cid:53)(cid:37)(cid:16)(cid:34)(cid:33,Unknown,8493.0
Unknown,Unknown,35,Unknown,Unknown,Unknown,Unknown,cid:12)(cid:29)(cid:26)(cid:41)(cid:25)(cid:2)(cid:53)(cid:53)(cid:37)(cid:16)(cid:34)(cid:33,Unknown,8528.0
Unknown,Unknown,2,Unknown,Unknown,Unknown,Unknown,cid:12)(cid:29)(cid:26)(cid:41)(cid:25)(cid:2)(cid:53)(cid:53)(cid:37)(cid:16)(cid:34)(cid:33,Unknown,8530.0
Unknown,Unknown,44,Unknown,Unknown,Unknown,Unknown,cid:12)(cid:29)(cid:26)(cid:41)(cid:25)(cid:2)(cid:53)(cid:53)(cid:37)(cid:16)(cid:34)(cid:33,Unknown,8574.0
Unknown,Unknown,12,Unknown,Unknown,Unknown,Unknown,cid:12)(cid:29)(cid:26)(cid:41)(cid:25)(cid:2)(cid:53)(cid:53)(cid:37)(cid:16)(cid:34)(cid:33,Unknown,8586.0
Unknown,Unknown,29,Unknown,Unknown,Unknown,Unknown,cid:12)(cid:29)(cid:26)(cid:41)(cid:25)(cid:2)(cid:53)(cid:53)(cid:37)(cid:16)(cid:34)(cid:33,Unknown,8615.0
Unknown,Unknown,26,Unknown,Unknown,Unknown,Unknown,cid:12)(cid:29)(cid:26)(cid:41)(cid:25)(cid:2)(cid:53)(cid:53)(cid:37)(cid:16)(cid:34)(cid:33,Unknown,8641.0
Unknown,Unknown,41,Unknown,Unknown,Unknown,Unknown,cid:12)(cid:29)(cid:26)(cid:41)(cid:25)(cid:2)(cid:53)(cid:53)(cid:37)(cid:16)(cid:34)(cid:33,Unknown,8682.0
Unknown,Unknown,25,Unknown,Unknown,Unknown,Unknown,cid:12)(cid:29)(cid:26)(cid:41)(cid:25)(cid:2)(cid:53)(cid:53)(cid:37)(cid:16)(cid:34)(cid:33,Unknown,8707.0
Unknown,Unknown,2,Unknown,Unknown,Unknown,Unknown,cid:12)(cid:29)(cid:26)(cid:41)(cid:25)(cid:2)(cid:53)(cid:53)(cid:37)(cid:16)(cid:34)(cid:33,Unknown,8709.0
Unknown,Unknown,53,Unknown,Unknown,Unknown,Unknown,cid:12)(cid:29)(cid:26)(cid:41)(cid:25)(cid:2)(cid:53)(cid:53)(cid:37)(cid:16)(cid:34)(cid:33,Unknown,8762.0
Unknown,Unknown,53,Unknown,Unknown,Unknown,Unknown,cid:12)(cid:29)(cid:26)(cid:41)(cid:25)(cid:2)(cid:53)(cid:53)(cid:37)(cid:16)(cid:34)(cid:33,Unknown,8815.0
Unknown,Unknown,18,Unknown,Unknown,Unknown,Unknown,cid:12)(cid:29)(cid:26)(cid:41)(cid:25)(cid:2)(cid:53)(cid:53)(cid:37)(cid:16)(cid:34)(cid:33,Unknown,8833.0
Unknown,Unknown,1,Unknown,Unknown,Unknown,Unknown,cid:12)(cid:29)(cid:26)(cid:41)(cid:25)(cid:2)(cid:53)(cid:53)(cid:37)(cid:16)(cid:34)(cid:33,Unknown,8834.0
Unknown,Unknown,1,Unknown,Unknown,Unknown,Unknown,cid:12)(cid:29)(cid:26)(cid:41)(cid:25)(cid:2)(cid:53)(cid:53)(cid:37)(cid:16)(cid:34)(cid:33,Unknown,8835.0
Unknown,Unknown,37,Unknown,Unknown,Unknown,Unknown,cid:12)(cid:29)(cid:26)(cid:41)(cid:25)(cid:2)(cid:53)(cid:53)(cid:37)(cid:16)(cid:34)(cid:33,Unknown,8872.0
Unknown,Unknown,1,Unknown,Unknown,Unknown,Unknown,cid:12)(cid:29)(cid:26)(cid:41)(cid:25)(cid:2)(cid:53)(cid:53)(cid:37)(cid:16)(cid:34)(cid:33,Unknown,8873.0
Unknown,Unknown,16,Unknown,Unknown,Unknown,Unknown,cid:12)(cid:29)(cid:26)(cid:41)(cid:25)(cid:2)(cid:53)(cid:53)(cid:37)(cid:16)(cid:34)(cid:33,Unknown,8889.0
Unknown,Unknown,45,Unknown,Unknown,Unknown,Unknown,cid:12)(cid:29)(cid:26)(cid:41)(cid:25)(cid:2)(cid:53)(cid:53)(cid:37)(cid:16)(cid:34)(cid:33,Unknown,8934.0
Unknown,Unknown,18,Unknown,Unknown,Unknown,Unknown,cid:12)(cid:29)(cid:26)(cid:41)(cid:25)(cid:2)(cid:53)(cid:53)(cid:37)(cid:16)(cid:34)(cid:33,Unknown,8952.0
Unknown,Unknown,34,Unknown,Unknown,Unknown,Unknown,cid:12)(cid:29)(cid:26)(cid:41)(cid:25)(cid:2)(cid:53)(cid:53)(cid:37)(cid:16)(cid:34)(cid:33,Unknown,8986.0
Unknown,Unknown,10,Unknown,Unknown,Unknown,Unknown,cid:12)(cid:29)(cid:26)(cid:41)(cid:25)(cid:2)(cid:53)(cid:53)(cid:37)(cid:16)(cid:34)(cid:33,Unknown,8996.0
Unknown,Unknown,7,Unknown,Unknown,Unknown,Unknown,cid:12)(cid:29)(cid:26)(cid:41)(cid:25)(cid:2)(cid:53)(cid:53)(cid:37)(cid:16)(cid:34)(cid:33,Unknown,9003.0
Unknown,Unknown,14,Unknown,Unknown,Unknown,Unknown,cid:12)(cid:29)(cid:26)(cid:41)(cid:25)(cid:2)(cid:53)(cid:53)(cid:37)(cid:16)(cid:34)(cid:33,Unknown,9017.0
Unknown,Unknown,7,Unknown,Unknown,Unknown,Unknown,cid:12)(cid:29)(cid:26)(cid:41)(cid:25)(cid:2)(cid:53)(cid:53)(cid:37)(cid:16)(cid:34)(cid:33,Unknown,9024.0
Unknown,Unknown,14,Unknown,Unknown,Unknown,Unknown,cid:12)(cid:29)(cid:26)(cid:41)(cid:25)(cid:2)(cid:53)(cid:53)(cid:37)(cid:16)(cid:34)(cid:33,Unknown,9038.0
Unknown,Unknown,49,Unknown,Unknown,Unknown,Unknown,cid:12)(cid:29)(cid:26)(cid:41)(cid:25)(cid:2)(cid:53)(cid:53)(cid:37)(cid:16)(cid:34)(cid:33,Unknown,9087.0
Unknown,Unknown,2,Unknown,Unknown,Unknown,Unknown,cid:12)(cid:29)(cid:26)(cid:41)(cid:25)(cid:2)(cid:53)(cid:53)(cid:37)(cid:16)(cid:34)(cid:33,Unknown,9089.0
Unknown,Unknown,9,Unknown,Unknown,Unknown,Unknown,cid:12)(cid:29)(cid:26)(cid:41)(cid:25)(cid:2)(cid:53)(cid:53)(cid:37)(cid:16)(cid:34)(cid:33,Unknown,9098.0
Unknown,Unknown,49,Unknown,Unknown,Unknown,Unknown,cid:12)(cid:29)(cid:26)(cid:41)(cid:25)(cid:2)(cid:53)(cid:53)(cid:37)(cid:16)(cid:34)(cid:33,Unknown,9147.0
Unknown,Unknown,3,Unknown,Unknown,Unknown,Unknown,cid:12)(cid:29)(cid:26)(cid:41)(cid:25)(cid:2)(cid:53)(cid:53)(cid:37)(cid:16)(cid:34)(cid:33,Unknown,9150.0
Unknown,Unknown,14,Unknown,Unknown,Unknown,Unknown,cid:12)(cid:29)(cid:26)(cid:41)(cid:25)(cid:2)(cid:53)(cid:53)(cid:37)(cid:16)(cid:34)(cid:33,Unknown,9164.0
Unknown,Unknown,2,Unknown,Unknown,Unknown,Unknown,cid:12)(cid:29)(cid:26)(cid:41)(cid:25)(cid:2)(cid:53)(cid:53)(cid:37)(cid:16)(cid:34)(cid:33,Unknown,9166.0
Unknown,Unknown,9,Unknown,Unknown,Unknown,Unknown,cid:12)(cid:29)(cid:26)(cid:41)(cid:25)(cid:2)(cid:53)(cid:53)(cid:37)(cid:16)(cid:34)(cid:33,Unknown,9175.0
Unknown,Unknown,10,Unknown,Unknown,Unknown,Unknown,cid:12)(cid:29)(cid:26)(cid:41)(cid:25)(cid:2)(cid:53)(cid:53)(cid:37)(cid:16)(cid:34)(cid:33,Unknown,9185.0
Unknown,Unknown,2,Unknown,Unknown,Unknown,Unknown,cid:12)(cid:29)(cid:26)(cid:41)(cid:25)(cid:2)(cid:53)(cid:53)(cid:37)(cid:16)(cid:34)(cid:33,Unknown,9187.0
Unknown,Unknown,46,Unknown,Unknown,Unknown,Unknown,cid:12)(cid:29)(cid:26)(cid:41)(cid:25)(cid:2)(cid:53)(cid:53)(cid:37)(cid:16)(cid:34)(cid:33,Unknown,9233.0
Unknown,Unknown,5,Unknown,Unknown,Unknown,Unknown,cid:12)(cid:29)(cid:26)(cid:41)(cid:25)(cid:2)(cid:53)(cid:53)(cid:37)(cid:16)(cid:34)(cid:33,Unknown,9238.0
Unknown,Unknown,3,Unknown,Unknown,Unknown,Unknown,cid:12)(cid:29)(cid:26)(cid:41)(cid:25)(cid:2)(cid:53)(cid:53)(cid:37)(cid:16)(cid:34)(cid:33,Unknown,9241.0
Unknown,Unknown,62,Unknown,Unknown,Unknown,Unknown,cid:12)(cid:29)(cid:26)(cid:41)(cid:25)(cid:2)(cid:53)(cid:53)(cid:37)(cid:16)(cid:34)(cid:33,Unknown,9303.0
Unknown,Unknown,49,Unknown,Unknown,Unknown,Unknown,cid:12)(cid:29)(cid:26)(cid:41)(cid:25)(cid:2)(cid:53)(cid:53)(cid:37)(cid:16)(cid:34)(cid:33,Unknown,9352.0
Unknown,Unknown,7,Unknown,Unknown,Unknown,Unknown,cid:12)(cid:29)(cid:26)(cid:41)(cid:25)(cid:2)(cid:53)(cid:53)(cid:37)(cid:16)(cid:34)(cid:33,Unknown,9359.0
Unknown,Unknown,8,Unknown,Unknown,Unknown,Unknown,cid:12)(cid:29)(cid:26)(cid:41)(cid:25)(cid:2)(cid:53)(cid:53)(cid:37)(cid:16)(cid:34)(cid:33,Unknown,9367.0
Unknown,Unknown,2,Unknown,Unknown,Unknown,Unknown,cid:12)(cid:29)(cid:26)(cid:41)(cid:25)(cid:2)(cid:53)(cid:53)(cid:37)(cid:16)(cid:34)(cid:33,Unknown,9369.0
Unknown,Unknown,9,Unknown,Unknown,Unknown,Unknown,cid:12)(cid:29)(cid:26)(cid:41)(cid:25)(cid:2)(cid:53)(cid:53)(cid:37)(cid:16)(cid:34)(cid:33,Unknown,9378.0
Unknown,Unknown,4,Unknown,Unknown,Unknown,Unknown,cid:12)(cid:29)(cid:26)(cid:41)(cid:25)(cid:2)(cid:53)(cid:53)(cid:37)(cid:16)(cid:34)(cid:33,Unknown,9382.0
Unknown,Unknown,2,Unknown,Unknown,Unknown,Unknown,cid:12)(cid:29)(cid:26)(cid:41)(cid:25)(cid:2)(cid:53)(cid:53)(cid:37)(cid:16)(cid:34)(cid:33,Unknown,9384.0
Unknown,Unknown,28,Unknown,Unknown,Unknown,Unknown,cid:12)(cid:29)(cid:26)(cid:41)(cid:25)(cid:2)(cid:53)(cid:53)(cid:37)(cid:16)(cid:34)(cid:33,Unknown,9412.0
Unknown,Unknown,3,Unknown,Unknown,Unknown,Unknown,cid:12)(cid:29)(cid:26)(cid:41)(cid:25)(cid:2)(cid:53)(cid:53)(cid:37)(cid:16)(cid:34)(cid:33,Unknown,9415.0
Unknown,Unknown,15,Unknown,Unknown,Unknown,Unknown,cid:12)(cid:29)(cid:26)(cid:41)(cid:25)(cid:2)(cid:53)(cid:53)(cid:37)(cid:16)(cid:34)(cid:33,Unknown,9430.0
Unknown,Unknown,2,Unknown,Unknown,Unknown,Unknown,cid:12)(cid:29)(cid:26)(cid:41)(cid:25)(cid:2)(cid:53)(cid:53)(cid:37)(cid:16)(cid:34)(cid:33,Unknown,9432.0
Unknown,Unknown,16,Unknown,Unknown,Unknown,Unknown,cid:12)(cid:29)(cid:26)(cid:41)(cid:25)(cid:2)(cid:53)(cid:53)(cid:37)(cid:16)(cid:34)(cid:33,Unknown,9448.0
Unknown,Unknown,19,Unknown,Unknown,Unknown,Unknown,cid:12)(cid:29)(cid:26)(cid:41)(cid:25)(cid:2)(cid:53)(cid:53)(cid:37)(cid:16)(cid:34)(cid:33,Unknown,9467.0
Unknown,Unknown,18,Unknown,Unknown,Unknown,Unknown,cid:12)(cid:29)(cid:26)(cid:41)(cid:25)(cid:2)(cid:53)(cid:53)(cid:37)(cid:16)(cid:34)(cid:33,Unknown,9485.0
Unknown,Unknown,18,Unknown,Unknown,Unknown,Unknown,cid:12)(cid:29)(cid:26)(cid:41)(cid:25)(cid:2)(cid:53)(cid:53)(cid:37)(cid:16)(cid:34)(cid:33,Unknown,9503.0
Unknown,Unknown,2,Unknown,Unknown,Unknown,Unknown,cid:12)(cid:29)(cid:26)(cid:41)(cid:25)(cid:2)(cid:53)(cid:53)(cid:37)(cid:16)(cid:34)(cid:33,Unknown,9505.0
Unknown,Unknown,44,Unknown,Unknown,Unknown,Unknown,cid:12)(cid:29)(cid:26)(cid:41)(cid:25)(cid:2)(cid:53)(cid:53)(cid:37)(cid:16)(cid:34)(cid:33,Unknown,9549.0
Unknown,Unknown,12,Unknown,Unknown,Unknown,Unknown,cid:12)(cid:29)(cid:26)(cid:41)(cid:25)(cid:2)(cid:53)(cid:53)(cid:37)(cid:16)(cid:34)(cid:33,Unknown,9561.0
Unknown,Unknown,29,Unknown,Unknown,Unknown,Unknown,cid:12)(cid:29)(cid:26)(cid:41)(cid:25)(cid:2)(cid:53)(cid:53)(cid:37)(cid:16)(cid:34)(cid:33,Unknown,9590.0
Unknown,Unknown,26,Unknown,Unknown,Unknown,Unknown,cid:12)(cid:29)(cid:26)(cid:41)(cid:25)(cid:2)(cid:53)(cid:53)(cid:37)(cid:16)(cid:34)(cid:33,Unknown,9616.0
Unknown,Unknown,41,Unknown,Unknown,Unknown,Unknown,cid:12)(cid:29)(cid:26)(cid:41)(cid:25)(cid:2)(cid:53)(cid:53)(cid:37)(cid:16)(cid:34)(cid:33,Unknown,9657.0
Unknown,Unknown,25,Unknown,Unknown,Unknown,Unknown,cid:12)(cid:29)(cid:26)(cid:41)(cid:25)(cid:2)(cid:53)(cid:53)(cid:37)(cid:16)(cid:34)(cid:33,Unknown,9682.0
Unknown,Unknown,2,Unknown,Unknown,Unknown,Unknown,cid:12)(cid:29)(cid:26)(cid:41)(cid:25)(cid:2)(cid:53)(cid:53)(cid:37)(cid:16)(cid:34)(cid:33,Unknown,9684.0
Unknown,Unknown,53,Unknown,Unknown,Unknown,Unknown,cid:12)(cid:29)(cid:26)(cid:41)(cid:25)(cid:2)(cid:53)(cid:53)(cid:37)(cid:16)(cid:34)(cid:33,Unknown,9737.0
Unknown,Unknown,53,Unknown,Unknown,Unknown,Unknown,cid:12)(cid:29)(cid:26)(cid:41)(cid:25)(cid:2)(cid:53)(cid:53)(cid:37)(cid:16)(cid:34)(cid:33,Unknown,9790.0
Unknown,Unknown,18,Unknown,Unknown,Unknown,Unknown,cid:12)(cid:29)(cid:26)(cid:41)(cid:25)(cid:2)(cid:53)(cid:53)(cid:37)(cid:16)(cid:34)(cid:33,Unknown,9808.0
Unknown,Unknown,1,Unknown,Unknown,Unknown,Unknown,cid:12)(cid:29)(cid:26)(cid:41)(cid:25)(cid:2)(cid:53)(cid:53)(cid:37)(cid:16)(cid:34)(cid:33,Unknown,9809.0
Unknown,Unknown,1,Unknown,Unknown,Unknown,Unknown,cid:12)(cid:29)(cid:26)(cid:41)(cid:25)(cid:2)(cid:53)(cid:53)(cid:37)(cid:16)(cid:34)(cid:33,Unknown,9810.0
Unknown,Unknown,37,Unknown,Unknown,Unknown,Unknown,cid:12)(cid:29)(cid:26)(cid:41)(cid:25)(cid:2)(cid:53)(cid:53)(cid:37)(cid:16)(cid:34)(cid:33,Unknown,9847.0
Unknown,Unknown,1,Unknown,Unknown,Unknown,Unknown,cid:12)(cid:29)(cid:26)(cid:41)(cid:25)(cid:2)(cid:53)(cid:53)(cid:37)(cid:16)(cid:34)(cid:33,Unknown,9848.0
Unknown,Unknown,35,Unknown,Unknown,Unknown,Unknown,cid:12)(cid:29)(cid:26)(cid:41)(cid:25)(cid:2)(cid:53)(cid:53)(cid:37)(cid:16)(cid:34)(cid:33,Unknown,9883.0
Unknown,Unknown,45,Unknown,Unknown,Unknown,Unknown,cid:12)(cid:29)(cid:26)(cid:41)(cid:25)(cid:2)(cid:53)(cid:53)(cid:37)(cid:16)(cid:34)(cid:33,Unknown,9928.0
Unknown,Unknown,18,Unknown,Unknown,Unknown,Unknown,cid:12)(cid:29)(cid:26)(cid:41)(cid:25)(cid:2)(cid:53)(cid:53)(cid:37)(cid:16)(cid:34)(cid:33,Unknown,9946.0
Unknown,Unknown,34,Unknown,Unknown,Unknown,Unknown,cid:12)(cid:29)(cid:26)(cid:41)(cid:25)(cid:2)(cid:53)(cid:53)(cid:37)(cid:16)(cid:34)(cid:33,Unknown,9980.0
Unknown,Unknown,14,Unknown,Unknown,Unknown,Unknown,cid:12)(cid:29)(cid:26)(cid:41)(cid:25)(cid:2)(cid:53)(cid:53)(cid:37)(cid:16)(cid:34)(cid:33,Unknown,9994.0
Unknown,Unknown,5,Unknown,Unknown,Unknown,Unknown,cid:12)(cid:29)(cid:26)(cid:41)(cid:25)(cid:2)(cid:53)(cid:53)(cid:37)(cid:16)(cid:34)(cid:33,Unknown,9999.0
Unknown,Unknown,12,Unknown,Unknown,Unknown,Unknown,cid:12)(cid:29)(cid:26)(cid:41)(cid:25)(cid:2)(cid:53)(cid:53)(cid:37)(cid:16)(cid:34)(cid:33,Unknown,10011.0
Unknown,Unknown,14,Unknown,Unknown,Unknown,Unknown,cid:12)(cid:29)(cid:26)(cid:41)(cid:25)(cid:2)(cid:53)(cid:53)(cid:37)(cid:16)(cid:34)(cid:33,Unknown,10025.0
Unknown,Unknown,5,Unknown,Unknown,Unknown,Unknown,cid:12)(cid:29)(cid:26)(cid:41)(cid:25)(cid:2)(cid:53)(cid:53)(cid:37)(cid:16)(cid:34)(cid:33,Unknown,10030.0
Unknown,Unknown,3,Unknown,Unknown,Unknown,Unknown,cid:12)(cid:29)(cid:26)(cid:41)(cid:25)(cid:2)(cid:53)(cid:53)(cid:37)(cid:16)(cid:34)(cid:33,Unknown,10033.0
Unknown,Unknown,12,Unknown,Unknown,Unknown,Unknown,cid:12)(cid:29)(cid:26)(cid:41)(cid:25)(cid:2)(cid:53)(cid:53)(cid:37)(cid:16)(cid:34)(cid:33,Unknown,10045.0
Unknown,Unknown,2,Unknown,Unknown,Unknown,Unknown,cid:12)(cid:29)(cid:26)(cid:41)(cid:25)(cid:2)(cid:53)(cid:53)(cid:37)(cid:16)(cid:34)(cid:33,Unknown,10047.0
Unknown,Unknown,52,Unknown,Unknown,Unknown,Unknown,cid:12)(cid:29)(cid:26)(cid:41)(cid:25)(cid:2)(cid:53)(cid:53)(cid:37)(cid:16)(cid:34)(cid:33,Unknown,10099.0
Unknown,Unknown,7,Unknown,Unknown,Unknown,Unknown,cid:12)(cid:29)(cid:26)(cid:41)(cid:25)(cid:2)(cid:53)(cid:53)(cid:37)(cid:16)(cid:34)(cid:33,Unknown,10106.0
Unknown,Unknown,9,Unknown,Unknown,Unknown,Unknown,cid:12)(cid:29)(cid:26)(cid:41)(cid:25)(cid:2)(cid:53)(cid:53)(cid:37)(cid:16)(cid:34)(cid:33,Unknown,10115.0
Unknown,Unknown,10,Unknown,Unknown,Unknown,Unknown,cid:12)(cid:29)(cid:26)(cid:41)(cid:25)(cid:2)(cid:53)(cid:53)(cid:37)(cid:16)(cid:34)(cid:33,Unknown,10125.0
Unknown,Unknown,3,Unknown,Unknown,Unknown,Unknown,cid:12)(cid:29)(cid:26)(cid:41)(cid:25)(cid:2)(cid:53)(cid:53)(cid:37)(cid:16)(cid:34)(cid:33,Unknown,10128.0
Unknown,Unknown,2,Unknown,Unknown,Unknown,Unknown,cid:12)(cid:29)(cid:26)(cid:41)(cid:25)(cid:2)(cid:53)(cid:53)(cid:37)(cid:16)(cid:34)(cid:33,Unknown,10130.0
Unknown,Unknown,12,Unknown,Unknown,Unknown,Unknown,cid:12)(cid:29)(cid:26)(cid:41)(cid:25)(cid:2)(cid:53)(cid:53)(cid:37)(cid:16)(cid:34)(cid:33,Unknown,10142.0
Unknown,Unknown,11,Unknown,Unknown,Unknown,Unknown,cid:12)(cid:29)(cid:26)(cid:41)(cid:25)(cid:2)(cid:53)(cid:53)(cid:37)(cid:16)(cid:34)(cid:33,Unknown,10153.0
Unknown,Unknown,4,Unknown,Unknown,Unknown,Unknown,cid:12)(cid:29)(cid:26)(cid:41)(cid:25)(cid:2)(cid:53)(cid:53)(cid:37)(cid:16)(cid:34)(cid:33,Unknown,10157.0
Unknown,Unknown,14,Unknown,Unknown,Unknown,Unknown,cid:12)(cid:29)(cid:26)(cid:41)(cid:25)(cid:2)(cid:53)(cid:53)(cid:37)(cid:16)(cid:34)(cid:33,Unknown,10171.0
Unknown,Unknown,11,Unknown,Unknown,Unknown,Unknown,cid:12)(cid:29)(cid:26)(cid:41)(cid:25)(cid:2)(cid:53)(cid:53)(cid:37)(cid:16)(cid:34)(cid:33,Unknown,10182.0
Unknown,Unknown,62,Unknown,Unknown,Unknown,Unknown,cid:12)(cid:29)(cid:26)(cid:41)(cid:25)(cid:2)(cid:53)(cid:53)(cid:37)(cid:16)(cid:34)(cid:33,Unknown,10244.0
Unknown,Unknown,62,Unknown,Unknown,Unknown,Unknown,cid:12)(cid:29)(cid:26)(cid:41)(cid:25)(cid:2)(cid:53)(cid:53)(cid:37)(cid:16)(cid:34)(cid:33,Unknown,10306.0
Unknown,Unknown,7,Unknown,Unknown,Unknown,Unknown,cid:12)(cid:29)(cid:26)(cid:41)(cid:25)(cid:2)(cid:53)(cid:53)(cid:37)(cid:16)(cid:34)(cid:33,Unknown,10313.0
Unknown,Unknown,5,Unknown,Unknown,Unknown,Unknown,cid:12)(cid:29)(cid:26)(cid:41)(cid:25)(cid:2)(cid:53)(cid:53)(cid:37)(cid:16)(cid:34)(cid:33,Unknown,10318.0
Unknown,Unknown,3,Unknown,Unknown,Unknown,Unknown,cid:12)(cid:29)(cid:26)(cid:41)(cid:25)(cid:2)(cid:53)(cid:53)(cid:37)(cid:16)(cid:34)(cid:33,Unknown,10321.0
Unknown,Unknown,2,Unknown,Unknown,Unknown,Unknown,cid:12)(cid:29)(cid:26)(cid:41)(cid:25)(cid:2)(cid:53)(cid:53)(cid:37)(cid:16)(cid:34)(cid:33,Unknown,10323.0
Unknown,Unknown,28,Unknown,Unknown,Unknown,Unknown,cid:12)(cid:29)(cid:26)(cid:41)(cid:25)(cid:2)(cid:53)(cid:53)(cid:37)(cid:16)(cid:34)(cid:33,Unknown,10351.0
Unknown,Unknown,3,Unknown,Unknown,Unknown,Unknown,cid:12)(cid:29)(cid:26)(cid:41)(cid:25)(cid:2)(cid:53)(cid:53)(cid:37)(cid:16)(cid:34)(cid:33,Unknown,10354.0
Unknown,Unknown,15,Unknown,Unknown,Unknown,Unknown,cid:12)(cid:29)(cid:26)(cid:41)(cid:25)(cid:2)(cid:53)(cid:53)(cid:37)(cid:16)(cid:34)(cid:33,Unknown,10369.0
Unknown,Unknown,2,Unknown,Unknown,Unknown,Unknown,cid:12)(cid:29)(cid:26)(cid:41)(cid:25)(cid:2)(cid:53)(cid:53)(cid:37)(cid:16)(cid:34)(cid:33,Unknown,10371.0
Unknown,Unknown,17,Unknown,Unknown,Unknown,Unknown,cid:12)(cid:29)(cid:26)(cid:41)(cid:25)(cid:2)(cid:53)(cid:53)(cid:37)(cid:16)(cid:34)(cid:33,Unknown,10388.0
Unknown,Unknown,35,Unknown,Unknown,Unknown,Unknown,cid:12)(cid:29)(cid:26)(cid:41)(cid:25)(cid:2)(cid:53)(cid:53)(cid:37)(cid:16)(cid:34)(cid:33,Unknown,10423.0
Unknown,Unknown,17,Unknown,Unknown,Unknown,Unknown,cid:12)(cid:29)(cid:26)(cid:41)(cid:25)(cid:2)(cid:53)(cid:53)(cid:37)(cid:16)(cid:34)(cid:33,Unknown,10440.0
Unknown,Unknown,19,Unknown,Unknown,Unknown,Unknown,cid:12)(cid:29)(cid:26)(cid:41)(cid:25)(cid:2)(cid:53)(cid:53)(cid:37)(cid:16)(cid:34)(cid:33,Unknown,10459.0
Unknown,Unknown,36,Unknown,Unknown,Unknown,Unknown,cid:12)(cid:29)(cid:26)(cid:41)(cid:25)(cid:2)(cid:53)(cid:53)(cid:37)(cid:16)(cid:34)(cid:33,Unknown,10495.0
Unknown,Unknown,34,Unknown,Unknown,Unknown,Unknown,cid:12)(cid:29)(cid:26)(cid:41)(cid:25)(cid:2)(cid:53)(cid:53)(cid:37)(cid:16)(cid:34)(cid:33,Unknown,10529.0
Unknown,Unknown,2,Unknown,Unknown,Unknown,Unknown,cid:12)(cid:29)(cid:26)(cid:41)(cid:25)(cid:2)(cid:53)(cid:53)(cid:37)(cid:16)(cid:34)(cid:33,Unknown,10531.0
Unknown,Unknown,44,Unknown,Unknown,Unknown,Unknown,cid:12)(cid:29)(cid:26)(cid:41)(cid:25)(cid:2)(cid:53)(cid:53)(cid:37)(cid:16)(cid:34)(cid:33,Unknown,10575.0
Unknown,Unknown,12,Unknown,Unknown,Unknown,Unknown,cid:12)(cid:29)(cid:26)(cid:41)(cid:25)(cid:2)(cid:53)(cid:53)(cid:37)(cid:16)(cid:34)(cid:33,Unknown,10587.0
Unknown,Unknown,29,Unknown,Unknown,Unknown,Unknown,cid:12)(cid:29)(cid:26)(cid:41)(cid:25)(cid:2)(cid:53)(cid:53)(cid:37)(cid:16)(cid:34)(cid:33,Unknown,10616.0
Unknown,Unknown,26,Unknown,Unknown,Unknown,Unknown,cid:12)(cid:29)(cid:26)(cid:41)(cid:25)(cid:2)(cid:53)(cid:53)(cid:37)(cid:16)(cid:34)(cid:33,Unknown,10642.0
Unknown,Unknown,41,Unknown,Unknown,Unknown,Unknown,cid:12)(cid:29)(cid:26)(cid:41)(cid:25)(cid:2)(cid:53)(cid:53)(cid:37)(cid:16)(cid:34)(cid:33,Unknown,10683.0
Unknown,Unknown,25,Unknown,Unknown,Unknown,Unknown,cid:12)(cid:29)(cid:26)(cid:41)(cid:25)(cid:2)(cid:53)(cid:53)(cid:37)(cid:16)(cid:34)(cid:33,Unknown,10708.0
Unknown,Unknown,2,Unknown,Unknown,Unknown,Unknown,cid:12)(cid:29)(cid:26)(cid:41)(cid:25)(cid:2)(cid:53)(cid:53)(cid:37)(cid:16)(cid:34)(cid:33,Unknown,10710.0
Unknown,Unknown,53,Unknown,Unknown,Unknown,Unknown,cid:12)(cid:29)(cid:26)(cid:41)(cid:25)(cid:2)(cid:53)(cid:53)(cid:37)(cid:16)(cid:34)(cid:33,Unknown,10763.0
Unknown,Unknown,53,Unknown,Unknown,Unknown,Unknown,cid:12)(cid:29)(cid:26)(cid:41)(cid:25)(cid:2)(cid:53)(cid:53)(cid:37)(cid:16)(cid:34)(cid:33,Unknown,10816.0
Unknown,Unknown,37,Unknown,Unknown,Unknown,Unknown,cid:12)(cid:29)(cid:26)(cid:41)(cid:25)(cid:2)(cid:53)(cid:53)(cid:37)(cid:16)(cid:34)(cid:33,Unknown,10853.0
Unknown,Unknown,16,Unknown,Unknown,Unknown,Unknown,cid:12)(cid:29)(cid:26)(cid:41)(cid:25)(cid:2)(cid:53)(cid:53)(cid:37)(cid:16)(cid:34)(cid:33,Unknown,10869.0
Unknown,Unknown,34,Unknown,Unknown,Unknown,Unknown,cid:12)(cid:29)(cid:26)(cid:41)(cid:25)(cid:2)(cid:53)(cid:53)(cid:37)(cid:16)(cid:34)(cid:33,Unknown,10903.0
Unknown,Unknown,33,Unknown,Unknown,Unknown,Unknown,cid:12)(cid:29)(cid:26)(cid:41)(cid:25)(cid:2)(cid:53)(cid:53)(cid:37)(cid:16)(cid:34)(cid:33,Unknown,10936.0
Unknown,Unknown,1,Unknown,Unknown,Unknown,Unknown,cid:12)(cid:29)(cid:26)(cid:41)(cid:25)(cid:2)(cid:53)(cid:53)(cid:37)(cid:16)(cid:34)(cid:33,Unknown,10937.0
Unknown,Unknown,35,Unknown,Unknown,Unknown,Unknown,cid:12)(cid:29)(cid:26)(cid:41)(cid:25)(cid:2)(cid:53)(cid:53)(cid:37)(cid:16)(cid:34)(cid:33,Unknown,10972.0
Unknown,Unknown,45,Unknown,Unknown,Unknown,Unknown,cid:12)(cid:29)(cid:26)(cid:41)(cid:25)(cid:2)(cid:53)(cid:53)(cid:37)(cid:16)(cid:34)(cid:33,Unknown,11017.0
Unknown,Unknown,18,Unknown,Unknown,Unknown,Unknown,cid:12)(cid:29)(cid:26)(cid:41)(cid:25)(cid:2)(cid:53)(cid:53)(cid:37)(cid:16)(cid:34)(cid:33,Unknown,11035.0
Unknown,Unknown,34,Unknown,Unknown,Unknown,Unknown,cid:12)(cid:29)(cid:26)(cid:41)(cid:25)(cid:2)(cid:53)(cid:53)(cid:37)(cid:16)(cid:34)(cid:33,Unknown,11069.0
Unknown,Unknown,10,Unknown,Unknown,Unknown,Unknown,cid:12)(cid:29)(cid:26)(cid:41)(cid:25)(cid:2)(cid:53)(cid:53)(cid:37)(cid:16)(cid:34)(cid:33,Unknown,11079.0
Unknown,Unknown,5,Unknown,Unknown,Unknown,Unknown,cid:12)(cid:29)(cid:26)(cid:41)(cid:25)(cid:2)(cid:53)(cid:53)(cid:37)(cid:16)(cid:34)(cid:33,Unknown,11084.0
Unknown,Unknown,14,Unknown,Unknown,Unknown,Unknown,cid:12)(cid:29)(cid:26)(cid:41)(cid:25)(cid:2)(cid:53)(cid:53)(cid:37)(cid:16)(cid:34)(cid:33,Unknown,11098.0
Unknown,Unknown,2,Unknown,Unknown,Unknown,Unknown,cid:12)(cid:29)(cid:26)(cid:41)(cid:25)(cid:2)(cid:53)(cid:53)(cid:37)(cid:16)(cid:34)(cid:33,Unknown,11100.0
Unknown,Unknown,62,Unknown,Unknown,Unknown,Unknown,cid:12)(cid:29)(cid:26)(cid:41)(cid:25)(cid:2)(cid:53)(cid:53)(cid:37)(cid:16)(cid:34)(cid:33,Unknown,11162.0
Unknown,Unknown,2,Unknown,Unknown,Unknown,Unknown,cid:12)(cid:29)(cid:26)(cid:41)(cid:25)(cid:2)(cid:53)(cid:53)(cid:37)(cid:16)(cid:34)(cid:33,Unknown,11164.0
Unknown,Unknown,62,Unknown,Unknown,Unknown,Unknown,cid:12)(cid:29)(cid:26)(cid:41)(cid:25)(cid:2)(cid:53)(cid:53)(cid:37)(cid:16)(cid:34)(cid:33,Unknown,11226.0
Unknown,Unknown,5,Unknown,Unknown,Unknown,Unknown,cid:12)(cid:29)(cid:26)(cid:41)(cid:25)(cid:2)(cid:53)(cid:53)(cid:37)(cid:16)(cid:34)(cid:33,Unknown,11231.0
Unknown,Unknown,4,Unknown,Unknown,Unknown,Unknown,cid:12)(cid:29)(cid:26)(cid:41)(cid:25)(cid:2)(cid:53)(cid:53)(cid:37)(cid:16)(cid:34)(cid:33,Unknown,11235.0
Unknown,Unknown,52,Unknown,Unknown,Unknown,Unknown,cid:12)(cid:29)(cid:26)(cid:41)(cid:25)(cid:2)(cid:53)(cid:53)(cid:37)(cid:16)(cid:34)(cid:33,Unknown,11287.0
Unknown,Unknown,11,Unknown,Unknown,Unknown,Unknown,cid:12)(cid:29)(cid:26)(cid:41)(cid:25)(cid:2)(cid:53)(cid:53)(cid:37)(cid:16)(cid:34)(cid:33,Unknown,11298.0
Unknown,Unknown,8,Unknown,Unknown,Unknown,Unknown,cid:12)(cid:29)(cid:26)(cid:41)(cid:25)(cid:2)(cid:53)(cid:53)(cid:37)(cid:16)(cid:34)(cid:33,Unknown,11306.0
Unknown,Unknown,2,Unknown,Unknown,Unknown,Unknown,cid:12)(cid:29)(cid:26)(cid:41)(cid:25)(cid:2)(cid:53)(cid:53)(cid:37)(cid:16)(cid:34)(cid:33,Unknown,11308.0
Unknown,Unknown,14,Unknown,Unknown,Unknown,Unknown,cid:12)(cid:29)(cid:26)(cid:41)(cid:25)(cid:2)(cid:53)(cid:53)(cid:37)(cid:16)(cid:34)(cid:33,Unknown,11322.0
Unknown,Unknown,49,Unknown,Unknown,Unknown,Unknown,cid:12)(cid:29)(cid:26)(cid:41)(cid:25)(cid:2)(cid:53)(cid:53)(cid:37)(cid:16)(cid:34)(cid:33,Unknown,11371.0
Unknown,Unknown,2,Unknown,Unknown,Unknown,Unknown,cid:12)(cid:29)(cid:26)(cid:41)(cid:25)(cid:2)(cid:53)(cid:53)(cid:37)(cid:16)(cid:34)(cid:33,Unknown,11373.0
Unknown,Unknown,28,Unknown,Unknown,Unknown,Unknown,cid:12)(cid:29)(cid:26)(cid:41)(cid:25)(cid:2)(cid:53)(cid:53)(cid:37)(cid:16)(cid:34)(cid:33,Unknown,11401.0
Unknown,Unknown,11,Unknown,Unknown,Unknown,Unknown,cid:12)(cid:29)(cid:26)(cid:41)(cid:25)(cid:2)(cid:53)(cid:53)(cid:37)(cid:16)(cid:34)(cid:33,Unknown,11412.0
Unknown,Unknown,3,Unknown,Unknown,Unknown,Unknown,cid:12)(cid:29)(cid:26)(cid:41)(cid:25)(cid:2)(cid:53)(cid:53)(cid:37)(cid:16)(cid:34)(cid:33,Unknown,11415.0
Unknown,Unknown,2,Unknown,Unknown,Unknown,Unknown,cid:12)(cid:29)(cid:26)(cid:41)(cid:25)(cid:2)(cid:53)(cid:53)(cid:37)(cid:16)(cid:34)(cid:33,Unknown,11417.0
Unknown,Unknown,28,Unknown,Unknown,Unknown,Unknown,cid:12)(cid:29)(cid:26)(cid:41)(cid:25)(cid:2)(cid:53)(cid:53)(cid:37)(cid:16)(cid:34)(cid:33,Unknown,11445.0
Unknown,Unknown,3,Unknown,Unknown,Unknown,Unknown,cid:12)(cid:29)(cid:26)(cid:41)(cid:25)(cid:2)(cid:53)(cid:53)(cid:37)(cid:16)(cid:34)(cid:33,Unknown,11448.0
Unknown,Unknown,15,Unknown,Unknown,Unknown,Unknown,cid:12)(cid:29)(cid:26)(cid:41)(cid:25)(cid:2)(cid:53)(cid:53)(cid:37)(cid:16)(cid:34)(cid:33,Unknown,11463.0
Unknown,Unknown,2,Unknown,Unknown,Unknown,Unknown,cid:12)(cid:29)(cid:26)(cid:41)(cid:25)(cid:2)(cid:53)(cid:53)(cid:37)(cid:16)(cid:34)(cid:33,Unknown,11465.0
Unknown,Unknown,16,Unknown,Unknown,Unknown,Unknown,cid:12)(cid:29)(cid:26)(cid:41)(cid:25)(cid:2)(cid:53)(cid:53)(cid:37)(cid:16)(cid:34)(cid:33,Unknown,11481.0
Unknown,Unknown,18,Unknown,Unknown,Unknown,Unknown,cid:12)(cid:29)(cid:26)(cid:41)(cid:25)(cid:2)(cid:53)(cid:53)(cid:37)(cid:16)(cid:34)(cid:33,Unknown,11499.0
Unknown,Unknown,19,Unknown,Unknown,Unknown,Unknown,cid:12)(cid:29)(cid:26)(cid:41)(cid:25)(cid:2)(cid:53)(cid:53)(cid:37)(cid:16)(cid:34)(cid:33,Unknown,11518.0
Unknown,Unknown,33,Unknown,Unknown,Unknown,Unknown,cid:12)(cid:29)(cid:26)(cid:41)(cid:25)(cid:2)(cid:53)(cid:53)(cid:37)(cid:16)(cid:34)(cid:33,Unknown,11551.0
Unknown,Unknown,33,Unknown,Unknown,Unknown,Unknown,cid:12)(cid:29)(cid:26)(cid:41)(cid:25)(cid:2)(cid:53)(cid:53)(cid:37)(cid:16)(cid:34)(cid:33,Unknown,11584.0
Unknown,Unknown,2,Unknown,Unknown,Unknown,Unknown,cid:12)(cid:29)(cid:26)(cid:41)(cid:25)(cid:2)(cid:53)(cid:53)(cid:37)(cid:16)(cid:34)(cid:33,Unknown,11586.0
Unknown,Unknown,44,Unknown,Unknown,Unknown,Unknown,cid:12)(cid:29)(cid:26)(cid:41)(cid:25)(cid:2)(cid:53)(cid:53)(cid:37)(cid:16)(cid:34)(cid:33,Unknown,11630.0
Unknown,Unknown,12,Unknown,Unknown,Unknown,Unknown,cid:12)(cid:29)(cid:26)(cid:41)(cid:25)(cid:2)(cid:53)(cid:53)(cid:37)(cid:16)(cid:34)(cid:33,Unknown,11642.0
Unknown,Unknown,29,Unknown,Unknown,Unknown,Unknown,cid:12)(cid:29)(cid:26)(cid:41)(cid:25)(cid:2)(cid:53)(cid:53)(cid:37)(cid:16)(cid:34)(cid:33,Unknown,11671.0
Unknown,Unknown,26,Unknown,Unknown,Unknown,Unknown,cid:12)(cid:29)(cid:26)(cid:41)(cid:25)(cid:2)(cid:53)(cid:53)(cid:37)(cid:16)(cid:34)(cid:33,Unknown,11697.0
Unknown,Unknown,41,Unknown,Unknown,Unknown,Unknown,cid:12)(cid:29)(cid:26)(cid:41)(cid:25)(cid:2)(cid:53)(cid:53)(cid:37)(cid:16)(cid:34)(cid:33,Unknown,11738.0
Unknown,Unknown,25,Unknown,Unknown,Unknown,Unknown,cid:12)(cid:29)(cid:26)(cid:41)(cid:25)(cid:2)(cid:53)(cid:53)(cid:37)(cid:16)(cid:34)(cid:33,Unknown,11763.0
Unknown,Unknown,2,Unknown,Unknown,Unknown,Unknown,cid:12)(cid:29)(cid:26)(cid:41)(cid:25)(cid:2)(cid:53)(cid:53)(cid:37)(cid:16)(cid:34)(cid:33,Unknown,11765.0
Unknown,Unknown,53,Unknown,Unknown,Unknown,Unknown,cid:12)(cid:29)(cid:26)(cid:41)(cid:25)(cid:2)(cid:53)(cid:53)(cid:37)(cid:16)(cid:34)(cid:33,Unknown,11818.0
Unknown,Unknown,53,Unknown,Unknown,Unknown,Unknown,cid:12)(cid:29)(cid:26)(cid:41)(cid:25)(cid:2)(cid:53)(cid:53)(cid:37)(cid:16)(cid:34)(cid:33,Unknown,11871.0
Unknown,Unknown,37,Unknown,Unknown,Unknown,Unknown,cid:12)(cid:29)(cid:26)(cid:41)(cid:25)(cid:2)(cid:53)(cid:53)(cid:37)(cid:16)(cid:34)(cid:33,Unknown,11908.0
Unknown,Unknown,16,Unknown,Unknown,Unknown,Unknown,cid:12)(cid:29)(cid:26)(cid:41)(cid:25)(cid:2)(cid:53)(cid:53)(cid:37)(cid:16)(cid:34)(cid:33,Unknown,11924.0
Unknown,Unknown,34,Unknown,Unknown,Unknown,Unknown,cid:12)(cid:29)(cid:26)(cid:41)(cid:25)(cid:2)(cid:53)(cid:53)(cid:37)(cid:16)(cid:34)(cid:33,Unknown,11958.0
Unknown,Unknown,33,Unknown,Unknown,Unknown,Unknown,cid:12)(cid:29)(cid:26)(cid:41)(cid:25)(cid:2)(cid:53)(cid:53)(cid:37)(cid:16)(cid:34)(cid:33,Unknown,11991.0
Unknown,Unknown,1,Unknown,Unknown,Unknown,Unknown,cid:12)(cid:29)(cid:26)(cid:41)(cid:25)(cid:2)(cid:53)(cid:53)(cid:37)(cid:16)(cid:34)(cid:33,Unknown,11992.0
Unknown,Unknown,35,Unknown,Unknown,Unknown,Unknown,cid:12)(cid:29)(cid:26)(cid:41)(cid:25)(cid:2)(cid:53)(cid:53)(cid:37)(cid:16)(cid:34)(cid:33,Unknown,12027.0
Unknown,Unknown,45,Unknown,Unknown,Unknown,Unknown,cid:12)(cid:29)(cid:26)(cid:41)(cid:25)(cid:2)(cid:53)(cid:53)(cid:37)(cid:16)(cid:34)(cid:33,Unknown,12072.0
Unknown,Unknown,18,Unknown,Unknown,Unknown,Unknown,cid:12)(cid:29)(cid:26)(cid:41)(cid:25)(cid:2)(cid:53)(cid:53)(cid:37)(cid:16)(cid:34)(cid:33,Unknown,12090.0
Unknown,Unknown,34,Unknown,Unknown,Unknown,Unknown,cid:12)(cid:29)(cid:26)(cid:41)(cid:25)(cid:2)(cid:53)(cid:53)(cid:37)(cid:16)(cid:34)(cid:33,Unknown,12124.0
Unknown,Unknown,10,Unknown,Unknown,Unknown,Unknown,cid:12)(cid:29)(cid:26)(cid:41)(cid:25)(cid:2)(cid:53)(cid:53)(cid:37)(cid:16)(cid:34)(cid:33,Unknown,12134.0
Unknown,Unknown,11,Unknown,Unknown,Unknown,Unknown,cid:12)(cid:29)(cid:26)(cid:41)(cid:25)(cid:2)(cid:53)(cid:53)(cid:37)(cid:16)(cid:34)(cid:33,Unknown,12145.0
Unknown,Unknown,10,Unknown,Unknown,Unknown,Unknown,cid:12)(cid:29)(cid:26)(cid:41)(cid:25)(cid:2)(cid:53)(cid:53)(cid:37)(cid:16)(cid:34)(cid:33,Unknown,12155.0
Unknown,Unknown,49,Unknown,Unknown,Unknown,Unknown,cid:12)(cid:29)(cid:26)(cid:41)(cid:25)(cid:2)(cid:53)(cid:53)(cid:37)(cid:16)(cid:34)(cid:33,Unknown,12204.0
Unknown,Unknown,14,Unknown,Unknown,Unknown,Unknown,cid:12)(cid:29)(cid:26)(cid:41)(cid:25)(cid:2)(cid:53)(cid:53)(cid:37)(cid:16)(cid:34)(cid:33,Unknown,12218.0
Unknown,Unknown,2,Unknown,Unknown,Unknown,Unknown,cid:12)(cid:29)(cid:26)(cid:41)(cid:25)(cid:2)(cid:53)(cid:53)(cid:37)(cid:16)(cid:34)(cid:33,Unknown,12220.0
Unknown,Unknown,12,Unknown,Unknown,Unknown,Unknown,cid:12)(cid:29)(cid:26)(cid:41)(cid:25)(cid:2)(cid:53)(cid:53)(cid:37)(cid:16)(cid:34)(cid:33,Unknown,12232.0
Unknown,Unknown,11,Unknown,Unknown,Unknown,Unknown,cid:12)(cid:29)(cid:26)(cid:41)(cid:25)(cid:2)(cid:53)(cid:53)(cid:37)(cid:16)(cid:34)(cid:33,Unknown,12243.0
Unknown,Unknown,4,Unknown,Unknown,Unknown,Unknown,cid:12)(cid:29)(cid:26)(cid:41)(cid:25)(cid:2)(cid:53)(cid:53)(cid:37)(cid:16)(cid:34)(cid:33,Unknown,12247.0
Unknown,Unknown,14,Unknown,Unknown,Unknown,Unknown,cid:12)(cid:29)(cid:26)(cid:41)(cid:25)(cid:2)(cid:53)(cid:53)(cid:37)(cid:16)(cid:34)(cid:33,Unknown,12261.0
Unknown,Unknown,11,Unknown,Unknown,Unknown,Unknown,cid:12)(cid:29)(cid:26)(cid:41)(cid:25)(cid:2)(cid:53)(cid:53)(cid:37)(cid:16)(cid:34)(cid:33,Unknown,12272.0
Unknown,Unknown,62,Unknown,Unknown,Unknown,Unknown,cid:12)(cid:29)(cid:26)(cid:41)(cid:25)(cid:2)(cid:53)(cid:53)(cid:37)(cid:16)(cid:34)(cid:33,Unknown,12334.0
Unknown,Unknown,62,Unknown,Unknown,Unknown,Unknown,cid:12)(cid:29)(cid:26)(cid:41)(cid:25)(cid:2)(cid:53)(cid:53)(cid:37)(cid:16)(cid:34)(cid:33,Unknown,12396.0
Unknown,Unknown,7,Unknown,Unknown,Unknown,Unknown,cid:12)(cid:29)(cid:26)(cid:41)(cid:25)(cid:2)(cid:53)(cid:53)(cid:37)(cid:16)(cid:34)(cid:33,Unknown,12403.0
Unknown,Unknown,5,Unknown,Unknown,Unknown,Unknown,cid:12)(cid:29)(cid:26)(cid:41)(cid:25)(cid:2)(cid:53)(cid:53)(cid:37)(cid:16)(cid:34)(cid:33,Unknown,12408.0
Unknown,Unknown,3,Unknown,Unknown,Unknown,Unknown,cid:12)(cid:29)(cid:26)(cid:41)(cid:25)(cid:2)(cid:53)(cid:53)(cid:37)(cid:16)(cid:34)(cid:33,Unknown,12411.0
Unknown,Unknown,9,Unknown,Unknown,Unknown,Unknown,cid:12)(cid:29)(cid:26)(cid:41)(cid:25)(cid:2)(cid:53)(cid:53)(cid:37)(cid:16)(cid:34)(cid:33,Unknown,12420.0
Unknown,Unknown,2,Unknown,Unknown,Unknown,Unknown,cid:12)(cid:29)(cid:26)(cid:41)(cid:25)(cid:2)(cid:53)(cid:53)(cid:37)(cid:16)(cid:34)(cid:33,Unknown,12422.0
Unknown,Unknown,28,Unknown,Unknown,Unknown,Unknown,cid:12)(cid:29)(cid:26)(cid:41)(cid:25)(cid:2)(cid:53)(cid:53)(cid:37)(cid:16)(cid:34)(cid:33,Unknown,12450.0
Unknown,Unknown,3,Unknown,Unknown,Unknown,Unknown,cid:12)(cid:29)(cid:26)(cid:41)(cid:25)(cid:2)(cid:53)(cid:53)(cid:37)(cid:16)(cid:34)(cid:33,Unknown,12453.0
Unknown,Unknown,15,Unknown,Unknown,Unknown,Unknown,cid:12)(cid:29)(cid:26)(cid:41)(cid:25)(cid:2)(cid:53)(cid:53)(cid:37)(cid:16)(cid:34)(cid:33,Unknown,12468.0
Unknown,Unknown,2,Unknown,Unknown,Unknown,Unknown,cid:12)(cid:29)(cid:26)(cid:41)(cid:25)(cid:2)(cid:53)(cid:53)(cid:37)(cid:16)(cid:34)(cid:33,Unknown,12470.0
Unknown,Unknown,17,Unknown,Unknown,Unknown,Unknown,cid:12)(cid:29)(cid:26)(cid:41)(cid:25)(cid:2)(cid:53)(cid:53)(cid:37)(cid:16)(cid:34)(cid:33,Unknown,12487.0
Unknown,Unknown,17,Unknown,Unknown,Unknown,Unknown,cid:12)(cid:29)(cid:26)(cid:41)(cid:25)(cid:2)(cid:53)(cid:53)(cid:37)(cid:16)(cid:34)(cid:33,Unknown,12504.0
Unknown,Unknown,33,Unknown,Unknown,Unknown,Unknown,cid:12)(cid:29)(cid:26)(cid:41)(cid:25)(cid:2)(cid:53)(cid:53)(cid:37)(cid:16)(cid:34)(cid:33,Unknown,12537.0
Unknown,Unknown,19,Unknown,Unknown,Unknown,Unknown,cid:12)(cid:29)(cid:26)(cid:41)(cid:25)(cid:2)(cid:53)(cid:53)(cid:37)(cid:16)(cid:34)(cid:33,Unknown,12556.0
Unknown,Unknown,33,Unknown,Unknown,Unknown,Unknown,cid:12)(cid:29)(cid:26)(cid:41)(cid:25)(cid:2)(cid:53)(cid:53)(cid:37)(cid:16)(cid:34)(cid:33,Unknown,12589.0
Unknown,Unknown,33,Unknown,Unknown,Unknown,Unknown,cid:12)(cid:29)(cid:26)(cid:41)(cid:25)(cid:2)(cid:53)(cid:53)(cid:37)(cid:16)(cid:34)(cid:33,Unknown,12622.0
Unknown,Unknown,2,Unknown,Unknown,Unknown,Unknown,cid:12)(cid:29)(cid:26)(cid:41)(cid:25)(cid:2)(cid:53)(cid:53)(cid:37)(cid:16)(cid:34)(cid:33,Unknown,12624.0
Unknown,Unknown,44,Unknown,Unknown,Unknown,Unknown,cid:12)(cid:29)(cid:26)(cid:41)(cid:25)(cid:2)(cid:53)(cid:53)(cid:37)(cid:16)(cid:34)(cid:33,Unknown,12668.0
Unknown,Unknown,12,Unknown,Unknown,Unknown,Unknown,cid:12)(cid:29)(cid:26)(cid:41)(cid:25)(cid:2)(cid:53)(cid:53)(cid:37)(cid:16)(cid:34)(cid:33,Unknown,12680.0
Unknown,Unknown,29,Unknown,Unknown,Unknown,Unknown,cid:12)(cid:29)(cid:26)(cid:41)(cid:25)(cid:2)(cid:53)(cid:53)(cid:37)(cid:16)(cid:34)(cid:33,Unknown,12709.0
Unknown,Unknown,26,Unknown,Unknown,Unknown,Unknown,cid:12)(cid:29)(cid:26)(cid:41)(cid:25)(cid:2)(cid:53)(cid:53)(cid:37)(cid:16)(cid:34)(cid:33,Unknown,12735.0
Unknown,Unknown,41,Unknown,Unknown,Unknown,Unknown,cid:12)(cid:29)(cid:26)(cid:41)(cid:25)(cid:2)(cid:53)(cid:53)(cid:37)(cid:16)(cid:34)(cid:33,Unknown,12776.0
Unknown,Unknown,25,Unknown,Unknown,Unknown,Unknown,cid:12)(cid:29)(cid:26)(cid:41)(cid:25)(cid:2)(cid:53)(cid:53)(cid:37)(cid:16)(cid:34)(cid:33,Unknown,12801.0
Unknown,Unknown,2,Unknown,Unknown,Unknown,Unknown,cid:12)(cid:29)(cid:26)(cid:41)(cid:25)(cid:2)(cid:53)(cid:53)(cid:37)(cid:16)(cid:34)(cid:33,Unknown,12803.0
Unknown,Unknown,53,Unknown,Unknown,Unknown,Unknown,cid:12)(cid:29)(cid:26)(cid:41)(cid:25)(cid:2)(cid:53)(cid:53)(cid:37)(cid:16)(cid:34)(cid:33,Unknown,12856.0
Unknown,Unknown,53,Unknown,Unknown,Unknown,Unknown,cid:12)(cid:29)(cid:26)(cid:41)(cid:25)(cid:2)(cid:53)(cid:53)(cid:37)(cid:16)(cid:34)(cid:33,Unknown,12909.0
Unknown,Unknown,18,Unknown,Unknown,Unknown,Unknown,cid:12)(cid:29)(cid:26)(cid:41)(cid:25)(cid:2)(cid:53)(cid:53)(cid:37)(cid:16)(cid:34)(cid:33,Unknown,12927.0
Unknown,Unknown,1,Unknown,Unknown,Unknown,Unknown,cid:12)(cid:29)(cid:26)(cid:41)(cid:25)(cid:2)(cid:53)(cid:53)(cid:37)(cid:16)(cid:34)(cid:33,Unknown,12928.0
Unknown,Unknown,1,Unknown,Unknown,Unknown,Unknown,cid:12)(cid:29)(cid:26)(cid:41)(cid:25)(cid:2)(cid:53)(cid:53)(cid:37)(cid:16)(cid:34)(cid:33,Unknown,12929.0
Unknown,Unknown,37,Unknown,Unknown,Unknown,Unknown,cid:12)(cid:29)(cid:26)(cid:41)(cid:25)(cid:2)(cid:53)(cid:53)(cid:37)(cid:16)(cid:34)(cid:33,Unknown,12966.0
Unknown,Unknown,1,Unknown,Unknown,Unknown,Unknown,cid:12)(cid:29)(cid:26)(cid:41)(cid:25)(cid:2)(cid:53)(cid:53)(cid:37)(cid:16)(cid:34)(cid:33,Unknown,12967.0
Unknown,Unknown,35,Unknown,Unknown,Unknown,Unknown,cid:12)(cid:29)(cid:26)(cid:41)(cid:25)(cid:2)(cid:53)(cid:53)(cid:37)(cid:16)(cid:34)(cid:33,Unknown,13002.0
Unknown,Unknown,45,Unknown,Unknown,Unknown,Unknown,cid:12)(cid:29)(cid:26)(cid:41)(cid:25)(cid:2)(cid:53)(cid:53)(cid:37)(cid:16)(cid:34)(cid:33,Unknown,13047.0
Unknown,Unknown,18,Unknown,Unknown,Unknown,Unknown,cid:12)(cid:29)(cid:26)(cid:41)(cid:25)(cid:2)(cid:53)(cid:53)(cid:37)(cid:16)(cid:34)(cid:33,Unknown,13065.0
Unknown,Unknown,34,Unknown,Unknown,Unknown,Unknown,cid:12)(cid:29)(cid:26)(cid:41)(cid:25)(cid:2)(cid:53)(cid:53)(cid:37)(cid:16)(cid:34)(cid:33,Unknown,13099.0
Unknown,Unknown,10,Unknown,Unknown,Unknown,Unknown,cid:12)(cid:29)(cid:26)(cid:41)(cid:25)(cid:2)(cid:53)(cid:53)(cid:37)(cid:16)(cid:34)(cid:33,Unknown,13109.0
Unknown,Unknown,5,Unknown,Unknown,Unknown,Unknown,cid:12)(cid:29)(cid:26)(cid:41)(cid:25)(cid:2)(cid:53)(cid:53)(cid:37)(cid:16)(cid:34)(cid:33,Unknown,13114.0
Unknown,Unknown,14,Unknown,Unknown,Unknown,Unknown,cid:12)(cid:29)(cid:26)(cid:41)(cid:25)(cid:2)(cid:53)(cid:53)(cid:37)(cid:16)(cid:34)(cid:33,Unknown,13128.0
Unknown,Unknown,2,Unknown,Unknown,Unknown,Unknown,cid:12)(cid:29)(cid:26)(cid:41)(cid:25)(cid:2)(cid:53)(cid:53)(cid:37)(cid:16)(cid:34)(cid:33,Unknown,13130.0
Unknown,Unknown,62,Unknown,Unknown,Unknown,Unknown,cid:12)(cid:29)(cid:26)(cid:41)(cid:25)(cid:2)(cid:53)(cid:53)(cid:37)(cid:16)(cid:34)(cid:33,Unknown,13192.0
Unknown,Unknown,2,Unknown,Unknown,Unknown,Unknown,cid:12)(cid:29)(cid:26)(cid:41)(cid:25)(cid:2)(cid:53)(cid:53)(cid:37)(cid:16)(cid:34)(cid:33,Unknown,13194.0
Unknown,Unknown,62,Unknown,Unknown,Unknown,Unknown,cid:12)(cid:29)(cid:26)(cid:41)(cid:25)(cid:2)(cid:53)(cid:53)(cid:37)(cid:16)(cid:34)(cid:33,Unknown,13256.0
Unknown,Unknown,5,Unknown,Unknown,Unknown,Unknown,cid:12)(cid:29)(cid:26)(cid:41)(cid:25)(cid:2)(cid:53)(cid:53)(cid:37)(cid:16)(cid:34)(cid:33,Unknown,13261.0
Unknown,Unknown,4,Unknown,Unknown,Unknown,Unknown,cid:12)(cid:29)(cid:26)(cid:41)(cid:25)(cid:2)(cid:53)(cid:53)(cid:37)(cid:16)(cid:34)(cid:33,Unknown,13265.0
Unknown,Unknown,52,Unknown,Unknown,Unknown,Unknown,cid:12)(cid:29)(cid:26)(cid:41)(cid:25)(cid:2)(cid:53)(cid:53)(cid:37)(cid:16)(cid:34)(cid:33,Unknown,13317.0
Unknown,Unknown,11,Unknown,Unknown,Unknown,Unknown,cid:12)(cid:29)(cid:26)(cid:41)(cid:25)(cid:2)(cid:53)(cid:53)(cid:37)(cid:16)(cid:34)(cid:33,Unknown,13328.0
Unknown,Unknown,8,Unknown,Unknown,Unknown,Unknown,cid:12)(cid:29)(cid:26)(cid:41)(cid:25)(cid:2)(cid:53)(cid:53)(cid:37)(cid:16)(cid:34)(cid:33,Unknown,13336.0
Unknown,Unknown,2,Unknown,Unknown,Unknown,Unknown,cid:12)(cid:29)(cid:26)(cid:41)(cid:25)(cid:2)(cid:53)(cid:53)(cid:37)(cid:16)(cid:34)(cid:33,Unknown,13338.0
Unknown,Unknown,14,Unknown,Unknown,Unknown,Unknown,cid:12)(cid:29)(cid:26)(cid:41)(cid:25)(cid:2)(cid:53)(cid:53)(cid:37)(cid:16)(cid:34)(cid:33,Unknown,13352.0
Unknown,Unknown,49,Unknown,Unknown,Unknown,Unknown,cid:12)(cid:29)(cid:26)(cid:41)(cid:25)(cid:2)(cid:53)(cid:53)(cid:37)(cid:16)(cid:34)(cid:33,Unknown,13401.0
Unknown,Unknown,2,Unknown,Unknown,Unknown,Unknown,cid:12)(cid:29)(cid:26)(cid:41)(cid:25)(cid:2)(cid:53)(cid:53)(cid:37)(cid:16)(cid:34)(cid:33,Unknown,13403.0
Unknown,Unknown,28,Unknown,Unknown,Unknown,Unknown,cid:12)(cid:29)(cid:26)(cid:41)(cid:25)(cid:2)(cid:53)(cid:53)(cid:37)(cid:16)(cid:34)(cid:33,Unknown,13431.0
Unknown,Unknown,11,Unknown,Unknown,Unknown,Unknown,cid:12)(cid:29)(cid:26)(cid:41)(cid:25)(cid:2)(cid:53)(cid:53)(cid:37)(cid:16)(cid:34)(cid:33,Unknown,13442.0
Unknown,Unknown,3,Unknown,Unknown,Unknown,Unknown,cid:12)(cid:29)(cid:26)(cid:41)(cid:25)(cid:2)(cid:53)(cid:53)(cid:37)(cid:16)(cid:34)(cid:33,Unknown,13445.0
Unknown,Unknown,2,Unknown,Unknown,Unknown,Unknown,cid:12)(cid:29)(cid:26)(cid:41)(cid:25)(cid:2)(cid:53)(cid:53)(cid:37)(cid:16)(cid:34)(cid:33,Unknown,13447.0
Unknown,Unknown,28,Unknown,Unknown,Unknown,Unknown,cid:12)(cid:29)(cid:26)(cid:41)(cid:25)(cid:2)(cid:53)(cid:53)(cid:37)(cid:16)(cid:34)(cid:33,Unknown,13475.0
Unknown,Unknown,3,Unknown,Unknown,Unknown,Unknown,cid:12)(cid:29)(cid:26)(cid:41)(cid:25)(cid:2)(cid:53)(cid:53)(cid:37)(cid:16)(cid:34)(cid:33,Unknown,13478.0
Unknown,Unknown,15,Unknown,Unknown,Unknown,Unknown,cid:12)(cid:29)(cid:26)(cid:41)(cid:25)(cid:2)(cid:53)(cid:53)(cid:37)(cid:16)(cid:34)(cid:33,Unknown,13493.0
Unknown,Unknown,2,Unknown,Unknown,Unknown,Unknown,cid:12)(cid:29)(cid:26)(cid:41)(cid:25)(cid:2)(cid:53)(cid:53)(cid:37)(cid:16)(cid:34)(cid:33,Unknown,13495.0
Unknown,Unknown,37,Unknown,Unknown,Unknown,Unknown,cid:12)(cid:29)(cid:26)(cid:41)(cid:25)(cid:2)(cid:53)(cid:53)(cid:37)(cid:16)(cid:34)(cid:33,Unknown,13532.0
Unknown,Unknown,33,Unknown,Unknown,Unknown,Unknown,cid:12)(cid:29)(cid:26)(cid:41)(cid:25)(cid:2)(cid:53)(cid:53)(cid:37)(cid:16)(cid:34)(cid:33,Unknown,13565.0
Unknown,Unknown,19,Unknown,Unknown,Unknown,Unknown,cid:12)(cid:29)(cid:26)(cid:41)(cid:25)(cid:2)(cid:53)(cid:53)(cid:37)(cid:16)(cid:34)(cid:33,Unknown,13584.0
Unknown,Unknown,33,Unknown,Unknown,Unknown,Unknown,cid:12)(cid:29)(cid:26)(cid:41)(cid:25)(cid:2)(cid:53)(cid:53)(cid:37)(cid:16)(cid:34)(cid:33,Unknown,13617.0
Unknown,Unknown,33,Unknown,Unknown,Unknown,Unknown,cid:12)(cid:29)(cid:26)(cid:41)(cid:25)(cid:2)(cid:53)(cid:53)(cid:37)(cid:16)(cid:34)(cid:33,Unknown,13650.0
Unknown,Unknown,2,Unknown,Unknown,Unknown,Unknown,cid:12)(cid:29)(cid:26)(cid:41)(cid:25)(cid:2)(cid:53)(cid:53)(cid:37)(cid:16)(cid:34)(cid:33,Unknown,13652.0
Unknown,Unknown,44,Unknown,Unknown,Unknown,Unknown,cid:12)(cid:29)(cid:26)(cid:41)(cid:25)(cid:2)(cid:53)(cid:53)(cid:37)(cid:16)(cid:34)(cid:33,Unknown,13696.0
Unknown,Unknown,12,Unknown,Unknown,Unknown,Unknown,cid:12)(cid:29)(cid:26)(cid:41)(cid:25)(cid:2)(cid:53)(cid:53)(cid:37)(cid:16)(cid:34)(cid:33,Unknown,13708.0
Unknown,Unknown,29,Unknown,Unknown,Unknown,Unknown,cid:12)(cid:29)(cid:26)(cid:41)(cid:25)(cid:2)(cid:53)(cid:53)(cid:37)(cid:16)(cid:34)(cid:33,Unknown,13737.0
Unknown,Unknown,26,Unknown,Unknown,Unknown,Unknown,cid:12)(cid:29)(cid:26)(cid:41)(cid:25)(cid:2)(cid:53)(cid:53)(cid:37)(cid:16)(cid:34)(cid:33,Unknown,13763.0
Unknown,Unknown,41,Unknown,Unknown,Unknown,Unknown,cid:12)(cid:29)(cid:26)(cid:41)(cid:25)(cid:2)(cid:53)(cid:53)(cid:37)(cid:16)(cid:34)(cid:33,Unknown,13804.0
Unknown,Unknown,25,Unknown,Unknown,Unknown,Unknown,cid:12)(cid:29)(cid:26)(cid:41)(cid:25)(cid:2)(cid:53)(cid:53)(cid:37)(cid:16)(cid:34)(cid:33,Unknown,13829.0
Unknown,Unknown,2,Unknown,Unknown,Unknown,Unknown,cid:12)(cid:29)(cid:26)(cid:41)(cid:25)(cid:2)(cid:53)(cid:53)(cid:37)(cid:16)(cid:34)(cid:33,Unknown,13831.0
Unknown,Unknown,53,Unknown,Unknown,Unknown,Unknown,cid:12)(cid:29)(cid:26)(cid:41)(cid:25)(cid:2)(cid:53)(cid:53)(cid:37)(cid:16)(cid:34)(cid:33,Unknown,13884.0
Unknown,Unknown,53,Unknown,Unknown,Unknown,Unknown,cid:12)(cid:29)(cid:26)(cid:41)(cid:25)(cid:2)(cid:53)(cid:53)(cid:37)(cid:16)(cid:34)(cid:33,Unknown,13937.0
Unknown,Unknown,37,Unknown,Unknown,Unknown,Unknown,cid:12)(cid:29)(cid:26)(cid:41)(cid:25)(cid:2)(cid:53)(cid:53)(cid:37)(cid:16)(cid:34)(cid:33,Unknown,13974.0
Unknown,Unknown,16,Unknown,Unknown,Unknown,Unknown,cid:12)(cid:29)(cid:26)(cid:41)(cid:25)(cid:2)(cid:53)(cid:53)(cid:37)(cid:16)(cid:34)(cid:33,Unknown,13990.0
Unknown,Unknown,34,Unknown,Unknown,Unknown,Unknown,cid:12)(cid:29)(cid:26)(cid:41)(cid:25)(cid:2)(cid:53)(cid:53)(cid:37)(cid:16)(cid:34)(cid:33,Unknown,14024.0
Unknown,Unknown,33,Unknown,Unknown,Unknown,Unknown,cid:12)(cid:29)(cid:26)(cid:41)(cid:25)(cid:2)(cid:53)(cid:53)(cid:37)(cid:16)(cid:34)(cid:33,Unknown,14057.0
Unknown,Unknown,1,Unknown,Unknown,Unknown,Unknown,cid:12)(cid:29)(cid:26)(cid:41)(cid:25)(cid:2)(cid:53)(cid:53)(cid:37)(cid:16)(cid:34)(cid:33,Unknown,14058.0
Unknown,Unknown,35,Unknown,Unknown,Unknown,Unknown,cid:12)(cid:29)(cid:26)(cid:41)(cid:25)(cid:2)(cid:53)(cid:53)(cid:37)(cid:16)(cid:34)(cid:33,Unknown,14093.0
Unknown,Unknown,45,Unknown,Unknown,Unknown,Unknown,cid:12)(cid:29)(cid:26)(cid:41)(cid:25)(cid:2)(cid:53)(cid:53)(cid:37)(cid:16)(cid:34)(cid:33,Unknown,14138.0
Unknown,Unknown,18,Unknown,Unknown,Unknown,Unknown,cid:12)(cid:29)(cid:26)(cid:41)(cid:25)(cid:2)(cid:53)(cid:53)(cid:37)(cid:16)(cid:34)(cid:33,Unknown,14156.0
Unknown,Unknown,34,Unknown,Unknown,Unknown,Unknown,cid:12)(cid:29)(cid:26)(cid:41)(cid:25)(cid:2)(cid:53)(cid:53)(cid:37)(cid:16)(cid:34)(cid:33,Unknown,14190.0
Unknown,Unknown,27,Unknown,Unknown,Unknown,Unknown,cid:12)(cid:29)(cid:26)(cid:41)(cid:25)(cid:2)(cid:53)(cid:53)(cid:37)(cid:16)(cid:34)(cid:33,Unknown,14217.0
Unknown,Unknown,29,Unknown,Unknown,Unknown,Unknown,cid:12)(cid:29)(cid:26)(cid:41)(cid:25)(cid:2)(cid:53)(cid:53)(cid:37)(cid:16)(cid:34)(cid:33,Unknown,14246.0
Unknown,Unknown,26,Unknown,Unknown,Unknown,Unknown,cid:12)(cid:29)(cid:26)(cid:41)(cid:25)(cid:2)(cid:53)(cid:53)(cid:37)(cid:16)(cid:34)(cid:33,Unknown,14272.0
Unknown,Unknown,22,Unknown,Unknown,Unknown,Unknown,cid:12)(cid:29)(cid:26)(cid:41)(cid:25)(cid:2)(cid:53)(cid:53)(cid:37)(cid:16)(cid:34)(cid:33,Unknown,14294.0
Unknown,Unknown,2,Unknown,Unknown,Unknown,Unknown,cid:12)(cid:29)(cid:26)(cid:41)(cid:25)(cid:2)(cid:53)(cid:53)(cid:37)(cid:16)(cid:34)(cid:33,Unknown,14296.0
Unknown,Unknown,27,Unknown,Unknown,Unknown,Unknown,cid:12)(cid:29)(cid:26)(cid:41)(cid:25)(cid:2)(cid:53)(cid:53)(cid:37)(cid:16)(cid:34)(cid:33,Unknown,14323.0
Unknown,Unknown,72,Unknown,Unknown,Unknown,Unknown,cid:12)(cid:29)(cid:26)(cid:41)(cid:25)(cid:2)(cid:53)(cid:53)(cid:37)(cid:16)(cid:34)(cid:33,Unknown,14395.0
Unknown,Unknown,22,Unknown,Unknown,Unknown,Unknown,cid:12)(cid:29)(cid:26)(cid:41)(cid:25)(cid:2)(cid:53)(cid:53)(cid:37)(cid:16)(cid:34)(cid:33,Unknown,14417.0
Unknown,Unknown,48,Unknown,Unknown,Unknown,Unknown,cid:12)(cid:29)(cid:26)(cid:41)(cid:25)(cid:2)(cid:53)(cid:53)(cid:37)(cid:16)(cid:34)(cid:33,Unknown,14465.0
Unknown,Unknown,25,Unknown,Unknown,Unknown,Unknown,cid:12)(cid:29)(cid:26)(cid:41)(cid:25)(cid:2)(cid:53)(cid:53)(cid:37)(cid:16)(cid:34)(cid:33,Unknown,14490.0
Unknown,Unknown,73,Unknown,Unknown,Unknown,Unknown,cid:12)(cid:29)(cid:26)(cid:41)(cid:25)(cid:2)(cid:53)(cid:53)(cid:37)(cid:16)(cid:34)(cid:33,Unknown,14563.0
Unknown,Unknown,55,Unknown,Unknown,Unknown,Unknown,cid:12)(cid:29)(cid:26)(cid:41)(cid:25)(cid:2)(cid:53)(cid:53)(cid:37)(cid:16)(cid:34)(cid:33,Unknown,14618.0
Unknown,Unknown,20,Unknown,Unknown,Unknown,Unknown,cid:12)(cid:29)(cid:26)(cid:41)(cid:25)(cid:2)(cid:53)(cid:53)(cid:37)(cid:16)(cid:34)(cid:33,Unknown,14638.0
Unknown,Unknown,26,Unknown,Unknown,Unknown,Unknown,cid:12)(cid:29)(cid:26)(cid:41)(cid:25)(cid:2)(cid:53)(cid:53)(cid:37)(cid:16)(cid:34)(cid:33,Unknown,14664.0
Unknown,Unknown,41,Unknown,Unknown,Unknown,Unknown,cid:12)(cid:29)(cid:26)(cid:41)(cid:25)(cid:2)(cid:53)(cid:53)(cid:37)(cid:16)(cid:34)(cid:33,Unknown,14705.0
Unknown,Unknown,15,Unknown,Unknown,Unknown,Unknown,cid:12)(cid:29)(cid:26)(cid:41)(cid:25)(cid:2)(cid:53)(cid:53)(cid:37)(cid:16)(cid:34)(cid:33,Unknown,14720.0
Unknown,Unknown,2,Unknown,Unknown,Unknown,Unknown,cid:12)(cid:29)(cid:26)(cid:41)(cid:25)(cid:2)(cid:53)(cid:53)(cid:37)(cid:16)(cid:34)(cid:33,Unknown,14722.0
Unknown,Unknown,1,Unknown,Unknown,Unknown,Unknown,cid:12)(cid:29)(cid:26)(cid:41)(cid:25)(cid:2)(cid:53)(cid:53)(cid:37)(cid:16)(cid:34)(cid:33,Unknown,14723.0
Unknown,Unknown,18,Unknown,Unknown,Unknown,Unknown,cid:12)(cid:29)(cid:26)(cid:41)(cid:25)(cid:2)(cid:53)(cid:53)(cid:37)(cid:16)(cid:34)(cid:33,Unknown,14741.0
Unknown,Unknown,2,Unknown,Unknown,Unknown,Unknown,cid:12)(cid:29)(cid:26)(cid:41)(cid:25)(cid:2)(cid:53)(cid:53)(cid:37)(cid:16)(cid:34)(cid:33,Unknown,14743.0
Unknown,Unknown,18,Unknown,Unknown,Unknown,Unknown,cid:12)(cid:29)(cid:26)(cid:41)(cid:25)(cid:2)(cid:53)(cid:53)(cid:37)(cid:16)(cid:34)(cid:33,Unknown,14761.0
Unknown,Unknown,18,Unknown,Unknown,Unknown,Unknown,cid:12)(cid:29)(cid:26)(cid:41)(cid:25)(cid:2)(cid:53)(cid:53)(cid:37)(cid:16)(cid:34)(cid:33,Unknown,14779.0
Unknown,Unknown,18,Unknown,Unknown,Unknown,Unknown,cid:12)(cid:29)(cid:26)(cid:41)(cid:25)(cid:2)(cid:53)(cid:53)(cid:37)(cid:16)(cid:34)(cid:33,Unknown,14797.0
Unknown,Unknown,19,Unknown,Unknown,Unknown,Unknown,cid:12)(cid:29)(cid:26)(cid:41)(cid:25)(cid:2)(cid:53)(cid:53)(cid:37)(cid:16)(cid:34)(cid:33,Unknown,14816.0
Unknown,Unknown,18,Unknown,Unknown,Unknown,Unknown,cid:12)(cid:29)(cid:26)(cid:41)(cid:25)(cid:2)(cid:53)(cid:53)(cid:37)(cid:16)(cid:34)(cid:33,Unknown,14834.0
Unknown,Unknown,18,Unknown,Unknown,Unknown,Unknown,cid:12)(cid:29)(cid:26)(cid:41)(cid:25)(cid:2)(cid:53)(cid:53)(cid:37)(cid:16)(cid:34)(cid:33,Unknown,14852.0
Unknown,Unknown,2,Unknown,Unknown,Unknown,Unknown,cid:12)(cid:29)(cid:26)(cid:41)(cid:25)(cid:2)(cid:53)(cid:53)(cid:37)(cid:16)(cid:34)(cid:33,Unknown,14854.0
Unknown,Unknown,44,Unknown,Unknown,Unknown,Unknown,cid:12)(cid:29)(cid:26)(cid:41)(cid:25)(cid:2)(cid:53)(cid:53)(cid:37)(cid:16)(cid:34)(cid:33,Unknown,14898.0
Unknown,Unknown,55,Unknown,Unknown,Unknown,Unknown,cid:12)(cid:29)(cid:26)(cid:41)(cid:25)(cid:2)(cid:53)(cid:53)(cid:37)(cid:16)(cid:34)(cid:33,Unknown,14953.0
Unknown,Unknown,29,Unknown,Unknown,Unknown,Unknown,cid:12)(cid:29)(cid:26)(cid:41)(cid:25)(cid:2)(cid:53)(cid:53)(cid:37)(cid:16)(cid:34)(cid:33,Unknown,14982.0
Unknown,Unknown,24,Unknown,Unknown,Unknown,Unknown,cid:12)(cid:29)(cid:26)(cid:41)(cid:25)(cid:2)(cid:53)(cid:53)(cid:37)(cid:16)(cid:34)(cid:33,Unknown,15006.0
Unknown,Unknown,25,Unknown,Unknown,Unknown,Unknown,cid:12)(cid:29)(cid:26)(cid:41)(cid:25)(cid:2)(cid:53)(cid:53)(cid:37)(cid:16)(cid:34)(cid:33,Unknown,15031.0
Unknown,Unknown,23,Unknown,Unknown,Unknown,Unknown,cid:12)(cid:29)(cid:26)(cid:41)(cid:25)(cid:2)(cid:53)(cid:53)(cid:37)(cid:16)(cid:34)(cid:33,Unknown,15054.0
Unknown,Unknown,25,Unknown,Unknown,Unknown,Unknown,cid:12)(cid:29)(cid:26)(cid:41)(cid:25)(cid:2)(cid:53)(cid:53)(cid:37)(cid:16)(cid:34)(cid:33,Unknown,15079.0
Unknown,Unknown,30,Unknown,Unknown,Unknown,Unknown,cid:12)(cid:29)(cid:26)(cid:41)(cid:25)(cid:2)(cid:53)(cid:53)(cid:37)(cid:16)(cid:34)(cid:33,Unknown,15109.0
Unknown,Unknown,41,Unknown,Unknown,Unknown,Unknown,cid:12)(cid:29)(cid:26)(cid:41)(cid:25)(cid:2)(cid:53)(cid:53)(cid:37)(cid:16)(cid:34)(cid:33,Unknown,15150.0
Unknown,Unknown,2,Unknown,Unknown,Unknown,Unknown,cid:12)(cid:29)(cid:26)(cid:41)(cid:25)(cid:2)(cid:53)(cid:53)(cid:37)(cid:16)(cid:34)(cid:33,Unknown,15152.0
Unknown,Unknown,50,Unknown,Unknown,Unknown,Unknown,cid:12)(cid:29)(cid:26)(cid:41)(cid:25)(cid:2)(cid:53)(cid:53)(cid:37)(cid:16)(cid:34)(cid:33,Unknown,15202.0
Unknown,Unknown,20,Unknown,Unknown,Unknown,Unknown,cid:12)(cid:29)(cid:26)(cid:41)(cid:25)(cid:2)(cid:53)(cid:53)(cid:37)(cid:16)(cid:34)(cid:33,Unknown,15222.0
Unknown,Unknown,24,Unknown,Unknown,Unknown,Unknown,cid:12)(cid:29)(cid:26)(cid:41)(cid:25)(cid:2)(cid:53)(cid:53)(cid:37)(cid:16)(cid:34)(cid:33,Unknown,15246.0
Unknown,Unknown,27,Unknown,Unknown,Unknown,Unknown,cid:12)(cid:29)(cid:26)(cid:41)(cid:25)(cid:2)(cid:53)(cid:53)(cid:37)(cid:16)(cid:34)(cid:33,Unknown,15273.0
Unknown,Unknown,1,Unknown,Unknown,Unknown,Unknown,cid:12)(cid:29)(cid:26)(cid:41)(cid:25)(cid:2)(cid:53)(cid:53)(cid:37)(cid:16)(cid:34)(cid:33,Unknown,15274.0
Unknown,Unknown,35,Unknown,Unknown,Unknown,Unknown,cid:12)(cid:29)(cid:26)(cid:41)(cid:25)(cid:2)(cid:53)(cid:53)(cid:37)(cid:16)(cid:34)(cid:33,Unknown,15309.0
Unknown,Unknown,45,Unknown,Unknown,Unknown,Unknown,cid:12)(cid:29)(cid:26)(cid:41)(cid:25)(cid:2)(cid:53)(cid:53)(cid:37)(cid:16)(cid:34)(cid:33,Unknown,15354.0
Unknown,Unknown,18,Unknown,Unknown,Unknown,Unknown,cid:12)(cid:29)(cid:26)(cid:41)(cid:25)(cid:2)(cid:53)(cid:53)(cid:37)(cid:16)(cid:34)(cid:33,Unknown,15372.0
Unknown,Unknown,34,Unknown,Unknown,Unknown,Unknown,cid:12)(cid:29)(cid:26)(cid:41)(cid:25)(cid:2)(cid:53)(cid:53)(cid:37)(cid:16)(cid:34)(cid:33,Unknown,15406.0
Unknown,Unknown,5,Unknown,Unknown,Unknown,Unknown,cid:12)(cid:29)(cid:26)(cid:41)(cid:25)(cid:2)(cid:53)(cid:53)(cid:37)(cid:16)(cid:34)(cid:33,Unknown,15411.0
Unknown,Unknown,74,Unknown,Unknown,Unknown,Unknown,cid:12)(cid:29)(cid:26)(cid:41)(cid:25)(cid:2)(cid:53)(cid:53)(cid:37)(cid:16)(cid:34)(cid:33,Unknown,15485.0
Unknown,Unknown,14,Unknown,Unknown,Unknown,Unknown,cid:12)(cid:29)(cid:26)(cid:41)(cid:25)(cid:2)(cid:53)(cid:53)(cid:37)(cid:16)(cid:34)(cid:33,Unknown,15499.0
Unknown,Unknown,5,Unknown,Unknown,Unknown,Unknown,cid:12)(cid:29)(cid:26)(cid:41)(cid:25)(cid:2)(cid:53)(cid:53)(cid:37)(cid:16)(cid:34)(cid:33,Unknown,15504.0
Unknown,Unknown,12,Unknown,Unknown,Unknown,Unknown,cid:12)(cid:29)(cid:26)(cid:41)(cid:25)(cid:2)(cid:53)(cid:53)(cid:37)(cid:16)(cid:34)(cid:33,Unknown,15516.0
Unknown,Unknown,14,Unknown,Unknown,Unknown,Unknown,cid:12)(cid:29)(cid:26)(cid:41)(cid:25)(cid:2)(cid:53)(cid:53)(cid:37)(cid:16)(cid:34)(cid:33,Unknown,15530.0
Unknown,Unknown,5,Unknown,Unknown,Unknown,Unknown,cid:12)(cid:29)(cid:26)(cid:41)(cid:25)(cid:2)(cid:53)(cid:53)(cid:37)(cid:16)(cid:34)(cid:33,Unknown,15535.0
Unknown,Unknown,3,Unknown,Unknown,Unknown,Unknown,cid:12)(cid:29)(cid:26)(cid:41)(cid:25)(cid:2)(cid:53)(cid:53)(cid:37)(cid:16)(cid:34)(cid:33,Unknown,15538.0
Unknown,Unknown,12,Unknown,Unknown,Unknown,Unknown,cid:12)(cid:29)(cid:26)(cid:41)(cid:25)(cid:2)(cid:53)(cid:53)(cid:37)(cid:16)(cid:34)(cid:33,Unknown,15550.0
Unknown,Unknown,2,Unknown,Unknown,Unknown,Unknown,cid:12)(cid:29)(cid:26)(cid:41)(cid:25)(cid:2)(cid:53)(cid:53)(cid:37)(cid:16)(cid:34)(cid:33,Unknown,15552.0
Unknown,Unknown,39,Unknown,Unknown,Unknown,Unknown,cid:12)(cid:29)(cid:26)(cid:41)(cid:25)(cid:2)(cid:53)(cid:53)(cid:37)(cid:16)(cid:34)(cid:33,Unknown,15591.0
Unknown,Unknown,3,Unknown,Unknown,Unknown,Unknown,cid:12)(cid:29)(cid:26)(cid:41)(cid:25)(cid:2)(cid:53)(cid:53)(cid:37)(cid:16)(cid:34)(cid:33,Unknown,15594.0
Unknown,Unknown,11,Unknown,Unknown,Unknown,Unknown,cid:12)(cid:29)(cid:26)(cid:41)(cid:25)(cid:2)(cid:53)(cid:53)(cid:37)(cid:16)(cid:34)(cid:33,Unknown,15605.0
Unknown,Unknown,63,Unknown,Unknown,Unknown,Unknown,cid:12)(cid:29)(cid:26)(cid:41)(cid:25)(cid:2)(cid:53)(cid:53)(cid:37)(cid:16)(cid:34)(cid:33,Unknown,15668.0
Unknown,Unknown,7,Unknown,Unknown,Unknown,Unknown,cid:12)(cid:29)(cid:26)(cid:41)(cid:25)(cid:2)(cid:53)(cid:53)(cid:37)(cid:16)(cid:34)(cid:33,Unknown,15675.0
Unknown,Unknown,8,Unknown,Unknown,Unknown,Unknown,cid:12)(cid:29)(cid:26)(cid:41)(cid:25)(cid:2)(cid:53)(cid:53)(cid:37)(cid:16)(cid:34)(cid:33,Unknown,15683.0
Unknown,Unknown,9,Unknown,Unknown,Unknown,Unknown,cid:12)(cid:29)(cid:26)(cid:41)(cid:25)(cid:2)(cid:53)(cid:53)(cid:37)(cid:16)(cid:34)(cid:33,Unknown,15692.0
Unknown,Unknown,2,Unknown,Unknown,Unknown,Unknown,cid:12)(cid:29)(cid:26)(cid:41)(cid:25)(cid:2)(cid:53)(cid:53)(cid:37)(cid:16)(cid:34)(cid:33,Unknown,15694.0
Unknown,Unknown,28,Unknown,Unknown,Unknown,Unknown,cid:12)(cid:29)(cid:26)(cid:41)(cid:25)(cid:2)(cid:53)(cid:53)(cid:37)(cid:16)(cid:34)(cid:33,Unknown,15722.0
Unknown,Unknown,3,Unknown,Unknown,Unknown,Unknown,cid:12)(cid:29)(cid:26)(cid:41)(cid:25)(cid:2)(cid:53)(cid:53)(cid:37)(cid:16)(cid:34)(cid:33,Unknown,15725.0
Unknown,Unknown,15,Unknown,Unknown,Unknown,Unknown,cid:12)(cid:29)(cid:26)(cid:41)(cid:25)(cid:2)(cid:53)(cid:53)(cid:37)(cid:16)(cid:34)(cid:33,Unknown,15740.0
Unknown,Unknown,2,Unknown,Unknown,Unknown,Unknown,cid:12)(cid:29)(cid:26)(cid:41)(cid:25)(cid:2)(cid:53)(cid:53)(cid:37)(cid:16)(cid:34)(cid:33,Unknown,15742.0
Unknown,Unknown,17,Unknown,Unknown,Unknown,Unknown,cid:12)(cid:29)(cid:26)(cid:41)(cid:25)(cid:2)(cid:53)(cid:53)(cid:37)(cid:16)(cid:34)(cid:33,Unknown,15759.0
Unknown,Unknown,34,Unknown,Unknown,Unknown,Unknown,cid:12)(cid:29)(cid:26)(cid:41)(cid:25)(cid:2)(cid:53)(cid:53)(cid:37)(cid:16)(cid:34)(cid:33,Unknown,15793.0
Unknown,Unknown,19,Unknown,Unknown,Unknown,Unknown,cid:12)(cid:29)(cid:26)(cid:41)(cid:25)(cid:2)(cid:53)(cid:53)(cid:37)(cid:16)(cid:34)(cid:33,Unknown,15812.0
Unknown,Unknown,36,Unknown,Unknown,Unknown,Unknown,cid:12)(cid:29)(cid:26)(cid:41)(cid:25)(cid:2)(cid:53)(cid:53)(cid:37)(cid:16)(cid:34)(cid:33,Unknown,15848.0
Unknown,Unknown,34,Unknown,Unknown,Unknown,Unknown,cid:12)(cid:29)(cid:26)(cid:41)(cid:25)(cid:2)(cid:53)(cid:53)(cid:37)(cid:16)(cid:34)(cid:33,Unknown,15882.0
Unknown,Unknown,2,Unknown,Unknown,Unknown,Unknown,cid:12)(cid:29)(cid:26)(cid:41)(cid:25)(cid:2)(cid:53)(cid:53)(cid:37)(cid:16)(cid:34)(cid:33,Unknown,15884.0
Unknown,Unknown,44,Unknown,Unknown,Unknown,Unknown,cid:12)(cid:29)(cid:26)(cid:41)(cid:25)(cid:2)(cid:53)(cid:53)(cid:37)(cid:16)(cid:34)(cid:33,Unknown,15928.0
Unknown,Unknown,12,Unknown,Unknown,Unknown,Unknown,cid:12)(cid:29)(cid:26)(cid:41)(cid:25)(cid:2)(cid:53)(cid:53)(cid:37)(cid:16)(cid:34)(cid:33,Unknown,15940.0
Unknown,Unknown,29,Unknown,Unknown,Unknown,Unknown,cid:12)(cid:29)(cid:26)(cid:41)(cid:25)(cid:2)(cid:53)(cid:53)(cid:37)(cid:16)(cid:34)(cid:33,Unknown,15969.0
Unknown,Unknown,26,Unknown,Unknown,Unknown,Unknown,cid:12)(cid:29)(cid:26)(cid:41)(cid:25)(cid:2)(cid:53)(cid:53)(cid:37)(cid:16)(cid:34)(cid:33,Unknown,15995.0
Unknown,Unknown,41,Unknown,Unknown,Unknown,Unknown,cid:12)(cid:29)(cid:26)(cid:41)(cid:25)(cid:2)(cid:53)(cid:53)(cid:37)(cid:16)(cid:34)(cid:33,Unknown,16036.0
Unknown,Unknown,25,Unknown,Unknown,Unknown,Unknown,cid:12)(cid:29)(cid:26)(cid:41)(cid:25)(cid:2)(cid:53)(cid:53)(cid:37)(cid:16)(cid:34)(cid:33,Unknown,16061.0
Unknown,Unknown,2,Unknown,Unknown,Unknown,Unknown,cid:12)(cid:29)(cid:26)(cid:41)(cid:25)(cid:2)(cid:53)(cid:53)(cid:37)(cid:16)(cid:34)(cid:33,Unknown,16063.0
Unknown,Unknown,53,Unknown,Unknown,Unknown,Unknown,cid:12)(cid:29)(cid:26)(cid:41)(cid:25)(cid:2)(cid:53)(cid:53)(cid:37)(cid:16)(cid:34)(cid:33,Unknown,16116.0
Unknown,Unknown,53,Unknown,Unknown,Unknown,Unknown,cid:12)(cid:29)(cid:26)(cid:41)(cid:25)(cid:2)(cid:53)(cid:53)(cid:37)(cid:16)(cid:34)(cid:33,Unknown,16169.0
Unknown,Unknown,18,Unknown,Unknown,Unknown,Unknown,cid:12)(cid:29)(cid:26)(cid:41)(cid:25)(cid:2)(cid:53)(cid:53)(cid:37)(cid:16)(cid:34)(cid:33,Unknown,16187.0
Unknown,Unknown,1,Unknown,Unknown,Unknown,Unknown,cid:12)(cid:29)(cid:26)(cid:41)(cid:25)(cid:2)(cid:53)(cid:53)(cid:37)(cid:16)(cid:34)(cid:33,Unknown,16188.0
Unknown,Unknown,1,Unknown,Unknown,Unknown,Unknown,cid:12)(cid:29)(cid:26)(cid:41)(cid:25)(cid:2)(cid:53)(cid:53)(cid:37)(cid:16)(cid:34)(cid:33,Unknown,16189.0
Unknown,Unknown,37,Unknown,Unknown,Unknown,Unknown,cid:12)(cid:29)(cid:26)(cid:41)(cid:25)(cid:2)(cid:53)(cid:53)(cid:37)(cid:16)(cid:34)(cid:33,Unknown,16226.0
Unknown,Unknown,1,Unknown,Unknown,Unknown,Unknown,cid:12)(cid:29)(cid:26)(cid:41)(cid:25)(cid:2)(cid:53)(cid:53)(cid:37)(cid:16)(cid:34)(cid:33,Unknown,16227.0
Unknown,Unknown,35,Unknown,Unknown,Unknown,Unknown,cid:12)(cid:29)(cid:26)(cid:41)(cid:25)(cid:2)(cid:53)(cid:53)(cid:37)(cid:16)(cid:34)(cid:33,Unknown,16262.0
Unknown,Unknown,45,Unknown,Unknown,Unknown,Unknown,cid:12)(cid:29)(cid:26)(cid:41)(cid:25)(cid:2)(cid:53)(cid:53)(cid:37)(cid:16)(cid:34)(cid:33,Unknown,16307.0
Unknown,Unknown,18,Unknown,Unknown,Unknown,Unknown,cid:12)(cid:29)(cid:26)(cid:41)(cid:25)(cid:2)(cid:53)(cid:53)(cid:37)(cid:16)(cid:34)(cid:33,Unknown,16325.0
Unknown,Unknown,34,Unknown,Unknown,Unknown,Unknown,cid:12)(cid:29)(cid:26)(cid:41)(cid:25)(cid:2)(cid:53)(cid:53)(cid:37)(cid:16)(cid:34)(cid:33,Unknown,16359.0
Unknown,Unknown,9,Unknown,Unknown,Unknown,Unknown,cid:12)(cid:29)(cid:26)(cid:41)(cid:25)(cid:2)(cid:53)(cid:53)(cid:37)(cid:16)(cid:34)(cid:33,Unknown,16368.0
Unknown,Unknown,49,Unknown,Unknown,Unknown,Unknown,cid:12)(cid:29)(cid:26)(cid:41)(cid:25)(cid:2)(cid:53)(cid:53)(cid:37)(cid:16)(cid:34)(cid:33,Unknown,16417.0
Unknown,Unknown,8,Unknown,Unknown,Unknown,Unknown,cid:12)(cid:29)(cid:26)(cid:41)(cid:25)(cid:2)(cid:53)(cid:53)(cid:37)(cid:16)(cid:34)(cid:33,Unknown,16425.0
Unknown,Unknown,5,Unknown,Unknown,Unknown,Unknown,cid:12)(cid:29)(cid:26)(cid:41)(cid:25)(cid:2)(cid:53)(cid:53)(cid:37)(cid:16)(cid:34)(cid:33,Unknown,16430.0
Unknown,Unknown,28,Unknown,Unknown,Unknown,Unknown,cid:12)(cid:29)(cid:26)(cid:41)(cid:25)(cid:2)(cid:53)(cid:53)(cid:37)(cid:16)(cid:34)(cid:33,Unknown,16458.0
Unknown,Unknown,2,Unknown,Unknown,Unknown,Unknown,cid:12)(cid:29)(cid:26)(cid:41)(cid:25)(cid:2)(cid:53)(cid:53)(cid:37)(cid:16)(cid:34)(cid:33,Unknown,16460.0
Unknown,Unknown,9,Unknown,Unknown,Unknown,Unknown,cid:12)(cid:29)(cid:26)(cid:41)(cid:25)(cid:2)(cid:53)(cid:53)(cid:37)(cid:16)(cid:34)(cid:33,Unknown,16469.0
Unknown,Unknown,5,Unknown,Unknown,Unknown,Unknown,cid:12)(cid:29)(cid:26)(cid:41)(cid:25)(cid:2)(cid:53)(cid:53)(cid:37)(cid:16)(cid:34)(cid:33,Unknown,16474.0
Unknown,Unknown,8,Unknown,Unknown,Unknown,Unknown,cid:12)(cid:29)(cid:26)(cid:41)(cid:25)(cid:2)(cid:53)(cid:53)(cid:37)(cid:16)(cid:34)(cid:33,Unknown,16482.0
Unknown,Unknown,14,Unknown,Unknown,Unknown,Unknown,cid:12)(cid:29)(cid:26)(cid:41)(cid:25)(cid:2)(cid:53)(cid:53)(cid:37)(cid:16)(cid:34)(cid:33,Unknown,16496.0
Unknown,Unknown,7,Unknown,Unknown,Unknown,Unknown,cid:12)(cid:29)(cid:26)(cid:41)(cid:25)(cid:2)(cid:53)(cid:53)(cid:37)(cid:16)(cid:34)(cid:33,Unknown,16503.0
Unknown,Unknown,9,Unknown,Unknown,Unknown,Unknown,cid:12)(cid:29)(cid:26)(cid:41)(cid:25)(cid:2)(cid:53)(cid:53)(cid:37)(cid:16)(cid:34)(cid:33,Unknown,16512.0
Unknown,Unknown,2,Unknown,Unknown,Unknown,Unknown,cid:12)(cid:29)(cid:26)(cid:41)(cid:25)(cid:2)(cid:53)(cid:53)(cid:37)(cid:16)(cid:34)(cid:33,Unknown,16514.0
Unknown,Unknown,28,Unknown,Unknown,Unknown,Unknown,cid:12)(cid:29)(cid:26)(cid:41)(cid:25)(cid:2)(cid:53)(cid:53)(cid:37)(cid:16)(cid:34)(cid:33,Unknown,16542.0
Unknown,Unknown,3,Unknown,Unknown,Unknown,Unknown,cid:12)(cid:29)(cid:26)(cid:41)(cid:25)(cid:2)(cid:53)(cid:53)(cid:37)(cid:16)(cid:34)(cid:33,Unknown,16545.0
Unknown,Unknown,15,Unknown,Unknown,Unknown,Unknown,cid:12)(cid:29)(cid:26)(cid:41)(cid:25)(cid:2)(cid:53)(cid:53)(cid:37)(cid:16)(cid:34)(cid:33,Unknown,16560.0
Unknown,Unknown,2,Unknown,Unknown,Unknown,Unknown,cid:12)(cid:29)(cid:26)(cid:41)(cid:25)(cid:2)(cid:53)(cid:53)(cid:37)(cid:16)(cid:34)(cid:33,Unknown,16562.0
Unknown,Unknown,37,Unknown,Unknown,Unknown,Unknown,cid:12)(cid:29)(cid:26)(cid:41)(cid:25)(cid:2)(cid:53)(cid:53)(cid:37)(cid:16)(cid:34)(cid:33,Unknown,16599.0
Unknown,Unknown,19,Unknown,Unknown,Unknown,Unknown,cid:12)(cid:29)(cid:26)(cid:41)(cid:25)(cid:2)(cid:53)(cid:53)(cid:37)(cid:16)(cid:34)(cid:33,Unknown,16618.0
Unknown,Unknown,34,Unknown,Unknown,Unknown,Unknown,cid:12)(cid:29)(cid:26)(cid:41)(cid:25)(cid:2)(cid:53)(cid:53)(cid:37)(cid:16)(cid:34)(cid:33,Unknown,16652.0
Unknown,Unknown,18,Unknown,Unknown,Unknown,Unknown,cid:12)(cid:29)(cid:26)(cid:41)(cid:25)(cid:2)(cid:53)(cid:53)(cid:37)(cid:16)(cid:34)(cid:33,Unknown,16670.0
Unknown,Unknown,2,Unknown,Unknown,Unknown,Unknown,cid:12)(cid:29)(cid:26)(cid:41)(cid:25)(cid:2)(cid:53)(cid:53)(cid:37)(cid:16)(cid:34)(cid:33,Unknown,16672.0
Unknown,Unknown,44,Unknown,Unknown,Unknown,Unknown,cid:12)(cid:29)(cid:26)(cid:41)(cid:25)(cid:2)(cid:53)(cid:53)(cid:37)(cid:16)(cid:34)(cid:33,Unknown,16716.0
Unknown,Unknown,12,Unknown,Unknown,Unknown,Unknown,cid:12)(cid:29)(cid:26)(cid:41)(cid:25)(cid:2)(cid:53)(cid:53)(cid:37)(cid:16)(cid:34)(cid:33,Unknown,16728.0
Unknown,Unknown,29,Unknown,Unknown,Unknown,Unknown,cid:12)(cid:29)(cid:26)(cid:41)(cid:25)(cid:2)(cid:53)(cid:53)(cid:37)(cid:16)(cid:34)(cid:33,Unknown,16757.0
Unknown,Unknown,26,Unknown,Unknown,Unknown,Unknown,cid:12)(cid:29)(cid:26)(cid:41)(cid:25)(cid:2)(cid:53)(cid:53)(cid:37)(cid:16)(cid:34)(cid:33,Unknown,16783.0
Unknown,Unknown,41,Unknown,Unknown,Unknown,Unknown,cid:12)(cid:29)(cid:26)(cid:41)(cid:25)(cid:2)(cid:53)(cid:53)(cid:37)(cid:16)(cid:34)(cid:33,Unknown,16824.0
Unknown,Unknown,25,Unknown,Unknown,Unknown,Unknown,cid:12)(cid:29)(cid:26)(cid:41)(cid:25)(cid:2)(cid:53)(cid:53)(cid:37)(cid:16)(cid:34)(cid:33,Unknown,16849.0
Unknown,Unknown,2,Unknown,Unknown,Unknown,Unknown,cid:12)(cid:29)(cid:26)(cid:41)(cid:25)(cid:2)(cid:53)(cid:53)(cid:37)(cid:16)(cid:34)(cid:33,Unknown,16851.0
Unknown,Unknown,53,Unknown,Unknown,Unknown,Unknown,cid:12)(cid:29)(cid:26)(cid:41)(cid:25)(cid:2)(cid:53)(cid:53)(cid:37)(cid:16)(cid:34)(cid:33,Unknown,16904.0
Unknown,Unknown,53,Unknown,Unknown,Unknown,Unknown,cid:12)(cid:29)(cid:26)(cid:41)(cid:25)(cid:2)(cid:53)(cid:53)(cid:37)(cid:16)(cid:34)(cid:33,Unknown,16957.0
Unknown,Unknown,18,Unknown,Unknown,Unknown,Unknown,cid:12)(cid:29)(cid:26)(cid:41)(cid:25)(cid:2)(cid:53)(cid:53)(cid:37)(cid:16)(cid:34)(cid:33,Unknown,16975.0
Unknown,Unknown,1,Unknown,Unknown,Unknown,Unknown,cid:12)(cid:29)(cid:26)(cid:41)(cid:25)(cid:2)(cid:53)(cid:53)(cid:37)(cid:16)(cid:34)(cid:33,Unknown,16976.0
Unknown,Unknown,1,Unknown,Unknown,Unknown,Unknown,cid:12)(cid:29)(cid:26)(cid:41)(cid:25)(cid:2)(cid:53)(cid:53)(cid:37)(cid:16)(cid:34)(cid:33,Unknown,16977.0
Unknown,Unknown,37,Unknown,Unknown,Unknown,Unknown,cid:12)(cid:29)(cid:26)(cid:41)(cid:25)(cid:2)(cid:53)(cid:53)(cid:37)(cid:16)(cid:34)(cid:33,Unknown,17014.0
Unknown,Unknown,1,Unknown,Unknown,Unknown,Unknown,cid:12)(cid:29)(cid:26)(cid:41)(cid:25)(cid:2)(cid:53)(cid:53)(cid:37)(cid:16)(cid:34)(cid:33,Unknown,17015.0
Unknown,Unknown,35,Unknown,Unknown,Unknown,Unknown,cid:12)(cid:29)(cid:26)(cid:41)(cid:25)(cid:2)(cid:53)(cid:53)(cid:37)(cid:16)(cid:34)(cid:33,Unknown,17050.0
Unknown,Unknown,45,Unknown,Unknown,Unknown,Unknown,cid:12)(cid:29)(cid:26)(cid:41)(cid:25)(cid:2)(cid:53)(cid:53)(cid:37)(cid:16)(cid:34)(cid:33,Unknown,17095.0
Unknown,Unknown,18,Unknown,Unknown,Unknown,Unknown,cid:12)(cid:29)(cid:26)(cid:41)(cid:25)(cid:2)(cid:53)(cid:53)(cid:37)(cid:16)(cid:34)(cid:33,Unknown,17113.0
Unknown,Unknown,34,Unknown,Unknown,Unknown,Unknown,cid:12)(cid:29)(cid:26)(cid:41)(cid:25)(cid:2)(cid:53)(cid:53)(cid:37)(cid:16)(cid:34)(cid:33,Unknown,17147.0
Unknown,Unknown,14,Unknown,Unknown,Unknown,Unknown,cid:12)(cid:29)(cid:26)(cid:41)(cid:25)(cid:2)(cid:53)(cid:53)(cid:37)(cid:16)(cid:34)(cid:33,Unknown,17161.0
Unknown,Unknown,5,Unknown,Unknown,Unknown,Unknown,cid:12)(cid:29)(cid:26)(cid:41)(cid:25)(cid:2)(cid:53)(cid:53)(cid:37)(cid:16)(cid:34)(cid:33,Unknown,17166.0
Unknown,Unknown,12,Unknown,Unknown,Unknown,Unknown,cid:12)(cid:29)(cid:26)(cid:41)(cid:25)(cid:2)(cid:53)(cid:53)(cid:37)(cid:16)(cid:34)(cid:33,Unknown,17178.0
Unknown,Unknown,14,Unknown,Unknown,Unknown,Unknown,cid:12)(cid:29)(cid:26)(cid:41)(cid:25)(cid:2)(cid:53)(cid:53)(cid:37)(cid:16)(cid:34)(cid:33,Unknown,17192.0
Unknown,Unknown,5,Unknown,Unknown,Unknown,Unknown,cid:12)(cid:29)(cid:26)(cid:41)(cid:25)(cid:2)(cid:53)(cid:53)(cid:37)(cid:16)(cid:34)(cid:33,Unknown,17197.0
Unknown,Unknown,3,Unknown,Unknown,Unknown,Unknown,cid:12)(cid:29)(cid:26)(cid:41)(cid:25)(cid:2)(cid:53)(cid:53)(cid:37)(cid:16)(cid:34)(cid:33,Unknown,17200.0
Unknown,Unknown,12,Unknown,Unknown,Unknown,Unknown,cid:12)(cid:29)(cid:26)(cid:41)(cid:25)(cid:2)(cid:53)(cid:53)(cid:37)(cid:16)(cid:34)(cid:33,Unknown,17212.0
Unknown,Unknown,2,Unknown,Unknown,Unknown,Unknown,cid:12)(cid:29)(cid:26)(cid:41)(cid:25)(cid:2)(cid:53)(cid:53)(cid:37)(cid:16)(cid:34)(cid:33,Unknown,17214.0
Unknown,Unknown,28,Unknown,Unknown,Unknown,Unknown,cid:12)(cid:29)(cid:26)(cid:41)(cid:25)(cid:2)(cid:53)(cid:53)(cid:37)(cid:16)(cid:34)(cid:33,Unknown,17242.0
Unknown,Unknown,5,Unknown,Unknown,Unknown,Unknown,cid:12)(cid:29)(cid:26)(cid:41)(cid:25)(cid:2)(cid:53)(cid:53)(cid:37)(cid:16)(cid:34)(cid:33,Unknown,17247.0
Unknown,Unknown,3,Unknown,Unknown,Unknown,Unknown,cid:12)(cid:29)(cid:26)(cid:41)(cid:25)(cid:2)(cid:53)(cid:53)(cid:37)(cid:16)(cid:34)(cid:33,Unknown,17250.0
Unknown,Unknown,10,Unknown,Unknown,Unknown,Unknown,cid:12)(cid:29)(cid:26)(cid:41)(cid:25)(cid:2)(cid:53)(cid:53)(cid:37)(cid:16)(cid:34)(cid:33,Unknown,17260.0
Unknown,Unknown,5,Unknown,Unknown,Unknown,Unknown,cid:12)(cid:29)(cid:26)(cid:41)(cid:25)(cid:2)(cid:53)(cid:53)(cid:37)(cid:16)(cid:34)(cid:33,Unknown,17265.0
Unknown,Unknown,2,Unknown,Unknown,Unknown,Unknown,cid:12)(cid:29)(cid:26)(cid:41)(cid:25)(cid:2)(cid:53)(cid:53)(cid:37)(cid:16)(cid:34)(cid:33,Unknown,17267.0
Unknown,Unknown,14,Unknown,Unknown,Unknown,Unknown,cid:12)(cid:29)(cid:26)(cid:41)(cid:25)(cid:2)(cid:53)(cid:53)(cid:37)(cid:16)(cid:34)(cid:33,Unknown,17281.0
Unknown,Unknown,49,Unknown,Unknown,Unknown,Unknown,cid:12)(cid:29)(cid:26)(cid:41)(cid:25)(cid:2)(cid:53)(cid:53)(cid:37)(cid:16)(cid:34)(cid:33,Unknown,17330.0
Unknown,Unknown,2,Unknown,Unknown,Unknown,Unknown,cid:12)(cid:29)(cid:26)(cid:41)(cid:25)(cid:2)(cid:53)(cid:53)(cid:37)(cid:16)(cid:34)(cid:33,Unknown,17332.0
Unknown,Unknown,28,Unknown,Unknown,Unknown,Unknown,cid:12)(cid:29)(cid:26)(cid:41)(cid:25)(cid:2)(cid:53)(cid:53)(cid:37)(cid:16)(cid:34)(cid:33,Unknown,17360.0
Unknown,Unknown,5,Unknown,Unknown,Unknown,Unknown,cid:12)(cid:29)(cid:26)(cid:41)(cid:25)(cid:2)(cid:53)(cid:53)(cid:37)(cid:16)(cid:34)(cid:33,Unknown,17365.0
Unknown,Unknown,3,Unknown,Unknown,Unknown,Unknown,cid:12)(cid:29)(cid:26)(cid:41)(cid:25)(cid:2)(cid:53)(cid:53)(cid:37)(cid:16)(cid:34)(cid:33,Unknown,17368.0
Unknown,Unknown,10,Unknown,Unknown,Unknown,Unknown,cid:12)(cid:29)(cid:26)(cid:41)(cid:25)(cid:2)(cid:53)(cid:53)(cid:37)(cid:16)(cid:34)(cid:33,Unknown,17378.0
Unknown,Unknown,5,Unknown,Unknown,Unknown,Unknown,cid:12)(cid:29)(cid:26)(cid:41)(cid:25)(cid:2)(cid:53)(cid:53)(cid:37)(cid:16)(cid:34)(cid:33,Unknown,17383.0
Unknown,Unknown,2,Unknown,Unknown,Unknown,Unknown,cid:12)(cid:29)(cid:26)(cid:41)(cid:25)(cid:2)(cid:53)(cid:53)(cid:37)(cid:16)(cid:34)(cid:33,Unknown,17385.0
Unknown,Unknown,9,Unknown,Unknown,Unknown,Unknown,cid:12)(cid:29)(cid:26)(cid:41)(cid:25)(cid:2)(cid:53)(cid:53)(cid:37)(cid:16)(cid:34)(cid:33,Unknown,17394.0
Unknown,Unknown,2,Unknown,Unknown,Unknown,Unknown,cid:12)(cid:29)(cid:26)(cid:41)(cid:25)(cid:2)(cid:53)(cid:53)(cid:37)(cid:16)(cid:34)(cid:33,Unknown,17396.0
Unknown,Unknown,28,Unknown,Unknown,Unknown,Unknown,cid:12)(cid:29)(cid:26)(cid:41)(cid:25)(cid:2)(cid:53)(cid:53)(cid:37)(cid:16)(cid:34)(cid:33,Unknown,17424.0
Unknown,Unknown,3,Unknown,Unknown,Unknown,Unknown,cid:12)(cid:29)(cid:26)(cid:41)(cid:25)(cid:2)(cid:53)(cid:53)(cid:37)(cid:16)(cid:34)(cid:33,Unknown,17427.0
Unknown,Unknown,15,Unknown,Unknown,Unknown,Unknown,cid:12)(cid:29)(cid:26)(cid:41)(cid:25)(cid:2)(cid:53)(cid:53)(cid:37)(cid:16)(cid:34)(cid:33,Unknown,17442.0
Unknown,Unknown,2,Unknown,Unknown,Unknown,Unknown,cid:12)(cid:29)(cid:26)(cid:41)(cid:25)(cid:2)(cid:53)(cid:53)(cid:37)(cid:16)(cid:34)(cid:33,Unknown,17444.0
Unknown,Unknown,37,Unknown,Unknown,Unknown,Unknown,cid:12)(cid:29)(cid:26)(cid:41)(cid:25)(cid:2)(cid:53)(cid:53)(cid:37)(cid:16)(cid:34)(cid:33,Unknown,17481.0
Unknown,Unknown,18,Unknown,Unknown,Unknown,Unknown,cid:12)(cid:29)(cid:26)(cid:41)(cid:25)(cid:2)(cid:53)(cid:53)(cid:37)(cid:16)(cid:34)(cid:33,Unknown,17499.0
Unknown,Unknown,19,Unknown,Unknown,Unknown,Unknown,cid:12)(cid:29)(cid:26)(cid:41)(cid:25)(cid:2)(cid:53)(cid:53)(cid:37)(cid:16)(cid:34)(cid:33,Unknown,17518.0
Unknown,Unknown,16,Unknown,Unknown,Unknown,Unknown,cid:12)(cid:29)(cid:26)(cid:41)(cid:25)(cid:2)(cid:53)(cid:53)(cid:37)(cid:16)(cid:34)(cid:33,Unknown,17534.0
Unknown,Unknown,1,Unknown,Unknown,Unknown,Unknown,cid:12)(cid:29)(cid:26)(cid:41)(cid:25)(cid:2)(cid:53)(cid:53)(cid:37)(cid:16)(cid:34)(cid:33,Unknown,17535.0
Unknown,Unknown,2,Unknown,Unknown,Unknown,Unknown,cid:12)(cid:29)(cid:26)(cid:41)(cid:25)(cid:2)(cid:53)(cid:53)(cid:37)(cid:16)(cid:34)(cid:33,Unknown,17537.0
Unknown,Unknown,44,Unknown,Unknown,Unknown,Unknown,cid:12)(cid:29)(cid:26)(cid:41)(cid:25)(cid:2)(cid:53)(cid:53)(cid:37)(cid:16)(cid:34)(cid:33,Unknown,17581.0
Unknown,Unknown,12,Unknown,Unknown,Unknown,Unknown,cid:12)(cid:29)(cid:26)(cid:41)(cid:25)(cid:2)(cid:53)(cid:53)(cid:37)(cid:16)(cid:34)(cid:33,Unknown,17593.0
Unknown,Unknown,29,Unknown,Unknown,Unknown,Unknown,cid:12)(cid:29)(cid:26)(cid:41)(cid:25)(cid:2)(cid:53)(cid:53)(cid:37)(cid:16)(cid:34)(cid:33,Unknown,17622.0
Unknown,Unknown,26,Unknown,Unknown,Unknown,Unknown,cid:12)(cid:29)(cid:26)(cid:41)(cid:25)(cid:2)(cid:53)(cid:53)(cid:37)(cid:16)(cid:34)(cid:33,Unknown,17648.0
Unknown,Unknown,41,Unknown,Unknown,Unknown,Unknown,cid:12)(cid:29)(cid:26)(cid:41)(cid:25)(cid:2)(cid:53)(cid:53)(cid:37)(cid:16)(cid:34)(cid:33,Unknown,17689.0
Unknown,Unknown,25,Unknown,Unknown,Unknown,Unknown,cid:12)(cid:29)(cid:26)(cid:41)(cid:25)(cid:2)(cid:53)(cid:53)(cid:37)(cid:16)(cid:34)(cid:33,Unknown,17714.0
Unknown,Unknown,2,Unknown,Unknown,Unknown,Unknown,cid:12)(cid:29)(cid:26)(cid:41)(cid:25)(cid:2)(cid:53)(cid:53)(cid:37)(cid:16)(cid:34)(cid:33,Unknown,17716.0
Unknown,Unknown,53,Unknown,Unknown,Unknown,Unknown,cid:12)(cid:29)(cid:26)(cid:41)(cid:25)(cid:2)(cid:53)(cid:53)(cid:37)(cid:16)(cid:34)(cid:33,Unknown,17769.0
Unknown,Unknown,53,Unknown,Unknown,Unknown,Unknown,cid:12)(cid:29)(cid:26)(cid:41)(cid:25)(cid:2)(cid:53)(cid:53)(cid:37)(cid:16)(cid:34)(cid:33,Unknown,17822.0
Unknown,Unknown,18,Unknown,Unknown,Unknown,Unknown,cid:12)(cid:29)(cid:26)(cid:41)(cid:25)(cid:2)(cid:53)(cid:53)(cid:37)(cid:16)(cid:34)(cid:33,Unknown,17840.0
Unknown,Unknown,1,Unknown,Unknown,Unknown,Unknown,cid:12)(cid:29)(cid:26)(cid:41)(cid:25)(cid:2)(cid:53)(cid:53)(cid:37)(cid:16)(cid:34)(cid:33,Unknown,17841.0
Unknown,Unknown,1,Unknown,Unknown,Unknown,Unknown,cid:12)(cid:29)(cid:26)(cid:41)(cid:25)(cid:2)(cid:53)(cid:53)(cid:37)(cid:16)(cid:34)(cid:33,Unknown,17842.0
Unknown,Unknown,37,Unknown,Unknown,Unknown,Unknown,cid:12)(cid:29)(cid:26)(cid:41)(cid:25)(cid:2)(cid:53)(cid:53)(cid:37)(cid:16)(cid:34)(cid:33,Unknown,17879.0
Unknown,Unknown,1,Unknown,Unknown,Unknown,Unknown,cid:12)(cid:29)(cid:26)(cid:41)(cid:25)(cid:2)(cid:53)(cid:53)(cid:37)(cid:16)(cid:34)(cid:33,Unknown,17880.0
Unknown,Unknown,35,Unknown,Unknown,Unknown,Unknown,cid:12)(cid:29)(cid:26)(cid:41)(cid:25)(cid:2)(cid:53)(cid:53)(cid:37)(cid:16)(cid:34)(cid:33,Unknown,17915.0
Unknown,Unknown,45,Unknown,Unknown,Unknown,Unknown,cid:12)(cid:29)(cid:26)(cid:41)(cid:25)(cid:2)(cid:53)(cid:53)(cid:37)(cid:16)(cid:34)(cid:33,Unknown,17960.0
Unknown,Unknown,18,Unknown,Unknown,Unknown,Unknown,cid:12)(cid:29)(cid:26)(cid:41)(cid:25)(cid:2)(cid:53)(cid:53)(cid:37)(cid:16)(cid:34)(cid:33,Unknown,17978.0
Unknown,Unknown,34,Unknown,Unknown,Unknown,Unknown,cid:12)(cid:29)(cid:26)(cid:41)(cid:25)(cid:2)(cid:53)(cid:53)(cid:37)(cid:16)(cid:34)(cid:33,Unknown,18012.0
Unknown,Unknown,9,Unknown,Unknown,Unknown,Unknown,cid:12)(cid:29)(cid:26)(cid:41)(cid:25)(cid:2)(cid:53)(cid:53)(cid:37)(cid:16)(cid:34)(cid:33,Unknown,18021.0
Unknown,Unknown,21,Unknown,Unknown,Unknown,Unknown,cid:12)(cid:29)(cid:26)(cid:41)(cid:25)(cid:2)(cid:53)(cid:53)(cid:37)(cid:16)(cid:34)(cid:33,Unknown,18042.0
Unknown,Unknown,23,Unknown,Unknown,Unknown,Unknown,cid:12)(cid:29)(cid:26)(cid:41)(cid:25)(cid:2)(cid:53)(cid:53)(cid:37)(cid:16)(cid:34)(cid:33,Unknown,18065.0
Unknown,Unknown,4,Unknown,Unknown,Unknown,Unknown,cid:12)(cid:29)(cid:26)(cid:41)(cid:25)(cid:2)(cid:53)(cid:53)(cid:37)(cid:16)(cid:34)(cid:33,Unknown,18069.0
Unknown,Unknown,55,Unknown,Unknown,Unknown,Unknown,cid:12)(cid:29)(cid:26)(cid:41)(cid:25)(cid:2)(cid:53)(cid:53)(cid:37)(cid:16)(cid:34)(cid:33,Unknown,18124.0
Unknown,Unknown,2,Unknown,Unknown,Unknown,Unknown,cid:12)(cid:29)(cid:26)(cid:41)(cid:25)(cid:2)(cid:53)(cid:53)(cid:37)(cid:16)(cid:34)(cid:33,Unknown,18126.0
Unknown,Unknown,53,Unknown,Unknown,Unknown,Unknown,cid:12)(cid:29)(cid:26)(cid:41)(cid:25)(cid:2)(cid:53)(cid:53)(cid:37)(cid:16)(cid:34)(cid:33,Unknown,18179.0
Unknown,Unknown,62,Unknown,Unknown,Unknown,Unknown,cid:12)(cid:29)(cid:26)(cid:41)(cid:25)(cid:2)(cid:53)(cid:53)(cid:37)(cid:16)(cid:34)(cid:33,Unknown,18241.0
Unknown,Unknown,11,Unknown,Unknown,Unknown,Unknown,cid:12)(cid:29)(cid:26)(cid:41)(cid:25)(cid:2)(cid:53)(cid:53)(cid:37)(cid:16)(cid:34)(cid:33,Unknown,18252.0
Unknown,Unknown,10,Unknown,Unknown,Unknown,Unknown,cid:12)(cid:29)(cid:26)(cid:41)(cid:25)(cid:2)(cid:53)(cid:53)(cid:37)(cid:16)(cid:34)(cid:33,Unknown,18262.0
Unknown,Unknown,11,Unknown,Unknown,Unknown,Unknown,cid:12)(cid:29)(cid:26)(cid:41)(cid:25)(cid:2)(cid:53)(cid:53)(cid:37)(cid:16)(cid:34)(cid:33,Unknown,18273.0
Unknown,Unknown,47,Unknown,Unknown,Unknown,Unknown,cid:12)(cid:29)(cid:26)(cid:41)(cid:25)(cid:2)(cid:53)(cid:53)(cid:37)(cid:16)(cid:34)(cid:33,Unknown,18320.0
Unknown,Unknown,3,Unknown,Unknown,Unknown,Unknown,cid:12)(cid:29)(cid:26)(cid:41)(cid:25)(cid:2)(cid:53)(cid:53)(cid:37)(cid:16)(cid:34)(cid:33,Unknown,18323.0
Unknown,Unknown,7,Unknown,Unknown,Unknown,Unknown,cid:12)(cid:29)(cid:26)(cid:41)(cid:25)(cid:2)(cid:53)(cid:53)(cid:37)(cid:16)(cid:34)(cid:33,Unknown,18330.0
Unknown,Unknown,5,Unknown,Unknown,Unknown,Unknown,cid:12)(cid:29)(cid:26)(cid:41)(cid:25)(cid:2)(cid:53)(cid:53)(cid:37)(cid:16)(cid:34)(cid:33,Unknown,18335.0
Unknown,Unknown,2,Unknown,Unknown,Unknown,Unknown,cid:12)(cid:29)(cid:26)(cid:41)(cid:25)(cid:2)(cid:53)(cid:53)(cid:37)(cid:16)(cid:34)(cid:33,Unknown,18337.0
Unknown,Unknown,39,Unknown,Unknown,Unknown,Unknown,cid:12)(cid:29)(cid:26)(cid:41)(cid:25)(cid:2)(cid:53)(cid:53)(cid:37)(cid:16)(cid:34)(cid:33,Unknown,18376.0
Unknown,Unknown,3,Unknown,Unknown,Unknown,Unknown,cid:12)(cid:29)(cid:26)(cid:41)(cid:25)(cid:2)(cid:53)(cid:53)(cid:37)(cid:16)(cid:34)(cid:33,Unknown,18379.0
Unknown,Unknown,11,Unknown,Unknown,Unknown,Unknown,cid:12)(cid:29)(cid:26)(cid:41)(cid:25)(cid:2)(cid:53)(cid:53)(cid:37)(cid:16)(cid:34)(cid:33,Unknown,18390.0
Unknown,Unknown,63,Unknown,Unknown,Unknown,Unknown,cid:12)(cid:29)(cid:26)(cid:41)(cid:25)(cid:2)(cid:53)(cid:53)(cid:37)(cid:16)(cid:34)(cid:33,Unknown,18453.0
Unknown,Unknown,7,Unknown,Unknown,Unknown,Unknown,cid:12)(cid:29)(cid:26)(cid:41)(cid:25)(cid:2)(cid:53)(cid:53)(cid:37)(cid:16)(cid:34)(cid:33,Unknown,18460.0
Unknown,Unknown,2,Unknown,Unknown,Unknown,Unknown,cid:12)(cid:29)(cid:26)(cid:41)(cid:25)(cid:2)(cid:53)(cid:53)(cid:37)(cid:16)(cid:34)(cid:33,Unknown,18462.0
Unknown,Unknown,39,Unknown,Unknown,Unknown,Unknown,cid:12)(cid:29)(cid:26)(cid:41)(cid:25)(cid:2)(cid:53)(cid:53)(cid:37)(cid:16)(cid:34)(cid:33,Unknown,18501.0
Unknown,Unknown,11,Unknown,Unknown,Unknown,Unknown,cid:12)(cid:29)(cid:26)(cid:41)(cid:25)(cid:2)(cid:53)(cid:53)(cid:37)(cid:16)(cid:34)(cid:33,Unknown,18512.0
Unknown,Unknown,7,Unknown,Unknown,Unknown,Unknown,cid:12)(cid:29)(cid:26)(cid:41)(cid:25)(cid:2)(cid:53)(cid:53)(cid:37)(cid:16)(cid:34)(cid:33,Unknown,18519.0
Unknown,Unknown,46,Unknown,Unknown,Unknown,Unknown,cid:12)(cid:29)(cid:26)(cid:41)(cid:25)(cid:2)(cid:53)(cid:53)(cid:37)(cid:16)(cid:34)(cid:33,Unknown,18565.0
Unknown,Unknown,8,Unknown,Unknown,Unknown,Unknown,cid:12)(cid:29)(cid:26)(cid:41)(cid:25)(cid:2)(cid:53)(cid:53)(cid:37)(cid:16)(cid:34)(cid:33,Unknown,18573.0
Unknown,Unknown,65,Unknown,Unknown,Unknown,Unknown,cid:12)(cid:29)(cid:26)(cid:41)(cid:25)(cid:2)(cid:53)(cid:53)(cid:37)(cid:16)(cid:34)(cid:33,Unknown,18638.0
Unknown,Unknown,2,Unknown,Unknown,Unknown,Unknown,cid:12)(cid:29)(cid:26)(cid:41)(cid:25)(cid:2)(cid:53)(cid:53)(cid:37)(cid:16)(cid:34)(cid:33,Unknown,18640.0
Unknown,Unknown,28,Unknown,Unknown,Unknown,Unknown,cid:12)(cid:29)(cid:26)(cid:41)(cid:25)(cid:2)(cid:53)(cid:53)(cid:37)(cid:16)(cid:34)(cid:33,Unknown,18668.0
Unknown,Unknown,3,Unknown,Unknown,Unknown,Unknown,cid:12)(cid:29)(cid:26)(cid:41)(cid:25)(cid:2)(cid:53)(cid:53)(cid:37)(cid:16)(cid:34)(cid:33,Unknown,18671.0
Unknown,Unknown,15,Unknown,Unknown,Unknown,Unknown,cid:12)(cid:29)(cid:26)(cid:41)(cid:25)(cid:2)(cid:53)(cid:53)(cid:37)(cid:16)(cid:34)(cid:33,Unknown,18686.0
Unknown,Unknown,2,Unknown,Unknown,Unknown,Unknown,cid:12)(cid:29)(cid:26)(cid:41)(cid:25)(cid:2)(cid:53)(cid:53)(cid:37)(cid:16)(cid:34)(cid:33,Unknown,18688.0
Unknown,Unknown,37,Unknown,Unknown,Unknown,Unknown,cid:12)(cid:29)(cid:26)(cid:41)(cid:25)(cid:2)(cid:53)(cid:53)(cid:37)(cid:16)(cid:34)(cid:33,Unknown,18725.0
Unknown,Unknown,37,Unknown,Unknown,Unknown,Unknown,cid:12)(cid:29)(cid:26)(cid:41)(cid:25)(cid:2)(cid:53)(cid:53)(cid:37)(cid:16)(cid:34)(cid:33,Unknown,18762.0
Unknown,Unknown,19,Unknown,Unknown,Unknown,Unknown,cid:12)(cid:29)(cid:26)(cid:41)(cid:25)(cid:2)(cid:53)(cid:53)(cid:37)(cid:16)(cid:34)(cid:33,Unknown,18781.0
Unknown,Unknown,17,Unknown,Unknown,Unknown,Unknown,cid:12)(cid:29)(cid:26)(cid:41)(cid:25)(cid:2)(cid:53)(cid:53)(cid:37)(cid:16)(cid:34)(cid:33,Unknown,18798.0
Unknown,Unknown,37,Unknown,Unknown,Unknown,Unknown,cid:12)(cid:29)(cid:26)(cid:41)(cid:25)(cid:2)(cid:53)(cid:53)(cid:37)(cid:16)(cid:34)(cid:33,Unknown,18835.0
Unknown,Unknown,2,Unknown,Unknown,Unknown,Unknown,cid:12)(cid:29)(cid:26)(cid:41)(cid:25)(cid:2)(cid:53)(cid:53)(cid:37)(cid:16)(cid:34)(cid:33,Unknown,18837.0
Unknown,Unknown,44,Unknown,Unknown,Unknown,Unknown,cid:12)(cid:29)(cid:26)(cid:41)(cid:25)(cid:2)(cid:53)(cid:53)(cid:37)(cid:16)(cid:34)(cid:33,Unknown,18881.0
Unknown,Unknown,12,Unknown,Unknown,Unknown,Unknown,cid:12)(cid:29)(cid:26)(cid:41)(cid:25)(cid:2)(cid:53)(cid:53)(cid:37)(cid:16)(cid:34)(cid:33,Unknown,18893.0
Unknown,Unknown,29,Unknown,Unknown,Unknown,Unknown,cid:12)(cid:29)(cid:26)(cid:41)(cid:25)(cid:2)(cid:53)(cid:53)(cid:37)(cid:16)(cid:34)(cid:33,Unknown,18922.0
Unknown,Unknown,26,Unknown,Unknown,Unknown,Unknown,cid:12)(cid:29)(cid:26)(cid:41)(cid:25)(cid:2)(cid:53)(cid:53)(cid:37)(cid:16)(cid:34)(cid:33,Unknown,18948.0
Unknown,Unknown,41,Unknown,Unknown,Unknown,Unknown,cid:12)(cid:29)(cid:26)(cid:41)(cid:25)(cid:2)(cid:53)(cid:53)(cid:37)(cid:16)(cid:34)(cid:33,Unknown,18989.0
Unknown,Unknown,25,Unknown,Unknown,Unknown,Unknown,cid:12)(cid:29)(cid:26)(cid:41)(cid:25)(cid:2)(cid:53)(cid:53)(cid:37)(cid:16)(cid:34)(cid:33,Unknown,19014.0
Unknown,Unknown,2,Unknown,Unknown,Unknown,Unknown,cid:12)(cid:29)(cid:26)(cid:41)(cid:25)(cid:2)(cid:53)(cid:53)(cid:37)(cid:16)(cid:34)(cid:33,Unknown,19016.0
Unknown,Unknown,53,Unknown,Unknown,Unknown,Unknown,cid:12)(cid:29)(cid:26)(cid:41)(cid:25)(cid:2)(cid:53)(cid:53)(cid:37)(cid:16)(cid:34)(cid:33,Unknown,19069.0
Unknown,Unknown,53,Unknown,Unknown,Unknown,Unknown,cid:12)(cid:29)(cid:26)(cid:41)(cid:25)(cid:2)(cid:53)(cid:53)(cid:37)(cid:16)(cid:34)(cid:33,Unknown,19122.0
Unknown,Unknown,18,Unknown,Unknown,Unknown,Unknown,cid:12)(cid:29)(cid:26)(cid:41)(cid:25)(cid:2)(cid:53)(cid:53)(cid:37)(cid:16)(cid:34)(cid:33,Unknown,19140.0
Unknown,Unknown,1,Unknown,Unknown,Unknown,Unknown,cid:12)(cid:29)(cid:26)(cid:41)(cid:25)(cid:2)(cid:53)(cid:53)(cid:37)(cid:16)(cid:34)(cid:33,Unknown,19141.0
Unknown,Unknown,1,Unknown,Unknown,Unknown,Unknown,cid:12)(cid:29)(cid:26)(cid:41)(cid:25)(cid:2)(cid:53)(cid:53)(cid:37)(cid:16)(cid:34)(cid:33,Unknown,19142.0
Unknown,Unknown,37,Unknown,Unknown,Unknown,Unknown,cid:12)(cid:29)(cid:26)(cid:41)(cid:25)(cid:2)(cid:53)(cid:53)(cid:37)(cid:16)(cid:34)(cid:33,Unknown,19179.0
Unknown,Unknown,1,Unknown,Unknown,Unknown,Unknown,cid:12)(cid:29)(cid:26)(cid:41)(cid:25)(cid:2)(cid:53)(cid:53)(cid:37)(cid:16)(cid:34)(cid:33,Unknown,19180.0
Unknown,Unknown,33,Unknown,Unknown,Unknown,Unknown,cid:12)(cid:29)(cid:26)(cid:41)(cid:25)(cid:2)(cid:53)(cid:53)(cid:37)(cid:16)(cid:34)(cid:33,Unknown,19213.0
Unknown,Unknown,45,Unknown,Unknown,Unknown,Unknown,cid:12)(cid:29)(cid:26)(cid:41)(cid:25)(cid:2)(cid:53)(cid:53)(cid:37)(cid:16)(cid:34)(cid:33,Unknown,19258.0
Unknown,Unknown,18,Unknown,Unknown,Unknown,Unknown,cid:12)(cid:29)(cid:26)(cid:41)(cid:25)(cid:2)(cid:53)(cid:53)(cid:37)(cid:16)(cid:34)(cid:33,Unknown,19276.0
Unknown,Unknown,34,Unknown,Unknown,Unknown,Unknown,cid:12)(cid:29)(cid:26)(cid:41)(cid:25)(cid:2)(cid:53)(cid:53)(cid:37)(cid:16)(cid:34)(cid:33,Unknown,19310.0
Unknown,Unknown,12,Unknown,Unknown,Unknown,Unknown,cid:12)(cid:29)(cid:26)(cid:41)(cid:25)(cid:2)(cid:53)(cid:53)(cid:37)(cid:16)(cid:34)(cid:33,Unknown,19322.0
Unknown,Unknown,49,Unknown,Unknown,Unknown,Unknown,cid:12)(cid:29)(cid:26)(cid:41)(cid:25)(cid:2)(cid:53)(cid:53)(cid:37)(cid:16)(cid:34)(cid:33,Unknown,19371.0
Unknown,Unknown,28,Unknown,Unknown,Unknown,Unknown,cid:12)(cid:29)(cid:26)(cid:41)(cid:25)(cid:2)(cid:53)(cid:53)(cid:37)(cid:16)(cid:34)(cid:33,Unknown,19399.0
Unknown,Unknown,5,Unknown,Unknown,Unknown,Unknown,cid:12)(cid:29)(cid:26)(cid:41)(cid:25)(cid:2)(cid:53)(cid:53)(cid:37)(cid:16)(cid:34)(cid:33,Unknown,19404.0
Unknown,Unknown,2,Unknown,Unknown,Unknown,Unknown,cid:12)(cid:29)(cid:26)(cid:41)(cid:25)(cid:2)(cid:53)(cid:53)(cid:37)(cid:16)(cid:34)(cid:33,Unknown,19406.0
Unknown,Unknown,52,Unknown,Unknown,Unknown,Unknown,cid:12)(cid:29)(cid:26)(cid:41)(cid:25)(cid:2)(cid:53)(cid:53)(cid:37)(cid:16)(cid:34)(cid:33,Unknown,19458.0
Unknown,Unknown,5,Unknown,Unknown,Unknown,Unknown,cid:12)(cid:29)(cid:26)(cid:41)(cid:25)(cid:2)(cid:53)(cid:53)(cid:37)(cid:16)(cid:34)(cid:33,Unknown,19463.0
Unknown,Unknown,2,Unknown,Unknown,Unknown,Unknown,cid:12)(cid:29)(cid:26)(cid:41)(cid:25)(cid:2)(cid:53)(cid:53)(cid:37)(cid:16)(cid:34)(cid:33,Unknown,19465.0
Unknown,Unknown,14,Unknown,Unknown,Unknown,Unknown,cid:12)(cid:29)(cid:26)(cid:41)(cid:25)(cid:2)(cid:53)(cid:53)(cid:37)(cid:16)(cid:34)(cid:33,Unknown,19479.0
Unknown,Unknown,68,Unknown,Unknown,Unknown,Unknown,cid:12)(cid:29)(cid:26)(cid:41)(cid:25)(cid:2)(cid:53)(cid:53)(cid:37)(cid:16)(cid:34)(cid:33,Unknown,19547.0
Unknown,Unknown,5,Unknown,Unknown,Unknown,Unknown,cid:12)(cid:29)(cid:26)(cid:41)(cid:25)(cid:2)(cid:53)(cid:53)(cid:37)(cid:16)(cid:34)(cid:33,Unknown,19552.0
Unknown,Unknown,12,Unknown,Unknown,Unknown,Unknown,cid:12)(cid:29)(cid:26)(cid:41)(cid:25)(cid:2)(cid:53)(cid:53)(cid:37)(cid:16)(cid:34)(cid:33,Unknown,19564.0
Unknown,Unknown,4,Unknown,Unknown,Unknown,Unknown,cid:12)(cid:29)(cid:26)(cid:41)(cid:25)(cid:2)(cid:53)(cid:53)(cid:37)(cid:16)(cid:34)(cid:33,Unknown,19568.0
Unknown,Unknown,2,Unknown,Unknown,Unknown,Unknown,cid:12)(cid:29)(cid:26)(cid:41)(cid:25)(cid:2)(cid:53)(cid:53)(cid:37)(cid:16)(cid:34)(cid:33,Unknown,19570.0
Unknown,Unknown,14,Unknown,Unknown,Unknown,Unknown,cid:12)(cid:29)(cid:26)(cid:41)(cid:25)(cid:2)(cid:53)(cid:53)(cid:37)(cid:16)(cid:34)(cid:33,Unknown,19584.0
Unknown,Unknown,49,Unknown,Unknown,Unknown,Unknown,cid:12)(cid:29)(cid:26)(cid:41)(cid:25)(cid:2)(cid:53)(cid:53)(cid:37)(cid:16)(cid:34)(cid:33,Unknown,19633.0
Unknown,Unknown,2,Unknown,Unknown,Unknown,Unknown,cid:12)(cid:29)(cid:26)(cid:41)(cid:25)(cid:2)(cid:53)(cid:53)(cid:37)(cid:16)(cid:34)(cid:33,Unknown,19635.0
Unknown,Unknown,28,Unknown,Unknown,Unknown,Unknown,cid:12)(cid:29)(cid:26)(cid:41)(cid:25)(cid:2)(cid:53)(cid:53)(cid:37)(cid:16)(cid:34)(cid:33,Unknown,19663.0
Unknown,Unknown,5,Unknown,Unknown,Unknown,Unknown,cid:12)(cid:29)(cid:26)(cid:41)(cid:25)(cid:2)(cid:53)(cid:53)(cid:37)(cid:16)(cid:34)(cid:33,Unknown,19668.0
Unknown,Unknown,3,Unknown,Unknown,Unknown,Unknown,cid:12)(cid:29)(cid:26)(cid:41)(cid:25)(cid:2)(cid:53)(cid:53)(cid:37)(cid:16)(cid:34)(cid:33,Unknown,19671.0
Unknown,Unknown,10,Unknown,Unknown,Unknown,Unknown,cid:12)(cid:29)(cid:26)(cid:41)(cid:25)(cid:2)(cid:53)(cid:53)(cid:37)(cid:16)(cid:34)(cid:33,Unknown,19681.0
Unknown,Unknown,5,Unknown,Unknown,Unknown,Unknown,cid:12)(cid:29)(cid:26)(cid:41)(cid:25)(cid:2)(cid:53)(cid:53)(cid:37)(cid:16)(cid:34)(cid:33,Unknown,19686.0
Unknown,Unknown,2,Unknown,Unknown,Unknown,Unknown,cid:12)(cid:29)(cid:26)(cid:41)(cid:25)(cid:2)(cid:53)(cid:53)(cid:37)(cid:16)(cid:34)(cid:33,Unknown,19688.0
Unknown,Unknown,46,Unknown,Unknown,Unknown,Unknown,cid:12)(cid:29)(cid:26)(cid:41)(cid:25)(cid:2)(cid:53)(cid:53)(cid:37)(cid:16)(cid:34)(cid:33,Unknown,19734.0
Unknown,Unknown,49,Unknown,Unknown,Unknown,Unknown,cid:12)(cid:29)(cid:26)(cid:41)(cid:25)(cid:2)(cid:53)(cid:53)(cid:37)(cid:16)(cid:34)(cid:33,Unknown,19783.0
Unknown,Unknown,4,Unknown,Unknown,Unknown,Unknown,cid:12)(cid:29)(cid:26)(cid:41)(cid:25)(cid:2)(cid:53)(cid:53)(cid:37)(cid:16)(cid:34)(cid:33,Unknown,19787.0
Unknown,Unknown,12,Unknown,Unknown,Unknown,Unknown,cid:12)(cid:29)(cid:26)(cid:41)(cid:25)(cid:2)(cid:53)(cid:53)(cid:37)(cid:16)(cid:34)(cid:33,Unknown,19799.0
Unknown,Unknown,2,Unknown,Unknown,Unknown,Unknown,cid:12)(cid:29)(cid:26)(cid:41)(cid:25)(cid:2)(cid:53)(cid:53)(cid:37)(cid:16)(cid:34)(cid:33,Unknown,19801.0
Unknown,Unknown,28,Unknown,Unknown,Unknown,Unknown,cid:12)(cid:29)(cid:26)(cid:41)(cid:25)(cid:2)(cid:53)(cid:53)(cid:37)(cid:16)(cid:34)(cid:33,Unknown,19829.0
Unknown,Unknown,3,Unknown,Unknown,Unknown,Unknown,cid:12)(cid:29)(cid:26)(cid:41)(cid:25)(cid:2)(cid:53)(cid:53)(cid:37)(cid:16)(cid:34)(cid:33,Unknown,19832.0
Unknown,Unknown,15,Unknown,Unknown,Unknown,Unknown,cid:12)(cid:29)(cid:26)(cid:41)(cid:25)(cid:2)(cid:53)(cid:53)(cid:37)(cid:16)(cid:34)(cid:33,Unknown,19847.0
Unknown,Unknown,2,Unknown,Unknown,Unknown,Unknown,cid:12)(cid:29)(cid:26)(cid:41)(cid:25)(cid:2)(cid:53)(cid:53)(cid:37)(cid:16)(cid:34)(cid:33,Unknown,19849.0
Unknown,Unknown,1,Unknown,Unknown,Unknown,Unknown,cid:12)(cid:29)(cid:26)(cid:41)(cid:25)(cid:2)(cid:53)(cid:53)(cid:37)(cid:16)(cid:34)(cid:33,Unknown,19850.0
Unknown,Unknown,34,Unknown,Unknown,Unknown,Unknown,cid:12)(cid:29)(cid:26)(cid:41)(cid:25)(cid:2)(cid:53)(cid:53)(cid:37)(cid:16)(cid:34)(cid:33,Unknown,19884.0
Unknown,Unknown,19,Unknown,Unknown,Unknown,Unknown,cid:12)(cid:29)(cid:26)(cid:41)(cid:25)(cid:2)(cid:53)(cid:53)(cid:37)(cid:16)(cid:34)(cid:33,Unknown,19903.0
Unknown,Unknown,34,Unknown,Unknown,Unknown,Unknown,cid:12)(cid:29)(cid:26)(cid:41)(cid:25)(cid:2)(cid:53)(cid:53)(cid:37)(cid:16)(cid:34)(cid:33,Unknown,19937.0
Unknown,Unknown,18,Unknown,Unknown,Unknown,Unknown,cid:12)(cid:29)(cid:26)(cid:41)(cid:25)(cid:2)(cid:53)(cid:53)(cid:37)(cid:16)(cid:34)(cid:33,Unknown,19955.0
Unknown,Unknown,2,Unknown,Unknown,Unknown,Unknown,cid:12)(cid:29)(cid:26)(cid:41)(cid:25)(cid:2)(cid:53)(cid:53)(cid:37)(cid:16)(cid:34)(cid:33,Unknown,19957.0
Unknown,Unknown,44,Unknown,Unknown,Unknown,Unknown,cid:12)(cid:29)(cid:26)(cid:41)(cid:25)(cid:2)(cid:53)(cid:53)(cid:37)(cid:16)(cid:34)(cid:33,Unknown,20001.0
Unknown,Unknown,12,Unknown,Unknown,Unknown,Unknown,cid:12)(cid:29)(cid:26)(cid:41)(cid:25)(cid:2)(cid:53)(cid:53)(cid:37)(cid:16)(cid:34)(cid:33,Unknown,20013.0
Unknown,Unknown,29,Unknown,Unknown,Unknown,Unknown,cid:12)(cid:29)(cid:26)(cid:41)(cid:25)(cid:2)(cid:53)(cid:53)(cid:37)(cid:16)(cid:34)(cid:33,Unknown,20042.0
Unknown,Unknown,26,Unknown,Unknown,Unknown,Unknown,cid:12)(cid:29)(cid:26)(cid:41)(cid:25)(cid:2)(cid:53)(cid:53)(cid:37)(cid:16)(cid:34)(cid:33,Unknown,20068.0
Unknown,Unknown,41,Unknown,Unknown,Unknown,Unknown,cid:12)(cid:29)(cid:26)(cid:41)(cid:25)(cid:2)(cid:53)(cid:53)(cid:37)(cid:16)(cid:34)(cid:33,Unknown,20109.0
Unknown,Unknown,25,Unknown,Unknown,Unknown,Unknown,cid:12)(cid:29)(cid:26)(cid:41)(cid:25)(cid:2)(cid:53)(cid:53)(cid:37)(cid:16)(cid:34)(cid:33,Unknown,20134.0
Unknown,Unknown,2,Unknown,Unknown,Unknown,Unknown,cid:12)(cid:29)(cid:26)(cid:41)(cid:25)(cid:2)(cid:53)(cid:53)(cid:37)(cid:16)(cid:34)(cid:33,Unknown,20136.0
Unknown,Unknown,53,Unknown,Unknown,Unknown,Unknown,cid:12)(cid:29)(cid:26)(cid:41)(cid:25)(cid:2)(cid:53)(cid:53)(cid:37)(cid:16)(cid:34)(cid:33,Unknown,20189.0
Unknown,Unknown,53,Unknown,Unknown,Unknown,Unknown,cid:12)(cid:29)(cid:26)(cid:41)(cid:25)(cid:2)(cid:53)(cid:53)(cid:37)(cid:16)(cid:34)(cid:33,Unknown,20242.0
Unknown,Unknown,18,Unknown,Unknown,Unknown,Unknown,cid:12)(cid:29)(cid:26)(cid:41)(cid:25)(cid:2)(cid:53)(cid:53)(cid:37)(cid:16)(cid:34)(cid:33,Unknown,20260.0
Unknown,Unknown,1,Unknown,Unknown,Unknown,Unknown,cid:12)(cid:29)(cid:26)(cid:41)(cid:25)(cid:2)(cid:53)(cid:53)(cid:37)(cid:16)(cid:34)(cid:33,Unknown,20261.0
Unknown,Unknown,1,Unknown,Unknown,Unknown,Unknown,cid:12)(cid:29)(cid:26)(cid:41)(cid:25)(cid:2)(cid:53)(cid:53)(cid:37)(cid:16)(cid:34)(cid:33,Unknown,20262.0
Unknown,Unknown,37,Unknown,Unknown,Unknown,Unknown,cid:12)(cid:29)(cid:26)(cid:41)(cid:25)(cid:2)(cid:53)(cid:53)(cid:37)(cid:16)(cid:34)(cid:33,Unknown,20299.0
Unknown,Unknown,1,Unknown,Unknown,Unknown,Unknown,cid:12)(cid:29)(cid:26)(cid:41)(cid:25)(cid:2)(cid:53)(cid:53)(cid:37)(cid:16)(cid:34)(cid:33,Unknown,20300.0
Unknown,Unknown,33,Unknown,Unknown,Unknown,Unknown,cid:12)(cid:29)(cid:26)(cid:41)(cid:25)(cid:2)(cid:53)(cid:53)(cid:37)(cid:16)(cid:34)(cid:33,Unknown,20333.0
Unknown,Unknown,45,Unknown,Unknown,Unknown,Unknown,cid:12)(cid:29)(cid:26)(cid:41)(cid:25)(cid:2)(cid:53)(cid:53)(cid:37)(cid:16)(cid:34)(cid:33,Unknown,20378.0
Unknown,Unknown,18,Unknown,Unknown,Unknown,Unknown,cid:12)(cid:29)(cid:26)(cid:41)(cid:25)(cid:2)(cid:53)(cid:53)(cid:37)(cid:16)(cid:34)(cid:33,Unknown,20396.0
Unknown,Unknown,34,Unknown,Unknown,Unknown,Unknown,cid:12)(cid:29)(cid:26)(cid:41)(cid:25)(cid:2)(cid:53)(cid:53)(cid:37)(cid:16)(cid:34)(cid:33,Unknown,20430.0
Unknown,Unknown,11,Unknown,Unknown,Unknown,Unknown,cid:12)(cid:29)(cid:26)(cid:41)(cid:25)(cid:2)(cid:53)(cid:53)(cid:37)(cid:16)(cid:34)(cid:33,Unknown,20441.0
Unknown,Unknown,39,Unknown,Unknown,Unknown,Unknown,cid:12)(cid:29)(cid:26)(cid:41)(cid:25)(cid:2)(cid:53)(cid:53)(cid:37)(cid:16)(cid:34)(cid:33,Unknown,20480.0
Unknown,Unknown,13,Unknown,Unknown,Unknown,Unknown,cid:12)(cid:29)(cid:26)(cid:41)(cid:25)(cid:2)(cid:53)(cid:53)(cid:37)(cid:16)(cid:34)(cid:33,Unknown,20493.0
Unknown,Unknown,2,Unknown,Unknown,Unknown,Unknown,cid:12)(cid:29)(cid:26)(cid:41)(cid:25)(cid:2)(cid:53)(cid:53)(cid:37)(cid:16)(cid:34)(cid:33,Unknown,20495.0
Unknown,Unknown,12,Unknown,Unknown,Unknown,Unknown,cid:12)(cid:29)(cid:26)(cid:41)(cid:25)(cid:2)(cid:53)(cid:53)(cid:37)(cid:16)(cid:34)(cid:33,Unknown,20507.0
Unknown,Unknown,11,Unknown,Unknown,Unknown,Unknown,cid:12)(cid:29)(cid:26)(cid:41)(cid:25)(cid:2)(cid:53)(cid:53)(cid:37)(cid:16)(cid:34)(cid:33,Unknown,20518.0
Unknown,Unknown,4,Unknown,Unknown,Unknown,Unknown,cid:12)(cid:29)(cid:26)(cid:41)(cid:25)(cid:2)(cid:53)(cid:53)(cid:37)(cid:16)(cid:34)(cid:33,Unknown,20522.0
Unknown,Unknown,14,Unknown,Unknown,Unknown,Unknown,cid:12)(cid:29)(cid:26)(cid:41)(cid:25)(cid:2)(cid:53)(cid:53)(cid:37)(cid:16)(cid:34)(cid:33,Unknown,20536.0
Unknown,Unknown,11,Unknown,Unknown,Unknown,Unknown,cid:12)(cid:29)(cid:26)(cid:41)(cid:25)(cid:2)(cid:53)(cid:53)(cid:37)(cid:16)(cid:34)(cid:33,Unknown,20547.0
Unknown,Unknown,62,Unknown,Unknown,Unknown,Unknown,cid:12)(cid:29)(cid:26)(cid:41)(cid:25)(cid:2)(cid:53)(cid:53)(cid:37)(cid:16)(cid:34)(cid:33,Unknown,20609.0
Unknown,Unknown,62,Unknown,Unknown,Unknown,Unknown,cid:12)(cid:29)(cid:26)(cid:41)(cid:25)(cid:2)(cid:53)(cid:53)(cid:37)(cid:16)(cid:34)(cid:33,Unknown,20671.0
Unknown,Unknown,7,Unknown,Unknown,Unknown,Unknown,cid:12)(cid:29)(cid:26)(cid:41)(cid:25)(cid:2)(cid:53)(cid:53)(cid:37)(cid:16)(cid:34)(cid:33,Unknown,20678.0
Unknown,Unknown,5,Unknown,Unknown,Unknown,Unknown,cid:12)(cid:29)(cid:26)(cid:41)(cid:25)(cid:2)(cid:53)(cid:53)(cid:37)(cid:16)(cid:34)(cid:33,Unknown,20683.0
Unknown,Unknown,3,Unknown,Unknown,Unknown,Unknown,cid:12)(cid:29)(cid:26)(cid:41)(cid:25)(cid:2)(cid:53)(cid:53)(cid:37)(cid:16)(cid:34)(cid:33,Unknown,20686.0
Unknown,Unknown,9,Unknown,Unknown,Unknown,Unknown,cid:12)(cid:29)(cid:26)(cid:41)(cid:25)(cid:2)(cid:53)(cid:53)(cid:37)(cid:16)(cid:34)(cid:33,Unknown,20695.0
Unknown,Unknown,2,Unknown,Unknown,Unknown,Unknown,cid:12)(cid:29)(cid:26)(cid:41)(cid:25)(cid:2)(cid:53)(cid:53)(cid:37)(cid:16)(cid:34)(cid:33,Unknown,20697.0
Unknown,Unknown,12,Unknown,Unknown,Unknown,Unknown,cid:12)(cid:29)(cid:26)(cid:41)(cid:25)(cid:2)(cid:53)(cid:53)(cid:37)(cid:16)(cid:34)(cid:33,Unknown,20709.0
Unknown,Unknown,11,Unknown,Unknown,Unknown,Unknown,cid:12)(cid:29)(cid:26)(cid:41)(cid:25)(cid:2)(cid:53)(cid:53)(cid:37)(cid:16)(cid:34)(cid:33,Unknown,20720.0
Unknown,Unknown,4,Unknown,Unknown,Unknown,Unknown,cid:12)(cid:29)(cid:26)(cid:41)(cid:25)(cid:2)(cid:53)(cid:53)(cid:37)(cid:16)(cid:34)(cid:33,Unknown,20724.0
Unknown,Unknown,14,Unknown,Unknown,Unknown,Unknown,cid:12)(cid:29)(cid:26)(cid:41)(cid:25)(cid:2)(cid:53)(cid:53)(cid:37)(cid:16)(cid:34)(cid:33,Unknown,20738.0
Unknown,Unknown,11,Unknown,Unknown,Unknown,Unknown,cid:12)(cid:29)(cid:26)(cid:41)(cid:25)(cid:2)(cid:53)(cid:53)(cid:37)(cid:16)(cid:34)(cid:33,Unknown,20749.0
Unknown,Unknown,62,Unknown,Unknown,Unknown,Unknown,cid:12)(cid:29)(cid:26)(cid:41)(cid:25)(cid:2)(cid:53)(cid:53)(cid:37)(cid:16)(cid:34)(cid:33,Unknown,20811.0
Unknown,Unknown,62,Unknown,Unknown,Unknown,Unknown,cid:12)(cid:29)(cid:26)(cid:41)(cid:25)(cid:2)(cid:53)(cid:53)(cid:37)(cid:16)(cid:34)(cid:33,Unknown,20873.0
Unknown,Unknown,7,Unknown,Unknown,Unknown,Unknown,cid:12)(cid:29)(cid:26)(cid:41)(cid:25)(cid:2)(cid:53)(cid:53)(cid:37)(cid:16)(cid:34)(cid:33,Unknown,20880.0
Unknown,Unknown,5,Unknown,Unknown,Unknown,Unknown,cid:12)(cid:29)(cid:26)(cid:41)(cid:25)(cid:2)(cid:53)(cid:53)(cid:37)(cid:16)(cid:34)(cid:33,Unknown,20885.0
Unknown,Unknown,3,Unknown,Unknown,Unknown,Unknown,cid:12)(cid:29)(cid:26)(cid:41)(cid:25)(cid:2)(cid:53)(cid:53)(cid:37)(cid:16)(cid:34)(cid:33,Unknown,20888.0
Unknown,Unknown,9,Unknown,Unknown,Unknown,Unknown,cid:12)(cid:29)(cid:26)(cid:41)(cid:25)(cid:2)(cid:53)(cid:53)(cid:37)(cid:16)(cid:34)(cid:33,Unknown,20897.0
Unknown,Unknown,2,Unknown,Unknown,Unknown,Unknown,cid:12)(cid:29)(cid:26)(cid:41)(cid:25)(cid:2)(cid:53)(cid:53)(cid:37)(cid:16)(cid:34)(cid:33,Unknown,20899.0
Unknown,Unknown,28,Unknown,Unknown,Unknown,Unknown,cid:12)(cid:29)(cid:26)(cid:41)(cid:25)(cid:2)(cid:53)(cid:53)(cid:37)(cid:16)(cid:34)(cid:33,Unknown,20927.0
Unknown,Unknown,3,Unknown,Unknown,Unknown,Unknown,cid:12)(cid:29)(cid:26)(cid:41)(cid:25)(cid:2)(cid:53)(cid:53)(cid:37)(cid:16)(cid:34)(cid:33,Unknown,20930.0
Unknown,Unknown,15,Unknown,Unknown,Unknown,Unknown,cid:12)(cid:29)(cid:26)(cid:41)(cid:25)(cid:2)(cid:53)(cid:53)(cid:37)(cid:16)(cid:34)(cid:33,Unknown,20945.0
Unknown,Unknown,2,Unknown,Unknown,Unknown,Unknown,cid:12)(cid:29)(cid:26)(cid:41)(cid:25)(cid:2)(cid:53)(cid:53)(cid:37)(cid:16)(cid:34)(cid:33,Unknown,20947.0
Unknown,Unknown,36,Unknown,Unknown,Unknown,Unknown,cid:12)(cid:29)(cid:26)(cid:41)(cid:25)(cid:2)(cid:53)(cid:53)(cid:37)(cid:16)(cid:34)(cid:33,Unknown,20983.0
Unknown,Unknown,37,Unknown,Unknown,Unknown,Unknown,cid:12)(cid:29)(cid:26)(cid:41)(cid:25)(cid:2)(cid:53)(cid:53)(cid:37)(cid:16)(cid:34)(cid:33,Unknown,21020.0
Unknown,Unknown,19,Unknown,Unknown,Unknown,Unknown,cid:12)(cid:29)(cid:26)(cid:41)(cid:25)(cid:2)(cid:53)(cid:53)(cid:37)(cid:16)(cid:34)(cid:33,Unknown,21039.0
Unknown,Unknown,34,Unknown,Unknown,Unknown,Unknown,cid:12)(cid:29)(cid:26)(cid:41)(cid:25)(cid:2)(cid:53)(cid:53)(cid:37)(cid:16)(cid:34)(cid:33,Unknown,21073.0
Unknown,Unknown,35,Unknown,Unknown,Unknown,Unknown,cid:12)(cid:29)(cid:26)(cid:41)(cid:25)(cid:2)(cid:53)(cid:53)(cid:37)(cid:16)(cid:34)(cid:33,Unknown,21108.0
Unknown,Unknown,2,Unknown,Unknown,Unknown,Unknown,cid:12)(cid:29)(cid:26)(cid:41)(cid:25)(cid:2)(cid:53)(cid:53)(cid:37)(cid:16)(cid:34)(cid:33,Unknown,21110.0
Unknown,Unknown,44,Unknown,Unknown,Unknown,Unknown,cid:12)(cid:29)(cid:26)(cid:41)(cid:25)(cid:2)(cid:53)(cid:53)(cid:37)(cid:16)(cid:34)(cid:33,Unknown,21154.0
Unknown,Unknown,12,Unknown,Unknown,Unknown,Unknown,cid:12)(cid:29)(cid:26)(cid:41)(cid:25)(cid:2)(cid:53)(cid:53)(cid:37)(cid:16)(cid:34)(cid:33,Unknown,21166.0
Unknown,Unknown,29,Unknown,Unknown,Unknown,Unknown,cid:12)(cid:29)(cid:26)(cid:41)(cid:25)(cid:2)(cid:53)(cid:53)(cid:37)(cid:16)(cid:34)(cid:33,Unknown,21195.0
Unknown,Unknown,26,Unknown,Unknown,Unknown,Unknown,cid:12)(cid:29)(cid:26)(cid:41)(cid:25)(cid:2)(cid:53)(cid:53)(cid:37)(cid:16)(cid:34)(cid:33,Unknown,21221.0
Unknown,Unknown,41,Unknown,Unknown,Unknown,Unknown,cid:12)(cid:29)(cid:26)(cid:41)(cid:25)(cid:2)(cid:53)(cid:53)(cid:37)(cid:16)(cid:34)(cid:33,Unknown,21262.0
Unknown,Unknown,25,Unknown,Unknown,Unknown,Unknown,cid:12)(cid:29)(cid:26)(cid:41)(cid:25)(cid:2)(cid:53)(cid:53)(cid:37)(cid:16)(cid:34)(cid:33,Unknown,21287.0
Unknown,Unknown,2,Unknown,Unknown,Unknown,Unknown,cid:12)(cid:29)(cid:26)(cid:41)(cid:25)(cid:2)(cid:53)(cid:53)(cid:37)(cid:16)(cid:34)(cid:33,Unknown,21289.0
Unknown,Unknown,53,Unknown,Unknown,Unknown,Unknown,cid:12)(cid:29)(cid:26)(cid:41)(cid:25)(cid:2)(cid:53)(cid:53)(cid:37)(cid:16)(cid:34)(cid:33,Unknown,21342.0
Unknown,Unknown,53,Unknown,Unknown,Unknown,Unknown,cid:12)(cid:29)(cid:26)(cid:41)(cid:25)(cid:2)(cid:53)(cid:53)(cid:37)(cid:16)(cid:34)(cid:33,Unknown,21395.0
Unknown,Unknown,37,Unknown,Unknown,Unknown,Unknown,cid:12)(cid:29)(cid:26)(cid:41)(cid:25)(cid:2)(cid:53)(cid:53)(cid:37)(cid:16)(cid:34)(cid:33,Unknown,21432.0
Unknown,Unknown,16,Unknown,Unknown,Unknown,Unknown,cid:12)(cid:29)(cid:26)(cid:41)(cid:25)(cid:2)(cid:53)(cid:53)(cid:37)(cid:16)(cid:34)(cid:33,Unknown,21448.0
Unknown,Unknown,34,Unknown,Unknown,Unknown,Unknown,cid:12)(cid:29)(cid:26)(cid:41)(cid:25)(cid:2)(cid:53)(cid:53)(cid:37)(cid:16)(cid:34)(cid:33,Unknown,21482.0
Unknown,Unknown,33,Unknown,Unknown,Unknown,Unknown,cid:12)(cid:29)(cid:26)(cid:41)(cid:25)(cid:2)(cid:53)(cid:53)(cid:37)(cid:16)(cid:34)(cid:33,Unknown,21515.0
Unknown,Unknown,1,Unknown,Unknown,Unknown,Unknown,cid:12)(cid:29)(cid:26)(cid:41)(cid:25)(cid:2)(cid:53)(cid:53)(cid:37)(cid:16)(cid:34)(cid:33,Unknown,21516.0
Unknown,Unknown,33,Unknown,Unknown,Unknown,Unknown,cid:12)(cid:29)(cid:26)(cid:41)(cid:25)(cid:2)(cid:53)(cid:53)(cid:37)(cid:16)(cid:34)(cid:33,Unknown,21549.0
Unknown,Unknown,45,Unknown,Unknown,Unknown,Unknown,cid:12)(cid:29)(cid:26)(cid:41)(cid:25)(cid:2)(cid:53)(cid:53)(cid:37)(cid:16)(cid:34)(cid:33,Unknown,21594.0
Unknown,Unknown,18,Unknown,Unknown,Unknown,Unknown,cid:12)(cid:29)(cid:26)(cid:41)(cid:25)(cid:2)(cid:53)(cid:53)(cid:37)(cid:16)(cid:34)(cid:33,Unknown,21612.0
Unknown,Unknown,34,Unknown,Unknown,Unknown,Unknown,cid:12)(cid:29)(cid:26)(cid:41)(cid:25)(cid:2)(cid:53)(cid:53)(cid:37)(cid:16)(cid:34)(cid:33,Unknown,21646.0
Unknown,Unknown,11,Unknown,Unknown,Unknown,Unknown,cid:12)(cid:29)(cid:26)(cid:41)(cid:25)(cid:2)(cid:53)(cid:53)(cid:37)(cid:16)(cid:34)(cid:33,Unknown,21657.0
Unknown,Unknown,39,Unknown,Unknown,Unknown,Unknown,cid:12)(cid:29)(cid:26)(cid:41)(cid:25)(cid:2)(cid:53)(cid:53)(cid:37)(cid:16)(cid:34)(cid:33,Unknown,21696.0
Unknown,Unknown,13,Unknown,Unknown,Unknown,Unknown,cid:12)(cid:29)(cid:26)(cid:41)(cid:25)(cid:2)(cid:53)(cid:53)(cid:37)(cid:16)(cid:34)(cid:33,Unknown,21709.0
Unknown,Unknown,2,Unknown,Unknown,Unknown,Unknown,cid:12)(cid:29)(cid:26)(cid:41)(cid:25)(cid:2)(cid:53)(cid:53)(cid:37)(cid:16)(cid:34)(cid:33,Unknown,21711.0
Unknown,Unknown,12,Unknown,Unknown,Unknown,Unknown,cid:12)(cid:29)(cid:26)(cid:41)(cid:25)(cid:2)(cid:53)(cid:53)(cid:37)(cid:16)(cid:34)(cid:33,Unknown,21723.0
Unknown,Unknown,11,Unknown,Unknown,Unknown,Unknown,cid:12)(cid:29)(cid:26)(cid:41)(cid:25)(cid:2)(cid:53)(cid:53)(cid:37)(cid:16)(cid:34)(cid:33,Unknown,21734.0
Unknown,Unknown,4,Unknown,Unknown,Unknown,Unknown,cid:12)(cid:29)(cid:26)(cid:41)(cid:25)(cid:2)(cid:53)(cid:53)(cid:37)(cid:16)(cid:34)(cid:33,Unknown,21738.0
Unknown,Unknown,14,Unknown,Unknown,Unknown,Unknown,cid:12)(cid:29)(cid:26)(cid:41)(cid:25)(cid:2)(cid:53)(cid:53)(cid:37)(cid:16)(cid:34)(cid:33,Unknown,21752.0
Unknown,Unknown,11,Unknown,Unknown,Unknown,Unknown,cid:12)(cid:29)(cid:26)(cid:41)(cid:25)(cid:2)(cid:53)(cid:53)(cid:37)(cid:16)(cid:34)(cid:33,Unknown,21763.0
Unknown,Unknown,62,Unknown,Unknown,Unknown,Unknown,cid:12)(cid:29)(cid:26)(cid:41)(cid:25)(cid:2)(cid:53)(cid:53)(cid:37)(cid:16)(cid:34)(cid:33,Unknown,21825.0
Unknown,Unknown,62,Unknown,Unknown,Unknown,Unknown,cid:12)(cid:29)(cid:26)(cid:41)(cid:25)(cid:2)(cid:53)(cid:53)(cid:37)(cid:16)(cid:34)(cid:33,Unknown,21887.0
Unknown,Unknown,7,Unknown,Unknown,Unknown,Unknown,cid:12)(cid:29)(cid:26)(cid:41)(cid:25)(cid:2)(cid:53)(cid:53)(cid:37)(cid:16)(cid:34)(cid:33,Unknown,21894.0
Unknown,Unknown,5,Unknown,Unknown,Unknown,Unknown,cid:12)(cid:29)(cid:26)(cid:41)(cid:25)(cid:2)(cid:53)(cid:53)(cid:37)(cid:16)(cid:34)(cid:33,Unknown,21899.0
Unknown,Unknown,3,Unknown,Unknown,Unknown,Unknown,cid:12)(cid:29)(cid:26)(cid:41)(cid:25)(cid:2)(cid:53)(cid:53)(cid:37)(cid:16)(cid:34)(cid:33,Unknown,21902.0
Unknown,Unknown,9,Unknown,Unknown,Unknown,Unknown,cid:12)(cid:29)(cid:26)(cid:41)(cid:25)(cid:2)(cid:53)(cid:53)(cid:37)(cid:16)(cid:34)(cid:33,Unknown,21911.0
Unknown,Unknown,2,Unknown,Unknown,Unknown,Unknown,cid:12)(cid:29)(cid:26)(cid:41)(cid:25)(cid:2)(cid:53)(cid:53)(cid:37)(cid:16)(cid:34)(cid:33,Unknown,21913.0
Unknown,Unknown,12,Unknown,Unknown,Unknown,Unknown,cid:12)(cid:29)(cid:26)(cid:41)(cid:25)(cid:2)(cid:53)(cid:53)(cid:37)(cid:16)(cid:34)(cid:33,Unknown,21925.0
Unknown,Unknown,11,Unknown,Unknown,Unknown,Unknown,cid:12)(cid:29)(cid:26)(cid:41)(cid:25)(cid:2)(cid:53)(cid:53)(cid:37)(cid:16)(cid:34)(cid:33,Unknown,21936.0
Unknown,Unknown,4,Unknown,Unknown,Unknown,Unknown,cid:12)(cid:29)(cid:26)(cid:41)(cid:25)(cid:2)(cid:53)(cid:53)(cid:37)(cid:16)(cid:34)(cid:33,Unknown,21940.0
Unknown,Unknown,14,Unknown,Unknown,Unknown,Unknown,cid:12)(cid:29)(cid:26)(cid:41)(cid:25)(cid:2)(cid:53)(cid:53)(cid:37)(cid:16)(cid:34)(cid:33,Unknown,21954.0
Unknown,Unknown,11,Unknown,Unknown,Unknown,Unknown,cid:12)(cid:29)(cid:26)(cid:41)(cid:25)(cid:2)(cid:53)(cid:53)(cid:37)(cid:16)(cid:34)(cid:33,Unknown,21965.0
Unknown,Unknown,62,Unknown,Unknown,Unknown,Unknown,cid:12)(cid:29)(cid:26)(cid:41)(cid:25)(cid:2)(cid:53)(cid:53)(cid:37)(cid:16)(cid:34)(cid:33,Unknown,22027.0
Unknown,Unknown,62,Unknown,Unknown,Unknown,Unknown,cid:12)(cid:29)(cid:26)(cid:41)(cid:25)(cid:2)(cid:53)(cid:53)(cid:37)(cid:16)(cid:34)(cid:33,Unknown,22089.0
Unknown,Unknown,7,Unknown,Unknown,Unknown,Unknown,cid:12)(cid:29)(cid:26)(cid:41)(cid:25)(cid:2)(cid:53)(cid:53)(cid:37)(cid:16)(cid:34)(cid:33,Unknown,22096.0
Unknown,Unknown,5,Unknown,Unknown,Unknown,Unknown,cid:12)(cid:29)(cid:26)(cid:41)(cid:25)(cid:2)(cid:53)(cid:53)(cid:37)(cid:16)(cid:34)(cid:33,Unknown,22101.0
Unknown,Unknown,3,Unknown,Unknown,Unknown,Unknown,cid:12)(cid:29)(cid:26)(cid:41)(cid:25)(cid:2)(cid:53)(cid:53)(cid:37)(cid:16)(cid:34)(cid:33,Unknown,22104.0
Unknown,Unknown,9,Unknown,Unknown,Unknown,Unknown,cid:12)(cid:29)(cid:26)(cid:41)(cid:25)(cid:2)(cid:53)(cid:53)(cid:37)(cid:16)(cid:34)(cid:33,Unknown,22113.0
Unknown,Unknown,2,Unknown,Unknown,Unknown,Unknown,cid:12)(cid:29)(cid:26)(cid:41)(cid:25)(cid:2)(cid:53)(cid:53)(cid:37)(cid:16)(cid:34)(cid:33,Unknown,22115.0
Unknown,Unknown,28,Unknown,Unknown,Unknown,Unknown,cid:12)(cid:29)(cid:26)(cid:41)(cid:25)(cid:2)(cid:53)(cid:53)(cid:37)(cid:16)(cid:34)(cid:33,Unknown,22143.0
Unknown,Unknown,3,Unknown,Unknown,Unknown,Unknown,cid:12)(cid:29)(cid:26)(cid:41)(cid:25)(cid:2)(cid:53)(cid:53)(cid:37)(cid:16)(cid:34)(cid:33,Unknown,22146.0
Unknown,Unknown,15,Unknown,Unknown,Unknown,Unknown,cid:12)(cid:29)(cid:26)(cid:41)(cid:25)(cid:2)(cid:53)(cid:53)(cid:37)(cid:16)(cid:34)(cid:33,Unknown,22161.0
Unknown,Unknown,2,Unknown,Unknown,Unknown,Unknown,cid:12)(cid:29)(cid:26)(cid:41)(cid:25)(cid:2)(cid:53)(cid:53)(cid:37)(cid:16)(cid:34)(cid:33,Unknown,22163.0
Unknown,Unknown,1,Unknown,Unknown,Unknown,Unknown,cid:12)(cid:29)(cid:26)(cid:41)(cid:25)(cid:2)(cid:53)(cid:53)(cid:37)(cid:16)(cid:34)(cid:33,Unknown,22164.0
Unknown,Unknown,17,Unknown,Unknown,Unknown,Unknown,cid:12)(cid:29)(cid:26)(cid:41)(cid:25)(cid:2)(cid:53)(cid:53)(cid:37)(cid:16)(cid:34)(cid:33,Unknown,22181.0
Unknown,Unknown,34,Unknown,Unknown,Unknown,Unknown,cid:12)(cid:29)(cid:26)(cid:41)(cid:25)(cid:2)(cid:53)(cid:53)(cid:37)(cid:16)(cid:34)(cid:33,Unknown,22215.0
Unknown,Unknown,19,Unknown,Unknown,Unknown,Unknown,cid:12)(cid:29)(cid:26)(cid:41)(cid:25)(cid:2)(cid:53)(cid:53)(cid:37)(cid:16)(cid:34)(cid:33,Unknown,22234.0
Unknown,Unknown,32,Unknown,Unknown,Unknown,Unknown,cid:12)(cid:29)(cid:26)(cid:41)(cid:25)(cid:2)(cid:53)(cid:53)(cid:37)(cid:16)(cid:34)(cid:33,Unknown,22266.0
Unknown,Unknown,33,Unknown,Unknown,Unknown,Unknown,cid:12)(cid:29)(cid:26)(cid:41)(cid:25)(cid:2)(cid:53)(cid:53)(cid:37)(cid:16)(cid:34)(cid:33,Unknown,22299.0
Unknown,Unknown,2,Unknown,Unknown,Unknown,Unknown,cid:12)(cid:29)(cid:26)(cid:41)(cid:25)(cid:2)(cid:53)(cid:53)(cid:37)(cid:16)(cid:34)(cid:33,Unknown,22301.0
Unknown,Unknown,44,Unknown,Unknown,Unknown,Unknown,cid:12)(cid:29)(cid:26)(cid:41)(cid:25)(cid:2)(cid:53)(cid:53)(cid:37)(cid:16)(cid:34)(cid:33,Unknown,22345.0
Unknown,Unknown,12,Unknown,Unknown,Unknown,Unknown,cid:12)(cid:29)(cid:26)(cid:41)(cid:25)(cid:2)(cid:53)(cid:53)(cid:37)(cid:16)(cid:34)(cid:33,Unknown,22357.0
Unknown,Unknown,29,Unknown,Unknown,Unknown,Unknown,cid:12)(cid:29)(cid:26)(cid:41)(cid:25)(cid:2)(cid:53)(cid:53)(cid:37)(cid:16)(cid:34)(cid:33,Unknown,22386.0
Unknown,Unknown,26,Unknown,Unknown,Unknown,Unknown,cid:12)(cid:29)(cid:26)(cid:41)(cid:25)(cid:2)(cid:53)(cid:53)(cid:37)(cid:16)(cid:34)(cid:33,Unknown,22412.0
Unknown,Unknown,41,Unknown,Unknown,Unknown,Unknown,cid:12)(cid:29)(cid:26)(cid:41)(cid:25)(cid:2)(cid:53)(cid:53)(cid:37)(cid:16)(cid:34)(cid:33,Unknown,22453.0
Unknown,Unknown,25,Unknown,Unknown,Unknown,Unknown,cid:12)(cid:29)(cid:26)(cid:41)(cid:25)(cid:2)(cid:53)(cid:53)(cid:37)(cid:16)(cid:34)(cid:33,Unknown,22478.0
Unknown,Unknown,2,Unknown,Unknown,Unknown,Unknown,cid:12)(cid:29)(cid:26)(cid:41)(cid:25)(cid:2)(cid:53)(cid:53)(cid:37)(cid:16)(cid:34)(cid:33,Unknown,22480.0
Unknown,Unknown,53,Unknown,Unknown,Unknown,Unknown,cid:12)(cid:29)(cid:26)(cid:41)(cid:25)(cid:2)(cid:53)(cid:53)(cid:37)(cid:16)(cid:34)(cid:33,Unknown,22533.0
Unknown,Unknown,53,Unknown,Unknown,Unknown,Unknown,cid:12)(cid:29)(cid:26)(cid:41)(cid:25)(cid:2)(cid:53)(cid:53)(cid:37)(cid:16)(cid:34)(cid:33,Unknown,22586.0
Unknown,Unknown,37,Unknown,Unknown,Unknown,Unknown,cid:12)(cid:29)(cid:26)(cid:41)(cid:25)(cid:2)(cid:53)(cid:53)(cid:37)(cid:16)(cid:34)(cid:33,Unknown,22623.0
Unknown,Unknown,16,Unknown,Unknown,Unknown,Unknown,cid:12)(cid:29)(cid:26)(cid:41)(cid:25)(cid:2)(cid:53)(cid:53)(cid:37)(cid:16)(cid:34)(cid:33,Unknown,22639.0
Unknown,Unknown,34,Unknown,Unknown,Unknown,Unknown,cid:12)(cid:29)(cid:26)(cid:41)(cid:25)(cid:2)(cid:53)(cid:53)(cid:37)(cid:16)(cid:34)(cid:33,Unknown,22673.0
Unknown,Unknown,33,Unknown,Unknown,Unknown,Unknown,cid:12)(cid:29)(cid:26)(cid:41)(cid:25)(cid:2)(cid:53)(cid:53)(cid:37)(cid:16)(cid:34)(cid:33,Unknown,22706.0
Unknown,Unknown,1,Unknown,Unknown,Unknown,Unknown,cid:12)(cid:29)(cid:26)(cid:41)(cid:25)(cid:2)(cid:53)(cid:53)(cid:37)(cid:16)(cid:34)(cid:33,Unknown,22707.0
Unknown,Unknown,33,Unknown,Unknown,Unknown,Unknown,cid:12)(cid:29)(cid:26)(cid:41)(cid:25)(cid:2)(cid:53)(cid:53)(cid:37)(cid:16)(cid:34)(cid:33,Unknown,22740.0
Unknown,Unknown,45,Unknown,Unknown,Unknown,Unknown,cid:12)(cid:29)(cid:26)(cid:41)(cid:25)(cid:2)(cid:53)(cid:53)(cid:37)(cid:16)(cid:34)(cid:33,Unknown,22785.0
Unknown,Unknown,18,Unknown,Unknown,Unknown,Unknown,cid:12)(cid:29)(cid:26)(cid:41)(cid:25)(cid:2)(cid:53)(cid:53)(cid:37)(cid:16)(cid:34)(cid:33,Unknown,22803.0
Unknown,Unknown,34,Unknown,Unknown,Unknown,Unknown,cid:12)(cid:29)(cid:26)(cid:41)(cid:25)(cid:2)(cid:53)(cid:53)(cid:37)(cid:16)(cid:34)(cid:33,Unknown,22837.0
Unknown,Unknown,62,Unknown,Unknown,Unknown,Unknown,cid:12)(cid:29)(cid:26)(cid:41)(cid:25)(cid:2)(cid:53)(cid:53)(cid:37)(cid:16)(cid:34)(cid:33,Unknown,22899.0
Unknown,Unknown,49,Unknown,Unknown,Unknown,Unknown,cid:12)(cid:29)(cid:26)(cid:41)(cid:25)(cid:2)(cid:53)(cid:53)(cid:37)(cid:16)(cid:34)(cid:33,Unknown,22948.0
Unknown,Unknown,3,Unknown,Unknown,Unknown,Unknown,cid:12)(cid:29)(cid:26)(cid:41)(cid:25)(cid:2)(cid:53)(cid:53)(cid:37)(cid:16)(cid:34)(cid:33,Unknown,22951.0
Unknown,Unknown,60,Unknown,Unknown,Unknown,Unknown,cid:12)(cid:29)(cid:26)(cid:41)(cid:25)(cid:2)(cid:53)(cid:53)(cid:37)(cid:16)(cid:34)(cid:33,Unknown,23011.0
Unknown,Unknown,5,Unknown,Unknown,Unknown,Unknown,cid:12)(cid:29)(cid:26)(cid:41)(cid:25)(cid:2)(cid:53)(cid:53)(cid:37)(cid:16)(cid:34)(cid:33,Unknown,23016.0
Unknown,Unknown,10,Unknown,Unknown,Unknown,Unknown,cid:12)(cid:29)(cid:26)(cid:41)(cid:25)(cid:2)(cid:53)(cid:53)(cid:37)(cid:16)(cid:34)(cid:33,Unknown,23026.0
Unknown,Unknown,2,Unknown,Unknown,Unknown,Unknown,cid:12)(cid:29)(cid:26)(cid:41)(cid:25)(cid:2)(cid:53)(cid:53)(cid:37)(cid:16)(cid:34)(cid:33,Unknown,23028.0
Unknown,Unknown,62,Unknown,Unknown,Unknown,Unknown,cid:12)(cid:29)(cid:26)(cid:41)(cid:25)(cid:2)(cid:53)(cid:53)(cid:37)(cid:16)(cid:34)(cid:33,Unknown,23090.0
Unknown,Unknown,11,Unknown,Unknown,Unknown,Unknown,cid:12)(cid:29)(cid:26)(cid:41)(cid:25)(cid:2)(cid:53)(cid:53)(cid:37)(cid:16)(cid:34)(cid:33,Unknown,23101.0
Unknown,Unknown,4,Unknown,Unknown,Unknown,Unknown,cid:12)(cid:29)(cid:26)(cid:41)(cid:25)(cid:2)(cid:53)(cid:53)(cid:37)(cid:16)(cid:34)(cid:33,Unknown,23105.0
Unknown,Unknown,3,Unknown,Unknown,Unknown,Unknown,cid:12)(cid:29)(cid:26)(cid:41)(cid:25)(cid:2)(cid:53)(cid:53)(cid:37)(cid:16)(cid:34)(cid:33,Unknown,23108.0
Unknown,Unknown,11,Unknown,Unknown,Unknown,Unknown,cid:12)(cid:29)(cid:26)(cid:41)(cid:25)(cid:2)(cid:53)(cid:53)(cid:37)(cid:16)(cid:34)(cid:33,Unknown,23119.0
Unknown,Unknown,4,Unknown,Unknown,Unknown,Unknown,cid:12)(cid:29)(cid:26)(cid:41)(cid:25)(cid:2)(cid:53)(cid:53)(cid:37)(cid:16)(cid:34)(cid:33,Unknown,23123.0
Unknown,Unknown,40,Unknown,Unknown,Unknown,Unknown,cid:12)(cid:29)(cid:26)(cid:41)(cid:25)(cid:2)(cid:53)(cid:53)(cid:37)(cid:16)(cid:34)(cid:33,Unknown,23163.0
Unknown,Unknown,2,Unknown,Unknown,Unknown,Unknown,cid:12)(cid:29)(cid:26)(cid:41)(cid:25)(cid:2)(cid:53)(cid:53)(cid:37)(cid:16)(cid:34)(cid:33,Unknown,23165.0
Unknown,Unknown,62,Unknown,Unknown,Unknown,Unknown,cid:12)(cid:29)(cid:26)(cid:41)(cid:25)(cid:2)(cid:53)(cid:53)(cid:37)(cid:16)(cid:34)(cid:33,Unknown,23227.0
Unknown,Unknown,11,Unknown,Unknown,Unknown,Unknown,cid:12)(cid:29)(cid:26)(cid:41)(cid:25)(cid:2)(cid:53)(cid:53)(cid:37)(cid:16)(cid:34)(cid:33,Unknown,23238.0
Unknown,Unknown,4,Unknown,Unknown,Unknown,Unknown,cid:12)(cid:29)(cid:26)(cid:41)(cid:25)(cid:2)(cid:53)(cid:53)(cid:37)(cid:16)(cid:34)(cid:33,Unknown,23242.0
Unknown,Unknown,3,Unknown,Unknown,Unknown,Unknown,cid:12)(cid:29)(cid:26)(cid:41)(cid:25)(cid:2)(cid:53)(cid:53)(cid:37)(cid:16)(cid:34)(cid:33,Unknown,23245.0
Unknown,Unknown,11,Unknown,Unknown,Unknown,Unknown,cid:12)(cid:29)(cid:26)(cid:41)(cid:25)(cid:2)(cid:53)(cid:53)(cid:37)(cid:16)(cid:34)(cid:33,Unknown,23256.0
Unknown,Unknown,4,Unknown,Unknown,Unknown,Unknown,cid:12)(cid:29)(cid:26)(cid:41)(cid:25)(cid:2)(cid:53)(cid:53)(cid:37)(cid:16)(cid:34)(cid:33,Unknown,23260.0
Unknown,Unknown,40,Unknown,Unknown,Unknown,Unknown,cid:12)(cid:29)(cid:26)(cid:41)(cid:25)(cid:2)(cid:53)(cid:53)(cid:37)(cid:16)(cid:34)(cid:33,Unknown,23300.0
Unknown,Unknown,2,Unknown,Unknown,Unknown,Unknown,cid:12)(cid:29)(cid:26)(cid:41)(cid:25)(cid:2)(cid:53)(cid:53)(cid:37)(cid:16)(cid:34)(cid:33,Unknown,23302.0
Unknown,Unknown,28,Unknown,Unknown,Unknown,Unknown,cid:12)(cid:29)(cid:26)(cid:41)(cid:25)(cid:2)(cid:53)(cid:53)(cid:37)(cid:16)(cid:34)(cid:33,Unknown,23330.0
Unknown,Unknown,3,Unknown,Unknown,Unknown,Unknown,cid:12)(cid:29)(cid:26)(cid:41)(cid:25)(cid:2)(cid:53)(cid:53)(cid:37)(cid:16)(cid:34)(cid:33,Unknown,23333.0
Unknown,Unknown,15,Unknown,Unknown,Unknown,Unknown,cid:12)(cid:29)(cid:26)(cid:41)(cid:25)(cid:2)(cid:53)(cid:53)(cid:37)(cid:16)(cid:34)(cid:33,Unknown,23348.0
Unknown,Unknown,2,Unknown,Unknown,Unknown,Unknown,cid:12)(cid:29)(cid:26)(cid:41)(cid:25)(cid:2)(cid:53)(cid:53)(cid:37)(cid:16)(cid:34)(cid:33,Unknown,23350.0
Unknown,Unknown,34,Unknown,Unknown,Unknown,Unknown,cid:12)(cid:29)(cid:26)(cid:41)(cid:25)(cid:2)(cid:53)(cid:53)(cid:37)(cid:16)(cid:34)(cid:33,Unknown,23384.0
Unknown,Unknown,18,Unknown,Unknown,Unknown,Unknown,cid:12)(cid:29)(cid:26)(cid:41)(cid:25)(cid:2)(cid:53)(cid:53)(cid:37)(cid:16)(cid:34)(cid:33,Unknown,23402.0
Unknown,Unknown,19,Unknown,Unknown,Unknown,Unknown,cid:12)(cid:29)(cid:26)(cid:41)(cid:25)(cid:2)(cid:53)(cid:53)(cid:37)(cid:16)(cid:34)(cid:33,Unknown,23421.0
Unknown,Unknown,36,Unknown,Unknown,Unknown,Unknown,cid:12)(cid:29)(cid:26)(cid:41)(cid:25)(cid:2)(cid:53)(cid:53)(cid:37)(cid:16)(cid:34)(cid:33,Unknown,23457.0
Unknown,Unknown,35,Unknown,Unknown,Unknown,Unknown,cid:12)(cid:29)(cid:26)(cid:41)(cid:25)(cid:2)(cid:53)(cid:53)(cid:37)(cid:16)(cid:34)(cid:33,Unknown,23492.0
Unknown,Unknown,2,Unknown,Unknown,Unknown,Unknown,cid:12)(cid:29)(cid:26)(cid:41)(cid:25)(cid:2)(cid:53)(cid:53)(cid:37)(cid:16)(cid:34)(cid:33,Unknown,23494.0
Unknown,Unknown,44,Unknown,Unknown,Unknown,Unknown,cid:12)(cid:29)(cid:26)(cid:41)(cid:25)(cid:2)(cid:53)(cid:53)(cid:37)(cid:16)(cid:34)(cid:33,Unknown,23538.0
Unknown,Unknown,12,Unknown,Unknown,Unknown,Unknown,cid:12)(cid:29)(cid:26)(cid:41)(cid:25)(cid:2)(cid:53)(cid:53)(cid:37)(cid:16)(cid:34)(cid:33,Unknown,23550.0
Unknown,Unknown,29,Unknown,Unknown,Unknown,Unknown,cid:12)(cid:29)(cid:26)(cid:41)(cid:25)(cid:2)(cid:53)(cid:53)(cid:37)(cid:16)(cid:34)(cid:33,Unknown,23579.0
Unknown,Unknown,26,Unknown,Unknown,Unknown,Unknown,cid:12)(cid:29)(cid:26)(cid:41)(cid:25)(cid:2)(cid:53)(cid:53)(cid:37)(cid:16)(cid:34)(cid:33,Unknown,23605.0
Unknown,Unknown,41,Unknown,Unknown,Unknown,Unknown,cid:12)(cid:29)(cid:26)(cid:41)(cid:25)(cid:2)(cid:53)(cid:53)(cid:37)(cid:16)(cid:34)(cid:33,Unknown,23646.0
Unknown,Unknown,25,Unknown,Unknown,Unknown,Unknown,cid:12)(cid:29)(cid:26)(cid:41)(cid:25)(cid:2)(cid:53)(cid:53)(cid:37)(cid:16)(cid:34)(cid:33,Unknown,23671.0
Unknown,Unknown,2,Unknown,Unknown,Unknown,Unknown,cid:12)(cid:29)(cid:26)(cid:41)(cid:25)(cid:2)(cid:53)(cid:53)(cid:37)(cid:16)(cid:34)(cid:33,Unknown,23673.0
Unknown,Unknown,53,Unknown,Unknown,Unknown,Unknown,cid:12)(cid:29)(cid:26)(cid:41)(cid:25)(cid:2)(cid:53)(cid:53)(cid:37)(cid:16)(cid:34)(cid:33,Unknown,23726.0
Unknown,Unknown,53,Unknown,Unknown,Unknown,Unknown,cid:12)(cid:29)(cid:26)(cid:41)(cid:25)(cid:2)(cid:53)(cid:53)(cid:37)(cid:16)(cid:34)(cid:33,Unknown,23779.0
Unknown,Unknown,37,Unknown,Unknown,Unknown,Unknown,cid:12)(cid:29)(cid:26)(cid:41)(cid:25)(cid:2)(cid:53)(cid:53)(cid:37)(cid:16)(cid:34)(cid:33,Unknown,23816.0
Unknown,Unknown,16,Unknown,Unknown,Unknown,Unknown,cid:12)(cid:29)(cid:26)(cid:41)(cid:25)(cid:2)(cid:53)(cid:53)(cid:37)(cid:16)(cid:34)(cid:33,Unknown,23832.0
Unknown,Unknown,34,Unknown,Unknown,Unknown,Unknown,cid:12)(cid:29)(cid:26)(cid:41)(cid:25)(cid:2)(cid:53)(cid:53)(cid:37)(cid:16)(cid:34)(cid:33,Unknown,23866.0
Unknown,Unknown,33,Unknown,Unknown,Unknown,Unknown,cid:12)(cid:29)(cid:26)(cid:41)(cid:25)(cid:2)(cid:53)(cid:53)(cid:37)(cid:16)(cid:34)(cid:33,Unknown,23899.0
Unknown,Unknown,1,Unknown,Unknown,Unknown,Unknown,cid:12)(cid:29)(cid:26)(cid:41)(cid:25)(cid:2)(cid:53)(cid:53)(cid:37)(cid:16)(cid:34)(cid:33,Unknown,23900.0
Unknown,Unknown,33,Unknown,Unknown,Unknown,Unknown,cid:12)(cid:29)(cid:26)(cid:41)(cid:25)(cid:2)(cid:53)(cid:53)(cid:37)(cid:16)(cid:34)(cid:33,Unknown,23933.0
Unknown,Unknown,45,Unknown,Unknown,Unknown,Unknown,cid:12)(cid:29)(cid:26)(cid:41)(cid:25)(cid:2)(cid:53)(cid:53)(cid:37)(cid:16)(cid:34)(cid:33,Unknown,23978.0
Unknown,Unknown,18,Unknown,Unknown,Unknown,Unknown,cid:12)(cid:29)(cid:26)(cid:41)(cid:25)(cid:2)(cid:53)(cid:53)(cid:37)(cid:16)(cid:34)(cid:33,Unknown,23996.0
Unknown,Unknown,34,Unknown,Unknown,Unknown,Unknown,cid:12)(cid:29)(cid:26)(cid:41)(cid:25)(cid:2)(cid:53)(cid:53)(cid:37)(cid:16)(cid:34)(cid:33,Unknown,24030.0
Unknown,Unknown,49,Unknown,Unknown,Unknown,Unknown,cid:12)(cid:29)(cid:26)(cid:41)(cid:25)(cid:2)(cid:53)(cid:53)(cid:37)(cid:16)(cid:34)(cid:33,Unknown,24079.0
Unknown,Unknown,31,Unknown,Unknown,Unknown,Unknown,cid:12)(cid:29)(cid:26)(cid:41)(cid:25)(cid:2)(cid:53)(cid:53)(cid:37)(cid:16)(cid:34)(cid:33,Unknown,24110.0
Unknown,Unknown,41,Unknown,Unknown,Unknown,Unknown,cid:12)(cid:29)(cid:26)(cid:41)(cid:25)(cid:2)(cid:53)(cid:53)(cid:37)(cid:16)(cid:34)(cid:33,Unknown,24151.0
Unknown,Unknown,24,Unknown,Unknown,Unknown,Unknown,cid:12)(cid:29)(cid:26)(cid:41)(cid:25)(cid:2)(cid:53)(cid:53)(cid:37)(cid:16)(cid:34)(cid:33,Unknown,24175.0
Unknown,Unknown,20,Unknown,Unknown,Unknown,Unknown,cid:12)(cid:29)(cid:26)(cid:41)(cid:25)(cid:2)(cid:53)(cid:53)(cid:37)(cid:16)(cid:34)(cid:33,Unknown,24195.0
Unknown,Unknown,30,Unknown,Unknown,Unknown,Unknown,cid:12)(cid:29)(cid:26)(cid:41)(cid:25)(cid:2)(cid:53)(cid:53)(cid:37)(cid:16)(cid:34)(cid:33,Unknown,24225.0
Unknown,Unknown,2,Unknown,Unknown,Unknown,Unknown,cid:12)(cid:29)(cid:26)(cid:41)(cid:25)(cid:2)(cid:53)(cid:53)(cid:37)(cid:16)(cid:34)(cid:33,Unknown,24227.0
Unknown,Unknown,36,Unknown,Unknown,Unknown,Unknown,cid:12)(cid:29)(cid:26)(cid:41)(cid:25)(cid:2)(cid:53)(cid:53)(cid:37)(cid:16)(cid:34)(cid:33,Unknown,24263.0
Unknown,Unknown,17,Unknown,Unknown,Unknown,Unknown,cid:12)(cid:29)(cid:26)(cid:41)(cid:25)(cid:2)(cid:53)(cid:53)(cid:37)(cid:16)(cid:34)(cid:33,Unknown,24280.0
Unknown,Unknown,17,Unknown,Unknown,Unknown,Unknown,cid:12)(cid:29)(cid:26)(cid:41)(cid:25)(cid:2)(cid:53)(cid:53)(cid:37)(cid:16)(cid:34)(cid:33,Unknown,24297.0
Unknown,Unknown,33,Unknown,Unknown,Unknown,Unknown,cid:12)(cid:29)(cid:26)(cid:41)(cid:25)(cid:2)(cid:53)(cid:53)(cid:37)(cid:16)(cid:34)(cid:33,Unknown,24330.0
Unknown,Unknown,2,Unknown,Unknown,Unknown,Unknown,cid:12)(cid:29)(cid:26)(cid:41)(cid:25)(cid:2)(cid:53)(cid:53)(cid:37)(cid:16)(cid:34)(cid:33,Unknown,24332.0
Unknown,Unknown,12,Unknown,Unknown,Unknown,Unknown,cid:12)(cid:29)(cid:26)(cid:41)(cid:25)(cid:2)(cid:53)(cid:53)(cid:37)(cid:16)(cid:34)(cid:33,Unknown,24344.0
Unknown,Unknown,20,Unknown,Unknown,Unknown,Unknown,cid:12)(cid:29)(cid:26)(cid:41)(cid:25)(cid:2)(cid:53)(cid:53)(cid:37)(cid:16)(cid:34)(cid:33,Unknown,24364.0
Unknown,Unknown,21,Unknown,Unknown,Unknown,Unknown,cid:12)(cid:29)(cid:26)(cid:41)(cid:25)(cid:2)(cid:53)(cid:53)(cid:37)(cid:16)(cid:34)(cid:33,Unknown,24385.0
Unknown,Unknown,22,Unknown,Unknown,Unknown,Unknown,cid:12)(cid:29)(cid:26)(cid:41)(cid:25)(cid:2)(cid:53)(cid:53)(cid:37)(cid:16)(cid:34)(cid:33,Unknown,24407.0
Unknown,Unknown,20,Unknown,Unknown,Unknown,Unknown,cid:12)(cid:29)(cid:26)(cid:41)(cid:25)(cid:2)(cid:53)(cid:53)(cid:37)(cid:16)(cid:34)(cid:33,Unknown,24427.0
Unknown,Unknown,23,Unknown,Unknown,Unknown,Unknown,cid:12)(cid:29)(cid:26)(cid:41)(cid:25)(cid:2)(cid:53)(cid:53)(cid:37)(cid:16)(cid:34)(cid:33,Unknown,24450.0
Unknown,Unknown,23,Unknown,Unknown,Unknown,Unknown,cid:12)(cid:29)(cid:26)(cid:41)(cid:25)(cid:2)(cid:53)(cid:53)(cid:37)(cid:16)(cid:34)(cid:33,Unknown,24473.0
Unknown,Unknown,24,Unknown,Unknown,Unknown,Unknown,cid:12)(cid:29)(cid:26)(cid:41)(cid:25)(cid:2)(cid:53)(cid:53)(cid:37)(cid:16)(cid:34)(cid:33,Unknown,24497.0
Unknown,Unknown,25,Unknown,Unknown,Unknown,Unknown,cid:12)(cid:29)(cid:26)(cid:41)(cid:25)(cid:2)(cid:53)(cid:53)(cid:37)(cid:16)(cid:34)(cid:33,Unknown,24522.0
Unknown,Unknown,26,Unknown,Unknown,Unknown,Unknown,cid:12)(cid:29)(cid:26)(cid:41)(cid:25)(cid:2)(cid:53)(cid:53)(cid:37)(cid:16)(cid:34)(cid:33,Unknown,24548.0
Unknown,Unknown,27,Unknown,Unknown,Unknown,Unknown,cid:12)(cid:29)(cid:26)(cid:41)(cid:25)(cid:2)(cid:53)(cid:53)(cid:37)(cid:16)(cid:34)(cid:33,Unknown,24575.0
Unknown,Unknown,2,Unknown,Unknown,Unknown,Unknown,cid:12)(cid:29)(cid:26)(cid:41)(cid:25)(cid:2)(cid:53)(cid:53)(cid:37)(cid:16)(cid:34)(cid:33,Unknown,24577.0
Unknown,Unknown,28,Unknown,Unknown,Unknown,Unknown,cid:12)(cid:29)(cid:26)(cid:41)(cid:25)(cid:2)(cid:53)(cid:53)(cid:37)(cid:16)(cid:34)(cid:33,Unknown,24605.0
Unknown,Unknown,3,Unknown,Unknown,Unknown,Unknown,cid:12)(cid:29)(cid:26)(cid:41)(cid:25)(cid:2)(cid:53)(cid:53)(cid:37)(cid:16)(cid:34)(cid:33,Unknown,24608.0
Unknown,Unknown,15,Unknown,Unknown,Unknown,Unknown,cid:12)(cid:29)(cid:26)(cid:41)(cid:25)(cid:2)(cid:53)(cid:53)(cid:37)(cid:16)(cid:34)(cid:33,Unknown,24623.0
Unknown,Unknown,2,Unknown,Unknown,Unknown,Unknown,cid:12)(cid:29)(cid:26)(cid:41)(cid:25)(cid:2)(cid:53)(cid:53)(cid:37)(cid:16)(cid:34)(cid:33,Unknown,24625.0
Unknown,Unknown,37,Unknown,Unknown,Unknown,Unknown,cid:12)(cid:29)(cid:26)(cid:41)(cid:25)(cid:2)(cid:53)(cid:53)(cid:37)(cid:16)(cid:34)(cid:33,Unknown,24662.0
Unknown,Unknown,1,Unknown,Unknown,Unknown,Unknown,cid:12)(cid:29)(cid:26)(cid:41)(cid:25)(cid:2)(cid:53)(cid:53)(cid:37)(cid:16)(cid:34)(cid:33,Unknown,24663.0
Unknown,Unknown,19,Unknown,Unknown,Unknown,Unknown,cid:12)(cid:29)(cid:26)(cid:41)(cid:25)(cid:2)(cid:53)(cid:53)(cid:37)(cid:16)(cid:34)(cid:33,Unknown,24682.0
Unknown,Unknown,1,Unknown,Unknown,Unknown,Unknown,cid:12)(cid:29)(cid:26)(cid:41)(cid:25)(cid:2)(cid:53)(cid:53)(cid:37)(cid:16)(cid:34)(cid:33,Unknown,24683.0
Unknown,Unknown,36,Unknown,Unknown,Unknown,Unknown,cid:12)(cid:29)(cid:26)(cid:41)(cid:25)(cid:2)(cid:53)(cid:53)(cid:37)(cid:16)(cid:34)(cid:33,Unknown,24719.0
Unknown,Unknown,2,Unknown,Unknown,Unknown,Unknown,cid:12)(cid:29)(cid:26)(cid:41)(cid:25)(cid:2)(cid:53)(cid:53)(cid:37)(cid:16)(cid:34)(cid:33,Unknown,24721.0
Unknown,Unknown,44,Unknown,Unknown,Unknown,Unknown,cid:12)(cid:29)(cid:26)(cid:41)(cid:25)(cid:2)(cid:53)(cid:53)(cid:37)(cid:16)(cid:34)(cid:33,Unknown,24765.0
Unknown,Unknown,12,Unknown,Unknown,Unknown,Unknown,cid:12)(cid:29)(cid:26)(cid:41)(cid:25)(cid:2)(cid:53)(cid:53)(cid:37)(cid:16)(cid:34)(cid:33,Unknown,24777.0
Unknown,Unknown,29,Unknown,Unknown,Unknown,Unknown,cid:12)(cid:29)(cid:26)(cid:41)(cid:25)(cid:2)(cid:53)(cid:53)(cid:37)(cid:16)(cid:34)(cid:33,Unknown,24806.0
Unknown,Unknown,26,Unknown,Unknown,Unknown,Unknown,cid:12)(cid:29)(cid:26)(cid:41)(cid:25)(cid:2)(cid:53)(cid:53)(cid:37)(cid:16)(cid:34)(cid:33,Unknown,24832.0
Unknown,Unknown,41,Unknown,Unknown,Unknown,Unknown,cid:12)(cid:29)(cid:26)(cid:41)(cid:25)(cid:2)(cid:53)(cid:53)(cid:37)(cid:16)(cid:34)(cid:33,Unknown,24873.0
Unknown,Unknown,25,Unknown,Unknown,Unknown,Unknown,cid:12)(cid:29)(cid:26)(cid:41)(cid:25)(cid:2)(cid:53)(cid:53)(cid:37)(cid:16)(cid:34)(cid:33,Unknown,24898.0
Unknown,Unknown,2,Unknown,Unknown,Unknown,Unknown,cid:12)(cid:29)(cid:26)(cid:41)(cid:25)(cid:2)(cid:53)(cid:53)(cid:37)(cid:16)(cid:34)(cid:33,Unknown,24900.0
Unknown,Unknown,53,Unknown,Unknown,Unknown,Unknown,cid:12)(cid:29)(cid:26)(cid:41)(cid:25)(cid:2)(cid:53)(cid:53)(cid:37)(cid:16)(cid:34)(cid:33,Unknown,24953.0
Unknown,Unknown,53,Unknown,Unknown,Unknown,Unknown,cid:12)(cid:29)(cid:26)(cid:41)(cid:25)(cid:2)(cid:53)(cid:53)(cid:37)(cid:16)(cid:34)(cid:33,Unknown,25006.0
Unknown,Unknown,37,Unknown,Unknown,Unknown,Unknown,cid:12)(cid:29)(cid:26)(cid:41)(cid:25)(cid:2)(cid:53)(cid:53)(cid:37)(cid:16)(cid:34)(cid:33,Unknown,25043.0
Unknown,Unknown,16,Unknown,Unknown,Unknown,Unknown,cid:12)(cid:29)(cid:26)(cid:41)(cid:25)(cid:2)(cid:53)(cid:53)(cid:37)(cid:16)(cid:34)(cid:33,Unknown,25059.0
Unknown,Unknown,34,Unknown,Unknown,Unknown,Unknown,cid:12)(cid:29)(cid:26)(cid:41)(cid:25)(cid:2)(cid:53)(cid:53)(cid:37)(cid:16)(cid:34)(cid:33,Unknown,25093.0
Unknown,Unknown,33,Unknown,Unknown,Unknown,Unknown,cid:12)(cid:29)(cid:26)(cid:41)(cid:25)(cid:2)(cid:53)(cid:53)(cid:37)(cid:16)(cid:34)(cid:33,Unknown,25126.0
Unknown,Unknown,37,Unknown,Unknown,Unknown,Unknown,cid:12)(cid:29)(cid:26)(cid:41)(cid:25)(cid:2)(cid:53)(cid:53)(cid:37)(cid:16)(cid:34)(cid:33,Unknown,25163.0
Unknown,Unknown,17,Unknown,Unknown,Unknown,Unknown,cid:12)(cid:29)(cid:26)(cid:41)(cid:25)(cid:2)(cid:53)(cid:53)(cid:37)(cid:16)(cid:34)(cid:33,Unknown,25180.0
Unknown,Unknown,45,Unknown,Unknown,Unknown,Unknown,cid:12)(cid:29)(cid:26)(cid:41)(cid:25)(cid:2)(cid:53)(cid:53)(cid:37)(cid:16)(cid:34)(cid:33,Unknown,25225.0
Unknown,Unknown,18,Unknown,Unknown,Unknown,Unknown,cid:12)(cid:29)(cid:26)(cid:41)(cid:25)(cid:2)(cid:53)(cid:53)(cid:37)(cid:16)(cid:34)(cid:33,Unknown,25243.0
Unknown,Unknown,34,Unknown,Unknown,Unknown,Unknown,cid:12)(cid:29)(cid:26)(cid:41)(cid:25)(cid:2)(cid:53)(cid:53)(cid:37)(cid:16)(cid:34)(cid:33,Unknown,25277.0
Unknown,Unknown,7,Unknown,Unknown,Unknown,Unknown,cid:12)(cid:29)(cid:26)(cid:41)(cid:25)(cid:2)(cid:53)(cid:53)(cid:37)(cid:16)(cid:34)(cid:33,Unknown,25284.0
Unknown,Unknown,8,Unknown,Unknown,Unknown,Unknown,cid:12)(cid:29)(cid:26)(cid:41)(cid:25)(cid:2)(cid:53)(cid:53)(cid:37)(cid:16)(cid:34)(cid:33,Unknown,25292.0
Unknown,Unknown,10,Unknown,Unknown,Unknown,Unknown,cid:12)(cid:29)(cid:26)(cid:41)(cid:25)(cid:2)(cid:53)(cid:53)(cid:37)(cid:16)(cid:34)(cid:33,Unknown,25302.0
Unknown,Unknown,5,Unknown,Unknown,Unknown,Unknown,cid:12)(cid:29)(cid:26)(cid:41)(cid:25)(cid:2)(cid:53)(cid:53)(cid:37)(cid:16)(cid:34)(cid:33,Unknown,25307.0
Unknown,Unknown,3,Unknown,Unknown,Unknown,Unknown,cid:12)(cid:29)(cid:26)(cid:41)(cid:25)(cid:2)(cid:53)(cid:53)(cid:37)(cid:16)(cid:34)(cid:33,Unknown,25310.0
Unknown,Unknown,9,Unknown,Unknown,Unknown,Unknown,cid:12)(cid:29)(cid:26)(cid:41)(cid:25)(cid:2)(cid:53)(cid:53)(cid:37)(cid:16)(cid:34)(cid:33,Unknown,25319.0
Unknown,Unknown,39,Unknown,Unknown,Unknown,Unknown,cid:12)(cid:29)(cid:26)(cid:41)(cid:25)(cid:2)(cid:53)(cid:53)(cid:37)(cid:16)(cid:34)(cid:33,Unknown,25358.0
Unknown,Unknown,11,Unknown,Unknown,Unknown,Unknown,cid:12)(cid:29)(cid:26)(cid:41)(cid:25)(cid:2)(cid:53)(cid:53)(cid:37)(cid:16)(cid:34)(cid:33,Unknown,25369.0
Unknown,Unknown,3,Unknown,Unknown,Unknown,Unknown,cid:12)(cid:29)(cid:26)(cid:41)(cid:25)(cid:2)(cid:53)(cid:53)(cid:37)(cid:16)(cid:34)(cid:33,Unknown,25372.0
Unknown,Unknown,10,Unknown,Unknown,Unknown,Unknown,cid:12)(cid:29)(cid:26)(cid:41)(cid:25)(cid:2)(cid:53)(cid:53)(cid:37)(cid:16)(cid:34)(cid:33,Unknown,25382.0
Unknown,Unknown,2,Unknown,Unknown,Unknown,Unknown,cid:12)(cid:29)(cid:26)(cid:41)(cid:25)(cid:2)(cid:53)(cid:53)(cid:37)(cid:16)(cid:34)(cid:33,Unknown,25384.0
Unknown,Unknown,12,Unknown,Unknown,Unknown,Unknown,cid:12)(cid:29)(cid:26)(cid:41)(cid:25)(cid:2)(cid:53)(cid:53)(cid:37)(cid:16)(cid:34)(cid:33,Unknown,25396.0
Unknown,Unknown,11,Unknown,Unknown,Unknown,Unknown,cid:12)(cid:29)(cid:26)(cid:41)(cid:25)(cid:2)(cid:53)(cid:53)(cid:37)(cid:16)(cid:34)(cid:33,Unknown,25407.0
Unknown,Unknown,4,Unknown,Unknown,Unknown,Unknown,cid:12)(cid:29)(cid:26)(cid:41)(cid:25)(cid:2)(cid:53)(cid:53)(cid:37)(cid:16)(cid:34)(cid:33,Unknown,25411.0
Unknown,Unknown,14,Unknown,Unknown,Unknown,Unknown,cid:12)(cid:29)(cid:26)(cid:41)(cid:25)(cid:2)(cid:53)(cid:53)(cid:37)(cid:16)(cid:34)(cid:33,Unknown,25425.0
Unknown,Unknown,11,Unknown,Unknown,Unknown,Unknown,cid:12)(cid:29)(cid:26)(cid:41)(cid:25)(cid:2)(cid:53)(cid:53)(cid:37)(cid:16)(cid:34)(cid:33,Unknown,25436.0
Unknown,Unknown,62,Unknown,Unknown,Unknown,Unknown,cid:12)(cid:29)(cid:26)(cid:41)(cid:25)(cid:2)(cid:53)(cid:53)(cid:37)(cid:16)(cid:34)(cid:33,Unknown,25498.0
Unknown,Unknown,62,Unknown,Unknown,Unknown,Unknown,cid:12)(cid:29)(cid:26)(cid:41)(cid:25)(cid:2)(cid:53)(cid:53)(cid:37)(cid:16)(cid:34)(cid:33,Unknown,25560.0
Unknown,Unknown,7,Unknown,Unknown,Unknown,Unknown,cid:12)(cid:29)(cid:26)(cid:41)(cid:25)(cid:2)(cid:53)(cid:53)(cid:37)(cid:16)(cid:34)(cid:33,Unknown,25567.0
Unknown,Unknown,5,Unknown,Unknown,Unknown,Unknown,cid:12)(cid:29)(cid:26)(cid:41)(cid:25)(cid:2)(cid:53)(cid:53)(cid:37)(cid:16)(cid:34)(cid:33,Unknown,25572.0
Unknown,Unknown,3,Unknown,Unknown,Unknown,Unknown,cid:12)(cid:29)(cid:26)(cid:41)(cid:25)(cid:2)(cid:53)(cid:53)(cid:37)(cid:16)(cid:34)(cid:33,Unknown,25575.0
Unknown,Unknown,9,Unknown,Unknown,Unknown,Unknown,cid:12)(cid:29)(cid:26)(cid:41)(cid:25)(cid:2)(cid:53)(cid:53)(cid:37)(cid:16)(cid:34)(cid:33,Unknown,25584.0
Unknown,Unknown,2,Unknown,Unknown,Unknown,Unknown,cid:12)(cid:29)(cid:26)(cid:41)(cid:25)(cid:2)(cid:53)(cid:53)(cid:37)(cid:16)(cid:34)(cid:33,Unknown,25586.0
Unknown,Unknown,28,Unknown,Unknown,Unknown,Unknown,cid:12)(cid:29)(cid:26)(cid:41)(cid:25)(cid:2)(cid:53)(cid:53)(cid:37)(cid:16)(cid:34)(cid:33,Unknown,25614.0
Unknown,Unknown,3,Unknown,Unknown,Unknown,Unknown,cid:12)(cid:29)(cid:26)(cid:41)(cid:25)(cid:2)(cid:53)(cid:53)(cid:37)(cid:16)(cid:34)(cid:33,Unknown,25617.0
Unknown,Unknown,15,Unknown,Unknown,Unknown,Unknown,cid:12)(cid:29)(cid:26)(cid:41)(cid:25)(cid:2)(cid:53)(cid:53)(cid:37)(cid:16)(cid:34)(cid:33,Unknown,25632.0
Unknown,Unknown,2,Unknown,Unknown,Unknown,Unknown,cid:12)(cid:29)(cid:26)(cid:41)(cid:25)(cid:2)(cid:53)(cid:53)(cid:37)(cid:16)(cid:34)(cid:33,Unknown,25634.0
Unknown,Unknown,17,Unknown,Unknown,Unknown,Unknown,cid:12)(cid:29)(cid:26)(cid:41)(cid:25)(cid:2)(cid:53)(cid:53)(cid:37)(cid:16)(cid:34)(cid:33,Unknown,25651.0
Unknown,Unknown,17,Unknown,Unknown,Unknown,Unknown,cid:12)(cid:29)(cid:26)(cid:41)(cid:25)(cid:2)(cid:53)(cid:53)(cid:37)(cid:16)(cid:34)(cid:33,Unknown,25668.0
Unknown,Unknown,33,Unknown,Unknown,Unknown,Unknown,cid:12)(cid:29)(cid:26)(cid:41)(cid:25)(cid:2)(cid:53)(cid:53)(cid:37)(cid:16)(cid:34)(cid:33,Unknown,25701.0
Unknown,Unknown,19,Unknown,Unknown,Unknown,Unknown,cid:12)(cid:29)(cid:26)(cid:41)(cid:25)(cid:2)(cid:53)(cid:53)(cid:37)(cid:16)(cid:34)(cid:33,Unknown,25720.0
Unknown,Unknown,33,Unknown,Unknown,Unknown,Unknown,cid:12)(cid:29)(cid:26)(cid:41)(cid:25)(cid:2)(cid:53)(cid:53)(cid:37)(cid:16)(cid:34)(cid:33,Unknown,25753.0
Unknown,Unknown,33,Unknown,Unknown,Unknown,Unknown,cid:12)(cid:29)(cid:26)(cid:41)(cid:25)(cid:2)(cid:53)(cid:53)(cid:37)(cid:16)(cid:34)(cid:33,Unknown,25786.0
Unknown,Unknown,2,Unknown,Unknown,Unknown,Unknown,cid:12)(cid:29)(cid:26)(cid:41)(cid:25)(cid:2)(cid:53)(cid:53)(cid:37)(cid:16)(cid:34)(cid:33,Unknown,25788.0
Unknown,Unknown,44,Unknown,Unknown,Unknown,Unknown,cid:12)(cid:29)(cid:26)(cid:41)(cid:25)(cid:2)(cid:53)(cid:53)(cid:37)(cid:16)(cid:34)(cid:33,Unknown,25832.0
Unknown,Unknown,12,Unknown,Unknown,Unknown,Unknown,cid:12)(cid:29)(cid:26)(cid:41)(cid:25)(cid:2)(cid:53)(cid:53)(cid:37)(cid:16)(cid:34)(cid:33,Unknown,25844.0
Unknown,Unknown,29,Unknown,Unknown,Unknown,Unknown,cid:12)(cid:29)(cid:26)(cid:41)(cid:25)(cid:2)(cid:53)(cid:53)(cid:37)(cid:16)(cid:34)(cid:33,Unknown,25873.0
Unknown,Unknown,26,Unknown,Unknown,Unknown,Unknown,cid:12)(cid:29)(cid:26)(cid:41)(cid:25)(cid:2)(cid:53)(cid:53)(cid:37)(cid:16)(cid:34)(cid:33,Unknown,25899.0
Unknown,Unknown,41,Unknown,Unknown,Unknown,Unknown,cid:12)(cid:29)(cid:26)(cid:41)(cid:25)(cid:2)(cid:53)(cid:53)(cid:37)(cid:16)(cid:34)(cid:33,Unknown,25940.0
Unknown,Unknown,25,Unknown,Unknown,Unknown,Unknown,cid:12)(cid:29)(cid:26)(cid:41)(cid:25)(cid:2)(cid:53)(cid:53)(cid:37)(cid:16)(cid:34)(cid:33,Unknown,25965.0
Unknown,Unknown,2,Unknown,Unknown,Unknown,Unknown,cid:12)(cid:29)(cid:26)(cid:41)(cid:25)(cid:2)(cid:53)(cid:53)(cid:37)(cid:16)(cid:34)(cid:33,Unknown,25967.0
Unknown,Unknown,53,Unknown,Unknown,Unknown,Unknown,cid:12)(cid:29)(cid:26)(cid:41)(cid:25)(cid:2)(cid:53)(cid:53)(cid:37)(cid:16)(cid:34)(cid:33,Unknown,26020.0
Unknown,Unknown,53,Unknown,Unknown,Unknown,Unknown,cid:12)(cid:29)(cid:26)(cid:41)(cid:25)(cid:2)(cid:53)(cid:53)(cid:37)(cid:16)(cid:34)(cid:33,Unknown,26073.0
Unknown,Unknown,18,Unknown,Unknown,Unknown,Unknown,cid:12)(cid:29)(cid:26)(cid:41)(cid:25)(cid:2)(cid:53)(cid:53)(cid:37)(cid:16)(cid:34)(cid:33,Unknown,26091.0
Unknown,Unknown,1,Unknown,Unknown,Unknown,Unknown,cid:12)(cid:29)(cid:26)(cid:41)(cid:25)(cid:2)(cid:53)(cid:53)(cid:37)(cid:16)(cid:34)(cid:33,Unknown,26092.0
Unknown,Unknown,1,Unknown,Unknown,Unknown,Unknown,cid:12)(cid:29)(cid:26)(cid:41)(cid:25)(cid:2)(cid:53)(cid:53)(cid:37)(cid:16)(cid:34)(cid:33,Unknown,26093.0
Unknown,Unknown,37,Unknown,Unknown,Unknown,Unknown,cid:12)(cid:29)(cid:26)(cid:41)(cid:25)(cid:2)(cid:53)(cid:53)(cid:37)(cid:16)(cid:34)(cid:33,Unknown,26130.0
Unknown,Unknown,18,Unknown,Unknown,Unknown,Unknown,cid:12)(cid:29)(cid:26)(cid:41)(cid:25)(cid:2)(cid:53)(cid:53)(cid:37)(cid:16)(cid:34)(cid:33,Unknown,26148.0
Unknown,Unknown,17,Unknown,Unknown,Unknown,Unknown,cid:12)(cid:29)(cid:26)(cid:41)(cid:25)(cid:2)(cid:53)(cid:53)(cid:37)(cid:16)(cid:34)(cid:33,Unknown,26165.0
Unknown,Unknown,45,Unknown,Unknown,Unknown,Unknown,cid:12)(cid:29)(cid:26)(cid:41)(cid:25)(cid:2)(cid:53)(cid:53)(cid:37)(cid:16)(cid:34)(cid:33,Unknown,26210.0
Unknown,Unknown,18,Unknown,Unknown,Unknown,Unknown,cid:12)(cid:29)(cid:26)(cid:41)(cid:25)(cid:2)(cid:53)(cid:53)(cid:37)(cid:16)(cid:34)(cid:33,Unknown,26228.0
Unknown,Unknown,32,Unknown,Unknown,Unknown,Unknown,cid:12)(cid:29)(cid:26)(cid:41)(cid:25)(cid:2)(cid:53)(cid:53)(cid:37)(cid:16)(cid:34)(cid:33,Unknown,26260.0
Unknown,Unknown,10,Unknown,Unknown,Unknown,Unknown,cid:12)(cid:29)(cid:26)(cid:41)(cid:25)(cid:2)(cid:53)(cid:53)(cid:37)(cid:16)(cid:34)(cid:33,Unknown,26270.0
Unknown,Unknown,11,Unknown,Unknown,Unknown,Unknown,cid:12)(cid:29)(cid:26)(cid:41)(cid:25)(cid:2)(cid:53)(cid:53)(cid:37)(cid:16)(cid:34)(cid:33,Unknown,26281.0
Unknown,Unknown,10,Unknown,Unknown,Unknown,Unknown,cid:12)(cid:29)(cid:26)(cid:41)(cid:25)(cid:2)(cid:53)(cid:53)(cid:37)(cid:16)(cid:34)(cid:33,Unknown,26291.0
Unknown,Unknown,49,Unknown,Unknown,Unknown,Unknown,cid:12)(cid:29)(cid:26)(cid:41)(cid:25)(cid:2)(cid:53)(cid:53)(cid:37)(cid:16)(cid:34)(cid:33,Unknown,26340.0
Unknown,Unknown,14,Unknown,Unknown,Unknown,Unknown,cid:12)(cid:29)(cid:26)(cid:41)(cid:25)(cid:2)(cid:53)(cid:53)(cid:37)(cid:16)(cid:34)(cid:33,Unknown,26354.0
Unknown,Unknown,2,Unknown,Unknown,Unknown,Unknown,cid:12)(cid:29)(cid:26)(cid:41)(cid:25)(cid:2)(cid:53)(cid:53)(cid:37)(cid:16)(cid:34)(cid:33,Unknown,26356.0
Unknown,Unknown,12,Unknown,Unknown,Unknown,Unknown,cid:12)(cid:29)(cid:26)(cid:41)(cid:25)(cid:2)(cid:53)(cid:53)(cid:37)(cid:16)(cid:34)(cid:33,Unknown,26368.0
Unknown,Unknown,11,Unknown,Unknown,Unknown,Unknown,cid:12)(cid:29)(cid:26)(cid:41)(cid:25)(cid:2)(cid:53)(cid:53)(cid:37)(cid:16)(cid:34)(cid:33,Unknown,26379.0
Unknown,Unknown,4,Unknown,Unknown,Unknown,Unknown,cid:12)(cid:29)(cid:26)(cid:41)(cid:25)(cid:2)(cid:53)(cid:53)(cid:37)(cid:16)(cid:34)(cid:33,Unknown,26383.0
Unknown,Unknown,14,Unknown,Unknown,Unknown,Unknown,cid:12)(cid:29)(cid:26)(cid:41)(cid:25)(cid:2)(cid:53)(cid:53)(cid:37)(cid:16)(cid:34)(cid:33,Unknown,26397.0
Unknown,Unknown,11,Unknown,Unknown,Unknown,Unknown,cid:12)(cid:29)(cid:26)(cid:41)(cid:25)(cid:2)(cid:53)(cid:53)(cid:37)(cid:16)(cid:34)(cid:33,Unknown,26408.0
Unknown,Unknown,62,Unknown,Unknown,Unknown,Unknown,cid:12)(cid:29)(cid:26)(cid:41)(cid:25)(cid:2)(cid:53)(cid:53)(cid:37)(cid:16)(cid:34)(cid:33,Unknown,26470.0
Unknown,Unknown,62,Unknown,Unknown,Unknown,Unknown,cid:12)(cid:29)(cid:26)(cid:41)(cid:25)(cid:2)(cid:53)(cid:53)(cid:37)(cid:16)(cid:34)(cid:33,Unknown,26532.0
Unknown,Unknown,7,Unknown,Unknown,Unknown,Unknown,cid:12)(cid:29)(cid:26)(cid:41)(cid:25)(cid:2)(cid:53)(cid:53)(cid:37)(cid:16)(cid:34)(cid:33,Unknown,26539.0
Unknown,Unknown,5,Unknown,Unknown,Unknown,Unknown,cid:12)(cid:29)(cid:26)(cid:41)(cid:25)(cid:2)(cid:53)(cid:53)(cid:37)(cid:16)(cid:34)(cid:33,Unknown,26544.0
Unknown,Unknown,3,Unknown,Unknown,Unknown,Unknown,cid:12)(cid:29)(cid:26)(cid:41)(cid:25)(cid:2)(cid:53)(cid:53)(cid:37)(cid:16)(cid:34)(cid:33,Unknown,26547.0
Unknown,Unknown,9,Unknown,Unknown,Unknown,Unknown,cid:12)(cid:29)(cid:26)(cid:41)(cid:25)(cid:2)(cid:53)(cid:53)(cid:37)(cid:16)(cid:34)(cid:33,Unknown,26556.0
Unknown,Unknown,2,Unknown,Unknown,Unknown,Unknown,cid:12)(cid:29)(cid:26)(cid:41)(cid:25)(cid:2)(cid:53)(cid:53)(cid:37)(cid:16)(cid:34)(cid:33,Unknown,26558.0
Unknown,Unknown,28,Unknown,Unknown,Unknown,Unknown,cid:12)(cid:29)(cid:26)(cid:41)(cid:25)(cid:2)(cid:53)(cid:53)(cid:37)(cid:16)(cid:34)(cid:33,Unknown,26586.0
Unknown,Unknown,3,Unknown,Unknown,Unknown,Unknown,cid:12)(cid:29)(cid:26)(cid:41)(cid:25)(cid:2)(cid:53)(cid:53)(cid:37)(cid:16)(cid:34)(cid:33,Unknown,26589.0
Unknown,Unknown,15,Unknown,Unknown,Unknown,Unknown,cid:12)(cid:29)(cid:26)(cid:41)(cid:25)(cid:2)(cid:53)(cid:53)(cid:37)(cid:16)(cid:34)(cid:33,Unknown,26604.0
Unknown,Unknown,2,Unknown,Unknown,Unknown,Unknown,cid:12)(cid:29)(cid:26)(cid:41)(cid:25)(cid:2)(cid:53)(cid:53)(cid:37)(cid:16)(cid:34)(cid:33,Unknown,26606.0
Unknown,Unknown,32,Unknown,Unknown,Unknown,Unknown,cid:12)(cid:29)(cid:26)(cid:41)(cid:25)(cid:2)(cid:53)(cid:53)(cid:37)(cid:16)(cid:34)(cid:33,Unknown,26638.0
Unknown,Unknown,18,Unknown,Unknown,Unknown,Unknown,cid:12)(cid:29)(cid:26)(cid:41)(cid:25)(cid:2)(cid:53)(cid:53)(cid:37)(cid:16)(cid:34)(cid:33,Unknown,26656.0
Unknown,Unknown,19,Unknown,Unknown,Unknown,Unknown,cid:12)(cid:29)(cid:26)(cid:41)(cid:25)(cid:2)(cid:53)(cid:53)(cid:37)(cid:16)(cid:34)(cid:33,Unknown,26675.0
Unknown,Unknown,17,Unknown,Unknown,Unknown,Unknown,cid:12)(cid:29)(cid:26)(cid:41)(cid:25)(cid:2)(cid:53)(cid:53)(cid:37)(cid:16)(cid:34)(cid:33,Unknown,26692.0
Unknown,Unknown,18,Unknown,Unknown,Unknown,Unknown,cid:12)(cid:29)(cid:26)(cid:41)(cid:25)(cid:2)(cid:53)(cid:53)(cid:37)(cid:16)(cid:34)(cid:33,Unknown,26710.0
Unknown,Unknown,2,Unknown,Unknown,Unknown,Unknown,cid:12)(cid:29)(cid:26)(cid:41)(cid:25)(cid:2)(cid:53)(cid:53)(cid:37)(cid:16)(cid:34)(cid:33,Unknown,26712.0
Unknown,Unknown,44,Unknown,Unknown,Unknown,Unknown,cid:12)(cid:29)(cid:26)(cid:41)(cid:25)(cid:2)(cid:53)(cid:53)(cid:37)(cid:16)(cid:34)(cid:33,Unknown,26756.0
Unknown,Unknown,12,Unknown,Unknown,Unknown,Unknown,cid:12)(cid:29)(cid:26)(cid:41)(cid:25)(cid:2)(cid:53)(cid:53)(cid:37)(cid:16)(cid:34)(cid:33,Unknown,26768.0
Unknown,Unknown,29,Unknown,Unknown,Unknown,Unknown,cid:12)(cid:29)(cid:26)(cid:41)(cid:25)(cid:2)(cid:53)(cid:53)(cid:37)(cid:16)(cid:34)(cid:33,Unknown,26797.0
Unknown,Unknown,26,Unknown,Unknown,Unknown,Unknown,cid:12)(cid:29)(cid:26)(cid:41)(cid:25)(cid:2)(cid:53)(cid:53)(cid:37)(cid:16)(cid:34)(cid:33,Unknown,26823.0
Unknown,Unknown,41,Unknown,Unknown,Unknown,Unknown,cid:12)(cid:29)(cid:26)(cid:41)(cid:25)(cid:2)(cid:53)(cid:53)(cid:37)(cid:16)(cid:34)(cid:33,Unknown,26864.0
Unknown,Unknown,25,Unknown,Unknown,Unknown,Unknown,cid:12)(cid:29)(cid:26)(cid:41)(cid:25)(cid:2)(cid:53)(cid:53)(cid:37)(cid:16)(cid:34)(cid:33,Unknown,26889.0
Unknown,Unknown,2,Unknown,Unknown,Unknown,Unknown,cid:12)(cid:29)(cid:26)(cid:41)(cid:25)(cid:2)(cid:53)(cid:53)(cid:37)(cid:16)(cid:34)(cid:33,Unknown,26891.0
Unknown,Unknown,53,Unknown,Unknown,Unknown,Unknown,cid:12)(cid:29)(cid:26)(cid:41)(cid:25)(cid:2)(cid:53)(cid:53)(cid:37)(cid:16)(cid:34)(cid:33,Unknown,26944.0
Unknown,Unknown,53,Unknown,Unknown,Unknown,Unknown,cid:12)(cid:29)(cid:26)(cid:41)(cid:25)(cid:2)(cid:53)(cid:53)(cid:37)(cid:16)(cid:34)(cid:33,Unknown,26997.0
Unknown,Unknown,18,Unknown,Unknown,Unknown,Unknown,cid:12)(cid:29)(cid:26)(cid:41)(cid:25)(cid:2)(cid:53)(cid:53)(cid:37)(cid:16)(cid:34)(cid:33,Unknown,27015.0
Unknown,Unknown,1,Unknown,Unknown,Unknown,Unknown,cid:12)(cid:29)(cid:26)(cid:41)(cid:25)(cid:2)(cid:53)(cid:53)(cid:37)(cid:16)(cid:34)(cid:33,Unknown,27016.0
Unknown,Unknown,1,Unknown,Unknown,Unknown,Unknown,cid:12)(cid:29)(cid:26)(cid:41)(cid:25)(cid:2)(cid:53)(cid:53)(cid:37)(cid:16)(cid:34)(cid:33,Unknown,27017.0
Unknown,Unknown,37,Unknown,Unknown,Unknown,Unknown,cid:12)(cid:29)(cid:26)(cid:41)(cid:25)(cid:2)(cid:53)(cid:53)(cid:37)(cid:16)(cid:34)(cid:33,Unknown,27054.0
Unknown,Unknown,10,Unknown,Unknown,Unknown,Unknown,Banque Inconnue,Unknown,10.0
Unknown,Unknown,20,Unknown,Unknown,Unknown,Unknown,Banque Inconnue,Unknown,30.0
Unknown,Unknown,21,Unknown,Unknown,Unknown,Unknown,Banque Inconnue,Unknown,51.0
Unknown,Unknown,41,Unknown,Unknown,Unknown,Unknown,Banque Inconnue,Unknown,92.0
Unknown,Unknown,25,Unknown,Unknown,Unknown,Unknown,Banque Inconnue,Unknown,117.0
Unknown,Unknown,27,Unknown,Unknown,Unknown,Unknown,Banque Inconnue,Unknown,144.0
Unknown,Unknown,2,Unknown,Unknown,Unknown,Unknown,Banque Inconnue,Unknown,146.0
Unknown,Unknown,22,Unknown,Unknown,Unknown,Unknown,Banque Inconnue,Unknown,168.0
Unknown,Unknown,25,Unknown,Unknown,Unknown,Unknown,Banque Inconnue,Unknown,193.0
Unknown,Unknown,27,Unknown,Unknown,Unknown,Unknown,Banque Inconnue,Unknown,220.0
Unknown,Unknown,2,Unknown,Unknown,Unknown,Unknown,Banque Inconnue,Unknown,222.0
Unknown,Unknown,31,Unknown,Unknown,Unknown,Unknown,Banque Inconnue,Unknown,253.0
Unknown,Unknown,29,Unknown,Unknown,Unknown,Unknown,Banque Inconnue,Unknown,282.0
Unknown,Unknown,26,Unknown,Unknown,Unknown,Unknown,Banque Inconnue,Unknown,308.0
Unknown,Unknown,41,Unknown,Unknown,Unknown,Unknown,Banque Inconnue,Unknown,349.0
Unknown,Unknown,25,Unknown,Unknown,Unknown,Unknown,Banque Inconnue,Unknown,374.0
Unknown,Unknown,27,Unknown,Unknown,Unknown,Unknown,Banque Inconnue,Unknown,401.0
Unknown,Unknown,2,Unknown,Unknown,Unknown,Unknown,Banque Inconnue,Unknown,403.0
Unknown,Unknown,51,Unknown,Unknown,Unknown,Unknown,Banque Inconnue,Unknown,454.0
Unknown,Unknown,25,Unknown,Unknown,Unknown,Unknown,Banque Inconnue,Unknown,479.0
Unknown,Unknown,2,Unknown,Unknown,Unknown,Unknown,Banque Inconnue,Unknown,481.0
Unknown,Unknown,48,Unknown,Unknown,Unknown,Unknown,Banque Inconnue,Unknown,529.0
Unknown,Unknown,20,Unknown,Unknown,Unknown,Unknown,Banque Inconnue,Unknown,549.0
Unknown,Unknown,41,Unknown,Unknown,Unknown,Unknown,Banque Inconnue,Unknown,590.0
Unknown,Unknown,26,Unknown,Unknown,Unknown,Unknown,Banque Inconnue,Unknown,616.0
Unknown,Unknown,25,Unknown,Unknown,Unknown,Unknown,Banque Inconnue,Unknown,641.0
Unknown,Unknown,2,Unknown,Unknown,Unknown,Unknown,Banque Inconnue,Unknown,643.0
Unknown,Unknown,31,Unknown,Unknown,Unknown,Unknown,Banque Inconnue,Unknown,674.0
Unknown,Unknown,20,Unknown,Unknown,Unknown,Unknown,Banque Inconnue,Unknown,694.0
Unknown,Unknown,23,Unknown,Unknown,Unknown,Unknown,Banque Inconnue,Unknown,717.0
Unknown,Unknown,55,Unknown,Unknown,Unknown,Unknown,Banque Inconnue,Unknown,772.0
Unknown,Unknown,41,Unknown,Unknown,Unknown,Unknown,Banque Inconnue,Unknown,813.0
Unknown,Unknown,25,Unknown,Unknown,Unknown,Unknown,Banque Inconnue,Unknown,838.0
Unknown,Unknown,2,Unknown,Unknown,Unknown,Unknown,Banque Inconnue,Unknown,840.0
Unknown,Unknown,38,Unknown,Unknown,Unknown,Unknown,Banque Inconnue,Unknown,878.0
Unknown,Unknown,20,Unknown,Unknown,Unknown,Unknown,Banque Inconnue,Unknown,898.0
Unknown,Unknown,30,Unknown,Unknown,Unknown,Unknown,Banque Inconnue,Unknown,928.0
Unknown,Unknown,41,Unknown,Unknown,Unknown,Unknown,Banque Inconnue,Unknown,969.0
Unknown,Unknown,20,Unknown,Unknown,Unknown,Unknown,Banque Inconnue,Unknown,989.0
Unknown,Unknown,2,Unknown,Unknown,Unknown,Unknown,Banque Inconnue,Unknown,991.0
Unknown,Unknown,27,Unknown,Unknown,Unknown,Unknown,Banque Inconnue,Unknown,1018.0
Unknown,Unknown,20,Unknown,Unknown,Unknown,Unknown,Banque Inconnue,Unknown,1038.0
Unknown,Unknown,30,Unknown,Unknown,Unknown,Unknown,Banque Inconnue,Unknown,1068.0
Unknown,Unknown,41,Unknown,Unknown,Unknown,Unknown,Banque Inconnue,Unknown,1109.0
Unknown,Unknown,2,Unknown,Unknown,Unknown,Unknown,Banque Inconnue,Unknown,1111.0
Unknown,Unknown,31,Unknown,Unknown,Unknown,Unknown,Banque Inconnue,Unknown,1142.0
Unknown,Unknown,20,Unknown,Unknown,Unknown,Unknown,Banque Inconnue,Unknown,1162.0
Unknown,Unknown,23,Unknown,Unknown,Unknown,Unknown,Banque Inconnue,Unknown,1185.0
Unknown,Unknown,55,Unknown,Unknown,Unknown,Unknown,Banque Inconnue,Unknown,1240.0
Unknown,Unknown,29,Unknown,Unknown,Unknown,Unknown,Banque Inconnue,Unknown,1269.0
Unknown,Unknown,41,Unknown,Unknown,Unknown,Unknown,Banque Inconnue,Unknown,1310.0
Unknown,Unknown,24,Unknown,Unknown,Unknown,Unknown,Banque Inconnue,Unknown,1334.0
Unknown,Unknown,50,Unknown,Unknown,Unknown,Unknown,Banque Inconnue,Unknown,1384.0
Unknown,Unknown,22,Unknown,Unknown,Unknown,Unknown,Banque Inconnue,Unknown,1406.0
Unknown,Unknown,25,Unknown,Unknown,Unknown,Unknown,Banque Inconnue,Unknown,1431.0
Unknown,Unknown,27,Unknown,Unknown,Unknown,Unknown,Banque Inconnue,Unknown,1458.0
Unknown,Unknown,2,Unknown,Unknown,Unknown,Unknown,Banque Inconnue,Unknown,1460.0
Unknown,Unknown,29,Unknown,Unknown,Unknown,Unknown,Banque Inconnue,Unknown,1489.0
Unknown,Unknown,48,Unknown,Unknown,Unknown,Unknown,Banque Inconnue,Unknown,1537.0
Unknown,Unknown,25,Unknown,Unknown,Unknown,Unknown,Banque Inconnue,Unknown,1562.0
Unknown,Unknown,31,Unknown,Unknown,Unknown,Unknown,Banque Inconnue,Unknown,1593.0
Unknown,Unknown,2,Unknown,Unknown,Unknown,Unknown,Banque Inconnue,Unknown,1595.0
Unknown,Unknown,49,Unknown,Unknown,Unknown,Unknown,Banque Inconnue,Unknown,1644.0
Unknown,Unknown,55,Unknown,Unknown,Unknown,Unknown,Banque Inconnue,Unknown,1699.0
Unknown,Unknown,55,Unknown,Unknown,Unknown,Unknown,Banque Inconnue,Unknown,1754.0
Unknown,Unknown,22,Unknown,Unknown,Unknown,Unknown,Banque Inconnue,Unknown,1776.0
Unknown,Unknown,25,Unknown,Unknown,Unknown,Unknown,Banque Inconnue,Unknown,1801.0
Unknown,Unknown,2,Unknown,Unknown,Unknown,Unknown,Banque Inconnue,Unknown,1803.0
Unknown,Unknown,39,Unknown,Unknown,Unknown,Unknown,Banque Inconnue,Unknown,1842.0
Unknown,Unknown,29,Unknown,Unknown,Unknown,Unknown,Banque Inconnue,Unknown,1871.0
Unknown,Unknown,72,Unknown,Unknown,Unknown,Unknown,Banque Inconnue,Unknown,1943.0
Unknown,Unknown,2,Unknown,Unknown,Unknown,Unknown,Banque Inconnue,Unknown,1945.0
Unknown,Unknown,25,Unknown,Unknown,Unknown,Unknown,Banque Inconnue,Unknown,1970.0
Unknown,Unknown,41,Unknown,Unknown,Unknown,Unknown,Banque Inconnue,Unknown,2011.0
Unknown,Unknown,2,Unknown,Unknown,Unknown,Unknown,Banque Inconnue,Unknown,2013.0
Unknown,Unknown,46,Unknown,Unknown,Unknown,Unknown,Banque Inconnue,Unknown,2059.0
Unknown,Unknown,20,Unknown,Unknown,Unknown,Unknown,Banque Inconnue,Unknown,2079.0
Unknown,Unknown,20,Unknown,Unknown,Unknown,Unknown,Banque Inconnue,Unknown,2099.0
Unknown,Unknown,69,Unknown,Unknown,Unknown,Unknown,Banque Inconnue,Unknown,2168.0
Unknown,Unknown,22,Unknown,Unknown,Unknown,Unknown,Banque Inconnue,Unknown,2190.0
Unknown,Unknown,25,Unknown,Unknown,Unknown,Unknown,Banque Inconnue,Unknown,2215.0
Unknown,Unknown,2,Unknown,Unknown,Unknown,Unknown,Banque Inconnue,Unknown,2217.0
Unknown,Unknown,39,Unknown,Unknown,Unknown,Unknown,Banque Inconnue,Unknown,2256.0
Unknown,Unknown,29,Unknown,Unknown,Unknown,Unknown,Banque Inconnue,Unknown,2285.0
Unknown,Unknown,72,Unknown,Unknown,Unknown,Unknown,Banque Inconnue,Unknown,2357.0
Unknown,Unknown,74,Unknown,Unknown,Unknown,Unknown,Banque Inconnue,Unknown,2431.0
Unknown,Unknown,38,Unknown,Unknown,Unknown,Unknown,Banque Inconnue,Unknown,2469.0
Unknown,Unknown,20,Unknown,Unknown,Unknown,Unknown,Banque Inconnue,Unknown,2489.0
Unknown,Unknown,30,Unknown,Unknown,Unknown,Unknown,Banque Inconnue,Unknown,2519.0
Unknown,Unknown,41,Unknown,Unknown,Unknown,Unknown,Banque Inconnue,Unknown,2560.0
Unknown,Unknown,20,Unknown,Unknown,Unknown,Unknown,Banque Inconnue,Unknown,2580.0
Unknown,Unknown,19,Unknown,Unknown,Unknown,Unknown,Banque Inconnue,Unknown,2599.0
Unknown,Unknown,2,Unknown,Unknown,Unknown,Unknown,Banque Inconnue,Unknown,2601.0
Unknown,Unknown,21,Unknown,Unknown,Unknown,Unknown,Banque Inconnue,Unknown,2622.0
Unknown,Unknown,30,Unknown,Unknown,Unknown,Unknown,Banque Inconnue,Unknown,2652.0
Unknown,Unknown,25,Unknown,Unknown,Unknown,Unknown,Banque Inconnue,Unknown,2677.0
Unknown,Unknown,2,Unknown,Unknown,Unknown,Unknown,Banque Inconnue,Unknown,2679.0
Unknown,Unknown,23,Unknown,Unknown,Unknown,Unknown,Banque Inconnue,Unknown,2702.0
Unknown,Unknown,29,Unknown,Unknown,Unknown,Unknown,Banque Inconnue,Unknown,2731.0
Unknown,Unknown,26,Unknown,Unknown,Unknown,Unknown,Banque Inconnue,Unknown,2757.0
Unknown,Unknown,59,Unknown,Unknown,Unknown,Unknown,Banque Inconnue,Unknown,2816.0
Unknown,Unknown,21,Unknown,Unknown,Unknown,Unknown,Banque Inconnue,Unknown,2837.0
Unknown,Unknown,25,Unknown,Unknown,Unknown,Unknown,Banque Inconnue,Unknown,2862.0
Unknown,Unknown,2,Unknown,Unknown,Unknown,Unknown,Banque Inconnue,Unknown,2864.0
Unknown,Unknown,51,Unknown,Unknown,Unknown,Unknown,Banque Inconnue,Unknown,2915.0
Unknown,Unknown,25,Unknown,Unknown,Unknown,Unknown,Banque Inconnue,Unknown,2940.0
Unknown,Unknown,2,Unknown,Unknown,Unknown,Unknown,Banque Inconnue,Unknown,2942.0
Unknown,Unknown,11,Unknown,Unknown,Unknown,Unknown,Banque Inconnue,Unknown,2953.0
Unknown,Unknown,14,Unknown,Unknown,Unknown,Unknown,Banque Inconnue,Unknown,2967.0
Unknown,Unknown,7,Unknown,Unknown,Unknown,Unknown,Banque Inconnue,Unknown,2974.0
Unknown,Unknown,8,Unknown,Unknown,Unknown,Unknown,Banque Inconnue,Unknown,2982.0
Unknown,Unknown,52,Unknown,Unknown,Unknown,Unknown,Banque Inconnue,Unknown,3034.0
Unknown,Unknown,49,Unknown,Unknown,Unknown,Unknown,Banque Inconnue,Unknown,3083.0
Unknown,Unknown,2,Unknown,Unknown,Unknown,Unknown,Banque Inconnue,Unknown,3085.0
Unknown,Unknown,9,Unknown,Unknown,Unknown,Unknown,Banque Inconnue,Unknown,3094.0
Unknown,Unknown,49,Unknown,Unknown,Unknown,Unknown,Banque Inconnue,Unknown,3143.0
Unknown,Unknown,9,Unknown,Unknown,Unknown,Unknown,Banque Inconnue,Unknown,3152.0
Unknown,Unknown,19,Unknown,Unknown,Unknown,Unknown,Banque Inconnue,Unknown,3171.0
Unknown,Unknown,2,Unknown,Unknown,Unknown,Unknown,Banque Inconnue,Unknown,3173.0
Unknown,Unknown,29,Unknown,Unknown,Unknown,Unknown,Banque Inconnue,Unknown,3202.0
Unknown,Unknown,21,Unknown,Unknown,Unknown,Unknown,Banque Inconnue,Unknown,3223.0
Unknown,Unknown,2,Unknown,Unknown,Unknown,Unknown,Banque Inconnue,Unknown,3225.0
Unknown,Unknown,31,Unknown,Unknown,Unknown,Unknown,Banque Inconnue,Unknown,3256.0
Unknown,Unknown,29,Unknown,Unknown,Unknown,Unknown,Banque Inconnue,Unknown,3285.0
Unknown,Unknown,55,Unknown,Unknown,Unknown,Unknown,Banque Inconnue,Unknown,3340.0
Unknown,Unknown,24,Unknown,Unknown,Unknown,Unknown,Banque Inconnue,Unknown,3364.0
Unknown,Unknown,41,Unknown,Unknown,Unknown,Unknown,Banque Inconnue,Unknown,3405.0
Unknown,Unknown,29,Unknown,Unknown,Unknown,Unknown,Banque Inconnue,Unknown,3434.0
Unknown,Unknown,22,Unknown,Unknown,Unknown,Unknown,Banque Inconnue,Unknown,3456.0
Unknown,Unknown,2,Unknown,Unknown,Unknown,Unknown,Banque Inconnue,Unknown,3458.0
Unknown,Unknown,51,Unknown,Unknown,Unknown,Unknown,Banque Inconnue,Unknown,3509.0
Unknown,Unknown,25,Unknown,Unknown,Unknown,Unknown,Banque Inconnue,Unknown,3534.0
Unknown,Unknown,2,Unknown,Unknown,Unknown,Unknown,Banque Inconnue,Unknown,3536.0
Unknown,Unknown,1,Unknown,Unknown,Unknown,Unknown,Banque Inconnue,Unknown,3537.0
Unknown,Unknown,34,Unknown,Unknown,Unknown,Unknown,Banque Inconnue,Unknown,3571.0
Unknown,Unknown,18,Unknown,Unknown,Unknown,Unknown,Banque Inconnue,Unknown,3589.0
Unknown,Unknown,2,Unknown,Unknown,Unknown,Unknown,Banque Inconnue,Unknown,3591.0
Unknown,Unknown,33,Unknown,Unknown,Unknown,Unknown,Banque Inconnue,Unknown,3624.0
Unknown,Unknown,33,Unknown,Unknown,Unknown,Unknown,Banque Inconnue,Unknown,3657.0
Unknown,Unknown,34,Unknown,Unknown,Unknown,Unknown,Banque Inconnue,Unknown,3691.0
Unknown,Unknown,2,Unknown,Unknown,Unknown,Unknown,Banque Inconnue,Unknown,3693.0
Unknown,Unknown,37,Unknown,Unknown,Unknown,Unknown,Banque Inconnue,Unknown,3730.0
Unknown,Unknown,34,Unknown,Unknown,Unknown,Unknown,Banque Inconnue,Unknown,3764.0
Unknown,Unknown,2,Unknown,Unknown,Unknown,Unknown,Banque Inconnue,Unknown,3766.0
Unknown,Unknown,44,Unknown,Unknown,Unknown,Unknown,Banque Inconnue,Unknown,3810.0
Unknown,Unknown,2,Unknown,Unknown,Unknown,Unknown,Banque Inconnue,Unknown,3812.0
Unknown,Unknown,15,Unknown,Unknown,Unknown,Unknown,Banque Inconnue,Unknown,3827.0
Unknown,Unknown,2,Unknown,Unknown,Unknown,Unknown,Banque Inconnue,Unknown,3829.0
Unknown,Unknown,27,Unknown,Unknown,Unknown,Unknown,Banque Inconnue,Unknown,3856.0
Unknown,Unknown,24,Unknown,Unknown,Unknown,Unknown,Banque Inconnue,Unknown,3880.0
Unknown,Unknown,58,Unknown,Unknown,Unknown,Unknown,Banque Inconnue,Unknown,3938.0
Unknown,Unknown,69,Unknown,Unknown,Unknown,Unknown,Banque Inconnue,Unknown,4007.0
Unknown,Unknown,25,Unknown,Unknown,Unknown,Unknown,Banque Inconnue,Unknown,4032.0
Unknown,Unknown,2,Unknown,Unknown,Unknown,Unknown,Banque Inconnue,Unknown,4034.0
Unknown,Unknown,27,Unknown,Unknown,Unknown,Unknown,Banque Inconnue,Unknown,4061.0
Unknown,Unknown,20,Unknown,Unknown,Unknown,Unknown,Banque Inconnue,Unknown,4081.0
Unknown,Unknown,31,Unknown,Unknown,Unknown,Unknown,Banque Inconnue,Unknown,4112.0
Unknown,Unknown,24,Unknown,Unknown,Unknown,Unknown,Banque Inconnue,Unknown,4136.0
Unknown,Unknown,29,Unknown,Unknown,Unknown,Unknown,Banque Inconnue,Unknown,4165.0
Unknown,Unknown,22,Unknown,Unknown,Unknown,Unknown,Banque Inconnue,Unknown,4187.0
Unknown,Unknown,2,Unknown,Unknown,Unknown,Unknown,Banque Inconnue,Unknown,4189.0
Unknown,Unknown,1,Unknown,Unknown,Unknown,Unknown,Banque Inconnue,Unknown,4190.0
Unknown,Unknown,18,Unknown,Unknown,Unknown,Unknown,Banque Inconnue,Unknown,4208.0
Unknown,Unknown,2,Unknown,Unknown,Unknown,Unknown,Banque Inconnue,Unknown,4210.0
Unknown,Unknown,50,Unknown,Unknown,Unknown,Unknown,Banque Inconnue,Unknown,4260.0
Unknown,Unknown,24,Unknown,Unknown,Unknown,Unknown,Banque Inconnue,Unknown,4284.0
Unknown,Unknown,27,Unknown,Unknown,Unknown,Unknown,Banque Inconnue,Unknown,4311.0
Unknown,Unknown,2,Unknown,Unknown,Unknown,Unknown,Banque Inconnue,Unknown,4313.0
Unknown,Unknown,26,Unknown,Unknown,Unknown,Unknown,Banque Inconnue,Unknown,4339.0
Unknown,Unknown,21,Unknown,Unknown,Unknown,Unknown,Banque Inconnue,Unknown,4360.0
Unknown,Unknown,25,Unknown,Unknown,Unknown,Unknown,Banque Inconnue,Unknown,4385.0
Unknown,Unknown,2,Unknown,Unknown,Unknown,Unknown,Banque Inconnue,Unknown,4387.0
Unknown,Unknown,14,Unknown,Unknown,Unknown,Unknown,Banque Inconnue,Unknown,4401.0
Unknown,Unknown,29,Unknown,Unknown,Unknown,Unknown,Banque Inconnue,Unknown,4430.0
Unknown,Unknown,2,Unknown,Unknown,Unknown,Unknown,Banque Inconnue,Unknown,4432.0
Unknown,Unknown,28,Unknown,Unknown,Unknown,Unknown,Banque Inconnue,Unknown,4460.0
Unknown,Unknown,29,Unknown,Unknown,Unknown,Unknown,Banque Inconnue,Unknown,4489.0
Unknown,Unknown,72,Unknown,Unknown,Unknown,Unknown,Banque Inconnue,Unknown,4561.0
Unknown,Unknown,25,Unknown,Unknown,Unknown,Unknown,Banque Inconnue,Unknown,4586.0
Unknown,Unknown,41,Unknown,Unknown,Unknown,Unknown,Banque Inconnue,Unknown,4627.0
Unknown,Unknown,41,Unknown,Unknown,Unknown,Unknown,Banque Inconnue,Unknown,4668.0
Unknown,Unknown,25,Unknown,Unknown,Unknown,Unknown,Banque Inconnue,Unknown,4693.0
Unknown,Unknown,19,Unknown,Unknown,Unknown,Unknown,Banque Inconnue,Unknown,4712.0
Unknown,Unknown,2,Unknown,Unknown,Unknown,Unknown,Banque Inconnue,Unknown,4714.0
Unknown,Unknown,16,Unknown,Unknown,Unknown,Unknown,Banque Inconnue,Unknown,4730.0
Unknown,Unknown,34,Unknown,Unknown,Unknown,Unknown,Banque Inconnue,Unknown,4764.0
Unknown,Unknown,18,Unknown,Unknown,Unknown,Unknown,Banque Inconnue,Unknown,4782.0
Unknown,Unknown,18,Unknown,Unknown,Unknown,Unknown,Banque Inconnue,Unknown,4800.0
Unknown,Unknown,33,Unknown,Unknown,Unknown,Unknown,Banque Inconnue,Unknown,4833.0
Unknown,Unknown,2,Unknown,Unknown,Unknown,Unknown,Banque Inconnue,Unknown,4835.0
Unknown,Unknown,39,Unknown,Unknown,Unknown,Unknown,Banque Inconnue,Unknown,4874.0
Unknown,Unknown,29,Unknown,Unknown,Unknown,Unknown,Banque Inconnue,Unknown,4903.0
Unknown,Unknown,26,Unknown,Unknown,Unknown,Unknown,Banque Inconnue,Unknown,4929.0
Unknown,Unknown,24,Unknown,Unknown,Unknown,Unknown,Banque Inconnue,Unknown,4953.0
Unknown,Unknown,27,Unknown,Unknown,Unknown,Unknown,Banque Inconnue,Unknown,4980.0
Unknown,Unknown,2,Unknown,Unknown,Unknown,Unknown,Banque Inconnue,Unknown,4982.0
Unknown,Unknown,15,Unknown,Unknown,Unknown,Unknown,Banque Inconnue,Unknown,4997.0
Unknown,Unknown,2,Unknown,Unknown,Unknown,Unknown,Banque Inconnue,Unknown,4999.0
Unknown,Unknown,3,Unknown,Unknown,Unknown,Unknown,Banque Inconnue,Unknown,5002.0
Unknown,Unknown,12,Unknown,Unknown,Unknown,Unknown,Banque Inconnue,Unknown,5014.0
Unknown,Unknown,9,Unknown,Unknown,Unknown,Unknown,Banque Inconnue,Unknown,5023.0
Unknown,Unknown,2,Unknown,Unknown,Unknown,Unknown,Banque Inconnue,Unknown,5025.0
Unknown,Unknown,39,Unknown,Unknown,Unknown,Unknown,Banque Inconnue,Unknown,5064.0
Unknown,Unknown,29,Unknown,Unknown,Unknown,Unknown,Banque Inconnue,Unknown,5093.0
Unknown,Unknown,26,Unknown,Unknown,Unknown,Unknown,Banque Inconnue,Unknown,5119.0
Unknown,Unknown,24,Unknown,Unknown,Unknown,Unknown,Banque Inconnue,Unknown,5143.0
Unknown,Unknown,27,Unknown,Unknown,Unknown,Unknown,Banque Inconnue,Unknown,5170.0
Unknown,Unknown,2,Unknown,Unknown,Unknown,Unknown,Banque Inconnue,Unknown,5172.0
Unknown,Unknown,30,Unknown,Unknown,Unknown,Unknown,Banque Inconnue,Unknown,5202.0
Unknown,Unknown,75,Unknown,Unknown,Unknown,Unknown,Banque Inconnue,Unknown,5277.0
Unknown,Unknown,35,Unknown,Unknown,Unknown,Unknown,Banque Inconnue,Unknown,5312.0
Unknown,Unknown,17,Unknown,Unknown,Unknown,Unknown,Banque Inconnue,Unknown,5329.0
Unknown,Unknown,33,Unknown,Unknown,Unknown,Unknown,Banque Inconnue,Unknown,5362.0
Unknown,Unknown,2,Unknown,Unknown,Unknown,Unknown,Banque Inconnue,Unknown,5364.0
Unknown,Unknown,36,Unknown,Unknown,Unknown,Unknown,Banque Inconnue,Unknown,5400.0
Unknown,Unknown,35,Unknown,Unknown,Unknown,Unknown,Banque Inconnue,Unknown,5435.0
Unknown,Unknown,33,Unknown,Unknown,Unknown,Unknown,Banque Inconnue,Unknown,5468.0
Unknown,Unknown,2,Unknown,Unknown,Unknown,Unknown,Banque Inconnue,Unknown,5470.0
Unknown,Unknown,32,Unknown,Unknown,Unknown,Unknown,Banque Inconnue,Unknown,5502.0
Unknown,Unknown,1,Unknown,Unknown,Unknown,Unknown,Banque Inconnue,Unknown,5503.0
Unknown,Unknown,32,Unknown,Unknown,Unknown,Unknown,Banque Inconnue,Unknown,5535.0
Unknown,Unknown,74,Unknown,Unknown,Unknown,Unknown,Banque Inconnue,Unknown,5609.0
Unknown,Unknown,11,Unknown,Unknown,Unknown,Unknown,Banque Inconnue,Unknown,5620.0
Unknown,Unknown,22,Unknown,Unknown,Unknown,Unknown,Banque Inconnue,Unknown,5642.0
Unknown,Unknown,24,Unknown,Unknown,Unknown,Unknown,Banque Inconnue,Unknown,5666.0
Unknown,Unknown,30,Unknown,Unknown,Unknown,Unknown,Banque Inconnue,Unknown,5696.0
Unknown,Unknown,51,Unknown,Unknown,Unknown,Unknown,Banque Inconnue,Unknown,5747.0
Unknown,Unknown,29,Unknown,Unknown,Unknown,Unknown,Banque Inconnue,Unknown,5776.0
Unknown,Unknown,2,Unknown,Unknown,Unknown,Unknown,Banque Inconnue,Unknown,5778.0
Unknown,Unknown,25,Unknown,Unknown,Unknown,Unknown,Banque Inconnue,Unknown,5803.0
Unknown,Unknown,27,Unknown,Unknown,Unknown,Unknown,Banque Inconnue,Unknown,5830.0
Unknown,Unknown,41,Unknown,Unknown,Unknown,Unknown,Banque Inconnue,Unknown,5871.0
Unknown,Unknown,2,Unknown,Unknown,Unknown,Unknown,Banque Inconnue,Unknown,5873.0
Unknown,Unknown,29,Unknown,Unknown,Unknown,Unknown,Banque Inconnue,Unknown,5902.0
Unknown,Unknown,69,Unknown,Unknown,Unknown,Unknown,Banque Inconnue,Unknown,5971.0
Unknown,Unknown,26,Unknown,Unknown,Unknown,Unknown,Banque Inconnue,Unknown,5997.0
Unknown,Unknown,42,Unknown,Unknown,Unknown,Unknown,Banque Inconnue,Unknown,6039.0
Unknown,Unknown,42,Unknown,Unknown,Unknown,Unknown,Banque Inconnue,Unknown,6081.0
Unknown,Unknown,2,Unknown,Unknown,Unknown,Unknown,Banque Inconnue,Unknown,6083.0
Unknown,Unknown,55,Unknown,Unknown,Unknown,Unknown,Banque Inconnue,Unknown,6138.0
Unknown,Unknown,29,Unknown,Unknown,Unknown,Unknown,Banque Inconnue,Unknown,6167.0
Unknown,Unknown,26,Unknown,Unknown,Unknown,Unknown,Banque Inconnue,Unknown,6193.0
Unknown,Unknown,2,Unknown,Unknown,Unknown,Unknown,Banque Inconnue,Unknown,6195.0
Unknown,Unknown,22,Unknown,Unknown,Unknown,Unknown,Banque Inconnue,Unknown,6217.0
Unknown,Unknown,68,Unknown,Unknown,Unknown,Unknown,Banque Inconnue,Unknown,6285.0
Unknown,Unknown,49,Unknown,Unknown,Unknown,Unknown,Banque Inconnue,Unknown,6334.0
Unknown,Unknown,21,Unknown,Unknown,Unknown,Unknown,Banque Inconnue,Unknown,6355.0
Unknown,Unknown,41,Unknown,Unknown,Unknown,Unknown,Banque Inconnue,Unknown,6396.0
Unknown,Unknown,20,Unknown,Unknown,Unknown,Unknown,Banque Inconnue,Unknown,6416.0
Unknown,Unknown,26,Unknown,Unknown,Unknown,Unknown,Banque Inconnue,Unknown,6442.0
Unknown,Unknown,24,Unknown,Unknown,Unknown,Unknown,Banque Inconnue,Unknown,6466.0
Unknown,Unknown,41,Unknown,Unknown,Unknown,Unknown,Banque Inconnue,Unknown,6507.0
Unknown,Unknown,42,Unknown,Unknown,Unknown,Unknown,Banque Inconnue,Unknown,6549.0
Unknown,Unknown,2,Unknown,Unknown,Unknown,Unknown,Banque Inconnue,Unknown,6551.0
Unknown,Unknown,51,Unknown,Unknown,Unknown,Unknown,Banque Inconnue,Unknown,6602.0
Unknown,Unknown,25,Unknown,Unknown,Unknown,Unknown,Banque Inconnue,Unknown,6627.0
Unknown,Unknown,2,Unknown,Unknown,Unknown,Unknown,Banque Inconnue,Unknown,6629.0
Unknown,Unknown,12,Unknown,Unknown,Unknown,Unknown,Banque Inconnue,Unknown,6641.0
Unknown,Unknown,20,Unknown,Unknown,Unknown,Unknown,Banque Inconnue,Unknown,6661.0
Unknown,Unknown,30,Unknown,Unknown,Unknown,Unknown,Banque Inconnue,Unknown,6691.0
Unknown,Unknown,41,Unknown,Unknown,Unknown,Unknown,Banque Inconnue,Unknown,6732.0
Unknown,Unknown,26,Unknown,Unknown,Unknown,Unknown,Banque Inconnue,Unknown,6758.0
Unknown,Unknown,56,Unknown,Unknown,Unknown,Unknown,Banque Inconnue,Unknown,6814.0
Unknown,Unknown,22,Unknown,Unknown,Unknown,Unknown,Banque Inconnue,Unknown,6836.0
Unknown,Unknown,25,Unknown,Unknown,Unknown,Unknown,Banque Inconnue,Unknown,6861.0
Unknown,Unknown,2,Unknown,Unknown,Unknown,Unknown,Banque Inconnue,Unknown,6863.0
Unknown,Unknown,39,Unknown,Unknown,Unknown,Unknown,Banque Inconnue,Unknown,6902.0
Unknown,Unknown,26,Unknown,Unknown,Unknown,Unknown,Banque Inconnue,Unknown,6928.0
Unknown,Unknown,21,Unknown,Unknown,Unknown,Unknown,Banque Inconnue,Unknown,6949.0
Unknown,Unknown,51,Unknown,Unknown,Unknown,Unknown,Banque Inconnue,Unknown,7000.0
Unknown,Unknown,25,Unknown,Unknown,Unknown,Unknown,Banque Inconnue,Unknown,7025.0
Unknown,Unknown,30,Unknown,Unknown,Unknown,Unknown,Banque Inconnue,Unknown,7055.0
Unknown,Unknown,41,Unknown,Unknown,Unknown,Unknown,Banque Inconnue,Unknown,7096.0
Unknown,Unknown,24,Unknown,Unknown,Unknown,Unknown,Banque Inconnue,Unknown,7120.0
Unknown,Unknown,25,Unknown,Unknown,Unknown,Unknown,Banque Inconnue,Unknown,7145.0
Unknown,Unknown,22,Unknown,Unknown,Unknown,Unknown,Banque Inconnue,Unknown,7167.0
Unknown,Unknown,2,Unknown,Unknown,Unknown,Unknown,Banque Inconnue,Unknown,7169.0
Unknown,Unknown,25,Unknown,Unknown,Unknown,Unknown,Banque Inconnue,Unknown,7194.0
Unknown,Unknown,41,Unknown,Unknown,Unknown,Unknown,Banque Inconnue,Unknown,7235.0
Unknown,Unknown,2,Unknown,Unknown,Unknown,Unknown,Banque Inconnue,Unknown,7237.0
Unknown,Unknown,51,Unknown,Unknown,Unknown,Unknown,Banque Inconnue,Unknown,7288.0
Unknown,Unknown,25,Unknown,Unknown,Unknown,Unknown,Banque Inconnue,Unknown,7313.0
Unknown,Unknown,2,Unknown,Unknown,Unknown,Unknown,Banque Inconnue,Unknown,7315.0
Unknown,Unknown,3,Unknown,Unknown,Unknown,Unknown,Banque Inconnue,Unknown,7318.0
Unknown,Unknown,42,Unknown,Unknown,Unknown,Unknown,Banque Inconnue,Unknown,7360.0
Unknown,Unknown,27,Unknown,Unknown,Unknown,Unknown,Banque Inconnue,Unknown,7387.0
Unknown,Unknown,20,Unknown,Unknown,Unknown,Unknown,Banque Inconnue,Unknown,7407.0
Unknown,Unknown,22,Unknown,Unknown,Unknown,Unknown,Banque Inconnue,Unknown,7429.0
Unknown,Unknown,21,Unknown,Unknown,Unknown,Unknown,Banque Inconnue,Unknown,7450.0
Unknown,Unknown,41,Unknown,Unknown,Unknown,Unknown,Banque Inconnue,Unknown,7491.0
Unknown,Unknown,24,Unknown,Unknown,Unknown,Unknown,Banque Inconnue,Unknown,7515.0
Unknown,Unknown,20,Unknown,Unknown,Unknown,Unknown,Banque Inconnue,Unknown,7535.0
Unknown,Unknown,30,Unknown,Unknown,Unknown,Unknown,Banque Inconnue,Unknown,7565.0
Unknown,Unknown,2,Unknown,Unknown,Unknown,Unknown,Banque Inconnue,Unknown,7567.0
Unknown,Unknown,66,Unknown,Unknown,Unknown,Unknown,Banque Inconnue,Unknown,7633.0
Unknown,Unknown,49,Unknown,Unknown,Unknown,Unknown,Banque Inconnue,Unknown,7682.0
Unknown,Unknown,12,Unknown,Unknown,Unknown,Unknown,Banque Inconnue,Unknown,7694.0
Unknown,Unknown,39,Unknown,Unknown,Unknown,Unknown,Banque Inconnue,Unknown,7733.0
Unknown,Unknown,3,Unknown,Unknown,Unknown,Unknown,Banque Inconnue,Unknown,7736.0
Unknown,Unknown,67,Unknown,Unknown,Unknown,Unknown,Banque Inconnue,Unknown,7803.0
Unknown,Unknown,2,Unknown,Unknown,Unknown,Unknown,Banque Inconnue,Unknown,7805.0
Unknown,Unknown,25,Unknown,Unknown,Unknown,Unknown,Banque Inconnue,Unknown,7830.0
Unknown,Unknown,30,Unknown,Unknown,Unknown,Unknown,Banque Inconnue,Unknown,7860.0
Unknown,Unknown,2,Unknown,Unknown,Unknown,Unknown,Banque Inconnue,Unknown,7862.0
Unknown,Unknown,41,Unknown,Unknown,Unknown,Unknown,Banque Inconnue,Unknown,7903.0
Unknown,Unknown,29,Unknown,Unknown,Unknown,Unknown,Banque Inconnue,Unknown,7932.0
Unknown,Unknown,30,Unknown,Unknown,Unknown,Unknown,Banque Inconnue,Unknown,7962.0
Unknown,Unknown,41,Unknown,Unknown,Unknown,Unknown,Banque Inconnue,Unknown,8003.0
Unknown,Unknown,2,Unknown,Unknown,Unknown,Unknown,Banque Inconnue,Unknown,8005.0
Unknown,Unknown,59,Unknown,Unknown,Unknown,Unknown,Banque Inconnue,Unknown,8064.0
Unknown,Unknown,21,Unknown,Unknown,Unknown,Unknown,Banque Inconnue,Unknown,8085.0
Unknown,Unknown,68,Unknown,Unknown,Unknown,Unknown,Banque Inconnue,Unknown,8153.0
Unknown,Unknown,42,Unknown,Unknown,Unknown,Unknown,Banque Inconnue,Unknown,8195.0
Unknown,Unknown,41,Unknown,Unknown,Unknown,Unknown,Banque Inconnue,Unknown,8236.0
Unknown,Unknown,29,Unknown,Unknown,Unknown,Unknown,Banque Inconnue,Unknown,8265.0
Unknown,Unknown,50,Unknown,Unknown,Unknown,Unknown,Banque Inconnue,Unknown,8315.0
Unknown,Unknown,22,Unknown,Unknown,Unknown,Unknown,Banque Inconnue,Unknown,8337.0
Unknown,Unknown,24,Unknown,Unknown,Unknown,Unknown,Banque Inconnue,Unknown,8361.0
Unknown,Unknown,27,Unknown,Unknown,Unknown,Unknown,Banque Inconnue,Unknown,8388.0
Unknown,Unknown,27,Unknown,Unknown,Unknown,Unknown,Banque Inconnue,Unknown,8415.0
Unknown,Unknown,25,Unknown,Unknown,Unknown,Unknown,Banque Inconnue,Unknown,8440.0
Unknown,Unknown,23,Unknown,Unknown,Unknown,Unknown,Banque Inconnue,Unknown,8463.0
Unknown,Unknown,25,Unknown,Unknown,Unknown,Unknown,Banque Inconnue,Unknown,8488.0
Unknown,Unknown,30,Unknown,Unknown,Unknown,Unknown,Banque Inconnue,Unknown,8518.0
Unknown,Unknown,41,Unknown,Unknown,Unknown,Unknown,Banque Inconnue,Unknown,8559.0
Unknown,Unknown,2,Unknown,Unknown,Unknown,Unknown,Banque Inconnue,Unknown,8561.0
Unknown,Unknown,51,Unknown,Unknown,Unknown,Unknown,Banque Inconnue,Unknown,8612.0
Unknown,Unknown,25,Unknown,Unknown,Unknown,Unknown,Banque Inconnue,Unknown,8637.0
Unknown,Unknown,2,Unknown,Unknown,Unknown,Unknown,Banque Inconnue,Unknown,8639.0
Unknown,Unknown,55,Unknown,Unknown,Unknown,Unknown,Banque Inconnue,Unknown,8694.0
Unknown,Unknown,29,Unknown,Unknown,Unknown,Unknown,Banque Inconnue,Unknown,8723.0
Unknown,Unknown,24,Unknown,Unknown,Unknown,Unknown,Banque Inconnue,Unknown,8747.0
Unknown,Unknown,25,Unknown,Unknown,Unknown,Unknown,Banque Inconnue,Unknown,8772.0
Unknown,Unknown,23,Unknown,Unknown,Unknown,Unknown,Banque Inconnue,Unknown,8795.0
Unknown,Unknown,25,Unknown,Unknown,Unknown,Unknown,Banque Inconnue,Unknown,8820.0
Unknown,Unknown,30,Unknown,Unknown,Unknown,Unknown,Banque Inconnue,Unknown,8850.0
Unknown,Unknown,41,Unknown,Unknown,Unknown,Unknown,Banque Inconnue,Unknown,8891.0
Unknown,Unknown,2,Unknown,Unknown,Unknown,Unknown,Banque Inconnue,Unknown,8893.0
Unknown,Unknown,27,Unknown,Unknown,Unknown,Unknown,Banque Inconnue,Unknown,8920.0
Unknown,Unknown,20,Unknown,Unknown,Unknown,Unknown,Banque Inconnue,Unknown,8940.0
Unknown,Unknown,21,Unknown,Unknown,Unknown,Unknown,Banque Inconnue,Unknown,8961.0
Unknown,Unknown,27,Unknown,Unknown,Unknown,Unknown,Banque Inconnue,Unknown,8988.0
Unknown,Unknown,2,Unknown,Unknown,Unknown,Unknown,Banque Inconnue,Unknown,8990.0
Unknown,Unknown,22,Unknown,Unknown,Unknown,Unknown,Banque Inconnue,Unknown,9012.0
Unknown,Unknown,25,Unknown,Unknown,Unknown,Unknown,Banque Inconnue,Unknown,9037.0
Unknown,Unknown,2,Unknown,Unknown,Unknown,Unknown,Banque Inconnue,Unknown,9039.0
Unknown,Unknown,30,Unknown,Unknown,Unknown,Unknown,Banque Inconnue,Unknown,9069.0
Unknown,Unknown,21,Unknown,Unknown,Unknown,Unknown,Banque Inconnue,Unknown,9090.0
Unknown,Unknown,23,Unknown,Unknown,Unknown,Unknown,Banque Inconnue,Unknown,9113.0
Unknown,Unknown,42,Unknown,Unknown,Unknown,Unknown,Banque Inconnue,Unknown,9155.0
Unknown,Unknown,26,Unknown,Unknown,Unknown,Unknown,Banque Inconnue,Unknown,9181.0
Unknown,Unknown,20,Unknown,Unknown,Unknown,Unknown,Banque Inconnue,Unknown,9201.0
Unknown,Unknown,2,Unknown,Unknown,Unknown,Unknown,Banque Inconnue,Unknown,9203.0
Unknown,Unknown,17,Unknown,Unknown,Unknown,Unknown,Banque Inconnue,Unknown,9220.0
Unknown,Unknown,32,Unknown,Unknown,Unknown,Unknown,Banque Inconnue,Unknown,9252.0
Unknown,Unknown,33,Unknown,Unknown,Unknown,Unknown,Banque Inconnue,Unknown,9285.0
Unknown,Unknown,34,Unknown,Unknown,Unknown,Unknown,Banque Inconnue,Unknown,9319.0
Unknown,Unknown,35,Unknown,Unknown,Unknown,Unknown,Banque Inconnue,Unknown,9354.0
Unknown,Unknown,74,Unknown,Unknown,Unknown,Unknown,Banque Inconnue,Unknown,9428.0
Unknown,Unknown,52,Unknown,Unknown,Unknown,Unknown,Banque Inconnue,Unknown,9480.0
Unknown,Unknown,21,Unknown,Unknown,Unknown,Unknown,Banque Inconnue,Unknown,9501.0
Unknown,Unknown,2,Unknown,Unknown,Unknown,Unknown,Banque Inconnue,Unknown,9503.0
Unknown,Unknown,18,Unknown,Unknown,Unknown,Unknown,Banque Inconnue,Unknown,9521.0
Unknown,Unknown,17,Unknown,Unknown,Unknown,Unknown,Banque Inconnue,Unknown,9538.0
Unknown,Unknown,45,Unknown,Unknown,Unknown,Unknown,Banque Inconnue,Unknown,9583.0
Unknown,Unknown,18,Unknown,Unknown,Unknown,Unknown,Banque Inconnue,Unknown,9601.0
Unknown,Unknown,34,Unknown,Unknown,Unknown,Unknown,Banque Inconnue,Unknown,9635.0
Unknown,Unknown,45,Unknown,Unknown,Unknown,Unknown,Banque Inconnue,Unknown,9680.0
Unknown,Unknown,1,Unknown,Unknown,Unknown,Unknown,Banque Inconnue,Unknown,9681.0
Unknown,Unknown,18,Unknown,Unknown,Unknown,Unknown,Banque Inconnue,Unknown,9699.0
Unknown,Unknown,1,Unknown,Unknown,Unknown,Unknown,Banque Inconnue,Unknown,9700.0
Unknown,Unknown,17,Unknown,Unknown,Unknown,Unknown,Banque Inconnue,Unknown,9717.0
Unknown,Unknown,2,Unknown,Unknown,Unknown,Unknown,Banque Inconnue,Unknown,9719.0
Unknown,Unknown,29,Unknown,Unknown,Unknown,Unknown,Banque Inconnue,Unknown,9748.0
Unknown,Unknown,21,Unknown,Unknown,Unknown,Unknown,Banque Inconnue,Unknown,9769.0
Unknown,Unknown,2,Unknown,Unknown,Unknown,Unknown,Banque Inconnue,Unknown,9771.0
Unknown,Unknown,37,Unknown,Unknown,Unknown,Unknown,Banque Inconnue,Unknown,9808.0
Unknown,Unknown,17,Unknown,Unknown,Unknown,Unknown,Banque Inconnue,Unknown,9825.0
Unknown,Unknown,45,Unknown,Unknown,Unknown,Unknown,Banque Inconnue,Unknown,9870.0
Unknown,Unknown,18,Unknown,Unknown,Unknown,Unknown,Banque Inconnue,Unknown,9888.0
Unknown,Unknown,34,Unknown,Unknown,Unknown,Unknown,Banque Inconnue,Unknown,9922.0
Unknown,Unknown,45,Unknown,Unknown,Unknown,Unknown,Banque Inconnue,Unknown,9967.0
Unknown,Unknown,1,Unknown,Unknown,Unknown,Unknown,Banque Inconnue,Unknown,9968.0
Unknown,Unknown,18,Unknown,Unknown,Unknown,Unknown,Banque Inconnue,Unknown,9986.0
Unknown,Unknown,1,Unknown,Unknown,Unknown,Unknown,Banque Inconnue,Unknown,9987.0
Unknown,Unknown,17,Unknown,Unknown,Unknown,Unknown,Banque Inconnue,Unknown,10004.0
Unknown,Unknown,5,Unknown,Unknown,Unknown,Unknown,Banque Inconnue,Unknown,10009.0
Unknown,Unknown,46,Unknown,Unknown,Unknown,Unknown,Banque Inconnue,Unknown,10055.0
Unknown,Unknown,47,Unknown,Unknown,Unknown,Unknown,Banque Inconnue,Unknown,10102.0
Unknown,Unknown,66,Unknown,Unknown,Unknown,Unknown,Banque Inconnue,Unknown,10168.0
Unknown,Unknown,28,Unknown,Unknown,Unknown,Unknown,Banque Inconnue,Unknown,10196.0
Unknown,Unknown,3,Unknown,Unknown,Unknown,Unknown,Banque Inconnue,Unknown,10199.0
Unknown,Unknown,16,Unknown,Unknown,Unknown,Unknown,Banque Inconnue,Unknown,10215.0
Unknown,Unknown,32,Unknown,Unknown,Unknown,Unknown,Banque Inconnue,Unknown,10247.0
Unknown,Unknown,2,Unknown,Unknown,Unknown,Unknown,Banque Inconnue,Unknown,10249.0
Unknown,Unknown,17,Unknown,Unknown,Unknown,Unknown,Banque Inconnue,Unknown,10266.0
Unknown,Unknown,32,Unknown,Unknown,Unknown,Unknown,Banque Inconnue,Unknown,10298.0
Unknown,Unknown,33,Unknown,Unknown,Unknown,Unknown,Banque Inconnue,Unknown,10331.0
Unknown,Unknown,34,Unknown,Unknown,Unknown,Unknown,Banque Inconnue,Unknown,10365.0
Unknown,Unknown,2,Unknown,Unknown,Unknown,Unknown,Banque Inconnue,Unknown,10367.0
Unknown,Unknown,35,Unknown,Unknown,Unknown,Unknown,Banque Inconnue,Unknown,10402.0
Unknown,Unknown,18,Unknown,Unknown,Unknown,Unknown,Banque Inconnue,Unknown,10420.0
Unknown,Unknown,18,Unknown,Unknown,Unknown,Unknown,Banque Inconnue,Unknown,10438.0
Unknown,Unknown,18,Unknown,Unknown,Unknown,Unknown,Banque Inconnue,Unknown,10456.0
Unknown,Unknown,2,Unknown,Unknown,Unknown,Unknown,Banque Inconnue,Unknown,10458.0
Unknown,Unknown,18,Unknown,Unknown,Unknown,Unknown,Banque Inconnue,Unknown,10476.0
Unknown,Unknown,17,Unknown,Unknown,Unknown,Unknown,Banque Inconnue,Unknown,10493.0
Unknown,Unknown,33,Unknown,Unknown,Unknown,Unknown,Banque Inconnue,Unknown,10526.0
Unknown,Unknown,35,Unknown,Unknown,Unknown,Unknown,Banque Inconnue,Unknown,10561.0
Unknown,Unknown,2,Unknown,Unknown,Unknown,Unknown,Banque Inconnue,Unknown,10563.0
Unknown,Unknown,17,Unknown,Unknown,Unknown,Unknown,Banque Inconnue,Unknown,10580.0
Unknown,Unknown,1,Unknown,Unknown,Unknown,Unknown,Banque Inconnue,Unknown,10581.0
Unknown,Unknown,36,Unknown,Unknown,Unknown,Unknown,Banque Inconnue,Unknown,10617.0
Unknown,Unknown,37,Unknown,Unknown,Unknown,Unknown,Banque Inconnue,Unknown,10654.0
Unknown,Unknown,2,Unknown,Unknown,Unknown,Unknown,Banque Inconnue,Unknown,10656.0
Unknown,Unknown,33,Unknown,Unknown,Unknown,Unknown,Banque Inconnue,Unknown,10689.0
Unknown,Unknown,35,Unknown,Unknown,Unknown,Unknown,Banque Inconnue,Unknown,10724.0
Unknown,Unknown,33,Unknown,Unknown,Unknown,Unknown,Banque Inconnue,Unknown,10757.0
Unknown,Unknown,1,Unknown,Unknown,Unknown,Unknown,Banque Inconnue,Unknown,10758.0
Unknown,Unknown,2,Unknown,Unknown,Unknown,Unknown,Banque Inconnue,Unknown,10760.0
Unknown,Unknown,1,Unknown,Unknown,Unknown,Unknown,Banque Inconnue,Unknown,10761.0
Unknown,Unknown,18,Unknown,Unknown,Unknown,Unknown,Banque Inconnue,Unknown,10779.0
Unknown,Unknown,34,Unknown,Unknown,Unknown,Unknown,Banque Inconnue,Unknown,10813.0
Unknown,Unknown,67,Unknown,Unknown,Unknown,Unknown,Banque Inconnue,Unknown,10880.0
Unknown,Unknown,37,Unknown,Unknown,Unknown,Unknown,Banque Inconnue,Unknown,10917.0
Unknown,Unknown,45,Unknown,Unknown,Unknown,Unknown,Banque Inconnue,Unknown,10962.0
Unknown,Unknown,37,Unknown,Unknown,Unknown,Unknown,Banque Inconnue,Unknown,10999.0
Unknown,Unknown,1,Unknown,Unknown,Card,Unknown,CARREFOUR MARKE,EGB,1.0
Unknown,Unknown,1,Unknown,Unknown,Card,Unknown,CARREFOUR MARKE,IBAN,2.0
Unknown,Unknown,31,Unknown,Unknown,Card,Unknown,CARREFOUR MARKE,Qonto,33.0
Unknown,Unknown,205 03,Unknown,Unknown,Card,Unknown,CARREFOUR MARKE,Qonto,20536.0
Unknown,Unknown,03,Unknown,Unknown,Card,Unknown,CARREFOUR MARKE,Qonto,20539.0
Unknown,Unknown,"18,00",Unknown,Unknown,Card,Unknown,CARREFOUR MARKE,Qonto,22339.0
Unknown,Unknown,03,Unknown,Unknown,Card,Unknown,CARREFOUR MARKE,Qonto,22342.0
Unknown,Unknown,03,Unknown,Unknown,Card,Unknown,CARREFOUR MARKE,Qonto,22345.0
Unknown,Unknown,"2,40",Unknown,Unknown,Card,Unknown,CARREFOUR MARKE,Qonto,22585.0
Unknown,Unknown,03,Unknown,Unknown,Card,Unknown,CARREFOUR MARKE,Qonto,22588.0
Unknown,Unknown,03,Unknown,Unknown,Card,Unknown,CARREFOUR MARKE,RESTAURANT VILLENEUVE,22591.0
Unknown,Unknown,"2,40",Unknown,Unknown,Card,Unknown,CARREFOUR MARKE,SU FRster,22831.0
Unknown,Unknown,03,Unknown,Unknown,Card,Unknown,CARREFOUR MARKE,Shein com,22834.0
Unknown,Unknown,03,Unknown,Unknown,Card,Unknown,CARREFOUR MARKE,London GB,22837.0
Unknown,Unknown,"2,40",Unknown,Unknown,Card,Unknown,CARREFOUR MARKE,KR PROV,23077.0
Unknown,Unknown,03,Unknown,Unknown,Card,Unknown,CARREFOUR MARKE,SARL PROVINS,23080.0
Unknown,Unknown,03,Unknown,Unknown,Card,Unknown,CARREFOUR MARKE,SumUp,23083.0
Unknown,Unknown,"2,40",Unknown,Unknown,Card,Unknown,CARREFOUR MARKE,PROVI,23323.0
Unknown,Unknown,03,Unknown,Unknown,Card,Unknown,CARREFOUR MARKE,AUBERGE DE LA VALLE,23326.0
Unknown,Unknown,03,Unknown,Unknown,Card,Unknown,CARREFOUR MARKE,GAUC FR Master Card .3759,23329.0
Unknown,Unknown,"2,40",Unknown,Unknown,Card,Unknown,CARREFOUR MARKE,Provins FR Master Card .3759,23569.0
Unknown,Unknown,03,Unknown,Unknown,Card,Unknown,CARREFOUR MARKE,LE NEMROD PROVINS FR Master Card .3759,23572.0
Unknown,Unknown,03,Unknown,Unknown,Card,Unknown,CARREFOUR MARKE,HEBDOS COMMUNIC,23575.0
Unknown,Unknown,"2,40",Unknown,Unknown,Card,Unknown,CARREFOUR MARKE,Qonto,23815.0
Unknown,Unknown,03,Unknown,Unknown,Card,Unknown,CARREFOUR MARKE,PAGE 2/4,23818.0
Unknown,Unknown,03,Unknown,Unknown,Card,Unknown,CARREFOUR MARKE,Unknown,23821.0
Unknown,Unknown,"2,40",Unknown,Unknown,Card,Unknown,CARREFOUR MARKE,Unknown,24061.0
Unknown,Unknown,04,Unknown,Unknown,Card,Unknown,CARREFOUR MARKE,Unknown,24065.0
Unknown,Unknown,03 27,Unknown,Unknown,Card,Unknown,CARREFOUR MARKE,Unknown,24392.0
Unknown,Unknown,00,Unknown,Unknown,Card,Unknown,CARREFOUR MARKE,Unknown,24392.0
Unknown,Unknown,04,Unknown,Unknown,Card,Unknown,CARREFOUR MARKE,Unknown,24396.0
Unknown,Unknown,03 65,Unknown,Unknown,Card,Unknown,CARREFOUR MARKE,Unknown,24761.0
Unknown,Unknown,95,Unknown,Unknown,Card,Unknown,CARREFOUR MARKE,Unknown,24856.0
Unknown,Unknown,04,Unknown,Unknown,Card,Unknown,CARREFOUR MARKE,Unknown,24860.0
Unknown,Unknown,03 47,Unknown,Unknown,Card,Unknown,CARREFOUR MARKE,Unknown,25207.0
Unknown,Unknown,77,Unknown,Unknown,Card,Unknown,CARREFOUR MARKE,Unknown,25284.0
Unknown,Unknown,74,Unknown,Unknown,Card,Unknown,CARREFOUR MARKE,Unknown,25358.0
Unknown,Unknown,04,Unknown,Unknown,Card,Unknown,CARREFOUR MARKE,Unknown,25362.0
Unknown,Unknown,03 64,Unknown,Unknown,Card,Unknown,CARREFOUR MARKE,Unknown,25726.0
Unknown,Unknown,99,Unknown,Unknown,Card,Unknown,CARREFOUR MARKE,Unknown,25825.0
Unknown,Unknown,05,Unknown,Unknown,Card,Unknown,CARREFOUR MARKE,Unknown,25830.0
Unknown,Unknown,03 14,Unknown,Unknown,Card,Unknown,CARREFOUR MARKE,Unknown,26144.0
Unknown,Unknown,00,Unknown,Unknown,Card,Unknown,CARREFOUR MARKE,Unknown,26144.0
Unknown,Unknown,05,Unknown,Unknown,Card,Unknown,CARREFOUR MARKE,Unknown,26149.0
Unknown,Unknown,03 58,Unknown,Unknown,Card,Unknown,CARREFOUR MARKE,Unknown,26507.0
Unknown,Unknown,19,Unknown,Unknown,Card,Unknown,CARREFOUR MARKE,Unknown,26526.0
Unknown,Unknown,05,Unknown,Unknown,Card,Unknown,CARREFOUR MARKE,Unknown,26531.0
Unknown,Unknown,03 46,Unknown,Unknown,Card,Unknown,CARREFOUR MARKE,Unknown,26877.0
Unknown,Unknown,00,Unknown,Unknown,Card,Unknown,CARREFOUR MARKE,Unknown,26877.0
Unknown,Unknown,06,Unknown,Unknown,Card,Unknown,CARREFOUR MARKE,Unknown,26883.0
Unknown,Unknown,"03 221,45",Unknown,Unknown,Card,Unknown,CARREFOUR MARKE,Unknown,349028.0
Unknown,Unknown,06,Unknown,Unknown,Card,Unknown,CARREFOUR MARKE,Unknown,349034.0
Unknown,Unknown,03,Unknown,Unknown,Card,Unknown,CARREFOUR MARKE,Unknown,349037.0
Unknown,Unknown,"9,99",Unknown,Unknown,Card,Unknown,CARREFOUR MARKE,Unknown,350036.0
Unknown,Unknown,06,Unknown,Unknown,Card,Unknown,CARREFOUR MARKE,Unknown,350042.0
Unknown,Unknown,03 25,Unknown,Unknown,Card,Unknown,CARREFOUR MARKE,Unknown,350367.0
Unknown,Unknown,50,Unknown,Unknown,Card,Unknown,CARREFOUR MARKE,Unknown,350417.0
Unknown,Unknown,09,Unknown,Unknown,Card,Unknown,CARREFOUR MARKE,Unknown,350426.0
Unknown,Unknown,"03 196,80",Unknown,Unknown,Card,Unknown,CARREFOUR MARKE,Unknown,670106.0
Unknown,Unknown,00,Unknown,Unknown,Card,Unknown,CARREFOUR MARKE,Unknown,670106.0
Unknown,Unknown,80,Unknown,Unknown,Card,Unknown,CARREFOUR MARKE,Unknown,670186.0
Unknown,Unknown,8 622,Unknown,Unknown,Card,Unknown,CARREFOUR MARKE,Unknown,678808.0
Unknown,Unknown,2,Unknown,Unknown,Card,Unknown,CARREFOUR MARKE,Unknown,678810.0
Unknown,Unknown,4,Unknown,Unknown,Card,Unknown,CARREFOUR MARKE,Unknown,678814.0
28/02/2022,Unknown,23,Unknown,Unknown,Cheque,Unknown,C8,VOTRE COMPTE COURANT N' 02421381795 DATE,23.0
Unknown,Unknown,02,Unknown,Unknown,Cheque,Unknown,C8,REMISE,25.0
Unknown,Unknown,50,Unknown,Unknown,Cheque,Unknown,C8,S7E MBoo12/180545,75.0
Unknown,Unknown,180,Unknown,Unknown,Cheque,Unknown,C8,CoM,255.0
Unknown,Unknown,0,Unknown,Unknown,Cheque,Unknown,C8,BRUT 64 69e,255.0
Unknown,Unknown,23,Unknown,Unknown,Cheque,Unknown,C8,MBo007/167241,278.0
Unknown,Unknown,02,Unknown,Unknown,Cheque,Unknown,C8,REMISE C8,280.0
Unknown,Unknown,59,Unknown,Unknown,Cheque,Unknown,C8,CoM,339.0
Unknown,Unknown,0,Unknown,Unknown,Cheque,Unknown,C8,BRUT 6 SE,339.0
Unknown,Unknown,24,Unknown,Unknown,Cheque,Unknown,C8,REMISE,363.0
Unknown,Unknown,02,Unknown,Unknown,Cheque,Unknown,C8,ReMISE,365.0
Unknown,Unknown,24,Unknown,Unknown,Cheque,Unknown,C8,CoM,389.0
Unknown,Unknown,02,Unknown,Unknown,Cheque,Unknown,C8,DEPOT AGEIICE,391.0
Unknown,Unknown,24,Unknown,Unknown,Cheque,Unknown,C8,REMISE,415.0
Unknown,Unknown,02,Unknown,Unknown,Cheque,Unknown,C8,MBC016/148159,417.0
Unknown,Unknown,50,Unknown,Unknown,Cheque,Unknown,C8,Sas Promogros,467.0
Unknown,Unknown,64,Unknown,Unknown,Cheque,Unknown,C8,Cou,531.0
Unknown,Unknown,0,Unknown,Unknown,Cheque,Unknown,C8,ReMISE,531.0
Unknown,Unknown,24,Unknown,Unknown,Cheque,Unknown,C8,BRUT 12,555.0
Unknown,Unknown,02,Unknown,Unknown,Cheque,Unknown,C8,CoM,557.0
Unknown,Unknown,228,Unknown,Unknown,Cheque,Unknown,C8,ReMISE,785.0
Unknown,Unknown,24,Unknown,Unknown,Cheque,Unknown,C8,BRUT 328 ME CoA,809.0
Unknown,Unknown,02,Unknown,Unknown,Cheque,Unknown,C8,BRUT 8,811.0
Unknown,Unknown,6,Unknown,Unknown,Cheque,Unknown,C8,COu 0,817.0
Unknown,Unknown,25,Unknown,Unknown,Cheque,Unknown,C8,N80002/195351,842.0
Unknown,Unknown,02,Unknown,Unknown,Cheque,Unknown,C8,REMISE,844.0
Unknown,Unknown,296,Unknown,Unknown,Cheque,Unknown,C8,Cou 0,1140.0
Unknown,Unknown,25,Unknown,Unknown,Cheque,Unknown,C8,BRUT 219 7oe,1165.0
Unknown,Unknown,02,Unknown,Unknown,Cheque,Unknown,C8,"Cou0,70E",1167.0
Unknown,Unknown,106 36,Unknown,Unknown,Cheque,Unknown,C8,ReMISE,11803.0
Unknown,Unknown,0,Unknown,Unknown,Cheque,Unknown,C8,BRUT 1 50E,11803.0
Unknown,Unknown,25,Unknown,Unknown,Cheque,Unknown,C8,M8o001/106883,11828.0
Unknown,Unknown,02,Unknown,Unknown,Cheque,Unknown,C8,SOUS ReSERVEDE CokptaGE RELEVE,11830.0
Unknown,Unknown,25,Unknown,Unknown,Cheque,Unknown,C8,DebIT CRedit,11855.0
Unknown,Unknown,02,Unknown,Unknown,Cheque,Unknown,C8,DATE DaTE OPERATION,11857.0
Unknown,Unknown,25,Unknown,Unknown,Cheque,Unknown,C8,Franche-Conté,11882.0
Unknown,Unknown,02,Unknown,Unknown,Cheque,Unknown,C8,QOMIE,11884.0
Unknown,Unknown,26,Unknown,Unknown,Cheque,Unknown,C8,Q5 0235,11910.0
Unknown,Unknown,02,Unknown,Unknown,Cheque,Unknown,C8,Bd0le Iremoulle,11912.0
Unknown,Unknown,50,Unknown,Unknown,Cheque,Unknown,C8,Coer F CCP Dion,11962.0
Unknown,Unknown,208,Unknown,Unknown,Cheque,Unknown,C8,Carba Assuaces,12170.0
Unknown,Unknown,0,Unknown,Unknown,Cheque,Unknown,C8,Unknown,12170.0
Unknown,Unknown,28,Unknown,Unknown,Cheque,Unknown,C8,Unknown,12198.0
Unknown,Unknown,02,Unknown,Unknown,Cheque,Unknown,C8,Unknown,12200.0
Unknown,Unknown,28,Unknown,Unknown,Cheque,Unknown,C8,Unknown,12228.0
Unknown,Unknown,02,Unknown,Unknown,Cheque,Unknown,C8,Unknown,12230.0
Unknown,Unknown,50,Unknown,Unknown,Cheque,Unknown,C8,Unknown,12280.0
Unknown,Unknown,647,Unknown,Unknown,Cheque,Unknown,C8,Unknown,12927.0
Unknown,Unknown,0,Unknown,Unknown,Cheque,Unknown,C8,Unknown,12927.0
Unknown,Unknown,110,Unknown,Unknown,Cheque,Unknown,C8,Unknown,13037.0
Unknown,Unknown,52 28,Unknown,Unknown,Cheque,Unknown,C8,Unknown,18265.0
Unknown,Unknown,02,Unknown,Unknown,Cheque,Unknown,C8,Unknown,18267.0
Unknown,Unknown,12,Unknown,Unknown,Cheque,Unknown,C8,Unknown,18279.0
Unknown,Unknown,28,Unknown,Unknown,Cheque,Unknown,C8,Unknown,18307.0
Unknown,Unknown,02,Unknown,Unknown,Cheque,Unknown,C8,Unknown,18309.0
Unknown,Unknown,328,Unknown,Unknown,Cheque,Unknown,C8,Unknown,18637.0
Unknown,Unknown,3,Unknown,Unknown,Cheque,Unknown,C8,Unknown,18640.0
Unknown,Unknown,28,Unknown,Unknown,Cheque,Unknown,C8,Unknown,18668.0
Unknown,Unknown,02,Unknown,Unknown,Cheque,Unknown,C8,Unknown,18670.0
Unknown,Unknown,372,Unknown,Unknown,Cheque,Unknown,C8,Unknown,19042.0
Unknown,Unknown,1,Unknown,Unknown,Cheque,Unknown,C8,Unknown,19043.0
Unknown,Unknown,28,Unknown,Unknown,Cheque,Unknown,C8,Unknown,19071.0
Unknown,Unknown,02,Unknown,Unknown,Cheque,Unknown,C8,Unknown,19073.0
Unknown,Unknown,8,Unknown,Unknown,Cheque,Unknown,C8,Unknown,19081.0
Unknown,Unknown,0 006,Unknown,Unknown,Cheque,Unknown,C8,Unknown,19087.0
Unknown,Unknown,3 28,Unknown,Unknown,Cheque,Unknown,C8,Unknown,19415.0
Unknown,Unknown,02,Unknown,Unknown,Cheque,Unknown,C8,Unknown,19417.0
Unknown,Unknown,43,Unknown,Unknown,Cheque,Unknown,C8,Unknown,19460.0
Unknown,Unknown,0,Unknown,Unknown,Cheque,Unknown,C8,Unknown,19460.0
Unknown,Unknown,28,Unknown,Unknown,Cheque,Unknown,C8,Unknown,19488.0
Unknown,Unknown,02,Unknown,Unknown,Cheque,Unknown,C8,Unknown,19490.0
Unknown,Unknown,595,Unknown,Unknown,Cheque,Unknown,C8,Unknown,20085.0
Unknown,Unknown,0,Unknown,Unknown,Cheque,Unknown,C8,Unknown,20085.0
Unknown,Unknown,28,Unknown,Unknown,Cheque,Unknown,C8,Unknown,20113.0
Unknown,Unknown,02,Unknown,Unknown,Cheque,Unknown,C8,Unknown,20115.0
Unknown,Unknown,219,Unknown,Unknown,Cheque,Unknown,C8,Unknown,20334.0
Unknown,Unknown,18,Unknown,Unknown,Cheque,Unknown,C8,Unknown,20352.0
Unknown,Unknown,517 28,Unknown,Unknown,Cheque,Unknown,C8,Unknown,72080.0
Unknown,Unknown,02,Unknown,Unknown,Cheque,Unknown,C8,Unknown,72082.0
Unknown,Unknown,1,Unknown,Unknown,Cheque,Unknown,C8,Unknown,72083.0
Unknown,Unknown,28,Unknown,Unknown,Cheque,Unknown,C8,Unknown,72111.0
Unknown,Unknown,02,Unknown,Unknown,Cheque,Unknown,C8,Unknown,72113.0
Unknown,Unknown,1,Unknown,Unknown,Cheque,Unknown,C8,Unknown,72114.0
Unknown,Unknown,28,Unknown,Unknown,Cheque,Unknown,C8,Unknown,72142.0
Unknown,Unknown,02,Unknown,Unknown,Cheque,Unknown,C8,Unknown,72144.0
Unknown,Unknown,180 24,Unknown,Unknown,Cheque,Unknown,C8,Unknown,90168.0
Unknown,Unknown,22,Unknown,Unknown,Cheque,Unknown,C8,Unknown,90190.0
Unknown,Unknown,02,Unknown,Unknown,Cheque,Unknown,C8,Unknown,90192.0
Unknown,Unknown,"58,91",Unknown,Unknown,Cheque,Unknown,C8,Unknown,96083.0
Unknown,Unknown,24,Unknown,Unknown,Cheque,Unknown,C8,Unknown,96107.0
Unknown,Unknown,02 23,Unknown,Unknown,Cheque,Unknown,C8,Unknown,96330.0
Unknown,Unknown,"02 747,86",Unknown,Unknown,Cheque,Unknown,C8,Unknown,371116.0
Unknown,Unknown,24,Unknown,Unknown,Cheque,Unknown,C8,Unknown,371140.0
Unknown,Unknown,02,Unknown,Unknown,Cheque,Unknown,C8,Unknown,371142.0
Unknown,Unknown,23,Unknown,Unknown,Cheque,Unknown,C8,Unknown,371165.0
Unknown,Unknown,02 24,Unknown,Unknown,Cheque,Unknown,C8,Unknown,371389.0
Unknown,Unknown,02 23,Unknown,Unknown,Cheque,Unknown,C8,Unknown,371612.0
Unknown,Unknown,"02 918,07",Unknown,Unknown,Cheque,Unknown,C8,Unknown,663419.0
Unknown,Unknown,"64,48",Unknown,Unknown,Cheque,Unknown,C8,Unknown,669867.0
Unknown,Unknown,24,Unknown,Unknown,Cheque,Unknown,C8,Unknown,669891.0
Unknown,Unknown,02 24,Unknown,Unknown,Cheque,Unknown,C8,Unknown,670115.0
Unknown,Unknown,"02 228,03",Unknown,Unknown,Cheque,Unknown,C8,Unknown,892918.0
Unknown,Unknown,24,Unknown,Unknown,Cheque,Unknown,C8,Unknown,892942.0
Unknown,Unknown,02 24,Unknown,Unknown,Cheque,Unknown,C8,Unknown,893166.0
Unknown,Unknown,02,Unknown,Unknown,Cheque,Unknown,C8,Unknown,893168.0
Unknown,Unknown,"6,52",Unknown,Unknown,Cheque,Unknown,C8,Unknown,893820.0
Unknown,Unknown,24,Unknown,Unknown,Cheque,Unknown,C8,Unknown,893844.0
Unknown,Unknown,02 24,Unknown,Unknown,Cheque,Unknown,C8,Unknown,894068.0
Unknown,Unknown,02 296 25,Unknown,Unknown,Cheque,Unknown,C8,Unknown,1123693.0
Unknown,Unknown,24,Unknown,Unknown,Cheque,Unknown,C8,Unknown,1123717.0
Unknown,Unknown,02 24,Unknown,Unknown,Cheque,Unknown,C8,Unknown,1123941.0
Unknown,Unknown,02 106.00,Unknown,Unknown,Cheque,Unknown,C8,Unknown,1126047.0
Unknown,Unknown,24,Unknown,Unknown,Cheque,Unknown,C8,Unknown,1126071.0
Unknown,Unknown,02 24,Unknown,Unknown,Cheque,Unknown,C8,Unknown,1126295.0
Unknown,Unknown,02,Unknown,Unknown,Cheque,Unknown,C8,Unknown,1126297.0
Unknown,Unknown,"7,14",Unknown,Unknown,Cheque,Unknown,C8,Unknown,1127011.0
Unknown,Unknown,25,Unknown,Unknown,Cheque,Unknown,C8,Unknown,1127036.0
Unknown,Unknown,02 25,Unknown,Unknown,Cheque,Unknown,C8,Unknown,1127261.0
Unknown,Unknown,"02 500,00",Unknown,Unknown,Cheque,Unknown,C8,Unknown,1377261.0
Unknown,Unknown,25,Unknown,Unknown,Cheque,Unknown,C8,Unknown,1377286.0
Unknown,Unknown,02 25,Unknown,Unknown,Cheque,Unknown,C8,Unknown,1377511.0
Unknown,Unknown,02,Unknown,Unknown,Cheque,Unknown,C8,Unknown,1377513.0
Unknown,Unknown,"4,65",Unknown,Unknown,Cheque,Unknown,C8,Unknown,1377978.0
Unknown,Unknown,25,Unknown,Unknown,Cheque,Unknown,C8,Unknown,1378003.0
Unknown,Unknown,02 25,Unknown,Unknown,Cheque,Unknown,C8,Unknown,1378228.0
Unknown,Unknown,02 237 24,Unknown,Unknown,Cheque,Unknown,C8,Unknown,1601952.0
Unknown,Unknown,28,Unknown,Unknown,Cheque,Unknown,C8,Unknown,1601980.0
Unknown,Unknown,02 28,Unknown,Unknown,Cheque,Unknown,C8,Unknown,1602208.0
Unknown,Unknown,"02 450,00",Unknown,Unknown,Cheque,Unknown,C8,Unknown,1847208.0
Unknown,Unknown,28,Unknown,Unknown,Cheque,Unknown,C8,Unknown,1847236.0
Unknown,Unknown,02,Unknown,Unknown,Cheque,Unknown,C8,Unknown,1847238.0
Unknown,Unknown,28,Unknown,Unknown,Cheque,Unknown,C8,Unknown,1847266.0
Unknown,Unknown,02 12,Unknown,Unknown,Cheque,Unknown,C8,Unknown,1847478.0
Unknown,Unknown,75,Unknown,Unknown,Cheque,Unknown,C8,Unknown,1847553.0
Unknown,Unknown,28,Unknown,Unknown,Cheque,Unknown,C8,Unknown,1847581.0
Unknown,Unknown,02 327 09,Unknown,Unknown,Cheque,Unknown,C8,Unknown,2080290.0
Unknown,Unknown,28,Unknown,Unknown,Cheque,Unknown,C8,Unknown,2080318.0
Unknown,Unknown,02 28,Unknown,Unknown,Cheque,Unknown,C8,Unknown,2080546.0
Unknown,Unknown,"02 372,83",Unknown,Unknown,Cheque,Unknown,C8,Unknown,2317829.0
Unknown,Unknown,28,Unknown,Unknown,Cheque,Unknown,C8,Unknown,2317857.0
Unknown,Unknown,02 18,Unknown,Unknown,Cheque,Unknown,C8,Unknown,2318075.0
Unknown,Unknown,89,Unknown,Unknown,Cheque,Unknown,C8,Unknown,2318164.0
Unknown,Unknown,28,Unknown,Unknown,Cheque,Unknown,C8,Unknown,2318192.0
Unknown,Unknown,02 28,Unknown,Unknown,Cheque,Unknown,C8,Unknown,2318420.0
Unknown,Unknown,02,Unknown,Unknown,Cheque,Unknown,C8,Unknown,2318422.0
Unknown,Unknown,28,Unknown,Unknown,Cheque,Unknown,C8,Unknown,2318450.0
Unknown,Unknown,02 28,Unknown,Unknown,Cheque,Unknown,C8,Unknown,2318678.0
Unknown,Unknown,"02 535,96",Unknown,Unknown,Cheque,Unknown,C8,Unknown,2572274.0
Unknown,Unknown,28,Unknown,Unknown,Cheque,Unknown,C8,Unknown,2572302.0
Unknown,Unknown,"02 219,00",Unknown,Unknown,Cheque,Unknown,C8,Unknown,2794202.0
Unknown,Unknown,28,Unknown,Unknown,Cheque,Unknown,C8,Unknown,2794230.0
Unknown,Unknown,02 748,Unknown,Unknown,Cheque,Unknown,C8,Unknown,2796978.0
Unknown,Unknown,28,Unknown,Unknown,Cheque,Unknown,C8,Unknown,2797006.0
Unknown,Unknown,02,Unknown,Unknown,Cheque,Unknown,C8,Unknown,2797008.0
Unknown,Unknown,00,Unknown,Unknown,Cheque,Unknown,C8,Unknown,2797008.0
Unknown,Unknown,6,Unknown,Unknown,Cheque,Unknown,C8,Unknown,2797014.0
Unknown,Unknown,0,Unknown,Unknown,Cheque,Unknown,C8,Unknown,2797014.0
Unknown,Unknown,2,Unknown,Unknown,Cheque,Unknown,C8,Unknown,2797016.0
Unknown,Unknown,14,Unknown,Unknown,Cheque,Unknown,C8,Unknown,2797030.0
Unknown,Unknown,07,Unknown,Unknown,Cheque,Unknown,C8,Unknown,2797037.0
28/02/2022,Unknown,28,Unknown,Unknown,Debit,Unknown,SVCS,BANQUE POPULAIRE +X BOURGOGNE FRANCHE,28.0
28/02/2022,Unknown,02,Unknown,Unknown,Debit,Unknown,SVCS,DATE,30.0
28/02/2022,Unknown,21,Unknown,Unknown,Debit,Unknown,SVCS,STICHIIG CUSTODIN,51.0
02/02/2022,Unknown,1,Unknown,Unknown,Debit,Unknown,SVCS,DebIT,52.0
02/02/2022,Unknown,28,Unknown,Unknown,Debit,Unknown,SVCS,TOTAL DES MOUVEMENTS,80.0
07/02/2022,Unknown,02,Unknown,Unknown,Debit,Unknown,SVCS,Oes oabonsen,82.0
07/02/2022,Unknown,"374,58",Unknown,Unknown,Debit,Unknown,SVCS,denreosremntetduno pronvon sucantectosonbelos oelarrete,37540.0
10/02/2022,Unknown,28,Unknown,Unknown,Debit,Unknown,SVCS,Debit DATE DETAIL DES PRELEVEMENTS,37568.0
11/02/2022,Unknown,02,Unknown,Unknown,Debit,Unknown,SVCS,FRatedfoo1oo7 ILRMA360000169109 051011c3/56d48c18081390080656c0d,37570.0
15/02/2022,Unknown,28,Unknown,Unknown,Debit,Unknown,SVCS,VERISURE,37598.0
21/02/2022,Unknown,02,Unknown,Unknown,Debit,Unknown,SVCS,Oph U1910026,37600.0
28/02/2022,Unknown,"32 554,09",Unknown,Unknown,Debit,Unknown,SVCS,SAS AEM SOFTS,3293009.0
03/02/2022,Unknown,"35 206,57",Unknown,Unknown,Debit,Unknown,SVCS,FR51222478175,6813666.0
28/02/2022,Unknown,"6 802,33",Unknown,Unknown,Debit,Unknown,SVCS,CUiEnT 005726 15/02/2022,7493899.0
03/02/2022,Unknown,1,Unknown,Unknown,Debit,Unknown,SVCS,VERISURE,7493900.0
07/02/2022,Unknown,28,Unknown,Unknown,Debit,Unknown,SVCS,FR93222324159,7493928.0
Unknown,Unknown,02,Unknown,Unknown,Debit,Unknown,SVCS,VOTRE,7493930.0
Unknown,Unknown,02,Unknown,Unknown,Debit,Unknown,SVCS,Debit DETAIL DES PRELEVEMENTS,7493932.0
Unknown,Unknown,02,Unknown,Unknown,Debit,Unknown,SVCS,BIMATOO,7493934.0
Unknown,Unknown,02,Unknown,Unknown,Debit,Unknown,SVCS,FORFAIT PROMOGROS,7493936.0
Unknown,Unknown,02,Unknown,Unknown,Debit,Unknown,SVCS,JANVIER 22 VOTRE COMPTE COURANT N' 02421381795 RELEVE N' 1 AU,7493938.0
Unknown,Unknown,01,Unknown,Unknown,Debit,Unknown,SVCS,CRedit EUROS DATE DETAIL DES VIREMENTS SEPA,7493939.0
Unknown,Unknown,01,Unknown,Unknown,Debit,Unknown,SVCS,MONEYGRAM,7493940.0
Unknown,Unknown,"652,35",Unknown,Unknown,Debit,Unknown,SVCS,Franche-Conté,7559175.0
Unknown,Unknown,160,Unknown,Unknown,Debit,Unknown,SVCS,FRCHE QOMIE,7559335.0
Unknown,Unknown,9,Unknown,Unknown,Debit,Unknown,SVCS,Q5 0235,7559344.0
Unknown,Unknown,8,Unknown,Unknown,Debit,Unknown,SVCS,14 Bd0le Tremoulle,7559352.0
Unknown,Unknown,07,Unknown,Unknown,Debit,Unknown,SVCS,F05,7559359.0
Unknown,Unknown,02,Unknown,Unknown,Debit,Unknown,SVCS,CCBPFFPPOHN 01s,7559361.0
Unknown,Unknown,"64,80",Unknown,Unknown,Debit,Unknown,SVCS,Unknown,7565841.0
Unknown,Unknown,07,Unknown,Unknown,Debit,Unknown,SVCS,Unknown,7565848.0
Unknown,Unknown,02,Unknown,Unknown,Debit,Unknown,SVCS,Unknown,7565850.0
Unknown,Unknown,"903,62",Unknown,Unknown,Debit,Unknown,SVCS,Unknown,7656212.0
Unknown,Unknown,1,Unknown,Unknown,Debit,Unknown,SVCS,Unknown,7656213.0
Unknown,Unknown,10,Unknown,Unknown,Debit,Unknown,SVCS,Unknown,7656223.0
Unknown,Unknown,02,Unknown,Unknown,Debit,Unknown,SVCS,Unknown,7656225.0
Unknown,Unknown,67 09,Unknown,Unknown,Debit,Unknown,SVCS,Unknown,7662934.0
Unknown,Unknown,11,Unknown,Unknown,Debit,Unknown,SVCS,Unknown,7662945.0
Unknown,Unknown,02,Unknown,Unknown,Debit,Unknown,SVCS,Unknown,7662947.0
Unknown,Unknown,"725,15",Unknown,Unknown,Debit,Unknown,SVCS,Unknown,7735462.0
Unknown,Unknown,15,Unknown,Unknown,Debit,Unknown,SVCS,Unknown,7735477.0
Unknown,Unknown,02,Unknown,Unknown,Debit,Unknown,SVCS,Unknown,7735479.0
Unknown,Unknown,47 99,Unknown,Unknown,Debit,Unknown,SVCS,Unknown,7740278.0
Unknown,Unknown,21,Unknown,Unknown,Debit,Unknown,SVCS,Unknown,7740299.0
Unknown,Unknown,02,Unknown,Unknown,Debit,Unknown,SVCS,Unknown,7740301.0
Unknown,Unknown,3,Unknown,Unknown,Debit,Unknown,SVCS,Unknown,7740304.0
Unknown,Unknown,"239,60",Unknown,Unknown,Debit,Unknown,SVCS,Unknown,7764264.0
Unknown,Unknown,8,Unknown,Unknown,Debit,Unknown,SVCS,Unknown,7764272.0
Unknown,Unknown,1,Unknown,Unknown,Debit,Unknown,SVCS,Unknown,7764273.0
Unknown,Unknown,28,Unknown,Unknown,Debit,Unknown,SVCS,Unknown,7764301.0
Unknown,Unknown,02,Unknown,Unknown,Debit,Unknown,SVCS,Unknown,7764303.0
Unknown,Unknown,8 03,Unknown,Unknown,Debit,Unknown,SVCS,Unknown,7765106.0
Unknown,Unknown,02,Unknown,Unknown,Debit,Unknown,SVCS,Unknown,7765108.0
Unknown,Unknown,"22 264,00",Unknown,Unknown,Debit,Unknown,SVCS,Unknown,9991508.0
Unknown,Unknown,22,Unknown,Unknown,Debit,Unknown,SVCS,Unknown,9991530.0
Unknown,Unknown,1,Unknown,Unknown,Debit,Unknown,SVCS,Unknown,9991531.0
Unknown,Unknown,28,Unknown,Unknown,Debit,Unknown,SVCS,Unknown,9991559.0
Unknown,Unknown,02,Unknown,Unknown,Debit,Unknown,SVCS,Unknown,9991561.0
Unknown,Unknown,03,Unknown,Unknown,Debit,Unknown,SVCS,Unknown,9991564.0
Unknown,Unknown,02,Unknown,Unknown,Debit,Unknown,SVCS,Unknown,9991566.0
Unknown,Unknown,"1,00",Unknown,Unknown,Debit,Unknown,SVCS,Unknown,9991666.0
Unknown,Unknown,07,Unknown,Unknown,Debit,Unknown,SVCS,Unknown,9991673.0
Unknown,Unknown,02,Unknown,Unknown,Debit,Unknown,SVCS,Unknown,9991675.0
Unknown,Unknown,008,Unknown,Unknown,Debit,Unknown,SVCS,Unknown,9991683.0
Unknown,Unknown,481 41,Unknown,Unknown,Debit,Unknown,SVCS,Unknown,10039824.0
Unknown,Unknown,7,Unknown,Unknown,Debit,Unknown,SVCS,Unknown,10039831.0
Unknown,Unknown,0,Unknown,Unknown,Debit,Unknown,SVCS,Unknown,10039831.0
Unknown,Unknown,2,Unknown,Unknown,Debit,Unknown,SVCS,Unknown,10039833.0
Unknown,Unknown,14,Unknown,Unknown,Debit,Unknown,SVCS,Unknown,10039847.0
Unknown,Unknown,160,Unknown,Unknown,Debit,Unknown,SVCS,Unknown,10040007.0
29/10/2021,Unknown,08,Unknown,Unknown,Debit,Unknown,SVCS,BANQUE POPULAIRE +X BOURGOGNE FRANCHE,8.0
Unknown,Unknown,10,Unknown,Unknown,Debit,Unknown,SVCS,Daie LibelleReFERENCE,18.0
Unknown,Unknown,26,Unknown,Unknown,Debit,Unknown,SVCS,C8 5072120015,44.0
Unknown,Unknown,08,Unknown,Unknown,Debit,Unknown,SVCS,ORUt,52.0
Unknown,Unknown,10,Unknown,Unknown,Debit,Unknown,SVCS,RyTHMEO,62.0
Unknown,Unknown,15,Unknown,Unknown,Debit,Unknown,SVCS,CONIRAT CXVSO,77.0
Unknown,Unknown,0,Unknown,Unknown,Debit,Unknown,SVCS,C8,77.0
Unknown,Unknown,06,Unknown,Unknown,Debit,Unknown,SVCS,ORUT J7,83.0
Unknown,Unknown,10,Unknown,Unknown,Debit,Unknown,SVCS,Rexise C8 5072120015 BRUr,93.0
Unknown,Unknown,07,Unknown,Unknown,Debit,Unknown,SVCS,COu,100.0
Unknown,Unknown,09,Unknown,Unknown,Debit,Unknown,SVCS,Revise C8,109.0
Unknown,Unknown,10,Unknown,Unknown,Debit,Unknown,SVCS,BRUt,119.0
Unknown,Unknown,11,Unknown,Unknown,Debit,Unknown,SVCS,Cou 0006,130.0
Unknown,Unknown,10,Unknown,Unknown,Debit,Unknown,SVCS,Rexise C8,140.0
Unknown,Unknown,19 906,Unknown,Unknown,Debit,Unknown,SVCS,BRUt S1v7e COv,20046.0
Unknown,Unknown,11,Unknown,Unknown,Debit,Unknown,SVCS,N8ooo714202,20057.0
Unknown,Unknown,10,Unknown,Unknown,Debit,Unknown,SVCS,Revise C8 6072120015 BRUt,20067.0
Unknown,Unknown,11,Unknown,Unknown,Debit,Unknown,SVCS,Cou 0 oe,20078.0
Unknown,Unknown,10,Unknown,Unknown,Debit,Unknown,SVCS,Revise C8,20088.0
Unknown,Unknown,0,Unknown,Unknown,Debit,Unknown,SVCS,Q6,20088.0
Unknown,Unknown,11,Unknown,Unknown,Debit,Unknown,SVCS,Coy 0 206 Necooe,20099.0
Unknown,Unknown,10,Unknown,Unknown,Debit,Unknown,SVCS,N80oo1/11056,20109.0
Unknown,Unknown,0,Unknown,Unknown,Debit,Unknown,SVCS,Remise C8,20109.0
Unknown,Unknown,11,Unknown,Unknown,Debit,Unknown,SVCS,PoP,20120.0
Unknown,Unknown,10,Unknown,Unknown,Debit,Unknown,SVCS,C8 470,20130.0
Unknown,Unknown,11,Unknown,Unknown,Debit,Unknown,SVCS,SM CASINO,20141.0
Unknown,Unknown,10,Unknown,Unknown,Debit,Unknown,SVCS,CSeo7oiconfrCON 11/10,20151.0
Unknown,Unknown,89,Unknown,Unknown,Debit,Unknown,SVCS,C8:*4704 Carrefour MarketicharnAY,20240.0
Unknown,Unknown,0 206,Unknown,Unknown,Debit,Unknown,SVCS,C8,20446.0
Unknown,Unknown,11,Unknown,Unknown,Debit,Unknown,SVCS,ELECTRODEPOI,20457.0
Unknown,Unknown,10,Unknown,Unknown,Debit,Unknown,SVCS,VeiRo,20467.0
Unknown,Unknown,0,Unknown,Unknown,Debit,Unknown,SVCS,RemiSE,20467.0
Unknown,Unknown,11,Unknown,Unknown,Debit,Unknown,SVCS,Remise,20478.0
Unknown,Unknown,10,Unknown,Unknown,Debit,Unknown,SVCS,COu,20488.0
Unknown,Unknown,215,Unknown,Unknown,Debit,Unknown,SVCS,SM CaSINO CSog7oiconfrancov,20703.0
Unknown,Unknown,11,Unknown,Unknown,Debit,Unknown,SVCS,Reservedecouptage 13/10,20714.0
Unknown,Unknown,10,Unknown,Unknown,Debit,Unknown,SVCS,Cou 0oe,20724.0
Unknown,Unknown,000,Unknown,Unknown,Debit,Unknown,SVCS,N80o16/105805 13/10 121021,20724.0
Unknown,Unknown,010 11,Unknown,Unknown,Debit,Unknown,SVCS,C8 4704 EuRoero,21735.0
Unknown,Unknown,10,Unknown,Unknown,Debit,Unknown,SVCS,N 9 AU 29/10/2021 Debit,21745.0
Unknown,Unknown,470,Unknown,Unknown,Debit,Unknown,SVCS,DATE Oaie,22215.0
Unknown,Unknown,11,Unknown,Unknown,Debit,Unknown,SVCS,D2CUU74,22226.0
Unknown,Unknown,10,Unknown,Unknown,Debit,Unknown,SVCS,D2CuU76,22236.0
Unknown,Unknown,11,Unknown,Unknown,Debit,Unknown,SVCS,D2CUU77,22247.0
Unknown,Unknown,10,Unknown,Unknown,Debit,Unknown,SVCS,DSNNBZK,22257.0
Unknown,Unknown,470,Unknown,Unknown,Debit,Unknown,SVCS,Bourgogne,22727.0
Unknown,Unknown,11,Unknown,Unknown,Debit,Unknown,SVCS,Franche-Comte,22738.0
Unknown,Unknown,10,Unknown,Unknown,Debit,Unknown,SVCS,PaGE,22748.0
Unknown,Unknown,470,Unknown,Unknown,Debit,Unknown,SVCS,Zex IVA,23218.0
Unknown,Unknown,12,Unknown,Unknown,Debit,Unknown,SVCS,Boungog,23230.0
Unknown,Unknown,10,Unknown,Unknown,Debit,Unknown,SVCS,CoVIf,23240.0
Unknown,Unknown,12,Unknown,Unknown,Debit,Unknown,SVCS,Dpon Cooo CCp Dpn0,23252.0
Unknown,Unknown,10,Unknown,Unknown,Debit,Unknown,SVCS,Ccbphppry0e,23262.0
Unknown,Unknown,12,Unknown,Unknown,Debit,Unknown,SVCS,Unknown,23274.0
Unknown,Unknown,10,Unknown,Unknown,Debit,Unknown,SVCS,Unknown,23284.0
Unknown,Unknown,470,Unknown,Unknown,Debit,Unknown,SVCS,Unknown,23754.0
Unknown,Unknown,12,Unknown,Unknown,Debit,Unknown,SVCS,Unknown,23766.0
Unknown,Unknown,10,Unknown,Unknown,Debit,Unknown,SVCS,Unknown,23776.0
Unknown,Unknown,13,Unknown,Unknown,Debit,Unknown,SVCS,Unknown,23789.0
Unknown,Unknown,10,Unknown,Unknown,Debit,Unknown,SVCS,Unknown,23799.0
Unknown,Unknown,0 246,Unknown,Unknown,Debit,Unknown,SVCS,Unknown,24045.0
Unknown,Unknown,13,Unknown,Unknown,Debit,Unknown,SVCS,Unknown,24058.0
Unknown,Unknown,10,Unknown,Unknown,Debit,Unknown,SVCS,Unknown,24068.0
Unknown,Unknown,0 006,Unknown,Unknown,Debit,Unknown,SVCS,Unknown,24074.0
Unknown,Unknown,0 026,Unknown,Unknown,Debit,Unknown,SVCS,Unknown,24100.0
Unknown,Unknown,13,Unknown,Unknown,Debit,Unknown,SVCS,Unknown,24113.0
Unknown,Unknown,10,Unknown,Unknown,Debit,Unknown,SVCS,Unknown,24123.0
Unknown,Unknown,13,Unknown,Unknown,Debit,Unknown,SVCS,Unknown,24136.0
Unknown,Unknown,10,Unknown,Unknown,Debit,Unknown,SVCS,Unknown,24146.0
Unknown,Unknown,9,Unknown,Unknown,Debit,Unknown,SVCS,Unknown,24155.0
Unknown,Unknown,29,Unknown,Unknown,Debit,Unknown,SVCS,Unknown,24184.0
Unknown,Unknown,10,Unknown,Unknown,Debit,Unknown,SVCS,Unknown,24194.0
Unknown,Unknown,26 15,Unknown,Unknown,Debit,Unknown,SVCS,Unknown,26809.0
Unknown,Unknown,07,Unknown,Unknown,Debit,Unknown,SVCS,Unknown,26816.0
Unknown,Unknown,10 07,Unknown,Unknown,Debit,Unknown,SVCS,Unknown,27823.0
Unknown,Unknown,10,Unknown,Unknown,Debit,Unknown,SVCS,Unknown,27833.0
Unknown,Unknown,07,Unknown,Unknown,Debit,Unknown,SVCS,Unknown,27840.0
Unknown,Unknown,10 07,Unknown,Unknown,Debit,Unknown,SVCS,Unknown,28847.0
Unknown,Unknown,"10 115,00",Unknown,Unknown,Debit,Unknown,SVCS,Unknown,1040347.0
Unknown,Unknown,07,Unknown,Unknown,Debit,Unknown,SVCS,Unknown,1040354.0
Unknown,Unknown,10 07,Unknown,Unknown,Debit,Unknown,SVCS,Unknown,1041361.0
Unknown,Unknown,10 21,Unknown,Unknown,Debit,Unknown,SVCS,Unknown,1042382.0
Unknown,Unknown,54,Unknown,Unknown,Debit,Unknown,SVCS,Unknown,1042436.0
Unknown,Unknown,08,Unknown,Unknown,Debit,Unknown,SVCS,Unknown,1042444.0
Unknown,Unknown,10 08,Unknown,Unknown,Debit,Unknown,SVCS,Unknown,1043452.0
Unknown,Unknown,10 37,Unknown,Unknown,Debit,Unknown,SVCS,Unknown,1044489.0
Unknown,Unknown,51,Unknown,Unknown,Debit,Unknown,SVCS,Unknown,1044540.0
Unknown,Unknown,11,Unknown,Unknown,Debit,Unknown,SVCS,Unknown,1044551.0
Unknown,Unknown,10 11,Unknown,Unknown,Debit,Unknown,SVCS,Unknown,1045562.0
Unknown,Unknown,10 19,Unknown,Unknown,Debit,Unknown,SVCS,Unknown,1046581.0
Unknown,Unknown,84,Unknown,Unknown,Debit,Unknown,SVCS,Unknown,1046665.0
Unknown,Unknown,0,Unknown,Unknown,Debit,Unknown,SVCS,Unknown,1046665.0
Unknown,Unknown,11,Unknown,Unknown,Debit,Unknown,SVCS,Unknown,1046676.0
Unknown,Unknown,10 11,Unknown,Unknown,Debit,Unknown,SVCS,Unknown,1047687.0
Unknown,Unknown,"10 224,49",Unknown,Unknown,Debit,Unknown,SVCS,Unknown,2070136.0
Unknown,Unknown,11,Unknown,Unknown,Debit,Unknown,SVCS,Unknown,2070147.0
Unknown,Unknown,10 11,Unknown,Unknown,Debit,Unknown,SVCS,Unknown,2071158.0
Unknown,Unknown,10 50,Unknown,Unknown,Debit,Unknown,SVCS,Unknown,2072208.0
Unknown,Unknown,99,Unknown,Unknown,Debit,Unknown,SVCS,Unknown,2072307.0
Unknown,Unknown,11,Unknown,Unknown,Debit,Unknown,SVCS,Unknown,2072318.0
Unknown,Unknown,10 11,Unknown,Unknown,Debit,Unknown,SVCS,Unknown,2073329.0
Unknown,Unknown,10 25,Unknown,Unknown,Debit,Unknown,SVCS,Unknown,2074354.0
Unknown,Unknown,96,Unknown,Unknown,Debit,Unknown,SVCS,Unknown,2074450.0
Unknown,Unknown,11,Unknown,Unknown,Debit,Unknown,SVCS,Unknown,2074461.0
Unknown,Unknown,10 11,Unknown,Unknown,Debit,Unknown,SVCS,Unknown,2075472.0
Unknown,Unknown,10 251 59,Unknown,Unknown,Debit,Unknown,SVCS,Unknown,3100631.0
Unknown,Unknown,11,Unknown,Unknown,Debit,Unknown,SVCS,Unknown,3100642.0
Unknown,Unknown,10 11,Unknown,Unknown,Debit,Unknown,SVCS,Unknown,3101653.0
Unknown,Unknown,10 89,Unknown,Unknown,Debit,Unknown,SVCS,Unknown,3102742.0
Unknown,Unknown,32,Unknown,Unknown,Debit,Unknown,SVCS,Unknown,3102774.0
Unknown,Unknown,11,Unknown,Unknown,Debit,Unknown,SVCS,Unknown,3102785.0
Unknown,Unknown,10 11,Unknown,Unknown,Debit,Unknown,SVCS,Unknown,3103796.0
Unknown,Unknown,10,Unknown,Unknown,Debit,Unknown,SVCS,Unknown,3103806.0
Unknown,Unknown,"5,87",Unknown,Unknown,Debit,Unknown,SVCS,Unknown,3104393.0
Unknown,Unknown,11,Unknown,Unknown,Debit,Unknown,SVCS,Unknown,3104404.0
Unknown,Unknown,10 11,Unknown,Unknown,Debit,Unknown,SVCS,Unknown,3105415.0
Unknown,Unknown,10 215 19,Unknown,Unknown,Debit,Unknown,SVCS,Unknown,4126934.0
Unknown,Unknown,11,Unknown,Unknown,Debit,Unknown,SVCS,Unknown,4126945.0
Unknown,Unknown,10 11,Unknown,Unknown,Debit,Unknown,SVCS,Unknown,4127956.0
Unknown,Unknown,"10 260,69",Unknown,Unknown,Debit,Unknown,SVCS,Unknown,5154025.0
Unknown,Unknown,11,Unknown,Unknown,Debit,Unknown,SVCS,Unknown,5154036.0
Unknown,Unknown,10 11,Unknown,Unknown,Debit,Unknown,SVCS,Unknown,5155047.0
Unknown,Unknown,10 11,Unknown,Unknown,Debit,Unknown,SVCS,Unknown,5156058.0
Unknown,Unknown,10 11,Unknown,Unknown,Debit,Unknown,SVCS,Unknown,5157069.0
Unknown,Unknown,10 11,Unknown,Unknown,Debit,Unknown,SVCS,Unknown,5158080.0
Unknown,Unknown,10 38,Unknown,Unknown,Debit,Unknown,SVCS,Unknown,5159118.0
Unknown,Unknown,05 11,Unknown,Unknown,Debit,Unknown,SVCS,Unknown,5159629.0
Unknown,Unknown,"10 114,18",Unknown,Unknown,Debit,Unknown,SVCS,Unknown,6171047.0
Unknown,Unknown,11,Unknown,Unknown,Debit,Unknown,SVCS,Unknown,6171058.0
Unknown,Unknown,"10 448,98",Unknown,Unknown,Debit,Unknown,SVCS,Unknown,7215956.0
Unknown,Unknown,"621,24",Unknown,Unknown,Debit,Unknown,SVCS,Unknown,7278080.0
Unknown,Unknown,11,Unknown,Unknown,Debit,Unknown,SVCS,Unknown,7278091.0
Unknown,Unknown,10 11,Unknown,Unknown,Debit,Unknown,SVCS,Unknown,7279102.0
Unknown,Unknown,10,Unknown,Unknown,Debit,Unknown,SVCS,Unknown,7279112.0
Unknown,Unknown,11,Unknown,Unknown,Debit,Unknown,SVCS,Unknown,7279123.0
Unknown,Unknown,10 103 16,Unknown,Unknown,Debit,Unknown,SVCS,Unknown,8289439.0
Unknown,Unknown,12,Unknown,Unknown,Debit,Unknown,SVCS,Unknown,8289451.0
Unknown,Unknown,10 12,Unknown,Unknown,Debit,Unknown,SVCS,Unknown,8290463.0
Unknown,Unknown,"10 160,67",Unknown,Unknown,Debit,Unknown,SVCS,Unknown,9306530.0
Unknown,Unknown,12,Unknown,Unknown,Debit,Unknown,SVCS,Unknown,9306542.0
Unknown,Unknown,10 12,Unknown,Unknown,Debit,Unknown,SVCS,Unknown,9307554.0
Unknown,Unknown,10 12,Unknown,Unknown,Debit,Unknown,SVCS,Unknown,9308566.0
Unknown,Unknown,10 12,Unknown,Unknown,Debit,Unknown,SVCS,Unknown,9309578.0
Unknown,Unknown,10 12,Unknown,Unknown,Debit,Unknown,SVCS,Unknown,9310590.0
Unknown,Unknown,10 12,Unknown,Unknown,Debit,Unknown,SVCS,Unknown,9311602.0
Unknown,Unknown,"10 213,73",Unknown,Unknown,Debit,Unknown,SVCS,Unknown,10332975.0
Unknown,Unknown,"460,00",Unknown,Unknown,Debit,Unknown,SVCS,Unknown,10378975.0
Unknown,Unknown,"76,83",Unknown,Unknown,Debit,Unknown,SVCS,Unknown,10386658.0
Unknown,Unknown,13,Unknown,Unknown,Debit,Unknown,SVCS,Unknown,10386671.0
Unknown,Unknown,10 13,Unknown,Unknown,Debit,Unknown,SVCS,Unknown,10387684.0
Unknown,Unknown,10,Unknown,Unknown,Debit,Unknown,SVCS,Unknown,10387694.0
Unknown,Unknown,5,Unknown,Unknown,Debit,Unknown,SVCS,Unknown,10387699.0
Unknown,Unknown,98,Unknown,Unknown,Debit,Unknown,SVCS,Unknown,10387797.0
Unknown,Unknown,13,Unknown,Unknown,Debit,Unknown,SVCS,Unknown,10387810.0
Unknown,Unknown,10 13,Unknown,Unknown,Debit,Unknown,SVCS,Unknown,10388823.0
Unknown,Unknown,"10 117,94",Unknown,Unknown,Debit,Unknown,SVCS,Unknown,11400617.0
Unknown,Unknown,13,Unknown,Unknown,Debit,Unknown,SVCS,Unknown,11400630.0
Unknown,Unknown,10 13,Unknown,Unknown,Debit,Unknown,SVCS,Unknown,11401643.0
Unknown,Unknown,10 296.00,Unknown,Unknown,Debit,Unknown,SVCS,Unknown,11411939.0
Unknown,Unknown,3,Unknown,Unknown,Debit,Unknown,SVCS,Unknown,11411942.0
Unknown,Unknown,09,Unknown,Unknown,Debit,Unknown,SVCS,Unknown,11411951.0
Unknown,Unknown,03,Unknown,Unknown,Debit,Unknown,SVCS,Unknown,11411954.0
Unknown,Unknown,0,Unknown,Unknown,Debit,Unknown,SVCS,Unknown,11411954.0
Unknown,Unknown,09,Unknown,Unknown,Debit,Unknown,SVCS,Unknown,11411963.0
Unknown,Unknown,0,Unknown,Unknown,Debit,Unknown,SVCS,Unknown,11411963.0
Unknown,Unknown,400 070 116,Unknown,Unknown,Debit,Unknown,SVCS,Unknown,411482079.0
Unknown,Unknown,1,Unknown,Unknown,Debit,Unknown,SVCS,Unknown,411482080.0
29/10/2021,Unknown,14,Unknown,Unknown,Cheque,Unknown,PRLV,VOTRE COMPTE COURANT N' 02421381795,14.0
Unknown,Unknown,10,Unknown,Unknown,Cheque,Unknown,PRLV,Oate CompiA Libelleireference,24.0
Unknown,Unknown,50,Unknown,Unknown,Cheque,Unknown,PRLV,82S56 CoY,74.0
Unknown,Unknown,0 166,Unknown,Unknown,Cheque,Unknown,PRLV,Cou,240.0
Unknown,Unknown,14,Unknown,Unknown,Cheque,Unknown,PRLV,Remise,254.0
Unknown,Unknown,10,Unknown,Unknown,Cheque,Unknown,PRLV,Cov,264.0
Unknown,Unknown,210,Unknown,Unknown,Cheque,Unknown,PRLV,Revise C8 5072120015,474.0
Unknown,Unknown,14,Unknown,Unknown,Cheque,Unknown,PRLV,Co,488.0
Unknown,Unknown,10,Unknown,Unknown,Cheque,Unknown,PRLV,Revise C8,498.0
Unknown,Unknown,15,Unknown,Unknown,Cheque,Unknown,PRLV,Ye CoM,513.0
Unknown,Unknown,10,Unknown,Unknown,Cheque,Unknown,PRLV,C8 470 Superu,523.0
Unknown,Unknown,0,Unknown,Unknown,Cheque,Unknown,PRLV,Vetrofrmce 6ovaULXenveli 16/10,523.0
Unknown,Unknown,15,Unknown,Unknown,Cheque,Unknown,PRLV,BRUI,538.0
Unknown,Unknown,10,Unknown,Unknown,Cheque,Unknown,PRLV,CoY,548.0
Unknown,Unknown,15,Unknown,Unknown,Cheque,Unknown,PRLV,Eviunited paRCEL SeRviC,563.0
Unknown,Unknown,10,Unknown,Unknown,Cheque,Unknown,PRLV,BRUt,573.0
Unknown,Unknown,8,Unknown,Unknown,Cheque,Unknown,PRLV,Cov,581.0
Unknown,Unknown,0 06,Unknown,Unknown,Cheque,Unknown,PRLV,RemiSE,587.0
Unknown,Unknown,15,Unknown,Unknown,Cheque,Unknown,PRLV,CoM,602.0
Unknown,Unknown,10,Unknown,Unknown,Cheque,Unknown,PRLV,Remise,612.0
Unknown,Unknown,15,Unknown,Unknown,Cheque,Unknown,PRLV,BRUr,627.0
Unknown,Unknown,10,Unknown,Unknown,Cheque,Unknown,PRLV,Remise C8 5072120015,637.0
Unknown,Unknown,470,Unknown,Unknown,Cheque,Unknown,PRLV,Revise C8 5072121012 BRUr,1107.0
Unknown,Unknown,15,Unknown,Unknown,Cheque,Unknown,PRLV,Cov,1122.0
Unknown,Unknown,10,Unknown,Unknown,Cheque,Unknown,PRLV,Verstou,1132.0
Unknown,Unknown,16,Unknown,Unknown,Cheque,Unknown,PRLV,AnNUVERST DU 121021,1148.0
Unknown,Unknown,10,Unknown,Unknown,Cheque,Unknown,PRLV,Erreuris,1158.0
Unknown,Unknown,56 236,Unknown,Unknown,Cheque,Unknown,PRLV,Vonnne,57394.0
Unknown,Unknown,0,Unknown,Unknown,Cheque,Unknown,PRLV,C8:4704 Relis MacoN,57394.0
Unknown,Unknown,16,Unknown,Unknown,Cheque,Unknown,PRLV,C8*4704 McTRo,57410.0
Unknown,Unknown,10,Unknown,Unknown,Cheque,Unknown,PRLV,Rexise,57420.0
Unknown,Unknown,18,Unknown,Unknown,Cheque,Unknown,PRLV,C8 5072121012,57438.0
Unknown,Unknown,10,Unknown,Unknown,Cheque,Unknown,PRLV,Date Daie,57448.0
Unknown,Unknown,09,Unknown,Unknown,Cheque,Unknown,PRLV,O9Taiam,57457.0
Unknown,Unknown,"30,72",Unknown,Unknown,Cheque,Unknown,PRLV,DBYQiEP,60529.0
Unknown,Unknown,28,Unknown,Unknown,Cheque,Unknown,PRLV,Franche-Comte,60557.0
Unknown,Unknown,228 18,Unknown,Unknown,Cheque,Unknown,PRLV,PAGE ^ Baroue PoPUARf,83375.0
Unknown,Unknown,10,Unknown,Unknown,Cheque,Unknown,PRLV,BoUaGocefaarof Couie,83385.0
Unknown,Unknown,18,Unknown,Unknown,Cheque,Unknown,PRLV,Voo 8Dacs 0io Cooon Qio2y IAilcor 6a,83403.0
Unknown,Unknown,10,Unknown,Unknown,Cheque,Unknown,PRLV,Irc 8,83413.0
Unknown,Unknown,18,Unknown,Unknown,Cheque,Unknown,PRLV,Cooor CcP Dnn,83431.0
Unknown,Unknown,10,Unknown,Unknown,Cheque,Unknown,PRLV,Unknown,83441.0
Unknown,Unknown,18,Unknown,Unknown,Cheque,Unknown,PRLV,Unknown,83459.0
Unknown,Unknown,10,Unknown,Unknown,Cheque,Unknown,PRLV,Unknown,83469.0
Unknown,Unknown,18,Unknown,Unknown,Cheque,Unknown,PRLV,Unknown,83487.0
Unknown,Unknown,10,Unknown,Unknown,Cheque,Unknown,PRLV,Unknown,83497.0
Unknown,Unknown,0 036,Unknown,Unknown,Cheque,Unknown,PRLV,Unknown,83533.0
Unknown,Unknown,12,Unknown,Unknown,Cheque,Unknown,PRLV,Unknown,83545.0
Unknown,Unknown,851 18,Unknown,Unknown,Cheque,Unknown,PRLV,Unknown,168663.0
Unknown,Unknown,10,Unknown,Unknown,Cheque,Unknown,PRLV,Unknown,168673.0
Unknown,Unknown,18,Unknown,Unknown,Cheque,Unknown,PRLV,Unknown,168691.0
Unknown,Unknown,10,Unknown,Unknown,Cheque,Unknown,PRLV,Unknown,168701.0
Unknown,Unknown,017 18,Unknown,Unknown,Cheque,Unknown,PRLV,Unknown,170419.0
Unknown,Unknown,10,Unknown,Unknown,Cheque,Unknown,PRLV,Unknown,170429.0
Unknown,Unknown,460,Unknown,Unknown,Cheque,Unknown,PRLV,Unknown,170889.0
Unknown,Unknown,459,Unknown,Unknown,Cheque,Unknown,PRLV,Unknown,171348.0
Unknown,Unknown,5,Unknown,Unknown,Cheque,Unknown,PRLV,Unknown,171353.0
Unknown,Unknown,18,Unknown,Unknown,Cheque,Unknown,PRLV,Unknown,171371.0
Unknown,Unknown,10,Unknown,Unknown,Cheque,Unknown,PRLV,Unknown,171381.0
Unknown,Unknown,60,Unknown,Unknown,Cheque,Unknown,PRLV,Unknown,171441.0
Unknown,Unknown,18,Unknown,Unknown,Cheque,Unknown,PRLV,Unknown,171459.0
Unknown,Unknown,10,Unknown,Unknown,Cheque,Unknown,PRLV,Unknown,171469.0
Unknown,Unknown,18,Unknown,Unknown,Cheque,Unknown,PRLV,Unknown,171487.0
Unknown,Unknown,10,Unknown,Unknown,Cheque,Unknown,PRLV,Unknown,171497.0
Unknown,Unknown,19,Unknown,Unknown,Cheque,Unknown,PRLV,Unknown,171516.0
Unknown,Unknown,10,Unknown,Unknown,Cheque,Unknown,PRLV,Unknown,171526.0
Unknown,Unknown,0 256,Unknown,Unknown,Cheque,Unknown,PRLV,Unknown,171782.0
Unknown,Unknown,19,Unknown,Unknown,Cheque,Unknown,PRLV,Unknown,171801.0
Unknown,Unknown,10,Unknown,Unknown,Cheque,Unknown,PRLV,Unknown,171811.0
Unknown,Unknown,72,Unknown,Unknown,Cheque,Unknown,PRLV,Unknown,171883.0
Unknown,Unknown,9,Unknown,Unknown,Cheque,Unknown,PRLV,Unknown,171892.0
Unknown,Unknown,29,Unknown,Unknown,Cheque,Unknown,PRLV,Unknown,171921.0
Unknown,Unknown,10,Unknown,Unknown,Cheque,Unknown,PRLV,Unknown,171931.0
Unknown,Unknown,"42,40",Unknown,Unknown,Cheque,Unknown,PRLV,Unknown,176171.0
Unknown,Unknown,13,Unknown,Unknown,Cheque,Unknown,PRLV,Unknown,176184.0
Unknown,Unknown,10 13,Unknown,Unknown,Cheque,Unknown,PRLV,Unknown,177197.0
Unknown,Unknown,10,Unknown,Unknown,Cheque,Unknown,PRLV,Unknown,177207.0
Unknown,Unknown,13,Unknown,Unknown,Cheque,Unknown,PRLV,Unknown,177220.0
Unknown,Unknown,10 13,Unknown,Unknown,Cheque,Unknown,PRLV,Unknown,178233.0
Unknown,Unknown,10 210 25,Unknown,Unknown,Cheque,Unknown,PRLV,Unknown,1199258.0
Unknown,Unknown,14,Unknown,Unknown,Cheque,Unknown,PRLV,Unknown,1199272.0
Unknown,Unknown,10,Unknown,Unknown,Cheque,Unknown,PRLV,Unknown,1199282.0
Unknown,Unknown,14,Unknown,Unknown,Cheque,Unknown,PRLV,Unknown,1199296.0
Unknown,Unknown,10 14,Unknown,Unknown,Cheque,Unknown,PRLV,Unknown,1200310.0
Unknown,Unknown,10 14,Unknown,Unknown,Cheque,Unknown,PRLV,Unknown,1201324.0
Unknown,Unknown,"10 500,00",Unknown,Unknown,Cheque,Unknown,PRLV,Unknown,2251324.0
Unknown,Unknown,62 03,Unknown,Unknown,Cheque,Unknown,PRLV,Unknown,2257527.0
Unknown,Unknown,15,Unknown,Unknown,Cheque,Unknown,PRLV,Unknown,2257542.0
Unknown,Unknown,10 15,Unknown,Unknown,Cheque,Unknown,PRLV,Unknown,2258557.0
Unknown,Unknown,"10 199,52",Unknown,Unknown,Cheque,Unknown,PRLV,Unknown,3278509.0
Unknown,Unknown,15,Unknown,Unknown,Cheque,Unknown,PRLV,Unknown,3278524.0
Unknown,Unknown,10 15,Unknown,Unknown,Cheque,Unknown,PRLV,Unknown,3279539.0
Unknown,Unknown,10,Unknown,Unknown,Cheque,Unknown,PRLV,Unknown,3279549.0
Unknown,Unknown,9 27,Unknown,Unknown,Cheque,Unknown,PRLV,Unknown,3280476.0
Unknown,Unknown,15,Unknown,Unknown,Cheque,Unknown,PRLV,Unknown,3280491.0
Unknown,Unknown,10 15,Unknown,Unknown,Cheque,Unknown,PRLV,Unknown,3281506.0
Unknown,Unknown,"10 205,34",Unknown,Unknown,Cheque,Unknown,PRLV,Unknown,4302040.0
Unknown,Unknown,15,Unknown,Unknown,Cheque,Unknown,PRLV,Unknown,4302055.0
Unknown,Unknown,10,Unknown,Unknown,Cheque,Unknown,PRLV,Unknown,4302065.0
Unknown,Unknown,15,Unknown,Unknown,Cheque,Unknown,PRLV,Unknown,4302080.0
Unknown,Unknown,10,Unknown,Unknown,Cheque,Unknown,PRLV,Unknown,4302090.0
Unknown,Unknown,15,Unknown,Unknown,Cheque,Unknown,PRLV,Unknown,4302105.0
Unknown,Unknown,10 15,Unknown,Unknown,Cheque,Unknown,PRLV,Unknown,4303120.0
Unknown,Unknown,10 15,Unknown,Unknown,Cheque,Unknown,PRLV,Unknown,4304135.0
Unknown,Unknown,"10 259,15",Unknown,Unknown,Cheque,Unknown,PRLV,Unknown,5330050.0
Unknown,Unknown,766 83,Unknown,Unknown,Cheque,Unknown,PRLV,Unknown,5406733.0
Unknown,Unknown,15,Unknown,Unknown,Cheque,Unknown,PRLV,Unknown,5406748.0
Unknown,Unknown,10 56,Unknown,Unknown,Cheque,Unknown,PRLV,Unknown,5407804.0
Unknown,Unknown,05,Unknown,Unknown,Cheque,Unknown,PRLV,Unknown,5407809.0
Unknown,Unknown,15,Unknown,Unknown,Cheque,Unknown,PRLV,Unknown,5407824.0
Unknown,Unknown,10 15,Unknown,Unknown,Cheque,Unknown,PRLV,Unknown,5408839.0
Unknown,Unknown,10,Unknown,Unknown,Cheque,Unknown,PRLV,Unknown,5408849.0
Unknown,Unknown,3 90,Unknown,Unknown,Cheque,Unknown,PRLV,Unknown,5409239.0
Unknown,Unknown,18,Unknown,Unknown,Cheque,Unknown,PRLV,Unknown,5409257.0
Unknown,Unknown,10 18,Unknown,Unknown,Cheque,Unknown,PRLV,Unknown,5410275.0
Unknown,Unknown,10 72,Unknown,Unknown,Cheque,Unknown,PRLV,Unknown,5411347.0
Unknown,Unknown,48,Unknown,Unknown,Cheque,Unknown,PRLV,Unknown,5411395.0
Unknown,Unknown,0,Unknown,Unknown,Cheque,Unknown,PRLV,Unknown,5411395.0
Unknown,Unknown,18,Unknown,Unknown,Cheque,Unknown,PRLV,Unknown,5411413.0
Unknown,Unknown,10 18,Unknown,Unknown,Cheque,Unknown,PRLV,Unknown,5412431.0
Unknown,Unknown,"10 247,42",Unknown,Unknown,Cheque,Unknown,PRLV,Unknown,6437173.0
Unknown,Unknown,18,Unknown,Unknown,Cheque,Unknown,PRLV,Unknown,6437191.0
Unknown,Unknown,10 18,Unknown,Unknown,Cheque,Unknown,PRLV,Unknown,6438209.0
Unknown,Unknown,10 24,Unknown,Unknown,Cheque,Unknown,PRLV,Unknown,6439233.0
Unknown,Unknown,31,Unknown,Unknown,Cheque,Unknown,PRLV,Unknown,6439264.0
Unknown,Unknown,18,Unknown,Unknown,Cheque,Unknown,PRLV,Unknown,6439282.0
Unknown,Unknown,10 18,Unknown,Unknown,Cheque,Unknown,PRLV,Unknown,6440300.0
Unknown,Unknown,"10 113,57",Unknown,Unknown,Cheque,Unknown,PRLV,Unknown,7451657.0
Unknown,Unknown,18,Unknown,Unknown,Cheque,Unknown,PRLV,Unknown,7451675.0
Unknown,Unknown,10,Unknown,Unknown,Cheque,Unknown,PRLV,Unknown,7451685.0
Unknown,Unknown,10 24,Unknown,Unknown,Cheque,Unknown,PRLV,Unknown,7452709.0
Unknown,Unknown,60,Unknown,Unknown,Cheque,Unknown,PRLV,Unknown,7452769.0
Unknown,Unknown,18,Unknown,Unknown,Cheque,Unknown,PRLV,Unknown,7452787.0
Unknown,Unknown,10 18,Unknown,Unknown,Cheque,Unknown,PRLV,Unknown,7453805.0
Unknown,Unknown,10,Unknown,Unknown,Cheque,Unknown,PRLV,Unknown,7453815.0
Unknown,Unknown,"8,67",Unknown,Unknown,Cheque,Unknown,PRLV,Unknown,7454682.0
Unknown,Unknown,18,Unknown,Unknown,Cheque,Unknown,PRLV,Unknown,7454700.0
Unknown,Unknown,10 18,Unknown,Unknown,Cheque,Unknown,PRLV,Unknown,7455718.0
Unknown,Unknown,10 181 44,Unknown,Unknown,Cheque,Unknown,PRLV,Unknown,8473862.0
Unknown,Unknown,18,Unknown,Unknown,Cheque,Unknown,PRLV,Unknown,8473880.0
Unknown,Unknown,10 18,Unknown,Unknown,Cheque,Unknown,PRLV,Unknown,8474898.0
Unknown,Unknown,10 146,Unknown,Unknown,Cheque,Unknown,PRLV,Unknown,8485044.0
Unknown,Unknown,08,Unknown,Unknown,Cheque,Unknown,PRLV,Unknown,8485052.0
Unknown,Unknown,18,Unknown,Unknown,Cheque,Unknown,PRLV,Unknown,8485070.0
Unknown,Unknown,10 12,Unknown,Unknown,Cheque,Unknown,PRLV,Unknown,8486082.0
Unknown,Unknown,"10 459,50",Unknown,Unknown,Cheque,Unknown,PRLV,Unknown,9532032.0
Unknown,Unknown,18,Unknown,Unknown,Cheque,Unknown,PRLV,Unknown,9532050.0
Unknown,Unknown,10 12,Unknown,Unknown,Cheque,Unknown,PRLV,Unknown,9533062.0
Unknown,Unknown,"10 460,00",Unknown,Unknown,Cheque,Unknown,PRLV,Unknown,10579062.0
Unknown,Unknown,18,Unknown,Unknown,Cheque,Unknown,PRLV,Unknown,10579080.0
Unknown,Unknown,10,Unknown,Unknown,Cheque,Unknown,PRLV,Unknown,10579090.0
Unknown,Unknown,18,Unknown,Unknown,Cheque,Unknown,PRLV,Unknown,10579108.0
Unknown,Unknown,10,Unknown,Unknown,Cheque,Unknown,PRLV,Unknown,10579118.0
Unknown,Unknown,18,Unknown,Unknown,Cheque,Unknown,PRLV,Unknown,10579136.0
Unknown,Unknown,10 18,Unknown,Unknown,Cheque,Unknown,PRLV,Unknown,10580154.0
Unknown,Unknown,10 18,Unknown,Unknown,Cheque,Unknown,PRLV,Unknown,10581172.0
Unknown,Unknown,10 76,Unknown,Unknown,Cheque,Unknown,PRLV,Unknown,10582248.0
Unknown,Unknown,00,Unknown,Unknown,Cheque,Unknown,PRLV,Unknown,10582248.0
Unknown,Unknown,"1 081,87",Unknown,Unknown,Cheque,Unknown,PRLV,Unknown,10690435.0
Unknown,Unknown,18,Unknown,Unknown,Cheque,Unknown,PRLV,Unknown,10690453.0
Unknown,Unknown,10 80,Unknown,Unknown,Cheque,Unknown,PRLV,Unknown,10691533.0
Unknown,Unknown,19,Unknown,Unknown,Cheque,Unknown,PRLV,Unknown,10691552.0
Unknown,Unknown,18,Unknown,Unknown,Cheque,Unknown,PRLV,Unknown,10691570.0
Unknown,Unknown,10 18,Unknown,Unknown,Cheque,Unknown,PRLV,Unknown,10692588.0
Unknown,Unknown,10 105,Unknown,Unknown,Cheque,Unknown,PRLV,Unknown,10702693.0
Unknown,Unknown,72,Unknown,Unknown,Cheque,Unknown,PRLV,Unknown,10702765.0
Unknown,Unknown,718,Unknown,Unknown,Cheque,Unknown,PRLV,Unknown,10703483.0
Unknown,Unknown,209,Unknown,Unknown,Cheque,Unknown,PRLV,Unknown,10703692.0
Unknown,Unknown,0,Unknown,Unknown,Cheque,Unknown,PRLV,Unknown,10703692.0
Unknown,Unknown,60,Unknown,Unknown,Cheque,Unknown,PRLV,Unknown,10703752.0
Unknown,Unknown,03,Unknown,Unknown,Cheque,Unknown,PRLV,Unknown,10703755.0
Unknown,Unknown,16,Unknown,Unknown,Cheque,Unknown,PRLV,Unknown,10703771.0
30/09/2021,Unknown,20,Unknown,Unknown,Debit,Unknown,RYTHMEO,VOTRE COMPTE COURANT N,20.0
30/09/2021,Unknown,09,Unknown,Unknown,Debit,Unknown,RYTHMEO,DATE,29.0
Unknown,Unknown,60,Unknown,Unknown,Debit,Unknown,RYTHMEO,C8 5033080011 BRUT 60 0e,89.0
Unknown,Unknown,0,Unknown,Unknown,Debit,Unknown,RYTHMEO,M80001/158866,89.0
Unknown,Unknown,20,Unknown,Unknown,Debit,Unknown,RYTHMEO,REMISE,109.0
Unknown,Unknown,09,Unknown,Unknown,Debit,Unknown,RYTHMEO,S7E,118.0
Unknown,Unknown,20,Unknown,Unknown,Debit,Unknown,RYTHMEO,COIRAT,138.0
Unknown,Unknown,09,Unknown,Unknown,Debit,Unknown,RYTHMEO,REMISE,147.0
Unknown,Unknown,85,Unknown,Unknown,Debit,Unknown,RYTHMEO,CB 5033081015 BRUT,232.0
Unknown,Unknown,0,Unknown,Unknown,Debit,Unknown,RYTHMEO,Ooe CoM,232.0
Unknown,Unknown,21,Unknown,Unknown,Debit,Unknown,RYTHMEO,REMISE,253.0
Unknown,Unknown,09,Unknown,Unknown,Debit,Unknown,RYTHMEO,J9e HBo002/182864,262.0
Unknown,Unknown,22,Unknown,Unknown,Debit,Unknown,RYTHMEO,C8 5033080011 BRUT,284.0
Unknown,Unknown,09,Unknown,Unknown,Debit,Unknown,RYTHMEO,REBRSE CB,293.0
Unknown,Unknown,0,Unknown,Unknown,Debit,Unknown,RYTHMEO,COH 0 50E,293.0
Unknown,Unknown,22,Unknown,Unknown,Debit,Unknown,RYTHMEO,CoM,315.0
Unknown,Unknown,09,Unknown,Unknown,Debit,Unknown,RYTHMEO,REMISE,324.0
Unknown,Unknown,23 806,Unknown,Unknown,Debit,Unknown,RYTHMEO,C8 5033080011 BRUT 200,24130.0
Unknown,Unknown,23,Unknown,Unknown,Debit,Unknown,RYTHMEO,Cou 0,24153.0
Unknown,Unknown,09,Unknown,Unknown,Debit,Unknown,RYTHMEO,ReMISE,24162.0
Unknown,Unknown,0,Unknown,Unknown,Debit,Unknown,RYTHMEO,DATE DaTE OPERATION,24162.0
Unknown,Unknown,55,Unknown,Unknown,Debit,Unknown,RYTHMEO,CKSOTNG,24217.0
Unknown,Unknown,0,Unknown,Unknown,Debit,Unknown,RYTHMEO,TOTAL DES MOUVEMENTS,24217.0
Unknown,Unknown,180,Unknown,Unknown,Debit,Unknown,RYTHMEO,uabonsen cus dencosremnteidune,24397.0
Unknown,Unknown,28,Unknown,Unknown,Debit,Unknown,RYTHMEO,TVAoudeb Qo,24425.0
Unknown,Unknown,09,Unknown,Unknown,Debit,Unknown,RYTHMEO,Resolubon,24434.0
Unknown,Unknown,175,Unknown,Unknown,Debit,Unknown,RYTHMEO,Reportez,24609.0
Unknown,Unknown,29,Unknown,Unknown,Debit,Unknown,RYTHMEO,FGDR,24638.0
Unknown,Unknown,09,Unknown,Unknown,Debit,Unknown,RYTHMEO,lormulaire dnlormation comnmunique,24647.0
Unknown,Unknown,200 06,Unknown,Unknown,Debit,Unknown,RYTHMEO,Lvret A,44653.0
Unknown,Unknown,29,Unknown,Unknown,Debit,Unknown,RYTHMEO,Lvret de Developpement Durable,44682.0
Unknown,Unknown,09,Unknown,Unknown,Debit,Unknown,RYTHMEO,Sohdare,44691.0
Unknown,Unknown,84,Unknown,Unknown,Debit,Unknown,RYTHMEO,Uvret dEpargne Populare,44775.0
Unknown,Unknown,0,Unknown,Unknown,Debit,Unknown,RYTHMEO,Banque Populaire Rives,44775.0
Unknown,Unknown,30,Unknown,Unknown,Debit,Unknown,RYTHMEO,Paris,44805.0
Unknown,Unknown,09,Unknown,Unknown,Debit,Unknown,RYTHMEO,Bnqe Poouare,44814.0
Unknown,Unknown,138,Unknown,Unknown,Debit,Unknown,RYTHMEO,Bnqe,44952.0
Unknown,Unknown,0,Unknown,Unknown,Debit,Unknown,RYTHMEO,Pais SooueimmtialecauRegsre,44952.0
Unknown,Unknown,30,Unknown,Unknown,Debit,Unknown,RYTHMEO,Aswnc sousk n07,44982.0
Unknown,Unknown,09,Unknown,Unknown,Debit,Unknown,RYTHMEO,Yous pouZ poulor,44991.0
Unknown,Unknown,5,Unknown,Unknown,Debit,Unknown,RYTHMEO,p0 non Vlue,44996.0
Unknown,Unknown,30,Unknown,Unknown,Debit,Unknown,RYTHMEO,Ms,45026.0
Unknown,Unknown,09,Unknown,Unknown,Debit,Unknown,RYTHMEO,Pourla,45035.0
Unknown,Unknown,"59,33",Unknown,Unknown,Debit,Unknown,RYTHMEO,Moou,50968.0
Unknown,Unknown,20,Unknown,Unknown,Debit,Unknown,RYTHMEO,Unknown,50988.0
Unknown,Unknown,09 20,Unknown,Unknown,Debit,Unknown,RYTHMEO,Unknown,51908.0
Unknown,Unknown,09,Unknown,Unknown,Debit,Unknown,RYTHMEO,Unknown,51917.0
Unknown,Unknown,20,Unknown,Unknown,Debit,Unknown,RYTHMEO,Unknown,51937.0
Unknown,Unknown,09 20,Unknown,Unknown,Debit,Unknown,RYTHMEO,Unknown,52857.0
Unknown,Unknown,09 84,Unknown,Unknown,Debit,Unknown,RYTHMEO,Unknown,53841.0
Unknown,Unknown,43,Unknown,Unknown,Debit,Unknown,RYTHMEO,Unknown,53884.0
Unknown,Unknown,20,Unknown,Unknown,Debit,Unknown,RYTHMEO,Unknown,53904.0
Unknown,Unknown,09 20,Unknown,Unknown,Debit,Unknown,RYTHMEO,Unknown,54824.0
Unknown,Unknown,09,Unknown,Unknown,Debit,Unknown,RYTHMEO,Unknown,54833.0
Unknown,Unknown,22,Unknown,Unknown,Debit,Unknown,RYTHMEO,Unknown,54855.0
Unknown,Unknown,09,Unknown,Unknown,Debit,Unknown,RYTHMEO,Unknown,54864.0
Unknown,Unknown,"43,51",Unknown,Unknown,Debit,Unknown,RYTHMEO,Unknown,59215.0
Unknown,Unknown,22,Unknown,Unknown,Debit,Unknown,RYTHMEO,Unknown,59237.0
Unknown,Unknown,09,Unknown,Unknown,Debit,Unknown,RYTHMEO,Unknown,59246.0
Unknown,Unknown,"122,41",Unknown,Unknown,Debit,Unknown,RYTHMEO,Unknown,71487.0
Unknown,Unknown,23,Unknown,Unknown,Debit,Unknown,RYTHMEO,Unknown,71510.0
Unknown,Unknown,09 23,Unknown,Unknown,Debit,Unknown,RYTHMEO,Unknown,72433.0
Unknown,Unknown,09 43,Unknown,Unknown,Debit,Unknown,RYTHMEO,Unknown,73376.0
Unknown,Unknown,82,Unknown,Unknown,Debit,Unknown,RYTHMEO,Unknown,73458.0
Unknown,Unknown,27,Unknown,Unknown,Debit,Unknown,RYTHMEO,Unknown,73485.0
Unknown,Unknown,09,Unknown,Unknown,Debit,Unknown,RYTHMEO,Unknown,73494.0
Unknown,Unknown,"54,50",Unknown,Unknown,Debit,Unknown,RYTHMEO,Unknown,78944.0
Unknown,Unknown,"178,52",Unknown,Unknown,Debit,Unknown,RYTHMEO,Unknown,96796.0
Unknown,Unknown,28,Unknown,Unknown,Debit,Unknown,RYTHMEO,Unknown,96824.0
Unknown,Unknown,"09 173,12",Unknown,Unknown,Debit,Unknown,RYTHMEO,Unknown,1014136.0
Unknown,Unknown,29,Unknown,Unknown,Debit,Unknown,RYTHMEO,Unknown,1014165.0
Unknown,Unknown,09 29,Unknown,Unknown,Debit,Unknown,RYTHMEO,Unknown,1015094.0
Unknown,Unknown,"09 198,50",Unknown,Unknown,Debit,Unknown,RYTHMEO,Unknown,1934944.0
Unknown,Unknown,29,Unknown,Unknown,Debit,Unknown,RYTHMEO,Unknown,1934973.0
Unknown,Unknown,09 29,Unknown,Unknown,Debit,Unknown,RYTHMEO,Unknown,1935902.0
Unknown,Unknown,09 83,Unknown,Unknown,Debit,Unknown,RYTHMEO,Unknown,1936885.0
Unknown,Unknown,55,Unknown,Unknown,Debit,Unknown,RYTHMEO,Unknown,1936940.0
Unknown,Unknown,30,Unknown,Unknown,Debit,Unknown,RYTHMEO,Unknown,1936970.0
Unknown,Unknown,09 30,Unknown,Unknown,Debit,Unknown,RYTHMEO,Unknown,1937900.0
Unknown,Unknown,"09 137,42",Unknown,Unknown,Debit,Unknown,RYTHMEO,Unknown,2851642.0
Unknown,Unknown,30,Unknown,Unknown,Debit,Unknown,RYTHMEO,Unknown,2851672.0
Unknown,Unknown,09 30,Unknown,Unknown,Debit,Unknown,RYTHMEO,Unknown,2852602.0
Unknown,Unknown,09 60,Unknown,Unknown,Debit,Unknown,RYTHMEO,Unknown,2853562.0
Unknown,Unknown,02,Unknown,Unknown,Debit,Unknown,RYTHMEO,Unknown,2853564.0
Unknown,Unknown,30,Unknown,Unknown,Debit,Unknown,RYTHMEO,Unknown,2853594.0
Unknown,Unknown,09,Unknown,Unknown,Debit,Unknown,RYTHMEO,Unknown,2853603.0
Unknown,Unknown,"1 511,15",Unknown,Unknown,Debit,Unknown,RYTHMEO,Unknown,3004718.0
Unknown,Unknown,"987,22",Unknown,Unknown,Debit,Unknown,RYTHMEO,Unknown,3103440.0
Unknown,Unknown,"672,71",Unknown,Unknown,Debit,Unknown,RYTHMEO,Unknown,3170711.0
Unknown,Unknown,2,Unknown,Unknown,Debit,Unknown,RYTHMEO,Unknown,3170713.0
Unknown,Unknown,0,Unknown,Unknown,Debit,Unknown,RYTHMEO,Unknown,3170713.0
Unknown,Unknown,11,Unknown,Unknown,Debit,Unknown,RYTHMEO,Unknown,3170724.0
Unknown,Unknown,75,Unknown,Unknown,Debit,Unknown,RYTHMEO,Unknown,3170799.0
18/09/2021,40,Unknown,40,Unknown,Cash,Unknown,EPI SERVICE PRIMEUR,Titulaire(s,-40.0
18/09/2021,10,Unknown,10,Unknown,Cash,Unknown,EPI SERVICE PRIMEUR,Date Date de Valeur,-50.0
18/09/2021,5,Unknown,5,Unknown,Cash,Unknown,EPI SERVICE PRIMEUR,COM,-55.0
20/09/2021,10,Unknown,10,Unknown,Cash,Unknown,EPI SERVICE PRIMEUR,CARTES,-65.0
20/09/2021,20,Unknown,20,Unknown,Cash,Unknown,EPI SERVICE PRIMEUR,COM,-85.0
20/09/2021,09 20,Unknown,09 20,Unknown,Cash,Unknown,EPI SERVICE PRIMEUR,COM,-1005.0
21/09/2021,09 20,Unknown,09 20,Unknown,Cash,Unknown,EPI SERVICE PRIMEUR,CARTES,-1925.0
20/09/2021,09 20,Unknown,09 20,Unknown,Cash,Unknown,EPI SERVICE PRIMEUR,METRO CASH,-2845.0
20/09/2021,09 18,Unknown,09 18,Unknown,Cash,Unknown,EPI SERVICE PRIMEUR,METRO CASH,-3763.0
21/09/2021,09,Unknown,09,Unknown,Cash,Unknown,EPI SERVICE PRIMEUR,REMISE,-3772.0
21/09/2021,64,Unknown,64,Unknown,Cash,Unknown,EPI SERVICE PRIMEUR,REMISE,-3836.0
21/09/2021,18,Unknown,18,Unknown,Cash,Unknown,EPI SERVICE PRIMEUR,TPV,-3854.0
21/09/2021,09,Unknown,09,Unknown,Cash,Unknown,EPI SERVICE PRIMEUR,REMISE,-3863.0
21/09/2021,64,Unknown,64,Unknown,Cash,Unknown,EPI SERVICE PRIMEUR,TPV,-3927.0
21/09/2021,18,Unknown,18,Unknown,Cash,Unknown,EPI SERVICE PRIMEUR,CARTE,-3945.0
21/09/2021,09,Unknown,09,Unknown,Cash,Unknown,EPI SERVICE PRIMEUR,CARREFOUR RENNES,-3954.0
21/09/2021,01,Unknown,01,Unknown,Cash,Unknown,EPI SERVICE PRIMEUR,COM,-3955.0
21/09/2021,20,Unknown,20,Unknown,Cash,Unknown,EPI SERVICE PRIMEUR,CARTES,-3975.0
21/09/2021,09,Unknown,09,Unknown,Cash,Unknown,EPI SERVICE PRIMEUR,COM,-3984.0
21/09/2021,20,Unknown,20,Unknown,Cash,Unknown,EPI SERVICE PRIMEUR,CARTES,-4004.0
22/09/2021,09,Unknown,09,Unknown,Cash,Unknown,EPI SERVICE PRIMEUR,COM,-4013.0
22/09/2021,20,Unknown,20,Unknown,Cash,Unknown,EPI SERVICE PRIMEUR,CARTES 0386405 64 2009,-4033.0
22/09/2021,09,Unknown,09,Unknown,Cash,Unknown,EPI SERVICE PRIMEUR,COM,-4042.0
22/09/2021,21,Unknown,21,Unknown,Cash,Unknown,EPI SERVICE PRIMEUR,CARTES,-4063.0
22/09/2021,09,Unknown,09,Unknown,Cash,Unknown,EPI SERVICE PRIMEUR,COM,-4072.0
22/09/2021,20,Unknown,20,Unknown,Cash,Unknown,EPI SERVICE PRIMEUR,CARTES,-4092.0
22/09/2021,09,Unknown,09,Unknown,Cash,Unknown,EPI SERVICE PRIMEUR,COM,-4101.0
22/09/2021,20,Unknown,20,Unknown,Cash,Unknown,EPI SERVICE PRIMEUR,CARTES,-4121.0
22/09/2021,09,Unknown,09,Unknown,Cash,Unknown,EPI SERVICE PRIMEUR,REMISE,-4130.0
22/09/2021,21,Unknown,21,Unknown,Cash,Unknown,EPI SERVICE PRIMEUR,TPV,-4151.0
23/09/2021,09,Unknown,09,Unknown,Cash,Unknown,EPI SERVICE PRIMEUR,REMISE,-4160.0
22/09/2021,20,Unknown,20,Unknown,Cash,Unknown,EPI SERVICE PRIMEUR,TPV,-4180.0
22/09/2021,09,Unknown,09,Unknown,Cash,Unknown,EPI SERVICE PRIMEUR,REMISE,-4189.0
23/09/2021,21,Unknown,21,Unknown,Cash,Unknown,EPI SERVICE PRIMEUR,TPV,-4210.0
23/09/2021,09,Unknown,09,Unknown,Cash,Unknown,EPI SERVICE PRIMEUR,REMISE,-4219.0
23/09/2021,64,Unknown,64,Unknown,Cash,Unknown,EPI SERVICE PRIMEUR,TPV,-4283.0
23/09/2021,21,Unknown,21,Unknown,Cash,Unknown,EPI SERVICE PRIMEUR,TPV,-4304.0
23/09/2021,09,Unknown,09,Unknown,Cash,Unknown,EPI SERVICE PRIMEUR,COM,-4313.0
23/09/2021,01,Unknown,01,Unknown,Cash,Unknown,EPI SERVICE PRIMEUR,CARTES,-4314.0
23/09/2021,21,Unknown,21,Unknown,Cash,Unknown,EPI SERVICE PRIMEUR,COM,-4335.0
23/09/2021,09,Unknown,09,Unknown,Cash,Unknown,EPI SERVICE PRIMEUR,CARTES,-4344.0
23/09/2021,64,Unknown,64,Unknown,Cash,Unknown,EPI SERVICE PRIMEUR,COM,-4408.0
Unknown,21,Unknown,21,Unknown,Cash,Unknown,EPI SERVICE PRIMEUR,CARTES 0386405,-4429.0
Unknown,09,Unknown,09,Unknown,Cash,Unknown,EPI SERVICE PRIMEUR,COM,-4438.0
Unknown,01,Unknown,01,Unknown,Cash,Unknown,EPI SERVICE PRIMEUR,CARTES,-4439.0
Unknown,21,Unknown,21,Unknown,Cash,Unknown,EPI SERVICE PRIMEUR,COM,-4460.0
Unknown,09,Unknown,09,Unknown,Cash,Unknown,EPI SERVICE PRIMEUR,CARTES,-4469.0
Unknown,64,Unknown,64,Unknown,Cash,Unknown,EPI SERVICE PRIMEUR,COM,-4533.0
Unknown,21,Unknown,21,Unknown,Cash,Unknown,EPI SERVICE PRIMEUR,COM,-4554.0
Unknown,09,Unknown,09,Unknown,Cash,Unknown,EPI SERVICE PRIMEUR,CARTES,-4563.0
Unknown,01,Unknown,01,Unknown,Cash,Unknown,EPI SERVICE PRIMEUR,TPV,-4564.0
Unknown,21,Unknown,21,Unknown,Cash,Unknown,EPI SERVICE PRIMEUR,TPV,-4585.0
Unknown,09,Unknown,09,Unknown,Cash,Unknown,EPI SERVICE PRIMEUR,REMISE,-4594.0
Unknown,21,Unknown,21,Unknown,Cash,Unknown,EPI SERVICE PRIMEUR,TPV,-4615.0
Unknown,09,Unknown,09,Unknown,Cash,Unknown,EPI SERVICE PRIMEUR,TPV,-4624.0
Unknown,21,Unknown,21,Unknown,Cash,Unknown,EPI SERVICE PRIMEUR,CARTE,-4645.0
Unknown,09,Unknown,09,Unknown,Cash,Unknown,EPI SERVICE PRIMEUR,ENTREP-,-4654.0
Unknown,21,Unknown,21,Unknown,Cash,Unknown,EPI SERVICE PRIMEUR,London,-4675.0
Unknown,09,Unknown,09,Unknown,Cash,Unknown,EPI SERVICE PRIMEUR,EUR 23/09/2021,-4684.0
Unknown,22,Unknown,22,Unknown,Cash,Unknown,EPI SERVICE PRIMEUR,CARTE,-4706.0
Unknown,09,Unknown,09,Unknown,Cash,Unknown,EPI SERVICE PRIMEUR,COM,-4715.0
Unknown,22,Unknown,22,Unknown,Cash,Unknown,EPI SERVICE PRIMEUR,CARTES,-4737.0
Unknown,09,Unknown,09,Unknown,Cash,Unknown,EPI SERVICE PRIMEUR,COM,-4746.0
Unknown,64,Unknown,64,Unknown,Cash,Unknown,EPI SERVICE PRIMEUR,CARTES 0386405,-4810.0
Unknown,22,Unknown,22,Unknown,Cash,Unknown,EPI SERVICE PRIMEUR,COM,-4832.0
Unknown,09,Unknown,09,Unknown,Cash,Unknown,EPI SERVICE PRIMEUR,CARTES,-4841.0
Unknown,01,Unknown,01,Unknown,Cash,Unknown,EPI SERVICE PRIMEUR,COM,-4842.0
Unknown,22,Unknown,22,Unknown,Cash,Unknown,EPI SERVICE PRIMEUR,CARTES,-4864.0
Unknown,09,Unknown,09,Unknown,Cash,Unknown,EPI SERVICE PRIMEUR,COM,-4873.0
Unknown,64,Unknown,64,Unknown,Cash,Unknown,EPI SERVICE PRIMEUR,CARTES,-4937.0
Unknown,22,Unknown,22,Unknown,Cash,Unknown,EPI SERVICE PRIMEUR,Unknown,-4959.0
Unknown,09,Unknown,09,Unknown,Cash,Unknown,EPI SERVICE PRIMEUR,Unknown,-4968.0
Unknown,01,Unknown,01,Unknown,Cash,Unknown,EPI SERVICE PRIMEUR,Unknown,-4969.0
Unknown,22,Unknown,22,Unknown,Cash,Unknown,EPI SERVICE PRIMEUR,Unknown,-4991.0
Unknown,09,Unknown,09,Unknown,Cash,Unknown,EPI SERVICE PRIMEUR,Unknown,-5000.0
Unknown,64,Unknown,64,Unknown,Cash,Unknown,EPI SERVICE PRIMEUR,Unknown,-5064.0
Unknown,22,Unknown,22,Unknown,Cash,Unknown,EPI SERVICE PRIMEUR,Unknown,-5086.0
Unknown,09,Unknown,09,Unknown,Cash,Unknown,EPI SERVICE PRIMEUR,Unknown,-5095.0
Unknown,64,Unknown,64,Unknown,Cash,Unknown,EPI SERVICE PRIMEUR,Unknown,-5159.0
Unknown,22,Unknown,22,Unknown,Cash,Unknown,EPI SERVICE PRIMEUR,Unknown,-5181.0
Unknown,09,Unknown,09,Unknown,Cash,Unknown,EPI SERVICE PRIMEUR,Unknown,-5190.0
Unknown,01,Unknown,01,Unknown,Cash,Unknown,EPI SERVICE PRIMEUR,Unknown,-5191.0
Unknown,22,Unknown,22,Unknown,Cash,Unknown,EPI SERVICE PRIMEUR,Unknown,-5213.0
Unknown,09,Unknown,09,Unknown,Cash,Unknown,EPI SERVICE PRIMEUR,Unknown,-5222.0
Unknown,22,Unknown,22,Unknown,Cash,Unknown,EPI SERVICE PRIMEUR,Unknown,-5244.0
Unknown,09,Unknown,09,Unknown,Cash,Unknown,EPI SERVICE PRIMEUR,Unknown,-5253.0
Unknown,23,Unknown,23,Unknown,Cash,Unknown,EPI SERVICE PRIMEUR,Unknown,-5276.0
Unknown,09,Unknown,09,Unknown,Cash,Unknown,EPI SERVICE PRIMEUR,Unknown,-5285.0
Unknown,22,Unknown,22,Unknown,Cash,Unknown,EPI SERVICE PRIMEUR,Unknown,-5307.0
Unknown,09,Unknown,09,Unknown,Cash,Unknown,EPI SERVICE PRIMEUR,Unknown,-5316.0
Unknown,22,Unknown,22,Unknown,Cash,Unknown,EPI SERVICE PRIMEUR,Unknown,-5338.0
Unknown,09,Unknown,09,Unknown,Cash,Unknown,EPI SERVICE PRIMEUR,Unknown,-5347.0
Unknown,23,Unknown,23,Unknown,Cash,Unknown,EPI SERVICE PRIMEUR,Unknown,-5370.0
Unknown,09,Unknown,09,Unknown,Cash,Unknown,EPI SERVICE PRIMEUR,Unknown,-5379.0
Unknown,23,Unknown,23,Unknown,Cash,Unknown,EPI SERVICE PRIMEUR,Unknown,-5402.0
Unknown,09,Unknown,09,Unknown,Cash,Unknown,EPI SERVICE PRIMEUR,Unknown,-5411.0
Unknown,23,Unknown,23,Unknown,Cash,Unknown,EPI SERVICE PRIMEUR,Unknown,-5434.0
Unknown,09,Unknown,09,Unknown,Cash,Unknown,EPI SERVICE PRIMEUR,Unknown,-5443.0
Unknown,22,Unknown,22,Unknown,Cash,Unknown,EPI SERVICE PRIMEUR,Unknown,-5465.0
Unknown,09,Unknown,09,Unknown,Cash,Unknown,EPI SERVICE PRIMEUR,Unknown,-5474.0
Unknown,"39,90",Unknown,"39,90",Unknown,Cash,Unknown,EPI SERVICE PRIMEUR,Unknown,-9464.0
Unknown,23,Unknown,23,Unknown,Cash,Unknown,EPI SERVICE PRIMEUR,Unknown,-9487.0
Unknown,09,Unknown,09,Unknown,Cash,Unknown,EPI SERVICE PRIMEUR,Unknown,-9496.0
Unknown,22,Unknown,22,Unknown,Cash,Unknown,EPI SERVICE PRIMEUR,Unknown,-9518.0
Unknown,09,Unknown,09,Unknown,Cash,Unknown,EPI SERVICE PRIMEUR,Unknown,-9527.0
Unknown,23,Unknown,23,Unknown,Cash,Unknown,EPI SERVICE PRIMEUR,Unknown,-9550.0
Unknown,09,Unknown,09,Unknown,Cash,Unknown,EPI SERVICE PRIMEUR,Unknown,-9559.0
Unknown,64,Unknown,64,Unknown,Cash,Unknown,EPI SERVICE PRIMEUR,Unknown,-9623.0
Unknown,23,Unknown,23,Unknown,Cash,Unknown,EPI SERVICE PRIMEUR,Unknown,-9646.0
Unknown,09,Unknown,09,Unknown,Cash,Unknown,EPI SERVICE PRIMEUR,Unknown,-9655.0
Unknown,64,Unknown,64,Unknown,Cash,Unknown,EPI SERVICE PRIMEUR,Unknown,-9719.0
Unknown,23,Unknown,23,Unknown,Cash,Unknown,EPI SERVICE PRIMEUR,Unknown,-9742.0
Unknown,09,Unknown,09,Unknown,Cash,Unknown,EPI SERVICE PRIMEUR,Unknown,-9751.0
Unknown,01,Unknown,01,Unknown,Cash,Unknown,EPI SERVICE PRIMEUR,Unknown,-9752.0
Unknown,23,Unknown,23,Unknown,Cash,Unknown,EPI SERVICE PRIMEUR,Unknown,-9775.0
Unknown,09,Unknown,09,Unknown,Cash,Unknown,EPI SERVICE PRIMEUR,Unknown,-9784.0
Unknown,64,Unknown,64,Unknown,Cash,Unknown,EPI SERVICE PRIMEUR,Unknown,-9848.0
Unknown,23,Unknown,23,Unknown,Cash,Unknown,EPI SERVICE PRIMEUR,Unknown,-9871.0
Unknown,09,Unknown,09,Unknown,Cash,Unknown,EPI SERVICE PRIMEUR,Unknown,-9880.0
Unknown,01,Unknown,01,Unknown,Cash,Unknown,EPI SERVICE PRIMEUR,Unknown,-9881.0
Unknown,"2,31",Unknown,"2,31",Unknown,Cash,Unknown,EPI SERVICE PRIMEUR,Unknown,-10112.0
Unknown,"0,18",Unknown,"0,18",Unknown,Cash,Unknown,EPI SERVICE PRIMEUR,Unknown,-10130.0
Unknown,"0,08",Unknown,"0,08",Unknown,Cash,Unknown,EPI SERVICE PRIMEUR,Unknown,-10138.0
Unknown,"260,00",Unknown,"260,00",Unknown,Cash,Unknown,EPI SERVICE PRIMEUR,Unknown,-36138.0
Unknown,20,Unknown,20,Unknown,Cash,Unknown,EPI SERVICE PRIMEUR,Unknown,-36158.0
Unknown,"09 449,55",Unknown,"09 449,55",Unknown,Cash,Unknown,EPI SERVICE PRIMEUR,Unknown,-981113.0
Unknown,20,Unknown,20,Unknown,Cash,Unknown,EPI SERVICE PRIMEUR,Unknown,-981133.0
Unknown,"09 112,24",Unknown,"09 112,24",Unknown,Cash,Unknown,EPI SERVICE PRIMEUR,Unknown,-1892357.0
Unknown,21,Unknown,21,Unknown,Cash,Unknown,EPI SERVICE PRIMEUR,Unknown,-1892378.0
Unknown,09 21,Unknown,09 21,Unknown,Cash,Unknown,EPI SERVICE PRIMEUR,Unknown,-1893299.0
Unknown,09 21,Unknown,09 21,Unknown,Cash,Unknown,EPI SERVICE PRIMEUR,Unknown,-1894220.0
Unknown,09 21,Unknown,09 21,Unknown,Cash,Unknown,EPI SERVICE PRIMEUR,Unknown,-1895141.0
Unknown,09 21,Unknown,09 21,Unknown,Cash,Unknown,EPI SERVICE PRIMEUR,Unknown,-1896062.0
Unknown,09 21,Unknown,09 21,Unknown,Cash,Unknown,EPI SERVICE PRIMEUR,Unknown,-1896983.0
Unknown,09 21,Unknown,09 21,Unknown,Cash,Unknown,EPI SERVICE PRIMEUR,Unknown,-1897904.0
Unknown,09 21,Unknown,09 21,Unknown,Cash,Unknown,EPI SERVICE PRIMEUR,Unknown,-1898825.0
Unknown,09 21,Unknown,09 21,Unknown,Cash,Unknown,EPI SERVICE PRIMEUR,Unknown,-1899746.0
Unknown,09 21,Unknown,09 21,Unknown,Cash,Unknown,EPI SERVICE PRIMEUR,Unknown,-1900667.0
Unknown,09 22,Unknown,09 22,Unknown,Cash,Unknown,EPI SERVICE PRIMEUR,Unknown,-1901589.0
Unknown,09 22,Unknown,09 22,Unknown,Cash,Unknown,EPI SERVICE PRIMEUR,Unknown,-1902511.0
Unknown,09 22,Unknown,09 22,Unknown,Cash,Unknown,EPI SERVICE PRIMEUR,Unknown,-1903433.0
Unknown,09 22,Unknown,09 22,Unknown,Cash,Unknown,EPI SERVICE PRIMEUR,Unknown,-1904355.0
Unknown,09 22,Unknown,09 22,Unknown,Cash,Unknown,EPI SERVICE PRIMEUR,Unknown,-1905277.0
Unknown,09 22,Unknown,09 22,Unknown,Cash,Unknown,EPI SERVICE PRIMEUR,Unknown,-1906199.0
Unknown,09 22,Unknown,09 22,Unknown,Cash,Unknown,EPI SERVICE PRIMEUR,Unknown,-1907121.0
Unknown,09 22,Unknown,09 22,Unknown,Cash,Unknown,EPI SERVICE PRIMEUR,Unknown,-1908043.0
Unknown,09 22,Unknown,09 22,Unknown,Cash,Unknown,EPI SERVICE PRIMEUR,Unknown,-1908965.0
Unknown,09 22,Unknown,09 22,Unknown,Cash,Unknown,EPI SERVICE PRIMEUR,Unknown,-1909887.0
Unknown,09 22,Unknown,09 22,Unknown,Cash,Unknown,EPI SERVICE PRIMEUR,Unknown,-1910809.0
Unknown,09 22,Unknown,09 22,Unknown,Cash,Unknown,EPI SERVICE PRIMEUR,Unknown,-1911731.0
Unknown,09 23,Unknown,09 23,Unknown,Cash,Unknown,EPI SERVICE PRIMEUR,Unknown,-1912654.0
Unknown,09 23,Unknown,09 23,Unknown,Cash,Unknown,EPI SERVICE PRIMEUR,Unknown,-1913577.0
Unknown,09 23,Unknown,09 23,Unknown,Cash,Unknown,EPI SERVICE PRIMEUR,Unknown,-1914500.0
Unknown,09 23,Unknown,09 23,Unknown,Cash,Unknown,EPI SERVICE PRIMEUR,Unknown,-1915423.0
Unknown,09 23,Unknown,09 23,Unknown,Cash,Unknown,EPI SERVICE PRIMEUR,Unknown,-1916346.0
Unknown,09 23,Unknown,09 23,Unknown,Cash,Unknown,EPI SERVICE PRIMEUR,Unknown,-1917269.0
Unknown,09 23,Unknown,09 23,Unknown,Cash,Unknown,EPI SERVICE PRIMEUR,Unknown,-1918192.0
Unknown,09 23,Unknown,09 23,Unknown,Cash,Unknown,EPI SERVICE PRIMEUR,Unknown,-1919115.0
Unknown,09 23,Unknown,09 23,Unknown,Cash,Unknown,EPI SERVICE PRIMEUR,Unknown,-1920038.0
Unknown,09 23,Unknown,09 23,Unknown,Cash,Unknown,EPI SERVICE PRIMEUR,Unknown,-1920961.0
Unknown,09 23,Unknown,09 23,Unknown,Cash,Unknown,EPI SERVICE PRIMEUR,Unknown,-1921884.0
Unknown,09 23,Unknown,09 23,Unknown,Cash,Unknown,EPI SERVICE PRIMEUR,Unknown,-1922807.0
Unknown,09 23,Unknown,09 23,Unknown,Cash,Unknown,EPI SERVICE PRIMEUR,Unknown,-1923730.0
Unknown,09 23,Unknown,09 23,Unknown,Cash,Unknown,EPI SERVICE PRIMEUR,Unknown,-1924653.0
Unknown,"09 298,90",Unknown,"09 298,90",Unknown,Cash,Unknown,EPI SERVICE PRIMEUR,Unknown,-2854543.0
Unknown,"79,00",Unknown,"79,00",Unknown,Cash,Unknown,EPI SERVICE PRIMEUR,Unknown,-2862443.0
Unknown,"236,00",Unknown,"236,00",Unknown,Cash,Unknown,EPI SERVICE PRIMEUR,Unknown,-2886043.0
Unknown,"142,55",Unknown,"142,55",Unknown,Cash,Unknown,EPI SERVICE PRIMEUR,Unknown,-2900298.0
Unknown,"1,63",Unknown,"1,63",Unknown,Cash,Unknown,EPI SERVICE PRIMEUR,Unknown,-2900461.0
Unknown,"2,01",Unknown,"2,01",Unknown,Cash,Unknown,EPI SERVICE PRIMEUR,Unknown,-2900662.0
Unknown,"1,25",Unknown,"1,25",Unknown,Cash,Unknown,EPI SERVICE PRIMEUR,Unknown,-2900787.0
Unknown,"0,31",Unknown,"0,31",Unknown,Cash,Unknown,EPI SERVICE PRIMEUR,Unknown,-2900818.0
Unknown,"0,76",Unknown,"0,76",Unknown,Cash,Unknown,EPI SERVICE PRIMEUR,Unknown,-2900894.0
Unknown,"0,38",Unknown,"0,38",Unknown,Cash,Unknown,EPI SERVICE PRIMEUR,Unknown,-2900932.0
Unknown,"39,50",Unknown,"39,50",Unknown,Cash,Unknown,EPI SERVICE PRIMEUR,Unknown,-2904882.0
Unknown,"322,00",Unknown,"322,00",Unknown,Cash,Unknown,EPI SERVICE PRIMEUR,Unknown,-2937082.0
Unknown,"61,50",Unknown,"61,50",Unknown,Cash,Unknown,EPI SERVICE PRIMEUR,Unknown,-2943232.0
Unknown,"56,70",Unknown,"56,70",Unknown,Cash,Unknown,EPI SERVICE PRIMEUR,Unknown,-2948902.0
Unknown,"176,20",Unknown,"176,20",Unknown,Cash,Unknown,EPI SERVICE PRIMEUR,Unknown,-2966522.0
Unknown,"0,62",Unknown,"0,62",Unknown,Cash,Unknown,EPI SERVICE PRIMEUR,Unknown,-2966584.0
Unknown,"3,73",Unknown,"3,73",Unknown,Cash,Unknown,EPI SERVICE PRIMEUR,Unknown,-2966957.0
Unknown,"1,27",Unknown,"1,27",Unknown,Cash,Unknown,EPI SERVICE PRIMEUR,Unknown,-2967084.0
Unknown,"0,22",Unknown,"0,22",Unknown,Cash,Unknown,EPI SERVICE PRIMEUR,Unknown,-2967106.0
Unknown,"0,79",Unknown,"0,79",Unknown,Cash,Unknown,EPI SERVICE PRIMEUR,Unknown,-2967185.0
Unknown,"0,13",Unknown,"0,13",Unknown,Cash,Unknown,EPI SERVICE PRIMEUR,Unknown,-2967198.0
Unknown,"0,03",Unknown,"0,03",Unknown,Cash,Unknown,EPI SERVICE PRIMEUR,Unknown,-2967201.0
Unknown,"37,00",Unknown,"37,00",Unknown,Cash,Unknown,EPI SERVICE PRIMEUR,Unknown,-2970901.0
Unknown,"49,50",Unknown,"49,50",Unknown,Cash,Unknown,EPI SERVICE PRIMEUR,Unknown,-2975851.0
Unknown,"256,30",Unknown,"256,30",Unknown,Cash,Unknown,EPI SERVICE PRIMEUR,Unknown,-3001481.0
Unknown,"44,00",Unknown,"44,00",Unknown,Cash,Unknown,EPI SERVICE PRIMEUR,Unknown,-3005881.0
Unknown,"66,30",Unknown,"66,30",Unknown,Cash,Unknown,EPI SERVICE PRIMEUR,Unknown,-3012511.0
Unknown,"181,95",Unknown,"181,95",Unknown,Cash,Unknown,EPI SERVICE PRIMEUR,Unknown,-3030706.0
Unknown,"50,43",Unknown,"50,43",Unknown,Cash,Unknown,EPI SERVICE PRIMEUR,Unknown,-3035749.0
Unknown,1,Unknown,1,Unknown,Cash,Unknown,EPI SERVICE PRIMEUR,Unknown,-3035750.0
Unknown,"39,90",Unknown,"39,90",Unknown,Cash,Unknown,EPI SERVICE PRIMEUR,Unknown,-3039740.0
Unknown,"144,41",Unknown,"144,41",Unknown,Cash,Unknown,EPI SERVICE PRIMEUR,Unknown,-3054181.0
Unknown,"0,73",Unknown,"0,73",Unknown,Cash,Unknown,EPI SERVICE PRIMEUR,Unknown,-3054254.0
Unknown,"1,05",Unknown,"1,05",Unknown,Cash,Unknown,EPI SERVICE PRIMEUR,Unknown,-3054359.0
Unknown,"0,18",Unknown,"0,18",Unknown,Cash,Unknown,EPI SERVICE PRIMEUR,Unknown,-3054377.0
Unknown,"0,87",Unknown,"0,87",Unknown,Cash,Unknown,EPI SERVICE PRIMEUR,Unknown,-3054464.0
Unknown,"0,12",Unknown,"0,12",Unknown,Cash,Unknown,EPI SERVICE PRIMEUR,Unknown,-3054476.0
23/09/2021,40,Unknown,40,Unknown,Cash,Unknown,EPI SERVICE PRIMEUR,Titulaire(s,-40.0
23/09/2021,10,Unknown,10,Unknown,Cash,Unknown,EPI SERVICE PRIMEUR,Date Date de Valeur,-50.0
23/09/2021,6,Unknown,6,Unknown,Cash,Unknown,EPI SERVICE PRIMEUR,METRO CASH,-56.0
23/09/2021,10,Unknown,10,Unknown,Cash,Unknown,EPI SERVICE PRIMEUR,REMISE,-66.0
23/09/2021,23,Unknown,23,Unknown,Cash,Unknown,EPI SERVICE PRIMEUR,REMISE,-89.0
24/09/2021,09 23,Unknown,09 23,Unknown,Cash,Unknown,EPI SERVICE PRIMEUR,TPV,-1012.0
24/09/2021,09,Unknown,09,Unknown,Cash,Unknown,EPI SERVICE PRIMEUR,REMISE,-1021.0
24/09/2021,23,Unknown,23,Unknown,Cash,Unknown,EPI SERVICE PRIMEUR,TPV,-1044.0
24/09/2021,09,Unknown,09,Unknown,Cash,Unknown,EPI SERVICE PRIMEUR,COM,-1053.0
24/09/2021,23,Unknown,23,Unknown,Cash,Unknown,EPI SERVICE PRIMEUR,CARTES,-1076.0
24/09/2021,09,Unknown,09,Unknown,Cash,Unknown,EPI SERVICE PRIMEUR,COM,-1085.0
24/09/2021,23,Unknown,23,Unknown,Cash,Unknown,EPI SERVICE PRIMEUR,CARTES,-1108.0
24/09/2021,09,Unknown,09,Unknown,Cash,Unknown,EPI SERVICE PRIMEUR,COM,-1117.0
24/09/2021,23,Unknown,23,Unknown,Cash,Unknown,EPI SERVICE PRIMEUR,CARTES 0386405,-1140.0
24/09/2021,09,Unknown,09,Unknown,Cash,Unknown,EPI SERVICE PRIMEUR,COM,-1149.0
24/09/2021,24,Unknown,24,Unknown,Cash,Unknown,EPI SERVICE PRIMEUR,CARTES,-1173.0
24/09/2021,09,Unknown,09,Unknown,Cash,Unknown,EPI SERVICE PRIMEUR,COM,-1182.0
27/09/2021,64,Unknown,64,Unknown,Cash,Unknown,EPI SERVICE PRIMEUR,CARTES,-1246.0
27/09/2021,24,Unknown,24,Unknown,Cash,Unknown,EPI SERVICE PRIMEUR,COM,-1270.0
25/09/2021,09,Unknown,09,Unknown,Cash,Unknown,EPI SERVICE PRIMEUR,CARTES,-1279.0
25/09/2021,01,Unknown,01,Unknown,Cash,Unknown,EPI SERVICE PRIMEUR,COM,-1280.0
25/09/2021,24,Unknown,24,Unknown,Cash,Unknown,EPI SERVICE PRIMEUR,CARTES 0386405,-1304.0
25/09/2021,09,Unknown,09,Unknown,Cash,Unknown,EPI SERVICE PRIMEUR,COM,-1313.0
25/09/2021,64,Unknown,64,Unknown,Cash,Unknown,EPI SERVICE PRIMEUR,CARTES,-1377.0
25/09/2021,24,Unknown,24,Unknown,Cash,Unknown,EPI SERVICE PRIMEUR,REMISE,-1401.0
25/09/2021,09,Unknown,09,Unknown,Cash,Unknown,EPI SERVICE PRIMEUR,REMISE,-1410.0
25/09/2021,01,Unknown,01,Unknown,Cash,Unknown,EPI SERVICE PRIMEUR,REMISE,-1411.0
25/09/2021,24,Unknown,24,Unknown,Cash,Unknown,EPI SERVICE PRIMEUR,TPV,-1435.0
25/09/2021,09,Unknown,09,Unknown,Cash,Unknown,EPI SERVICE PRIMEUR,REMISE,-1444.0
25/09/2021,64,Unknown,64,Unknown,Cash,Unknown,EPI SERVICE PRIMEUR,REMISE,-1508.0
25/09/2021,24,Unknown,24,Unknown,Cash,Unknown,EPI SERVICE PRIMEUR,REMISE,-1532.0
25/09/2021,09,Unknown,09,Unknown,Cash,Unknown,EPI SERVICE PRIMEUR,CARTE,-1541.0
27/09/2021,01,Unknown,01,Unknown,Cash,Unknown,EPI SERVICE PRIMEUR,AUTO,-1542.0
27/09/2021,24,Unknown,24,Unknown,Cash,Unknown,EPI SERVICE PRIMEUR,VERN SUR SEICH,-1566.0
27/09/2021,09,Unknown,09,Unknown,Cash,Unknown,EPI SERVICE PRIMEUR,COM,-1575.0
27/09/2021,64,Unknown,64,Unknown,Cash,Unknown,EPI SERVICE PRIMEUR,CARTES,-1639.0
27/09/2021,24,Unknown,24,Unknown,Cash,Unknown,EPI SERVICE PRIMEUR,COM,-1663.0
27/09/2021,09,Unknown,09,Unknown,Cash,Unknown,EPI SERVICE PRIMEUR,CARTES,-1672.0
27/09/2021,01,Unknown,01,Unknown,Cash,Unknown,EPI SERVICE PRIMEUR,COM,-1673.0
27/09/2021,24,Unknown,24,Unknown,Cash,Unknown,EPI SERVICE PRIMEUR,CARTES 0386405,-1697.0
27/09/2021,09,Unknown,09,Unknown,Cash,Unknown,EPI SERVICE PRIMEUR,COM,-1706.0
27/09/2021,24,Unknown,24,Unknown,Cash,Unknown,EPI SERVICE PRIMEUR,CARTES,-1730.0
27/09/2021,09,Unknown,09,Unknown,Cash,Unknown,EPI SERVICE PRIMEUR,COM,-1739.0
27/09/2021,24,Unknown,24,Unknown,Cash,Unknown,EPI SERVICE PRIMEUR,CARTES,-1763.0
27/09/2021,09,Unknown,09,Unknown,Cash,Unknown,EPI SERVICE PRIMEUR,COM,-1772.0
26/09/2021,24,Unknown,24,Unknown,Cash,Unknown,EPI SERVICE PRIMEUR,CARTES,-1796.0
27/09/2021,09,Unknown,09,Unknown,Cash,Unknown,EPI SERVICE PRIMEUR,COM,-1805.0
27/09/2021,27,Unknown,27,Unknown,Cash,Unknown,EPI SERVICE PRIMEUR,CARTES 0386405,-1832.0
26/09/2021,09,Unknown,09,Unknown,Cash,Unknown,EPI SERVICE PRIMEUR,COM,-1841.0
26/09/2021,27,Unknown,27,Unknown,Cash,Unknown,EPI SERVICE PRIMEUR,CARTES,-1868.0
Unknown,09,Unknown,09,Unknown,Cash,Unknown,EPI SERVICE PRIMEUR,COM,-1877.0
Unknown,25,Unknown,25,Unknown,Cash,Unknown,EPI SERVICE PRIMEUR,CARTES 0386405,-1902.0
Unknown,09,Unknown,09,Unknown,Cash,Unknown,EPI SERVICE PRIMEUR,COM,-1911.0
Unknown,24,Unknown,24,Unknown,Cash,Unknown,EPI SERVICE PRIMEUR,CARTES,-1935.0
Unknown,09,Unknown,09,Unknown,Cash,Unknown,EPI SERVICE PRIMEUR,COM,-1944.0
Unknown,25,Unknown,25,Unknown,Cash,Unknown,EPI SERVICE PRIMEUR,CARTES 0386405,-1969.0
Unknown,09,Unknown,09,Unknown,Cash,Unknown,EPI SERVICE PRIMEUR,COM,-1978.0
Unknown,64,Unknown,64,Unknown,Cash,Unknown,EPI SERVICE PRIMEUR,CARTES,-2042.0
Unknown,25,Unknown,25,Unknown,Cash,Unknown,EPI SERVICE PRIMEUR,REMISE,-2067.0
Unknown,09,Unknown,09,Unknown,Cash,Unknown,EPI SERVICE PRIMEUR,REMISE,-2076.0
Unknown,01,Unknown,01,Unknown,Cash,Unknown,EPI SERVICE PRIMEUR,REMISE,-2077.0
Unknown,25,Unknown,25,Unknown,Cash,Unknown,EPI SERVICE PRIMEUR,REMISE,-2102.0
Unknown,09,Unknown,09,Unknown,Cash,Unknown,EPI SERVICE PRIMEUR,STICHTING CUSTODIAN UBER PAY 27/09/2021,-2111.0
Unknown,64,Unknown,64,Unknown,Cash,Unknown,EPI SERVICE PRIMEUR,CARTE,-2175.0
Unknown,25,Unknown,25,Unknown,Cash,Unknown,EPI SERVICE PRIMEUR,METRO,-2200.0
Unknown,09,Unknown,09,Unknown,Cash,Unknown,EPI SERVICE PRIMEUR,COM,-2209.0
Unknown,01,Unknown,01,Unknown,Cash,Unknown,EPI SERVICE PRIMEUR,CARTES,-2210.0
Unknown,25,Unknown,25,Unknown,Cash,Unknown,EPI SERVICE PRIMEUR,COM,-2235.0
Unknown,09,Unknown,09,Unknown,Cash,Unknown,EPI SERVICE PRIMEUR,CARTES,-2244.0
Unknown,64,Unknown,64,Unknown,Cash,Unknown,EPI SERVICE PRIMEUR,COM,-2308.0
Unknown,25,Unknown,25,Unknown,Cash,Unknown,EPI SERVICE PRIMEUR,CARTES 0386405,-2333.0
Unknown,09,Unknown,09,Unknown,Cash,Unknown,EPI SERVICE PRIMEUR,COM,-2342.0
Unknown,01,Unknown,01,Unknown,Cash,Unknown,EPI SERVICE PRIMEUR,CARTES,-2343.0
Unknown,25,Unknown,25,Unknown,Cash,Unknown,EPI SERVICE PRIMEUR,COM,-2368.0
Unknown,09,Unknown,09,Unknown,Cash,Unknown,EPI SERVICE PRIMEUR,CARTES,-2377.0
Unknown,64,Unknown,64,Unknown,Cash,Unknown,EPI SERVICE PRIMEUR,COM,-2441.0
Unknown,25,Unknown,25,Unknown,Cash,Unknown,EPI SERVICE PRIMEUR,CARTES,-2466.0
Unknown,09,Unknown,09,Unknown,Cash,Unknown,EPI SERVICE PRIMEUR,COM,-2475.0
Unknown,01,Unknown,01,Unknown,Cash,Unknown,EPI SERVICE PRIMEUR,CARTES 0386405,-2476.0
Unknown,25,Unknown,25,Unknown,Cash,Unknown,EPI SERVICE PRIMEUR,COM,-2501.0
Unknown,09,Unknown,09,Unknown,Cash,Unknown,EPI SERVICE PRIMEUR,CARTES,-2510.0
Unknown,64,Unknown,64,Unknown,Cash,Unknown,EPI SERVICE PRIMEUR,COM,-2574.0
Unknown,25,Unknown,25,Unknown,Cash,Unknown,EPI SERVICE PRIMEUR,CARTES,-2599.0
Unknown,09,Unknown,09,Unknown,Cash,Unknown,EPI SERVICE PRIMEUR,COM,-2608.0
Unknown,01,Unknown,01,Unknown,Cash,Unknown,EPI SERVICE PRIMEUR,CARTES,-2609.0
Unknown,25,Unknown,25,Unknown,Cash,Unknown,EPI SERVICE PRIMEUR,Unknown,-2634.0
Unknown,09,Unknown,09,Unknown,Cash,Unknown,EPI SERVICE PRIMEUR,Unknown,-2643.0
Unknown,64,Unknown,64,Unknown,Cash,Unknown,EPI SERVICE PRIMEUR,Unknown,-2707.0
Unknown,25,Unknown,25,Unknown,Cash,Unknown,EPI SERVICE PRIMEUR,Unknown,-2732.0
Unknown,09,Unknown,09,Unknown,Cash,Unknown,EPI SERVICE PRIMEUR,Unknown,-2741.0
Unknown,01,Unknown,01,Unknown,Cash,Unknown,EPI SERVICE PRIMEUR,Unknown,-2742.0
Unknown,27,Unknown,27,Unknown,Cash,Unknown,EPI SERVICE PRIMEUR,Unknown,-2769.0
Unknown,09,Unknown,09,Unknown,Cash,Unknown,EPI SERVICE PRIMEUR,Unknown,-2778.0
Unknown,27,Unknown,27,Unknown,Cash,Unknown,EPI SERVICE PRIMEUR,Unknown,-2805.0
Unknown,09,Unknown,09,Unknown,Cash,Unknown,EPI SERVICE PRIMEUR,Unknown,-2814.0
Unknown,27,Unknown,27,Unknown,Cash,Unknown,EPI SERVICE PRIMEUR,Unknown,-2841.0
Unknown,09,Unknown,09,Unknown,Cash,Unknown,EPI SERVICE PRIMEUR,Unknown,-2850.0
Unknown,27,Unknown,27,Unknown,Cash,Unknown,EPI SERVICE PRIMEUR,Unknown,-2877.0
Unknown,09,Unknown,09,Unknown,Cash,Unknown,EPI SERVICE PRIMEUR,Unknown,-2886.0
Unknown,27,Unknown,27,Unknown,Cash,Unknown,EPI SERVICE PRIMEUR,Unknown,-2913.0
Unknown,09,Unknown,09,Unknown,Cash,Unknown,EPI SERVICE PRIMEUR,Unknown,-2922.0
Unknown,27,Unknown,27,Unknown,Cash,Unknown,EPI SERVICE PRIMEUR,Unknown,-2949.0
Unknown,09,Unknown,09,Unknown,Cash,Unknown,EPI SERVICE PRIMEUR,Unknown,-2958.0
Unknown,27,Unknown,27,Unknown,Cash,Unknown,EPI SERVICE PRIMEUR,Unknown,-2985.0
Unknown,09,Unknown,09,Unknown,Cash,Unknown,EPI SERVICE PRIMEUR,Unknown,-2994.0
Unknown,27,Unknown,27,Unknown,Cash,Unknown,EPI SERVICE PRIMEUR,Unknown,-3021.0
Unknown,09,Unknown,09,Unknown,Cash,Unknown,EPI SERVICE PRIMEUR,Unknown,-3030.0
Unknown,25,Unknown,25,Unknown,Cash,Unknown,EPI SERVICE PRIMEUR,Unknown,-3055.0
Unknown,09,Unknown,09,Unknown,Cash,Unknown,EPI SERVICE PRIMEUR,Unknown,-3064.0
Unknown,27,Unknown,27,Unknown,Cash,Unknown,EPI SERVICE PRIMEUR,Unknown,-3091.0
Unknown,09,Unknown,09,Unknown,Cash,Unknown,EPI SERVICE PRIMEUR,Unknown,-3100.0
Unknown,64,Unknown,64,Unknown,Cash,Unknown,EPI SERVICE PRIMEUR,Unknown,-3164.0
Unknown,27,Unknown,27,Unknown,Cash,Unknown,EPI SERVICE PRIMEUR,Unknown,-3191.0
Unknown,09,Unknown,09,Unknown,Cash,Unknown,EPI SERVICE PRIMEUR,Unknown,-3200.0
Unknown,01,Unknown,01,Unknown,Cash,Unknown,EPI SERVICE PRIMEUR,Unknown,-3201.0
Unknown,27,Unknown,27,Unknown,Cash,Unknown,EPI SERVICE PRIMEUR,Unknown,-3228.0
Unknown,09,Unknown,09,Unknown,Cash,Unknown,EPI SERVICE PRIMEUR,Unknown,-3237.0
Unknown,64,Unknown,64,Unknown,Cash,Unknown,EPI SERVICE PRIMEUR,Unknown,-3301.0
Unknown,27,Unknown,27,Unknown,Cash,Unknown,EPI SERVICE PRIMEUR,Unknown,-3328.0
Unknown,09,Unknown,09,Unknown,Cash,Unknown,EPI SERVICE PRIMEUR,Unknown,-3337.0
Unknown,01,Unknown,01,Unknown,Cash,Unknown,EPI SERVICE PRIMEUR,Unknown,-3338.0
Unknown,27,Unknown,27,Unknown,Cash,Unknown,EPI SERVICE PRIMEUR,Unknown,-3365.0
Unknown,09,Unknown,09,Unknown,Cash,Unknown,EPI SERVICE PRIMEUR,Unknown,-3374.0
Unknown,64,Unknown,64,Unknown,Cash,Unknown,EPI SERVICE PRIMEUR,Unknown,-3438.0
Unknown,26,Unknown,26,Unknown,Cash,Unknown,EPI SERVICE PRIMEUR,Unknown,-3464.0
Unknown,09,Unknown,09,Unknown,Cash,Unknown,EPI SERVICE PRIMEUR,Unknown,-3473.0
Unknown,01,Unknown,01,Unknown,Cash,Unknown,EPI SERVICE PRIMEUR,Unknown,-3474.0
Unknown,27,Unknown,27,Unknown,Cash,Unknown,EPI SERVICE PRIMEUR,Unknown,-3501.0
Unknown,09,Unknown,09,Unknown,Cash,Unknown,EPI SERVICE PRIMEUR,Unknown,-3510.0
Unknown,64,Unknown,64,Unknown,Cash,Unknown,EPI SERVICE PRIMEUR,Unknown,-3574.0
Unknown,27,Unknown,27,Unknown,Cash,Unknown,EPI SERVICE PRIMEUR,Unknown,-3601.0
Unknown,09,Unknown,09,Unknown,Cash,Unknown,EPI SERVICE PRIMEUR,Unknown,-3610.0
Unknown,01,Unknown,01,Unknown,Cash,Unknown,EPI SERVICE PRIMEUR,Unknown,-3611.0
Unknown,26,Unknown,26,Unknown,Cash,Unknown,EPI SERVICE PRIMEUR,Unknown,-3637.0
Unknown,09,Unknown,09,Unknown,Cash,Unknown,EPI SERVICE PRIMEUR,Unknown,-3646.0
Unknown,64,Unknown,64,Unknown,Cash,Unknown,EPI SERVICE PRIMEUR,Unknown,-3710.0
Unknown,26,Unknown,26,Unknown,Cash,Unknown,EPI SERVICE PRIMEUR,Unknown,-3736.0
Unknown,09,Unknown,09,Unknown,Cash,Unknown,EPI SERVICE PRIMEUR,Unknown,-3745.0
Unknown,01,Unknown,01,Unknown,Cash,Unknown,EPI SERVICE PRIMEUR,Unknown,-3746.0
Unknown,"1 305,03",Unknown,"1 305,03",Unknown,Cash,Unknown,EPI SERVICE PRIMEUR,Unknown,-134249.0
Unknown,24,Unknown,24,Unknown,Cash,Unknown,EPI SERVICE PRIMEUR,Unknown,-134273.0
Unknown,09 24,Unknown,09 24,Unknown,Cash,Unknown,EPI SERVICE PRIMEUR,Unknown,-135197.0
Unknown,09 24,Unknown,09 24,Unknown,Cash,Unknown,EPI SERVICE PRIMEUR,Unknown,-136121.0
Unknown,09 24,Unknown,09 24,Unknown,Cash,Unknown,EPI SERVICE PRIMEUR,Unknown,-137045.0
Unknown,09 24,Unknown,09 24,Unknown,Cash,Unknown,EPI SERVICE PRIMEUR,Unknown,-137969.0
Unknown,09 24,Unknown,09 24,Unknown,Cash,Unknown,EPI SERVICE PRIMEUR,Unknown,-138893.0
Unknown,09 24,Unknown,09 24,Unknown,Cash,Unknown,EPI SERVICE PRIMEUR,Unknown,-139817.0
Unknown,09 24,Unknown,09 24,Unknown,Cash,Unknown,EPI SERVICE PRIMEUR,Unknown,-140741.0
Unknown,09 24,Unknown,09 24,Unknown,Cash,Unknown,EPI SERVICE PRIMEUR,Unknown,-141665.0
Unknown,09 24,Unknown,09 24,Unknown,Cash,Unknown,EPI SERVICE PRIMEUR,Unknown,-142589.0
Unknown,09 24,Unknown,09 24,Unknown,Cash,Unknown,EPI SERVICE PRIMEUR,Unknown,-143513.0
Unknown,09 24,Unknown,09 24,Unknown,Cash,Unknown,EPI SERVICE PRIMEUR,Unknown,-144437.0
Unknown,09 25,Unknown,09 25,Unknown,Cash,Unknown,EPI SERVICE PRIMEUR,Unknown,-145362.0
Unknown,09 25,Unknown,09 25,Unknown,Cash,Unknown,EPI SERVICE PRIMEUR,Unknown,-146287.0
Unknown,09 25,Unknown,09 25,Unknown,Cash,Unknown,EPI SERVICE PRIMEUR,Unknown,-147212.0
Unknown,09 25,Unknown,09 25,Unknown,Cash,Unknown,EPI SERVICE PRIMEUR,Unknown,-148137.0
Unknown,09 25,Unknown,09 25,Unknown,Cash,Unknown,EPI SERVICE PRIMEUR,Unknown,-149062.0
Unknown,09 25,Unknown,09 25,Unknown,Cash,Unknown,EPI SERVICE PRIMEUR,Unknown,-149987.0
Unknown,09 25,Unknown,09 25,Unknown,Cash,Unknown,EPI SERVICE PRIMEUR,Unknown,-150912.0
Unknown,09 25,Unknown,09 25,Unknown,Cash,Unknown,EPI SERVICE PRIMEUR,Unknown,-151837.0
Unknown,09 25,Unknown,09 25,Unknown,Cash,Unknown,EPI SERVICE PRIMEUR,Unknown,-152762.0
Unknown,09 25,Unknown,09 25,Unknown,Cash,Unknown,EPI SERVICE PRIMEUR,Unknown,-153687.0
Unknown,09 25,Unknown,09 25,Unknown,Cash,Unknown,EPI SERVICE PRIMEUR,Unknown,-154612.0
Unknown,09 25,Unknown,09 25,Unknown,Cash,Unknown,EPI SERVICE PRIMEUR,Unknown,-155537.0
Unknown,09 25,Unknown,09 25,Unknown,Cash,Unknown,EPI SERVICE PRIMEUR,Unknown,-156462.0
Unknown,09 25,Unknown,09 25,Unknown,Cash,Unknown,EPI SERVICE PRIMEUR,Unknown,-157387.0
Unknown,09 25,Unknown,09 25,Unknown,Cash,Unknown,EPI SERVICE PRIMEUR,Unknown,-158312.0
Unknown,09 25,Unknown,09 25,Unknown,Cash,Unknown,EPI SERVICE PRIMEUR,Unknown,-159237.0
Unknown,09 25,Unknown,09 25,Unknown,Cash,Unknown,EPI SERVICE PRIMEUR,Unknown,-160162.0
Unknown,09 25,Unknown,09 25,Unknown,Cash,Unknown,EPI SERVICE PRIMEUR,Unknown,-161087.0
Unknown,09 25,Unknown,09 25,Unknown,Cash,Unknown,EPI SERVICE PRIMEUR,Unknown,-162012.0
Unknown,09 27,Unknown,09 27,Unknown,Cash,Unknown,EPI SERVICE PRIMEUR,Unknown,-162939.0
Unknown,09 27,Unknown,09 27,Unknown,Cash,Unknown,EPI SERVICE PRIMEUR,Unknown,-163866.0
Unknown,09 27,Unknown,09 27,Unknown,Cash,Unknown,EPI SERVICE PRIMEUR,Unknown,-164793.0
Unknown,09 27,Unknown,09 27,Unknown,Cash,Unknown,EPI SERVICE PRIMEUR,Unknown,-165720.0
Unknown,09 27,Unknown,09 27,Unknown,Cash,Unknown,EPI SERVICE PRIMEUR,Unknown,-166647.0
Unknown,09 27,Unknown,09 27,Unknown,Cash,Unknown,EPI SERVICE PRIMEUR,Unknown,-167574.0
Unknown,09,Unknown,09,Unknown,Cash,Unknown,EPI SERVICE PRIMEUR,Unknown,-167583.0
Unknown,27,Unknown,27,Unknown,Cash,Unknown,EPI SERVICE PRIMEUR,Unknown,-167610.0
Unknown,09 27,Unknown,09 27,Unknown,Cash,Unknown,EPI SERVICE PRIMEUR,Unknown,-168537.0
Unknown,09 27,Unknown,09 27,Unknown,Cash,Unknown,EPI SERVICE PRIMEUR,Unknown,-169464.0
Unknown,09 27,Unknown,09 27,Unknown,Cash,Unknown,EPI SERVICE PRIMEUR,Unknown,-170391.0
Unknown,09 27,Unknown,09 27,Unknown,Cash,Unknown,EPI SERVICE PRIMEUR,Unknown,-171318.0
Unknown,09 27,Unknown,09 27,Unknown,Cash,Unknown,EPI SERVICE PRIMEUR,Unknown,-172245.0
Unknown,09 27,Unknown,09 27,Unknown,Cash,Unknown,EPI SERVICE PRIMEUR,Unknown,-173172.0
Unknown,09 27,Unknown,09 27,Unknown,Cash,Unknown,EPI SERVICE PRIMEUR,Unknown,-174099.0
Unknown,09 27,Unknown,09 27,Unknown,Cash,Unknown,EPI SERVICE PRIMEUR,Unknown,-175026.0
Unknown,09,Unknown,09,Unknown,Cash,Unknown,EPI SERVICE PRIMEUR,Unknown,-175035.0
Unknown,27,Unknown,27,Unknown,Cash,Unknown,EPI SERVICE PRIMEUR,Unknown,-175062.0
Unknown,09 56,Unknown,09 56,Unknown,Cash,Unknown,EPI SERVICE PRIMEUR,Unknown,-176018.0
Unknown,"40 364,80",Unknown,"40 364,80",Unknown,Cash,Unknown,EPI SERVICE PRIMEUR,Unknown,-4212498.0
Unknown,"51,90",Unknown,"51,90",Unknown,Cash,Unknown,EPI SERVICE PRIMEUR,Unknown,-4217688.0
Unknown,"73,00",Unknown,"73,00",Unknown,Cash,Unknown,EPI SERVICE PRIMEUR,Unknown,-4224988.0
Unknown,"0,64",Unknown,"0,64",Unknown,Cash,Unknown,EPI SERVICE PRIMEUR,Unknown,-4225052.0
Unknown,"0,15",Unknown,"0,15",Unknown,Cash,Unknown,EPI SERVICE PRIMEUR,Unknown,-4225067.0
Unknown,"1,82",Unknown,"1,82",Unknown,Cash,Unknown,EPI SERVICE PRIMEUR,Unknown,-4225249.0
Unknown,"0,08",Unknown,"0,08",Unknown,Cash,Unknown,EPI SERVICE PRIMEUR,Unknown,-4225257.0
Unknown,"0,46",Unknown,"0,46",Unknown,Cash,Unknown,EPI SERVICE PRIMEUR,Unknown,-4225303.0
Unknown,"0,33",Unknown,"0,33",Unknown,Cash,Unknown,EPI SERVICE PRIMEUR,Unknown,-4225336.0
Unknown,"0,12",Unknown,"0,12",Unknown,Cash,Unknown,EPI SERVICE PRIMEUR,Unknown,-4225348.0
Unknown,"0,08",Unknown,"0,08",Unknown,Cash,Unknown,EPI SERVICE PRIMEUR,Unknown,-4225356.0
Unknown,"56,00",Unknown,"56,00",Unknown,Cash,Unknown,EPI SERVICE PRIMEUR,Unknown,-4230956.0
Unknown,"972,20",Unknown,"972,20",Unknown,Cash,Unknown,EPI SERVICE PRIMEUR,Unknown,-4328176.0
Unknown,"56,60",Unknown,"56,60",Unknown,Cash,Unknown,EPI SERVICE PRIMEUR,Unknown,-4333836.0
Unknown,"92,30",Unknown,"92,30",Unknown,Cash,Unknown,EPI SERVICE PRIMEUR,Unknown,-4343066.0
Unknown,"35,10",Unknown,"35,10",Unknown,Cash,Unknown,EPI SERVICE PRIMEUR,Unknown,-4346576.0
Unknown,"352,60",Unknown,"352,60",Unknown,Cash,Unknown,EPI SERVICE PRIMEUR,Unknown,-4381836.0
Unknown,"172,10",Unknown,"172,10",Unknown,Cash,Unknown,EPI SERVICE PRIMEUR,Unknown,-4399046.0
Unknown,"1,01",Unknown,"1,01",Unknown,Cash,Unknown,EPI SERVICE PRIMEUR,Unknown,-4399147.0
Unknown,"0,17",Unknown,"0,17",Unknown,Cash,Unknown,EPI SERVICE PRIMEUR,Unknown,-4399164.0
Unknown,"3,64",Unknown,"3,64",Unknown,Cash,Unknown,EPI SERVICE PRIMEUR,Unknown,-4399528.0
Unknown,"0,77",Unknown,"0,77",Unknown,Cash,Unknown,EPI SERVICE PRIMEUR,Unknown,-4399605.0
Unknown,"0,23",Unknown,"0,23",Unknown,Cash,Unknown,EPI SERVICE PRIMEUR,Unknown,-4399628.0
Unknown,"0,38",Unknown,"0,38",Unknown,Cash,Unknown,EPI SERVICE PRIMEUR,Unknown,-4399666.0
Unknown,"0,24",Unknown,"0,24",Unknown,Cash,Unknown,EPI SERVICE PRIMEUR,Unknown,-4399690.0
Unknown,"0,03",Unknown,"0,03",Unknown,Cash,Unknown,EPI SERVICE PRIMEUR,Unknown,-4399693.0
Unknown,"1,05",Unknown,"1,05",Unknown,Cash,Unknown,EPI SERVICE PRIMEUR,Unknown,-4399798.0
Unknown,"0,18",Unknown,"0,18",Unknown,Cash,Unknown,EPI SERVICE PRIMEUR,Unknown,-4399816.0
Unknown,"0,08",Unknown,"0,08",Unknown,Cash,Unknown,EPI SERVICE PRIMEUR,Unknown,-4399824.0
Unknown,"0,08",Unknown,"0,08",Unknown,Cash,Unknown,EPI SERVICE PRIMEUR,Unknown,-4399832.0
Unknown,"768,00",Unknown,"768,00",Unknown,Cash,Unknown,EPI SERVICE PRIMEUR,Unknown,-4476632.0
Unknown,"982,10",Unknown,"982,10",Unknown,Cash,Unknown,EPI SERVICE PRIMEUR,Unknown,-4574842.0
Unknown,"145,20",Unknown,"145,20",Unknown,Cash,Unknown,EPI SERVICE PRIMEUR,Unknown,-4589362.0
Unknown,"283,10",Unknown,"283,10",Unknown,Cash,Unknown,EPI SERVICE PRIMEUR,Unknown,-4617672.0
Unknown,"265,50",Unknown,"265,50",Unknown,Cash,Unknown,EPI SERVICE PRIMEUR,Unknown,-4644222.0
Unknown,"505,35",Unknown,"505,35",Unknown,Cash,Unknown,EPI SERVICE PRIMEUR,Unknown,-4694757.0
Unknown,"83,51",Unknown,"83,51",Unknown,Cash,Unknown,EPI SERVICE PRIMEUR,Unknown,-4703108.0
Unknown,"583,49",Unknown,"583,49",Unknown,Cash,Unknown,EPI SERVICE PRIMEUR,Unknown,-4761457.0
Unknown,"1,43",Unknown,"1,43",Unknown,Cash,Unknown,EPI SERVICE PRIMEUR,Unknown,-4761600.0
Unknown,"1,15",Unknown,"1,15",Unknown,Cash,Unknown,EPI SERVICE PRIMEUR,Unknown,-4761715.0
Unknown,"3,35",Unknown,"3,35",Unknown,Cash,Unknown,EPI SERVICE PRIMEUR,Unknown,-4762050.0
Unknown,"1,04",Unknown,"1,04",Unknown,Cash,Unknown,EPI SERVICE PRIMEUR,Unknown,-4762154.0
Unknown,"2,08",Unknown,"2,08",Unknown,Cash,Unknown,EPI SERVICE PRIMEUR,Unknown,-4762362.0
Unknown,"0,39",Unknown,"0,39",Unknown,Cash,Unknown,EPI SERVICE PRIMEUR,Unknown,-4762401.0
Unknown,"2,26",Unknown,"2,26",Unknown,Cash,Unknown,EPI SERVICE PRIMEUR,Unknown,-4762627.0
Unknown,"1,07",Unknown,"1,07",Unknown,Cash,Unknown,EPI SERVICE PRIMEUR,Unknown,-4762734.0
Unknown,"0,80",Unknown,"0,80",Unknown,Cash,Unknown,EPI SERVICE PRIMEUR,Unknown,-4762814.0
Unknown,"0,30",Unknown,"0,30",Unknown,Cash,Unknown,EPI SERVICE PRIMEUR,Unknown,-4762844.0
Unknown,8,Unknown,8,Unknown,Cash,Unknown,EPI SERVICE PRIMEUR,Unknown,-4762852.0
Unknown,4,Unknown,4,Unknown,Cash,Unknown,EPI SERVICE PRIMEUR,Unknown,-4762856.0
Unknown,1,Unknown,1,Unknown,Cash,Unknown,EPI SERVICE PRIMEUR,Unknown,-4762857.0
27/09/2021,40,Unknown,40,Unknown,Cash,Unknown,EPI SERVICE PRIMEUR,Titulaire(s,-40.0
27/09/2021,10,Unknown,10,Unknown,Cash,Unknown,EPI SERVICE PRIMEUR,Date Date de Valeur,-50.0
27/09/2021,7,Unknown,7,Unknown,Cash,Unknown,EPI SERVICE PRIMEUR,METRO CASH,-57.0
28/09/2021,10,Unknown,10,Unknown,Cash,Unknown,EPI SERVICE PRIMEUR,REMISE,-67.0
27/09/2021,27,Unknown,27,Unknown,Cash,Unknown,EPI SERVICE PRIMEUR,REMISE,-94.0
27/09/2021,09 27,Unknown,09 27,Unknown,Cash,Unknown,EPI SERVICE PRIMEUR,REMISE,-1021.0
28/09/2021,09,Unknown,09,Unknown,Cash,Unknown,EPI SERVICE PRIMEUR,REMISE,-1030.0
28/09/2021,27,Unknown,27,Unknown,Cash,Unknown,EPI SERVICE PRIMEUR,REMISE,-1057.0
28/09/2021,09,Unknown,09,Unknown,Cash,Unknown,EPI SERVICE PRIMEUR,TPV,-1066.0
28/09/2021,27,Unknown,27,Unknown,Cash,Unknown,EPI SERVICE PRIMEUR,COM,-1093.0
28/09/2021,09,Unknown,09,Unknown,Cash,Unknown,EPI SERVICE PRIMEUR,CARTES,-1102.0
28/09/2021,28,Unknown,28,Unknown,Cash,Unknown,EPI SERVICE PRIMEUR,COM,-1130.0
28/09/2021,09,Unknown,09,Unknown,Cash,Unknown,EPI SERVICE PRIMEUR,CARTES,-1139.0
28/09/2021,27,Unknown,27,Unknown,Cash,Unknown,EPI SERVICE PRIMEUR,COM,-1166.0
28/09/2021,09,Unknown,09,Unknown,Cash,Unknown,EPI SERVICE PRIMEUR,COM,-1175.0
29/09/2021,27,Unknown,27,Unknown,Cash,Unknown,EPI SERVICE PRIMEUR,CARTES,-1202.0
28/09/2021,09,Unknown,09,Unknown,Cash,Unknown,EPI SERVICE PRIMEUR,COM,-1211.0
28/09/2021,28,Unknown,28,Unknown,Cash,Unknown,EPI SERVICE PRIMEUR,CARTES,-1239.0
29/09/2021,09,Unknown,09,Unknown,Cash,Unknown,EPI SERVICE PRIMEUR,COM,-1248.0
29/09/2021,64,Unknown,64,Unknown,Cash,Unknown,EPI SERVICE PRIMEUR,CARTES,-1312.0
29/09/2021,28,Unknown,28,Unknown,Cash,Unknown,EPI SERVICE PRIMEUR,COM,-1340.0
29/09/2021,09,Unknown,09,Unknown,Cash,Unknown,EPI SERVICE PRIMEUR,CARTES,-1349.0
29/09/2021,01,Unknown,01,Unknown,Cash,Unknown,EPI SERVICE PRIMEUR,REMISE,-1350.0
29/09/2021,28,Unknown,28,Unknown,Cash,Unknown,EPI SERVICE PRIMEUR,REMISE,-1378.0
29/09/2021,09,Unknown,09,Unknown,Cash,Unknown,EPI SERVICE PRIMEUR,COM,-1387.0
29/09/2021,64,Unknown,64,Unknown,Cash,Unknown,EPI SERVICE PRIMEUR,CARTES,-1451.0
29/09/2021,28,Unknown,28,Unknown,Cash,Unknown,EPI SERVICE PRIMEUR,COM,-1479.0
29/09/2021,09,Unknown,09,Unknown,Cash,Unknown,EPI SERVICE PRIMEUR,CARTES,-1488.0
29/09/2021,01,Unknown,01,Unknown,Cash,Unknown,EPI SERVICE PRIMEUR,COM,-1489.0
30/09/2021,28,Unknown,28,Unknown,Cash,Unknown,EPI SERVICE PRIMEUR,CARTES 0386405,-1517.0
30/09/2021,09,Unknown,09,Unknown,Cash,Unknown,EPI SERVICE PRIMEUR,COM,-1526.0
30/09/2021,64,Unknown,64,Unknown,Cash,Unknown,EPI SERVICE PRIMEUR,CARTES,-1590.0
30/09/2021,28,Unknown,28,Unknown,Cash,Unknown,EPI SERVICE PRIMEUR,COM,-1618.0
30/09/2021,09,Unknown,09,Unknown,Cash,Unknown,EPI SERVICE PRIMEUR,CARTES,-1627.0
30/09/2021,01,Unknown,01,Unknown,Cash,Unknown,EPI SERVICE PRIMEUR,COM,-1628.0
30/09/2021,28,Unknown,28,Unknown,Cash,Unknown,EPI SERVICE PRIMEUR,CARTES,-1656.0
30/09/2021,09,Unknown,09,Unknown,Cash,Unknown,EPI SERVICE PRIMEUR,COM,-1665.0
30/09/2021,01,Unknown,01,Unknown,Cash,Unknown,EPI SERVICE PRIMEUR,REMISE,-1666.0
30/09/2021,28,Unknown,28,Unknown,Cash,Unknown,EPI SERVICE PRIMEUR,REMISE,-1694.0
30/09/2021,09,Unknown,09,Unknown,Cash,Unknown,EPI SERVICE PRIMEUR,REMISE,-1703.0
30/09/2021,28,Unknown,28,Unknown,Cash,Unknown,EPI SERVICE PRIMEUR,TPV,-1731.0
30/09/2021,09,Unknown,09,Unknown,Cash,Unknown,EPI SERVICE PRIMEUR,REMISE,-1740.0
30/09/2021,29,Unknown,29,Unknown,Cash,Unknown,EPI SERVICE PRIMEUR,TPV,-1769.0
30/09/2021,09,Unknown,09,Unknown,Cash,Unknown,EPI SERVICE PRIMEUR,COM,-1778.0
30/09/2021,28,Unknown,28,Unknown,Cash,Unknown,EPI SERVICE PRIMEUR,CARTES,-1806.0
01/10/2021,09,Unknown,09,Unknown,Cash,Unknown,EPI SERVICE PRIMEUR,COM,-1815.0
30/09/2021,28,Unknown,28,Unknown,Cash,Unknown,EPI SERVICE PRIMEUR,CARTES,-1843.0
30/09/2021,09,Unknown,09,Unknown,Cash,Unknown,EPI SERVICE PRIMEUR,COM,-1852.0
01/10/2021,29,Unknown,29,Unknown,Cash,Unknown,EPI SERVICE PRIMEUR,CARTES 0386405,-1881.0
01/10/2021,09,Unknown,09,Unknown,Cash,Unknown,EPI SERVICE PRIMEUR,COM,-1890.0
01/10/2021,64,Unknown,64,Unknown,Cash,Unknown,EPI SERVICE PRIMEUR,CARTES,-1954.0
01/10/2021,29,Unknown,29,Unknown,Cash,Unknown,EPI SERVICE PRIMEUR,COM,-1983.0
01/10/2021,09,Unknown,09,Unknown,Cash,Unknown,EPI SERVICE PRIMEUR,CARTES,-1992.0
Unknown,01,Unknown,01,Unknown,Cash,Unknown,EPI SERVICE PRIMEUR,COM,-1993.0
Unknown,29,Unknown,29,Unknown,Cash,Unknown,EPI SERVICE PRIMEUR,CARTES,-2022.0
Unknown,09,Unknown,09,Unknown,Cash,Unknown,EPI SERVICE PRIMEUR,COM,-2031.0
Unknown,64,Unknown,64,Unknown,Cash,Unknown,EPI SERVICE PRIMEUR,CARTES 0386405,-2095.0
Unknown,29,Unknown,29,Unknown,Cash,Unknown,EPI SERVICE PRIMEUR,COM,-2124.0
Unknown,09,Unknown,09,Unknown,Cash,Unknown,EPI SERVICE PRIMEUR,CARTES,-2133.0
Unknown,01,Unknown,01,Unknown,Cash,Unknown,EPI SERVICE PRIMEUR,COM,-2134.0
Unknown,29,Unknown,29,Unknown,Cash,Unknown,EPI SERVICE PRIMEUR,CARTES 0386405,-2163.0
Unknown,09,Unknown,09,Unknown,Cash,Unknown,EPI SERVICE PRIMEUR,COM,-2172.0
Unknown,64,Unknown,64,Unknown,Cash,Unknown,EPI SERVICE PRIMEUR,CARTES,-2236.0
Unknown,29,Unknown,29,Unknown,Cash,Unknown,EPI SERVICE PRIMEUR,COM,-2265.0
Unknown,09,Unknown,09,Unknown,Cash,Unknown,EPI SERVICE PRIMEUR,CARTES 0386405,-2274.0
Unknown,01,Unknown,01,Unknown,Cash,Unknown,EPI SERVICE PRIMEUR,COM,-2275.0
Unknown,29,Unknown,29,Unknown,Cash,Unknown,EPI SERVICE PRIMEUR,CARTES,-2304.0
Unknown,09,Unknown,09,Unknown,Cash,Unknown,EPI SERVICE PRIMEUR,TPV,-2313.0
Unknown,64,Unknown,64,Unknown,Cash,Unknown,EPI SERVICE PRIMEUR,TPV,-2377.0
Unknown,29,Unknown,29,Unknown,Cash,Unknown,EPI SERVICE PRIMEUR,CARTE,-2406.0
Unknown,09,Unknown,09,Unknown,Cash,Unknown,EPI SERVICE PRIMEUR,COM,-2415.0
Unknown,29,Unknown,29,Unknown,Cash,Unknown,EPI SERVICE PRIMEUR,CARTES,-2444.0
Unknown,09,Unknown,09,Unknown,Cash,Unknown,EPI SERVICE PRIMEUR,COM,-2453.0
Unknown,29,Unknown,29,Unknown,Cash,Unknown,EPI SERVICE PRIMEUR,CARTES 0386405,-2482.0
Unknown,09,Unknown,09,Unknown,Cash,Unknown,EPI SERVICE PRIMEUR,COM,-2491.0
Unknown,29,Unknown,29,Unknown,Cash,Unknown,EPI SERVICE PRIMEUR,CARTES,-2520.0
Unknown,09,Unknown,09,Unknown,Cash,Unknown,EPI SERVICE PRIMEUR,COM,-2529.0
Unknown,30,Unknown,30,Unknown,Cash,Unknown,EPI SERVICE PRIMEUR,CARTES,-2559.0
Unknown,09,Unknown,09,Unknown,Cash,Unknown,EPI SERVICE PRIMEUR,Unknown,-2568.0
Unknown,30,Unknown,30,Unknown,Cash,Unknown,EPI SERVICE PRIMEUR,Unknown,-2598.0
Unknown,09,Unknown,09,Unknown,Cash,Unknown,EPI SERVICE PRIMEUR,Unknown,-2607.0
Unknown,30,Unknown,30,Unknown,Cash,Unknown,EPI SERVICE PRIMEUR,Unknown,-2637.0
Unknown,09,Unknown,09,Unknown,Cash,Unknown,EPI SERVICE PRIMEUR,Unknown,-2646.0
Unknown,30,Unknown,30,Unknown,Cash,Unknown,EPI SERVICE PRIMEUR,Unknown,-2676.0
Unknown,09,Unknown,09,Unknown,Cash,Unknown,EPI SERVICE PRIMEUR,Unknown,-2685.0
Unknown,30,Unknown,30,Unknown,Cash,Unknown,EPI SERVICE PRIMEUR,Unknown,-2715.0
Unknown,09,Unknown,09,Unknown,Cash,Unknown,EPI SERVICE PRIMEUR,Unknown,-2724.0
Unknown,64,Unknown,64,Unknown,Cash,Unknown,EPI SERVICE PRIMEUR,Unknown,-2788.0
Unknown,30,Unknown,30,Unknown,Cash,Unknown,EPI SERVICE PRIMEUR,Unknown,-2818.0
Unknown,09,Unknown,09,Unknown,Cash,Unknown,EPI SERVICE PRIMEUR,Unknown,-2827.0
Unknown,01,Unknown,01,Unknown,Cash,Unknown,EPI SERVICE PRIMEUR,Unknown,-2828.0
Unknown,30,Unknown,30,Unknown,Cash,Unknown,EPI SERVICE PRIMEUR,Unknown,-2858.0
Unknown,09,Unknown,09,Unknown,Cash,Unknown,EPI SERVICE PRIMEUR,Unknown,-2867.0
Unknown,64,Unknown,64,Unknown,Cash,Unknown,EPI SERVICE PRIMEUR,Unknown,-2931.0
Unknown,30,Unknown,30,Unknown,Cash,Unknown,EPI SERVICE PRIMEUR,Unknown,-2961.0
Unknown,09,Unknown,09,Unknown,Cash,Unknown,EPI SERVICE PRIMEUR,Unknown,-2970.0
Unknown,01,Unknown,01,Unknown,Cash,Unknown,EPI SERVICE PRIMEUR,Unknown,-2971.0
Unknown,30,Unknown,30,Unknown,Cash,Unknown,EPI SERVICE PRIMEUR,Unknown,-3001.0
Unknown,09,Unknown,09,Unknown,Cash,Unknown,EPI SERVICE PRIMEUR,Unknown,-3010.0
Unknown,64,Unknown,64,Unknown,Cash,Unknown,EPI SERVICE PRIMEUR,Unknown,-3074.0
Unknown,30,Unknown,30,Unknown,Cash,Unknown,EPI SERVICE PRIMEUR,Unknown,-3104.0
Unknown,09,Unknown,09,Unknown,Cash,Unknown,EPI SERVICE PRIMEUR,Unknown,-3113.0
Unknown,01,Unknown,01,Unknown,Cash,Unknown,EPI SERVICE PRIMEUR,Unknown,-3114.0
Unknown,30,Unknown,30,Unknown,Cash,Unknown,EPI SERVICE PRIMEUR,Unknown,-3144.0
Unknown,09,Unknown,09,Unknown,Cash,Unknown,EPI SERVICE PRIMEUR,Unknown,-3153.0
Unknown,64,Unknown,64,Unknown,Cash,Unknown,EPI SERVICE PRIMEUR,Unknown,-3217.0
Unknown,30,Unknown,30,Unknown,Cash,Unknown,EPI SERVICE PRIMEUR,Unknown,-3247.0
Unknown,09,Unknown,09,Unknown,Cash,Unknown,EPI SERVICE PRIMEUR,Unknown,-3256.0
Unknown,01,Unknown,01,Unknown,Cash,Unknown,EPI SERVICE PRIMEUR,Unknown,-3257.0
Unknown,30,Unknown,30,Unknown,Cash,Unknown,EPI SERVICE PRIMEUR,Unknown,-3287.0
Unknown,09,Unknown,09,Unknown,Cash,Unknown,EPI SERVICE PRIMEUR,Unknown,-3296.0
Unknown,64,Unknown,64,Unknown,Cash,Unknown,EPI SERVICE PRIMEUR,Unknown,-3360.0
Unknown,30,Unknown,30,Unknown,Cash,Unknown,EPI SERVICE PRIMEUR,Unknown,-3390.0
Unknown,09,Unknown,09,Unknown,Cash,Unknown,EPI SERVICE PRIMEUR,Unknown,-3399.0
Unknown,01,Unknown,01,Unknown,Cash,Unknown,EPI SERVICE PRIMEUR,Unknown,-3400.0
Unknown,30,Unknown,30,Unknown,Cash,Unknown,EPI SERVICE PRIMEUR,Unknown,-3430.0
Unknown,09,Unknown,09,Unknown,Cash,Unknown,EPI SERVICE PRIMEUR,Unknown,-3439.0
Unknown,64,Unknown,64,Unknown,Cash,Unknown,EPI SERVICE PRIMEUR,Unknown,-3503.0
Unknown,30,Unknown,30,Unknown,Cash,Unknown,EPI SERVICE PRIMEUR,Unknown,-3533.0
Unknown,09,Unknown,09,Unknown,Cash,Unknown,EPI SERVICE PRIMEUR,Unknown,-3542.0
Unknown,01,Unknown,01,Unknown,Cash,Unknown,EPI SERVICE PRIMEUR,Unknown,-3543.0
Unknown,01,Unknown,01,Unknown,Cash,Unknown,EPI SERVICE PRIMEUR,Unknown,-3544.0
Unknown,10,Unknown,10,Unknown,Cash,Unknown,EPI SERVICE PRIMEUR,Unknown,-3554.0
Unknown,30,Unknown,30,Unknown,Cash,Unknown,EPI SERVICE PRIMEUR,Unknown,-3584.0
Unknown,09,Unknown,09,Unknown,Cash,Unknown,EPI SERVICE PRIMEUR,Unknown,-3593.0
Unknown,30,Unknown,30,Unknown,Cash,Unknown,EPI SERVICE PRIMEUR,Unknown,-3623.0
Unknown,09,Unknown,09,Unknown,Cash,Unknown,EPI SERVICE PRIMEUR,Unknown,-3632.0
Unknown,01,Unknown,01,Unknown,Cash,Unknown,EPI SERVICE PRIMEUR,Unknown,-3633.0
Unknown,10,Unknown,10,Unknown,Cash,Unknown,EPI SERVICE PRIMEUR,Unknown,-3643.0
Unknown,30,Unknown,30,Unknown,Cash,Unknown,EPI SERVICE PRIMEUR,Unknown,-3673.0
Unknown,09,Unknown,09,Unknown,Cash,Unknown,EPI SERVICE PRIMEUR,Unknown,-3682.0
Unknown,01,Unknown,01,Unknown,Cash,Unknown,EPI SERVICE PRIMEUR,Unknown,-3683.0
Unknown,10,Unknown,10,Unknown,Cash,Unknown,EPI SERVICE PRIMEUR,Unknown,-3693.0
Unknown,64,Unknown,64,Unknown,Cash,Unknown,EPI SERVICE PRIMEUR,Unknown,-3757.0
Unknown,01,Unknown,01,Unknown,Cash,Unknown,EPI SERVICE PRIMEUR,Unknown,-3758.0
Unknown,10,Unknown,10,Unknown,Cash,Unknown,EPI SERVICE PRIMEUR,Unknown,-3768.0
Unknown,64,Unknown,64,Unknown,Cash,Unknown,EPI SERVICE PRIMEUR,Unknown,-3832.0
Unknown,01,Unknown,01,Unknown,Cash,Unknown,EPI SERVICE PRIMEUR,Unknown,-3833.0
Unknown,10,Unknown,10,Unknown,Cash,Unknown,EPI SERVICE PRIMEUR,Unknown,-3843.0
Unknown,01,Unknown,01,Unknown,Cash,Unknown,EPI SERVICE PRIMEUR,Unknown,-3844.0
Unknown,01,Unknown,01,Unknown,Cash,Unknown,EPI SERVICE PRIMEUR,Unknown,-3845.0
Unknown,10,Unknown,10,Unknown,Cash,Unknown,EPI SERVICE PRIMEUR,Unknown,-3855.0
Unknown,64,Unknown,64,Unknown,Cash,Unknown,EPI SERVICE PRIMEUR,Unknown,-3919.0
Unknown,"297,00",Unknown,"297,00",Unknown,Cash,Unknown,EPI SERVICE PRIMEUR,Unknown,-33619.0
Unknown,28,Unknown,28,Unknown,Cash,Unknown,EPI SERVICE PRIMEUR,Unknown,-33647.0
Unknown,09 28,Unknown,09 28,Unknown,Cash,Unknown,EPI SERVICE PRIMEUR,Unknown,-34575.0
Unknown,09 28,Unknown,09 28,Unknown,Cash,Unknown,EPI SERVICE PRIMEUR,Unknown,-35503.0
Unknown,09 28,Unknown,09 28,Unknown,Cash,Unknown,EPI SERVICE PRIMEUR,Unknown,-36431.0
Unknown,09 28,Unknown,09 28,Unknown,Cash,Unknown,EPI SERVICE PRIMEUR,Unknown,-37359.0
Unknown,09 28,Unknown,09 28,Unknown,Cash,Unknown,EPI SERVICE PRIMEUR,Unknown,-38287.0
Unknown,09 28,Unknown,09 28,Unknown,Cash,Unknown,EPI SERVICE PRIMEUR,Unknown,-39215.0
Unknown,09 28,Unknown,09 28,Unknown,Cash,Unknown,EPI SERVICE PRIMEUR,Unknown,-40143.0
Unknown,09 28,Unknown,09 28,Unknown,Cash,Unknown,EPI SERVICE PRIMEUR,Unknown,-41071.0
Unknown,09 28,Unknown,09 28,Unknown,Cash,Unknown,EPI SERVICE PRIMEUR,Unknown,-41999.0
Unknown,09 28,Unknown,09 28,Unknown,Cash,Unknown,EPI SERVICE PRIMEUR,Unknown,-42927.0
Unknown,09 28,Unknown,09 28,Unknown,Cash,Unknown,EPI SERVICE PRIMEUR,Unknown,-43855.0
Unknown,09 29,Unknown,09 29,Unknown,Cash,Unknown,EPI SERVICE PRIMEUR,Unknown,-44784.0
Unknown,09 29,Unknown,09 29,Unknown,Cash,Unknown,EPI SERVICE PRIMEUR,Unknown,-45713.0
Unknown,09 29,Unknown,09 29,Unknown,Cash,Unknown,EPI SERVICE PRIMEUR,Unknown,-46642.0
Unknown,09 29,Unknown,09 29,Unknown,Cash,Unknown,EPI SERVICE PRIMEUR,Unknown,-47571.0
Unknown,09 29,Unknown,09 29,Unknown,Cash,Unknown,EPI SERVICE PRIMEUR,Unknown,-48500.0
Unknown,09 29,Unknown,09 29,Unknown,Cash,Unknown,EPI SERVICE PRIMEUR,Unknown,-49429.0
Unknown,09 29,Unknown,09 29,Unknown,Cash,Unknown,EPI SERVICE PRIMEUR,Unknown,-50358.0
Unknown,09 29,Unknown,09 29,Unknown,Cash,Unknown,EPI SERVICE PRIMEUR,Unknown,-51287.0
Unknown,09 29,Unknown,09 29,Unknown,Cash,Unknown,EPI SERVICE PRIMEUR,Unknown,-52216.0
Unknown,09 29,Unknown,09 29,Unknown,Cash,Unknown,EPI SERVICE PRIMEUR,Unknown,-53145.0
Unknown,09 29,Unknown,09 29,Unknown,Cash,Unknown,EPI SERVICE PRIMEUR,Unknown,-54074.0
Unknown,09 29,Unknown,09 29,Unknown,Cash,Unknown,EPI SERVICE PRIMEUR,Unknown,-55003.0
Unknown,09 30,Unknown,09 30,Unknown,Cash,Unknown,EPI SERVICE PRIMEUR,Unknown,-55933.0
Unknown,09 30,Unknown,09 30,Unknown,Cash,Unknown,EPI SERVICE PRIMEUR,Unknown,-56863.0
Unknown,09 30,Unknown,09 30,Unknown,Cash,Unknown,EPI SERVICE PRIMEUR,Unknown,-57793.0
Unknown,09 30,Unknown,09 30,Unknown,Cash,Unknown,EPI SERVICE PRIMEUR,Unknown,-58723.0
Unknown,09 30,Unknown,09 30,Unknown,Cash,Unknown,EPI SERVICE PRIMEUR,Unknown,-59653.0
Unknown,09 30,Unknown,09 30,Unknown,Cash,Unknown,EPI SERVICE PRIMEUR,Unknown,-60583.0
Unknown,09 30,Unknown,09 30,Unknown,Cash,Unknown,EPI SERVICE PRIMEUR,Unknown,-61513.0
Unknown,09 30,Unknown,09 30,Unknown,Cash,Unknown,EPI SERVICE PRIMEUR,Unknown,-62443.0
Unknown,09 30,Unknown,09 30,Unknown,Cash,Unknown,EPI SERVICE PRIMEUR,Unknown,-63373.0
Unknown,09 30,Unknown,09 30,Unknown,Cash,Unknown,EPI SERVICE PRIMEUR,Unknown,-64303.0
Unknown,09 30,Unknown,09 30,Unknown,Cash,Unknown,EPI SERVICE PRIMEUR,Unknown,-65233.0
Unknown,09 30,Unknown,09 30,Unknown,Cash,Unknown,EPI SERVICE PRIMEUR,Unknown,-66163.0
Unknown,09 30,Unknown,09 30,Unknown,Cash,Unknown,EPI SERVICE PRIMEUR,Unknown,-67093.0
Unknown,09 30,Unknown,09 30,Unknown,Cash,Unknown,EPI SERVICE PRIMEUR,Unknown,-68023.0
Unknown,09 30,Unknown,09 30,Unknown,Cash,Unknown,EPI SERVICE PRIMEUR,Unknown,-68953.0
Unknown,09 30,Unknown,09 30,Unknown,Cash,Unknown,EPI SERVICE PRIMEUR,Unknown,-69883.0
Unknown,09 30,Unknown,09 30,Unknown,Cash,Unknown,EPI SERVICE PRIMEUR,Unknown,-70813.0
Unknown,09 30,Unknown,09 30,Unknown,Cash,Unknown,EPI SERVICE PRIMEUR,Unknown,-71743.0
Unknown,09 30,Unknown,09 30,Unknown,Cash,Unknown,EPI SERVICE PRIMEUR,Unknown,-72673.0
Unknown,09 30,Unknown,09 30,Unknown,Cash,Unknown,EPI SERVICE PRIMEUR,Unknown,-73603.0
Unknown,09 01,Unknown,09 01,Unknown,Cash,Unknown,EPI SERVICE PRIMEUR,Unknown,-74504.0
Unknown,10 01,Unknown,10 01,Unknown,Cash,Unknown,EPI SERVICE PRIMEUR,Unknown,-75505.0
Unknown,10 01,Unknown,10 01,Unknown,Cash,Unknown,EPI SERVICE PRIMEUR,Unknown,-76506.0
Unknown,10 01,Unknown,10 01,Unknown,Cash,Unknown,EPI SERVICE PRIMEUR,Unknown,-77507.0
Unknown,10 01,Unknown,10 01,Unknown,Cash,Unknown,EPI SERVICE PRIMEUR,Unknown,-78508.0
Unknown,10 01,Unknown,10 01,Unknown,Cash,Unknown,EPI SERVICE PRIMEUR,Unknown,-79509.0
Unknown,10 01,Unknown,10 01,Unknown,Cash,Unknown,EPI SERVICE PRIMEUR,Unknown,-80510.0
Unknown,10 01,Unknown,10 01,Unknown,Cash,Unknown,EPI SERVICE PRIMEUR,Unknown,-81511.0
Unknown,10 10,Unknown,10 10,Unknown,Cash,Unknown,EPI SERVICE PRIMEUR,Unknown,-82521.0
Unknown,70 28,Unknown,70 28,Unknown,Cash,Unknown,EPI SERVICE PRIMEUR,Unknown,-89549.0
Unknown,"80 187,30",Unknown,"80 187,30",Unknown,Cash,Unknown,EPI SERVICE PRIMEUR,Unknown,-8108279.0
Unknown,"60,50",Unknown,"60,50",Unknown,Cash,Unknown,EPI SERVICE PRIMEUR,Unknown,-8114329.0
Unknown,"43,20",Unknown,"43,20",Unknown,Cash,Unknown,EPI SERVICE PRIMEUR,Unknown,-8118649.0
Unknown,"0,10",Unknown,"0,10",Unknown,Cash,Unknown,EPI SERVICE PRIMEUR,Unknown,-8118659.0
Unknown,"0,27",Unknown,"0,27",Unknown,Cash,Unknown,EPI SERVICE PRIMEUR,Unknown,-8118686.0
Unknown,"0,89",Unknown,"0,89",Unknown,Cash,Unknown,EPI SERVICE PRIMEUR,Unknown,-8118775.0
Unknown,"0,12",Unknown,"0,12",Unknown,Cash,Unknown,EPI SERVICE PRIMEUR,Unknown,-8118787.0
Unknown,"0,26",Unknown,"0,26",Unknown,Cash,Unknown,EPI SERVICE PRIMEUR,Unknown,-8118813.0
Unknown,"0,34",Unknown,"0,34",Unknown,Cash,Unknown,EPI SERVICE PRIMEUR,Unknown,-8118847.0
Unknown,"0,04",Unknown,"0,04",Unknown,Cash,Unknown,EPI SERVICE PRIMEUR,Unknown,-8118851.0
Unknown,"11,00",Unknown,"11,00",Unknown,Cash,Unknown,EPI SERVICE PRIMEUR,Unknown,-8119951.0
Unknown,"225,40",Unknown,"225,40",Unknown,Cash,Unknown,EPI SERVICE PRIMEUR,Unknown,-8142491.0
Unknown,"41,60",Unknown,"41,60",Unknown,Cash,Unknown,EPI SERVICE PRIMEUR,Unknown,-8146651.0
Unknown,"28,30",Unknown,"28,30",Unknown,Cash,Unknown,EPI SERVICE PRIMEUR,Unknown,-8149481.0
Unknown,"92,00",Unknown,"92,00",Unknown,Cash,Unknown,EPI SERVICE PRIMEUR,Unknown,-8158681.0
Unknown,"0,66",Unknown,"0,66",Unknown,Cash,Unknown,EPI SERVICE PRIMEUR,Unknown,-8158747.0
Unknown,"0,39",Unknown,"0,39",Unknown,Cash,Unknown,EPI SERVICE PRIMEUR,Unknown,-8158786.0
Unknown,"1,10",Unknown,"1,10",Unknown,Cash,Unknown,EPI SERVICE PRIMEUR,Unknown,-8158896.0
Unknown,"0,17",Unknown,"0,17",Unknown,Cash,Unknown,EPI SERVICE PRIMEUR,Unknown,-8158913.0
Unknown,"0,13",Unknown,"0,13",Unknown,Cash,Unknown,EPI SERVICE PRIMEUR,Unknown,-8158926.0
Unknown,"0,47",Unknown,"0,47",Unknown,Cash,Unknown,EPI SERVICE PRIMEUR,Unknown,-8158973.0
Unknown,"0,05",Unknown,"0,05",Unknown,Cash,Unknown,EPI SERVICE PRIMEUR,Unknown,-8158978.0
Unknown,"27,50",Unknown,"27,50",Unknown,Cash,Unknown,EPI SERVICE PRIMEUR,Unknown,-8161728.0
Unknown,"519,50",Unknown,"519,50",Unknown,Cash,Unknown,EPI SERVICE PRIMEUR,Unknown,-8213678.0
Unknown,"62,30",Unknown,"62,30",Unknown,Cash,Unknown,EPI SERVICE PRIMEUR,Unknown,-8219908.0
Unknown,"73,50",Unknown,"73,50",Unknown,Cash,Unknown,EPI SERVICE PRIMEUR,Unknown,-8227258.0
Unknown,"68,70",Unknown,"68,70",Unknown,Cash,Unknown,EPI SERVICE PRIMEUR,Unknown,-8234128.0
Unknown,"143,30",Unknown,"143,30",Unknown,Cash,Unknown,EPI SERVICE PRIMEUR,Unknown,-8248458.0
Unknown,"137,74",Unknown,"137,74",Unknown,Cash,Unknown,EPI SERVICE PRIMEUR,Unknown,-8262232.0
Unknown,"67,39",Unknown,"67,39",Unknown,Cash,Unknown,EPI SERVICE PRIMEUR,Unknown,-8268971.0
Unknown,"0,88",Unknown,"0,88",Unknown,Cash,Unknown,EPI SERVICE PRIMEUR,Unknown,-8269059.0
Unknown,"0,20",Unknown,"0,20",Unknown,Cash,Unknown,EPI SERVICE PRIMEUR,Unknown,-8269079.0
Unknown,"1,41",Unknown,"1,41",Unknown,Cash,Unknown,EPI SERVICE PRIMEUR,Unknown,-8269220.0
Unknown,"0,84",Unknown,"0,84",Unknown,Cash,Unknown,EPI SERVICE PRIMEUR,Unknown,-8269304.0
Unknown,"1,02",Unknown,"1,02",Unknown,Cash,Unknown,EPI SERVICE PRIMEUR,Unknown,-8269406.0
Unknown,"0,02",Unknown,"0,02",Unknown,Cash,Unknown,EPI SERVICE PRIMEUR,Unknown,-8269408.0
Unknown,"0,08",Unknown,"0,08",Unknown,Cash,Unknown,EPI SERVICE PRIMEUR,Unknown,-8269416.0
Unknown,"0,03",Unknown,"0,03",Unknown,Cash,Unknown,EPI SERVICE PRIMEUR,Unknown,-8269419.0
Unknown,"0,61",Unknown,"0,61",Unknown,Cash,Unknown,EPI SERVICE PRIMEUR,Unknown,-8269480.0
Unknown,"0,08",Unknown,"0,08",Unknown,Cash,Unknown,EPI SERVICE PRIMEUR,Unknown,-8269488.0
Unknown,"0,18",Unknown,"0,18",Unknown,Cash,Unknown,EPI SERVICE PRIMEUR,Unknown,-8269506.0
Unknown,"0,50",Unknown,"0,50",Unknown,Cash,Unknown,EPI SERVICE PRIMEUR,Unknown,-8269556.0
Unknown,1,Unknown,1,Unknown,Cash,Unknown,EPI SERVICE PRIMEUR,Unknown,-8269557.0
Unknown,1,Unknown,1,Unknown,Cash,Unknown,EPI SERVICE PRIMEUR,Unknown,-8269558.0
Unknown,"391,35",Unknown,"391,35",Unknown,Cash,Unknown,EPI SERVICE PRIMEUR,Unknown,-8308693.0
Unknown,"38,60",Unknown,"38,60",Unknown,Cash,Unknown,EPI SERVICE PRIMEUR,Unknown,-8312553.0
Unknown,"80,50",Unknown,"80,50",Unknown,Cash,Unknown,EPI SERVICE PRIMEUR,Unknown,-8320603.0
Unknown,"449,00",Unknown,"449,00",Unknown,Cash,Unknown,EPI SERVICE PRIMEUR,Unknown,-8365503.0
Unknown,"1,29",Unknown,"1,29",Unknown,Cash,Unknown,EPI SERVICE PRIMEUR,Unknown,-8365632.0
Unknown,"1,58",Unknown,"1,58",Unknown,Cash,Unknown,EPI SERVICE PRIMEUR,Unknown,-8365790.0
Unknown,"0,19",Unknown,"0,19",Unknown,Cash,Unknown,EPI SERVICE PRIMEUR,Unknown,-8365809.0
Unknown,"0,43",Unknown,"0,43",Unknown,Cash,Unknown,EPI SERVICE PRIMEUR,Unknown,-8365852.0
01/10/2021,01,Unknown,01,Unknown,Cheque,Unknown,Transactions,Relevés,-1.0
31/10/2021,10,Unknown,10,Unknown,Cheque,Unknown,Transactions,Du 01/10/2021 au 31/10/2021 qonto EGB 2 RUE WINSTON CHURCHILL 77120,-11.0
01/10/2021,31,Unknown,31,Unknown,Cheque,Unknown,Transactions,Coulommiers,-42.0
31/10/2021,10,Unknown,10,Unknown,Cheque,Unknown,Transactions,France Solde,-52.0
Unknown,2,Unknown,2,Unknown,Cheque,Unknown,Transactions,"Entrées + 3 796,40 € Sorties 2 504,46",-54.0
Unknown,01,Unknown,01,Unknown,Cheque,Unknown,Transactions,QNTOFRPIXXX Solde,-55.0
Unknown,10 27,Unknown,10 27,Unknown,Cheque,Unknown,Transactions,Date,-1082.0
Unknown,16,Unknown,16,Unknown,Cheque,Unknown,Transactions,Depot,-1098.0
Unknown,"3 796,40",Unknown,"3 796,40",Unknown,Cheque,Unknown,Transactions,DOS SANTOS Depot,-380738.0
Unknown,"2 504,46",Unknown,"2 504,46",Unknown,Cheque,Unknown,Transactions,Depot,-631184.0
Unknown,205,Unknown,205,Unknown,Cheque,Unknown,Transactions,Oonto,-631389.0
Unknown,31,Unknown,31,Unknown,Cheque,Unknown,Transactions,Abonnement,-631420.0
Unknown,10,Unknown,10,Unknown,Cheque,Unknown,Transactions,Frais,-631430.0
Unknown,"1 319,10",Unknown,"1 319,10",Unknown,Cheque,Unknown,Transactions,Oonto,-763340.0
Unknown,05,Unknown,05,Unknown,Cheque,Unknown,Transactions,Abonnement Frais,-763345.0
Unknown,10,Unknown,10,Unknown,Cheque,Unknown,Transactions,Oonto,-763355.0
Unknown,"450,00",Unknown,"450,00",Unknown,Cheque,Unknown,Transactions,Abonnement Frais,-808355.0
Unknown,05,Unknown,05,Unknown,Cheque,Unknown,Transactions,Oonto,-808360.0
Unknown,10,Unknown,10,Unknown,Cheque,Unknown,Transactions,Abonnement,-808370.0
Unknown,"530,00",Unknown,"530,00",Unknown,Cheque,Unknown,Transactions,Frais,-861370.0
Unknown,05,Unknown,05,Unknown,Cheque,Unknown,Transactions,Oonto,-861375.0
Unknown,10,Unknown,10,Unknown,Cheque,Unknown,Transactions,Oonto,-861385.0
Unknown,"288,00",Unknown,"288,00",Unknown,Cheque,Unknown,Transactions,Abonnement Frais,-890185.0
Unknown,05,Unknown,05,Unknown,Cheque,Unknown,Transactions,DELICES 77,-890190.0
Unknown,10,Unknown,10,Unknown,Cheque,Unknown,Transactions,EGB,-890200.0
Unknown,"240,00",Unknown,"240,00",Unknown,Cheque,Unknown,Transactions,Unknown,-914200.0
Unknown,05,Unknown,05,Unknown,Cheque,Unknown,Transactions,Unknown,-914205.0
Unknown,10,Unknown,10,Unknown,Cheque,Unknown,Transactions,Unknown,-914215.0
Unknown,"288,00",Unknown,"288,00",Unknown,Cheque,Unknown,Transactions,Unknown,-943015.0
Unknown,05,Unknown,05,Unknown,Cheque,Unknown,Transactions,Unknown,-943020.0
Unknown,10,Unknown,10,Unknown,Cheque,Unknown,Transactions,Unknown,-943030.0
Unknown,"42,00",Unknown,"42,00",Unknown,Cheque,Unknown,Transactions,Unknown,-947230.0
Unknown,05,Unknown,05,Unknown,Cheque,Unknown,Transactions,Unknown,-947235.0
Unknown,10,Unknown,10,Unknown,Cheque,Unknown,Transactions,Unknown,-947245.0
Unknown,"2,40",Unknown,"2,40",Unknown,Cheque,Unknown,Transactions,Unknown,-947485.0
Unknown,05,Unknown,05,Unknown,Cheque,Unknown,Transactions,Unknown,-947490.0
Unknown,10,Unknown,10,Unknown,Cheque,Unknown,Transactions,Unknown,-947500.0
Unknown,"2,40",Unknown,"2,40",Unknown,Cheque,Unknown,Transactions,Unknown,-947740.0
Unknown,05,Unknown,05,Unknown,Cheque,Unknown,Transactions,Unknown,-947745.0
Unknown,10,Unknown,10,Unknown,Cheque,Unknown,Transactions,Unknown,-947755.0
Unknown,"2,40",Unknown,"2,40",Unknown,Cheque,Unknown,Transactions,Unknown,-947995.0
Unknown,05,Unknown,05,Unknown,Cheque,Unknown,Transactions,Unknown,-948000.0
Unknown,10,Unknown,10,Unknown,Cheque,Unknown,Transactions,Unknown,-948010.0
Unknown,"2,40",Unknown,"2,40",Unknown,Cheque,Unknown,Transactions,Unknown,-948250.0
Unknown,05,Unknown,05,Unknown,Cheque,Unknown,Transactions,Unknown,-948255.0
Unknown,10,Unknown,10,Unknown,Cheque,Unknown,Transactions,Unknown,-948265.0
Unknown,"2,40",Unknown,"2,40",Unknown,Cheque,Unknown,Transactions,Unknown,-948505.0
Unknown,06,Unknown,06,Unknown,Cheque,Unknown,Transactions,Unknown,-948511.0
Unknown,10,Unknown,10,Unknown,Cheque,Unknown,Transactions,Unknown,-948521.0
Unknown,"237,78",Unknown,"237,78",Unknown,Cheque,Unknown,Transactions,Unknown,-972299.0
Unknown,07,Unknown,07,Unknown,Cheque,Unknown,Transactions,Unknown,-972306.0
Unknown,10,Unknown,10,Unknown,Cheque,Unknown,Transactions,Unknown,-972316.0
Unknown,"616,64",Unknown,"616,64",Unknown,Cheque,Unknown,Transactions,Unknown,-1033980.0
Unknown,08,Unknown,08,Unknown,Cheque,Unknown,Transactions,Unknown,-1033988.0
Unknown,10,Unknown,10,Unknown,Cheque,Unknown,Transactions,Unknown,-1033998.0
Unknown,"58,02",Unknown,"58,02",Unknown,Cheque,Unknown,Transactions,Unknown,-1039800.0
Unknown,08,Unknown,08,Unknown,Cheque,Unknown,Transactions,Unknown,-1039808.0
Unknown,10,Unknown,10,Unknown,Cheque,Unknown,Transactions,Unknown,-1039818.0
Unknown,77,Unknown,77,Unknown,Cheque,Unknown,Transactions,Unknown,-1039895.0
Unknown,"51,50",Unknown,"51,50",Unknown,Cheque,Unknown,Transactions,Unknown,-1045045.0
Unknown,08,Unknown,08,Unknown,Cheque,Unknown,Transactions,Unknown,-1045053.0
Unknown,10,Unknown,10,Unknown,Cheque,Unknown,Transactions,Unknown,-1045063.0
Unknown,"51,00",Unknown,"51,00",Unknown,Cheque,Unknown,Transactions,Unknown,-1050163.0
Unknown,09,Unknown,09,Unknown,Cheque,Unknown,Transactions,Unknown,-1050172.0
Unknown,10,Unknown,10,Unknown,Cheque,Unknown,Transactions,Unknown,-1050182.0
Unknown,"68,74",Unknown,"68,74",Unknown,Cheque,Unknown,Transactions,Unknown,-1057056.0
Unknown,01,Unknown,01,Unknown,Cheque,Unknown,Transactions,Unknown,-1057057.0
Unknown,10,Unknown,10,Unknown,Cheque,Unknown,Transactions,Unknown,-1057067.0
Unknown,31,Unknown,31,Unknown,Cheque,Unknown,Transactions,Unknown,-1057098.0
Unknown,10,Unknown,10,Unknown,Cheque,Unknown,Transactions,Unknown,-1057108.0
Unknown,205,Unknown,205,Unknown,Cheque,Unknown,Transactions,Unknown,-1057313.0
Unknown,1,Unknown,1,Unknown,Cheque,Unknown,Transactions,Unknown,-1057314.0
Unknown,2,Unknown,2,Unknown,Cheque,Unknown,Transactions,Unknown,-1057316.0
01/10/2021,Unknown,11,Unknown,Unknown,Cheque,Unknown,TOTAL,GROUPAMA 401374,11.0
31/10/2021,Unknown,10,Unknown,Unknown,Cheque,Unknown,TOTAL,Po73939785,21.0
Unknown,Unknown,"29,99",Unknown,Unknown,Cheque,Unknown,TOTAL,diallo mamadou,3020.0
Unknown,Unknown,11,Unknown,Unknown,Cheque,Unknown,TOTAL,WESTERN,3031.0
Unknown,Unknown,10,Unknown,Unknown,Cheque,Unknown,TOTAL,RELCOULOMMIERS,3041.0
Unknown,Unknown,"15,06",Unknown,Unknown,Cheque,Unknown,TOTAL,MAILLARD,4547.0
Unknown,Unknown,12,Unknown,Unknown,Cheque,Unknown,TOTAL,REBAIS FR,4559.0
Unknown,Unknown,10,Unknown,Unknown,Cheque,Unknown,TOTAL,LES TEMPLIERS,4569.0
Unknown,Unknown,"30,00",Unknown,Unknown,Cheque,Unknown,TOTAL,LECLERC,7569.0
Unknown,Unknown,12,Unknown,Unknown,Cheque,Unknown,TOTAL,RELCOULOMMIERS,7581.0
Unknown,Unknown,10,Unknown,Unknown,Cheque,Unknown,TOTAL,RECIPON Depot,7591.0
Unknown,Unknown,"58,50",Unknown,Unknown,Cheque,Unknown,TOTAL,RECIPON Depot,13441.0
Unknown,Unknown,12,Unknown,Unknown,Cheque,Unknown,TOTAL,Qonto,13453.0
Unknown,Unknown,10,Unknown,Unknown,Cheque,Unknown,TOTAL,Abonnement,13463.0
Unknown,Unknown,"16,02",Unknown,Unknown,Cheque,Unknown,TOTAL,Frais,15065.0
Unknown,Unknown,12,Unknown,Unknown,Cheque,Unknown,TOTAL,Oonto,15077.0
Unknown,Unknown,10,Unknown,Unknown,Cheque,Unknown,TOTAL,Abonnement,15087.0
Unknown,Unknown,"27,40",Unknown,Unknown,Cheque,Unknown,TOTAL,Frais,17827.0
Unknown,Unknown,13,Unknown,Unknown,Cheque,Unknown,TOTAL,Qonto,17840.0
Unknown,Unknown,10,Unknown,Unknown,Cheque,Unknown,TOTAL,Apple Pay,17850.0
Unknown,Unknown,"249,50",Unknown,Unknown,Cheque,Unknown,TOTAL,Qonto,42800.0
Unknown,Unknown,14,Unknown,Unknown,Cheque,Unknown,TOTAL,La Fayette,42814.0
Unknown,Unknown,10,Unknown,Unknown,Cheque,Unknown,TOTAL,"Paris RCS Paris n8819,489",42824.0
Unknown,Unknown,"25,00",Unknown,Unknown,Cheque,Unknown,TOTAL,Olinda,45324.0
Unknown,Unknown,14,Unknown,Unknown,Cheque,Unknown,TOTAL,| 'Autonte,45338.0
Unknown,Unknown,10,Unknown,Unknown,Cheque,Unknown,TOTAL,Resolution,45348.0
Unknown,Unknown,"51,20",Unknown,Unknown,Cheque,Unknown,TOTAL,ACPR)en,50468.0
Unknown,Unknown,15,Unknown,Unknown,Cheque,Unknown,TOTAL,numero,50483.0
Unknown,Unknown,10,Unknown,Unknown,Cheque,Unknown,TOTAL,EGB,50493.0
Unknown,Unknown,"17,33",Unknown,Unknown,Cheque,Unknown,TOTAL,Unknown,52226.0
Unknown,Unknown,15,Unknown,Unknown,Cheque,Unknown,TOTAL,Unknown,52241.0
Unknown,Unknown,10,Unknown,Unknown,Cheque,Unknown,TOTAL,Unknown,52251.0
Unknown,Unknown,"39,45",Unknown,Unknown,Cheque,Unknown,TOTAL,Unknown,56196.0
Unknown,Unknown,15,Unknown,Unknown,Cheque,Unknown,TOTAL,Unknown,56211.0
Unknown,Unknown,10,Unknown,Unknown,Cheque,Unknown,TOTAL,Unknown,56221.0
Unknown,Unknown,"10,00",Unknown,Unknown,Cheque,Unknown,TOTAL,Unknown,57221.0
Unknown,Unknown,16,Unknown,Unknown,Cheque,Unknown,TOTAL,Unknown,57237.0
Unknown,Unknown,10,Unknown,Unknown,Cheque,Unknown,TOTAL,Unknown,57247.0
Unknown,Unknown,"26,28",Unknown,Unknown,Cheque,Unknown,TOTAL,Unknown,59875.0
Unknown,Unknown,18,Unknown,Unknown,Cheque,Unknown,TOTAL,Unknown,59893.0
Unknown,Unknown,10,Unknown,Unknown,Cheque,Unknown,TOTAL,Unknown,59903.0
Unknown,Unknown,"16,43",Unknown,Unknown,Cheque,Unknown,TOTAL,Unknown,61546.0
Unknown,Unknown,18,Unknown,Unknown,Cheque,Unknown,TOTAL,Unknown,61564.0
Unknown,Unknown,10,Unknown,Unknown,Cheque,Unknown,TOTAL,Unknown,61574.0
Unknown,Unknown,"16,84",Unknown,Unknown,Cheque,Unknown,TOTAL,Unknown,63258.0
Unknown,Unknown,19,Unknown,Unknown,Cheque,Unknown,TOTAL,Unknown,63277.0
Unknown,Unknown,10,Unknown,Unknown,Cheque,Unknown,TOTAL,Unknown,63287.0
Unknown,Unknown,"56,34",Unknown,Unknown,Cheque,Unknown,TOTAL,Unknown,68921.0
Unknown,Unknown,28,Unknown,Unknown,Cheque,Unknown,TOTAL,Unknown,68949.0
Unknown,Unknown,10,Unknown,Unknown,Cheque,Unknown,TOTAL,Unknown,68959.0
Unknown,Unknown,"1 320,00",Unknown,Unknown,Cheque,Unknown,TOTAL,Unknown,200959.0
Unknown,Unknown,28,Unknown,Unknown,Cheque,Unknown,TOTAL,Unknown,200987.0
Unknown,Unknown,10,Unknown,Unknown,Cheque,Unknown,TOTAL,Unknown,200997.0
Unknown,Unknown,"680,40",Unknown,Unknown,Cheque,Unknown,TOTAL,Unknown,269037.0
Unknown,Unknown,28,Unknown,Unknown,Cheque,Unknown,TOTAL,Unknown,269065.0
Unknown,Unknown,10,Unknown,Unknown,Cheque,Unknown,TOTAL,Unknown,269075.0
Unknown,Unknown,"2,40",Unknown,Unknown,Cheque,Unknown,TOTAL,Unknown,269315.0
Unknown,Unknown,28,Unknown,Unknown,Cheque,Unknown,TOTAL,Unknown,269343.0
Unknown,Unknown,10,Unknown,Unknown,Cheque,Unknown,TOTAL,Unknown,269353.0
Unknown,Unknown,"2,40",Unknown,Unknown,Cheque,Unknown,TOTAL,Unknown,269593.0
Unknown,Unknown,29,Unknown,Unknown,Cheque,Unknown,TOTAL,Unknown,269622.0
Unknown,Unknown,10,Unknown,Unknown,Cheque,Unknown,TOTAL,Unknown,269632.0
Unknown,Unknown,"616,64",Unknown,Unknown,Cheque,Unknown,TOTAL,Unknown,331296.0
Unknown,Unknown,30,Unknown,Unknown,Cheque,Unknown,TOTAL,Unknown,331326.0
Unknown,Unknown,10,Unknown,Unknown,Cheque,Unknown,TOTAL,Unknown,331336.0
Unknown,Unknown,"60,00",Unknown,Unknown,Cheque,Unknown,TOTAL,Unknown,337336.0
Unknown,Unknown,250 995 35,Unknown,Unknown,Cheque,Unknown,TOTAL,Unknown,25436871.0
Unknown,Unknown,20,Unknown,Unknown,Cheque,Unknown,TOTAL,Unknown,25436891.0
Unknown,Unknown,489 626,Unknown,Unknown,Cheque,Unknown,TOTAL,Unknown,25926517.0
Unknown,Unknown,01,Unknown,Unknown,Cheque,Unknown,TOTAL,Unknown,25926518.0
Unknown,Unknown,10,Unknown,Unknown,Cheque,Unknown,TOTAL,Unknown,25926528.0
Unknown,Unknown,31,Unknown,Unknown,Cheque,Unknown,TOTAL,Unknown,25926559.0
Unknown,Unknown,10,Unknown,Unknown,Cheque,Unknown,TOTAL,Unknown,25926569.0
Unknown,Unknown,205,Unknown,Unknown,Cheque,Unknown,TOTAL,Unknown,25926774.0
Unknown,Unknown,2,Unknown,Unknown,Cheque,Unknown,TOTAL,Unknown,25926776.0
Unknown,Unknown,2,Unknown,Unknown,Cheque,Unknown,TOTAL,Unknown,25926778.0
Unknown,Unknown,5,Unknown,Unknown,Debit,Unknown,Credit Solde,poooic 2oiC01j1,5.0
Unknown,Unknown,01 79,Unknown,Unknown,Debit,Unknown,Credit Solde,Coût dun appel local WWW,184.0
Unknown,Unknown,48 40,Unknown,Unknown,Debit,Unknown,Credit Solde,COULOMMIERS 5 COURS GAMBETTA 77120,5024.0
Unknown,Unknown,00,Unknown,Unknown,Debit,Unknown,Credit Solde,Marai Mercredi,5024.0
Unknown,Unknown,01 64,Unknown,Unknown,Debit,Unknown,Credit Solde,ARGJENDI,5188.0
Unknown,Unknown,75 67,Unknown,Unknown,Debit,Unknown,Credit Solde,RUE,12755.0
Unknown,Unknown,08,Unknown,Unknown,Debit,Unknown,Credit Solde,FLEMING Votro Interlocuteur,12763.0
Unknown,Unknown,31,Unknown,Unknown,Debit,Unknown,Credit Solde,EURO ComptE,12794.0
Unknown,Unknown,01,Unknown,Unknown,Debit,Unknown,Credit Solde,Depot,12795.0
Unknown,Unknown,19,Unknown,Unknown,Debit,Unknown,Credit Solde,PARTS SOCIALES,12814.0
Unknown,Unknown,2,Unknown,Unknown,Debit,Unknown,Credit Solde,Solde,12816.0
Unknown,Unknown,1,Unknown,Unknown,Debit,Unknown,Credit Solde,31/01/19 Solde,12817.0
Unknown,Unknown,2,Unknown,Unknown,Debit,Unknown,Credit Solde,"31/01/19 41224,61 +000 +00 +200,00",12819.0
Unknown,Unknown,001 15,Unknown,Unknown,Debit,Unknown,Credit Solde,Remises Cheques,12934.0
Unknown,Unknown,00 080,Unknown,Unknown,Debit,Unknown,Credit Solde,N1751590000,13014.0
Unknown,Unknown,8,Unknown,Unknown,Debit,Unknown,Credit Solde,EURO Date Valeur Detail,13022.0
Unknown,Unknown,87,Unknown,Unknown,Debit,Unknown,Credit Solde,ReT,13109.0
Unknown,Unknown,63,Unknown,Unknown,Debit,Unknown,Credit Solde,ViRement,13172.0
Unknown,Unknown,10,Unknown,Unknown,Debit,Unknown,Credit Solde,RB ViR,13182.0
Unknown,Unknown,70,Unknown,Unknown,Debit,Unknown,Credit Solde,DOS,13252.0
Unknown,Unknown,31,Unknown,Unknown,Debit,Unknown,Credit Solde,ReT,13283.0
Unknown,Unknown,01,Unknown,Unknown,Debit,Unknown,Credit Solde,ViRement InteRne,13284.0
Unknown,Unknown,19,Unknown,Unknown,Debit,Unknown,Credit Solde,ReTRAIT,13303.0
Unknown,Unknown,31,Unknown,Unknown,Debit,Unknown,Credit Solde,GASHI,13334.0
Unknown,Unknown,01,Unknown,Unknown,Debit,Unknown,Credit Solde,N 0114688 M,13335.0
Unknown,Unknown,19,Unknown,Unknown,Debit,Unknown,Credit Solde,CB CONFORAMA FACT 230119,13354.0
Unknown,Unknown,31,Unknown,Unknown,Debit,Unknown,Credit Solde,N 0114688 M,13385.0
Unknown,Unknown,01,Unknown,Unknown,Debit,Unknown,Credit Solde,ReMZI,13386.0
Unknown,Unknown,19,Unknown,Unknown,Debit,Unknown,Credit Solde,N.0114688 M,13405.0
Unknown,Unknown,31,Unknown,Unknown,Debit,Unknown,Credit Solde,EPyinee{d6 Prevopnce Ie-Ce,13436.0
Unknown,Unknown,01,Unknown,Unknown,Debit,Unknown,Credit Solde,PaRS,13437.0
Unknown,Unknown,19,Unknown,Unknown,Debit,Unknown,Credit Solde,Banqu,13456.0
Unknown,Unknown,61,Unknown,Unknown,Debit,Unknown,Credit Solde,Cooperuve,13517.0
Unknown,Unknown,000,Unknown,Unknown,Debit,Unknown,Credit Solde,Utnu CU Coce Honeure,13517.0
Unknown,Unknown,00,Unknown,Unknown,Debit,Unknown,Credit Solde,Drectoire €,13517.0
Unknown,Unknown,"200,00",Unknown,Unknown,Debit,Unknown,Credit Solde,Onenuuon,33517.0
Unknown,Unknown,"725,00",Unknown,Unknown,Debit,Unknown,Credit Solde,@e Survcillance Caprul Ge 2 J15,106017.0
Unknown,Unknown,"50,00",Unknown,Unknown,Debit,Unknown,Credit Solde,Evros,111017.0
Unknown,Unknown,"445,39",Unknown,Unknown,Debit,Unknown,Credit Solde,Pons,155556.0
Unknown,Unknown,50,Unknown,Unknown,Debit,Unknown,Credit Solde,numero 07 0OS 200,155606.0
Unknown,Unknown,"1 500,39",Unknown,Unknown,Debit,Unknown,Credit Solde,Unknown,305645.0
Unknown,Unknown,2 725 00,Unknown,Unknown,Debit,Unknown,Credit Solde,Unknown,578145.0
Unknown,Unknown,87,Unknown,Unknown,Debit,Unknown,Credit Solde,Unknown,578232.0
Unknown,Unknown,9,Unknown,Unknown,Debit,Unknown,Credit Solde,Unknown,578241.0
Unknown,Unknown,"0,00",Unknown,Unknown,Debit,Unknown,Credit Solde,Unknown,578241.0
Unknown,Unknown,05,Unknown,Unknown,Debit,Unknown,Credit Solde,Unknown,578246.0
Unknown,Unknown,01 05,Unknown,Unknown,Debit,Unknown,Credit Solde,Unknown,578351.0
Unknown,Unknown,01,Unknown,Unknown,Debit,Unknown,Credit Solde,Unknown,578352.0
Unknown,Unknown,69 05,Unknown,Unknown,Debit,Unknown,Credit Solde,Unknown,585257.0
Unknown,Unknown,01 05,Unknown,Unknown,Debit,Unknown,Credit Solde,Unknown,585362.0
Unknown,Unknown,01,Unknown,Unknown,Debit,Unknown,Credit Solde,Unknown,585363.0
Unknown,Unknown,63,Unknown,Unknown,Debit,Unknown,Credit Solde,Unknown,585426.0
Unknown,Unknown,"2 000,00",Unknown,Unknown,Debit,Unknown,Credit Solde,Unknown,785426.0
Unknown,Unknown,"200,00",Unknown,Unknown,Debit,Unknown,Credit Solde,Unknown,805426.0
Unknown,Unknown,07,Unknown,Unknown,Debit,Unknown,Credit Solde,Unknown,805433.0
Unknown,Unknown,01 07,Unknown,Unknown,Debit,Unknown,Credit Solde,Unknown,805540.0
Unknown,Unknown,01,Unknown,Unknown,Debit,Unknown,Credit Solde,Unknown,805541.0
Unknown,Unknown,15,Unknown,Unknown,Debit,Unknown,Credit Solde,Unknown,805556.0
Unknown,Unknown,01 14,Unknown,Unknown,Debit,Unknown,Credit Solde,Unknown,805670.0
Unknown,Unknown,01,Unknown,Unknown,Debit,Unknown,Credit Solde,Unknown,805671.0
Unknown,Unknown,15,Unknown,Unknown,Debit,Unknown,Credit Solde,Unknown,805686.0
Unknown,Unknown,01 15,Unknown,Unknown,Debit,Unknown,Credit Solde,Unknown,805801.0
Unknown,Unknown,01,Unknown,Unknown,Debit,Unknown,Credit Solde,Unknown,805802.0
Unknown,Unknown,63 22,Unknown,Unknown,Debit,Unknown,Credit Solde,Unknown,812124.0
Unknown,Unknown,01 22,Unknown,Unknown,Debit,Unknown,Credit Solde,Unknown,812246.0
Unknown,Unknown,01,Unknown,Unknown,Debit,Unknown,Credit Solde,Unknown,812247.0
Unknown,Unknown,23,Unknown,Unknown,Debit,Unknown,Credit Solde,Unknown,812270.0
Unknown,Unknown,01 23,Unknown,Unknown,Debit,Unknown,Credit Solde,Unknown,812393.0
Unknown,Unknown,01,Unknown,Unknown,Debit,Unknown,Credit Solde,Unknown,812394.0
Unknown,Unknown,24,Unknown,Unknown,Debit,Unknown,Credit Solde,Unknown,812418.0
Unknown,Unknown,01 24,Unknown,Unknown,Debit,Unknown,Credit Solde,Unknown,812542.0
Unknown,Unknown,01,Unknown,Unknown,Debit,Unknown,Credit Solde,Unknown,812543.0
Unknown,Unknown,28,Unknown,Unknown,Debit,Unknown,Credit Solde,Unknown,812571.0
Unknown,Unknown,01 28,Unknown,Unknown,Debit,Unknown,Credit Solde,Unknown,812699.0
Unknown,Unknown,01,Unknown,Unknown,Debit,Unknown,Credit Solde,Unknown,812700.0
Unknown,Unknown,28,Unknown,Unknown,Debit,Unknown,Credit Solde,Unknown,812728.0
Unknown,Unknown,01 28,Unknown,Unknown,Debit,Unknown,Credit Solde,Unknown,812856.0
Unknown,Unknown,01,Unknown,Unknown,Debit,Unknown,Credit Solde,Unknown,812857.0
Unknown,Unknown,"5,00",Unknown,Unknown,Debit,Unknown,Credit Solde,Unknown,813357.0
Unknown,Unknown,"200,00",Unknown,Unknown,Debit,Unknown,Credit Solde,Unknown,833357.0
Unknown,Unknown,"600,00",Unknown,Unknown,Debit,Unknown,Credit Solde,Unknown,893357.0
Unknown,Unknown,"50,00",Unknown,Unknown,Debit,Unknown,Credit Solde,Unknown,898357.0
Unknown,Unknown,"52,00",Unknown,Unknown,Debit,Unknown,Credit Solde,Unknown,903557.0
Unknown,Unknown,"249,99",Unknown,Unknown,Debit,Unknown,Credit Solde,Unknown,928556.0
Unknown,Unknown,"60,00",Unknown,Unknown,Debit,Unknown,Credit Solde,Unknown,934556.0
Unknown,Unknown,1 71,Unknown,Unknown,Debit,Unknown,Credit Solde,Unknown,934727.0
Unknown,Unknown,00,Unknown,Unknown,Debit,Unknown,Credit Solde,Unknown,934727.0
Unknown,Unknown,1,Unknown,Unknown,Debit,Unknown,Credit Solde,Unknown,934728.0
Unknown,Unknown,3,Unknown,Unknown,Debit,Unknown,Credit Solde,Unknown,934731.0
Unknown,Unknown,16,Unknown,Unknown,Debit,Unknown,Credit Solde,Unknown,934747.0
Unknown,Unknown,512,Unknown,Unknown,Debit,Unknown,Credit Solde,Unknown,935259.0
Unknown,Unknown,85,Unknown,Unknown,Debit,Unknown,Credit Solde,Unknown,935344.0
Unknown,Unknown,2,Unknown,Unknown,Debit,Unknown,Credit Solde,Unknown,935346.0
Unknown,Unknown,000 000,Unknown,Unknown,Debit,Unknown,Credit Solde,Unknown,935346.0
Unknown,Unknown,182 900 942,Unknown,Unknown,Debit,Unknown,Credit Solde,Unknown,183836288.0
Unknown,Unknown,07,Unknown,Unknown,Debit,Unknown,Credit Solde,Unknown,183836295.0
Unknown,Unknown,200,Unknown,Unknown,Debit,Unknown,Credit Solde,Unknown,183836495.0
13/10/2020,Unknown,1,Unknown,Unknown,Debit,Unknown,PRLV,Gi PhoooiC,1.0
21/10/2020,Unknown,31,Unknown,Unknown,Debit,Unknown,PRLV,W20s2e8,32.0
Unknown,Unknown,10,Unknown,Unknown,Debit,Unknown,PRLV,COURANT N,42.0
Unknown,Unknown,20,Unknown,Unknown,Debit,Unknown,PRLV,Date Valeur Detail,62.0
Unknown,Unknown,23,Unknown,Unknown,Debit,Unknown,PRLV,ADBPNCOULOMMIER FACT 061020,85.0
Unknown,Unknown,2,Unknown,Unknown,Debit,Unknown,PRLV,ReMZI,87.0
Unknown,Unknown,3,Unknown,Unknown,Debit,Unknown,PRLV,ConVERGENCE DONT,90.0
Unknown,Unknown,87,Unknown,Unknown,Debit,Unknown,PRLV,EUR,177.0
Unknown,Unknown,07,Unknown,Unknown,Debit,Unknown,PRLV,Ret,184.0
Unknown,Unknown,10 07,Unknown,Unknown,Debit,Unknown,PRLV,RemZI,1191.0
Unknown,Unknown,10,Unknown,Unknown,Debit,Unknown,PRLV,RemZI,1201.0
Unknown,Unknown,07,Unknown,Unknown,Debit,Unknown,PRLV,CB TOTAL,1208.0
Unknown,Unknown,10 07,Unknown,Unknown,Debit,Unknown,PRLV,RemZI,2215.0
Unknown,Unknown,10,Unknown,Unknown,Debit,Unknown,PRLV,ReMISE,2225.0
Unknown,Unknown,08,Unknown,Unknown,Debit,Unknown,PRLV,Remis LE 13/10/2020,2233.0
Unknown,Unknown,10 08,Unknown,Unknown,Debit,Unknown,PRLV,PRLV ALLIANZ ARO ALLIANZ | A,3241.0
Unknown,Unknown,10,Unknown,Unknown,Debit,Unknown,PRLV,NMa,3251.0
Unknown,Unknown,"0,64",Unknown,Unknown,Debit,Unknown,PRLV,FR20ZZZ1075 14,3315.0
Unknown,Unknown,09,Unknown,Unknown,Debit,Unknown,PRLV,Tenue DossieR AdMinistratif,3324.0
Unknown,Unknown,10 09,Unknown,Unknown,Debit,Unknown,PRLV,CB SC,4333.0
Unknown,Unknown,10,Unknown,Unknown,Debit,Unknown,PRLV,ReMZI,4343.0
Unknown,Unknown,09,Unknown,Unknown,Debit,Unknown,PRLV,ReMISE,4352.0
Unknown,Unknown,10 09,Unknown,Unknown,Debit,Unknown,PRLV,ChEquES N,5361.0
Unknown,Unknown,10,Unknown,Unknown,Debit,Unknown,PRLV,ReMIS LE,5371.0
Unknown,Unknown,12,Unknown,Unknown,Debit,Unknown,PRLV,Cecocument,5383.0
Unknown,Unknown,10 12,Unknown,Unknown,Debit,Unknown,PRLV,chequler Ou,6395.0
Unknown,Unknown,10,Unknown,Unknown,Debit,Unknown,PRLV,Dancaire YoU,6405.0
Unknown,Unknown,12,Unknown,Unknown,Debit,Unknown,PRLV,Jerier You€,6417.0
Unknown,Unknown,10 12,Unknown,Unknown,Debit,Unknown,PRLV,Jknce PoU,7429.0
Unknown,Unknown,10,Unknown,Unknown,Debit,Unknown,PRLV,OfIC JU,7439.0
Unknown,Unknown,12,Unknown,Unknown,Debit,Unknown,PRLV,appei Cjne,7451.0
Unknown,Unknown,10 12,Unknown,Unknown,Debit,Unknown,PRLV,PJf,8463.0
Unknown,Unknown,10,Unknown,Unknown,Debit,Unknown,PRLV,Qu H YoUs Ctc},8473.0
Unknown,Unknown,13,Unknown,Unknown,Debit,Unknown,PRLV,YolYous,8486.0
Unknown,Unknown,10 13,Unknown,Unknown,Debit,Unknown,PRLV,rendarmene OU,9499.0
Unknown,Unknown,10,Unknown,Unknown,Debit,Unknown,PRLV,Ie Plus,9509.0
Unknown,Unknown,13,Unknown,Unknown,Debit,Unknown,PRLV,Cereleve ser,9522.0
Unknown,Unknown,10 14,Unknown,Unknown,Debit,Unknown,PRLV,ehnuvemen spprouve Yous,10536.0
Unknown,Unknown,10,Unknown,Unknown,Debit,Unknown,PRLV,Jucune,10546.0
Unknown,Unknown,13,Unknown,Unknown,Debit,Unknown,PRLV,Afuint Canf Voj€,10559.0
Unknown,Unknown,10,Unknown,Unknown,Debit,Unknown,PRLV,CtVo},10569.0
Unknown,Unknown,14,Unknown,Unknown,Debit,Unknown,PRLV,Onuju,10583.0
Unknown,Unknown,10 14,Unknown,Unknown,Debit,Unknown,PRLV,Ou rrchamjuon rcljuve,11597.0
Unknown,Unknown,10,Unknown,Unknown,Debit,Unknown,PRLV,JUX Pfocuu Ct IeMce} Dancaire,11607.0
Unknown,Unknown,15,Unknown,Unknown,Debit,Unknown,PRLV,Ouscnu Cft,11622.0
Unknown,Unknown,10 15,Unknown,Unknown,Debit,Unknown,PRLV,JUofes,12637.0
Unknown,Unknown,10,Unknown,Unknown,Debit,Unknown,PRLV,YoU€,12647.0
Unknown,Unknown,14,Unknown,Unknown,Debit,Unknown,PRLV,Unknown,12661.0
Unknown,Unknown,15,Unknown,Unknown,Debit,Unknown,PRLV,Unknown,12676.0
Unknown,Unknown,10 15,Unknown,Unknown,Debit,Unknown,PRLV,Unknown,13691.0
Unknown,Unknown,10,Unknown,Unknown,Debit,Unknown,PRLV,Unknown,13701.0
Unknown,Unknown,"400,00",Unknown,Unknown,Debit,Unknown,PRLV,Unknown,53701.0
Unknown,Unknown,"103,00",Unknown,Unknown,Debit,Unknown,PRLV,Unknown,64001.0
Unknown,Unknown,"29,64",Unknown,Unknown,Debit,Unknown,PRLV,Unknown,66965.0
Unknown,Unknown,"24,90",Unknown,Unknown,Debit,Unknown,PRLV,Unknown,69455.0
Unknown,Unknown,"46,00",Unknown,Unknown,Debit,Unknown,PRLV,Unknown,74055.0
Unknown,Unknown,"80,90",Unknown,Unknown,Debit,Unknown,PRLV,Unknown,82145.0
Unknown,Unknown,"34,41",Unknown,Unknown,Debit,Unknown,PRLV,Unknown,85586.0
Unknown,Unknown,"66,00",Unknown,Unknown,Debit,Unknown,PRLV,Unknown,92186.0
Unknown,Unknown,"14,60",Unknown,Unknown,Debit,Unknown,PRLV,Unknown,93646.0
Unknown,Unknown,"065,00",Unknown,Unknown,Debit,Unknown,PRLV,Unknown,100146.0
Unknown,Unknown,"54,00",Unknown,Unknown,Debit,Unknown,PRLV,Unknown,105546.0
Unknown,Unknown,"147,95",Unknown,Unknown,Debit,Unknown,PRLV,Unknown,120341.0
Unknown,Unknown,269 22,Unknown,Unknown,Debit,Unknown,PRLV,Unknown,147263.0
Unknown,Unknown,15,Unknown,Unknown,Debit,Unknown,PRLV,Unknown,147278.0
Unknown,Unknown,10 15,Unknown,Unknown,Debit,Unknown,PRLV,Unknown,148293.0
Unknown,Unknown,10,Unknown,Unknown,Debit,Unknown,PRLV,Unknown,148303.0
Unknown,Unknown,16,Unknown,Unknown,Debit,Unknown,PRLV,Unknown,148319.0
Unknown,Unknown,10 16,Unknown,Unknown,Debit,Unknown,PRLV,Unknown,149335.0
Unknown,Unknown,10,Unknown,Unknown,Debit,Unknown,PRLV,Unknown,149345.0
Unknown,Unknown,19,Unknown,Unknown,Debit,Unknown,PRLV,Unknown,149364.0
Unknown,Unknown,10 19,Unknown,Unknown,Debit,Unknown,PRLV,Unknown,150383.0
Unknown,Unknown,10,Unknown,Unknown,Debit,Unknown,PRLV,Unknown,150393.0
Unknown,Unknown,19,Unknown,Unknown,Debit,Unknown,PRLV,Unknown,150412.0
Unknown,Unknown,10 19,Unknown,Unknown,Debit,Unknown,PRLV,Unknown,151431.0
Unknown,Unknown,10,Unknown,Unknown,Debit,Unknown,PRLV,Unknown,151441.0
Unknown,Unknown,20,Unknown,Unknown,Debit,Unknown,PRLV,Unknown,151461.0
Unknown,Unknown,10 20,Unknown,Unknown,Debit,Unknown,PRLV,Unknown,152481.0
Unknown,Unknown,10,Unknown,Unknown,Debit,Unknown,PRLV,Unknown,152491.0
Unknown,Unknown,21,Unknown,Unknown,Debit,Unknown,PRLV,Unknown,152512.0
Unknown,Unknown,10 22,Unknown,Unknown,Debit,Unknown,PRLV,Unknown,153534.0
Unknown,Unknown,10,Unknown,Unknown,Debit,Unknown,PRLV,Unknown,153544.0
Unknown,Unknown,21,Unknown,Unknown,Debit,Unknown,PRLV,Unknown,153565.0
Unknown,Unknown,10,Unknown,Unknown,Debit,Unknown,PRLV,Unknown,153575.0
Unknown,Unknown,"80,00",Unknown,Unknown,Debit,Unknown,PRLV,Unknown,161575.0
Unknown,Unknown,"90,00",Unknown,Unknown,Debit,Unknown,PRLV,Unknown,170575.0
Unknown,Unknown,"37,50",Unknown,Unknown,Debit,Unknown,PRLV,Unknown,174325.0
Unknown,Unknown,"35,00",Unknown,Unknown,Debit,Unknown,PRLV,Unknown,177825.0
Unknown,Unknown,"8,00",Unknown,Unknown,Debit,Unknown,PRLV,Unknown,178625.0
Unknown,Unknown,"966,00",Unknown,Unknown,Debit,Unknown,PRLV,Unknown,275225.0
Unknown,Unknown,08,Unknown,Unknown,Debit,Unknown,PRLV,Unknown,275233.0
Unknown,Unknown,8,Unknown,Unknown,Debit,Unknown,PRLV,Unknown,275241.0
Unknown,Unknown,8,Unknown,Unknown,Debit,Unknown,PRLV,Unknown,275249.0
Unknown,Unknown,4,Unknown,Unknown,Debit,Unknown,PRLV,Unknown,275253.0
Unknown,Unknown,88,Unknown,Unknown,Debit,Unknown,PRLV,Unknown,275341.0
Unknown,Unknown,6,Unknown,Unknown,Debit,Unknown,PRLV,Unknown,275347.0
Unknown,Unknown,8,Unknown,Unknown,Debit,Unknown,PRLV,Unknown,275355.0
Unknown,Unknown,9,Unknown,Unknown,Debit,Unknown,PRLV,Unknown,275364.0
Unknown,Unknown,09 68,Unknown,Unknown,Debit,Unknown,PRLV,Unknown,276332.0
Unknown,Unknown,6 45,Unknown,Unknown,Debit,Unknown,PRLV,Unknown,276977.0
Unknown,Unknown,45,Unknown,Unknown,Debit,Unknown,PRLV,Unknown,277022.0
Unknown,Unknown,"0,15",Unknown,Unknown,Debit,Unknown,PRLV,Unknown,277037.0
Unknown,Unknown,3,Unknown,Unknown,Debit,Unknown,PRLV,Unknown,277040.0
Unknown,Unknown,1,Unknown,Unknown,Debit,Unknown,PRLV,Unknown,277041.0
Unknown,Unknown,1,Unknown,Unknown,Debit,Unknown,PRLV,Unknown,277042.0
31/10/2019,Unknown,31,Unknown,Unknown,Debit,Unknown,Credit,Gi PhoooiC,31.0
Unknown,Unknown,10,Unknown,Unknown,Debit,Unknown,Credit,W204)as 01j18604,41.0
Unknown,Unknown,19,Unknown,Unknown,Debit,Unknown,Credit,Mensuel N*1 Page 4 / ARgJEnDi,60.0
Unknown,Unknown,1,Unknown,Unknown,Debit,Unknown,Credit,Sunte,61.0
Unknown,Unknown,4,Unknown,Unknown,Debit,Unknown,Credit,CB RELAIS,65.0
Unknown,Unknown,87,Unknown,Unknown,Debit,Unknown,Credit,N 0114688 M,152.0
Unknown,Unknown,30,Unknown,Unknown,Debit,Unknown,Credit,SolDE AU,182.0
Unknown,Unknown,10 30,Unknown,Unknown,Debit,Unknown,Credit,N,1212.0
Unknown,Unknown,10,Unknown,Unknown,Debit,Unknown,Credit,Datalis,1222.0
Unknown,Unknown,"65,00",Unknown,Unknown,Debit,Unknown,Credit,dale dedition Qu,7722.0
Unknown,Unknown,31,Unknown,Unknown,Debit,Unknown,Credit,EUR,7753.0
Unknown,Unknown,"411 895,71",Unknown,Unknown,Debit,Unknown,Credit,tanfe,41197324.0
Unknown,Unknown,"813,49",Unknown,Unknown,Debit,Unknown,Credit,Ou defautselon celles higurant,41278673.0
Unknown,Unknown,87,Unknown,Unknown,Debit,Unknown,Credit,Conditions et Tants de la Caisse depargne,41278760.0
Unknown,Unknown,00,Unknown,Unknown,Debit,Unknown,Credit,Taux dinterets debiteurs,41278760.0
Unknown,Unknown,87,Unknown,Unknown,Debit,Unknown,Credit,TAUX DE BASE,41278847.0
Unknown,Unknown,31,Unknown,Unknown,Debit,Unknown,Credit,Ihypothese,41278878.0
Unknown,Unknown,10,Unknown,Unknown,Debit,Unknown,Credit,zero,41278888.0
Unknown,Unknown,6,Unknown,Unknown,Debit,Unknown,Credit,FRPp,41278894.0
Unknown,Unknown,4,Unknown,Unknown,Debit,Unknown,Credit,IBAN FR76,41278898.0
Unknown,Unknown,"0,150",Unknown,Unknown,Debit,Unknown,Credit,IBAN FR76,41279048.0
Unknown,Unknown,8,Unknown,Unknown,Debit,Unknown,Credit,Information,41279056.0
Unknown,Unknown,"1,000",Unknown,Unknown,Debit,Unknown,Credit,Vos depots,41280056.0
Unknown,Unknown,"0,150",Unknown,Unknown,Debit,Unknown,Credit,ala garantie,41280206.0
Unknown,Unknown,1,Unknown,Unknown,Debit,Unknown,Credit,Resolution,41280207.0
Unknown,Unknown,"2,000",Unknown,Unknown,Debit,Unknown,Credit,FGDR,41282207.0
Unknown,Unknown,2,Unknown,Unknown,Debit,Unknown,Credit,etablissementou,41282209.0
Unknown,Unknown,"2,000",Unknown,Unknown,Debit,Unknown,Credit,Concernant le Livret A Association,41284209.0
Unknown,Unknown,3,Unknown,Unknown,Debit,Unknown,Credit,Livret A HLM,41284212.0
Unknown,Unknown,"2,000",Unknown,Unknown,Debit,Unknown,Credit,TEtat,41286212.0
Unknown,Unknown,751,Unknown,Unknown,Debit,Unknown,Credit,Unknown,41286963.0
Unknown,Unknown,987,Unknown,Unknown,Debit,Unknown,Credit,Unknown,41287950.0
Unknown,Unknown,751,Unknown,Unknown,Debit,Unknown,Credit,Unknown,41288701.0
Unknown,Unknown,163,Unknown,Unknown,Debit,Unknown,Credit,Unknown,41288864.0
29/10/2020,Unknown,31,Unknown,Unknown,Debit,Unknown,Mensuel,Gi PuoooiC,31.0
Unknown,Unknown,10,Unknown,Unknown,Debit,Unknown,Mensuel,D'EPARGNE ILE DE FRANCE,41.0
Unknown,Unknown,20,Unknown,Unknown,Debit,Unknown,Mensuel,COURANT N,61.0
Unknown,Unknown,23,Unknown,Unknown,Debit,Unknown,Mensuel,Date Valeur Detail,84.0
Unknown,Unknown,3,Unknown,Unknown,Debit,Unknown,Mensuel,FACT 191020 N 0204603,87.0
Unknown,Unknown,3,Unknown,Unknown,Debit,Unknown,Mensuel,ReMZI,90.0
Unknown,Unknown,87,Unknown,Unknown,Debit,Unknown,Mensuel,TOTAL FACT 211020,177.0
Unknown,Unknown,21,Unknown,Unknown,Debit,Unknown,Mensuel,Sanel,198.0
Unknown,Unknown,10 21,Unknown,Unknown,Debit,Unknown,Mensuel,REMIS LE 29/10/2020,1219.0
Unknown,Unknown,10,Unknown,Unknown,Debit,Unknown,Mensuel,AU,1229.0
Unknown,Unknown,21,Unknown,Unknown,Debit,Unknown,Mensuel,"Irancs +14,302,29",1250.0
Unknown,Unknown,10 21,Unknown,Unknown,Debit,Unknown,Mensuel,FRPP,2271.0
Unknown,Unknown,10,Unknown,Unknown,Debit,Unknown,Mensuel,IBAN FR76,2281.0
Unknown,Unknown,22,Unknown,Unknown,Debit,Unknown,Mensuel,IBAN FR76,2303.0
Unknown,Unknown,10 22,Unknown,Unknown,Debit,Unknown,Mensuel,Information,3325.0
Unknown,Unknown,10,Unknown,Unknown,Debit,Unknown,Mensuel,Vos depots,3335.0
Unknown,Unknown,22,Unknown,Unknown,Debit,Unknown,Mensuel,Resolution,3357.0
Unknown,Unknown,10 22,Unknown,Unknown,Debit,Unknown,Mensuel,Roportez-vous &,4379.0
Unknown,Unknown,10,Unknown,Unknown,Debit,Unknown,Mensuel,FGDR,4389.0
Unknown,Unknown,26,Unknown,Unknown,Debit,Unknown,Mensuel,Livret A HLM,4415.0
Unknown,Unknown,10 26,Unknown,Unknown,Debit,Unknown,Mensuel,Cusse,5441.0
Unknown,Unknown,10,Unknown,Unknown,Debit,Unknown,Mensuel,Arcvoynce,5451.0
Unknown,Unknown,28,Unknown,Unknown,Debit,Unknown,Mensuel,Tolbiac CS,5479.0
Unknown,Unknown,10 28,Unknown,Unknown,Debit,Unknown,Mensuel,Banquc Cooperuve reoe,6507.0
Unknown,Unknown,10,Unknown,Unknown,Debit,Unknown,Mensuel,lcs arucles,6517.0
Unknown,Unknown,28,Unknown,Unknown,Debit,Unknown,Mensuel,t 'Uants,6545.0
Unknown,Unknown,10 28,Unknown,Unknown,Debit,Unknown,Mensuel,Code Honeuire,7573.0
Unknown,Unknown,10,Unknown,Unknown,Debit,Unknown,Mensuel,t hinngier Socete,7583.0
Unknown,Unknown,29,Unknown,Unknown,Debit,Unknown,Mensuel,Conscil d Onentuon,7612.0
Unknown,Unknown,10 30,Unknown,Unknown,Debit,Unknown,Mensuel,Surveillance Capial,8642.0
Unknown,Unknown,10,Unknown,Unknown,Debit,Unknown,Mensuel,RCS Pons,8652.0
Unknown,Unknown,29,Unknown,Unknown,Debit,Unknown,Mensuel,Pons,8681.0
Unknown,Unknown,10,Unknown,Unknown,Debit,Unknown,Mensuel,Casuaane,8691.0
Unknown,Unknown,"3,50",Unknown,Unknown,Debit,Unknown,Mensuel,numcro 07 0OS 200,9041.0
Unknown,Unknown,"152,65",Unknown,Unknown,Debit,Unknown,Mensuel,Unknown,24306.0
Unknown,Unknown,"60,00",Unknown,Unknown,Debit,Unknown,Mensuel,Unknown,30306.0
Unknown,Unknown,"4,80",Unknown,Unknown,Debit,Unknown,Mensuel,Unknown,30786.0
Unknown,Unknown,"90,33",Unknown,Unknown,Debit,Unknown,Mensuel,Unknown,39819.0
Unknown,Unknown,"3,50",Unknown,Unknown,Debit,Unknown,Mensuel,Unknown,40169.0
Unknown,Unknown,"50,00",Unknown,Unknown,Debit,Unknown,Mensuel,Unknown,45169.0
Unknown,Unknown,"005,00",Unknown,Unknown,Debit,Unknown,Mensuel,Unknown,45669.0
Unknown,Unknown,31,Unknown,Unknown,Debit,Unknown,Mensuel,Unknown,45700.0
Unknown,Unknown,"14,302,29",Unknown,Unknown,Debit,Unknown,Mensuel,Unknown,1475929.0
Unknown,Unknown,"2 180,37",Unknown,Unknown,Debit,Unknown,Mensuel,Unknown,1693966.0
Unknown,Unknown,751,Unknown,Unknown,Debit,Unknown,Mensuel,Unknown,1694717.0
Unknown,Unknown,987,Unknown,Unknown,Debit,Unknown,Mensuel,Unknown,1695704.0
Unknown,Unknown,751,Unknown,Unknown,Debit,Unknown,Mensuel,Unknown,1696455.0
Unknown,Unknown,163,Unknown,Unknown,Debit,Unknown,Mensuel,Unknown,1696618.0
Unknown,Unknown,1,Unknown,Unknown,Debit,Unknown,Mensuel,Unknown,1696619.0
Unknown,Unknown,5,Unknown,Unknown,Debit,Unknown,Mensuel,Unknown,1696624.0
Unknown,Unknown,26,Unknown,Unknown,Debit,Unknown,Mensuel,Unknown,1696650.0
Unknown,Unknown,28,Unknown,Unknown,Debit,Unknown,Mensuel,Unknown,1696678.0
Unknown,Unknown,512,Unknown,Unknown,Debit,Unknown,Mensuel,Unknown,1697190.0
Unknown,Unknown,85,Unknown,Unknown,Debit,Unknown,Mensuel,Unknown,1697275.0
Unknown,Unknown,3,Unknown,Unknown,Debit,Unknown,Mensuel,Unknown,1697278.0
Unknown,Unknown,2,Unknown,Unknown,Debit,Unknown,Mensuel,Unknown,1697280.0
Unknown,Unknown,75,Unknown,Unknown,Debit,Unknown,Mensuel,Unknown,1697355.0
Unknown,Unknown,900 942,Unknown,Unknown,Debit,Unknown,Mensuel,Unknown,2598297.0
Unknown,Unknown,07,Unknown,Unknown,Debit,Unknown,Mensuel,Unknown,2598304.0
Unknown,Unknown,200,Unknown,Unknown,Debit,Unknown,Mensuel,Unknown,2598504.0
Unknown,Unknown,1,Unknown,Unknown,Debit,Unknown,Mensuel,Unknown,2598505.0
01/08/2020,92,Unknown,92,Unknown,Unknown,Unknown,NAIS BEAUTE 15,SOCIETE GENERALE RELEVÉ DE COMPTE,-92.0
31/08/2020,01,Unknown,01,Unknown,Unknown,Unknown,NAIS BEAUTE 15,Page 1/5 VOS CONTACTS Votre Banque,-93.0
31/07/2020,08,Unknown,08,Unknown,Unknown,Unknown,NAIS BEAUTE 15,RUE DE VERDUN,-101.0
03/08/2020,31,Unknown,31,Unknown,Unknown,Unknown,NAIS BEAUTE 15,Email Isabelle,-132.0
03/08/2020,08,Unknown,08,Unknown,Unknown,Unknown,NAIS BEAUTE 15,NE VaUT PaS FaCTURE P61,-140.0
03/08/2020,8,Unknown,8,Unknown,Unknown,Unknown,NAIS BEAUTE 15,opération SOLDE,-148.0
03/08/2020,1,Unknown,1,Unknown,Unknown,Unknown,NAIS BEAUTE 15,OOE COM,-149.0
03/08/2020,5,Unknown,5,Unknown,Unknown,Unknown,NAIS BEAUTE 15,R06821 CT3883641801,-154.0
03/08/2020,0,Unknown,0,Unknown,Unknown,Unknown,NAIS BEAUTE 15,COM,-154.0
03/08/2020,15,Unknown,15,Unknown,Unknown,Unknown,NAIS BEAUTE 15,CT3883641001 BT,-169.0
03/08/2020,01 45,Unknown,01 45,Unknown,Unknown,Unknown,NAIS BEAUTE 15,COM,-314.0
03/08/2020,10 10,Unknown,10 10,Unknown,Unknown,Unknown,NAIS BEAUTE 15,COM,-1324.0
03/08/2020,10,Unknown,10,Unknown,Unknown,Unknown,NAIS BEAUTE 15,C13883641001 BT 127,-1334.0
03/08/2020,01 43,Unknown,01 43,Unknown,Unknown,Unknown,NAIS BEAUTE 15,OOE COM,-1477.0
03/08/2020,89 87,Unknown,89 87,Unknown,Unknown,Unknown,NAIS BEAUTE 15,EMIS NET,-10464.0
03/08/2020,62,Unknown,62,Unknown,Unknown,Unknown,NAIS BEAUTE 15,POURSamihana bhatta,-10526.0
03/08/2020,31,Unknown,31,Unknown,Unknown,Unknown,NAIS BEAUTE 15,Salary MOTIF,-10557.0
03/08/2020,07,Unknown,07,Unknown,Unknown,Unknown,NAIS BEAUTE 15,Salary CHEZ,-10564.0
03/08/2020,03,Unknown,03,Unknown,Unknown,Unknown,NAIS BEAUTE 15,REMISE,-10567.0
03/08/2020,08,Unknown,08,Unknown,Unknown,Unknown,NAIS BEAUTE 15,Salaire MOTIF: Salaire CHEZ SOGEFRPP,-10575.0
03/08/2020,03,Unknown,03,Unknown,Unknown,Unknown,NAIS BEAUTE 15,LIB,-10578.0
01/10/2015,08,Unknown,08,Unknown,Unknown,Unknown,NAIS BEAUTE 15,Insatisfaction,-10586.0
Unknown,01,Unknown,01,Unknown,Unknown,Unknown,NAIS BEAUTE 15,dosaccord,-10587.0
Unknown,08,Unknown,08,Unknown,Unknown,Unknown,NAIS BEAUTE 15,VOus pouvoz contactor Lagonco,-10595.0
Unknown,60,Unknown,60,Unknown,Unknown,Unknown,NAIS BEAUTE 15,Paris,-10655.0
Unknown,0,Unknown,0,Unknown,Unknown,Unknown,NAIS BEAUTE 15,Mediatour,-10655.0
Unknown,03,Unknown,03,Unknown,Unknown,Unknown,NAIS BEAUTE 15,Charte de la Mediation Societe Generale,-10658.0
Unknown,08,Unknown,08,Unknown,Unknown,Unknown,NAIS BEAUTE 15,Tadresse,-10666.0
Unknown,03,Unknown,03,Unknown,Unknown,Unknown,NAIS BEAUTE 15,Le Mediateur aupres,-10669.0
Unknown,08,Unknown,08,Unknown,Unknown,Unknown,NAIS BEAUTE 15,Valmy 92987,-10677.0
Unknown,02,Unknown,02,Unknown,Unknown,Unknown,NAIS BEAUTE 15,OU,-10679.0
Unknown,08,Unknown,08,Unknown,Unknown,Unknown,NAIS BEAUTE 15,recepton,-10687.0
Unknown,252,Unknown,252,Unknown,Unknown,Unknown,NAIS BEAUTE 15,Soacie Gcncae,-10939.0
Unknown,2,Unknown,2,Unknown,Unknown,Unknown,NAIS BEAUTE 15,Pans 1,-10941.0
Unknown,03,Unknown,03,Unknown,Unknown,Unknown,NAIS BEAUTE 15,Unknown,-10944.0
Unknown,08,Unknown,08,Unknown,Unknown,Unknown,NAIS BEAUTE 15,Unknown,-10952.0
Unknown,03,Unknown,03,Unknown,Unknown,Unknown,NAIS BEAUTE 15,Unknown,-10955.0
Unknown,08,Unknown,08,Unknown,Unknown,Unknown,NAIS BEAUTE 15,Unknown,-10963.0
Unknown,02,Unknown,02,Unknown,Unknown,Unknown,NAIS BEAUTE 15,Unknown,-10965.0
Unknown,08,Unknown,08,Unknown,Unknown,Unknown,NAIS BEAUTE 15,Unknown,-10973.0
Unknown,239,Unknown,239,Unknown,Unknown,Unknown,NAIS BEAUTE 15,Unknown,-11212.0
Unknown,2,Unknown,2,Unknown,Unknown,Unknown,NAIS BEAUTE 15,Unknown,-11214.0
Unknown,03,Unknown,03,Unknown,Unknown,Unknown,NAIS BEAUTE 15,Unknown,-11217.0
Unknown,08,Unknown,08,Unknown,Unknown,Unknown,NAIS BEAUTE 15,Unknown,-11225.0
Unknown,03,Unknown,03,Unknown,Unknown,Unknown,NAIS BEAUTE 15,Unknown,-11228.0
Unknown,08,Unknown,08,Unknown,Unknown,Unknown,NAIS BEAUTE 15,Unknown,-11236.0
Unknown,01,Unknown,01,Unknown,Unknown,Unknown,NAIS BEAUTE 15,Unknown,-11237.0
Unknown,08,Unknown,08,Unknown,Unknown,Unknown,NAIS BEAUTE 15,Unknown,-11245.0
Unknown,120,Unknown,120,Unknown,Unknown,Unknown,NAIS BEAUTE 15,Unknown,-11365.0
Unknown,1,Unknown,1,Unknown,Unknown,Unknown,NAIS BEAUTE 15,Unknown,-11366.0
Unknown,03,Unknown,03,Unknown,Unknown,Unknown,NAIS BEAUTE 15,Unknown,-11369.0
Unknown,08,Unknown,08,Unknown,Unknown,Unknown,NAIS BEAUTE 15,Unknown,-11377.0
Unknown,03,Unknown,03,Unknown,Unknown,Unknown,NAIS BEAUTE 15,Unknown,-11380.0
Unknown,08,Unknown,08,Unknown,Unknown,Unknown,NAIS BEAUTE 15,Unknown,-11388.0
Unknown,03,Unknown,03,Unknown,Unknown,Unknown,NAIS BEAUTE 15,Unknown,-11391.0
Unknown,08,Unknown,08,Unknown,Unknown,Unknown,NAIS BEAUTE 15,Unknown,-11399.0
Unknown,104,Unknown,104,Unknown,Unknown,Unknown,NAIS BEAUTE 15,Unknown,-11503.0
Unknown,1,Unknown,1,Unknown,Unknown,Unknown,NAIS BEAUTE 15,Unknown,-11504.0
Unknown,03,Unknown,03,Unknown,Unknown,Unknown,NAIS BEAUTE 15,Unknown,-11507.0
Unknown,08,Unknown,08,Unknown,Unknown,Unknown,NAIS BEAUTE 15,Unknown,-11515.0
Unknown,03,Unknown,03,Unknown,Unknown,Unknown,NAIS BEAUTE 15,Unknown,-11518.0
Unknown,08,Unknown,08,Unknown,Unknown,Unknown,NAIS BEAUTE 15,Unknown,-11526.0
Unknown,03,Unknown,03,Unknown,Unknown,Unknown,NAIS BEAUTE 15,Unknown,-11529.0
Unknown,08,Unknown,08,Unknown,Unknown,Unknown,NAIS BEAUTE 15,Unknown,-11537.0
Unknown,127,Unknown,127,Unknown,Unknown,Unknown,NAIS BEAUTE 15,Unknown,-11664.0
Unknown,1,Unknown,1,Unknown,Unknown,Unknown,NAIS BEAUTE 15,Unknown,-11665.0
Unknown,03,Unknown,03,Unknown,Unknown,Unknown,NAIS BEAUTE 15,Unknown,-11668.0
Unknown,08,Unknown,08,Unknown,Unknown,Unknown,NAIS BEAUTE 15,Unknown,-11676.0
Unknown,03,Unknown,03,Unknown,Unknown,Unknown,NAIS BEAUTE 15,Unknown,-11679.0
Unknown,08,Unknown,08,Unknown,Unknown,Unknown,NAIS BEAUTE 15,Unknown,-11687.0
Unknown,001,Unknown,001,Unknown,Unknown,Unknown,NAIS BEAUTE 15,Unknown,-11688.0
Unknown,03,Unknown,03,Unknown,Unknown,Unknown,NAIS BEAUTE 15,Unknown,-11691.0
Unknown,08,Unknown,08,Unknown,Unknown,Unknown,NAIS BEAUTE 15,Unknown,-11699.0
Unknown,03,Unknown,03,Unknown,Unknown,Unknown,NAIS BEAUTE 15,Unknown,-11702.0
Unknown,08,Unknown,08,Unknown,Unknown,Unknown,NAIS BEAUTE 15,Unknown,-11710.0
Unknown,001,Unknown,001,Unknown,Unknown,Unknown,NAIS BEAUTE 15,Unknown,-11711.0
Unknown,03,Unknown,03,Unknown,Unknown,Unknown,NAIS BEAUTE 15,Unknown,-11714.0
Unknown,08,Unknown,08,Unknown,Unknown,Unknown,NAIS BEAUTE 15,Unknown,-11722.0
Unknown,03,Unknown,03,Unknown,Unknown,Unknown,NAIS BEAUTE 15,Unknown,-11725.0
Unknown,08,Unknown,08,Unknown,Unknown,Unknown,NAIS BEAUTE 15,Unknown,-11733.0
Unknown,001,Unknown,001,Unknown,Unknown,Unknown,NAIS BEAUTE 15,Unknown,-11734.0
Unknown,"3.809,58",Unknown,"3.809,58",Unknown,Unknown,Unknown,NAIS BEAUTE 15,Unknown,-11737.80958
Unknown,"59,41",Unknown,"59,41",Unknown,Unknown,Unknown,NAIS BEAUTE 15,Unknown,-17678.80958
Unknown,"249,53",Unknown,"249,53",Unknown,Unknown,Unknown,NAIS BEAUTE 15,Unknown,-42631.80958
Unknown,"236,61",Unknown,"236,61",Unknown,Unknown,Unknown,NAIS BEAUTE 15,Unknown,-66292.80958
Unknown,"118,80",Unknown,"118,80",Unknown,Unknown,Unknown,NAIS BEAUTE 15,Unknown,-78172.80958
Unknown,"102,97",Unknown,"102,97",Unknown,Unknown,Unknown,NAIS BEAUTE 15,Unknown,-88469.80958
Unknown,"125,73",Unknown,"125,73",Unknown,Unknown,Unknown,NAIS BEAUTE 15,Unknown,-101042.80958
Unknown,"696,37",Unknown,"696,37",Unknown,Unknown,Unknown,NAIS BEAUTE 15,Unknown,-170679.80958
Unknown,"1 218,63",Unknown,"1 218,63",Unknown,Unknown,Unknown,NAIS BEAUTE 15,Unknown,-292542.80958
Unknown,1,Unknown,1,Unknown,Unknown,Unknown,NAIS BEAUTE 15,Unknown,-292543.80958
Unknown,"218,63",Unknown,"218,63",Unknown,Unknown,Unknown,NAIS BEAUTE 15,Unknown,-314406.80958
Unknown,33,Unknown,33,Unknown,Unknown,Unknown,NAIS BEAUTE 15,Unknown,-314439.80958
Unknown,76 77,Unknown,76 77,Unknown,Unknown,Unknown,NAIS BEAUTE 15,Unknown,-322116.80958
Unknown,01,Unknown,01,Unknown,Unknown,Unknown,NAIS BEAUTE 15,Unknown,-322117.80958
Unknown,10,Unknown,10,Unknown,Unknown,Unknown,NAIS BEAUTE 15,Unknown,-322127.80958
Unknown,18,Unknown,18,Unknown,Unknown,Unknown,NAIS BEAUTE 15,Unknown,-322145.80958
Unknown,17,Unknown,17,Unknown,Unknown,Unknown,NAIS BEAUTE 15,Unknown,-322162.80958
Unknown,7,Unknown,7,Unknown,Unknown,Unknown,NAIS BEAUTE 15,Unknown,-322169.80958
Unknown,90,Unknown,90,Unknown,Unknown,Unknown,NAIS BEAUTE 15,Unknown,-322259.80958
Unknown,552 120 222,Unknown,552 120 222,Unknown,Unknown,Unknown,NAIS BEAUTE 15,Unknown,-552442481.80958
Unknown,066 714 367,Unknown,066 714 367,Unknown,Unknown,Unknown,NAIS BEAUTE 15,Unknown,-619156848.80958
Unknown,58,Unknown,58,Unknown,Unknown,Unknown,NAIS BEAUTE 15,Unknown,-619156906.80958
Unknown,20,Unknown,20,Unknown,Unknown,Unknown,NAIS BEAUTE 15,Unknown,-619156926.80958
Unknown,1,Unknown,1,Unknown,Unknown,Unknown,NAIS BEAUTE 15,Unknown,-619156927.80958
Unknown,Unknown,5,Unknown,Unknown,Debit,Unknown,FLEMING,Mo1E0,5.0
Unknown,Unknown,01 79,Unknown,Unknown,Debit,Unknown,FLEMING,Coût dun appel local WWW caisse,184.0
Unknown,Unknown,48 40,Unknown,Unknown,Debit,Unknown,FLEMING,Votre Agence COULOMMIERS 5 COURS GAMBETTA 77120,5024.0
Unknown,Unknown,00,Unknown,Unknown,Debit,Unknown,FLEMING,Mensuel N'37,5024.0
Unknown,Unknown,01 64,Unknown,Unknown,Debit,Unknown,FLEMING,ARGJENDI,5188.0
Unknown,Unknown,75 67,Unknown,Unknown,Debit,Unknown,FLEMING,RUE,12755.0
Unknown,Unknown,08,Unknown,Unknown,Debit,Unknown,FLEMING,Votre Interlocuteur DE CLIENTELE AGENCE,12763.0
Unknown,Unknown,31,Unknown,Unknown,Debit,Unknown,FLEMING,COULOMMIERS Identifiant,12794.0
Unknown,Unknown,12,Unknown,Unknown,Debit,Unknown,FLEMING,EURO COMPTE,12806.0
Unknown,Unknown,21,Unknown,Unknown,Debit,Unknown,FLEMING,PARTS SOCIALES,12827.0
Unknown,Unknown,37,Unknown,Unknown,Debit,Unknown,FLEMING,Solde,12864.0
Unknown,Unknown,1,Unknown,Unknown,Debit,Unknown,FLEMING,u 31/12/21 Solde,12865.0
Unknown,Unknown,4,Unknown,Unknown,Debit,Unknown,FLEMING,Solde,12869.0
Unknown,Unknown,002,Unknown,Unknown,Debit,Unknown,FLEMING,DecaiSSES,12871.0
Unknown,Unknown,29,Unknown,Unknown,Debit,Unknown,FLEMING,EURO Date Valeur Detail,12900.0
Unknown,Unknown,00 880,Unknown,Unknown,Debit,Unknown,FLEMING,PRecedent AU,13780.0
Unknown,Unknown,8,Unknown,Unknown,Debit,Unknown,FLEMING,TOTAL FACT,13788.0
Unknown,Unknown,06 14,Unknown,Unknown,Debit,Unknown,FLEMING,CB SPORT,14402.0
Unknown,Unknown,84 16,Unknown,Unknown,Debit,Unknown,FLEMING,ReMZI,22818.0
Unknown,Unknown,12,Unknown,Unknown,Debit,Unknown,FLEMING,MC DONALDS FACT,22830.0
Unknown,Unknown,87,Unknown,Unknown,Debit,Unknown,FLEMING,ReTRAIT,22917.0
Unknown,Unknown,63,Unknown,Unknown,Debit,Unknown,FLEMING,Epxineet de Prevofonce,22980.0
Unknown,Unknown,10,Unknown,Unknown,Debit,Unknown,FLEMING,PARS,22990.0
Unknown,Unknown,70,Unknown,Unknown,Debit,Unknown,FLEMING,Banque Cooperauve,23060.0
Unknown,Unknown,31,Unknown,Unknown,Debit,Unknown,FLEMING,sUvanus,23091.0
Unknown,Unknown,12,Unknown,Unknown,Debit,Unknown,FLEMING,Code Honeuire,23103.0
Unknown,Unknown,21,Unknown,Unknown,Debit,Unknown,FLEMING,hinnaer Socete,23124.0
Unknown,Unknown,31,Unknown,Unknown,Debit,Unknown,FLEMING,Drcctoire,23155.0
Unknown,Unknown,12,Unknown,Unknown,Debit,Unknown,FLEMING,Conscil,23167.0
Unknown,Unknown,21,Unknown,Unknown,Debit,Unknown,FLEMING,Onenuuon ct de Surveillance 1 Cspiual de 2,23188.0
Unknown,Unknown,31,Unknown,Unknown,Debit,Unknown,FLEMING,RCS Pn:,23219.0
Unknown,Unknown,12,Unknown,Unknown,Debit,Unknown,FLEMING,Unknown,23231.0
Unknown,Unknown,21 69,Unknown,Unknown,Debit,Unknown,FLEMING,Unknown,25400.0
Unknown,Unknown,53,Unknown,Unknown,Debit,Unknown,FLEMING,Unknown,25453.0
Unknown,Unknown,00 200,Unknown,Unknown,Debit,Unknown,FLEMING,Unknown,25653.0
Unknown,Unknown,0,Unknown,Unknown,Debit,Unknown,FLEMING,Unknown,25653.0
Unknown,Unknown,"1 845,00",Unknown,Unknown,Debit,Unknown,FLEMING,Unknown,210153.0
Unknown,Unknown,30,Unknown,Unknown,Debit,Unknown,FLEMING,Unknown,210183.0
Unknown,Unknown,0 50,Unknown,Unknown,Debit,Unknown,FLEMING,Unknown,210233.0
Unknown,Unknown,"0 699,76",Unknown,Unknown,Debit,Unknown,FLEMING,Unknown,280209.0
Unknown,Unknown,"2 293,51",Unknown,Unknown,Debit,Unknown,FLEMING,Unknown,509560.0
Unknown,Unknown,"38,78",Unknown,Unknown,Debit,Unknown,FLEMING,Unknown,513438.0
Unknown,Unknown,05,Unknown,Unknown,Debit,Unknown,FLEMING,Unknown,513443.0
Unknown,Unknown,"1 845,00",Unknown,Unknown,Debit,Unknown,FLEMING,Unknown,697943.0
Unknown,Unknown,87,Unknown,Unknown,Debit,Unknown,FLEMING,Unknown,698030.0
Unknown,Unknown,"21 197,52",Unknown,Unknown,Debit,Unknown,FLEMING,Unknown,2817782.0
Unknown,Unknown,01,Unknown,Unknown,Debit,Unknown,FLEMING,Unknown,2817783.0
Unknown,Unknown,12 01,Unknown,Unknown,Debit,Unknown,FLEMING,Unknown,2818984.0
Unknown,Unknown,12,Unknown,Unknown,Debit,Unknown,FLEMING,Unknown,2818996.0
Unknown,Unknown,"96,90",Unknown,Unknown,Debit,Unknown,FLEMING,Unknown,2828686.0
Unknown,Unknown,02,Unknown,Unknown,Debit,Unknown,FLEMING,Unknown,2828688.0
Unknown,Unknown,12 02,Unknown,Unknown,Debit,Unknown,FLEMING,Unknown,2829890.0
Unknown,Unknown,12,Unknown,Unknown,Debit,Unknown,FLEMING,Unknown,2829902.0
Unknown,Unknown,172,Unknown,Unknown,Debit,Unknown,FLEMING,Unknown,2830074.0
Unknown,Unknown,97 03,Unknown,Unknown,Debit,Unknown,FLEMING,Unknown,2839777.0
Unknown,Unknown,12 03,Unknown,Unknown,Debit,Unknown,FLEMING,Unknown,2840980.0
Unknown,Unknown,12,Unknown,Unknown,Debit,Unknown,FLEMING,Unknown,2840992.0
Unknown,Unknown,"24,40",Unknown,Unknown,Debit,Unknown,FLEMING,Unknown,2843432.0
Unknown,Unknown,03,Unknown,Unknown,Debit,Unknown,FLEMING,Unknown,2843435.0
Unknown,Unknown,12 03,Unknown,Unknown,Debit,Unknown,FLEMING,Unknown,2844638.0
Unknown,Unknown,12,Unknown,Unknown,Debit,Unknown,FLEMING,Unknown,2844650.0
Unknown,Unknown,"10,00",Unknown,Unknown,Debit,Unknown,FLEMING,Unknown,2845650.0
Unknown,Unknown,03,Unknown,Unknown,Debit,Unknown,FLEMING,Unknown,2845653.0
Unknown,Unknown,12 03,Unknown,Unknown,Debit,Unknown,FLEMING,Unknown,2846856.0
Unknown,Unknown,12,Unknown,Unknown,Debit,Unknown,FLEMING,Unknown,2846868.0
Unknown,Unknown,"30,00",Unknown,Unknown,Debit,Unknown,FLEMING,Unknown,2849868.0
Unknown,Unknown,03,Unknown,Unknown,Debit,Unknown,FLEMING,Unknown,2849871.0
Unknown,Unknown,12 03,Unknown,Unknown,Debit,Unknown,FLEMING,Unknown,2851074.0
Unknown,Unknown,12,Unknown,Unknown,Debit,Unknown,FLEMING,Unknown,2851086.0
Unknown,Unknown,02,Unknown,Unknown,Debit,Unknown,FLEMING,Unknown,2851088.0
Unknown,Unknown,12,Unknown,Unknown,Debit,Unknown,FLEMING,Unknown,2851100.0
Unknown,Unknown,"30,00",Unknown,Unknown,Debit,Unknown,FLEMING,Unknown,2854100.0
Unknown,Unknown,03,Unknown,Unknown,Debit,Unknown,FLEMING,Unknown,2854103.0
Unknown,Unknown,12 03,Unknown,Unknown,Debit,Unknown,FLEMING,Unknown,2855306.0
Unknown,Unknown,12,Unknown,Unknown,Debit,Unknown,FLEMING,Unknown,2855318.0
Unknown,Unknown,"156,32",Unknown,Unknown,Debit,Unknown,FLEMING,Unknown,2870950.0
Unknown,Unknown,04,Unknown,Unknown,Debit,Unknown,FLEMING,Unknown,2870954.0
Unknown,Unknown,12 04,Unknown,Unknown,Debit,Unknown,FLEMING,Unknown,2872158.0
Unknown,Unknown,12,Unknown,Unknown,Debit,Unknown,FLEMING,Unknown,2872170.0
Unknown,Unknown,77,Unknown,Unknown,Debit,Unknown,FLEMING,Unknown,2872247.0
Unknown,Unknown,"12,00",Unknown,Unknown,Debit,Unknown,FLEMING,Unknown,2873447.0
Unknown,Unknown,1 06,Unknown,Unknown,Debit,Unknown,FLEMING,Unknown,2873553.0
Unknown,Unknown,12 06,Unknown,Unknown,Debit,Unknown,FLEMING,Unknown,2874759.0
Unknown,Unknown,12,Unknown,Unknown,Debit,Unknown,FLEMING,Unknown,2874771.0
Unknown,Unknown,"42,56",Unknown,Unknown,Debit,Unknown,FLEMING,Unknown,2879027.0
Unknown,Unknown,1,Unknown,Unknown,Debit,Unknown,FLEMING,Unknown,2879028.0
Unknown,Unknown,1,Unknown,Unknown,Debit,Unknown,FLEMING,Unknown,2879029.0
Unknown,Unknown,512,Unknown,Unknown,Debit,Unknown,FLEMING,Unknown,2879541.0
Unknown,Unknown,85,Unknown,Unknown,Debit,Unknown,FLEMING,Unknown,2879626.0
Unknown,Unknown,1,Unknown,Unknown,Debit,Unknown,FLEMING,Unknown,2879627.0
Unknown,Unknown,2,Unknown,Unknown,Debit,Unknown,FLEMING,Unknown,2879629.0
Unknown,Unknown,75,Unknown,Unknown,Debit,Unknown,FLEMING,Unknown,2879704.0
Unknown,Unknown,182 900 942,Unknown,Unknown,Debit,Unknown,FLEMING,Unknown,185780646.0
Unknown,Unknown,07,Unknown,Unknown,Debit,Unknown,FLEMING,Unknown,185780653.0
Unknown,Unknown,200,Unknown,Unknown,Debit,Unknown,FLEMING,Unknown,185780853.0
Unknown,Unknown,6,Unknown,Unknown,Debit,Unknown,FLEMING,Unknown,185780859.0
Unknown,Unknown,8,Unknown,Unknown,Debit,Unknown,FLEMING,Unknown,185780867.0
Unknown,Unknown,29,Unknown,Unknown,Debit,Unknown,Mensuel,Gi PhoooiC,29.0
Unknown,Unknown,02,Unknown,Unknown,Debit,Unknown,Mensuel,M2o4bee,31.0
Unknown,Unknown,20,Unknown,Unknown,Debit,Unknown,Mensuel,COURANT N,51.0
Unknown,Unknown,15,Unknown,Unknown,Debit,Unknown,Mensuel,Sune),66.0
Unknown,Unknown,2,Unknown,Unknown,Debit,Unknown,Mensuel,CB CARREFMARKETDAC FACT 070220,68.0
Unknown,Unknown,3,Unknown,Unknown,Debit,Unknown,Mensuel,PRLV,71.0
Unknown,Unknown,87,Unknown,Unknown,Debit,Unknown,Mensuel,N 0114688,158.0
Unknown,Unknown,10,Unknown,Unknown,Debit,Unknown,Mensuel,GASHI,168.0
Unknown,Unknown,02 10,Unknown,Unknown,Debit,Unknown,Mensuel,ReMZI,378.0
Unknown,Unknown,02,Unknown,Unknown,Debit,Unknown,Mensuel,ReMZI,380.0
Unknown,Unknown,10,Unknown,Unknown,Debit,Unknown,Mensuel,NMa,390.0
Unknown,Unknown,02 10,Unknown,Unknown,Debit,Unknown,Mensuel,GASHI,600.0
Unknown,Unknown,02,Unknown,Unknown,Debit,Unknown,Mensuel,ReMZI,602.0
Unknown,Unknown,11,Unknown,Unknown,Debit,Unknown,Mensuel,CB RELAIS,613.0
Unknown,Unknown,02 10,Unknown,Unknown,Debit,Unknown,Mensuel,N.0114688 M GASHI,823.0
Unknown,Unknown,02,Unknown,Unknown,Debit,Unknown,Mensuel,ReMZI,825.0
Unknown,Unknown,11,Unknown,Unknown,Debit,Unknown,Mensuel,Saner,836.0
Unknown,Unknown,02 11,Unknown,Unknown,Debit,Unknown,Mensuel,FACT 220220,1047.0
Unknown,Unknown,02,Unknown,Unknown,Debit,Unknown,Mensuel,ReMZI,1049.0
Unknown,Unknown,77,Unknown,Unknown,Debit,Unknown,Mensuel,N 0114688,1126.0
Unknown,Unknown,13,Unknown,Unknown,Debit,Unknown,Mensuel,SOLDE AU,1139.0
Unknown,Unknown,02 13,Unknown,Unknown,Debit,Unknown,Mensuel,Irancs,1352.0
Unknown,Unknown,02,Unknown,Unknown,Debit,Unknown,Mensuel,IBAN FR76,1354.0
Unknown,Unknown,17,Unknown,Unknown,Debit,Unknown,Mensuel,IBAN FR76,1371.0
Unknown,Unknown,02 17,Unknown,Unknown,Debit,Unknown,Mensuel,Paf,1588.0
Unknown,Unknown,02,Unknown,Unknown,Debit,Unknown,Mensuel,Penie,1590.0
Unknown,Unknown,17,Unknown,Unknown,Debit,Unknown,Mensuel,YoUf Cevez,1607.0
Unknown,Unknown,02 17,Unknown,Unknown,Debit,Unknown,Mensuel,Jeftef Yole,1824.0
Unknown,Unknown,02,Unknown,Unknown,Debit,Unknown,Mensuel,Concernant vou€ Cafte bancaire,1826.0
Unknown,Unknown,18,Unknown,Unknown,Debit,Unknown,Mensuel,Ccyci,1844.0
Unknown,Unknown,02 17,Unknown,Unknown,Debit,Unknown,Mensuel,ommungucr Je nmero,2061.0
Unknown,Unknown,02,Unknown,Unknown,Debit,Unknown,Mensuel,U,2063.0
Unknown,Unknown,14,Unknown,Unknown,Debit,Unknown,Mensuel,dppei Cune,2077.0
Unknown,Unknown,20,Unknown,Unknown,Debit,Unknown,Mensuel,ePyine,2097.0
Unknown,Unknown,02 20,Unknown,Unknown,Debit,Unknown,Mensuel,Qunneft Paf,2317.0
Unknown,Unknown,02,Unknown,Unknown,Debit,Unknown,Mensuel,QU B YoUs,2319.0
Unknown,Unknown,21,Unknown,Unknown,Debit,Unknown,Mensuel,TOhou,2340.0
Unknown,Unknown,02 21,Unknown,Unknown,Debit,Unknown,Mensuel,Encrge Yol Yous,2561.0
Unknown,Unknown,02,Unknown,Unknown,Debit,Unknown,Mensuel,Ctef JUC}PoybPefle,2563.0
Unknown,Unknown,22,Unknown,Unknown,Debit,Unknown,Mensuel,Ce Yos Moyen},2585.0
Unknown,Unknown,02 22,Unknown,Unknown,Debit,Unknown,Mensuel,Ce Puemeok,2807.0
Unknown,Unknown,02,Unknown,Unknown,Debit,Unknown,Mensuel,Uniiue,2809.0
Unknown,Unknown,24,Unknown,Unknown,Debit,Unknown,Mensuel,Umln,2833.0
Unknown,Unknown,02 24,Unknown,Unknown,Debit,Unknown,Mensuel,IBh Cereleve {er,3057.0
Unknown,Unknown,02,Unknown,Unknown,Debit,Unknown,Mensuel,conridert,3059.0
Unknown,Unknown,26,Unknown,Unknown,Debit,Unknown,Mensuel,Jppfolnve B,3085.0
Unknown,Unknown,02 26,Unknown,Unknown,Debit,Unknown,Mensuel,Jkufe,3311.0
Unknown,Unknown,02,Unknown,Unknown,Debit,Unknown,Mensuel,Beuant Canf vol€,3313.0
Unknown,Unknown,26,Unknown,Unknown,Debit,Unknown,Mensuel,Ct vof,3339.0
Unknown,Unknown,02 26,Unknown,Unknown,Debit,Unknown,Mensuel,OnUju,3565.0
Unknown,Unknown,02,Unknown,Unknown,Debit,Unknown,Mensuel,Ge Puemenr Jiooer,3567.0
Unknown,Unknown,27,Unknown,Unknown,Debit,Unknown,Mensuel,ainlormauon OU recamauon reljuye BPX,3594.0
Unknown,Unknown,02 27,Unknown,Unknown,Debit,Unknown,Mensuel,Produu,3821.0
Unknown,Unknown,02,Unknown,Unknown,Debit,Unknown,Mensuel,Jenyce} bancdire},3823.0
Unknown,Unknown,"66,00",Unknown,Unknown,Debit,Unknown,Mensuel,MLprc},10423.0
Unknown,Unknown,"85,00",Unknown,Unknown,Debit,Unknown,Mensuel,Unknown,18923.0
Unknown,Unknown,"24,90",Unknown,Unknown,Debit,Unknown,Mensuel,Unknown,21413.0
Unknown,Unknown,"5,50",Unknown,Unknown,Debit,Unknown,Mensuel,Unknown,21963.0
Unknown,Unknown,"55,07",Unknown,Unknown,Debit,Unknown,Mensuel,Unknown,27470.0
Unknown,Unknown,"88,80",Unknown,Unknown,Debit,Unknown,Mensuel,Unknown,36350.0
Unknown,Unknown,"2,80",Unknown,Unknown,Debit,Unknown,Mensuel,Unknown,36630.0
Unknown,Unknown,145 10,Unknown,Unknown,Debit,Unknown,Mensuel,Unknown,51140.0
Unknown,Unknown,"642,34",Unknown,Unknown,Debit,Unknown,Mensuel,Unknown,115374.0
Unknown,Unknown,"78,30",Unknown,Unknown,Debit,Unknown,Mensuel,Unknown,123204.0
Unknown,Unknown,"77,00",Unknown,Unknown,Debit,Unknown,Mensuel,Unknown,130904.0
Unknown,Unknown,"89,60",Unknown,Unknown,Debit,Unknown,Mensuel,Unknown,139864.0
Unknown,Unknown,"1,90",Unknown,Unknown,Debit,Unknown,Mensuel,Unknown,140054.0
Unknown,Unknown,"75,01",Unknown,Unknown,Debit,Unknown,Mensuel,Unknown,147555.0
Unknown,Unknown,"151,91",Unknown,Unknown,Debit,Unknown,Mensuel,Unknown,162746.0
Unknown,Unknown,"50,60",Unknown,Unknown,Debit,Unknown,Mensuel,Unknown,167806.0
Unknown,Unknown,29,Unknown,Unknown,Debit,Unknown,Mensuel,Unknown,167835.0
Unknown,Unknown,02,Unknown,Unknown,Debit,Unknown,Mensuel,Unknown,167837.0
Unknown,Unknown,20,Unknown,Unknown,Debit,Unknown,Mensuel,Unknown,167857.0
Unknown,Unknown,1 183 15,Unknown,Unknown,Debit,Unknown,Mensuel,Unknown,286172.0
Unknown,Unknown,"180,37",Unknown,Unknown,Debit,Unknown,Mensuel,Unknown,304209.0
Unknown,Unknown,751,Unknown,Unknown,Debit,Unknown,Mensuel,Unknown,304960.0
Unknown,Unknown,987,Unknown,Unknown,Debit,Unknown,Mensuel,Unknown,305947.0
Unknown,Unknown,751,Unknown,Unknown,Debit,Unknown,Mensuel,Unknown,306698.0
Unknown,Unknown,163,Unknown,Unknown,Debit,Unknown,Mensuel,Unknown,306861.0
Unknown,Unknown,4 08,Unknown,Unknown,Debit,Unknown,Mensuel,Unknown,307269.0
Unknown,Unknown,88,Unknown,Unknown,Debit,Unknown,Mensuel,Unknown,307357.0
Unknown,Unknown,6,Unknown,Unknown,Debit,Unknown,Mensuel,Unknown,307363.0
Unknown,Unknown,8,Unknown,Unknown,Debit,Unknown,Mensuel,Unknown,307371.0
Unknown,Unknown,8,Unknown,Unknown,Debit,Unknown,Mensuel,Unknown,307379.0
Unknown,Unknown,01,Unknown,Unknown,Debit,Unknown,Mensuel,Unknown,307380.0
Unknown,Unknown,4,Unknown,Unknown,Debit,Unknown,Mensuel,Unknown,307384.0
Unknown,Unknown,22,Unknown,Unknown,Debit,Unknown,Mensuel,Unknown,307406.0
Unknown,Unknown,88,Unknown,Unknown,Debit,Unknown,Mensuel,Unknown,307494.0
Unknown,Unknown,6,Unknown,Unknown,Debit,Unknown,Mensuel,Unknown,307500.0
Unknown,Unknown,8,Unknown,Unknown,Debit,Unknown,Mensuel,Unknown,307508.0
Unknown,Unknown,9,Unknown,Unknown,Debit,Unknown,Mensuel,Unknown,307517.0
Unknown,Unknown,08 88,Unknown,Unknown,Debit,Unknown,Mensuel,Unknown,308405.0
Unknown,Unknown,6 45,Unknown,Unknown,Debit,Unknown,Mensuel,Unknown,309050.0
Unknown,Unknown,48,Unknown,Unknown,Debit,Unknown,Mensuel,Unknown,309098.0
Unknown,Unknown,"0,15",Unknown,Unknown,Debit,Unknown,Mensuel,Unknown,309113.0
Unknown,Unknown,3,Unknown,Unknown,Debit,Unknown,Mensuel,Unknown,309116.0
Unknown,Unknown,1,Unknown,Unknown,Debit,Unknown,Mensuel,Unknown,309117.0
Unknown,Unknown,11,Unknown,Unknown,Credit,Unknown,Crédit du Nord,No 11,11.0
Unknown,Unknown,30 11,Unknown,Unknown,Credit,Unknown,Crédit du Nord,Paoe 1/,3022.0
Unknown,Unknown,1,Unknown,Unknown,Credit,Unknown,Crédit du Nord,MOISYLE,3023.0
Unknown,Unknown,42,Unknown,Unknown,Credit,Unknown,Crédit du Nord,GRAND Ter,3065.0
Unknown,Unknown,01 48,Unknown,Unknown,Credit,Unknown,Crédit du Nord,Vore ogence Quoumo,3213.0
Unknown,Unknown,15,Unknown,Unknown,Credit,Unknown,Crédit du Nord,Chns Laure BeRNET,3228.0
Unknown,Unknown,15 13,Unknown,Unknown,Credit,Unknown,Crédit du Nord,STALINGRAD Te,4741.0
Unknown,Unknown,65,Unknown,Unknown,Credit,Unknown,Crédit du Nord,Elode Drect,4806.0
Unknown,Unknown,01 55,Unknown,Unknown,Credit,Unknown,Crédit du Nord,Internet,4961.0
Unknown,Unknown,00,Unknown,Unknown,Credit,Unknown,Crédit du Nord,LE MARCHE DE TREMBLAY Date,4961.0
Unknown,Unknown,033,Unknown,Unknown,Credit,Unknown,Crédit du Nord,IBAN FR76,4994.0
Unknown,Unknown,"872,21",Unknown,Unknown,Credit,Unknown,Crédit du Nord,AT PREVOY,92215.0
Unknown,Unknown,"746,20",Unknown,Unknown,Credit,Unknown,Crédit du Nord,411 PAGPOIOOLECPL7 511,166835.0
Unknown,Unknown,"31,10",Unknown,Unknown,Credit,Unknown,Crédit du Nord,IvERSEMENT ESPECES,169945.0
Unknown,Unknown,411,Unknown,Unknown,Credit,Unknown,Crédit du Nord,VERDI 16687882,170356.0
Unknown,Unknown,"10,58",Unknown,Unknown,Credit,Unknown,Crédit du Nord,IvERSEMENT ESPECES,171414.0
Unknown,Unknown,26 11,Unknown,Unknown,Credit,Unknown,Crédit du Nord,N0,174025.0
Unknown,Unknown,411,Unknown,Unknown,Credit,Unknown,Crédit du Nord,N0,174436.0
Unknown,Unknown,"97,75",Unknown,Unknown,Credit,Unknown,Crédit du Nord,N0,184211.0
Unknown,Unknown,11 411,Unknown,Unknown,Credit,Unknown,Crédit du Nord,METROFRANCE,195622.0
Unknown,Unknown,0,Unknown,Unknown,Credit,Unknown,Crédit du Nord,PRelevement,195622.0
Unknown,Unknown,"168,84",Unknown,Unknown,Credit,Unknown,Crédit du Nord,N0,212506.0
Unknown,Unknown,11 41,Unknown,Unknown,Credit,Unknown,Crédit du Nord,C8 No,213647.0
Unknown,Unknown,"178,36",Unknown,Unknown,Credit,Unknown,Crédit du Nord,lutlisation,231483.0
Unknown,Unknown,411 411,Unknown,Unknown,Credit,Unknown,Crédit du Nord,VOls,642894.0
Unknown,Unknown,0,Unknown,Unknown,Credit,Unknown,Crédit du Nord,Linque,642894.0
Unknown,Unknown,411 411,Unknown,Unknown,Credit,Unknown,Crédit du Nord,boulevard Haussmann,1054305.0
Unknown,Unknown,"250,78",Unknown,Unknown,Credit,Unknown,Crédit du Nord,Pars ouparvoie clectroniaesulesteinternet,1079383.0
Unknown,Unknown,411,Unknown,Unknown,Credit,Unknown,Crédit du Nord,Qunadcon Le Mduteu rpadradans unalai,1079794.0
Unknown,Unknown,"312,67",Unknown,Unknown,Credit,Unknown,Crédit du Nord,Faccise feceptiond pise,1111061.0
Unknown,Unknown,411,Unknown,Unknown,Credit,Unknown,Crédit du Nord,Encasdeltoe,1111472.0
Unknown,Unknown,0,Unknown,Unknown,Credit,Unknown,Crédit du Nord,ddai,1111472.0
Unknown,Unknown,"393,77",Unknown,Unknown,Credit,Unknown,Crédit du Nord,ere prolonge,1150849.0
Unknown,Unknown,411 411,Unknown,Unknown,Credit,Unknown,Crédit du Nord,Medutur,1562260.0
Unknown,Unknown,0,Unknown,Unknown,Credit,Unknown,Crédit du Nord,Vous serezendroi dacccolrou reluserla pcoosmtion,1562260.0
Unknown,Unknown,"462,12",Unknown,Unknown,Credit,Unknown,Crédit du Nord,Mdiateur,1608472.0
Unknown,Unknown,411 411,Unknown,Unknown,Credit,Unknown,Crédit du Nord,J0jours 8,2019883.0
Unknown,Unknown,"9,99",Unknown,Unknown,Credit,Unknown,Crédit du Nord,quelekkdurunestpas,2020882.0
Unknown,Unknown,411,Unknown,Unknown,Credit,Unknown,Crédit du Nord,TvA,2021293.0
Unknown,Unknown,511,Unknown,Unknown,Credit,Unknown,Crédit du Nord,Jassanos Inftu @ORuS ousln,2021804.0
Unknown,Unknown,"900,00",Unknown,Unknown,Credit,Unknown,Crédit du Nord,Unknown,2111804.0
Unknown,Unknown,511 511,Unknown,Unknown,Credit,Unknown,Crédit du Nord,Unknown,2623315.0
Unknown,Unknown,"236,00",Unknown,Unknown,Credit,Unknown,Crédit du Nord,Unknown,2646915.0
Unknown,Unknown,511,Unknown,Unknown,Credit,Unknown,Crédit du Nord,Unknown,2647426.0
Unknown,Unknown,5 11,Unknown,Unknown,Credit,Unknown,Crédit du Nord,Unknown,2647937.0
Unknown,Unknown,"740,00",Unknown,Unknown,Credit,Unknown,Crédit du Nord,Unknown,2721937.0
Unknown,Unknown,531 511,Unknown,Unknown,Credit,Unknown,Crédit du Nord,Unknown,3253448.0
Unknown,Unknown,"760,00",Unknown,Unknown,Credit,Unknown,Crédit du Nord,Unknown,3329448.0
Unknown,Unknown,531,Unknown,Unknown,Credit,Unknown,Crédit du Nord,Unknown,3329979.0
Unknown,Unknown,5 11,Unknown,Unknown,Credit,Unknown,Crédit du Nord,Unknown,3330490.0
Unknown,Unknown,00 531,Unknown,Unknown,Credit,Unknown,Crédit du Nord,Unknown,3331021.0
Unknown,Unknown,5 11,Unknown,Unknown,Credit,Unknown,Crédit du Nord,Unknown,3331532.0
Unknown,Unknown,"127,33",Unknown,Unknown,Credit,Unknown,Crédit du Nord,Unknown,3344265.0
Unknown,Unknown,531 511,Unknown,Unknown,Credit,Unknown,Crédit du Nord,Unknown,3875776.0
Unknown,Unknown,"127,77",Unknown,Unknown,Credit,Unknown,Crédit du Nord,Unknown,3888553.0
Unknown,Unknown,51,Unknown,Unknown,Credit,Unknown,Crédit du Nord,Unknown,3888604.0
Unknown,Unknown,6 11,Unknown,Unknown,Credit,Unknown,Crédit du Nord,Unknown,3889215.0
Unknown,Unknown,"63,88",Unknown,Unknown,Credit,Unknown,Crédit du Nord,Unknown,3895603.0
Unknown,Unknown,6 11,Unknown,Unknown,Credit,Unknown,Crédit du Nord,Unknown,3896214.0
Unknown,Unknown,6 11,Unknown,Unknown,Credit,Unknown,Crédit du Nord,Unknown,3896825.0
Unknown,Unknown,"128,12",Unknown,Unknown,Credit,Unknown,Crédit du Nord,Unknown,3909637.0
Unknown,Unknown,6 11,Unknown,Unknown,Credit,Unknown,Crédit du Nord,Unknown,3910248.0
Unknown,Unknown,6 11,Unknown,Unknown,Credit,Unknown,Crédit du Nord,Unknown,3910859.0
Unknown,Unknown,919 28,Unknown,Unknown,Credit,Unknown,Crédit du Nord,Unknown,4002787.0
Unknown,Unknown,6 31,Unknown,Unknown,Credit,Unknown,Crédit du Nord,Unknown,4003418.0
Unknown,Unknown,711,Unknown,Unknown,Credit,Unknown,Crédit du Nord,Unknown,4004129.0
Unknown,Unknown,"145,53",Unknown,Unknown,Credit,Unknown,Crédit du Nord,Unknown,4018682.0
Unknown,Unknown,71 711,Unknown,Unknown,Credit,Unknown,Crédit du Nord,Unknown,4090393.0
Unknown,Unknown,711 711,Unknown,Unknown,Credit,Unknown,Crédit du Nord,Unknown,4802104.0
Unknown,Unknown,"651,18",Unknown,Unknown,Credit,Unknown,Crédit du Nord,Unknown,4867222.0
Unknown,Unknown,6 31,Unknown,Unknown,Credit,Unknown,Crédit du Nord,Unknown,4867853.0
Unknown,Unknown,8,Unknown,Unknown,Credit,Unknown,Crédit du Nord,Unknown,4867861.0
Unknown,Unknown,"159,90",Unknown,Unknown,Credit,Unknown,Crédit du Nord,Unknown,4883851.0
Unknown,Unknown,8 11,Unknown,Unknown,Credit,Unknown,Crédit du Nord,Unknown,4884662.0
Unknown,Unknown,59,Unknown,Unknown,Credit,Unknown,Crédit du Nord,Unknown,4884721.0
Unknown,Unknown,90,Unknown,Unknown,Credit,Unknown,Crédit du Nord,Unknown,4884811.0
Unknown,Unknown,0,Unknown,Unknown,Credit,Unknown,Crédit du Nord,Unknown,4884811.0
Unknown,Unknown,0,Unknown,Unknown,Credit,Unknown,Crédit du Nord,Unknown,4884811.0
Unknown,Unknown,8,Unknown,Unknown,Credit,Unknown,Crédit du Nord,Unknown,4884819.0
Unknown,Unknown,8,Unknown,Unknown,Credit,Unknown,Crédit du Nord,Unknown,4884827.0
Unknown,Unknown,890,Unknown,Unknown,Credit,Unknown,Crédit du Nord,Unknown,4885717.0
Unknown,Unknown,456 504 851,Unknown,Unknown,Credit,Unknown,Crédit du Nord,Unknown,461390568.0
Unknown,Unknown,456 504 851,Unknown,Unknown,Credit,Unknown,Crédit du Nord,Unknown,917895419.0
Unknown,Unknown,2,Unknown,Unknown,Credit,Unknown,Crédit du Nord,Unknown,917895421.0
Unknown,Unknown,12,Unknown,Unknown,Credit,Unknown,Crédit du Nord,Paoe 1/,12.0
Unknown,Unknown,31 12,Unknown,Unknown,Credit,Unknown,Crédit du Nord,MOISYLE,3124.0
Unknown,Unknown,1,Unknown,Unknown,Credit,Unknown,Crédit du Nord,GRAND Ter,3125.0
Unknown,Unknown,42,Unknown,Unknown,Credit,Unknown,Crédit du Nord,Vore ogence Quoumo vndcao,3167.0
Unknown,Unknown,01 48,Unknown,Unknown,Credit,Unknown,Crédit du Nord,Soha DAHLAB,3315.0
Unknown,Unknown,15,Unknown,Unknown,Credit,Unknown,Crédit du Nord,Elode Drect,3330.0
Unknown,Unknown,15 13,Unknown,Unknown,Credit,Unknown,Crédit du Nord,Internet,4843.0
Unknown,Unknown,65,Unknown,Unknown,Credit,Unknown,Crédit du Nord,LE MARCHE DE TREMBLAY Date,4908.0
Unknown,Unknown,15,Unknown,Unknown,Credit,Unknown,Crédit du Nord,IBAN FR76,4923.0
Unknown,Unknown,00,Unknown,Unknown,Credit,Unknown,Crédit du Nord,N0,4923.0
Unknown,Unknown,033,Unknown,Unknown,Credit,Unknown,Crédit du Nord,ReMISE,4956.0
Unknown,Unknown,"566,06",Unknown,Unknown,Credit,Unknown,Crédit du Nord,CB N0,61562.0
Unknown,Unknown,2 12,Unknown,Unknown,Credit,Unknown,Crédit du Nord,IPRLV,61774.0
Unknown,Unknown,"0,99",Unknown,Unknown,Credit,Unknown,Crédit du Nord,METROFRAICE,61873.0
Unknown,Unknown,212 212,Unknown,Unknown,Credit,Unknown,Crédit du Nord,METROFRAICE,274085.0
Unknown,Unknown,"174,10",Unknown,Unknown,Credit,Unknown,Crédit du Nord,PRelevement,291495.0
Unknown,Unknown,212,Unknown,Unknown,Credit,Unknown,Crédit du Nord,IpRElEVEMENT AT,291707.0
Unknown,Unknown,2 12,Unknown,Unknown,Credit,Unknown,Crédit du Nord,N0,291919.0
Unknown,Unknown,"260,39",Unknown,Unknown,Credit,Unknown,Crédit du Nord,PRElEVEMENT,317958.0
Unknown,Unknown,212 212,Unknown,Unknown,Credit,Unknown,Crédit du Nord,N0,530170.0
Unknown,Unknown,"318,67",Unknown,Unknown,Credit,Unknown,Crédit du Nord,Encas,562037.0
Unknown,Unknown,212,Unknown,Unknown,Credit,Unknown,Crédit du Nord,lutlisation,562249.0
Unknown,Unknown,2 12,Unknown,Unknown,Credit,Unknown,Crédit du Nord,VOls,562461.0
Unknown,Unknown,"368,73",Unknown,Unknown,Credit,Unknown,Crédit du Nord,Linque,599334.0
Unknown,Unknown,212 212,Unknown,Unknown,Credit,Unknown,Crédit du Nord,boulevard Haussmann,811546.0
Unknown,Unknown,0,Unknown,Unknown,Credit,Unknown,Crédit du Nord,Pars ouparvoie clectroniaesulesteinternet,811546.0
Unknown,Unknown,"392,93",Unknown,Unknown,Credit,Unknown,Crédit du Nord,Qunadcon Le Mduteu rpadradans unalai,850839.0
Unknown,Unknown,212 212,Unknown,Unknown,Credit,Unknown,Crédit du Nord,Faccise feceptiond pise,1063051.0
Unknown,Unknown,"411,58",Unknown,Unknown,Credit,Unknown,Crédit du Nord,Encasdeltoe,1104209.0
Unknown,Unknown,212,Unknown,Unknown,Credit,Unknown,Crédit du Nord,ddai,1104421.0
Unknown,Unknown,2 12,Unknown,Unknown,Credit,Unknown,Crédit du Nord,ere prolonge,1104633.0
Unknown,Unknown,"120,00",Unknown,Unknown,Credit,Unknown,Crédit du Nord,Medutur,1116633.0
Unknown,Unknown,212 212,Unknown,Unknown,Credit,Unknown,Crédit du Nord,Vous serezendroi dacccolrou reluserla pcoosmtion,1328845.0
Unknown,Unknown,"746,20",Unknown,Unknown,Credit,Unknown,Crédit du Nord,Mdiateur,1403465.0
Unknown,Unknown,3 12,Unknown,Unknown,Credit,Unknown,Crédit du Nord,J0jours 8,1403777.0
Unknown,Unknown,"101,93",Unknown,Unknown,Credit,Unknown,Crédit du Nord,quelekkdurunestpas,1413970.0
Unknown,Unknown,312,Unknown,Unknown,Credit,Unknown,Crédit du Nord,TvA,1414282.0
Unknown,Unknown,3 12,Unknown,Unknown,Credit,Unknown,Crédit du Nord,Jassanos Inftu @ORuS ousln,1414594.0
Unknown,Unknown,0,Unknown,Unknown,Credit,Unknown,Crédit du Nord,Unknown,1414594.0
Unknown,Unknown,"287,13",Unknown,Unknown,Credit,Unknown,Crédit du Nord,Unknown,1443307.0
Unknown,Unknown,312,Unknown,Unknown,Credit,Unknown,Crédit du Nord,Unknown,1443619.0
Unknown,Unknown,3 12,Unknown,Unknown,Credit,Unknown,Crédit du Nord,Unknown,1443931.0
Unknown,Unknown,312,Unknown,Unknown,Credit,Unknown,Crédit du Nord,Unknown,1444243.0
Unknown,Unknown,"4,12",Unknown,Unknown,Credit,Unknown,Crédit du Nord,Unknown,1444655.0
Unknown,Unknown,"10,58",Unknown,Unknown,Credit,Unknown,Crédit du Nord,Unknown,1445713.0
Unknown,Unknown,512,Unknown,Unknown,Credit,Unknown,Crédit du Nord,Unknown,1446225.0
Unknown,Unknown,4 12,Unknown,Unknown,Credit,Unknown,Crédit du Nord,Unknown,1446637.0
Unknown,Unknown,0,Unknown,Unknown,Credit,Unknown,Crédit du Nord,Unknown,1446637.0
Unknown,Unknown,"151,97",Unknown,Unknown,Credit,Unknown,Crédit du Nord,Unknown,1461834.0
Unknown,Unknown,412,Unknown,Unknown,Credit,Unknown,Crédit du Nord,Unknown,1462246.0
Unknown,Unknown,"4,12",Unknown,Unknown,Credit,Unknown,Crédit du Nord,Unknown,1462658.0
Unknown,Unknown,"168,84",Unknown,Unknown,Credit,Unknown,Crédit du Nord,Unknown,1479542.0
Unknown,Unknown,412 412,Unknown,Unknown,Credit,Unknown,Crédit du Nord,Unknown,1891954.0
Unknown,Unknown,"9,99",Unknown,Unknown,Credit,Unknown,Crédit du Nord,Unknown,1892953.0
Unknown,Unknown,412,Unknown,Unknown,Credit,Unknown,Crédit du Nord,Unknown,1893365.0
Unknown,Unknown,412,Unknown,Unknown,Credit,Unknown,Crédit du Nord,Unknown,1893777.0
Unknown,Unknown,"741,85",Unknown,Unknown,Credit,Unknown,Crédit du Nord,Unknown,1967962.0
Unknown,Unknown,412,Unknown,Unknown,Credit,Unknown,Crédit du Nord,Unknown,1968374.0
Unknown,Unknown,4 12,Unknown,Unknown,Credit,Unknown,Crédit du Nord,Unknown,1968786.0
Unknown,Unknown,29 312,Unknown,Unknown,Credit,Unknown,Crédit du Nord,Unknown,1998098.0
Unknown,Unknown,5 12,Unknown,Unknown,Credit,Unknown,Crédit du Nord,Unknown,1998610.0
Unknown,Unknown,"81,34",Unknown,Unknown,Credit,Unknown,Crédit du Nord,Unknown,2006744.0
Unknown,Unknown,512,Unknown,Unknown,Credit,Unknown,Crédit du Nord,Unknown,2007256.0
Unknown,Unknown,5 12,Unknown,Unknown,Credit,Unknown,Crédit du Nord,Unknown,2007768.0
Unknown,Unknown,"191,35",Unknown,Unknown,Credit,Unknown,Crédit du Nord,Unknown,2026903.0
Unknown,Unknown,512,Unknown,Unknown,Credit,Unknown,Crédit du Nord,Unknown,2027415.0
Unknown,Unknown,6 12,Unknown,Unknown,Credit,Unknown,Crédit du Nord,Unknown,2028027.0
Unknown,Unknown,0,Unknown,Unknown,Credit,Unknown,Crédit du Nord,Unknown,2028027.0
Unknown,Unknown,"111,55",Unknown,Unknown,Credit,Unknown,Crédit du Nord,Unknown,2039182.0
Unknown,Unknown,6 12,Unknown,Unknown,Credit,Unknown,Crédit du Nord,Unknown,2039794.0
Unknown,Unknown,6 12,Unknown,Unknown,Credit,Unknown,Crédit du Nord,Unknown,2040406.0
Unknown,Unknown,"171,06",Unknown,Unknown,Credit,Unknown,Crédit du Nord,Unknown,2057512.0
Unknown,Unknown,612,Unknown,Unknown,Credit,Unknown,Crédit du Nord,Unknown,2058124.0
Unknown,Unknown,9 12,Unknown,Unknown,Credit,Unknown,Crédit du Nord,Unknown,2059036.0
Unknown,Unknown,"256,03",Unknown,Unknown,Credit,Unknown,Crédit du Nord,Unknown,2084639.0
Unknown,Unknown,9 12,Unknown,Unknown,Credit,Unknown,Crédit du Nord,Unknown,2085551.0
Unknown,Unknown,59,Unknown,Unknown,Credit,Unknown,Crédit du Nord,Unknown,2085610.0
Unknown,Unknown,90,Unknown,Unknown,Credit,Unknown,Crédit du Nord,Unknown,2085700.0
Unknown,Unknown,0,Unknown,Unknown,Credit,Unknown,Crédit du Nord,Unknown,2085700.0
Unknown,Unknown,0,Unknown,Unknown,Credit,Unknown,Crédit du Nord,Unknown,2085700.0
Unknown,Unknown,8,Unknown,Unknown,Credit,Unknown,Crédit du Nord,Unknown,2085708.0
Unknown,Unknown,8,Unknown,Unknown,Credit,Unknown,Crédit du Nord,Unknown,2085716.0
Unknown,Unknown,890,Unknown,Unknown,Credit,Unknown,Crédit du Nord,Unknown,2086606.0
Unknown,Unknown,456 504 851,Unknown,Unknown,Credit,Unknown,Crédit du Nord,Unknown,458591457.0
Unknown,Unknown,456 504 851,Unknown,Unknown,Credit,Unknown,Crédit du Nord,Unknown,915096308.0
Unknown,Unknown,2,Unknown,Unknown,Credit,Unknown,Crédit du Nord,Unknown,915096310.0
28/02/2021,33,Unknown,33,Unknown,Unknown,Unknown,DENTREPRISE,SOCIETE GENERALE RELEVÉ DE COMPTE,-33.0
31/03/2021,28,Unknown,28,Unknown,Unknown,Unknown,DENTREPRISE,Page 1/8,-61.0
01/03/2020,02,Unknown,02,Unknown,Unknown,Unknown,DENTREPRISE,nternet,-63.0
Unknown,31,Unknown,31,Unknown,Unknown,Unknown,DENTREPRISE,prolessionnels socleteoencrale,-94.0
Unknown,03,Unknown,03,Unknown,Unknown,Unknown,DENTREPRISE,IAppli,-97.0
Unknown,3,Unknown,3,Unknown,Unknown,Unknown,DENTREPRISE,copel he &,-100.0
Unknown,1,Unknown,1,Unknown,Unknown,Unknown,DENTREPRISE,Votre agence,-101.0
Unknown,8,Unknown,8,Unknown,Unknown,Unknown,DENTREPRISE,ANNECY partelephone,-109.0
Unknown,0,Unknown,0,Unknown,Unknown,Unknown,DENTREPRISE,RUE ROYALE,-109.0
Unknown,04 50,Unknown,04 50,Unknown,Unknown,Unknown,DENTREPRISE,ANNECY,-559.0
Unknown,33 57,Unknown,33 57,Unknown,Unknown,Unknown,DENTREPRISE,Isabelle money@socoen com,-3916.0
Unknown,50,Unknown,50,Unknown,Unknown,Unknown,DENTREPRISE,opération SolDE,-3966.0
Unknown,04 50,Unknown,04 50,Unknown,Unknown,Unknown,DENTREPRISE,ReMISE,-4416.0
Unknown,10 90,Unknown,10 90,Unknown,Unknown,Unknown,DENTREPRISE,R35,-5506.0
Unknown,53,Unknown,53,Unknown,Unknown,Unknown,DENTREPRISE,COM,-5559.0
Unknown,98,Unknown,98,Unknown,Unknown,Unknown,DENTREPRISE,ReMISE,-5657.0
Unknown,04 50,Unknown,04 50,Unknown,Unknown,Unknown,DENTREPRISE,CoM 2 46e 01/032021,-6107.0
Unknown,33 57,Unknown,33 57,Unknown,Unknown,Unknown,DENTREPRISE,ReMISE,-9464.0
Unknown,2,Unknown,2,Unknown,Unknown,Unknown,DENTREPRISE,R63,-9466.0
Unknown,01,Unknown,01,Unknown,Unknown,Unknown,DENTREPRISE,CoM,-9467.0
Unknown,01,Unknown,01,Unknown,Unknown,Unknown,DENTREPRISE,ReMISE,-9468.0
Unknown,33,Unknown,33,Unknown,Unknown,Unknown,DENTREPRISE,CoM,-9501.0
Unknown,569,Unknown,569,Unknown,Unknown,Unknown,DENTREPRISE,ReMISE,-10070.0
Unknown,01,Unknown,01,Unknown,Unknown,Unknown,DENTREPRISE,"R65659 C13600,38501 BT 555",-10071.0
Unknown,01,Unknown,01,Unknown,Unknown,Unknown,DENTREPRISE,COM,-10072.0
Unknown,722,Unknown,722,Unknown,Unknown,Unknown,DENTREPRISE,ReMISE,-10794.0
Unknown,2,Unknown,2,Unknown,Unknown,Unknown,DENTREPRISE,"R65792 C13600,38501 BT",-10796.0
Unknown,01,Unknown,01,Unknown,Unknown,Unknown,DENTREPRISE,CoM 2,-10797.0
Unknown,01,Unknown,01,Unknown,Unknown,Unknown,DENTREPRISE,CARTE X2609,-10798.0
Unknown,78,Unknown,78,Unknown,Unknown,Unknown,DENTREPRISE,ThUSHYANTHAN DOUBLE,-10876.0
Unknown,736,Unknown,736,Unknown,Unknown,Unknown,DENTREPRISE,CoM 0 98E 02/032021 Q032021 ReMISE,-11612.0
Unknown,2,Unknown,2,Unknown,Unknown,Unknown,DENTREPRISE,CoM,-11614.0
Unknown,01,Unknown,01,Unknown,Unknown,Unknown,DENTREPRISE,ANUELLE CARTE,-11615.0
Unknown,01,Unknown,01,Unknown,Unknown,Unknown,DENTREPRISE,CIONS,-11616.0
Unknown,598,Unknown,598,Unknown,Unknown,Unknown,DENTREPRISE,TENUE DE CoMPTE AU,-12214.0
Unknown,01,Unknown,01,Unknown,Unknown,Unknown,DENTREPRISE,Cuito2 Depurs,-12215.0
Unknown,01,Unknown,01,Unknown,Unknown,Unknown,DENTREPRISE,tartt,-12216.0
Unknown,555,Unknown,555,Unknown,Unknown,Unknown,DENTREPRISE,Insatislaction OU,-12771.0
Unknown,01,Unknown,01,Unknown,Unknown,Unknown,DENTREPRISE,VOUs,-12772.0
Unknown,01,Unknown,01,Unknown,Unknown,Unknown,DENTREPRISE,Panis ceder18,-12773.0
Unknown,654,Unknown,654,Unknown,Unknown,Unknown,DENTREPRISE,Le Mediateurendemierrecours,-13427.0
Unknown,2,Unknown,2,Unknown,Unknown,Unknown,DENTREPRISE,Soaete Gencralendressantun,-13429.0
Unknown,01,Unknown,01,Unknown,Unknown,Unknown,DENTREPRISE,Le Aduleu,-13430.0
Unknown,01,Unknown,01,Unknown,Unknown,Unknown,DENTREPRISE,Sootte Gencrale,-13431.0
Unknown,26,Unknown,26,Unknown,Unknown,Unknown,DENTREPRISE,Valmny,-13457.0
Unknown,02,Unknown,02,Unknown,Unknown,Unknown,DENTREPRISE,Par L Deknse ceda 7 oupi,-13459.0
Unknown,02,Unknown,02,Unknown,Unknown,Unknown,DENTREPRISE,sie nlernet Qu,-13461.0
Unknown,01,Unknown,01,Unknown,Unknown,Unknown,DENTREPRISE,Ir LeMduleu,-13462.0
Unknown,2,Unknown,2,Unknown,Unknown,Unknown,DENTREPRISE,dosskf,-13464.0
Unknown,548,Unknown,548,Unknown,Unknown,Unknown,DENTREPRISE,So0,-14012.0
Unknown,35 567,Unknown,35 567,Unknown,Unknown,Unknown,DENTREPRISE,Unknown,-49579.0
Unknown,"13 719,61",Unknown,"13 719,61",Unknown,Unknown,Unknown,DENTREPRISE,Unknown,-1421540.0
Unknown,734,Unknown,734,Unknown,Unknown,Unknown,DENTREPRISE,Unknown,-1422274.0
Unknown,3 596,Unknown,3 596,Unknown,Unknown,Unknown,DENTREPRISE,Unknown,-1425870.0
Unknown,"73 554,01",Unknown,"73 554,01",Unknown,Unknown,Unknown,DENTREPRISE,Unknown,-8781271.0
Unknown,652 48,Unknown,652 48,Unknown,Unknown,Unknown,DENTREPRISE,Unknown,-8846519.0
Unknown,"73,10",Unknown,"73,10",Unknown,Unknown,Unknown,DENTREPRISE,Unknown,-8853829.0
Unknown,36,Unknown,36,Unknown,Unknown,Unknown,DENTREPRISE,Unknown,-8853865.0
Unknown,49 02,Unknown,49 02,Unknown,Unknown,Unknown,DENTREPRISE,Unknown,-8858767.0
Unknown,289,Unknown,289,Unknown,Unknown,Unknown,DENTREPRISE,Unknown,-8859056.0
Unknown,0,Unknown,0,Unknown,Unknown,Unknown,DENTREPRISE,Unknown,-8859056.0
Unknown,02,Unknown,02,Unknown,Unknown,Unknown,DENTREPRISE,Unknown,-8859058.0
Unknown,425,Unknown,425,Unknown,Unknown,Unknown,DENTREPRISE,Unknown,-8859483.0
Unknown,02,Unknown,02,Unknown,Unknown,Unknown,DENTREPRISE,Unknown,-8859485.0
Unknown,01,Unknown,01,Unknown,Unknown,Unknown,DENTREPRISE,Unknown,-8859486.0
Unknown,02,Unknown,02,Unknown,Unknown,Unknown,DENTREPRISE,Unknown,-8859488.0
Unknown,"38,73",Unknown,"38,73",Unknown,Unknown,Unknown,DENTREPRISE,Unknown,-8863361.0
Unknown,02,Unknown,02,Unknown,Unknown,Unknown,DENTREPRISE,Unknown,-8863363.0
Unknown,288,Unknown,288,Unknown,Unknown,Unknown,DENTREPRISE,Unknown,-8863651.0
Unknown,423,Unknown,423,Unknown,Unknown,Unknown,DENTREPRISE,Unknown,-8864074.0
Unknown,6 12,Unknown,6 12,Unknown,Unknown,Unknown,DENTREPRISE,Unknown,-8864686.0
Unknown,00,Unknown,00,Unknown,Unknown,Unknown,DENTREPRISE,Unknown,-8864686.0
Unknown,"38,73",Unknown,"38,73",Unknown,Unknown,Unknown,DENTREPRISE,Unknown,-8868559.0
Unknown,10,Unknown,10,Unknown,Unknown,Unknown,DENTREPRISE,Unknown,-8868569.0
Unknown,25,Unknown,25,Unknown,Unknown,Unknown,DENTREPRISE,Unknown,-8868594.0
Unknown,33,Unknown,33,Unknown,Unknown,Unknown,DENTREPRISE,Unknown,-8868627.0
Unknown,1 76,Unknown,1 76,Unknown,Unknown,Unknown,DENTREPRISE,Unknown,-8868803.0
Unknown,01,Unknown,01,Unknown,Unknown,Unknown,DENTREPRISE,Unknown,-8868804.0
Unknown,03,Unknown,03,Unknown,Unknown,Unknown,DENTREPRISE,Unknown,-8868807.0
Unknown,17,Unknown,17,Unknown,Unknown,Unknown,DENTREPRISE,Unknown,-8868824.0
Unknown,7,Unknown,7,Unknown,Unknown,Unknown,DENTREPRISE,Unknown,-8868831.0
Unknown,552,Unknown,552,Unknown,Unknown,Unknown,DENTREPRISE,Unknown,-8869383.0
Unknown,367,Unknown,367,Unknown,Unknown,Unknown,DENTREPRISE,Unknown,-8869750.0
Unknown,25,Unknown,25,Unknown,Unknown,Unknown,DENTREPRISE,Unknown,-8869775.0
Unknown,1,Unknown,1,Unknown,Unknown,Unknown,DENTREPRISE,Unknown,-8869776.0
01/08/2021,33,Unknown,33,Unknown,Unknown,Unknown,DENTREPRISE,SOCIETE GENERALE RELEVÉ DE COMPTE,-33.0
31/08/2021,01,Unknown,01,Unknown,Unknown,Unknown,DENTREPRISE,n'8,-34.0
28/08/2021,08,Unknown,08,Unknown,Unknown,Unknown,DENTREPRISE,Page 1/8 VOS CONTACTS Votre Banque,-42.0
31/07/2021,31,Unknown,31,Unknown,Unknown,Unknown,DENTREPRISE,nternet,-73.0
01/03/2020,08,Unknown,08,Unknown,Unknown,Unknown,DENTREPRISE,prolessionnels socleteoencrale,-81.0
Unknown,8,Unknown,8,Unknown,Unknown,Unknown,DENTREPRISE,IAppli,-89.0
Unknown,1,Unknown,1,Unknown,Unknown,Unknown,DENTREPRISE,execubon,-90.0
Unknown,8,Unknown,8,Unknown,Unknown,Unknown,DENTREPRISE,appelnon surtare,-98.0
Unknown,0,Unknown,0,Unknown,Unknown,Unknown,DENTREPRISE,ANNECY partelephone,-98.0
Unknown,04 50,Unknown,04 50,Unknown,Unknown,Unknown,DENTREPRISE,ax,-548.0
Unknown,33 57,Unknown,33 57,Unknown,Unknown,Unknown,DENTREPRISE,RUE ROYALE,-3905.0
Unknown,50,Unknown,50,Unknown,Unknown,Unknown,DENTREPRISE,Isabelle money@socoen com,-3955.0
Unknown,04 50,Unknown,04 50,Unknown,Unknown,Unknown,DENTREPRISE,P06 INFO CHEQUIER,-4405.0
Unknown,10 90,Unknown,10 90,Unknown,Unknown,Unknown,DENTREPRISE,ANNECY,-5495.0
Unknown,53,Unknown,53,Unknown,Unknown,Unknown,DENTREPRISE,RELEVÉ DES OPÉRATIONS,-5548.0
Unknown,98,Unknown,98,Unknown,Unknown,Unknown,DENTREPRISE,opération SolDE,-5646.0
Unknown,04 50,Unknown,04 50,Unknown,Unknown,Unknown,DENTREPRISE,"R3032 C13600,38501",-6096.0
Unknown,33 57,Unknown,33 57,Unknown,Unknown,Unknown,DENTREPRISE,CoM,-9453.0
Unknown,2,Unknown,2,Unknown,Unknown,Unknown,DENTREPRISE,S8e CoM,-9455.0
Unknown,28,Unknown,28,Unknown,Unknown,Unknown,DENTREPRISE,CoM,-9483.0
Unknown,08,Unknown,08,Unknown,Unknown,Unknown,DENTREPRISE,007 R3o9,-9491.0
Unknown,31,Unknown,31,Unknown,Unknown,Unknown,DENTREPRISE,"R47216 C13600,38501 BT 912 9E",-9522.0
Unknown,07,Unknown,07,Unknown,Unknown,Unknown,DENTREPRISE,CoM 3,-9529.0
Unknown,02,Unknown,02,Unknown,Unknown,Unknown,DENTREPRISE,"R48228 C13600,38501",-9531.0
Unknown,01,Unknown,01,Unknown,Unknown,Unknown,DENTREPRISE,"CoM 2,75E",-9532.0
Unknown,08,Unknown,08,Unknown,Unknown,Unknown,DENTREPRISE,CoM 0,-9540.0
Unknown,365,Unknown,365,Unknown,Unknown,Unknown,DENTREPRISE,BQ CEPACPT,-9905.0
Unknown,02,Unknown,02,Unknown,Unknown,Unknown,DENTREPRISE,ReMise,-9907.0
Unknown,01,Unknown,01,Unknown,Unknown,Unknown,DENTREPRISE,CEPAFRPPASO,-9908.0
Unknown,08,Unknown,08,Unknown,Unknown,Unknown,DENTREPRISE,PReLEVEMENT EUROPEEN 3012809104 DE,-9916.0
Unknown,813,Unknown,813,Unknown,Unknown,Unknown,DENTREPRISE,MADAT,-10729.0
Unknown,2,Unknown,2,Unknown,Unknown,Unknown,DENTREPRISE,Cuito2 Depurs,-10731.0
Unknown,02,Unknown,02,Unknown,Unknown,Unknown,DENTREPRISE,tartt,-10733.0
Unknown,007,Unknown,007,Unknown,Unknown,Unknown,DENTREPRISE,Insatislaction OU,-10740.0
Unknown,627,Unknown,627,Unknown,Unknown,Unknown,DENTREPRISE,VOUs,-11367.0
Unknown,2,Unknown,2,Unknown,Unknown,Unknown,DENTREPRISE,Pans ceder18 Tel,-11369.0
Unknown,02,Unknown,02,Unknown,Unknown,Unknown,DENTREPRISE,Le Mediateurendemierrecours,-11371.0
Unknown,007,Unknown,007,Unknown,Unknown,Unknown,DENTREPRISE,Soaete Gencralendressantun,-11378.0
Unknown,341,Unknown,341,Unknown,Unknown,Unknown,DENTREPRISE,Le Aeduleu aupesde,-11719.0
Unknown,02,Unknown,02,Unknown,Unknown,Unknown,DENTREPRISE,Deknse Ceda,-11721.0
Unknown,912,Unknown,912,Unknown,Unknown,Unknown,DENTREPRISE,sie nlernet Qu,-12633.0
Unknown,3,Unknown,3,Unknown,Unknown,Unknown,DENTREPRISE,WMW mneduleu,-12636.0
Unknown,02,Unknown,02,Unknown,Unknown,Unknown,DENTREPRISE,Ir LeMeduleu,-12638.0
Unknown,808,Unknown,808,Unknown,Unknown,Unknown,DENTREPRISE,dosskf,-13446.0
Unknown,2,Unknown,2,Unknown,Unknown,Unknown,DENTREPRISE,So0,-13448.0
Unknown,02,Unknown,02,Unknown,Unknown,Unknown,DENTREPRISE,Unknown,-13450.0
Unknown,45,Unknown,45,Unknown,Unknown,Unknown,DENTREPRISE,Unknown,-13495.0
Unknown,0,Unknown,0,Unknown,Unknown,Unknown,DENTREPRISE,Unknown,-13495.0
Unknown,02,Unknown,02,Unknown,Unknown,Unknown,DENTREPRISE,Unknown,-13497.0
Unknown,05 23,Unknown,05 23,Unknown,Unknown,Unknown,DENTREPRISE,Unknown,-14020.0
Unknown,02,Unknown,02,Unknown,Unknown,Unknown,DENTREPRISE,Unknown,-14022.0
Unknown,"2.681,27",Unknown,"2.681,27",Unknown,Unknown,Unknown,DENTREPRISE,Unknown,-14024.68127
Unknown,"364,01",Unknown,"364,01",Unknown,Unknown,Unknown,DENTREPRISE,Unknown,-50425.68127
Unknown,810 77,Unknown,810 77,Unknown,Unknown,Unknown,DENTREPRISE,Unknown,-131502.68127
Unknown,625,Unknown,625,Unknown,Unknown,Unknown,DENTREPRISE,Unknown,-132127.68127
Unknown,"6 310,28",Unknown,"6 310,28",Unknown,Unknown,Unknown,DENTREPRISE,Unknown,-763155.6812700001
Unknown,"909,45",Unknown,"909,45",Unknown,Unknown,Unknown,DENTREPRISE,Unknown,-854100.6812700001
Unknown,805 70,Unknown,805 70,Unknown,Unknown,Unknown,DENTREPRISE,Unknown,-934670.68127
Unknown,45 74,Unknown,45 74,Unknown,Unknown,Unknown,DENTREPRISE,Unknown,-939244.68127
Unknown,"6 480,00",Unknown,"6 480,00",Unknown,Unknown,Unknown,DENTREPRISE,Unknown,-1587244.68127
Unknown,68 40,Unknown,68 40,Unknown,Unknown,Unknown,DENTREPRISE,Unknown,-1594084.68127
Unknown,33,Unknown,33,Unknown,Unknown,Unknown,DENTREPRISE,Unknown,-1594117.68127
Unknown,1 76,Unknown,1 76,Unknown,Unknown,Unknown,DENTREPRISE,Unknown,-1594293.68127
Unknown,01,Unknown,01,Unknown,Unknown,Unknown,DENTREPRISE,Unknown,-1594294.68127
Unknown,03,Unknown,03,Unknown,Unknown,Unknown,DENTREPRISE,Unknown,-1594297.68127
Unknown,17,Unknown,17,Unknown,Unknown,Unknown,DENTREPRISE,Unknown,-1594314.68127
Unknown,7,Unknown,7,Unknown,Unknown,Unknown,DENTREPRISE,Unknown,-1594321.68127
Unknown,552,Unknown,552,Unknown,Unknown,Unknown,DENTREPRISE,Unknown,-1594873.68127
Unknown,367,Unknown,367,Unknown,Unknown,Unknown,DENTREPRISE,Unknown,-1595240.68127
Unknown,25,Unknown,25,Unknown,Unknown,Unknown,DENTREPRISE,Unknown,-1595265.68127
Unknown,1,Unknown,1,Unknown,Unknown,Unknown,DENTREPRISE,Unknown,-1595266.68127
01/09/2021,33,Unknown,33,Unknown,Cheque,Unknown,DENTREPRISE,SOCIETE GENERALE RELEVÉ DE COMPTE,-33.0
30/09/2021,01,Unknown,01,Unknown,Cheque,Unknown,DENTREPRISE,Page 1/8 VOS CONTACTS Votre Banque,-34.0
01/03/2020,09,Unknown,09,Unknown,Cheque,Unknown,DENTREPRISE,nternet,-43.0
Unknown,30,Unknown,30,Unknown,Cheque,Unknown,DENTREPRISE,prolessionnels socleteoencrale,-73.0
Unknown,09,Unknown,09,Unknown,Cheque,Unknown,DENTREPRISE,IAppli,-82.0
Unknown,9,Unknown,9,Unknown,Cheque,Unknown,DENTREPRISE,execubon,-91.0
Unknown,1,Unknown,1,Unknown,Cheque,Unknown,DENTREPRISE,appelnon surtare,-92.0
Unknown,8,Unknown,8,Unknown,Cheque,Unknown,DENTREPRISE,ANNECY partelephone,-100.0
Unknown,0,Unknown,0,Unknown,Cheque,Unknown,DENTREPRISE,ax,-100.0
Unknown,04 50,Unknown,04 50,Unknown,Cheque,Unknown,DENTREPRISE,RUE ROYALE,-550.0
Unknown,33 57,Unknown,33 57,Unknown,Cheque,Unknown,DENTREPRISE,Isabelle money@socoen com,-3907.0
Unknown,50,Unknown,50,Unknown,Cheque,Unknown,DENTREPRISE,opération SolDE,-3957.0
Unknown,04 50,Unknown,04 50,Unknown,Cheque,Unknown,DENTREPRISE,Alne CY Av De Geneve,-4407.0
Unknown,10 90,Unknown,10 90,Unknown,Cheque,Unknown,DENTREPRISE,ReMISE,-5497.0
Unknown,53,Unknown,53,Unknown,Cheque,Unknown,DENTREPRISE,ReMISE,-5550.0
Unknown,98,Unknown,98,Unknown,Cheque,Unknown,DENTREPRISE,"R85777 C13600,38501 BT 685 SE CoM",-5648.0
Unknown,04 50,Unknown,04 50,Unknown,Cheque,Unknown,DENTREPRISE,BQ CRLY CPT,-6098.0
Unknown,33 57,Unknown,33 57,Unknown,Cheque,Unknown,DENTREPRISE,DATE,-9455.0
Unknown,2,Unknown,2,Unknown,Cheque,Unknown,DENTREPRISE,CRLYFRPPXXX,-9457.0
Unknown,31,Unknown,31,Unknown,Cheque,Unknown,DENTREPRISE,CARTE,-9488.0
Unknown,01,Unknown,01,Unknown,Cheque,Unknown,DENTREPRISE,AREA,-9489.0
Unknown,01,Unknown,01,Unknown,Cheque,Unknown,DENTREPRISE,PRLVEUROPEEN,-9490.0
Unknown,01,Unknown,01,Unknown,Cheque,Unknown,DENTREPRISE,B28 6205321557 DE BimaTooCoNSEIL ID FR59Z,-9491.0
Unknown,01,Unknown,01,Unknown,Cheque,Unknown,DENTREPRISE,MotifNnecyseptembre,-9492.0
Unknown,01,Unknown,01,Unknown,Cheque,Unknown,DENTREPRISE,MARCHE MADAT AMARCHE21,-9493.0
Unknown,31,Unknown,31,Unknown,Cheque,Unknown,DENTREPRISE,Q092021 ReMISE,-9524.0
Unknown,08,Unknown,08,Unknown,Cheque,Unknown,DENTREPRISE,R00593 C13600438501,-9532.0
Unknown,965,Unknown,965,Unknown,Cheque,Unknown,DENTREPRISE,CoM,-10497.0
Unknown,6,Unknown,6,Unknown,Cheque,Unknown,DENTREPRISE,ChEQUE 202 Pnementchon 202 Débit Crédit,-10503.0
Unknown,01,Unknown,01,Unknown,Cheque,Unknown,DENTREPRISE,uito2 Depurs,-10504.0
Unknown,01,Unknown,01,Unknown,Cheque,Unknown,DENTREPRISE,tartt,-10505.0
Unknown,31,Unknown,31,Unknown,Cheque,Unknown,DENTREPRISE,Insatislaction OU,-10536.0
Unknown,08,Unknown,08,Unknown,Cheque,Unknown,DENTREPRISE,VOUs,-10544.0
Unknown,685,Unknown,685,Unknown,Cheque,Unknown,DENTREPRISE,Pans ceder18 Tel,-11229.0
Unknown,2,Unknown,2,Unknown,Cheque,Unknown,DENTREPRISE,Le Mediateurendemierrecours,-11231.0
Unknown,01,Unknown,01,Unknown,Cheque,Unknown,DENTREPRISE,Soaete Gencralendressantun,-11232.0
Unknown,01,Unknown,01,Unknown,Cheque,Unknown,DENTREPRISE,Le Aeduleu aupesde,-11233.0
Unknown,11 46,Unknown,11 46,Unknown,Cheque,Unknown,DENTREPRISE,Deknse Ceda,-12379.0
Unknown,01,Unknown,01,Unknown,Cheque,Unknown,DENTREPRISE,sie nlernet Qu,-12380.0
Unknown,205 01,Unknown,205 01,Unknown,Cheque,Unknown,DENTREPRISE,WMW mneduleu,-32881.0
Unknown,30,Unknown,30,Unknown,Cheque,Unknown,DENTREPRISE,Ir LeMeduleu,-32911.0
Unknown,08,Unknown,08,Unknown,Cheque,Unknown,DENTREPRISE,dosskf,-32919.0
Unknown,01,Unknown,01,Unknown,Cheque,Unknown,DENTREPRISE,So0,-32920.0
Unknown,01,Unknown,01,Unknown,Cheque,Unknown,DENTREPRISE,Unknown,-32921.0
Unknown,02,Unknown,02,Unknown,Cheque,Unknown,DENTREPRISE,Unknown,-32923.0
Unknown,01,Unknown,01,Unknown,Cheque,Unknown,DENTREPRISE,Unknown,-32924.0
Unknown,09,Unknown,09,Unknown,Cheque,Unknown,DENTREPRISE,Unknown,-32933.0
Unknown,496,Unknown,496,Unknown,Cheque,Unknown,DENTREPRISE,Unknown,-33429.0
Unknown,02,Unknown,02,Unknown,Cheque,Unknown,DENTREPRISE,Unknown,-33431.0
Unknown,3,Unknown,3,Unknown,Cheque,Unknown,DENTREPRISE,Unknown,-33434.0
Unknown,02,Unknown,02,Unknown,Cheque,Unknown,DENTREPRISE,Unknown,-33436.0
Unknown,01,Unknown,01,Unknown,Cheque,Unknown,DENTREPRISE,Unknown,-33437.0
Unknown,202,Unknown,202,Unknown,Cheque,Unknown,DENTREPRISE,Unknown,-33639.0
Unknown,202,Unknown,202,Unknown,Cheque,Unknown,DENTREPRISE,Unknown,-33841.0
Unknown,135,Unknown,135,Unknown,Cheque,Unknown,DENTREPRISE,Unknown,-33976.0
Unknown,92 850,Unknown,92 850,Unknown,Cheque,Unknown,DENTREPRISE,Unknown,-126826.0
Unknown,0 959,Unknown,0 959,Unknown,Cheque,Unknown,DENTREPRISE,Unknown,-127785.0
Unknown,0 683 10,Unknown,0 683 10,Unknown,Cheque,Unknown,DENTREPRISE,Unknown,-196095.0
Unknown,"915,96",Unknown,"915,96",Unknown,Cheque,Unknown,DENTREPRISE,Unknown,-287691.0
Unknown,"761,61",Unknown,"761,61",Unknown,Cheque,Unknown,DENTREPRISE,Unknown,-363852.0
Unknown,"4,40",Unknown,"4,40",Unknown,Cheque,Unknown,DENTREPRISE,Unknown,-364292.0
Unknown,"200,00",Unknown,"200,00",Unknown,Cheque,Unknown,DENTREPRISE,Unknown,-384292.0
Unknown,494,Unknown,494,Unknown,Cheque,Unknown,DENTREPRISE,Unknown,-384786.0
Unknown,76,Unknown,76,Unknown,Cheque,Unknown,DENTREPRISE,Unknown,-384862.0
Unknown,1,Unknown,1,Unknown,Cheque,Unknown,DENTREPRISE,Unknown,-384863.0
Unknown,14,Unknown,14,Unknown,Cheque,Unknown,DENTREPRISE,Unknown,-384877.0
Unknown,33,Unknown,33,Unknown,Cheque,Unknown,DENTREPRISE,Unknown,-384910.0
Unknown,1 76,Unknown,1 76,Unknown,Cheque,Unknown,DENTREPRISE,Unknown,-385086.0
Unknown,01,Unknown,01,Unknown,Cheque,Unknown,DENTREPRISE,Unknown,-385087.0
Unknown,03,Unknown,03,Unknown,Cheque,Unknown,DENTREPRISE,Unknown,-385090.0
Unknown,17,Unknown,17,Unknown,Cheque,Unknown,DENTREPRISE,Unknown,-385107.0
Unknown,7,Unknown,7,Unknown,Cheque,Unknown,DENTREPRISE,Unknown,-385114.0
Unknown,552,Unknown,552,Unknown,Cheque,Unknown,DENTREPRISE,Unknown,-385666.0
Unknown,367,Unknown,367,Unknown,Cheque,Unknown,DENTREPRISE,Unknown,-386033.0
Unknown,25,Unknown,25,Unknown,Cheque,Unknown,DENTREPRISE,Unknown,-386058.0
Unknown,1,Unknown,1,Unknown,Cheque,Unknown,DENTREPRISE,Unknown,-386059.0
01/12/2021,33,Unknown,33,Unknown,Cheque,Unknown,DENTREPRISE,SOCIETE GENERALE RELEVÉ DE COMPTE,-33.0
31/12/2021,01,Unknown,01,Unknown,Cheque,Unknown,DENTREPRISE,n'12 Page,-34.0
30/11/2021,12,Unknown,12,Unknown,Cheque,Unknown,DENTREPRISE,nternet,-46.0
01/12/2021,31,Unknown,31,Unknown,Cheque,Unknown,DENTREPRISE,prolessionnels socleteoencrale,-77.0
01/12/2021,12,Unknown,12,Unknown,Cheque,Unknown,DENTREPRISE,IAppli,-89.0
01/12/2021,12,Unknown,12,Unknown,Cheque,Unknown,DENTREPRISE,execubon,-101.0
01/12/2021,1,Unknown,1,Unknown,Cheque,Unknown,DENTREPRISE,appelnon surtare,-102.0
29/11/2021,9,Unknown,9,Unknown,Cheque,Unknown,DENTREPRISE,ANNECY partelephone,-111.0
01/03/2020,0,Unknown,0,Unknown,Cheque,Unknown,DENTREPRISE,ax,-111.0
Unknown,04 50,Unknown,04 50,Unknown,Cheque,Unknown,DENTREPRISE,RUE ROYALE,-561.0
Unknown,33 57,Unknown,33 57,Unknown,Cheque,Unknown,DENTREPRISE,Isabelle money@socoen com,-3918.0
Unknown,50,Unknown,50,Unknown,Cheque,Unknown,DENTREPRISE,opération SolDE,-3968.0
Unknown,04 50,Unknown,04 50,Unknown,Cheque,Unknown,DENTREPRISE,GAB,-4418.0
Unknown,10 90,Unknown,10 90,Unknown,Cheque,Unknown,DENTREPRISE,Alne CY Av De Geneve,-5508.0
Unknown,53,Unknown,53,Unknown,Cheque,Unknown,DENTREPRISE,"R99692 C13600,38501 BT 327",-5561.0
Unknown,98,Unknown,98,Unknown,Cheque,Unknown,DENTREPRISE,COM Me,-5659.0
Unknown,04 50,Unknown,04 50,Unknown,Cheque,Unknown,DENTREPRISE,"R99718 C13600,38501 BT 583 19E",-6109.0
Unknown,33 57,Unknown,33 57,Unknown,Cheque,Unknown,DENTREPRISE,CoM,-9466.0
Unknown,2,Unknown,2,Unknown,Cheque,Unknown,DENTREPRISE,POUR Eurodel,-9468.0
Unknown,30,Unknown,30,Unknown,Cheque,Unknown,DENTREPRISE,BQ,-9498.0
Unknown,11,Unknown,11,Unknown,Cheque,Unknown,DENTREPRISE,CMCI CPT 00020123901 DATE,-9509.0
Unknown,01,Unknown,01,Unknown,Cheque,Unknown,DENTREPRISE,INSTATANEEMiSNet,-9510.0
Unknown,01,Unknown,01,Unknown,Cheque,Unknown,DENTREPRISE,BQ CMCI CPT 00020123901 DATE,-9511.0
Unknown,01,Unknown,01,Unknown,Cheque,Unknown,DENTREPRISE,REMISE,-9512.0
Unknown,01,Unknown,01,Unknown,Cheque,Unknown,DENTREPRISE,Ref,-9513.0
Unknown,01,Unknown,01,Unknown,Cheque,Unknown,DENTREPRISE,MOTIF Facture,-9514.0
Unknown,0,Unknown,0,Unknown,Cheque,Unknown,DENTREPRISE,CMCIFRPPXXX,-9514.0
Unknown,11,Unknown,11,Unknown,Cheque,Unknown,DENTREPRISE,ChEQUE 194 01/122021/ 30/112021 ChEQUE 195,-9525.0
Unknown,327,Unknown,327,Unknown,Cheque,Unknown,DENTREPRISE,Remise C8,-9852.0
Unknown,01,Unknown,01,Unknown,Cheque,Unknown,DENTREPRISE,COM,-9853.0
Unknown,01,Unknown,01,Unknown,Cheque,Unknown,DENTREPRISE,"C13600,38501 BT 397",-9854.0
Unknown,0,Unknown,0,Unknown,Cheque,Unknown,DENTREPRISE,tartt,-9854.0
Unknown,11,Unknown,11,Unknown,Cheque,Unknown,DENTREPRISE,Insatislaction OU,-9865.0
Unknown,583,Unknown,583,Unknown,Cheque,Unknown,DENTREPRISE,VOUs,-10448.0
Unknown,01,Unknown,01,Unknown,Cheque,Unknown,DENTREPRISE,Panis ceder18,-10449.0
Unknown,01,Unknown,01,Unknown,Cheque,Unknown,DENTREPRISE,Le Mediateurendemierrecours,-10450.0
Unknown,01,Unknown,01,Unknown,Cheque,Unknown,DENTREPRISE,Soaete Gencralendressantun,-10451.0
Unknown,12,Unknown,12,Unknown,Cheque,Unknown,DENTREPRISE,Le Aeduleu aupesde,-10463.0
Unknown,12 19,Unknown,12 19,Unknown,Cheque,Unknown,DENTREPRISE,Deknse Ceda,-11682.0
Unknown,01,Unknown,01,Unknown,Cheque,Unknown,DENTREPRISE,sie nlernet Qu,-11683.0
Unknown,12,Unknown,12,Unknown,Cheque,Unknown,DENTREPRISE,WMW mneduleu,-11695.0
Unknown,01,Unknown,01,Unknown,Cheque,Unknown,DENTREPRISE,Ir LeMeduleu,-11696.0
Unknown,12,Unknown,12,Unknown,Cheque,Unknown,DENTREPRISE,dosskf,-11708.0
Unknown,01,Unknown,01,Unknown,Cheque,Unknown,DENTREPRISE,So0,-11709.0
Unknown,12,Unknown,12,Unknown,Cheque,Unknown,DENTREPRISE,Unknown,-11721.0
Unknown,12 20,Unknown,12 20,Unknown,Cheque,Unknown,DENTREPRISE,Unknown,-12941.0
Unknown,01,Unknown,01,Unknown,Cheque,Unknown,DENTREPRISE,Unknown,-12942.0
Unknown,29,Unknown,29,Unknown,Cheque,Unknown,DENTREPRISE,Unknown,-12971.0
Unknown,11,Unknown,11,Unknown,Cheque,Unknown,DENTREPRISE,Unknown,-12982.0
Unknown,194 01,Unknown,194 01,Unknown,Cheque,Unknown,DENTREPRISE,Unknown,-32383.0
Unknown,30,Unknown,30,Unknown,Cheque,Unknown,DENTREPRISE,Unknown,-32413.0
Unknown,195 02,Unknown,195 02,Unknown,Cheque,Unknown,DENTREPRISE,Unknown,-51915.0
Unknown,01,Unknown,01,Unknown,Cheque,Unknown,DENTREPRISE,Unknown,-51916.0
Unknown,12,Unknown,12,Unknown,Cheque,Unknown,DENTREPRISE,Unknown,-51928.0
Unknown,30,Unknown,30,Unknown,Cheque,Unknown,DENTREPRISE,Unknown,-51958.0
Unknown,02,Unknown,02,Unknown,Cheque,Unknown,DENTREPRISE,Unknown,-51960.0
Unknown,01,Unknown,01,Unknown,Cheque,Unknown,DENTREPRISE,Unknown,-51961.0
Unknown,12,Unknown,12,Unknown,Cheque,Unknown,DENTREPRISE,Unknown,-51973.0
Unknown,397,Unknown,397,Unknown,Cheque,Unknown,DENTREPRISE,Unknown,-52370.0
Unknown,"781,26",Unknown,"781,26",Unknown,Cheque,Unknown,DENTREPRISE,Unknown,-130496.0
Unknown,5 590,Unknown,5 590,Unknown,Cheque,Unknown,DENTREPRISE,Unknown,-136086.0
Unknown,0 326,Unknown,0 326,Unknown,Cheque,Unknown,DENTREPRISE,Unknown,-136412.0
Unknown,"5 581,21",Unknown,"5 581,21",Unknown,Cheque,Unknown,DENTREPRISE,Unknown,-694533.0
Unknown,"2 849,09",Unknown,"2 849,09",Unknown,Cheque,Unknown,DENTREPRISE,Unknown,-979442.0
Unknown,"2 221,07",Unknown,"2 221,07",Unknown,Cheque,Unknown,DENTREPRISE,Unknown,-1201549.0
Unknown,"1 122,60",Unknown,"1 122,60",Unknown,Cheque,Unknown,DENTREPRISE,Unknown,-1313809.0
Unknown,"536,08",Unknown,"536,08",Unknown,Cheque,Unknown,DENTREPRISE,Unknown,-1367417.0
Unknown,338,Unknown,338,Unknown,Cheque,Unknown,DENTREPRISE,Unknown,-1367755.0
Unknown,9 395 73,Unknown,9 395 73,Unknown,Cheque,Unknown,DENTREPRISE,Unknown,-2307328.0
Unknown,33,Unknown,33,Unknown,Cheque,Unknown,DENTREPRISE,Unknown,-2307361.0
Unknown,1 76,Unknown,1 76,Unknown,Cheque,Unknown,DENTREPRISE,Unknown,-2307537.0
Unknown,01,Unknown,01,Unknown,Cheque,Unknown,DENTREPRISE,Unknown,-2307538.0
Unknown,03,Unknown,03,Unknown,Cheque,Unknown,DENTREPRISE,Unknown,-2307541.0
Unknown,17,Unknown,17,Unknown,Cheque,Unknown,DENTREPRISE,Unknown,-2307558.0
Unknown,7,Unknown,7,Unknown,Cheque,Unknown,DENTREPRISE,Unknown,-2307565.0
Unknown,552,Unknown,552,Unknown,Cheque,Unknown,DENTREPRISE,Unknown,-2308117.0
Unknown,367,Unknown,367,Unknown,Cheque,Unknown,DENTREPRISE,Unknown,-2308484.0
Unknown,25,Unknown,25,Unknown,Cheque,Unknown,DENTREPRISE,Unknown,-2308509.0
Unknown,1,Unknown,1,Unknown,Cheque,Unknown,DENTREPRISE,Unknown,-2308510.0
01/01/2022,33,Unknown,33,Unknown,Cash,Unknown,DENTREPRISE,SOCIETE GENERALE RELEVÉ DE COMPTE,-33.0
31/01/2022,01,Unknown,01,Unknown,Cash,Unknown,DENTREPRISE,Page 1/9 VOS CONTACTS,-34.0
31/12/2021,01,Unknown,01,Unknown,Cash,Unknown,DENTREPRISE,nternet,-35.0
03/01/2022,31,Unknown,31,Unknown,Cash,Unknown,DENTREPRISE,prolessionnels socleteoencrale,-66.0
04/01/2022,01,Unknown,01,Unknown,Cash,Unknown,DENTREPRISE,IAppli,-67.0
01/03/2020,1,Unknown,1,Unknown,Cash,Unknown,DENTREPRISE,execubon,-68.0
Unknown,1,Unknown,1,Unknown,Cash,Unknown,DENTREPRISE,appelnon surtare,-69.0
Unknown,9,Unknown,9,Unknown,Cash,Unknown,DENTREPRISE,ANNECY partelephone,-78.0
Unknown,0,Unknown,0,Unknown,Cash,Unknown,DENTREPRISE,ax,-78.0
Unknown,04 50,Unknown,04 50,Unknown,Cash,Unknown,DENTREPRISE,RUE ROYALE,-528.0
Unknown,33 57,Unknown,33 57,Unknown,Cash,Unknown,DENTREPRISE,ANNECY,-3885.0
Unknown,50,Unknown,50,Unknown,Cash,Unknown,DENTREPRISE,Isabelle money@socoen com,-3935.0
Unknown,04 50,Unknown,04 50,Unknown,Cash,Unknown,DENTREPRISE,opération SolDE PREcEDEnT AU,-4385.0
Unknown,10 90,Unknown,10 90,Unknown,Cash,Unknown,DENTREPRISE,ReMISE,-5475.0
Unknown,53,Unknown,53,Unknown,Cash,Unknown,DENTREPRISE,CoM,-5528.0
Unknown,98,Unknown,98,Unknown,Cash,Unknown,DENTREPRISE,REMISE,-5626.0
Unknown,04 50,Unknown,04 50,Unknown,Cash,Unknown,DENTREPRISE,R13329,-6076.0
Unknown,33 57,Unknown,33 57,Unknown,Cash,Unknown,DENTREPRISE,CoM,-9433.0
Unknown,2,Unknown,2,Unknown,Cash,Unknown,DENTREPRISE,CoM 3,-9435.0
Unknown,31,Unknown,31,Unknown,Cash,Unknown,DENTREPRISE,ReMISE,-9466.0
Unknown,12,Unknown,12,Unknown,Cash,Unknown,DENTREPRISE,"R398o C13600,38501 BT",-9478.0
Unknown,03,Unknown,03,Unknown,Cash,Unknown,DENTREPRISE,M1ECoM 5,-9481.0
Unknown,777,Unknown,777,Unknown,Cash,Unknown,DENTREPRISE,ReMISE,-10258.0
Unknown,2,Unknown,2,Unknown,Cash,Unknown,DENTREPRISE,"0201 R62915 C13600,38501 BT 467 68E",-10260.0
Unknown,03,Unknown,03,Unknown,Cash,Unknown,DENTREPRISE,CoM,-10263.0
Unknown,745,Unknown,745,Unknown,Cash,Unknown,DENTREPRISE,ReMISE,-11008.0
Unknown,2,Unknown,2,Unknown,Cash,Unknown,DENTREPRISE,"R62920 C13600,38501 BT 689 05E",-11010.0
Unknown,03,Unknown,03,Unknown,Cash,Unknown,DENTREPRISE,CoM 2,-11013.0
Unknown,31,Unknown,31,Unknown,Cash,Unknown,DENTREPRISE,ReMISE,-11044.0
Unknown,12,Unknown,12,Unknown,Cash,Unknown,DENTREPRISE,"R96275 C13600,38501",-11056.0
Unknown,896,Unknown,896,Unknown,Cash,Unknown,DENTREPRISE,COM,-11952.0
Unknown,3,Unknown,3,Unknown,Cash,Unknown,DENTREPRISE,CARTE,-11955.0
Unknown,03,Unknown,03,Unknown,Cash,Unknown,DENTREPRISE,CHAM,-11958.0
Unknown,31,Unknown,31,Unknown,Cash,Unknown,DENTREPRISE,PRLVEUROPEEN,-11989.0
Unknown,12,Unknown,12,Unknown,Cash,Unknown,DENTREPRISE,B28 9204181210,-12001.0
Unknown,5,Unknown,5,Unknown,Cash,Unknown,DENTREPRISE,MoTIF SERVICE JANVIER REF,-12006.0
Unknown,03,Unknown,03,Unknown,Cash,Unknown,DENTREPRISE,MADAT AMARCHE21,-12009.0
Unknown,467,Unknown,467,Unknown,Cash,Unknown,DENTREPRISE,PRELEVEMENT EUROPEEN 9218847221 DE METRO CASH,-12476.0
Unknown,03,Unknown,03,Unknown,Cash,Unknown,DENTREPRISE,ID FR17ZZ7452888 MoTIF PRelevement REF 0101198076,-12479.0
Unknown,689,Unknown,689,Unknown,Cash,Unknown,DENTREPRISE,REMISE,-13168.0
Unknown,2 80,Unknown,2 80,Unknown,Cash,Unknown,DENTREPRISE,S0e COM,-13448.0
Unknown,03,Unknown,03,Unknown,Cash,Unknown,DENTREPRISE,C8 0301,-13451.0
Unknown,01,Unknown,01,Unknown,Cash,Unknown,DENTREPRISE,COM,-13452.0
Unknown,01,Unknown,01,Unknown,Cash,Unknown,DENTREPRISE,tartt,-13453.0
Unknown,03,Unknown,03,Unknown,Cash,Unknown,DENTREPRISE,Insatislaction OU,-13456.0
Unknown,01,Unknown,01,Unknown,Cash,Unknown,DENTREPRISE,VOUs,-13457.0
Unknown,03,Unknown,03,Unknown,Cash,Unknown,DENTREPRISE,Pans ceder18 Tel,-13460.0
Unknown,654 56,Unknown,654 56,Unknown,Cash,Unknown,DENTREPRISE,Le Mediateurendemierrecours graturement eten apolication deb Chale,-78916.0
Unknown,"775,31",Unknown,"775,31",Unknown,Cash,Unknown,DENTREPRISE,Tadresse,-156447.0
Unknown,742 74,Unknown,742 74,Unknown,Cash,Unknown,DENTREPRISE,Le Aduleu,-230721.0
Unknown,893,Unknown,893,Unknown,Cash,Unknown,DENTREPRISE,Sootte Gencrale,-231614.0
Unknown,8,Unknown,8,Unknown,Cash,Unknown,DENTREPRISE,Valmny,-231622.0
Unknown,"1 277,37",Unknown,"1 277,37",Unknown,Cash,Unknown,DENTREPRISE,Par L Deknse ceda 7 oupi,-359359.0
Unknown,466,Unknown,466,Unknown,Cash,Unknown,DENTREPRISE,sie nlernet Qu,-359825.0
Unknown,0 686,Unknown,0 686,Unknown,Cash,Unknown,DENTREPRISE,WMW mneduleu,-360511.0
Unknown,2 458 92,Unknown,2 458 92,Unknown,Cash,Unknown,DENTREPRISE,Ir LeMeduleu,-606403.0
Unknown,"30 200,00",Unknown,"30 200,00",Unknown,Cash,Unknown,DENTREPRISE,dosskf,-3626403.0
Unknown,"1 500,00",Unknown,"1 500,00",Unknown,Cash,Unknown,DENTREPRISE,So0,-3776403.0
Unknown,04,Unknown,04,Unknown,Cash,Unknown,DENTREPRISE,Unknown,-3776407.0
Unknown,01,Unknown,01,Unknown,Cash,Unknown,DENTREPRISE,Unknown,-3776408.0
Unknown,8,Unknown,8,Unknown,Cash,Unknown,DENTREPRISE,Unknown,-3776416.0
Unknown,0,Unknown,0,Unknown,Cash,Unknown,DENTREPRISE,Unknown,-3776416.0
Unknown,04,Unknown,04,Unknown,Cash,Unknown,DENTREPRISE,Unknown,-3776420.0
Unknown,476,Unknown,476,Unknown,Cash,Unknown,DENTREPRISE,Unknown,-3776896.0
Unknown,"8,47",Unknown,"8,47",Unknown,Cash,Unknown,DENTREPRISE,Unknown,-3777743.0
Unknown,474 56,Unknown,474 56,Unknown,Cash,Unknown,DENTREPRISE,Unknown,-3825199.0
Unknown,33,Unknown,33,Unknown,Cash,Unknown,DENTREPRISE,Unknown,-3825232.0
Unknown,1 76,Unknown,1 76,Unknown,Cash,Unknown,DENTREPRISE,Unknown,-3825408.0
Unknown,01,Unknown,01,Unknown,Cash,Unknown,DENTREPRISE,Unknown,-3825409.0
Unknown,03,Unknown,03,Unknown,Cash,Unknown,DENTREPRISE,Unknown,-3825412.0
Unknown,17,Unknown,17,Unknown,Cash,Unknown,DENTREPRISE,Unknown,-3825429.0
Unknown,7,Unknown,7,Unknown,Cash,Unknown,DENTREPRISE,Unknown,-3825436.0
Unknown,552,Unknown,552,Unknown,Cash,Unknown,DENTREPRISE,Unknown,-3825988.0
Unknown,367,Unknown,367,Unknown,Cash,Unknown,DENTREPRISE,Unknown,-3826355.0
Unknown,25,Unknown,25,Unknown,Cash,Unknown,DENTREPRISE,Unknown,-3826380.0
Unknown,1,Unknown,1,Unknown,Cash,Unknown,DENTREPRISE,Unknown,-3826381.0
29/11/2019,11,Unknown,11,Unknown,Credit,Unknown,Crédit,BANQUE POSTALE,-11.0
31/10/2019,1,Unknown,1,Unknown,Credit,Unknown,Crédit,Relevé,-12.0
Unknown,29,Unknown,29,Unknown,Credit,Unknown,Crédit,Vos Comptes 24h/24,-41.0
Unknown,2,Unknown,2,Unknown,Credit,Unknown,Crédit,BAnQUE PoSTalE,-43.0
Unknown,24,Unknown,24,Unknown,Credit,Unknown,Crédit,GRANDE,-67.0
Unknown,00,Unknown,00,Unknown,Credit,Unknown,Crédit,Y 033 IBAN,-67.0
Unknown,01 53,Unknown,01 53,Unknown,Credit,Unknown,Crédit,FR37,-220.0
Unknown,68 37,Unknown,68 37,Unknown,Credit,Unknown,Crédit,CREDIT CARTE BANCAIRE ReMISE,-7057.0
Unknown,37,Unknown,37,Unknown,Credit,Unknown,Crédit,CRedit CaRTE BanCAiRE,-7094.0
Unknown,9,Unknown,9,Unknown,Credit,Unknown,Crédit,CARTE BANCAIRE,-7103.0
Unknown,170,Unknown,170,Unknown,Credit,Unknown,Crédit,CRedit,-7273.0
Unknown,52 177 18,Unknown,52 177 18,Unknown,Credit,Unknown,Crédit,CARTE BANCAIRE ReMISE,-5224991.0
Unknown,033,Unknown,033,Unknown,Credit,Unknown,Crédit,CARTE BANCAIRE,-5225024.0
Unknown,342,Unknown,342,Unknown,Credit,Unknown,Crédit,COCCI,-5225366.0
Unknown,29,Unknown,29,Unknown,Credit,Unknown,Crédit,MARKEI,-5225395.0
Unknown,11,Unknown,11,Unknown,Credit,Unknown,Crédit,CREDIT CARTE BANCAIRE,-5225406.0
Unknown,"609,59",Unknown,"609,59",Unknown,Credit,Unknown,Crédit,OPe,-5286365.0
Unknown,0,Unknown,0,Unknown,Credit,Unknown,Crédit,CARTE BANCAIRE ReMISE,-5286365.0
Unknown,"69,33",Unknown,"69,33",Unknown,Credit,Unknown,Crédit,S,-5293298.0
Unknown,31,Unknown,31,Unknown,Credit,Unknown,Crédit,CARTE BANCAIRE,-5293329.0
Unknown,10,Unknown,10,Unknown,Credit,Unknown,Crédit,OPE,-5293339.0
Unknown,04,Unknown,04,Unknown,Credit,Unknown,Crédit,CARTE BANCAIRE,-5293343.0
Unknown,11,Unknown,11,Unknown,Credit,Unknown,Crédit,CARTE BANCAIRE,-5293354.0
Unknown,04,Unknown,04,Unknown,Credit,Unknown,Crédit,CARTE BANCAIRE,-5293358.0
Unknown,11,Unknown,11,Unknown,Credit,Unknown,Crédit,CARTE BANCAIRE,-5293369.0
Unknown,04,Unknown,04,Unknown,Credit,Unknown,Crédit,CARTE BANCAIRE,-5293373.0
Unknown,11,Unknown,11,Unknown,Credit,Unknown,Crédit,CARTE BANCAIRE,-5293384.0
Unknown,04,Unknown,04,Unknown,Credit,Unknown,Crédit,CARTE BANCAIRE,-5293388.0
Unknown,11,Unknown,11,Unknown,Credit,Unknown,Crédit,Page 1/4,-5293399.0
Unknown,2,Unknown,2,Unknown,Credit,Unknown,Crédit,Unknown,-5293401.0
Unknown,04,Unknown,04,Unknown,Credit,Unknown,Crédit,Unknown,-5293405.0
Unknown,11,Unknown,11,Unknown,Credit,Unknown,Crédit,Unknown,-5293416.0
Unknown,04,Unknown,04,Unknown,Credit,Unknown,Crédit,Unknown,-5293420.0
Unknown,11,Unknown,11,Unknown,Credit,Unknown,Crédit,Unknown,-5293431.0
Unknown,3,Unknown,3,Unknown,Credit,Unknown,Crédit,Unknown,-5293434.0
Unknown,04,Unknown,04,Unknown,Credit,Unknown,Crédit,Unknown,-5293438.0
Unknown,11,Unknown,11,Unknown,Credit,Unknown,Crédit,Unknown,-5293449.0
Unknown,04,Unknown,04,Unknown,Credit,Unknown,Crédit,Unknown,-5293453.0
Unknown,11,Unknown,11,Unknown,Credit,Unknown,Crédit,Unknown,-5293464.0
Unknown,04,Unknown,04,Unknown,Credit,Unknown,Crédit,Unknown,-5293468.0
Unknown,11,Unknown,11,Unknown,Credit,Unknown,Crédit,Unknown,-5293479.0
Unknown,04,Unknown,04,Unknown,Credit,Unknown,Crédit,Unknown,-5293483.0
Unknown,11,Unknown,11,Unknown,Credit,Unknown,Crédit,Unknown,-5293494.0
Unknown,04,Unknown,04,Unknown,Credit,Unknown,Crédit,Unknown,-5293498.0
Unknown,11,Unknown,11,Unknown,Credit,Unknown,Crédit,Unknown,-5293509.0
Unknown,04,Unknown,04,Unknown,Credit,Unknown,Crédit,Unknown,-5293513.0
Unknown,11,Unknown,11,Unknown,Credit,Unknown,Crédit,Unknown,-5293524.0
Unknown,04,Unknown,04,Unknown,Credit,Unknown,Crédit,Unknown,-5293528.0
Unknown,11,Unknown,11,Unknown,Credit,Unknown,Crédit,Unknown,-5293539.0
Unknown,2,Unknown,2,Unknown,Credit,Unknown,Crédit,Unknown,-5293541.0
Unknown,04,Unknown,04,Unknown,Credit,Unknown,Crédit,Unknown,-5293545.0
Unknown,11,Unknown,11,Unknown,Credit,Unknown,Crédit,Unknown,-5293556.0
Unknown,3,Unknown,3,Unknown,Credit,Unknown,Crédit,Unknown,-5293559.0
Unknown,04,Unknown,04,Unknown,Credit,Unknown,Crédit,Unknown,-5293563.0
Unknown,11,Unknown,11,Unknown,Credit,Unknown,Crédit,Unknown,-5293574.0
Unknown,04,Unknown,04,Unknown,Credit,Unknown,Crédit,Unknown,-5293578.0
Unknown,11,Unknown,11,Unknown,Credit,Unknown,Crédit,Unknown,-5293589.0
Unknown,04,Unknown,04,Unknown,Credit,Unknown,Crédit,Unknown,-5293593.0
Unknown,11,Unknown,11,Unknown,Credit,Unknown,Crédit,Unknown,-5293604.0
Unknown,"2,99",Unknown,"2,99",Unknown,Credit,Unknown,Crédit,Unknown,-5293903.0
Unknown,"3,21",Unknown,"3,21",Unknown,Credit,Unknown,Crédit,Unknown,-5294224.0
Unknown,"3,81",Unknown,"3,81",Unknown,Credit,Unknown,Crédit,Unknown,-5294605.0
Unknown,"8,06",Unknown,"8,06",Unknown,Credit,Unknown,Crédit,Unknown,-5295411.0
Unknown,"12,76",Unknown,"12,76",Unknown,Credit,Unknown,Crédit,Unknown,-5296687.0
Unknown,"19,87",Unknown,"19,87",Unknown,Credit,Unknown,Crédit,Unknown,-5298674.0
Unknown,"32,27",Unknown,"32,27",Unknown,Credit,Unknown,Crédit,Unknown,-5301901.0
Unknown,"32,45",Unknown,"32,45",Unknown,Credit,Unknown,Crédit,Unknown,-5305146.0
Unknown,"40,26",Unknown,"40,26",Unknown,Credit,Unknown,Crédit,Unknown,-5309172.0
Unknown,"0,05",Unknown,"0,05",Unknown,Credit,Unknown,Crédit,Unknown,-5309177.0
Unknown,"0,05",Unknown,"0,05",Unknown,Credit,Unknown,Crédit,Unknown,-5309182.0
Unknown,"0,05",Unknown,"0,05",Unknown,Credit,Unknown,Crédit,Unknown,-5309187.0
Unknown,"0,10",Unknown,"0,10",Unknown,Credit,Unknown,Crédit,Unknown,-5309197.0
Unknown,"0,15",Unknown,"0,15",Unknown,Credit,Unknown,Crédit,Unknown,-5309212.0
Unknown,"0,15",Unknown,"0,15",Unknown,Credit,Unknown,Crédit,Unknown,-5309227.0
Unknown,"0,25",Unknown,"0,25",Unknown,Credit,Unknown,Crédit,Unknown,-5309252.0
Unknown,"0,25",Unknown,"0,25",Unknown,Credit,Unknown,Crédit,Unknown,-5309277.0
Unknown,1,Unknown,1,Unknown,Credit,Unknown,Crédit,Unknown,-5309278.0
Unknown,4,Unknown,4,Unknown,Credit,Unknown,Crédit,Unknown,-5309282.0
31/12/2019,12,Unknown,12,Unknown,Virement,Unknown,Crédit,BANQUE POSTALE,-12.0
29/11/2019,30,Unknown,30,Unknown,Virement,Unknown,Crédit,Arrêté,-42.0
Unknown,31,Unknown,31,Unknown,Virement,Unknown,Crédit,Relevé,-73.0
Unknown,2,Unknown,2,Unknown,Virement,Unknown,Crédit,Vos Comptes 24h/24,-75.0
Unknown,24,Unknown,24,Unknown,Virement,Unknown,Crédit,BAnQUE PoSTalE,-99.0
Unknown,01 53,Unknown,01 53,Unknown,Virement,Unknown,Crédit,GRANDE,-252.0
Unknown,68 37,Unknown,68 37,Unknown,Virement,Unknown,Crédit,Y 033 IBAN,-7089.0
Unknown,37,Unknown,37,Unknown,Virement,Unknown,Crédit,FR37,-7126.0
Unknown,9,Unknown,9,Unknown,Virement,Unknown,Crédit,VIREMENT DE MONDIAL,-7135.0
Unknown,170,Unknown,170,Unknown,Virement,Unknown,Crédit,VSEA004071/98300000,-7305.0
Unknown,52 177 18,Unknown,52 177 18,Unknown,Virement,Unknown,Crédit,CRedit CaRTE BanCAiRE,-5225023.0
Unknown,033,Unknown,033,Unknown,Virement,Unknown,Crédit,CARTE BANCAIRE ReMISE,-5225056.0
Unknown,342,Unknown,342,Unknown,Virement,Unknown,Crédit,CRedit,-5225398.0
Unknown,31,Unknown,31,Unknown,Virement,Unknown,Crédit,CARTE BANCAIRE,-5225429.0
Unknown,12,Unknown,12,Unknown,Virement,Unknown,Crédit,DE7,-5225441.0
Unknown,"278,42",Unknown,"278,42",Unknown,Virement,Unknown,Crédit,CARTE BANCAIRE,-5253283.0
Unknown,0,Unknown,0,Unknown,Virement,Unknown,Crédit,CARTE BANCAIRE,-5253283.0
Unknown,"609,59",Unknown,"609,59",Unknown,Virement,Unknown,Crédit,CARTE BANCAIRE,-5314242.0
Unknown,29,Unknown,29,Unknown,Virement,Unknown,Crédit,Remise 030073,-5314271.0
Unknown,11,Unknown,11,Unknown,Virement,Unknown,Crédit,CARTE BANCAIRE,-5314282.0
Unknown,02,Unknown,02,Unknown,Virement,Unknown,Crédit,DEZ FA,-5314284.0
Unknown,12,Unknown,12,Unknown,Virement,Unknown,Crédit,CREDIT CARTE BANCAIRE,-5314296.0
Unknown,02,Unknown,02,Unknown,Virement,Unknown,Crédit,CARTE BANCAIRE,-5314298.0
Unknown,12,Unknown,12,Unknown,Virement,Unknown,Crédit,CARTE,-5314310.0
Unknown,02,Unknown,02,Unknown,Virement,Unknown,Crédit,CARTE BANCAIRE,-5314312.0
Unknown,12,Unknown,12,Unknown,Virement,Unknown,Crédit,S OPE,-5314324.0
Unknown,02,Unknown,02,Unknown,Virement,Unknown,Crédit,CARTE BANCAIRE,-5314326.0
Unknown,12,Unknown,12,Unknown,Virement,Unknown,Crédit,Ope CoccimaRket,-5314338.0
Unknown,4,Unknown,4,Unknown,Virement,Unknown,Crédit,CARTE BANCAIRE,-5314342.0
Unknown,02,Unknown,02,Unknown,Virement,Unknown,Crédit,FA CoCCI MARKET SevReS,-5314344.0
Unknown,12,Unknown,12,Unknown,Virement,Unknown,Crédit,Unknown,-5314356.0
Unknown,02,Unknown,02,Unknown,Virement,Unknown,Crédit,Unknown,-5314358.0
Unknown,12,Unknown,12,Unknown,Virement,Unknown,Crédit,Unknown,-5314370.0
Unknown,02,Unknown,02,Unknown,Virement,Unknown,Crédit,Unknown,-5314372.0
Unknown,12,Unknown,12,Unknown,Virement,Unknown,Crédit,Unknown,-5314384.0
Unknown,02,Unknown,02,Unknown,Virement,Unknown,Crédit,Unknown,-5314386.0
Unknown,12,Unknown,12,Unknown,Virement,Unknown,Crédit,Unknown,-5314398.0
Unknown,4,Unknown,4,Unknown,Virement,Unknown,Crédit,Unknown,-5314402.0
Unknown,02,Unknown,02,Unknown,Virement,Unknown,Crédit,Unknown,-5314404.0
Unknown,12,Unknown,12,Unknown,Virement,Unknown,Crédit,Unknown,-5314416.0
Unknown,02,Unknown,02,Unknown,Virement,Unknown,Crédit,Unknown,-5314418.0
Unknown,12,Unknown,12,Unknown,Virement,Unknown,Crédit,Unknown,-5314430.0
Unknown,04,Unknown,04,Unknown,Virement,Unknown,Crédit,Unknown,-5314434.0
Unknown,12,Unknown,12,Unknown,Virement,Unknown,Crédit,Unknown,-5314446.0
Unknown,2,Unknown,2,Unknown,Virement,Unknown,Crédit,Unknown,-5314448.0
Unknown,04,Unknown,04,Unknown,Virement,Unknown,Crédit,Unknown,-5314452.0
Unknown,12,Unknown,12,Unknown,Virement,Unknown,Crédit,Unknown,-5314464.0
Unknown,2,Unknown,2,Unknown,Virement,Unknown,Crédit,Unknown,-5314466.0
Unknown,04,Unknown,04,Unknown,Virement,Unknown,Crédit,Unknown,-5314470.0
Unknown,12,Unknown,12,Unknown,Virement,Unknown,Crédit,Unknown,-5314482.0
Unknown,2,Unknown,2,Unknown,Virement,Unknown,Crédit,Unknown,-5314484.0
Unknown,04,Unknown,04,Unknown,Virement,Unknown,Crédit,Unknown,-5314488.0
Unknown,12,Unknown,12,Unknown,Virement,Unknown,Crédit,Unknown,-5314500.0
Unknown,2,Unknown,2,Unknown,Virement,Unknown,Crédit,Unknown,-5314502.0
Unknown,05,Unknown,05,Unknown,Virement,Unknown,Crédit,Unknown,-5314507.0
Unknown,12,Unknown,12,Unknown,Virement,Unknown,Crédit,Unknown,-5314519.0
Unknown,05,Unknown,05,Unknown,Virement,Unknown,Crédit,Unknown,-5314524.0
Unknown,12,Unknown,12,Unknown,Virement,Unknown,Crédit,Unknown,-5314536.0
Unknown,2,Unknown,2,Unknown,Virement,Unknown,Crédit,Unknown,-5314538.0
Unknown,05,Unknown,05,Unknown,Virement,Unknown,Crédit,Unknown,-5314543.0
Unknown,12,Unknown,12,Unknown,Virement,Unknown,Crédit,Unknown,-5314555.0
Unknown,2,Unknown,2,Unknown,Virement,Unknown,Crédit,Unknown,-5314557.0
Unknown,"272,64",Unknown,"272,64",Unknown,Virement,Unknown,Crédit,Unknown,-5341821.0
Unknown,"2,30",Unknown,"2,30",Unknown,Virement,Unknown,Crédit,Unknown,-5342051.0
Unknown,"3,68",Unknown,"3,68",Unknown,Virement,Unknown,Crédit,Unknown,-5342419.0
Unknown,"12,14",Unknown,"12,14",Unknown,Virement,Unknown,Crédit,Unknown,-5343633.0
Unknown,"35,88",Unknown,"35,88",Unknown,Virement,Unknown,Crédit,Unknown,-5347221.0
Unknown,"0,05",Unknown,"0,05",Unknown,Virement,Unknown,Crédit,Unknown,-5347226.0
Unknown,"0,05",Unknown,"0,05",Unknown,Virement,Unknown,Crédit,Unknown,-5347231.0
Unknown,"0,35",Unknown,"0,35",Unknown,Virement,Unknown,Crédit,Unknown,-5347266.0
Unknown,609,Unknown,609,Unknown,Virement,Unknown,Crédit,Unknown,-5347875.0
Unknown,59,Unknown,59,Unknown,Virement,Unknown,Crédit,Unknown,-5347934.0
Unknown,"8,00",Unknown,"8,00",Unknown,Virement,Unknown,Crédit,Unknown,-5348734.0
Unknown,"0,10",Unknown,"0,10",Unknown,Virement,Unknown,Crédit,Unknown,-5348744.0
Unknown,"0,10",Unknown,"0,10",Unknown,Virement,Unknown,Crédit,Unknown,-5348754.0
Unknown,"23,48",Unknown,"23,48",Unknown,Virement,Unknown,Crédit,Unknown,-5351102.0
Unknown,"28,10",Unknown,"28,10",Unknown,Virement,Unknown,Crédit,Unknown,-5353912.0
Unknown,"0,14",Unknown,"0,14",Unknown,Virement,Unknown,Crédit,Unknown,-5353926.0
Unknown,1,Unknown,1,Unknown,Virement,Unknown,Crédit,Unknown,-5353927.0
Unknown,2,Unknown,2,Unknown,Virement,Unknown,Crédit,Unknown,-5353929.0
Unknown,20,Unknown,20,Unknown,Virement,Unknown,Crédit,Unknown,-5353949.0
07.10.2019,Unknown,010,Unknown,Unknown,Cheque,Unknown,S.A,Paris,10.0
Unknown,Unknown,05,Unknown,Unknown,Cheque,Unknown,S.A,Bun Oua,15.0
Unknown,Unknown,91,Unknown,Unknown,Cheque,Unknown,S.A,Votre conseiller Sebastien Hippias,106.0
Unknown,Unknown,01 42,Unknown,Unknown,Cheque,Unknown,S.A,THIBIYA,248.0
Unknown,Unknown,85,Unknown,Unknown,Cheque,Unknown,S.A,SUPERMARKET,333.0
Unknown,Unknown,01 42,Unknown,Unknown,Cheque,Unknown,S.A,BOULEVARD SAINT,475.0
Unknown,Unknown,85 71,Unknown,Unknown,Cheque,Unknown,S.A,Internet,9046.0
Unknown,Unknown,34,Unknown,Unknown,Cheque,Unknown,S.A,S.as,9080.0
Unknown,Unknown,01 42,Unknown,Unknown,Cheque,Unknown,S.A,Thibiya Supermarket,9222.0
Unknown,Unknown,85 71,Unknown,Unknown,Cheque,Unknown,S.A,S.a.s,17793.0
Unknown,Unknown,41,Unknown,Unknown,Cheque,Unknown,S.A,Thibiya Supermarket,17834.0
Unknown,Unknown,29,Unknown,Unknown,Cheque,Unknown,S.A,FR76,17863.0
Unknown,Unknown,1,Unknown,Unknown,Cheque,Unknown,S.A,BIc,17864.0
Unknown,Unknown,09 69,Unknown,Unknown,Cheque,Unknown,S.A,Libelle,18833.0
Unknown,Unknown,39 92,Unknown,Unknown,Cheque,Unknown,S.A,Remise,22825.0
Unknown,Unknown,91,Unknown,Unknown,Cheque,Unknown,S.A,Remise,22916.0
Unknown,Unknown,2,Unknown,Unknown,Cheque,Unknown,S.A,Cheque,22918.0
Unknown,Unknown,"421,40",Unknown,Unknown,Cheque,Unknown,S.A,Com Carte 223639401,65058.0
Unknown,Unknown,002,Unknown,Unknown,Cheque,Unknown,S.A,Com,65060.0
Unknown,Unknown,632,Unknown,Unknown,Cheque,Unknown,S.A,Remise,65692.0
Unknown,Unknown,07.10,Unknown,Unknown,Cheque,Unknown,S.A,Remise,65699.1
Unknown,Unknown,07.10,Unknown,Unknown,Cheque,Unknown,S.A,Virement Blocage,65706.20000000001
Unknown,Unknown,07.10,Unknown,Unknown,Cheque,Unknown,S.A,Com Carte 223639401 3721864,65713.30000000002
Unknown,Unknown,08.10,Unknown,Unknown,Cheque,Unknown,S.A,Com,65721.40000000002
Unknown,Unknown,08.10,Unknown,Unknown,Cheque,Unknown,S.A,Frais,65729.50000000003
Unknown,Unknown,07,Unknown,Unknown,Cheque,Unknown,S.A,10.10 10.10 Prlv AXA,65736.50000000003
Unknown,Unknown,10 08,Unknown,Unknown,Cheque,Unknown,S.A,CONTRATOOOOO1043754320400Ax000000000013163092 FRI4ZZZ391832,66744.50000000003
Unknown,Unknown,10 08,Unknown,Unknown,Cheque,Unknown,S.A,Com Carte 223639401,67752.50000000003
Unknown,Unknown,10,Unknown,Unknown,Cheque,Unknown,S.A,Com Carte 223639301,67762.50000000003
Unknown,Unknown,07,Unknown,Unknown,Cheque,Unknown,S.A,CA Ile-De-France26,67769.50000000003
Unknown,Unknown,10 08,Unknown,Unknown,Cheque,Unknown,S.A,Qual De La Rapee,68777.50000000003
Unknown,Unknown,10 08,Unknown,Unknown,Cheque,Unknown,S.A,RCS PARIS,69785.50000000003
Unknown,Unknown,10,Unknown,Unknown,Cheque,Unknown,S.A,Unknown,69795.50000000003
Unknown,Unknown,08.10,Unknown,Unknown,Cheque,Unknown,S.A,Unknown,69803.60000000003
Unknown,Unknown,08.10,Unknown,Unknown,Cheque,Unknown,S.A,Unknown,69811.70000000004
Unknown,Unknown,07,Unknown,Unknown,Cheque,Unknown,S.A,Unknown,69818.70000000004
Unknown,Unknown,10 08,Unknown,Unknown,Cheque,Unknown,S.A,Unknown,70826.70000000004
Unknown,Unknown,10 08,Unknown,Unknown,Cheque,Unknown,S.A,Unknown,71834.70000000004
Unknown,Unknown,10,Unknown,Unknown,Cheque,Unknown,S.A,Unknown,71844.70000000004
Unknown,Unknown,07,Unknown,Unknown,Cheque,Unknown,S.A,Unknown,71851.70000000004
Unknown,Unknown,10 09,Unknown,Unknown,Cheque,Unknown,S.A,Unknown,72860.70000000004
Unknown,Unknown,10 09,Unknown,Unknown,Cheque,Unknown,S.A,Unknown,73869.70000000004
Unknown,Unknown,10,Unknown,Unknown,Cheque,Unknown,S.A,Unknown,73879.70000000004
Unknown,Unknown,08,Unknown,Unknown,Cheque,Unknown,S.A,Unknown,73887.70000000004
Unknown,Unknown,10 09,Unknown,Unknown,Cheque,Unknown,S.A,Unknown,74896.70000000004
Unknown,Unknown,10 09,Unknown,Unknown,Cheque,Unknown,S.A,Unknown,75905.70000000004
Unknown,Unknown,10,Unknown,Unknown,Cheque,Unknown,S.A,Unknown,75915.70000000004
Unknown,Unknown,08,Unknown,Unknown,Cheque,Unknown,S.A,Unknown,75923.70000000004
Unknown,Unknown,10 09,Unknown,Unknown,Cheque,Unknown,S.A,Unknown,76932.70000000004
Unknown,Unknown,10 09,Unknown,Unknown,Cheque,Unknown,S.A,Unknown,77941.70000000004
Unknown,Unknown,10,Unknown,Unknown,Cheque,Unknown,S.A,Unknown,77951.70000000004
Unknown,Unknown,09.10,Unknown,Unknown,Cheque,Unknown,S.A,Unknown,77960.80000000005
Unknown,Unknown,09.10,Unknown,Unknown,Cheque,Unknown,S.A,Unknown,77969.90000000005
Unknown,Unknown,08,Unknown,Unknown,Cheque,Unknown,S.A,Unknown,77977.90000000005
Unknown,Unknown,10 09,Unknown,Unknown,Cheque,Unknown,S.A,Unknown,78986.90000000005
Unknown,Unknown,10 09,Unknown,Unknown,Cheque,Unknown,S.A,Unknown,79995.90000000005
Unknown,Unknown,10,Unknown,Unknown,Cheque,Unknown,S.A,Unknown,80005.90000000005
Unknown,Unknown,08,Unknown,Unknown,Cheque,Unknown,S.A,Unknown,80013.90000000005
Unknown,Unknown,10 09,Unknown,Unknown,Cheque,Unknown,S.A,Unknown,81022.90000000005
Unknown,Unknown,10 09,Unknown,Unknown,Cheque,Unknown,S.A,Unknown,82031.90000000005
Unknown,Unknown,10,Unknown,Unknown,Cheque,Unknown,S.A,Unknown,82041.90000000005
Unknown,Unknown,10.10,Unknown,Unknown,Cheque,Unknown,S.A,Unknown,82052.00000000006
Unknown,Unknown,10.10,Unknown,Unknown,Cheque,Unknown,S.A,Unknown,82062.10000000006
Unknown,Unknown,09,Unknown,Unknown,Cheque,Unknown,S.A,Unknown,82071.10000000006
Unknown,Unknown,10 10,Unknown,Unknown,Cheque,Unknown,S.A,Unknown,83081.10000000006
Unknown,Unknown,10 10,Unknown,Unknown,Cheque,Unknown,S.A,Unknown,84091.10000000006
Unknown,Unknown,10,Unknown,Unknown,Cheque,Unknown,S.A,Unknown,84101.10000000006
Unknown,Unknown,09,Unknown,Unknown,Cheque,Unknown,S.A,Unknown,84110.10000000006
Unknown,Unknown,10 10,Unknown,Unknown,Cheque,Unknown,S.A,Unknown,85120.10000000006
Unknown,Unknown,10 10,Unknown,Unknown,Cheque,Unknown,S.A,Unknown,86130.10000000006
Unknown,Unknown,10,Unknown,Unknown,Cheque,Unknown,S.A,Unknown,86140.10000000006
Unknown,Unknown,10.10,Unknown,Unknown,Cheque,Unknown,S.A,Unknown,86150.20000000007
Unknown,Unknown,10.10,Unknown,Unknown,Cheque,Unknown,S.A,Unknown,86160.30000000008
Unknown,Unknown,09,Unknown,Unknown,Cheque,Unknown,S.A,Unknown,86169.30000000008
Unknown,Unknown,10 10,Unknown,Unknown,Cheque,Unknown,S.A,Unknown,87179.30000000008
Unknown,Unknown,10 10,Unknown,Unknown,Cheque,Unknown,S.A,Unknown,88189.30000000008
Unknown,Unknown,10,Unknown,Unknown,Cheque,Unknown,S.A,Unknown,88199.30000000008
Unknown,Unknown,09,Unknown,Unknown,Cheque,Unknown,S.A,Unknown,88208.30000000008
Unknown,Unknown,10 11,Unknown,Unknown,Cheque,Unknown,S.A,Unknown,89219.30000000008
Unknown,Unknown,10 11,Unknown,Unknown,Cheque,Unknown,S.A,Unknown,90230.30000000008
Unknown,Unknown,10,Unknown,Unknown,Cheque,Unknown,S.A,Unknown,90240.30000000008
Unknown,Unknown,10,Unknown,Unknown,Cheque,Unknown,S.A,Unknown,90250.30000000008
Unknown,Unknown,10 11,Unknown,Unknown,Cheque,Unknown,S.A,Unknown,91261.30000000008
Unknown,Unknown,10 11,Unknown,Unknown,Cheque,Unknown,S.A,Unknown,92272.30000000008
Unknown,Unknown,10,Unknown,Unknown,Cheque,Unknown,S.A,Unknown,92282.30000000008
Unknown,Unknown,10,Unknown,Unknown,Cheque,Unknown,S.A,Unknown,92292.30000000008
Unknown,Unknown,10 11,Unknown,Unknown,Cheque,Unknown,S.A,Unknown,93303.30000000008
Unknown,Unknown,10 11,Unknown,Unknown,Cheque,Unknown,S.A,Unknown,94314.30000000008
Unknown,Unknown,10,Unknown,Unknown,Cheque,Unknown,S.A,Unknown,94324.30000000008
Unknown,Unknown,10,Unknown,Unknown,Cheque,Unknown,S.A,Unknown,94334.30000000008
Unknown,Unknown,10 11,Unknown,Unknown,Cheque,Unknown,S.A,Unknown,95345.30000000008
Unknown,Unknown,10 11,Unknown,Unknown,Cheque,Unknown,S.A,Unknown,96356.30000000008
Unknown,Unknown,10,Unknown,Unknown,Cheque,Unknown,S.A,Unknown,96366.30000000008
Unknown,Unknown,10,Unknown,Unknown,Cheque,Unknown,S.A,Unknown,96376.30000000008
Unknown,Unknown,10,Unknown,Unknown,Cheque,Unknown,S.A,Unknown,96386.30000000008
Unknown,Unknown,"3 234,26",Unknown,Unknown,Cheque,Unknown,S.A,Unknown,419812.3000000001
Unknown,Unknown,"12,00",Unknown,Unknown,Cheque,Unknown,S.A,Unknown,421012.3000000001
Unknown,Unknown,"73,20",Unknown,Unknown,Cheque,Unknown,S.A,Unknown,428332.3000000001
Unknown,Unknown,100 20,Unknown,Unknown,Cheque,Unknown,S.A,Unknown,438352.3000000001
Unknown,Unknown,"465,60",Unknown,Unknown,Cheque,Unknown,S.A,Unknown,484912.3000000001
Unknown,Unknown,"0,85",Unknown,Unknown,Cheque,Unknown,S.A,Unknown,484997.3000000001
Unknown,Unknown,"0,37",Unknown,Unknown,Cheque,Unknown,S.A,Unknown,485034.3000000001
Unknown,Unknown,"126,40",Unknown,Unknown,Cheque,Unknown,S.A,Unknown,497674.3000000001
Unknown,Unknown,158 40,Unknown,Unknown,Cheque,Unknown,S.A,Unknown,513514.3000000001
Unknown,Unknown,802 12,Unknown,Unknown,Cheque,Unknown,S.A,Unknown,593726.3
Unknown,Unknown,"0,96",Unknown,Unknown,Cheque,Unknown,S.A,Unknown,593822.3
Unknown,Unknown,"3,08",Unknown,Unknown,Cheque,Unknown,S.A,Unknown,594130.3
Unknown,Unknown,81.00,Unknown,Unknown,Cheque,Unknown,S.A,Unknown,594211.3
Unknown,Unknown,"130,90",Unknown,Unknown,Cheque,Unknown,S.A,Unknown,607301.3
Unknown,Unknown,58 70,Unknown,Unknown,Cheque,Unknown,S.A,Unknown,613171.3
Unknown,Unknown,48 04,Unknown,Unknown,Cheque,Unknown,S.A,Unknown,617975.3
Unknown,Unknown,0 21,Unknown,Unknown,Cheque,Unknown,S.A,Unknown,617996.3
Unknown,Unknown,0 47,Unknown,Unknown,Cheque,Unknown,S.A,Unknown,618043.3
Unknown,Unknown,141 00,Unknown,Unknown,Cheque,Unknown,S.A,Unknown,632143.3
Unknown,Unknown,"114,60",Unknown,Unknown,Cheque,Unknown,S.A,Unknown,643603.3
Unknown,Unknown,"0,63",Unknown,Unknown,Cheque,Unknown,S.A,Unknown,643666.3
Unknown,Unknown,0 50,Unknown,Unknown,Cheque,Unknown,S.A,Unknown,643716.3
Unknown,Unknown,1,Unknown,Unknown,Cheque,Unknown,S.A,Unknown,643717.3
Unknown,Unknown,4,Unknown,Unknown,Cheque,Unknown,S.A,Unknown,643721.3
Unknown,Unknown,775 665 615,Unknown,Unknown,Cheque,Unknown,S.A,Unknown,776309336.3
05.11.2019,Unknown,011,Unknown,Unknown,Debit,Unknown,S.A,Paris,11.0
Unknown,Unknown,05,Unknown,Unknown,Debit,Unknown,S.A,We,16.0
Unknown,Unknown,91,Unknown,Unknown,Debit,Unknown,S.A,Votre conseiller Sebastien Hippias,107.0
Unknown,Unknown,01 42,Unknown,Unknown,Debit,Unknown,S.A,THIBIYA,249.0
Unknown,Unknown,85,Unknown,Unknown,Debit,Unknown,S.A,SUPERMARKET,334.0
Unknown,Unknown,01 42,Unknown,Unknown,Debit,Unknown,S.A,BOULEVARD SAINT,476.0
Unknown,Unknown,85 71,Unknown,Unknown,Debit,Unknown,S.A,Internet,9047.0
Unknown,Unknown,34,Unknown,Unknown,Debit,Unknown,S.A,S.as,9081.0
Unknown,Unknown,01 42,Unknown,Unknown,Debit,Unknown,S.A,Thibiya Supermarket,9223.0
Unknown,Unknown,85 71,Unknown,Unknown,Debit,Unknown,S.A,S.a.s,17794.0
Unknown,Unknown,41,Unknown,Unknown,Debit,Unknown,S.A,FR76,17835.0
Unknown,Unknown,29,Unknown,Unknown,Debit,Unknown,S.A,BIc,17864.0
Unknown,Unknown,1,Unknown,Unknown,Debit,Unknown,S.A,Libelle,17865.0
Unknown,Unknown,09 69,Unknown,Unknown,Debit,Unknown,S.A,Remise,18834.0
Unknown,Unknown,39 92,Unknown,Unknown,Debit,Unknown,S.A,Remise,22826.0
Unknown,Unknown,91,Unknown,Unknown,Debit,Unknown,S.A,Com Carte 223639401,22917.0
Unknown,Unknown,2,Unknown,Unknown,Debit,Unknown,S.A,Com,22919.0
Unknown,Unknown,1 092.81,Unknown,Unknown,Debit,Unknown,S.A,Prlv Comm Interventio,24011.81
Unknown,Unknown,002,Unknown,Unknown,Debit,Unknown,S.A,Carte Metro,24013.81
Unknown,Unknown,632,Unknown,Unknown,Debit,Unknown,S.A,Remise,24645.81
Unknown,Unknown,05.11,Unknown,Unknown,Debit,Unknown,S.A,Remise Carte 223639301,24650.92
Unknown,Unknown,06.11,Unknown,Unknown,Debit,Unknown,S.A,Com,24657.03
Unknown,Unknown,06.11,Unknown,Unknown,Debit,Unknown,S.A,Com Carte 223639401,24663.140000000003
Unknown,Unknown,05,Unknown,Unknown,Debit,Unknown,S.A,Frais,24668.140000000003
Unknown,Unknown,11 06,Unknown,Unknown,Debit,Unknown,S.A,Remise,25774.140000000003
Unknown,Unknown,41 06,Unknown,Unknown,Debit,Unknown,S.A,Remise,29880.140000000003
Unknown,Unknown,41,Unknown,Unknown,Debit,Unknown,S.A,Com Carte 223639401,29921.140000000003
Unknown,Unknown,05,Unknown,Unknown,Debit,Unknown,S.A,Com Carte 223639401,29926.140000000003
Unknown,Unknown,11 06,Unknown,Unknown,Debit,Unknown,S.A,Page 1,31032.140000000003
Unknown,Unknown,11 06,Unknown,Unknown,Debit,Unknown,S.A,CA Ile-De-France26,32138.140000000003
Unknown,Unknown,11,Unknown,Unknown,Debit,Unknown,S.A,Qual De La Rapee,32149.140000000003
Unknown,Unknown,05,Unknown,Unknown,Debit,Unknown,S.A,RCS PARIS,32154.140000000003
Unknown,Unknown,11 06,Unknown,Unknown,Debit,Unknown,S.A,Unknown,33260.14
Unknown,Unknown,41 06,Unknown,Unknown,Debit,Unknown,S.A,Unknown,37366.14
Unknown,Unknown,41,Unknown,Unknown,Debit,Unknown,S.A,Unknown,37407.14
Unknown,Unknown,05,Unknown,Unknown,Debit,Unknown,S.A,Unknown,37412.14
Unknown,Unknown,11,Unknown,Unknown,Debit,Unknown,S.A,Unknown,37423.14
Unknown,Unknown,12.11,Unknown,Unknown,Debit,Unknown,S.A,Unknown,37435.25
Unknown,Unknown,09,Unknown,Unknown,Debit,Unknown,S.A,Unknown,37444.25
Unknown,Unknown,11 12,Unknown,Unknown,Debit,Unknown,S.A,Unknown,38556.25
Unknown,Unknown,11,Unknown,Unknown,Debit,Unknown,S.A,Unknown,38567.25
Unknown,Unknown,07,Unknown,Unknown,Debit,Unknown,S.A,Unknown,38574.25
Unknown,Unknown,11 14,Unknown,Unknown,Debit,Unknown,S.A,Unknown,39688.25
Unknown,Unknown,11 14,Unknown,Unknown,Debit,Unknown,S.A,Unknown,40802.25
Unknown,Unknown,11,Unknown,Unknown,Debit,Unknown,S.A,Unknown,40813.25
Unknown,Unknown,13,Unknown,Unknown,Debit,Unknown,S.A,Unknown,40826.25
Unknown,Unknown,11,Unknown,Unknown,Debit,Unknown,S.A,Unknown,40837.25
Unknown,Unknown,13,Unknown,Unknown,Debit,Unknown,S.A,Unknown,40850.25
Unknown,Unknown,11 14,Unknown,Unknown,Debit,Unknown,S.A,Unknown,41964.25
Unknown,Unknown,11 14,Unknown,Unknown,Debit,Unknown,S.A,Unknown,43078.25
Unknown,Unknown,11,Unknown,Unknown,Debit,Unknown,S.A,Unknown,43089.25
Unknown,Unknown,07,Unknown,Unknown,Debit,Unknown,S.A,Unknown,43096.25
Unknown,Unknown,11 14,Unknown,Unknown,Debit,Unknown,S.A,Unknown,44210.25
Unknown,Unknown,11,Unknown,Unknown,Debit,Unknown,S.A,Unknown,44221.25
Unknown,Unknown,14,Unknown,Unknown,Debit,Unknown,S.A,Unknown,44235.25
Unknown,Unknown,11,Unknown,Unknown,Debit,Unknown,S.A,Unknown,44246.25
Unknown,Unknown,14,Unknown,Unknown,Debit,Unknown,S.A,Unknown,44260.25
Unknown,Unknown,11 15,Unknown,Unknown,Debit,Unknown,S.A,Unknown,45375.25
Unknown,Unknown,11 15,Unknown,Unknown,Debit,Unknown,S.A,Unknown,46490.25
Unknown,Unknown,11,Unknown,Unknown,Debit,Unknown,S.A,Unknown,46501.25
Unknown,Unknown,14,Unknown,Unknown,Debit,Unknown,S.A,Unknown,46515.25
Unknown,Unknown,11,Unknown,Unknown,Debit,Unknown,S.A,Unknown,46526.25
Unknown,Unknown,14,Unknown,Unknown,Debit,Unknown,S.A,Unknown,46540.25
Unknown,Unknown,11 16,Unknown,Unknown,Debit,Unknown,S.A,Unknown,47656.25
Unknown,Unknown,11 18,Unknown,Unknown,Debit,Unknown,S.A,Unknown,48774.25
Unknown,Unknown,11,Unknown,Unknown,Debit,Unknown,S.A,Unknown,48785.25
Unknown,Unknown,15,Unknown,Unknown,Debit,Unknown,S.A,Unknown,48800.25
Unknown,Unknown,11 16,Unknown,Unknown,Debit,Unknown,S.A,Unknown,49916.25
Unknown,Unknown,11 18,Unknown,Unknown,Debit,Unknown,S.A,Unknown,51034.25
Unknown,Unknown,11,Unknown,Unknown,Debit,Unknown,S.A,Unknown,51045.25
Unknown,Unknown,15,Unknown,Unknown,Debit,Unknown,S.A,Unknown,51060.25
Unknown,Unknown,11 16,Unknown,Unknown,Debit,Unknown,S.A,Unknown,52176.25
Unknown,Unknown,11 18,Unknown,Unknown,Debit,Unknown,S.A,Unknown,53294.25
Unknown,Unknown,11,Unknown,Unknown,Debit,Unknown,S.A,Unknown,53305.25
Unknown,Unknown,15,Unknown,Unknown,Debit,Unknown,S.A,Unknown,53320.25
Unknown,Unknown,"11 421,40",Unknown,Unknown,Debit,Unknown,S.A,Unknown,1195460.25
Unknown,Unknown,"12,00",Unknown,Unknown,Debit,Unknown,S.A,Unknown,1196660.25
Unknown,Unknown,"90,96",Unknown,Unknown,Debit,Unknown,S.A,Unknown,1205756.25
Unknown,Unknown,68 40,Unknown,Unknown,Debit,Unknown,S.A,Unknown,1212596.25
Unknown,Unknown,0 26,Unknown,Unknown,Debit,Unknown,S.A,Unknown,1212622.25
Unknown,Unknown,"0,38",Unknown,Unknown,Debit,Unknown,S.A,Unknown,1212660.25
Unknown,Unknown,"400 179,04",Unknown,Unknown,Debit,Unknown,S.A,Unknown,41230564.25
Unknown,Unknown,48,Unknown,Unknown,Debit,Unknown,S.A,Unknown,41230612.25
Unknown,Unknown,04 48,Unknown,Unknown,Debit,Unknown,S.A,Unknown,41231060.25
Unknown,Unknown,"04 654,62",Unknown,Unknown,Debit,Unknown,S.A,Unknown,41696522.25
Unknown,Unknown,"698,16",Unknown,Unknown,Debit,Unknown,S.A,Unknown,41766338.25
Unknown,Unknown,"3,38",Unknown,Unknown,Debit,Unknown,S.A,Unknown,41766676.25
Unknown,Unknown,"2,36",Unknown,Unknown,Debit,Unknown,S.A,Unknown,41766912.25
Unknown,Unknown,"16,00",Unknown,Unknown,Debit,Unknown,S.A,Unknown,41768512.25
Unknown,Unknown,"36,80",Unknown,Unknown,Debit,Unknown,S.A,Unknown,41772192.25
Unknown,Unknown,"175,00",Unknown,Unknown,Debit,Unknown,S.A,Unknown,41789692.25
Unknown,Unknown,"0,16",Unknown,Unknown,Debit,Unknown,S.A,Unknown,41789708.25
Unknown,Unknown,"1,46",Unknown,Unknown,Debit,Unknown,S.A,Unknown,41789854.25
Unknown,Unknown,"155,60",Unknown,Unknown,Debit,Unknown,S.A,Unknown,41805414.25
Unknown,Unknown,"10,60",Unknown,Unknown,Debit,Unknown,S.A,Unknown,41806474.25
Unknown,Unknown,"0,64",Unknown,Unknown,Debit,Unknown,S.A,Unknown,41806538.25
Unknown,Unknown,1,Unknown,Unknown,Debit,Unknown,S.A,Unknown,41806539.25
Unknown,Unknown,4,Unknown,Unknown,Debit,Unknown,S.A,Unknown,41806543.25
Unknown,Unknown,775 665 615,Unknown,Unknown,Debit,Unknown,S.A,Unknown,817472158.25
06/09/2021,40,Unknown,40,Unknown,Unknown,Unknown,EPI SERVICE PRIMEUR,Titulaire(s,-40.0
06/09/2021,9,Unknown,9,Unknown,Unknown,Unknown,EPI SERVICE PRIMEUR,Date Date de Valeur,-49.0
06/09/2021,9,Unknown,9,Unknown,Unknown,Unknown,EPI SERVICE PRIMEUR,TPV,-58.0
06/09/2021,10,Unknown,10,Unknown,Unknown,Unknown,EPI SERVICE PRIMEUR,STICHTING CUSTODIAN UBER PAY 06/09/2021,-68.0
06/09/2021,06,Unknown,06,Unknown,Unknown,Unknown,EPI SERVICE PRIMEUR,UBER PAY 06/09/2021,-74.0
06/09/2021,09 06,Unknown,09 06,Unknown,Unknown,Unknown,EPI SERVICE PRIMEUR,COM,-980.0
06/09/2021,09 06,Unknown,09 06,Unknown,Unknown,Unknown,EPI SERVICE PRIMEUR,CARTES,-1886.0
06/09/2021,09 06,Unknown,09 06,Unknown,Unknown,Unknown,EPI SERVICE PRIMEUR,COM,-2792.0
06/09/2021,09 06,Unknown,09 06,Unknown,Unknown,Unknown,EPI SERVICE PRIMEUR,CARTES,-3698.0
05/09/2021,09 06,Unknown,09 06,Unknown,Unknown,Unknown,EPI SERVICE PRIMEUR,COM,-4604.0
05/09/2021,09 06,Unknown,09 06,Unknown,Unknown,Unknown,EPI SERVICE PRIMEUR,CARTES 0386405,-5510.0
05/09/2021,09 06,Unknown,09 06,Unknown,Unknown,Unknown,EPI SERVICE PRIMEUR,COM,-6416.0
05/09/2021,09 06,Unknown,09 06,Unknown,Unknown,Unknown,EPI SERVICE PRIMEUR,CARTES,-7322.0
05/09/2021,09 06,Unknown,09 06,Unknown,Unknown,Unknown,EPI SERVICE PRIMEUR,COM,-8228.0
05/09/2021,09 06,Unknown,09 06,Unknown,Unknown,Unknown,EPI SERVICE PRIMEUR,CARTES,-9134.0
06/09/2021,09 06,Unknown,09 06,Unknown,Unknown,Unknown,EPI SERVICE PRIMEUR,COM,-10040.0
06/09/2021,09 06,Unknown,09 06,Unknown,Unknown,Unknown,EPI SERVICE PRIMEUR,CARTES,-10946.0
06/09/2021,09 06,Unknown,09 06,Unknown,Unknown,Unknown,EPI SERVICE PRIMEUR,COM,-11852.0
06/09/2021,09 06,Unknown,09 06,Unknown,Unknown,Unknown,EPI SERVICE PRIMEUR,CARTES 0386405 64,-12758.0
06/09/2021,09 06,Unknown,09 06,Unknown,Unknown,Unknown,EPI SERVICE PRIMEUR,COM,-13664.0
06/09/2021,09 06,Unknown,09 06,Unknown,Unknown,Unknown,EPI SERVICE PRIMEUR,CARTES,-14570.0
07/09/2021,09 06,Unknown,09 06,Unknown,Unknown,Unknown,EPI SERVICE PRIMEUR,COM,-15476.0
06/09/2021,09,Unknown,09,Unknown,Unknown,Unknown,EPI SERVICE PRIMEUR,CARTES,-15485.0
06/09/2021,06,Unknown,06,Unknown,Unknown,Unknown,EPI SERVICE PRIMEUR,COM,-15491.0
07/09/2021,09,Unknown,09,Unknown,Unknown,Unknown,EPI SERVICE PRIMEUR,CARTES,-15500.0
07/09/2021,06,Unknown,06,Unknown,Unknown,Unknown,EPI SERVICE PRIMEUR,COM,-15506.0
07/09/2021,09,Unknown,09,Unknown,Unknown,Unknown,EPI SERVICE PRIMEUR,CARTES 0386405 64 0309,-15515.0
07/09/2021,06,Unknown,06,Unknown,Unknown,Unknown,EPI SERVICE PRIMEUR,COM,-15521.0
07/09/2021,09,Unknown,09,Unknown,Unknown,Unknown,EPI SERVICE PRIMEUR,CARTES,-15530.0
07/09/2021,64,Unknown,64,Unknown,Unknown,Unknown,EPI SERVICE PRIMEUR,EDF EPI SERVICE,-15594.0
07/09/2021,06,Unknown,06,Unknown,Unknown,Unknown,EPI SERVICE PRIMEUR,TPV,-15600.0
07/09/2021,09,Unknown,09,Unknown,Unknown,Unknown,EPI SERVICE PRIMEUR,TPV,-15609.0
07/09/2021,01,Unknown,01,Unknown,Unknown,Unknown,EPI SERVICE PRIMEUR,TPV,-15610.0
07/09/2021,06,Unknown,06,Unknown,Unknown,Unknown,EPI SERVICE PRIMEUR,CARTE,-15616.0
07/09/2021,09,Unknown,09,Unknown,Unknown,Unknown,EPI SERVICE PRIMEUR,PEAGE AUTOROUTE,-15625.0
Unknown,64,Unknown,64,Unknown,Unknown,Unknown,EPI SERVICE PRIMEUR,CARTE,-15689.0
Unknown,06,Unknown,06,Unknown,Unknown,Unknown,EPI SERVICE PRIMEUR,CARTE,-15695.0
Unknown,09,Unknown,09,Unknown,Unknown,Unknown,EPI SERVICE PRIMEUR,COM,-15704.0
Unknown,01,Unknown,01,Unknown,Unknown,Unknown,EPI SERVICE PRIMEUR,CARTES,-15705.0
Unknown,06,Unknown,06,Unknown,Unknown,Unknown,EPI SERVICE PRIMEUR,COM,-15711.0
Unknown,09,Unknown,09,Unknown,Unknown,Unknown,EPI SERVICE PRIMEUR,CARTES,-15720.0
Unknown,64,Unknown,64,Unknown,Unknown,Unknown,EPI SERVICE PRIMEUR,COM,-15784.0
Unknown,06,Unknown,06,Unknown,Unknown,Unknown,EPI SERVICE PRIMEUR,COM,-15790.0
Unknown,09,Unknown,09,Unknown,Unknown,Unknown,EPI SERVICE PRIMEUR,CARTES,-15799.0
Unknown,01,Unknown,01,Unknown,Unknown,Unknown,EPI SERVICE PRIMEUR,COM,-15800.0
Unknown,05,Unknown,05,Unknown,Unknown,Unknown,EPI SERVICE PRIMEUR,CARTES,-15805.0
Unknown,09,Unknown,09,Unknown,Unknown,Unknown,EPI SERVICE PRIMEUR,COM,-15814.0
Unknown,64,Unknown,64,Unknown,Unknown,Unknown,EPI SERVICE PRIMEUR,CARTES,-15878.0
Unknown,05,Unknown,05,Unknown,Unknown,Unknown,EPI SERVICE PRIMEUR,COM,-15883.0
Unknown,09,Unknown,09,Unknown,Unknown,Unknown,EPI SERVICE PRIMEUR,CARTES,-15892.0
Unknown,01,Unknown,01,Unknown,Unknown,Unknown,EPI SERVICE PRIMEUR,Unknown,-15893.0
Unknown,05,Unknown,05,Unknown,Unknown,Unknown,EPI SERVICE PRIMEUR,Unknown,-15898.0
Unknown,09,Unknown,09,Unknown,Unknown,Unknown,EPI SERVICE PRIMEUR,Unknown,-15907.0
Unknown,64,Unknown,64,Unknown,Unknown,Unknown,EPI SERVICE PRIMEUR,Unknown,-15971.0
Unknown,05,Unknown,05,Unknown,Unknown,Unknown,EPI SERVICE PRIMEUR,Unknown,-15976.0
Unknown,09,Unknown,09,Unknown,Unknown,Unknown,EPI SERVICE PRIMEUR,Unknown,-15985.0
Unknown,01,Unknown,01,Unknown,Unknown,Unknown,EPI SERVICE PRIMEUR,Unknown,-15986.0
Unknown,05,Unknown,05,Unknown,Unknown,Unknown,EPI SERVICE PRIMEUR,Unknown,-15991.0
Unknown,09,Unknown,09,Unknown,Unknown,Unknown,EPI SERVICE PRIMEUR,Unknown,-16000.0
Unknown,64,Unknown,64,Unknown,Unknown,Unknown,EPI SERVICE PRIMEUR,Unknown,-16064.0
Unknown,05,Unknown,05,Unknown,Unknown,Unknown,EPI SERVICE PRIMEUR,Unknown,-16069.0
Unknown,09,Unknown,09,Unknown,Unknown,Unknown,EPI SERVICE PRIMEUR,Unknown,-16078.0
Unknown,01,Unknown,01,Unknown,Unknown,Unknown,EPI SERVICE PRIMEUR,Unknown,-16079.0
Unknown,06,Unknown,06,Unknown,Unknown,Unknown,EPI SERVICE PRIMEUR,Unknown,-16085.0
Unknown,09,Unknown,09,Unknown,Unknown,Unknown,EPI SERVICE PRIMEUR,Unknown,-16094.0
Unknown,06,Unknown,06,Unknown,Unknown,Unknown,EPI SERVICE PRIMEUR,Unknown,-16100.0
Unknown,09,Unknown,09,Unknown,Unknown,Unknown,EPI SERVICE PRIMEUR,Unknown,-16109.0
Unknown,09,Unknown,09,Unknown,Unknown,Unknown,EPI SERVICE PRIMEUR,Unknown,-16118.0
Unknown,06,Unknown,06,Unknown,Unknown,Unknown,EPI SERVICE PRIMEUR,Unknown,-16124.0
Unknown,2,Unknown,2,Unknown,Unknown,Unknown,EPI SERVICE PRIMEUR,Unknown,-16126.0
Unknown,992 06,Unknown,992 06,Unknown,Unknown,Unknown,EPI SERVICE PRIMEUR,Unknown,-115332.0
Unknown,09,Unknown,09,Unknown,Unknown,Unknown,EPI SERVICE PRIMEUR,Unknown,-115341.0
Unknown,06,Unknown,06,Unknown,Unknown,Unknown,EPI SERVICE PRIMEUR,Unknown,-115347.0
Unknown,09,Unknown,09,Unknown,Unknown,Unknown,EPI SERVICE PRIMEUR,Unknown,-115356.0
Unknown,06,Unknown,06,Unknown,Unknown,Unknown,EPI SERVICE PRIMEUR,Unknown,-115362.0
Unknown,09,Unknown,09,Unknown,Unknown,Unknown,EPI SERVICE PRIMEUR,Unknown,-115371.0
Unknown,06,Unknown,06,Unknown,Unknown,Unknown,EPI SERVICE PRIMEUR,Unknown,-115377.0
Unknown,09,Unknown,09,Unknown,Unknown,Unknown,EPI SERVICE PRIMEUR,Unknown,-115386.0
Unknown,07,Unknown,07,Unknown,Unknown,Unknown,EPI SERVICE PRIMEUR,Unknown,-115393.0
Unknown,09,Unknown,09,Unknown,Unknown,Unknown,EPI SERVICE PRIMEUR,Unknown,-115402.0
Unknown,06,Unknown,06,Unknown,Unknown,Unknown,EPI SERVICE PRIMEUR,Unknown,-115408.0
Unknown,09,Unknown,09,Unknown,Unknown,Unknown,EPI SERVICE PRIMEUR,Unknown,-115417.0
Unknown,06,Unknown,06,Unknown,Unknown,Unknown,EPI SERVICE PRIMEUR,Unknown,-115423.0
Unknown,09,Unknown,09,Unknown,Unknown,Unknown,EPI SERVICE PRIMEUR,Unknown,-115432.0
Unknown,07,Unknown,07,Unknown,Unknown,Unknown,EPI SERVICE PRIMEUR,Unknown,-115439.0
Unknown,09,Unknown,09,Unknown,Unknown,Unknown,EPI SERVICE PRIMEUR,Unknown,-115448.0
Unknown,04,Unknown,04,Unknown,Unknown,Unknown,EPI SERVICE PRIMEUR,Unknown,-115452.0
Unknown,09,Unknown,09,Unknown,Unknown,Unknown,EPI SERVICE PRIMEUR,Unknown,-115461.0
Unknown,07,Unknown,07,Unknown,Unknown,Unknown,EPI SERVICE PRIMEUR,Unknown,-115468.0
Unknown,09,Unknown,09,Unknown,Unknown,Unknown,EPI SERVICE PRIMEUR,Unknown,-115477.0
Unknown,04,Unknown,04,Unknown,Unknown,Unknown,EPI SERVICE PRIMEUR,Unknown,-115481.0
Unknown,09,Unknown,09,Unknown,Unknown,Unknown,EPI SERVICE PRIMEUR,Unknown,-115490.0
Unknown,07,Unknown,07,Unknown,Unknown,Unknown,EPI SERVICE PRIMEUR,Unknown,-115497.0
Unknown,09,Unknown,09,Unknown,Unknown,Unknown,EPI SERVICE PRIMEUR,Unknown,-115506.0
Unknown,06,Unknown,06,Unknown,Unknown,Unknown,EPI SERVICE PRIMEUR,Unknown,-115512.0
Unknown,09,Unknown,09,Unknown,Unknown,Unknown,EPI SERVICE PRIMEUR,Unknown,-115521.0
Unknown,07,Unknown,07,Unknown,Unknown,Unknown,EPI SERVICE PRIMEUR,Unknown,-115528.0
Unknown,09,Unknown,09,Unknown,Unknown,Unknown,EPI SERVICE PRIMEUR,Unknown,-115537.0
Unknown,07,Unknown,07,Unknown,Unknown,Unknown,EPI SERVICE PRIMEUR,Unknown,-115544.0
Unknown,09,Unknown,09,Unknown,Unknown,Unknown,EPI SERVICE PRIMEUR,Unknown,-115553.0
Unknown,64,Unknown,64,Unknown,Unknown,Unknown,EPI SERVICE PRIMEUR,Unknown,-115617.0
Unknown,07,Unknown,07,Unknown,Unknown,Unknown,EPI SERVICE PRIMEUR,Unknown,-115624.0
Unknown,09,Unknown,09,Unknown,Unknown,Unknown,EPI SERVICE PRIMEUR,Unknown,-115633.0
Unknown,01,Unknown,01,Unknown,Unknown,Unknown,EPI SERVICE PRIMEUR,Unknown,-115634.0
Unknown,07,Unknown,07,Unknown,Unknown,Unknown,EPI SERVICE PRIMEUR,Unknown,-115641.0
Unknown,09,Unknown,09,Unknown,Unknown,Unknown,EPI SERVICE PRIMEUR,Unknown,-115650.0
Unknown,64,Unknown,64,Unknown,Unknown,Unknown,EPI SERVICE PRIMEUR,Unknown,-115714.0
Unknown,07,Unknown,07,Unknown,Unknown,Unknown,EPI SERVICE PRIMEUR,Unknown,-115721.0
Unknown,09,Unknown,09,Unknown,Unknown,Unknown,EPI SERVICE PRIMEUR,Unknown,-115730.0
Unknown,01,Unknown,01,Unknown,Unknown,Unknown,EPI SERVICE PRIMEUR,Unknown,-115731.0
Unknown,07,Unknown,07,Unknown,Unknown,Unknown,EPI SERVICE PRIMEUR,Unknown,-115738.0
Unknown,09,Unknown,09,Unknown,Unknown,Unknown,EPI SERVICE PRIMEUR,Unknown,-115747.0
Unknown,64,Unknown,64,Unknown,Unknown,Unknown,EPI SERVICE PRIMEUR,Unknown,-115811.0
Unknown,07,Unknown,07,Unknown,Unknown,Unknown,EPI SERVICE PRIMEUR,Unknown,-115818.0
Unknown,09,Unknown,09,Unknown,Unknown,Unknown,EPI SERVICE PRIMEUR,Unknown,-115827.0
Unknown,01,Unknown,01,Unknown,Unknown,Unknown,EPI SERVICE PRIMEUR,Unknown,-115828.0
Unknown,07,Unknown,07,Unknown,Unknown,Unknown,EPI SERVICE PRIMEUR,Unknown,-115835.0
Unknown,09,Unknown,09,Unknown,Unknown,Unknown,EPI SERVICE PRIMEUR,Unknown,-115844.0
Unknown,01,Unknown,01,Unknown,Unknown,Unknown,EPI SERVICE PRIMEUR,Unknown,-115845.0
Unknown,"249,30",Unknown,"249,30",Unknown,Unknown,Unknown,EPI SERVICE PRIMEUR,Unknown,-140775.0
Unknown,"41,42",Unknown,"41,42",Unknown,Unknown,Unknown,EPI SERVICE PRIMEUR,Unknown,-144917.0
Unknown,"608,69",Unknown,"608,69",Unknown,Unknown,Unknown,EPI SERVICE PRIMEUR,Unknown,-205786.0
Unknown,"1,16",Unknown,"1,16",Unknown,Unknown,Unknown,EPI SERVICE PRIMEUR,Unknown,-205902.0
Unknown,"0,47",Unknown,"0,47",Unknown,Unknown,Unknown,EPI SERVICE PRIMEUR,Unknown,-205949.0
Unknown,"4,65",Unknown,"4,65",Unknown,Unknown,Unknown,EPI SERVICE PRIMEUR,Unknown,-206414.0
Unknown,"1,46",Unknown,"1,46",Unknown,Unknown,Unknown,EPI SERVICE PRIMEUR,Unknown,-206560.0
Unknown,"4,11",Unknown,"4,11",Unknown,Unknown,Unknown,EPI SERVICE PRIMEUR,Unknown,-206971.0
Unknown,"0,37",Unknown,"0,37",Unknown,Unknown,Unknown,EPI SERVICE PRIMEUR,Unknown,-207008.0
Unknown,"4,68",Unknown,"4,68",Unknown,Unknown,Unknown,EPI SERVICE PRIMEUR,Unknown,-207476.0
Unknown,"1,15",Unknown,"1,15",Unknown,Unknown,Unknown,EPI SERVICE PRIMEUR,Unknown,-207591.0
Unknown,"0,39",Unknown,"0,39",Unknown,Unknown,Unknown,EPI SERVICE PRIMEUR,Unknown,-207630.0
Unknown,"0,51",Unknown,"0,51",Unknown,Unknown,Unknown,EPI SERVICE PRIMEUR,Unknown,-207681.0
Unknown,"0,19",Unknown,"0,19",Unknown,Unknown,Unknown,EPI SERVICE PRIMEUR,Unknown,-207700.0
Unknown,"0,27",Unknown,"0,27",Unknown,Unknown,Unknown,EPI SERVICE PRIMEUR,Unknown,-207727.0
Unknown,"89,33",Unknown,"89,33",Unknown,Unknown,Unknown,EPI SERVICE PRIMEUR,Unknown,-216660.0
Unknown,"121,58",Unknown,"121,58",Unknown,Unknown,Unknown,EPI SERVICE PRIMEUR,Unknown,-228818.0
Unknown,06,Unknown,06,Unknown,Unknown,Unknown,EPI SERVICE PRIMEUR,Unknown,-228824.0
Unknown,"09 600,00",Unknown,"09 600,00",Unknown,Unknown,Unknown,EPI SERVICE PRIMEUR,Unknown,-1188824.0
Unknown,06,Unknown,06,Unknown,Unknown,Unknown,EPI SERVICE PRIMEUR,Unknown,-1188830.0
Unknown,"09 125,41",Unknown,"09 125,41",Unknown,Unknown,Unknown,EPI SERVICE PRIMEUR,Unknown,-2101371.0
Unknown,07,Unknown,07,Unknown,Unknown,Unknown,EPI SERVICE PRIMEUR,Unknown,-2101378.0
Unknown,09 07,Unknown,09 07,Unknown,Unknown,Unknown,EPI SERVICE PRIMEUR,Unknown,-2102285.0
Unknown,09 07,Unknown,09 07,Unknown,Unknown,Unknown,EPI SERVICE PRIMEUR,Unknown,-2103192.0
Unknown,09 07,Unknown,09 07,Unknown,Unknown,Unknown,EPI SERVICE PRIMEUR,Unknown,-2104099.0
Unknown,09 07,Unknown,09 07,Unknown,Unknown,Unknown,EPI SERVICE PRIMEUR,Unknown,-2105006.0
Unknown,09 07,Unknown,09 07,Unknown,Unknown,Unknown,EPI SERVICE PRIMEUR,Unknown,-2105913.0
Unknown,09 07,Unknown,09 07,Unknown,Unknown,Unknown,EPI SERVICE PRIMEUR,Unknown,-2106820.0
Unknown,09 07,Unknown,09 07,Unknown,Unknown,Unknown,EPI SERVICE PRIMEUR,Unknown,-2107727.0
Unknown,09 07,Unknown,09 07,Unknown,Unknown,Unknown,EPI SERVICE PRIMEUR,Unknown,-2108634.0
Unknown,09 07,Unknown,09 07,Unknown,Unknown,Unknown,EPI SERVICE PRIMEUR,Unknown,-2109541.0
Unknown,09 07,Unknown,09 07,Unknown,Unknown,Unknown,EPI SERVICE PRIMEUR,Unknown,-2110448.0
Unknown,09 07,Unknown,09 07,Unknown,Unknown,Unknown,EPI SERVICE PRIMEUR,Unknown,-2111355.0
Unknown,09 07,Unknown,09 07,Unknown,Unknown,Unknown,EPI SERVICE PRIMEUR,Unknown,-2112262.0
Unknown,09 07,Unknown,09 07,Unknown,Unknown,Unknown,EPI SERVICE PRIMEUR,Unknown,-2113169.0
Unknown,09 07,Unknown,09 07,Unknown,Unknown,Unknown,EPI SERVICE PRIMEUR,Unknown,-2114076.0
Unknown,09 07,Unknown,09 07,Unknown,Unknown,Unknown,EPI SERVICE PRIMEUR,Unknown,-2114983.0
Unknown,"09 106,72",Unknown,"09 106,72",Unknown,Unknown,Unknown,EPI SERVICE PRIMEUR,Unknown,-3025655.0
Unknown,"83,30",Unknown,"83,30",Unknown,Unknown,Unknown,EPI SERVICE PRIMEUR,Unknown,-3033985.0
Unknown,"387,90",Unknown,"387,90",Unknown,Unknown,Unknown,EPI SERVICE PRIMEUR,Unknown,-3072775.0
Unknown,"184,90",Unknown,"184,90",Unknown,Unknown,Unknown,EPI SERVICE PRIMEUR,Unknown,-3091265.0
Unknown,"151,10",Unknown,"151,10",Unknown,Unknown,Unknown,EPI SERVICE PRIMEUR,Unknown,-3106375.0
Unknown,"8,20",Unknown,"8,20",Unknown,Unknown,Unknown,EPI SERVICE PRIMEUR,Unknown,-3107195.0
Unknown,"29,50",Unknown,"29,50",Unknown,Unknown,Unknown,EPI SERVICE PRIMEUR,Unknown,-3110145.0
Unknown,"246,89",Unknown,"246,89",Unknown,Unknown,Unknown,EPI SERVICE PRIMEUR,Unknown,-3134834.0
Unknown,"1,25",Unknown,"1,25",Unknown,Unknown,Unknown,EPI SERVICE PRIMEUR,Unknown,-3134959.0
Unknown,"1,30",Unknown,"1,30",Unknown,Unknown,Unknown,EPI SERVICE PRIMEUR,Unknown,-3135089.0
Unknown,"0,19",Unknown,"0,19",Unknown,Unknown,Unknown,EPI SERVICE PRIMEUR,Unknown,-3135108.0
Unknown,"1,70",Unknown,"1,70",Unknown,Unknown,Unknown,EPI SERVICE PRIMEUR,Unknown,-3135278.0
Unknown,"0,31",Unknown,"0,31",Unknown,Unknown,Unknown,EPI SERVICE PRIMEUR,Unknown,-3135309.0
Unknown,"1,01",Unknown,"1,01",Unknown,Unknown,Unknown,EPI SERVICE PRIMEUR,Unknown,-3135410.0
Unknown,"2,02",Unknown,"2,02",Unknown,Unknown,Unknown,EPI SERVICE PRIMEUR,Unknown,-3135612.0
Unknown,"0,47",Unknown,"0,47",Unknown,Unknown,Unknown,EPI SERVICE PRIMEUR,Unknown,-3135659.0
Unknown,1,Unknown,1,Unknown,Unknown,Unknown,EPI SERVICE PRIMEUR,Unknown,-3135660.0
Unknown,1,Unknown,1,Unknown,Unknown,Unknown,EPI SERVICE PRIMEUR,Unknown,-3135661.0
Unknown,4,Unknown,4,Unknown,Unknown,Unknown,EPI SERVICE PRIMEUR,Unknown,-3135665.0
07.11.2018,Unknown,06.10,Unknown,Unknown,Debit,Unknown,DAANCY,LCL RELEVE DE COMPTE,6.1
Unknown,Unknown,07.11,Unknown,Unknown,Debit,Unknown,DAANCY,AvENUE HENRI,13.21
Unknown,Unknown,3,Unknown,Unknown,Debit,Unknown,DAANCY,BARBUSSE,16.21
Unknown,Unknown,107,Unknown,Unknown,Debit,Unknown,DAANCY,DES POSTES,123.21
Unknown,Unknown,23,Unknown,Unknown,Debit,Unknown,DAANCY,PSK ALIMENTATION Domiciliaton,146.21
Unknown,Unknown,25,Unknown,Unknown,Debit,Unknown,DAANCY,Relercnces bancaires nationalcs RB Banque Indicatit N,171.21
Unknown,Unknown,4,Unknown,Unknown,Debit,Unknown,DAANCY,Qe 30002,175.21
Unknown,Unknown,45,Unknown,Unknown,Debit,Unknown,DAANCY,PA5,220.21
Unknown,Unknown,01 48,Unknown,Unknown,Debit,Unknown,DAANCY,BARIS KELES,368.21
Unknown,Unknown,14 98,Unknown,Unknown,Debit,Unknown,DAANCY,Identiliant,1866.21
Unknown,Unknown,66,Unknown,Unknown,Debit,Unknown,DAANCY,Internet,1932.21
Unknown,Unknown,19,Unknown,Unknown,Debit,Unknown,DAANCY,LCLIr,1951.21
Unknown,Unknown,05.10,Unknown,Unknown,Debit,Unknown,DAANCY,PRELEVEMENT A LA SOURCE,1956.31
Unknown,Unknown,"524,73",Unknown,Unknown,Debit,Unknown,DAANCY,B2B,54429.31
Unknown,Unknown,03.10,Unknown,Unknown,Debit,Unknown,DAANCY,B2B,54432.41
Unknown,Unknown,02,Unknown,Unknown,Debit,Unknown,DAANCY,ECriTuURES DE,54434.41
Unknown,Unknown,10,Unknown,Unknown,Debit,Unknown,DAANCY,PerioDE DATE,54444.41
Unknown,Unknown,18 03,Unknown,Unknown,Debit,Unknown,DAANCY,Libelle VALEUR,56247.41
Unknown,Unknown,10,Unknown,Unknown,Debit,Unknown,DAANCY,CrEDIT,56257.41
Unknown,Unknown,0,Unknown,Unknown,Debit,Unknown,DAANCY,NO,56257.41
Unknown,Unknown,18 08,Unknown,Unknown,Debit,Unknown,DAANCY,CB NO619077 DU,58065.41
Unknown,Unknown,10,Unknown,Unknown,Debit,Unknown,DAANCY,NO619433 DU,58075.41
Unknown,Unknown,08.10,Unknown,Unknown,Debit,Unknown,DAANCY,CB NO 714335 DU,58083.51
Unknown,Unknown,08.10,Unknown,Unknown,Debit,Unknown,DAANCY,COMMISSIONS SuR,58091.60999999999
Unknown,Unknown,08.10,Unknown,Unknown,Debit,Unknown,DAANCY,CB NO,58099.70999999999
Unknown,Unknown,08.10,Unknown,Unknown,Debit,Unknown,DAANCY,COMMISSIONS SuA REMISE,58107.80999999999
Unknown,Unknown,08.10,Unknown,Unknown,Debit,Unknown,DAANCY,CB NO,58115.90999999999
Unknown,Unknown,08.10,Unknown,Unknown,Debit,Unknown,DAANCY,COMMISSIONS SuR ReMISE,58124.00999999999
Unknown,Unknown,08.10,Unknown,Unknown,Debit,Unknown,DAANCY,COMMISSIONS,58132.10999999999
Unknown,Unknown,08.10,Unknown,Unknown,Debit,Unknown,DAANCY,REMISE,58140.20999999999
Unknown,Unknown,08.10,Unknown,Unknown,Debit,Unknown,DAANCY,CB NO,58148.30999999998
Unknown,Unknown,08.10,Unknown,Unknown,Debit,Unknown,DAANCY,COMMISSIONS,58156.40999999998
Unknown,Unknown,"619,33",Unknown,Unknown,Debit,Unknown,DAANCY,COMMISSIONS,120089.40999999996
Unknown,Unknown,08.10,Unknown,Unknown,Debit,Unknown,DAANCY,CB NO 619077 DU,120097.50999999998
Unknown,Unknown,09.10,Unknown,Unknown,Debit,Unknown,DAANCY,COMMISSIONS SuA,120106.61
Unknown,Unknown,09.10,Unknown,Unknown,Debit,Unknown,DAANCY,CB NO8*7106 DU 091018 09.10,120115.71
Unknown,Unknown,03.10,Unknown,Unknown,Debit,Unknown,DAANCY,REMISE,120118.81
Unknown,Unknown,18 03,Unknown,Unknown,Debit,Unknown,DAANCY,NO847106 DU,121921.81
Unknown,Unknown,10.18,Unknown,Unknown,Debit,Unknown,DAANCY,Page 76 Credi Lyonnais,121931.99
Unknown,Unknown,08.10,Unknown,Unknown,Debit,Unknown,DAANCY,Lyon,121940.09
Unknown,Unknown,18 08,Unknown,Unknown,Debit,Unknown,DAANCY,Aepublique,123748.09
Unknown,Unknown,10.18,Unknown,Unknown,Debit,Unknown,DAANCY,Lyon,123758.27
Unknown,Unknown,08.10,Unknown,Unknown,Debit,Unknown,DAANCY,Unknown,123766.37
Unknown,Unknown,18 08,Unknown,Unknown,Debit,Unknown,DAANCY,Unknown,125574.37
Unknown,Unknown,10.18,Unknown,Unknown,Debit,Unknown,DAANCY,Unknown,125584.55
Unknown,Unknown,08.10,Unknown,Unknown,Debit,Unknown,DAANCY,Unknown,125592.65
Unknown,Unknown,18 08,Unknown,Unknown,Debit,Unknown,DAANCY,Unknown,127400.65
Unknown,Unknown,10.18,Unknown,Unknown,Debit,Unknown,DAANCY,Unknown,127410.83
Unknown,Unknown,08.10,Unknown,Unknown,Debit,Unknown,DAANCY,Unknown,127418.93
Unknown,Unknown,"18 374,45",Unknown,Unknown,Debit,Unknown,DAANCY,Unknown,1964863.93
Unknown,Unknown,"374,45",Unknown,Unknown,Debit,Unknown,DAANCY,Unknown,2002308.93
Unknown,Unknown,"70,301 28",Unknown,Unknown,Debit,Unknown,DAANCY,Unknown,9032436.93
Unknown,Unknown,"70,201 82",Unknown,Unknown,Debit,Unknown,DAANCY,Unknown,16052618.93
Unknown,Unknown,20,Unknown,Unknown,Debit,Unknown,DAANCY,Unknown,16052638.93
Unknown,Unknown,49,Unknown,Unknown,Debit,Unknown,DAANCY,Unknown,16052687.93
Unknown,Unknown,"48,201",Unknown,Unknown,Debit,Unknown,DAANCY,Unknown,16100888.93
Unknown,Unknown,"0,29",Unknown,Unknown,Debit,Unknown,DAANCY,Unknown,16100917.93
Unknown,Unknown,08.10,Unknown,Unknown,Debit,Unknown,DAANCY,Unknown,16100926.03
Unknown,Unknown,18,Unknown,Unknown,Debit,Unknown,DAANCY,Unknown,16100944.03
Unknown,Unknown,"0,42",Unknown,Unknown,Debit,Unknown,DAANCY,Unknown,16100986.03
Unknown,Unknown,08.10,Unknown,Unknown,Debit,Unknown,DAANCY,Unknown,16100994.13
Unknown,Unknown,18,Unknown,Unknown,Debit,Unknown,DAANCY,Unknown,16101012.13
Unknown,Unknown,"0,29",Unknown,Unknown,Debit,Unknown,DAANCY,Unknown,16101041.13
Unknown,Unknown,08,Unknown,Unknown,Debit,Unknown,DAANCY,Unknown,16101049.13
Unknown,Unknown,10.18,Unknown,Unknown,Debit,Unknown,DAANCY,Unknown,16101059.31
Unknown,Unknown,"0,17",Unknown,Unknown,Debit,Unknown,DAANCY,Unknown,16101076.31
Unknown,Unknown,08.10,Unknown,Unknown,Debit,Unknown,DAANCY,Unknown,16101084.409999998
Unknown,Unknown,18,Unknown,Unknown,Debit,Unknown,DAANCY,Unknown,16101102.409999998
Unknown,Unknown,"0,60",Unknown,Unknown,Debit,Unknown,DAANCY,Unknown,16101162.409999998
Unknown,Unknown,08.10,Unknown,Unknown,Debit,Unknown,DAANCY,Unknown,16101170.509999998
Unknown,Unknown,18,Unknown,Unknown,Debit,Unknown,DAANCY,Unknown,16101188.509999998
Unknown,Unknown,"0,42",Unknown,Unknown,Debit,Unknown,DAANCY,Unknown,16101230.509999998
Unknown,Unknown,09.10,Unknown,Unknown,Debit,Unknown,DAANCY,Unknown,16101239.609999998
Unknown,Unknown,18,Unknown,Unknown,Debit,Unknown,DAANCY,Unknown,16101257.609999998
Unknown,Unknown,"0,12",Unknown,Unknown,Debit,Unknown,DAANCY,Unknown,16101269.609999998
Unknown,Unknown,9 20,Unknown,Unknown,Debit,Unknown,DAANCY,Unknown,16102189.609999998
Unknown,Unknown,09.10,Unknown,Unknown,Debit,Unknown,DAANCY,Unknown,16102198.709999995
Unknown,Unknown,18,Unknown,Unknown,Debit,Unknown,DAANCY,Unknown,16102216.709999995
Unknown,Unknown,76,Unknown,Unknown,Debit,Unknown,DAANCY,Unknown,16102292.709999995
Unknown,Unknown,2 037 713 591,Unknown,Unknown,Debit,Unknown,DAANCY,Unknown,2053815883.71
Unknown,Unknown,509 741,Unknown,Unknown,Debit,Unknown,DAANCY,Unknown,2054325624.71
Unknown,Unknown,18,Unknown,Unknown,Debit,Unknown,DAANCY,Unknown,2054325642.71
Unknown,Unknown,07 00,Unknown,Unknown,Debit,Unknown,DAANCY,Unknown,2054326342.71
07.12.2018,Unknown,08.11,Unknown,Unknown,Debit,Unknown,DAANCY,LCL RELEVE DE COMPTE,8.11
Unknown,Unknown,07.12,Unknown,Unknown,Debit,Unknown,DAANCY,No 4,15.23
Unknown,Unknown,4,Unknown,Unknown,Debit,Unknown,DAANCY,AvENUE HENRI,19.23
Unknown,Unknown,107,Unknown,Unknown,Debit,Unknown,DAANCY,BARBUSSE,126.23
Unknown,Unknown,23,Unknown,Unknown,Debit,Unknown,DAANCY,DES POSTES,149.23000000000002
Unknown,Unknown,25,Unknown,Unknown,Debit,Unknown,DAANCY,PSK ALIMENTATION Domiciliaton,174.23000000000002
Unknown,Unknown,4,Unknown,Unknown,Debit,Unknown,DAANCY,Relercnces bancaires nationalcs RB Banque Indicatit N,178.23000000000002
Unknown,Unknown,45,Unknown,Unknown,Debit,Unknown,DAANCY,Qe 30002,223.23
Unknown,Unknown,01 48,Unknown,Unknown,Debit,Unknown,DAANCY,PA5,371.23
Unknown,Unknown,14 98,Unknown,Unknown,Debit,Unknown,DAANCY,BARIS KELES,1869.23
Unknown,Unknown,66,Unknown,Unknown,Debit,Unknown,DAANCY,votre Identifiant,1935.23
Unknown,Unknown,19,Unknown,Unknown,Debit,Unknown,DAANCY,Ier decembre 2018,1954.23
Unknown,Unknown,07.11,Unknown,Unknown,Debit,Unknown,DAANCY,Gerer vos cartes Pros,1961.34
Unknown,Unknown,"382,72",Unknown,Unknown,Debit,Unknown,DAANCY,Ier,40233.34
Unknown,Unknown,08.11,Unknown,Unknown,Debit,Unknown,DAANCY,PAS,40241.45
Unknown,Unknown,08.11,Unknown,Unknown,Debit,Unknown,DAANCY,B28,40249.56
Unknown,Unknown,08.11,Unknown,Unknown,Debit,Unknown,DAANCY,Tresor Public,40257.67
Unknown,Unknown,08.11,Unknown,Unknown,Debit,Unknown,DAANCY,PAS declare,40265.78
Unknown,Unknown,08.11,Unknown,Unknown,Debit,Unknown,DAANCY,gouvfr,40273.89
Unknown,Unknown,09.11,Unknown,Unknown,Debit,Unknown,DAANCY,B2B,40283.0
Unknown,Unknown,09.11,Unknown,Unknown,Debit,Unknown,DAANCY,detaut,40292.11
Unknown,Unknown,08.11,Unknown,Unknown,Debit,Unknown,DAANCY,B2B,40300.22
Unknown,Unknown,18 08,Unknown,Unknown,Debit,Unknown,DAANCY,ECRITURES DE LA PErioDE DATE,42108.22
Unknown,Unknown,11.18,Unknown,Unknown,Debit,Unknown,DAANCY,SOLDE,42119.4
Unknown,Unknown,08.11,Unknown,Unknown,Debit,Unknown,DAANCY,CB,42127.51
Unknown,Unknown,18 24,Unknown,Unknown,Debit,Unknown,DAANCY,Palv SEPA Free Telecom UBELLeFree,43951.51
Unknown,Unknown,70,Unknown,Unknown,Debit,Unknown,DAANCY,aefClient,44021.51
Unknown,Unknown,"92,00",Unknown,Unknown,Debit,Unknown,DAANCY,COMMISSIONS,53221.51
Unknown,Unknown,"29,99",Unknown,Unknown,Debit,Unknown,DAANCY,REMISE,56220.51
Unknown,Unknown,08.11,Unknown,Unknown,Debit,Unknown,DAANCY,COMMISSIONS,56228.62
Unknown,Unknown,18,Unknown,Unknown,Debit,Unknown,DAANCY,CHO,56246.62
Unknown,Unknown,"0,15",Unknown,Unknown,Debit,Unknown,DAANCY,COMMISSIONS,56261.62
Unknown,Unknown,08.11,Unknown,Unknown,Debit,Unknown,DAANCY,CB NO,56269.73
Unknown,Unknown,18,Unknown,Unknown,Debit,Unknown,DAANCY,Page 76 Credi Lyonnais,56287.73
Unknown,Unknown,"0,66",Unknown,Unknown,Debit,Unknown,DAANCY,ACS,56353.73
Unknown,Unknown,09.11,Unknown,Unknown,Debit,Unknown,DAANCY,Lyon,56362.84
Unknown,Unknown,18 09,Unknown,Unknown,Debit,Unknown,DAANCY,Aepublique,58171.84
Unknown,Unknown,11.18,Unknown,Unknown,Debit,Unknown,DAANCY,Lyon,58183.02
Unknown,Unknown,"890,00",Unknown,Unknown,Debit,Unknown,DAANCY,Unknown,147183.02000000002
Unknown,Unknown,"0,12",Unknown,Unknown,Debit,Unknown,DAANCY,Unknown,147195.02000000002
Unknown,Unknown,7,Unknown,Unknown,Debit,Unknown,DAANCY,Unknown,147202.02000000002
Unknown,Unknown,76,Unknown,Unknown,Debit,Unknown,DAANCY,Unknown,147278.02000000002
Unknown,Unknown,2 037 713 591,Unknown,Unknown,Debit,Unknown,DAANCY,Unknown,2037860869.02
Unknown,Unknown,954 509 741,Unknown,Unknown,Debit,Unknown,DAANCY,Unknown,2992370610.02
Unknown,Unknown,18,Unknown,Unknown,Debit,Unknown,DAANCY,Unknown,2992370628.02
Unknown,Unknown,07 00,Unknown,Unknown,Debit,Unknown,DAANCY,Unknown,2992371328.02
06.12.2019,Unknown,08.11,Unknown,Unknown,Debit,Unknown,DAANCY,LCL RELEVE DE COMPTE,8.11
Unknown,Unknown,06.12,Unknown,Unknown,Debit,Unknown,DAANCY,AvENUE HENRI,14.23
Unknown,Unknown,16,Unknown,Unknown,Debit,Unknown,DAANCY,BARBUSSE,30.23
Unknown,Unknown,107,Unknown,Unknown,Debit,Unknown,DAANCY,DES POSTES,137.23
Unknown,Unknown,23,Unknown,Unknown,Debit,Unknown,DAANCY,PSK ALIMENTATION Domiciliaton,160.23
Unknown,Unknown,25,Unknown,Unknown,Debit,Unknown,DAANCY,Relercnces bancaires nationalcs RB Banque Indicatit N,185.23
Unknown,Unknown,4,Unknown,Unknown,Debit,Unknown,DAANCY,Qe 30002,189.23
Unknown,Unknown,45,Unknown,Unknown,Debit,Unknown,DAANCY,PA5,234.23
Unknown,Unknown,01 48,Unknown,Unknown,Debit,Unknown,DAANCY,BARIS KELES,382.23
Unknown,Unknown,14 98,Unknown,Unknown,Debit,Unknown,DAANCY,votre Identifiant,1880.23
Unknown,Unknown,66,Unknown,Unknown,Debit,Unknown,DAANCY,Ier,1946.23
Unknown,Unknown,19,Unknown,Unknown,Debit,Unknown,DAANCY,Ier decembre 2019,1965.23
Unknown,Unknown,07.11,Unknown,Unknown,Debit,Unknown,DAANCY,LCLIr,1972.34
Unknown,Unknown,"400,05",Unknown,Unknown,Debit,Unknown,DAANCY,Icl.tr,41977.34
Unknown,Unknown,08.11,Unknown,Unknown,Debit,Unknown,DAANCY,Solution,41985.45
Unknown,Unknown,08.11,Unknown,Unknown,Debit,Unknown,DAANCY,Gerer vos cartes Pros,41993.56
Unknown,Unknown,08.11,Unknown,Unknown,Debit,Unknown,DAANCY,vouS pouveZ resilier,42001.67
Unknown,Unknown,08.11,Unknown,Unknown,Debit,Unknown,DAANCY,ECriTuURES DE LA,42009.78
Unknown,Unknown,"388,06",Unknown,Unknown,Debit,Unknown,DAANCY,PerioDE DATE,80815.78
Unknown,Unknown,08.11,Unknown,Unknown,Debit,Unknown,DAANCY,Libelle VALEUR,80823.89
Unknown,Unknown,12.11,Unknown,Unknown,Debit,Unknown,DAANCY,CreDIT,80836.0
Unknown,Unknown,12.11,Unknown,Unknown,Debit,Unknown,DAANCY,SOLDE,80848.11
Unknown,Unknown,08,Unknown,Unknown,Debit,Unknown,DAANCY,CB NO 388776,80856.11
Unknown,Unknown,11.19,Unknown,Unknown,Debit,Unknown,DAANCY,COMMISSIONS SuR REMISE,80867.3
Unknown,Unknown,08.11,Unknown,Unknown,Debit,Unknown,DAANCY,CB NO,80875.41
Unknown,Unknown,19 08,Unknown,Unknown,Debit,Unknown,DAANCY,COMMISSIONS SuA REMISE,82783.41
Unknown,Unknown,11.19,Unknown,Unknown,Debit,Unknown,DAANCY,CB NO 388776,82794.6
Unknown,Unknown,08.11,Unknown,Unknown,Debit,Unknown,DAANCY,COMMISSIONS,82802.71
Unknown,Unknown,"19 030,94",Unknown,Unknown,Debit,Unknown,DAANCY,NO 498368 DU,1985896.71
Unknown,Unknown,"70,101 50",Unknown,Unknown,Debit,Unknown,DAANCY,COMMISSIONS,8996046.71
Unknown,Unknown,201,Unknown,Unknown,Debit,Unknown,DAANCY,NO 675738 DU,8996247.71
Unknown,Unknown,"0,42",Unknown,Unknown,Debit,Unknown,DAANCY,NO 591524 DU,8996289.71
Unknown,Unknown,08.11,Unknown,Unknown,Debit,Unknown,DAANCY,COMMISSIONS,8996297.82
Unknown,Unknown,19,Unknown,Unknown,Debit,Unknown,DAANCY,CB NO 631595 DU,8996316.82
Unknown,Unknown,"0,30",Unknown,Unknown,Debit,Unknown,DAANCY,COMMISSIONS,8996346.82
Unknown,Unknown,19,Unknown,Unknown,Debit,Unknown,DAANCY,COMMISSIONS,8996365.82
Unknown,Unknown,"0,89",Unknown,Unknown,Debit,Unknown,DAANCY,NO 675914 DU,8996454.82
Unknown,Unknown,19,Unknown,Unknown,Debit,Unknown,DAANCY,COMMISSIONS,8996473.82
Unknown,Unknown,"0,70",Unknown,Unknown,Debit,Unknown,DAANCY,NO 631390,8996543.82
Unknown,Unknown,19,Unknown,Unknown,Debit,Unknown,DAANCY,Page 76,8996562.82
Unknown,Unknown,"1,62",Unknown,Unknown,Debit,Unknown,DAANCY,Lyon,8996724.82
Unknown,Unknown,19,Unknown,Unknown,Debit,Unknown,DAANCY,Aepublique,8996743.82
Unknown,Unknown,"1,25",Unknown,Unknown,Debit,Unknown,DAANCY,Lyon,8996868.82
Unknown,Unknown,19,Unknown,Unknown,Debit,Unknown,DAANCY,Unknown,8996887.82
Unknown,Unknown,0,Unknown,Unknown,Debit,Unknown,DAANCY,Unknown,8996887.82
Unknown,Unknown,64,Unknown,Unknown,Debit,Unknown,DAANCY,Unknown,8996951.82
Unknown,Unknown,19,Unknown,Unknown,Debit,Unknown,DAANCY,Unknown,8996970.82
Unknown,Unknown,"0,39",Unknown,Unknown,Debit,Unknown,DAANCY,Unknown,8997009.82
Unknown,Unknown,19,Unknown,Unknown,Debit,Unknown,DAANCY,Unknown,8997028.82
Unknown,Unknown,"1,88",Unknown,Unknown,Debit,Unknown,DAANCY,Unknown,8997216.82
Unknown,Unknown,8,Unknown,Unknown,Debit,Unknown,DAANCY,Unknown,8997224.82
Unknown,Unknown,76,Unknown,Unknown,Debit,Unknown,DAANCY,Unknown,8997300.82
Unknown,Unknown,2 037 713 591,Unknown,Unknown,Debit,Unknown,DAANCY,Unknown,2046710891.82
Unknown,Unknown,509 741,Unknown,Unknown,Debit,Unknown,DAANCY,Unknown,2047220632.82
Unknown,Unknown,18,Unknown,Unknown,Debit,Unknown,DAANCY,Unknown,2047220650.82
Unknown,Unknown,07 00,Unknown,Unknown,Debit,Unknown,DAANCY,Unknown,2047221350.82
07.01.2020,Unknown,07.12,Unknown,Unknown,Debit,Unknown,DAANCY,LCL RELEVE DE COMPTE,7.12
Unknown,Unknown,07.01,Unknown,Unknown,Debit,Unknown,DAANCY,07.12.2019au 07.01.2020 - N,14.13
Unknown,Unknown,17,Unknown,Unknown,Debit,Unknown,DAANCY,AvENUE HENRI,31.13
Unknown,Unknown,107,Unknown,Unknown,Debit,Unknown,DAANCY,BARBUSSE,138.13
Unknown,Unknown,23,Unknown,Unknown,Debit,Unknown,DAANCY,DES POSTES,161.13
Unknown,Unknown,25,Unknown,Unknown,Debit,Unknown,DAANCY,PSK ALIMENTATION Domiciliaton,186.13
Unknown,Unknown,4,Unknown,Unknown,Debit,Unknown,DAANCY,Relercnces bancaires nationalcs RB Banque Indicatit N,190.13
Unknown,Unknown,45,Unknown,Unknown,Debit,Unknown,DAANCY,Qe 30002,235.13
Unknown,Unknown,01 48,Unknown,Unknown,Debit,Unknown,DAANCY,PA5,383.13
Unknown,Unknown,14 98,Unknown,Unknown,Debit,Unknown,DAANCY,ROMAIN LAIDET,1881.13
Unknown,Unknown,88,Unknown,Unknown,Debit,Unknown,DAANCY,votre Identifiant,1969.13
Unknown,Unknown,19,Unknown,Unknown,Debit,Unknown,DAANCY,Mes Comptes ECrITURES DE LA PErioDE DATE,1988.13
Unknown,Unknown,06.12,Unknown,Unknown,Debit,Unknown,DAANCY,CreDIT,1994.25
Unknown,Unknown,"574,26",Unknown,Unknown,Debit,Unknown,DAANCY,SOLDE,59420.25
Unknown,Unknown,09.12,Unknown,Unknown,Debit,Unknown,DAANCY,CHO,59429.37
Unknown,Unknown,09.12,Unknown,Unknown,Debit,Unknown,DAANCY,COMMISSIONS,59438.490000000005
Unknown,Unknown,09.12,Unknown,Unknown,Debit,Unknown,DAANCY,CB NO 150511,59447.61000000001
Unknown,Unknown,09.12,Unknown,Unknown,Debit,Unknown,DAANCY,COMMISSIONS SuA REMISE,59456.73000000001
Unknown,Unknown,09.12,Unknown,Unknown,Debit,Unknown,DAANCY,CB NO,59465.85000000001
Unknown,Unknown,09.12,Unknown,Unknown,Debit,Unknown,DAANCY,COMMISSIONS SuA REMISE,59474.970000000016
Unknown,Unknown,09.12,Unknown,Unknown,Debit,Unknown,DAANCY,CB NO,59484.09000000002
Unknown,Unknown,09.12,Unknown,Unknown,Debit,Unknown,DAANCY,COMMISSIONS,59493.21000000002
Unknown,Unknown,09.12,Unknown,Unknown,Debit,Unknown,DAANCY,NO,59502.33000000002
Unknown,Unknown,09.12,Unknown,Unknown,Debit,Unknown,DAANCY,COMMISSIONS,59511.450000000026
Unknown,Unknown,09.12,Unknown,Unknown,Debit,Unknown,DAANCY,COMMISSIONS,59520.57000000003
Unknown,Unknown,09.12,Unknown,Unknown,Debit,Unknown,DAANCY,CB NO,59529.69000000003
Unknown,Unknown,09.12,Unknown,Unknown,Debit,Unknown,DAANCY,REMISE,59538.810000000034
Unknown,Unknown,09.12,Unknown,Unknown,Debit,Unknown,DAANCY,CB NO 150511,59547.93000000004
Unknown,Unknown,07,Unknown,Unknown,Debit,Unknown,DAANCY,CB NO,59554.93000000004
Unknown,Unknown,12,Unknown,Unknown,Debit,Unknown,DAANCY,REMISE,59566.93000000004
Unknown,Unknown,19 10,Unknown,Unknown,Debit,Unknown,DAANCY,CB NO055905 DU,61476.93000000004
Unknown,Unknown,12,Unknown,Unknown,Debit,Unknown,DAANCY,REMISE,61488.93000000004
Unknown,Unknown,10.12,Unknown,Unknown,Debit,Unknown,DAANCY,CB NO056353,61499.05000000004
Unknown,Unknown,10.12,Unknown,Unknown,Debit,Unknown,DAANCY,CB2BOIMA DiSTAIB,61509.17000000004
Unknown,Unknown,10.12,Unknown,Unknown,Debit,Unknown,DAANCY,CB NO 292633 DU 101219,61519.290000000045
Unknown,Unknown,09.12,Unknown,Unknown,Debit,Unknown,DAANCY,CB NO,61528.41000000005
Unknown,Unknown,19 09,Unknown,Unknown,Debit,Unknown,DAANCY,COMMISSIONS SuR REMISE,63437.41000000005
Unknown,Unknown,12.19,Unknown,Unknown,Debit,Unknown,DAANCY,CB NO 292633 DU 101219,63449.60000000005
Unknown,Unknown,"297,04",Unknown,Unknown,Debit,Unknown,DAANCY,COMMISSIONS SuA,93153.60000000003
Unknown,Unknown,"0,47",Unknown,Unknown,Debit,Unknown,DAANCY,CB NO,93200.60000000003
Unknown,Unknown,09.12,Unknown,Unknown,Debit,Unknown,DAANCY,Page 76,93209.72000000004
Unknown,Unknown,19,Unknown,Unknown,Debit,Unknown,DAANCY,Lyon,93228.72000000004
Unknown,Unknown,"0,88",Unknown,Unknown,Debit,Unknown,DAANCY,Aepublique,93316.72000000004
Unknown,Unknown,09.12,Unknown,Unknown,Debit,Unknown,DAANCY,Lyon,93325.84000000004
Unknown,Unknown,19,Unknown,Unknown,Debit,Unknown,DAANCY,Unknown,93344.84000000004
Unknown,Unknown,"1,17",Unknown,Unknown,Debit,Unknown,DAANCY,Unknown,93461.84000000004
Unknown,Unknown,09.12,Unknown,Unknown,Debit,Unknown,DAANCY,Unknown,93470.96000000004
Unknown,Unknown,19,Unknown,Unknown,Debit,Unknown,DAANCY,Unknown,93489.96000000004
Unknown,Unknown,"0,83",Unknown,Unknown,Debit,Unknown,DAANCY,Unknown,93572.96000000004
Unknown,Unknown,09.12,Unknown,Unknown,Debit,Unknown,DAANCY,Unknown,93582.08000000005
Unknown,Unknown,19,Unknown,Unknown,Debit,Unknown,DAANCY,Unknown,93601.08000000005
Unknown,Unknown,"1,25",Unknown,Unknown,Debit,Unknown,DAANCY,Unknown,93726.08000000005
Unknown,Unknown,09.12,Unknown,Unknown,Debit,Unknown,DAANCY,Unknown,93735.20000000004
Unknown,Unknown,19,Unknown,Unknown,Debit,Unknown,DAANCY,Unknown,93754.20000000004
Unknown,Unknown,"0,45",Unknown,Unknown,Debit,Unknown,DAANCY,Unknown,93799.20000000004
Unknown,Unknown,09.12,Unknown,Unknown,Debit,Unknown,DAANCY,Unknown,93808.32000000002
Unknown,Unknown,19 09,Unknown,Unknown,Debit,Unknown,DAANCY,Unknown,95717.32000000002
Unknown,Unknown,12.19,Unknown,Unknown,Debit,Unknown,DAANCY,Unknown,95729.51000000002
Unknown,Unknown,09.12,Unknown,Unknown,Debit,Unknown,DAANCY,Unknown,95738.63000000002
Unknown,Unknown,19 09,Unknown,Unknown,Debit,Unknown,DAANCY,Unknown,97647.63000000002
Unknown,Unknown,12.19,Unknown,Unknown,Debit,Unknown,DAANCY,Unknown,97659.82000000002
Unknown,Unknown,09.12,Unknown,Unknown,Debit,Unknown,DAANCY,Unknown,97668.94000000002
Unknown,Unknown,19 09,Unknown,Unknown,Debit,Unknown,DAANCY,Unknown,99577.94000000002
Unknown,Unknown,12.19,Unknown,Unknown,Debit,Unknown,DAANCY,Unknown,99590.13000000002
Unknown,Unknown,09.12,Unknown,Unknown,Debit,Unknown,DAANCY,Unknown,99599.25
Unknown,Unknown,19 10,Unknown,Unknown,Debit,Unknown,DAANCY,Unknown,101509.25
Unknown,Unknown,12 19,Unknown,Unknown,Debit,Unknown,DAANCY,Unknown,102728.25
Unknown,Unknown,10.12,Unknown,Unknown,Debit,Unknown,DAANCY,Unknown,102738.37
Unknown,Unknown,19 10,Unknown,Unknown,Debit,Unknown,DAANCY,Unknown,104648.37
Unknown,Unknown,12.19,Unknown,Unknown,Debit,Unknown,DAANCY,Unknown,104660.56
Unknown,Unknown,208,Unknown,Unknown,Debit,Unknown,DAANCY,Unknown,104868.56
Unknown,Unknown,"194,70",Unknown,Unknown,Debit,Unknown,DAANCY,Unknown,124338.56
Unknown,Unknown,"78,10",Unknown,Unknown,Debit,Unknown,DAANCY,Unknown,132148.56
Unknown,Unknown,"74,301 146,90",Unknown,Unknown,Debit,Unknown,DAANCY,Unknown,7430246838.56
Unknown,Unknown,"120,58",Unknown,Unknown,Debit,Unknown,DAANCY,Unknown,7430258896.56
Unknown,Unknown,"160,72",Unknown,Unknown,Debit,Unknown,DAANCY,Unknown,7430274968.56
Unknown,Unknown,"123,80",Unknown,Unknown,Debit,Unknown,DAANCY,Unknown,7430287348.56
Unknown,Unknown,"66,20",Unknown,Unknown,Debit,Unknown,DAANCY,Unknown,7430293968.56
Unknown,Unknown,"0,94",Unknown,Unknown,Debit,Unknown,DAANCY,Unknown,7430294062.56
Unknown,Unknown,10.12,Unknown,Unknown,Debit,Unknown,DAANCY,Unknown,7430294072.68
Unknown,Unknown,19,Unknown,Unknown,Debit,Unknown,DAANCY,Unknown,7430294091.68
Unknown,Unknown,"0,40",Unknown,Unknown,Debit,Unknown,DAANCY,Unknown,7430294131.68
Unknown,Unknown,8,Unknown,Unknown,Debit,Unknown,DAANCY,Unknown,7430294139.68
Unknown,Unknown,76,Unknown,Unknown,Debit,Unknown,DAANCY,Unknown,7430294215.68
Unknown,Unknown,2 037 713 591,Unknown,Unknown,Debit,Unknown,DAANCY,Unknown,9468007806.68
Unknown,Unknown,509 741,Unknown,Unknown,Debit,Unknown,DAANCY,Unknown,9468517547.68
Unknown,Unknown,18,Unknown,Unknown,Debit,Unknown,DAANCY,Unknown,9468517565.68
Unknown,Unknown,07 00,Unknown,Unknown,Debit,Unknown,DAANCY,Unknown,9468518265.68
